State,StateCode,Municipality,MunicipalityCode,Locality,Schools,Students,StudentsFemale,StudentsMale,Teachers
AGUASCALIENTES,1,AGUASCALIENTES,001,AGUASCALIENTES,1015,255156,130040,125116,17715
AGUASCALIENTES,1,AGUASCALIENTES,001,ARDILLAS DE ABAJO (LAS ARDILLAS),1,99,49,50,3
AGUASCALIENTES,1,AGUASCALIENTES,001,ARELLANO,7,1522,703,819,109
AGUASCALIENTES,1,AGUASCALIENTES,001,BAJÍO LOS VÁZQUEZ,2,15,8,7,2
AGUASCALIENTES,1,AGUASCALIENTES,001,BUENAVISTA DE PEÑUELAS,2,208,111,97,20
AGUASCALIENTES,1,AGUASCALIENTES,001,CABECITA 3 MARÍAS (RANCHO NUEVO),2,18,6,12,2
AGUASCALIENTES,1,AGUASCALIENTES,001,CAÑADA GRANDE DE COTORINA,4,359,186,173,16
AGUASCALIENTES,1,AGUASCALIENTES,001,CAÑADA HONDA [ESTACIÓN],1,5,2,3,1
AGUASCALIENTES,1,AGUASCALIENTES,001,CENTRO DE ARRIBA (EL TARAY),4,330,169,161,14
AGUASCALIENTES,1,AGUASCALIENTES,001,CHE GUEVARA [COLONIA],2,11,5,6,2
AGUASCALIENTES,1,AGUASCALIENTES,001,CIENEGUILLA (LA LUMBRERA),4,271,140,131,12
AGUASCALIENTES,1,AGUASCALIENTES,001,COMUNIDAD EL ROCÍO,1,52,25,27,3
AGUASCALIENTES,1,AGUASCALIENTES,001,COTORINA (COYOTES),4,452,220,232,21
AGUASCALIENTES,1,AGUASCALIENTES,001,CUAUHTÉMOC (LAS PALOMAS),2,82,39,43,4
AGUASCALIENTES,1,AGUASCALIENTES,001,CUMBRES III,4,494,231,263,16
AGUASCALIENTES,1,AGUASCALIENTES,001,EJIDO SAN ANTONIO DE LOS PEDROZA,2,27,9,18,3
AGUASCALIENTES,1,AGUASCALIENTES,001,EL CARDÓN,3,33,20,13,3
AGUASCALIENTES,1,AGUASCALIENTES,001,EL CARIÑÁN,2,66,31,35,3
AGUASCALIENTES,1,AGUASCALIENTES,001,EL CEDAZO (CEDAZO DE SAN ANTONIO),2,24,13,11,2
AGUASCALIENTES,1,AGUASCALIENTES,001,EL COLORADO (EL SOYATAL),2,117,57,60,4
AGUASCALIENTES,1,AGUASCALIENTES,001,EL CONEJAL,4,318,168,150,14
AGUASCALIENTES,1,AGUASCALIENTES,001,EL CRUCERO DE CALVILLITO,2,22,6,16,2
AGUASCALIENTES,1,AGUASCALIENTES,001,EL DOMINADO (EL RELICARIO),1,40,20,20,2
AGUASCALIENTES,1,AGUASCALIENTES,001,EL DURAZNILLO,4,142,70,72,8
AGUASCALIENTES,1,AGUASCALIENTES,001,EL GIGANTE (ARELLANO),2,53,27,26,3
AGUASCALIENTES,1,AGUASCALIENTES,001,EL GUARDA,4,148,85,63,9
AGUASCALIENTES,1,AGUASCALIENTES,001,EL HOTELITO,1,34,19,15,1
AGUASCALIENTES,1,AGUASCALIENTES,001,EL JAGÜEY,3,26,13,13,3
AGUASCALIENTES,1,AGUASCALIENTES,001,EL MALACATE,2,50,22,28,3
AGUASCALIENTES,1,AGUASCALIENTES,001,EL NIÁGARA,2,75,35,40,4
AGUASCALIENTES,1,AGUASCALIENTES,001,EL OCOTE,2,33,18,15,2
AGUASCALIENTES,1,AGUASCALIENTES,001,EL REFUGIO DE PEÑUELAS,2,306,153,153,9
AGUASCALIENTES,1,AGUASCALIENTES,001,EL RELICARIO,3,172,84,88,9
AGUASCALIENTES,1,AGUASCALIENTES,001,EL SALTO DE LOS SALADO,4,537,289,248,30
AGUASCALIENTES,1,AGUASCALIENTES,001,EL TANQUE DE LOS JIMÉNEZ,2,96,42,54,4
AGUASCALIENTES,1,AGUASCALIENTES,001,EL TURICATE,3,55,31,24,5
AGUASCALIENTES,1,AGUASCALIENTES,001,GENERAL JOSÉ MARÍA MORELOS Y PAVÓN (CAÑADA HONDA),5,1722,1059,663,131
AGUASCALIENTES,1,AGUASCALIENTES,001,GRANJAS FÁTIMA,2,156,62,94,6
AGUASCALIENTES,1,AGUASCALIENTES,001,HACIENDA NUEVA,7,1588,890,698,127
AGUASCALIENTES,1,AGUASCALIENTES,001,JALTOMATE,5,754,384,370,28
AGUASCALIENTES,1,AGUASCALIENTES,001,LA NUEVA TERESA,2,51,30,21,2
AGUASCALIENTES,1,AGUASCALIENTES,001,LA PROVIDENCIA,2,38,18,20,2
AGUASCALIENTES,1,AGUASCALIENTES,001,LOMAS DE ARELLANO,2,62,27,35,3
AGUASCALIENTES,1,AGUASCALIENTES,001,LOMAS DE NUEVA YORK,1,22,8,14,2
AGUASCALIENTES,1,AGUASCALIENTES,001,LOMAS DEL GACHUPÍN,1,260,105,155,19
AGUASCALIENTES,1,AGUASCALIENTES,001,LOS CAÑOS,4,302,155,147,16
AGUASCALIENTES,1,AGUASCALIENTES,001,LOS CUERVOS (LOS OJOS DE AGUA),4,317,174,143,15
AGUASCALIENTES,1,AGUASCALIENTES,001,LOS DURÓN,3,47,20,27,3
AGUASCALIENTES,1,AGUASCALIENTES,001,LOS NEGRITOS,4,660,335,325,31
AGUASCALIENTES,1,AGUASCALIENTES,001,LOS PARGAS [RANCHO],2,107,45,62,5
AGUASCALIENTES,1,AGUASCALIENTES,001,LOTES DE ARELLANO,1,16,9,7,1
AGUASCALIENTES,1,AGUASCALIENTES,001,MATAMOROS [CONGREGACIÓN],4,154,67,87,9
AGUASCALIENTES,1,AGUASCALIENTES,001,MONTORO,5,492,252,240,19
AGUASCALIENTES,1,AGUASCALIENTES,001,NORIAS DE CEDAZO (CEDAZO NORIAS DE MONTORO),3,51,24,27,3
AGUASCALIENTES,1,AGUASCALIENTES,001,NORIAS DE OJOCALIENTE,7,1304,681,623,44
AGUASCALIENTES,1,AGUASCALIENTES,001,NORIAS DEL PASO HONDO,5,790,397,393,30
AGUASCALIENTES,1,AGUASCALIENTES,001,OJO DE AGUA DE PALMITAS,2,177,82,95,6
AGUASCALIENTES,1,AGUASCALIENTES,001,PEÑUELAS (EL CIENEGAL),5,979,506,473,60
AGUASCALIENTES,1,AGUASCALIENTES,001,POCITOS,6,886,418,468,32
AGUASCALIENTES,1,AGUASCALIENTES,001,PUERTA DE LOS VIEJITOS,2,20,10,10,4
AGUASCALIENTES,1,AGUASCALIENTES,001,SAN ANTONIO DE PEÑUELAS,3,686,329,357,23
AGUASCALIENTES,1,AGUASCALIENTES,001,SAN ANTONIO PRIMERO DE LOS PEDROZA [CONGREGACIÓN],2,22,14,8,2
AGUASCALIENTES,1,AGUASCALIENTES,001,SAN FELIPE [VIÑEDOS],4,332,175,157,14
AGUASCALIENTES,1,AGUASCALIENTES,001,SAN IGNACIO,6,926,452,474,37
AGUASCALIENTES,1,AGUASCALIENTES,001,SAN JOSÉ DE LA ORDEÑA,4,216,110,106,10
AGUASCALIENTES,1,AGUASCALIENTES,001,SAN MIGUEL,1,4,1,3,1
AGUASCALIENTES,1,AGUASCALIENTES,001,SAN NICOLÁS DE ARRIBA,3,49,27,22,5
AGUASCALIENTES,1,AGUASCALIENTES,001,SAN NICOLÁS DE EN MEDIO,2,48,20,28,3
AGUASCALIENTES,1,AGUASCALIENTES,001,SAN PEDRO CIENEGUILLA,3,126,58,68,6
AGUASCALIENTES,1,AGUASCALIENTES,001,SANTA CRUZ DE LA PRESA (LA TLACUACHA),2,52,22,30,3
AGUASCALIENTES,1,AGUASCALIENTES,001,SANTA MARÍA DE GALLARDO,2,212,107,105,8
AGUASCALIENTES,1,AGUASCALIENTES,001,SOLEDAD DE ABAJO,3,66,31,35,4
AGUASCALIENTES,1,AGUASCALIENTES,001,TANQUE EL TRIGO,3,81,36,45,4
AGUASCALIENTES,1,AGUASCALIENTES,001,VENUSTIANO CARRANZA [EJIDO],1,2,1,1,1
AGUASCALIENTES,1,AGUASCALIENTES,001,VILLA LICENCIADO JESÚS TERÁN (CALVILLITO),7,1606,776,830,85
AGUASCALIENTES,1,ASIENTOS,002,AMARILLAS DE ESPARZA,4,268,143,125,12
AGUASCALIENTES,1,ASIENTOS,002,ASIENTOS,6,1720,893,827,68
AGUASCALIENTES,1,ASIENTOS,002,BIMBALETES AGUASCALIENTES (EL ÁLAMO),4,540,263,277,21
AGUASCALIENTES,1,ASIENTOS,002,BIMBALETES ATLAS (TANQUE DE LA VIEJA),2,220,109,111,9
AGUASCALIENTES,1,ASIENTOS,002,CALDERA,1,76,38,38,3
AGUASCALIENTES,1,ASIENTOS,002,CHARCO AZUL,2,57,27,30,2
AGUASCALIENTES,1,ASIENTOS,002,CIÉNEGA GRANDE,5,1320,660,660,59
AGUASCALIENTES,1,ASIENTOS,002,CLAVELLINAS,3,125,65,60,6
AGUASCALIENTES,1,ASIENTOS,002,CRISÓSTOMOS,2,182,91,91,6
AGUASCALIENTES,1,ASIENTOS,002,EL EPAZOTE,2,59,32,27,3
AGUASCALIENTES,1,ASIENTOS,002,EL MUERTO,3,15,9,6,2
AGUASCALIENTES,1,ASIENTOS,002,EL POLVO,4,303,146,157,14
AGUASCALIENTES,1,ASIENTOS,002,EL SALITRE,2,67,34,33,3
AGUASCALIENTES,1,ASIENTOS,002,EL TEPETATILLO [RANCHO],2,11,6,5,2
AGUASCALIENTES,1,ASIENTOS,002,EL TULE,3,298,147,151,12
AGUASCALIENTES,1,ASIENTOS,002,EMANCIPACIÓN (BORUNDA) [COLONIA],4,215,114,101,11
AGUASCALIENTES,1,ASIENTOS,002,FRANCISCO VILLA,4,241,109,132,11
AGUASCALIENTES,1,ASIENTOS,002,GÓMEZ PORTUGAL [COLONIA],1,11,6,5,1
AGUASCALIENTES,1,ASIENTOS,002,GORRIONES,4,203,101,102,9
AGUASCALIENTES,1,ASIENTOS,002,GUADALUPE DE ATLAS,4,966,498,468,35
AGUASCALIENTES,1,ASIENTOS,002,JARILLAS,4,380,173,207,16
AGUASCALIENTES,1,ASIENTOS,002,JILOTEPEC,4,277,131,146,14
AGUASCALIENTES,1,ASIENTOS,002,LA DICHOSA,4,321,170,151,14
AGUASCALIENTES,1,ASIENTOS,002,LA ESPERANZA,2,61,36,25,3
AGUASCALIENTES,1,ASIENTOS,002,LA GLORIA,4,176,94,82,9
AGUASCALIENTES,1,ASIENTOS,002,LA TINAJUELA,2,31,12,19,3
AGUASCALIENTES,1,ASIENTOS,002,LAS ADJUNTAS,4,144,63,81,9
AGUASCALIENTES,1,ASIENTOS,002,LAS FRAGUAS,4,390,180,210,23
AGUASCALIENTES,1,ASIENTOS,002,LAS NEGRITAS,4,177,98,79,9
AGUASCALIENTES,1,ASIENTOS,002,LÁZARO CÁRDENAS,2,319,155,164,13
AGUASCALIENTES,1,ASIENTOS,002,LICENCIADO ADOLFO LÓPEZ MATEOS,4,444,250,194,20
AGUASCALIENTES,1,ASIENTOS,002,MOLINOS,4,365,208,157,15
AGUASCALIENTES,1,ASIENTOS,002,NORIA DEL BORREGO (NORIAS),4,485,237,248,19
AGUASCALIENTES,1,ASIENTOS,002,OJO DE AGUA DE LOS SAUCES,2,78,37,41,5
AGUASCALIENTES,1,ASIENTOS,002,OJO DE AGUA DE ROSALES,2,109,59,50,5
AGUASCALIENTES,1,ASIENTOS,002,PILOTOS,4,394,201,193,17
AGUASCALIENTES,1,ASIENTOS,002,PINO SUÁREZ (RANCHO VIEJO),3,99,45,54,4
AGUASCALIENTES,1,ASIENTOS,002,PLUTARCO ELÍAS CALLES,3,291,131,160,11
AGUASCALIENTES,1,ASIENTOS,002,SAN ANTONIO DE LOS MARTÍNEZ,2,32,19,13,2
AGUASCALIENTES,1,ASIENTOS,002,SAN GIL,2,138,59,79,5
AGUASCALIENTES,1,ASIENTOS,002,SAN JOSÉ DEL RÍO,3,297,137,160,13
AGUASCALIENTES,1,ASIENTOS,002,SAN PEDRO [COLONIA],2,17,7,10,2
AGUASCALIENTES,1,ASIENTOS,002,SAN RAFAEL DE OCAMPO,4,276,126,150,16
AGUASCALIENTES,1,ASIENTOS,002,SAN VICENTE,3,95,39,56,4
AGUASCALIENTES,1,ASIENTOS,002,TANQUE DE GUADALUPE,2,70,31,39,3
AGUASCALIENTES,1,ASIENTOS,002,TANQUE VIEJO,2,88,42,46,4
AGUASCALIENTES,1,ASIENTOS,002,VILLA JUÁREZ,7,2357,1256,1101,121
AGUASCALIENTES,1,ASIENTOS,002,VIUDAS DE PONIENTE,3,126,61,65,5
AGUASCALIENTES,1,CALVILLO,003,BARRANCA DE PORTALES,2,48,26,22,3
AGUASCALIENTES,1,CALVILLO,003,CALVILLO,27,6729,3503,3226,410
AGUASCALIENTES,1,CALVILLO,003,CERRO BLANCO,3,8,2,6,2
AGUASCALIENTES,1,CALVILLO,003,CHIQUIHUITERO (SAN ISIDRO),4,425,220,205,19
AGUASCALIENTES,1,CALVILLO,003,COLOMOS,2,64,35,29,4
AGUASCALIENTES,1,CALVILLO,003,CRUCERO LAS PILAS,3,267,123,144,11
AGUASCALIENTES,1,CALVILLO,003,EL CUERVERO (CUERVEROS),4,486,249,237,21
AGUASCALIENTES,1,CALVILLO,003,EL MAGUEY,3,34,20,14,3
AGUASCALIENTES,1,CALVILLO,003,EL MORANCILLO (LOS ARCOS),1,45,27,18,2
AGUASCALIENTES,1,CALVILLO,003,EL RODEO,2,105,57,48,4
AGUASCALIENTES,1,CALVILLO,003,EL SALITRE,5,654,359,295,41
AGUASCALIENTES,1,CALVILLO,003,EL SAUZ,2,30,15,15,2
AGUASCALIENTES,1,CALVILLO,003,EL SAUZ DE LA LABOR,2,15,5,10,2
AGUASCALIENTES,1,CALVILLO,003,EL TEPETATE DE ABAJO,2,7,4,3,2
AGUASCALIENTES,1,CALVILLO,003,EL TERRERO DE LA LABOR,3,69,30,39,4
AGUASCALIENTES,1,CALVILLO,003,EL TERRERO DEL REFUGIO,2,29,17,12,2
AGUASCALIENTES,1,CALVILLO,003,EL ZAPOTE DE LA LABOR,3,31,18,13,3
AGUASCALIENTES,1,CALVILLO,003,JALTICHE DE ABAJO,3,48,26,22,3
AGUASCALIENTES,1,CALVILLO,003,JALTICHE DE ARRIBA,3,174,83,91,8
AGUASCALIENTES,1,CALVILLO,003,JARDINES DE SAN ISIDRO (COLONIA LIMÓN),1,81,35,46,3
AGUASCALIENTES,1,CALVILLO,003,LA FRAGUA,2,26,13,13,3
AGUASCALIENTES,1,CALVILLO,003,LA LABOR,4,589,294,295,36
AGUASCALIENTES,1,CALVILLO,003,LA MEDIA LUNA,2,81,37,44,4
AGUASCALIENTES,1,CALVILLO,003,LA PANADERA,5,357,160,197,16
AGUASCALIENTES,1,CALVILLO,003,LA RINCONADA,4,131,65,66,7
AGUASCALIENTES,1,CALVILLO,003,LA TERESA,1,9,4,5,1
AGUASCALIENTES,1,CALVILLO,003,LAS ÁNIMAS,2,59,27,32,3
AGUASCALIENTES,1,CALVILLO,003,LAS TINAJAS,2,23,13,10,2
AGUASCALIENTES,1,CALVILLO,003,LOS MUÑOZ,2,8,3,5,1
AGUASCALIENTES,1,CALVILLO,003,LOS PATOS,4,168,90,78,9
AGUASCALIENTES,1,CALVILLO,003,MALPASO,3,251,118,133,22
AGUASCALIENTES,1,CALVILLO,003,MESA DEL MÁRQUEZ,2,18,9,9,2
AGUASCALIENTES,1,CALVILLO,003,MESA DEL ROBLE,2,16,8,8,2
AGUASCALIENTES,1,CALVILLO,003,MESA GRANDE,4,341,171,170,16
AGUASCALIENTES,1,CALVILLO,003,OJO DE AGUA,4,240,123,117,18
AGUASCALIENTES,1,CALVILLO,003,OJOCALIENTE,11,1628,797,831,76
AGUASCALIENTES,1,CALVILLO,003,PIEDRAS CHINAS,2,19,5,14,2
AGUASCALIENTES,1,CALVILLO,003,POTRERO DE LOS LÓPEZ,1,6,3,3,1
AGUASCALIENTES,1,CALVILLO,003,PRESA DE LOS SERNA,3,113,59,54,6
AGUASCALIENTES,1,CALVILLO,003,PUERTA DE FRAGUA (PRESA LA CODORNIZ),2,40,21,19,2
AGUASCALIENTES,1,CALVILLO,003,SAN TADEO,5,478,229,249,20
AGUASCALIENTES,1,CALVILLO,003,SOLIDARIDAD [FRACCIONAMIENTO],1,13,6,7,1
AGUASCALIENTES,1,CALVILLO,003,TEMAZCAL,2,31,23,8,3
AGUASCALIENTES,1,COSÍO,004,COSÍO,7,1815,934,881,120
AGUASCALIENTES,1,COSÍO,004,EL DURAZNO,2,45,21,24,2
AGUASCALIENTES,1,COSÍO,004,EL REFUGIO DE AGUA ZARCA,4,262,133,129,11
AGUASCALIENTES,1,COSÍO,004,EL REFUGIO DE PROVIDENCIA (PROVIDENCIA),4,443,197,246,18
AGUASCALIENTES,1,COSÍO,004,EL SALERO,4,426,213,213,16
AGUASCALIENTES,1,COSÍO,004,GUADALUPITO,1,5,3,2,1
AGUASCALIENTES,1,COSÍO,004,LA PUNTA,5,907,478,429,43
AGUASCALIENTES,1,COSÍO,004,SANTA MARÍA DE LA PAZ,4,349,175,174,19
AGUASCALIENTES,1,COSÍO,004,SOLEDAD DE ABAJO [ESTACIÓN DE ADAMES],4,208,111,97,11
AGUASCALIENTES,1,COSÍO,004,SOLEDAD DE ARRIBA,1,67,24,43,3
AGUASCALIENTES,1,COSÍO,004,ZACATEQUILLAS,3,246,123,123,11
AGUASCALIENTES,1,JESÚS MARÍA,005,ARBOLEDAS PASO BLANCO [FRACCIONAMIENTO],3,144,66,78,31
AGUASCALIENTES,1,JESÚS MARÍA,005,BROWNSVILLE,1,23,12,11,1
AGUASCALIENTES,1,JESÚS MARÍA,005,CAÑADA EL RODEO,3,74,43,31,5
AGUASCALIENTES,1,JESÚS MARÍA,005,CORRAL DE BARRANCOS,10,938,452,486,40
AGUASCALIENTES,1,JESÚS MARÍA,005,EJIDO LA GUAYANA (RANCHO SECO),4,336,164,172,14
AGUASCALIENTES,1,JESÚS MARÍA,005,EL AURERO,1,59,25,34,2
AGUASCALIENTES,1,JESÚS MARÍA,005,EL CENIZO,2,83,34,49,4
AGUASCALIENTES,1,JESÚS MARÍA,005,EL CHICHIMECO,2,399,202,197,12
AGUASCALIENTES,1,JESÚS MARÍA,005,EL LLANO,10,8646,4891,3755,572
AGUASCALIENTES,1,JESÚS MARÍA,005,EL REFUGIO,2,231,96,135,9
AGUASCALIENTES,1,JESÚS MARÍA,005,EX-HACIENDA DE MILPILLAS,3,124,75,49,7
AGUASCALIENTES,1,JESÚS MARÍA,005,GENERAL IGNACIO ZARAGOZA (VENADERO),4,698,327,371,34
AGUASCALIENTES,1,JESÚS MARÍA,005,GRACIAS A DIOS,3,102,52,50,5
AGUASCALIENTES,1,JESÚS MARÍA,005,JESÚS GÓMEZ PORTUGAL (MARGARITAS),12,2354,1186,1168,116
AGUASCALIENTES,1,JESÚS MARÍA,005,JESÚS MARÍA,88,19437,9655,9782,1078
AGUASCALIENTES,1,JESÚS MARÍA,005,JESÚS MARÍA [EJIDO],2,110,49,61,7
AGUASCALIENTES,1,JESÚS MARÍA,005,LA FLORIDA,4,185,87,98,7
AGUASCALIENTES,1,JESÚS MARÍA,005,LA LOMA DE VALLADOLID,3,162,70,92,7
AGUASCALIENTES,1,JESÚS MARÍA,005,LA PRIMAVERA,1,12,6,6,1
AGUASCALIENTES,1,JESÚS MARÍA,005,LA TOMATINA,4,341,166,175,15
AGUASCALIENTES,1,JESÚS MARÍA,005,LAS JAULAS,2,169,80,89,8
AGUASCALIENTES,1,JESÚS MARÍA,005,LOS ARENALES,3,103,41,62,17
AGUASCALIENTES,1,JESÚS MARÍA,005,LOS ARQUITOS,4,478,231,247,19
AGUASCALIENTES,1,JESÚS MARÍA,005,LOS RAMÍREZ,2,187,87,100,8
AGUASCALIENTES,1,JESÚS MARÍA,005,LOS VÁZQUEZ,4,466,239,227,17
AGUASCALIENTES,1,JESÚS MARÍA,005,MARAVILLAS,5,1118,591,527,59
AGUASCALIENTES,1,JESÚS MARÍA,005,MILPILLAS DE ABAJO,1,16,5,11,1
AGUASCALIENTES,1,JESÚS MARÍA,005,MIRAVALLE,3,298,134,164,11
AGUASCALIENTES,1,JESÚS MARÍA,005,PASEOS DE LAS HACIENDAS [FRACCIONAMIENTO],4,292,141,151,12
AGUASCALIENTES,1,JESÚS MARÍA,005,PASO BLANCO,8,903,430,473,52
AGUASCALIENTES,1,JESÚS MARÍA,005,PEDERNAL PRIMERO,3,170,79,91,7
AGUASCALIENTES,1,JESÚS MARÍA,005,SAN ANTONIO DE LOS HORCONES,4,369,168,201,16
AGUASCALIENTES,1,JESÚS MARÍA,005,SAN ISIDRO,1,22,12,10,1
AGUASCALIENTES,1,JESÚS MARÍA,005,TANQUE LA VIZNAGA,1,27,16,11,2
AGUASCALIENTES,1,JESÚS MARÍA,005,TAPIAS VIEJAS,4,219,89,130,11
AGUASCALIENTES,1,JESÚS MARÍA,005,TEPETATES,2,291,137,154,10
AGUASCALIENTES,1,JESÚS MARÍA,005,VALLADOLID,4,580,276,304,27
AGUASCALIENTES,1,PABELLÓN DE ARTEAGA,006,COLONIA NUEVA,2,65,39,26,3
AGUASCALIENTES,1,PABELLÓN DE ARTEAGA,006,EJIDO EL MEZQUITE (OJO DE AGUA DEL MEZQUITE),3,117,58,59,5
AGUASCALIENTES,1,PABELLÓN DE ARTEAGA,006,EJIDO OJO ZARCO (LA LOMA),3,191,95,96,6
AGUASCALIENTES,1,PABELLÓN DE ARTEAGA,006,EL GARABATO,3,133,82,51,5
AGUASCALIENTES,1,PABELLÓN DE ARTEAGA,006,EL MEZQUITE [COLONIA],2,19,9,10,2
AGUASCALIENTES,1,PABELLÓN DE ARTEAGA,006,EL MEZQUITE [HACIENDA],1,26,15,11,1
AGUASCALIENTES,1,PABELLÓN DE ARTEAGA,006,EL PEDREGAL,1,9,7,2,1
AGUASCALIENTES,1,PABELLÓN DE ARTEAGA,006,EMILIANO ZAPATA,6,959,479,480,35
AGUASCALIENTES,1,PABELLÓN DE ARTEAGA,006,GÁMEZ OROZCO (PUERTA DE CARBONERAS) [COLONIA],2,30,18,12,2
AGUASCALIENTES,1,PABELLÓN DE ARTEAGA,006,LADRILLERAS UNIDAS,2,22,10,12,2
AGUASCALIENTES,1,PABELLÓN DE ARTEAGA,006,LAS ÁNIMAS,4,601,314,287,24
AGUASCALIENTES,1,PABELLÓN DE ARTEAGA,006,LOS LIRA,2,37,19,18,2
AGUASCALIENTES,1,PABELLÓN DE ARTEAGA,006,MIGUEL ALEMÁN [SECADORA],2,30,17,13,2
AGUASCALIENTES,1,PABELLÓN DE ARTEAGA,006,OJO ZARCO [COLONIA],4,263,139,124,12
AGUASCALIENTES,1,PABELLÓN DE ARTEAGA,006,PABELLÓN DE ARTEAGA,40,9788,4788,5000,580
AGUASCALIENTES,1,PABELLÓN DE ARTEAGA,006,SAN AGUSTÍN DE LOS PUENTES,1,15,8,7,1
AGUASCALIENTES,1,PABELLÓN DE ARTEAGA,006,SAN LUIS DE LETRAS,4,312,141,171,14
AGUASCALIENTES,1,PABELLÓN DE ARTEAGA,006,SANTIAGO,3,311,165,146,11
AGUASCALIENTES,1,RINCÓN DE ROMOS,007,16 DE SEPTIEMBRE,3,98,44,54,5
AGUASCALIENTES,1,RINCÓN DE ROMOS,007,CALIFORNIA,4,440,228,212,18
AGUASCALIENTES,1,RINCÓN DE ROMOS,007,EL AJILADERO,3,23,4,19,3
AGUASCALIENTES,1,RINCÓN DE ROMOS,007,EL BAJÍO,2,289,144,145,9
AGUASCALIENTES,1,RINCÓN DE ROMOS,007,EL MILAGRO,3,124,61,63,6
AGUASCALIENTES,1,RINCÓN DE ROMOS,007,EL SALITRILLO,2,44,25,19,2
AGUASCALIENTES,1,RINCÓN DE ROMOS,007,EL SAUCILLO,4,307,154,153,15
AGUASCALIENTES,1,RINCÓN DE ROMOS,007,EL VALLE DE LAS DELICIAS,3,196,91,105,7
AGUASCALIENTES,1,RINCÓN DE ROMOS,007,ESTANCIA DE MOSQUEIRA,2,75,40,35,3
AGUASCALIENTES,1,RINCÓN DE ROMOS,007,FRESNILLO,1,26,16,10,1
AGUASCALIENTES,1,RINCÓN DE ROMOS,007,LA BOQUILLA,4,278,135,143,17
AGUASCALIENTES,1,RINCÓN DE ROMOS,007,LAS CAMAS,2,6,1,5,1
AGUASCALIENTES,1,RINCÓN DE ROMOS,007,MAR NEGRO,3,180,79,101,7
AGUASCALIENTES,1,RINCÓN DE ROMOS,007,MORELOS,4,307,156,151,13
AGUASCALIENTES,1,RINCÓN DE ROMOS,007,PABELLÓN DE HIDALGO,7,1241,598,643,57
AGUASCALIENTES,1,RINCÓN DE ROMOS,007,PABELLÓN DE HIDALGO [EJIDO EX-HACIENDA],2,26,14,12,3
AGUASCALIENTES,1,RINCÓN DE ROMOS,007,PABLO ESCALERAS,7,1043,537,506,40
AGUASCALIENTES,1,RINCÓN DE ROMOS,007,PUERTA DEL MUERTO (EL 15),2,139,76,63,5
AGUASCALIENTES,1,RINCÓN DE ROMOS,007,RINCÓN DE ROMOS,49,13157,6711,6446,847
AGUASCALIENTES,1,RINCÓN DE ROMOS,007,RINCÓN DE ROMOS [ESTACIÓN],2,31,16,15,2
AGUASCALIENTES,1,RINCÓN DE ROMOS,007,SAN JACINTO,4,782,391,391,40
AGUASCALIENTES,1,RINCÓN DE ROMOS,007,SAN JUAN DE LA NATURA,3,191,84,107,8
AGUASCALIENTES,1,RINCÓN DE ROMOS,007,TÚNEL DE POTRERILLO,1,10,7,3,1
AGUASCALIENTES,1,SAN JOSÉ DE GRACIA,008,BOCA DEL TÚNEL DE POTRERILLO,2,13,7,6,2
AGUASCALIENTES,1,SAN JOSÉ DE GRACIA,008,EL TECONGO,3,39,17,22,4
AGUASCALIENTES,1,SAN JOSÉ DE GRACIA,008,LA CONGOJA,4,138,74,64,8
AGUASCALIENTES,1,SAN JOSÉ DE GRACIA,008,PAREDES,4,351,175,176,18
AGUASCALIENTES,1,SAN JOSÉ DE GRACIA,008,POTRERO DE LOS LÓPEZ,2,13,8,5,1
AGUASCALIENTES,1,SAN JOSÉ DE GRACIA,008,RANCHO VIEJO,3,47,28,19,3
AGUASCALIENTES,1,SAN JOSÉ DE GRACIA,008,SAN ANTONIO DE LOS RÍOS,4,329,167,162,14
AGUASCALIENTES,1,SAN JOSÉ DE GRACIA,008,SAN JOSÉ DE GRACIA,11,1935,1008,927,90
AGUASCALIENTES,1,SAN JOSÉ DE GRACIA,008,SANTA ELENA DE LA CRUZ (CAPADERO),2,27,10,17,3
AGUASCALIENTES,1,SAN JOSÉ DE GRACIA,008,TÚNEL DE POTRERILLO,3,129,69,60,7
AGUASCALIENTES,1,TEPEZALÁ,009,AMPLIACIÓN LOS HORNOS (EL LAGUNAZO) [COLONIA],2,29,15,14,2
AGUASCALIENTES,1,TEPEZALÁ,009,ARROYO HONDO,3,133,59,74,5
AGUASCALIENTES,1,TEPEZALÁ,009,CALDERA,4,332,183,149,13
AGUASCALIENTES,1,TEPEZALÁ,009,CARBONERAS,4,450,220,230,23
AGUASCALIENTES,1,TEPEZALÁ,009,EL ÁGUILA,3,77,39,38,4
AGUASCALIENTES,1,TEPEZALÁ,009,EL BARRANCO,2,35,17,18,2
AGUASCALIENTES,1,TEPEZALÁ,009,EL CARMEN,2,59,27,32,3
AGUASCALIENTES,1,TEPEZALÁ,009,EL CHAYOTE,4,708,380,328,37
AGUASCALIENTES,1,TEPEZALÁ,009,EL GIGANTE,4,227,120,107,10
AGUASCALIENTES,1,TEPEZALÁ,009,EL PORVENIR,4,208,101,107,10
AGUASCALIENTES,1,TEPEZALÁ,009,EL REFUGIO,3,139,54,85,6
AGUASCALIENTES,1,TEPEZALÁ,009,EL TEPOZÁN,4,259,147,112,13
AGUASCALIENTES,1,TEPEZALÁ,009,LA VICTORIA,3,186,88,98,8
AGUASCALIENTES,1,TEPEZALÁ,009,LOS ALAMITOS,4,370,185,185,18
AGUASCALIENTES,1,TEPEZALÁ,009,MESILLAS,4,214,115,99,10
AGUASCALIENTES,1,TEPEZALÁ,009,OJO DE AGUA DE LOS MONTES,4,298,141,157,13
AGUASCALIENTES,1,TEPEZALÁ,009,PUERTO DE LA CONCEPCIÓN,4,150,72,78,8
AGUASCALIENTES,1,TEPEZALÁ,009,SAN ANTONIO,5,1378,718,660,56
AGUASCALIENTES,1,TEPEZALÁ,009,TEPEZALÁ,7,1485,721,764,80
AGUASCALIENTES,1,EL LLANO,010,EL COPETILLO,2,14,8,6,2
AGUASCALIENTES,1,EL LLANO,010,EL COPETILLO (EL MOQUETE),2,38,22,16,2
AGUASCALIENTES,1,EL LLANO,010,EL MILAGRO,2,19,12,7,2
AGUASCALIENTES,1,EL LLANO,010,EL NOVILLO,4,260,118,142,13
AGUASCALIENTES,1,EL LLANO,010,EL PUERTECITO,2,37,14,23,2
AGUASCALIENTES,1,EL LLANO,010,EL RETOÑO,4,1276,577,699,127
AGUASCALIENTES,1,EL LLANO,010,EL TERREMOTO,3,94,44,50,8
AGUASCALIENTES,1,EL LLANO,010,EL TILDÍO,4,223,116,107,11
AGUASCALIENTES,1,EL LLANO,010,FRANCISCO SARABIA (LA REFORMA),3,201,103,98,8
AGUASCALIENTES,1,EL LLANO,010,LA FRONTERA,3,33,15,18,3
AGUASCALIENTES,1,EL LLANO,010,LA LUCITA,1,18,10,8,2
AGUASCALIENTES,1,EL LLANO,010,LA LUZ,4,201,100,101,10
AGUASCALIENTES,1,EL LLANO,010,LA TINAJA,4,211,114,97,10
AGUASCALIENTES,1,EL LLANO,010,LA UNIÓN (LA PAZ),4,81,34,47,4
AGUASCALIENTES,1,EL LLANO,010,LICENCIADO JESÚS TERÁN (EL MUERTO),4,358,163,195,15
AGUASCALIENTES,1,EL LLANO,010,LOMAS DEL REFUGIO (LA LOMA),4,429,217,212,16
AGUASCALIENTES,1,EL LLANO,010,LOS CONOS,2,185,84,101,8
AGUASCALIENTES,1,EL LLANO,010,MONTOYA,3,209,106,103,10
AGUASCALIENTES,1,EL LLANO,010,OJO DE AGUA DE CRUCITAS,4,358,183,175,16
AGUASCALIENTES,1,EL LLANO,010,PALO ALTO,9,3223,1618,1605,212
AGUASCALIENTES,1,EL LLANO,010,SAN FRANCISCO DE LOS VIVEROS,4,256,139,117,11
AGUASCALIENTES,1,EL LLANO,010,SAN GERÓNIMO,3,37,23,14,3
AGUASCALIENTES,1,EL LLANO,010,SANDOVALES (SAN MIGUEL DE LOS SANDOVALES),2,35,16,19,2
AGUASCALIENTES,1,EL LLANO,010,SANTA CLARA (LAS MIELERAS),2,101,64,37,4
AGUASCALIENTES,1,EL LLANO,010,SANTA ROSA (EL HUIZACHE),4,324,165,159,14
AGUASCALIENTES,1,EL LLANO,010,TANQUE EL COYOTE (EL COYOTE),1,4,2,2,1
AGUASCALIENTES,1,SAN FRANCISCO DE LOS ROMO,011,AMAPOLAS DEL RÍO,3,95,48,47,6
AGUASCALIENTES,1,SAN FRANCISCO DE LOS ROMO,011,BORROTES,3,94,40,54,5
AGUASCALIENTES,1,SAN FRANCISCO DE LOS ROMO,011,CHICALOTE [ESTACIÓN],2,57,17,40,3
AGUASCALIENTES,1,SAN FRANCISCO DE LOS ROMO,011,EJIDO RANCHO NUEVO,2,67,33,34,4
AGUASCALIENTES,1,SAN FRANCISCO DE LOS ROMO,011,EL CHAPARRAL,2,13,4,9,2
AGUASCALIENTES,1,SAN FRANCISCO DE LOS ROMO,011,EL TEPETATE,3,101,47,54,6
AGUASCALIENTES,1,SAN FRANCISCO DE LOS ROMO,011,EX-VIÑEDOS GUADALUPE,2,517,277,240,15
AGUASCALIENTES,1,SAN FRANCISCO DE LOS ROMO,011,LA CONCEPCIÓN,4,447,230,217,19
AGUASCALIENTES,1,SAN FRANCISCO DE LOS ROMO,011,LA ESCONDIDA (EL SALERO),6,847,427,420,30
AGUASCALIENTES,1,SAN FRANCISCO DE LOS ROMO,011,LA PROVIDENCIA,2,139,66,73,5
AGUASCALIENTES,1,SAN FRANCISCO DE LOS ROMO,011,LA RIBERA [FRACCIONAMIENTO],9,2460,1212,1248,123
AGUASCALIENTES,1,SAN FRANCISCO DE LOS ROMO,011,LORETITO (CHARCO DEL TORO),3,326,147,179,12
AGUASCALIENTES,1,SAN FRANCISCO DE LOS ROMO,011,MACARIO J. GÓMEZ [COLONIA],7,839,417,422,28
AGUASCALIENTES,1,SAN FRANCISCO DE LOS ROMO,011,MEDIO KILO,1,87,39,48,6
AGUASCALIENTES,1,SAN FRANCISCO DE LOS ROMO,011,PASEOS DE LA PROVIDENCIA [FRACCIONAMIENTO],4,777,367,410,92
AGUASCALIENTES,1,SAN FRANCISCO DE LOS ROMO,011,PUERTECITO DE LA VIRGEN,9,2125,1046,1079,77
AGUASCALIENTES,1,SAN FRANCISCO DE LOS ROMO,011,SAN FRANCISCO DE LOS ROMO,24,6875,3504,3371,396
AGUASCALIENTES,1,SAN FRANCISCO DE LOS ROMO,011,URBIVILLA DEL VERGEL [FRACCIONAMIENTO],4,970,493,477,32
AGUASCALIENTES,1,SAN FRANCISCO DE LOS ROMO,011,VIÑEDOS RIVIER,8,343,174,169,40
AGUASCALIENTES,1,ENCARNACIÓN DE DÍAZ,035,EL CODO,2,22,11,11,2
AGUASCALIENTES,1,LAGOS DE MORENO,053,SAN ANTONIO DE PADUA,2,45,22,23,3
AGUASCALIENTES,1,OJUELOS DE JALISCO,064,PEDREGAL DE SAN ÁNGEL,2,182,90,92,8
BAJA CALIFORNIA,2,ENSENADA,001,ALFREDO V. BONFIL,3,53,28,25,4
BAJA CALIFORNIA,2,ENSENADA,001,AMPLIACIÓN EL PORVENIR,2,4,2,2,1
BAJA CALIFORNIA,2,ENSENADA,001,ARROYO DE LEÓN (EJIDO KILIWAS),2,7,2,5,2
BAJA CALIFORNIA,2,ENSENADA,001,ARTÍCULO CIENTO QUINCE,4,289,134,155,14
BAJA CALIFORNIA,2,ENSENADA,001,COLINAS DEL PEDREGAL,1,4,2,2,1
BAJA CALIFORNIA,2,ENSENADA,001,COLONIA ESPERANZA (CAÑÓN SAN CARLOS),3,75,41,34,4
BAJA CALIFORNIA,2,ENSENADA,001,COLONIA GÓMEZ MORÍN,4,386,173,213,16
BAJA CALIFORNIA,2,ENSENADA,001,COLONIA MÉXICO [PARCELA NÚMERO DIEZ],2,6,2,4,2
BAJA CALIFORNIA,2,ENSENADA,001,COMUNIDAD INDÍGENA DE SANTA CATARINA,3,57,25,32,4
BAJA CALIFORNIA,2,ENSENADA,001,CORONEL ESTEBAN CANTÚ,3,201,110,91,10
BAJA CALIFORNIA,2,ENSENADA,001,DÍAZ [RANCHO],1,1191,652,539,94
BAJA CALIFORNIA,2,ENSENADA,001,EJIDO 27 DE ENERO,3,35,14,21,3
BAJA CALIFORNIA,2,ENSENADA,001,EJIDO BENITO JUÁREZ,3,38,18,20,3
BAJA CALIFORNIA,2,ENSENADA,001,EJIDO EL AJUSCO,6,267,121,146,15
BAJA CALIFORNIA,2,ENSENADA,001,EJIDO ERÉNDIRA,3,314,144,170,15
BAJA CALIFORNIA,2,ENSENADA,001,EJIDO FRANCISCO R. SERRANO (VALLE SAN MATÍAS),3,97,45,52,4
BAJA CALIFORNIA,2,ENSENADA,001,EJIDO IGNACIO LÓPEZ RAYÓN (LOS OLIVOS),2,5,2,3,2
BAJA CALIFORNIA,2,ENSENADA,001,EJIDO NACIONALISTA,1,49,21,28,2
BAJA CALIFORNIA,2,ENSENADA,001,EJIDO PUNTA COLNETT (PUNTA COLONET),9,916,464,452,45
BAJA CALIFORNIA,2,ENSENADA,001,EJIDO RODOLFO SÁNCHEZ TABOADA (EL CALVARIO),4,101,47,54,7
BAJA CALIFORNIA,2,ENSENADA,001,EJIDO SANTA ROSA,2,16,8,8,1
BAJA CALIFORNIA,2,ENSENADA,001,EL BARRIL (LA ROCA) [CENTRO DE REHABILITACIÓN],1,5,3,2,1
BAJA CALIFORNIA,2,ENSENADA,001,EL CHOYAL,3,13,5,8,3
BAJA CALIFORNIA,2,ENSENADA,001,EL CONSUELO,1,13,5,8,1
BAJA CALIFORNIA,2,ENSENADA,001,EL CORONEL,3,59,27,32,4
BAJA CALIFORNIA,2,ENSENADA,001,EL PORVENIR (GUADALUPE),4,777,410,367,49
BAJA CALIFORNIA,2,ENSENADA,001,EL REFUGIO,3,8,4,4,3
BAJA CALIFORNIA,2,ENSENADA,001,EL RINCÓN DEL VELADERO,3,48,22,26,3
BAJA CALIFORNIA,2,ENSENADA,001,EL SALITRAL,2,125,61,64,5
BAJA CALIFORNIA,2,ENSENADA,001,EL SAUZAL DE RODRÍGUEZ,13,3322,1630,1692,272
BAJA CALIFORNIA,2,ENSENADA,001,EL TULE,3,44,27,17,2
BAJA CALIFORNIA,2,ENSENADA,001,EL VELADERO (EJIDO NACIONALISTA),3,73,32,41,3
BAJA CALIFORNIA,2,ENSENADA,001,EL VERGELITO,2,63,24,39,2
BAJA CALIFORNIA,2,ENSENADA,001,ENSENADA,407,89939,46099,43840,6607
BAJA CALIFORNIA,2,ENSENADA,001,ESCORPIÓN [CENTRO RECREATIVO],3,345,157,188,16
BAJA CALIFORNIA,2,ENSENADA,001,FAMILIA HIRATA,1,127,75,52,6
BAJA CALIFORNIA,2,ENSENADA,001,FRANCISCO ZARCO (VALLE DE GUADALUPE),5,870,447,423,39
BAJA CALIFORNIA,2,ENSENADA,001,HACIENDA SAN CARLOS,1,2,0,2,1
BAJA CALIFORNIA,2,ENSENADA,001,HÉROES DE LA INDEPENDENCIA (LLANO COLORADO),3,158,86,72,11
BAJA CALIFORNIA,2,ENSENADA,001,IGNACIO ZARAGOZA,3,32,13,19,2
BAJA CALIFORNIA,2,ENSENADA,001,ISLA DE CEDROS,6,424,214,210,44
BAJA CALIFORNIA,2,ENSENADA,001,LA ESCONDIDA,2,82,39,43,3
BAJA CALIFORNIA,2,ENSENADA,001,LA HUERTA,2,55,29,26,3
BAJA CALIFORNIA,2,ENSENADA,001,LA HUERTA (EJIDO NACIONALISTA),1,65,32,33,3
BAJA CALIFORNIA,2,ENSENADA,001,LA MISIÓN,4,604,305,299,27
BAJA CALIFORNIA,2,ENSENADA,001,LA PROVIDENCIA,3,532,264,268,21
BAJA CALIFORNIA,2,ENSENADA,001,LAS BRISAS,4,205,108,97,12
BAJA CALIFORNIA,2,ENSENADA,001,LAS DELICIAS (FAMILIA BAÑAGAS),1,3,0,3,1
BAJA CALIFORNIA,2,ENSENADA,001,LÁZARO CÁRDENAS (VALLE DE LA TRINIDAD),4,572,272,300,24
BAJA CALIFORNIA,2,ENSENADA,001,LEYES DE REFORMA (EL RODEO),1,20,5,15,1
BAJA CALIFORNIA,2,ENSENADA,001,LICENCIADO GUSTAVO DÍAZ ORDAZ,3,429,201,228,13
BAJA CALIFORNIA,2,ENSENADA,001,LOS ARBOLITOS,2,347,156,191,14
BAJA CALIFORNIA,2,ENSENADA,001,LOS PINOS,1,64,30,34,2
BAJA CALIFORNIA,2,ENSENADA,001,NUEVO CENTRO DE POBLACIÓN EJIDAL EL PÍPILA,2,31,18,13,2
BAJA CALIFORNIA,2,ENSENADA,001,OJO DE AGUA,2,171,84,87,8
BAJA CALIFORNIA,2,ENSENADA,001,PARCELA NÚMERO CIENTO OCHENTA Y SIETE (EJIDO NACIONALISTA),1,34,15,19,2
BAJA CALIFORNIA,2,ENSENADA,001,PARCELA NÚMERO DOSCIENTOS TREINTA Y UNO (RANCHO EL REFUGIO DEL VIEJO),3,235,111,124,9
BAJA CALIFORNIA,2,ENSENADA,001,POBLADO HÉROES DE CHAPULTEPEC,2,273,151,122,11
BAJA CALIFORNIA,2,ENSENADA,001,POBLADO PUERTA TRAMPA,3,66,34,32,4
BAJA CALIFORNIA,2,ENSENADA,001,POCITOS (VALLE DE LA TRINIDAD),2,384,194,190,17
BAJA CALIFORNIA,2,ENSENADA,001,PUNTA CLARA,2,14,9,5,2
BAJA CALIFORNIA,2,ENSENADA,001,RANCHO BELLAVISTA,2,42,20,22,2
BAJA CALIFORNIA,2,ENSENADA,001,RANCHO CAÑÓN BUENA VISTA (EL ZORRILLO),11,1961,981,980,83
BAJA CALIFORNIA,2,ENSENADA,001,RANCHO LLAMAS,1,4,2,2,1
BAJA CALIFORNIA,2,ENSENADA,001,REAL DEL CASTILLO NUEVO (OJOS NEGROS),6,906,438,468,42
BAJA CALIFORNIA,2,ENSENADA,001,REAL DEL CASTILLO VIEJO,2,181,99,82,8
BAJA CALIFORNIA,2,ENSENADA,001,RODOLFO SÁNCHEZ TABOADA (MANEADERO),41,7710,3839,3871,344
BAJA CALIFORNIA,2,ENSENADA,001,SAN ANTONIO NECUA (CAÑADA DE LOS ENCINOS),4,65,31,34,6
BAJA CALIFORNIA,2,ENSENADA,001,SAN CARLOS (EJIDO NACIONALISTA),3,306,155,151,11
BAJA CALIFORNIA,2,ENSENADA,001,SAN FRANCISCO,1,12,6,6,1
BAJA CALIFORNIA,2,ENSENADA,001,SAN JOSÉ DE LA ZORRA,2,29,15,14,3
BAJA CALIFORNIA,2,ENSENADA,001,SAN MARCOS,2,44,19,25,3
BAJA CALIFORNIA,2,ENSENADA,001,SAN MIGUEL,1,22,9,13,1
BAJA CALIFORNIA,2,ENSENADA,001,SAN VICENTE,5,1130,556,574,54
BAJA CALIFORNIA,2,ENSENADA,001,SANTA JUQUILA [COLONIA],4,165,88,77,7
BAJA CALIFORNIA,2,ENSENADA,001,SANTA MARTHA,4,243,122,121,27
BAJA CALIFORNIA,2,ENSENADA,001,SANTO TOMÁS,1,59,32,27,3
BAJA CALIFORNIA,2,ENSENADA,001,URUAPAN,3,277,144,133,18
BAJA CALIFORNIA,2,ENSENADA,001,VILLA DE JUÁREZ (SAN ANTONIO DE LAS MINAS),5,410,188,222,20
BAJA CALIFORNIA,2,ENSENADA,001,VILLANUEVA MIXTECA,1,4,1,3,1
BAJA CALIFORNIA,2,MEXICALI,002,BENITO JUÁREZ (EJIDO TECOLOTES),6,966,473,493,77
BAJA CALIFORNIA,2,MEXICALI,002,CAMPO DIECINUEVE (EJIDO MORELOS COLONIA EL SUSPIRO),1,75,33,42,2
BAJA CALIFORNIA,2,MEXICALI,002,CAMPO LA CURVA (COLONIA SILVA),1,47,23,24,2
BAJA CALIFORNIA,2,MEXICALI,002,CAMPO LEÓN NÚMERO UNO (ESCUADRÓN DOSCIENTOS UNO),1,47,19,28,3
BAJA CALIFORNIA,2,MEXICALI,002,CENTINELA TERCERA SECCIÓN,2,22,6,16,3
BAJA CALIFORNIA,2,MEXICALI,002,CIUDAD COAHUILA (KILÓMETRO CINCUENTA Y SIETE),10,1535,735,800,86
BAJA CALIFORNIA,2,MEXICALI,002,CIUDAD GUADALUPE VICTORIA (KILÓMETRO CUARENTA Y TRES),26,5882,2947,2935,440
BAJA CALIFORNIA,2,MEXICALI,002,CIUDAD MORELOS (CUERVOS),14,2996,1565,1431,181
BAJA CALIFORNIA,2,MEXICALI,002,COLONIA 4 CERRO PRIETO (RANCHO EL ROA),1,198,100,98,13
BAJA CALIFORNIA,2,MEXICALI,002,COLONIA 5 DE MAYO,2,70,31,39,5
BAJA CALIFORNIA,2,MEXICALI,002,COLONIA AGRÍCOLA BENITO JUÁREZ,5,1063,567,496,145
BAJA CALIFORNIA,2,MEXICALI,002,COLONIA BÓRQUEZ NORTE (LA CANALETA),1,19,10,9,1
BAJA CALIFORNIA,2,MEXICALI,002,COLONIA CALLES,4,2879,1523,1356,81
BAJA CALIFORNIA,2,MEXICALI,002,COLONIA CASTRO,1,22,5,17,1
BAJA CALIFORNIA,2,MEXICALI,002,COLONIA FRANCISCO SANTANA PERALTA,2,126,64,62,7
BAJA CALIFORNIA,2,MEXICALI,002,COLONIA HIDALGO (GONZÁLEZ ORTEGA DOS),1,8,0,8,1
BAJA CALIFORNIA,2,MEXICALI,002,COLONIA JOSÉ MARÍA RODRÍGUEZ MÉRIDA (LA PANGA),2,58,33,25,4
BAJA CALIFORNIA,2,MEXICALI,002,COLONIA LA PUERTA,4,311,155,156,16
BAJA CALIFORNIA,2,MEXICALI,002,COLONIA MARIANA,1,4,2,2,1
BAJA CALIFORNIA,2,MEXICALI,002,COLONIA MARIANO ABASOLO,3,196,103,93,11
BAJA CALIFORNIA,2,MEXICALI,002,COLONIA MIGUEL ALEMÁN,2,34,19,15,2
BAJA CALIFORNIA,2,MEXICALI,002,COLONIA ORIVE DE ALBA (SUME),2,194,99,95,8
BAJA CALIFORNIA,2,MEXICALI,002,COLONIA PACÍFICO,1,26,16,10,2
BAJA CALIFORNIA,2,MEXICALI,002,COLONIA PESCADEROS (CAMPO LA CATORCE),2,64,29,35,4
BAJA CALIFORNIA,2,MEXICALI,002,COLONIA PÓLVORA,2,139,74,65,7
BAJA CALIFORNIA,2,MEXICALI,002,COLONIA SILVA NOROESTE,3,134,58,76,8
BAJA CALIFORNIA,2,MEXICALI,002,COLONIA SILVA SUR (LAS PLAYITAS),2,85,47,38,5
BAJA CALIFORNIA,2,MEXICALI,002,COLONIA VENUSTIANO CARRANZA (LA CARRANZA),3,632,302,330,40
BAJA CALIFORNIA,2,MEXICALI,002,COLONIA VENUSTIANO CARRANZA MARGEN IZQUIERDO (LA CARRANCITA),2,64,31,33,4
BAJA CALIFORNIA,2,MEXICALI,002,COLONIA VILLARREAL,2,58,29,29,4
BAJA CALIFORNIA,2,MEXICALI,002,COMPUERTA LA 24 (COLONIA SILVA),1,12,8,4,1
BAJA CALIFORNIA,2,MEXICALI,002,COMUNIDAD INDÍGENA CUCAPAH EL MAYOR,3,45,26,19,4
BAJA CALIFORNIA,2,MEXICALI,002,DELTA (ESTACIÓN DELTA),8,1015,498,517,59
BAJA CALIFORNIA,2,MEXICALI,002,EJIDO CHIAPAS 1,2,152,61,91,8
BAJA CALIFORNIA,2,MEXICALI,002,EJIDO CHIAPAS 2,4,352,177,175,16
BAJA CALIFORNIA,2,MEXICALI,002,EJIDO CHIHUAHUA,2,67,30,37,4
BAJA CALIFORNIA,2,MEXICALI,002,EJIDO COLIMA 1,2,248,137,111,9
BAJA CALIFORNIA,2,MEXICALI,002,EJIDO CUCAPAH INDÍGENA,2,147,68,79,8
BAJA CALIFORNIA,2,MEXICALI,002,EJIDO CUCAPAH MESTIZO,2,61,25,36,4
BAJA CALIFORNIA,2,MEXICALI,002,EJIDO DISTRITO FEDERAL,3,307,128,179,25
BAJA CALIFORNIA,2,MEXICALI,002,EJIDO DOCTOR ALBERTO OVIEDO MOTA (EL INDIVISO),3,144,56,88,11
BAJA CALIFORNIA,2,MEXICALI,002,EJIDO DURANGO,4,396,179,217,45
BAJA CALIFORNIA,2,MEXICALI,002,EJIDO EL CHOROPO (COLONIA COLORADO NÚMERO UNO),2,159,76,83,8
BAJA CALIFORNIA,2,MEXICALI,002,EJIDO EL MARÍTIMO,2,68,31,37,4
BAJA CALIFORNIA,2,MEXICALI,002,EJIDO GENERAL ÁLVARO OBREGÓN (TIERRAS BLANCAS),2,16,6,10,2
BAJA CALIFORNIA,2,MEXICALI,002,EJIDO GENERAL J. GERTRUDIS GARCÍA SÁNCHEZ,1,25,14,11,1
BAJA CALIFORNIA,2,MEXICALI,002,EJIDO GUADALAJARA,3,103,62,41,12
BAJA CALIFORNIA,2,MEXICALI,002,EJIDO GUANAJUATO,3,379,190,189,30
BAJA CALIFORNIA,2,MEXICALI,002,EJIDO HECHICERA,4,722,371,351,37
BAJA CALIFORNIA,2,MEXICALI,002,EJIDO HERIBERTO JARA SECCIÓN CORONITA,4,125,63,62,9
BAJA CALIFORNIA,2,MEXICALI,002,EJIDO HERMOSILLO,5,1006,511,495,51
BAJA CALIFORNIA,2,MEXICALI,002,EJIDO HIPÓLITO RENTERÍA,2,53,25,28,3
BAJA CALIFORNIA,2,MEXICALI,002,EJIDO IRAPUATO,2,143,65,78,8
BAJA CALIFORNIA,2,MEXICALI,002,EJIDO JALAPA,2,69,41,28,4
BAJA CALIFORNIA,2,MEXICALI,002,EJIDO JALISCO,2,67,38,29,3
BAJA CALIFORNIA,2,MEXICALI,002,EJIDO JIQUILPAN,2,295,140,155,14
BAJA CALIFORNIA,2,MEXICALI,002,EJIDO LÁZARO CÁRDENAS (LA MOSCA),3,748,389,359,35
BAJA CALIFORNIA,2,MEXICALI,002,EJIDO LICENCIADO ADOLFO LÓPEZ MATEOS,1,32,15,17,2
BAJA CALIFORNIA,2,MEXICALI,002,EJIDO MÉRIDA,3,160,75,85,18
BAJA CALIFORNIA,2,MEXICALI,002,EJIDO MÉXICO,2,112,63,49,5
BAJA CALIFORNIA,2,MEXICALI,002,EJIDO MEZQUITAL,2,156,76,80,8
BAJA CALIFORNIA,2,MEXICALI,002,EJIDO MIGUEL HIDALGO,2,72,34,38,4
BAJA CALIFORNIA,2,MEXICALI,002,EJIDO MONTERREY (COLONIA BATÁQUEZ),2,107,47,60,8
BAJA CALIFORNIA,2,MEXICALI,002,EJIDO NETZAHUALCÓYOTL,2,203,110,93,9
BAJA CALIFORNIA,2,MEXICALI,002,EJIDO NUEVO MICHOACÁN DE BAJA CALIFORNIA,1,14,3,11,3
BAJA CALIFORNIA,2,MEXICALI,002,EJIDO PACHUCA,2,289,125,164,14
BAJA CALIFORNIA,2,MEXICALI,002,EJIDO PÁTZCUARO,2,359,188,171,21
BAJA CALIFORNIA,2,MEXICALI,002,EJIDO PLAN DE AYALA,3,468,235,233,36
BAJA CALIFORNIA,2,MEXICALI,002,EJIDO QUINTANA ROO,3,694,390,304,36
BAJA CALIFORNIA,2,MEXICALI,002,EJIDO REPÚBLICA MEXICANA,2,156,80,76,9
BAJA CALIFORNIA,2,MEXICALI,002,EJIDO SALTILLO,4,472,221,251,46
BAJA CALIFORNIA,2,MEXICALI,002,EJIDO SAN LUIS POTOSÍ,2,127,57,70,7
BAJA CALIFORNIA,2,MEXICALI,002,EJIDO SAN LUIS POTOSÍ DOS,2,23,11,12,3
BAJA CALIFORNIA,2,MEXICALI,002,EJIDO SINALOA (ESTACIÓN KASEY),4,819,414,405,44
BAJA CALIFORNIA,2,MEXICALI,002,EJIDO SONORA,3,373,176,197,31
BAJA CALIFORNIA,2,MEXICALI,002,EJIDO SONORA 2 (CAMPOS NUEVOS),1,20,9,11,2
BAJA CALIFORNIA,2,MEXICALI,002,EJIDO TABASCO,3,407,193,214,26
BAJA CALIFORNIA,2,MEXICALI,002,EJIDO TAMAULIPAS (ESTACIÓN CUCAPAH),2,120,67,53,7
BAJA CALIFORNIA,2,MEXICALI,002,EJIDO TEHUANTEPEC (SANTA ROSA),2,195,89,106,8
BAJA CALIFORNIA,2,MEXICALI,002,EJIDO TEPIC,2,45,22,23,3
BAJA CALIFORNIA,2,MEXICALI,002,EJIDO TLAXCALA,2,110,57,53,8
BAJA CALIFORNIA,2,MEXICALI,002,EJIDO TOLUCA,2,285,144,141,12
BAJA CALIFORNIA,2,MEXICALI,002,EJIDO TULA,2,37,17,20,3
BAJA CALIFORNIA,2,MEXICALI,002,EJIDO VERACRUZ DOS,3,645,327,318,34
BAJA CALIFORNIA,2,MEXICALI,002,EJIDO VICENTE GUERRERO,2,159,87,72,8
BAJA CALIFORNIA,2,MEXICALI,002,EJIDO YUCATÁN,3,366,172,194,23
BAJA CALIFORNIA,2,MEXICALI,002,EL PIRIHOT (FAMILIA VARGAS),2,60,29,31,5
BAJA CALIFORNIA,2,MEXICALI,002,EL PORVENIR [PRODUCTOS LÁCTEOS],1,136,69,67,6
BAJA CALIFORNIA,2,MEXICALI,002,ELIGIO ESQUIVEL MÉNDEZ (EL CHORIZO),3,24,12,12,3
BAJA CALIFORNIA,2,MEXICALI,002,EMILIANO ZAPATA (COLONIA PROGRESO),1,10,3,7,1
BAJA CALIFORNIA,2,MEXICALI,002,ESTACIÓN PESCADEROS (KILÓMETRO TREINTA Y NUEVE),2,43,20,23,3
BAJA CALIFORNIA,2,MEXICALI,002,FAMILIA ANDRADE,1,65,39,26,4
BAJA CALIFORNIA,2,MEXICALI,002,FAMILIA GONZÁLEZ (EJIDO QUERÉTARO),1,11,3,8,1
BAJA CALIFORNIA,2,MEXICALI,002,FAMILIA RODRÍGUEZ BATALLA (COLONIA COLORADO),1,5,2,3,1
BAJA CALIFORNIA,2,MEXICALI,002,FRANCISCO MURGUÍA (KILÓMETRO CUARENTA Y NUEVE),2,131,59,72,8
BAJA CALIFORNIA,2,MEXICALI,002,GENERAL HERIBERTO JARA,2,40,18,22,3
BAJA CALIFORNIA,2,MEXICALI,002,GONZÁLEZ ORTEGA 1 (COLONIA BAJA CALIFORNIA),3,277,125,152,13
BAJA CALIFORNIA,2,MEXICALI,002,GRANJA ORIENTACIÓN (COLONIA AHUMADA PARCELA CUARENTA),1,13,1,12,4
BAJA CALIFORNIA,2,MEXICALI,002,ISLAS AGRARIAS GRUPO A,8,1621,823,798,116
BAJA CALIFORNIA,2,MEXICALI,002,ISLAS AGRARIAS GRUPO B,3,321,148,173,23
BAJA CALIFORNIA,2,MEXICALI,002,JESÚS SANSÓN FLORES,2,123,60,63,8
BAJA CALIFORNIA,2,MEXICALI,002,JOSÉ LÓPEZ PORTILLO (COLONIA VENUSTIANO CARRANZA),2,79,44,35,6
BAJA CALIFORNIA,2,MEXICALI,002,LA LADRILLERA (COLONIA COLORADO NÚMERO DIEZ),1,180,90,90,6
BAJA CALIFORNIA,2,MEXICALI,002,MESA ARENOSA DE ANDRADE (VILLA ZAPATA),4,236,114,122,12
BAJA CALIFORNIA,2,MEXICALI,002,MEXICALI,843,209798,106047,103751,14456
BAJA CALIFORNIA,2,MEXICALI,002,MICHOACÁN DE OCAMPO,6,808,402,406,41
BAJA CALIFORNIA,2,MEXICALI,002,NACAY (COLONIA SILVA),2,27,18,9,2
BAJA CALIFORNIA,2,MEXICALI,002,NAYARIT LLAMADA,2,162,76,86,8
BAJA CALIFORNIA,2,MEXICALI,002,NUEVO LEÓN,7,2114,1133,981,103
BAJA CALIFORNIA,2,MEXICALI,002,NUEVO MILENIUM,2,102,53,49,4
BAJA CALIFORNIA,2,MEXICALI,002,POBLADO ALFREDO V. BONFIL,2,402,204,198,14
BAJA CALIFORNIA,2,MEXICALI,002,POBLADO FRANCISCO SANTANA PERALTA,1,15,6,9,2
BAJA CALIFORNIA,2,MEXICALI,002,POBLADO JANITZIO,2,143,84,59,7
BAJA CALIFORNIA,2,MEXICALI,002,POBLADO LAS MINITAS,3,68,35,33,5
BAJA CALIFORNIA,2,MEXICALI,002,POBLADO LÁZARO CÁRDENAS (LA VEINTIOCHO),3,547,269,278,22
BAJA CALIFORNIA,2,MEXICALI,002,POBLADO PALO VERDE,2,68,31,37,3
BAJA CALIFORNIA,2,MEXICALI,002,POBLADO PAREDONES,5,466,236,230,22
BAJA CALIFORNIA,2,MEXICALI,002,POBLADO PUENTE TREVIÑO,2,90,42,48,5
BAJA CALIFORNIA,2,MEXICALI,002,POBLADO SOMBRERETE,1,16,6,10,1
BAJA CALIFORNIA,2,MEXICALI,002,POBLADO TORCHOZA,1,13,2,11,1
BAJA CALIFORNIA,2,MEXICALI,002,PROGRESO,15,2491,1251,1240,92
BAJA CALIFORNIA,2,MEXICALI,002,PUEBLA,11,5233,2542,2691,364
BAJA CALIFORNIA,2,MEXICALI,002,RANCHO EL PELIGRO (COLONIA PÓLVORA),2,22,13,9,2
BAJA CALIFORNIA,2,MEXICALI,002,RANCHO FLORES (COLONIA VENUSTIANO CARRANZA),1,3,1,2,1
BAJA CALIFORNIA,2,MEXICALI,002,REACOMODO RÍO COLORADO,3,448,220,228,27
BAJA CALIFORNIA,2,MEXICALI,002,REPRESA AURELIO BENANSINI (CAREHEY),1,26,13,13,1
BAJA CALIFORNIA,2,MEXICALI,002,RICARDO MAZÓN GUERRERO (COLONIA BAJA CALIFORNIA EL POLVORÍN),1,23,6,17,2
BAJA CALIFORNIA,2,MEXICALI,002,SAN JOSÉ [VIVERO],1,5,3,2,1
BAJA CALIFORNIA,2,MEXICALI,002,SANTA ISABEL,26,4969,2447,2522,262
BAJA CALIFORNIA,2,MEXICALI,002,SANTO NIÑO,3,400,199,201,16
BAJA CALIFORNIA,2,MEXICALI,002,UNO DEL CHEN DE CERRO PRIETO,1,96,45,51,6
BAJA CALIFORNIA,2,MEXICALI,002,VERACRUZ UNO,2,155,61,94,8
BAJA CALIFORNIA,2,MEXICALI,002,VICENTE GUERRERO (ALGODONES),6,1617,768,849,70
BAJA CALIFORNIA,2,MEXICALI,002,VILLA HERMOSA,2,94,46,48,6
BAJA CALIFORNIA,2,MEXICALI,002,VULCANO,1,116,59,57,6
BAJA CALIFORNIA,2,MEXICALI,002,ZAKAMOTO (NAYARIT 2),1,142,70,72,19
BAJA CALIFORNIA,2,MEXICALI,002,ZARAGOZA SEGUNDA SECCIÓN,2,295,147,148,12
BAJA CALIFORNIA,2,TECATE,003,ALFONSO GARZÓN [GRANJAS FAMILIARES],2,183,87,96,9
BAJA CALIFORNIA,2,TECATE,003,AMPLIACIÓN VALLE DE LAS PALMAS,2,112,55,57,5
BAJA CALIFORNIA,2,TECATE,003,COMUNIDAD INDÍGENA JUNTAS DE NEJI ANEXA,2,11,4,7,1
BAJA CALIFORNIA,2,TECATE,003,EJIDO ENCINAL,2,188,98,90,8
BAJA CALIFORNIA,2,TECATE,003,EJIDO JACUMÉ,3,138,65,73,8
BAJA CALIFORNIA,2,TECATE,003,EL CERRITO TANAMÁ,1,36,18,18,4
BAJA CALIFORNIA,2,TECATE,003,EL ENCINAL,4,276,131,145,11
BAJA CALIFORNIA,2,TECATE,003,EL ESCORIAL,2,194,85,109,9
BAJA CALIFORNIA,2,TECATE,003,EL MIRADOR,1,165,79,86,6
BAJA CALIFORNIA,2,TECATE,003,EL ROBLE,2,41,21,20,4
BAJA CALIFORNIA,2,TECATE,003,EL TESTERAZO,4,229,105,124,11
BAJA CALIFORNIA,2,TECATE,003,HACIENDA SANTA VERÓNICA,3,28,14,14,3
BAJA CALIFORNIA,2,TECATE,003,HACIENDA TECATE,3,340,170,170,15
BAJA CALIFORNIA,2,TECATE,003,JARDINES DEL RINCÓN,3,37,20,17,2
BAJA CALIFORNIA,2,TECATE,003,LA RUMOROSA,5,455,224,231,23
BAJA CALIFORNIA,2,TECATE,003,LOMA LINDA,1,142,86,56,6
BAJA CALIFORNIA,2,TECATE,003,LOMA TOVA,3,24,12,12,3
BAJA CALIFORNIA,2,TECATE,003,LOMAS DE SANTA ANITA,4,790,386,404,34
BAJA CALIFORNIA,2,TECATE,003,LUIS ECHEVERRÍA ÁLVAREZ (EL HONGO),6,936,483,453,43
BAJA CALIFORNIA,2,TECATE,003,MACLOVIO HERRERA (COLONIA AVIACIÓN),4,1098,567,531,69
BAJA CALIFORNIA,2,TECATE,003,MI RANCHITO (CHULA VISTA),2,168,89,79,8
BAJA CALIFORNIA,2,TECATE,003,NUEVA COLONIA HINDÚ,8,1276,634,642,52
BAJA CALIFORNIA,2,TECATE,003,PARCELA 44 (VALLE DE LAS PALMAS),1,10,3,7,1
BAJA CALIFORNIA,2,TECATE,003,PASO DEL ÁGUILA,8,1682,803,879,175
BAJA CALIFORNIA,2,TECATE,003,SIERRA TECATE,2,170,75,95,8
BAJA CALIFORNIA,2,TECATE,003,TECATE,101,19965,9961,10004,1298
BAJA CALIFORNIA,2,TECATE,003,VALLE DE LAS PALMAS,5,688,326,362,37
BAJA CALIFORNIA,2,TIJUANA,004,BUENOS AIRES,3,896,449,447,29
BAJA CALIFORNIA,2,TIJUANA,004,COLINAS DEL FLORIDO,2,78,46,32,4
BAJA CALIFORNIA,2,TIJUANA,004,COLINAS DEL SOL,4,590,293,297,31
BAJA CALIFORNIA,2,TIJUANA,004,CUEROS DE VENADOS [RANCHO],2,35,13,22,2
BAJA CALIFORNIA,2,TIJUANA,004,EJIDO CARMEN SERDÁN,3,55,26,29,3
BAJA CALIFORNIA,2,TIJUANA,004,EJIDO JAVIER ROJO GÓMEZ,6,989,481,508,36
BAJA CALIFORNIA,2,TIJUANA,004,EJIDO LÁZARO CÁRDENAS,2,520,278,242,17
BAJA CALIFORNIA,2,TIJUANA,004,EJIDO OJO DE AGUA,8,2110,1099,1011,104
BAJA CALIFORNIA,2,TIJUANA,004,EL CAMINO,1,78,32,46,3
BAJA CALIFORNIA,2,TIJUANA,004,EL GAVILÁN,1,84,42,42,4
BAJA CALIFORNIA,2,TIJUANA,004,EL NIÑO,5,2245,1116,1129,70
BAJA CALIFORNIA,2,TIJUANA,004,EL REFUGIO,13,5237,2646,2591,209
BAJA CALIFORNIA,2,TIJUANA,004,EL RINCONCITO,2,69,30,39,3
BAJA CALIFORNIA,2,TIJUANA,004,EL TRÉBOL,2,22,8,14,2
BAJA CALIFORNIA,2,TIJUANA,004,GENARO VÁZQUEZ SECCIÓN TRES,3,1246,615,631,42
BAJA CALIFORNIA,2,TIJUANA,004,GRUPO MUZQUIZ,1,18,10,8,1
BAJA CALIFORNIA,2,TIJUANA,004,LA ESPERANZA [GRANJAS FAMILIARES],2,424,224,200,16
BAJA CALIFORNIA,2,TIJUANA,004,LA ESPERANZA [VIVERO],3,16,7,9,3
BAJA CALIFORNIA,2,TIJUANA,004,LA JOYA,16,5101,2542,2559,208
BAJA CALIFORNIA,2,TIJUANA,004,LAS DELICIAS,10,5012,2525,2487,190
BAJA CALIFORNIA,2,TIJUANA,004,LOMAS DEL MAR,2,182,82,100,8
BAJA CALIFORNIA,2,TIJUANA,004,LOMAS DEL PEDREGAL,1,44,28,16,3
BAJA CALIFORNIA,2,TIJUANA,004,LOMAS DEL VALLE,3,870,425,445,30
BAJA CALIFORNIA,2,TIJUANA,004,LOS AGUAJITOS,2,450,228,222,25
BAJA CALIFORNIA,2,TIJUANA,004,MACLOVIO ROJAS,9,2152,1016,1136,76
BAJA CALIFORNIA,2,TIJUANA,004,MARGARITA RESIDENCIAL [FRACCIONAMIENTO],2,841,409,432,30
BAJA CALIFORNIA,2,TIJUANA,004,NATURA,4,1581,813,768,50
BAJA CALIFORNIA,2,TIJUANA,004,PARAJES DEL VALLE,14,6822,3376,3446,250
BAJA CALIFORNIA,2,TIJUANA,004,PÓRTICOS DE SAN ANTONIO,14,6213,3106,3107,276
BAJA CALIFORNIA,2,TIJUANA,004,REAL DEL MAR,2,211,116,95,9
BAJA CALIFORNIA,2,TIJUANA,004,SAN LUIS,17,8135,4007,4128,295
BAJA CALIFORNIA,2,TIJUANA,004,SANTA FE,2,27,14,13,2
BAJA CALIFORNIA,2,TIJUANA,004,TERRAZAS DEL VALLE,9,3727,1849,1878,159
BAJA CALIFORNIA,2,TIJUANA,004,TIJUANA,1735,428033,216328,211705,25284
BAJA CALIFORNIA,2,TIJUANA,004,VALLE BONITO,3,276,132,144,10
BAJA CALIFORNIA,2,TIJUANA,004,VALLE REDONDO,6,705,331,374,30
BAJA CALIFORNIA,2,PLAYAS DE ROSARITO,005,AMPLIACIÓN EJIDO PLAN LIBERTADOR,11,3510,1712,1798,161
BAJA CALIFORNIA,2,PLAYAS DE ROSARITO,005,COLONIA MORELOS,4,620,310,310,25
BAJA CALIFORNIA,2,PLAYAS DE ROSARITO,005,COLONIA POLIDUCTO,1,6,4,2,1
BAJA CALIFORNIA,2,PLAYAS DE ROSARITO,005,EL DESCANSO,2,153,67,86,8
BAJA CALIFORNIA,2,PLAYAS DE ROSARITO,005,EL MORRO,3,27,18,9,3
BAJA CALIFORNIA,2,PLAYAS DE ROSARITO,005,EL REFUGIO,1,4,2,2,1
BAJA CALIFORNIA,2,PLAYAS DE ROSARITO,005,LA MISIÓN  (CAMINO A SAN JOSÉ DE LA ZORRA),1,2,1,1,1
BAJA CALIFORNIA,2,PLAYAS DE ROSARITO,005,LADRILLERA PESCADOR,5,543,273,270,23
BAJA CALIFORNIA,2,PLAYAS DE ROSARITO,005,LOMAS ALTAS UNO Y DOS,1,65,35,30,2
BAJA CALIFORNIA,2,PLAYAS DE ROSARITO,005,MARBELLA,2,8,4,4,1
BAJA CALIFORNIA,2,PLAYAS DE ROSARITO,005,PLAYAS DE ROSARITO,135,25902,13287,12615,1498
BAJA CALIFORNIA,2,PLAYAS DE ROSARITO,005,PRIMO TAPIA,8,1960,980,980,86
BAJA CALIFORNIA,2,PLAYAS DE ROSARITO,005,SAN JOSÉ DE LA ZORRA,1,12,2,10,1
BAJA CALIFORNIA,2,PLAYAS DE ROSARITO,005,SANTA ANITA,1,55,33,22,3
BAJA CALIFORNIA,2,PLAYAS DE ROSARITO,005,VALLES DEL MAR,2,169,87,82,8
BAJA CALIFORNIA,2,PLAYAS DE ROSARITO,005,VENUSTIANO CARRANZA,1,18,12,6,1
BAJA CALIFORNIA,2,SAN QUINTÍN,006,ABC,1,14,6,8,1
BAJA CALIFORNIA,2,SAN QUINTÍN,006,BAHÍA DE LOS ÁNGELES,3,190,99,91,10
BAJA CALIFORNIA,2,SAN QUINTÍN,006,BENJAMÍN SALAZAR (EJIDO),2,36,21,15,4
BAJA CALIFORNIA,2,SAN QUINTÍN,006,CAMALÚ,17,3786,1866,1920,183
BAJA CALIFORNIA,2,SAN QUINTÍN,006,CATAVIÑA,3,39,24,15,4
BAJA CALIFORNIA,2,SAN QUINTÍN,006,COLONIA ÁVILA,2,10,4,6,2
BAJA CALIFORNIA,2,SAN QUINTÍN,006,COLONIA BENITO JUÁREZ,2,647,341,306,25
BAJA CALIFORNIA,2,SAN QUINTÍN,006,COLONIA LOMAS DE SAN RAMÓN (TRIQUIS),3,552,279,273,23
BAJA CALIFORNIA,2,SAN QUINTÍN,006,COLONIA LOS REYES,3,30,16,14,4
BAJA CALIFORNIA,2,SAN QUINTÍN,006,COLONIA MILITAR ELPIDIO BERLANGA DE LEÓN,3,227,115,112,11
BAJA CALIFORNIA,2,SAN QUINTÍN,006,COLONIA NUEVA ERA,4,914,479,435,40
BAJA CALIFORNIA,2,SAN QUINTÍN,006,DIVINAS MUJERES,2,223,115,108,8
BAJA CALIFORNIA,2,SAN QUINTÍN,006,EJIDO CHAPALA,1,19,9,10,2
BAJA CALIFORNIA,2,SAN QUINTÍN,006,EJIDO EMILIANO ZAPATA,3,411,214,197,50
BAJA CALIFORNIA,2,SAN QUINTÍN,006,EJIDO FRANCISCO VILLA (SAN SIMÓN),3,437,213,224,21
BAJA CALIFORNIA,2,SAN QUINTÍN,006,EJIDO GENERAL LEANDRO VALLE,3,474,237,237,24
BAJA CALIFORNIA,2,SAN QUINTÍN,006,EJIDO GRACIANO SÁNCHEZ,1,64,25,39,3
BAJA CALIFORNIA,2,SAN QUINTÍN,006,EJIDO JOSÉ MARÍA MORELOS,2,125,73,52,7
BAJA CALIFORNIA,2,SAN QUINTÍN,006,EJIDO JOSÉ MARÍA MORELOS Y PAVÓN,1,35,13,22,2
BAJA CALIFORNIA,2,SAN QUINTÍN,006,EJIDO LIC. LUIS ECHEVERRÍA ÁLVAREZ (CHULA VISTA),3,258,118,140,11
BAJA CALIFORNIA,2,SAN QUINTÍN,006,EJIDO MESA DE SAN JACINTO,2,23,12,11,2
BAJA CALIFORNIA,2,SAN QUINTÍN,006,EJIDO NUEVA ODISEA (EL PABELLÓN),3,108,54,54,6
BAJA CALIFORNIA,2,SAN QUINTÍN,006,EJIDO NUEVO BAJA CALIFORNIA,6,1327,680,647,145
BAJA CALIFORNIA,2,SAN QUINTÍN,006,EJIDO NUEVO ROSARITO,3,28,10,18,3
BAJA CALIFORNIA,2,SAN QUINTÍN,006,EJIDO PAPALOTE,8,1077,518,559,65
BAJA CALIFORNIA,2,SAN QUINTÍN,006,EJIDO PROFESOR GRACIANO SÁNCHEZ,1,177,93,84,7
BAJA CALIFORNIA,2,SAN QUINTÍN,006,EJIDO RAÚL SÁNCHEZ DÍAZ,7,637,357,280,32
BAJA CALIFORNIA,2,SAN QUINTÍN,006,EJIDO RUBÉN JARAMILLO,4,266,134,132,13
BAJA CALIFORNIA,2,SAN QUINTÍN,006,EJIDO VALLE TRANQUILO,3,40,20,20,3
BAJA CALIFORNIA,2,SAN QUINTÍN,006,EJIDO VILLA JESÚS MARÍA,3,149,70,79,12
BAJA CALIFORNIA,2,SAN QUINTÍN,006,EJIDO ZARAHEMLA,3,203,91,112,10
BAJA CALIFORNIA,2,SAN QUINTÍN,006,EL BARRIL,2,12,6,6,2
BAJA CALIFORNIA,2,SAN QUINTÍN,006,EL BASURERO (VICENTE GUERRERO),2,11,3,8,2
BAJA CALIFORNIA,2,SAN QUINTÍN,006,EL ROSARIO DE ABAJO,3,139,70,69,8
BAJA CALIFORNIA,2,SAN QUINTÍN,006,EL ROSARIO DE ARRIBA,4,617,301,316,31
BAJA CALIFORNIA,2,SAN QUINTÍN,006,EMILIANO ZAPATA,11,2025,1007,1018,91
BAJA CALIFORNIA,2,SAN QUINTÍN,006,ESMERALDA,2,26,16,10,4
BAJA CALIFORNIA,2,SAN QUINTÍN,006,EUCALIPTO,2,19,8,11,2
BAJA CALIFORNIA,2,SAN QUINTÍN,006,FAMILIA ÁREAS (NUEVO MEXICALI),2,286,151,135,12
BAJA CALIFORNIA,2,SAN QUINTÍN,006,FAMILIA ROMO (NUEVO MEXICALI),1,278,127,151,15
BAJA CALIFORNIA,2,SAN QUINTÍN,006,FAMILIA TALAMANTES,1,64,35,29,3
BAJA CALIFORNIA,2,SAN QUINTÍN,006,FAMILIA VEGA (ESTADO VEINTINUEVE),1,36,12,24,2
BAJA CALIFORNIA,2,SAN QUINTÍN,006,HACIENDA SINALOA,4,65,29,36,7
BAJA CALIFORNIA,2,SAN QUINTÍN,006,JUAN MARÍA SALVATIERRA [GRANJAS],1,15,8,7,1
BAJA CALIFORNIA,2,SAN QUINTÍN,006,LA CHORERA,3,25,13,12,3
BAJA CALIFORNIA,2,SAN QUINTÍN,006,LA ESPINITA [RESTAURANTE],3,314,135,179,14
BAJA CALIFORNIA,2,SAN QUINTÍN,006,LAS FLORES,1,69,26,43,3
BAJA CALIFORNIA,2,SAN QUINTÍN,006,LÁZARO CÁRDENAS,28,4824,2505,2319,272
BAJA CALIFORNIA,2,SAN QUINTÍN,006,LUIS RODRÍGUEZ (EL VERGEL),2,278,132,146,11
BAJA CALIFORNIA,2,SAN QUINTÍN,006,MONTE ALBÁN,2,138,68,70,7
BAJA CALIFORNIA,2,SAN QUINTÍN,006,NUEVO CENTRO DE POBLACIÓN PADRE KINO,8,3001,1535,1466,207
BAJA CALIFORNIA,2,SAN QUINTÍN,006,NUEVO MUNDO,2,14,10,4,2
BAJA CALIFORNIA,2,SAN QUINTÍN,006,NUEVO URUAPAN,2,189,87,102,8
BAJA CALIFORNIA,2,SAN QUINTÍN,006,PINOS DE MADRID ETAPA 1,2,15,8,7,2
BAJA CALIFORNIA,2,SAN QUINTÍN,006,PLAYAS DE LA VICENTE GUERRERO,3,106,41,65,6
BAJA CALIFORNIA,2,SAN QUINTÍN,006,PUEBLO BENITO GARCÍA,2,238,115,123,9
BAJA CALIFORNIA,2,SAN QUINTÍN,006,PUNTA PRIETA,3,36,14,22,3
BAJA CALIFORNIA,2,SAN QUINTÍN,006,RANCHO MERCADO,1,166,88,78,6
BAJA CALIFORNIA,2,SAN QUINTÍN,006,SAN FRANCISCO [FRACCIONAMIENTO],1,5,3,2,1
BAJA CALIFORNIA,2,SAN QUINTÍN,006,SAN QUINTÍN,16,2946,1601,1345,193
BAJA CALIFORNIA,2,SAN QUINTÍN,006,SANTA CANDELARIA,2,138,65,73,6
BAJA CALIFORNIA,2,SAN QUINTÍN,006,SANTA FE,7,1239,648,591,50
BAJA CALIFORNIA,2,SAN QUINTÍN,006,SANTA FE [RANCHO],2,322,167,155,12
BAJA CALIFORNIA,2,SAN QUINTÍN,006,SANTA MARÍA (LOS PINOS),4,633,292,341,25
BAJA CALIFORNIA,2,SAN QUINTÍN,006,SANTA ROSALIÍTA,3,58,18,40,6
BAJA CALIFORNIA,2,SAN QUINTÍN,006,TEPEYAC (CAMPAMENTO WESTE),3,10,2,8,3
BAJA CALIFORNIA,2,SAN QUINTÍN,006,VENUSTIANO CARRANZA (SANTA MARÍA),3,327,147,180,15
BAJA CALIFORNIA,2,SAN QUINTÍN,006,VICENTE GUERRERO,31,4473,2231,2242,236
BAJA CALIFORNIA,2,SAN FELIPE,007,COLONIA FRANCISCO VILLA,1,119,59,60,4
BAJA CALIFORNIA,2,SAN FELIPE,007,EJIDO DELICIAS,2,7,5,2,2
BAJA CALIFORNIA,2,SAN FELIPE,007,EJIDO PLAN NACIONAL AGRARIO,3,124,66,58,6
BAJA CALIFORNIA,2,SAN FELIPE,007,MATOMÍ,1,4,1,3,1
BAJA CALIFORNIA,2,SAN FELIPE,007,POBLADO LAS MINITAS,2,56,26,30,3
BAJA CALIFORNIA,2,SAN FELIPE,007,SAN FELIPE,28,4535,2322,2213,227
BAJA CALIFORNIA SUR,3,COMONDÚ,001,BENITO JUÁREZ,4,236,133,103,20
BAJA CALIFORNIA SUR,3,COMONDÚ,001,CARAMBUCHE,1,4,1,3,1
BAJA CALIFORNIA SUR,3,COMONDÚ,001,CIUDAD CONSTITUCIÓN,51,11696,5893,5803,801
BAJA CALIFORNIA SUR,3,COMONDÚ,001,CIUDAD INSURGENTES,12,2391,1156,1235,170
BAJA CALIFORNIA SUR,3,COMONDÚ,001,EL CHICHARRÓN,2,7,4,3,1
BAJA CALIFORNIA SUR,3,COMONDÚ,001,EL CINCUENTAIDÓS,3,18,5,13,3
BAJA CALIFORNIA SUR,3,COMONDÚ,001,EL MEZQUITAL,2,8,4,4,1
BAJA CALIFORNIA SUR,3,COMONDÚ,001,EL RANCHITO (ESTERO TLAQUEPAQUE),2,27,13,14,3
BAJA CALIFORNIA SUR,3,COMONDÚ,001,JOSEFA ORTIZ DE DOMÍNGUEZ,2,25,12,13,2
BAJA CALIFORNIA SUR,3,COMONDÚ,001,LA POZA GRANDE,4,105,49,56,11
BAJA CALIFORNIA SUR,3,COMONDÚ,001,LA PRESA DEL HIGUAJIL,1,4,2,2,1
BAJA CALIFORNIA SUR,3,COMONDÚ,001,LA PURÍSIMA,2,41,24,17,3
BAJA CALIFORNIA SUR,3,COMONDÚ,001,LAS BARRANCAS,4,132,66,66,10
BAJA CALIFORNIA SUR,3,COMONDÚ,001,LEY FEDERAL DE AGUAS NÚMERO CINCO,3,33,12,21,4
BAJA CALIFORNIA SUR,3,COMONDÚ,001,LEY FEDERAL DE AGUAS NÚMERO CUATRO,4,114,52,62,17
BAJA CALIFORNIA SUR,3,COMONDÚ,001,LEY FEDERAL DE AGUAS NÚMERO DOS,2,30,15,15,2
BAJA CALIFORNIA SUR,3,COMONDÚ,001,LEY FEDERAL DE AGUAS NÚMERO TRES,2,10,3,7,2
BAJA CALIFORNIA SUR,3,COMONDÚ,001,LEY FEDERAL DE AGUAS NÚMERO UNO,4,118,55,63,13
BAJA CALIFORNIA SUR,3,COMONDÚ,001,MARÍA AUXILIADORA,2,16,8,8,2
BAJA CALIFORNIA SUR,3,COMONDÚ,001,PALO BOLA,4,196,93,103,14
BAJA CALIFORNIA SUR,3,COMONDÚ,001,PUERTO ADOLFO LÓPEZ MATEOS,6,472,243,229,31
BAJA CALIFORNIA SUR,3,COMONDÚ,001,PUERTO ALCATRAZ,4,28,17,11,6
BAJA CALIFORNIA SUR,3,COMONDÚ,001,PUERTO MAGDALENA,3,14,8,6,2
BAJA CALIFORNIA SUR,3,COMONDÚ,001,PUERTO SAN CARLOS,7,1188,617,571,88
BAJA CALIFORNIA SUR,3,COMONDÚ,001,RAMADITAS,1,9,4,5,1
BAJA CALIFORNIA SUR,3,COMONDÚ,001,SAN ISIDRO,4,112,51,61,13
BAJA CALIFORNIA SUR,3,COMONDÚ,001,SAN JOSÉ DE COMONDÚ,1,5,3,2,1
BAJA CALIFORNIA SUR,3,COMONDÚ,001,SAN JOSÉ DE LA NORIA,2,18,10,8,2
BAJA CALIFORNIA SUR,3,COMONDÚ,001,SAN JUANICO,4,178,95,83,13
BAJA CALIFORNIA SUR,3,COMONDÚ,001,SAN LUIS GONZAGA,3,17,6,11,3
BAJA CALIFORNIA SUR,3,COMONDÚ,001,SAN MIGUEL DE COMONDÚ,3,38,15,23,5
BAJA CALIFORNIA SUR,3,COMONDÚ,001,SANTO DOMINGO,4,124,59,65,10
BAJA CALIFORNIA SUR,3,COMONDÚ,001,VILLA HIDALGO,2,34,18,16,3
BAJA CALIFORNIA SUR,3,COMONDÚ,001,VILLA IGNACIO ZARAGOZA,4,230,103,127,17
BAJA CALIFORNIA SUR,3,COMONDÚ,001,VILLA MORELOS,4,225,117,108,20
BAJA CALIFORNIA SUR,3,MULEGÉ,002,ÁNGEL CÉSAR MENDOZA ARÁMBURO,1,181,83,98,7
BAJA CALIFORNIA SUR,3,MULEGÉ,002,BAHÍA ASUNCIÓN,4,359,183,176,22
BAJA CALIFORNIA SUR,3,MULEGÉ,002,BAHÍA TORTUGAS,6,613,314,299,35
BAJA CALIFORNIA SUR,3,MULEGÉ,002,BENITO JUÁREZ,4,114,50,64,10
BAJA CALIFORNIA SUR,3,MULEGÉ,002,CAMPO DELGADITO,1,3,2,1,1
BAJA CALIFORNIA SUR,3,MULEGÉ,002,COLONIA NUEVA ESPERANZA,3,35,13,22,5
BAJA CALIFORNIA SUR,3,MULEGÉ,002,DON JUANITO,1,30,17,13,2
BAJA CALIFORNIA SUR,3,MULEGÉ,002,EJIDO LICENCIADO ALFREDO VLADIMIR BONFIL,4,74,38,36,8
BAJA CALIFORNIA SUR,3,MULEGÉ,002,EJIDO LUIS ECHEVERRÍA,4,177,91,86,11
BAJA CALIFORNIA SUR,3,MULEGÉ,002,EJIDO SAN LUCAS,4,196,106,90,13
BAJA CALIFORNIA SUR,3,MULEGÉ,002,EL CARDÓN,1,5,3,2,1
BAJA CALIFORNIA SUR,3,MULEGÉ,002,EL DÁTIL,4,62,24,38,8
BAJA CALIFORNIA SUR,3,MULEGÉ,002,EL PARAÍSO II,2,120,48,72,8
BAJA CALIFORNIA SUR,3,MULEGÉ,002,EL PATROCINIO,2,8,3,5,1
BAJA CALIFORNIA SUR,3,MULEGÉ,002,EL SILENCIO,4,249,114,135,15
BAJA CALIFORNIA SUR,3,MULEGÉ,002,EMILIANO ZAPATA,3,57,26,31,5
BAJA CALIFORNIA SUR,3,MULEGÉ,002,ESTERO DE LA BOCANA,2,130,68,62,8
BAJA CALIFORNIA SUR,3,MULEGÉ,002,FRANCISCO J. MÚJICA,2,4,2,2,1
BAJA CALIFORNIA SUR,3,MULEGÉ,002,GUAMÚCHIL,1,9,3,6,1
BAJA CALIFORNIA SUR,3,MULEGÉ,002,GUERRERO NEGRO,20,2990,1538,1452,233
BAJA CALIFORNIA SUR,3,MULEGÉ,002,GUSTAVO DÍAZ ORDAZ,14,1057,538,519,69
BAJA CALIFORNIA SUR,3,MULEGÉ,002,HEROICA MULEGÉ,12,817,393,424,58
BAJA CALIFORNIA SUR,3,MULEGÉ,002,ISLA NATIVIDAD,3,82,42,40,5
BAJA CALIFORNIA SUR,3,MULEGÉ,002,ISLA SAN MARCOS,4,97,51,46,6
BAJA CALIFORNIA SUR,3,MULEGÉ,002,LA BANDERA,1,2,0,2,1
BAJA CALIFORNIA SUR,3,MULEGÉ,002,LA BOCANITA,2,138,70,68,9
BAJA CALIFORNIA SUR,3,MULEGÉ,002,LA NORIA,1,44,26,18,3
BAJA CALIFORNIA SUR,3,MULEGÉ,002,LAS TINAJITAS,1,4,2,2,1
BAJA CALIFORNIA SUR,3,MULEGÉ,002,LOS PATOS,1,7,3,4,1
BAJA CALIFORNIA SUR,3,MULEGÉ,002,PALO VERDE,3,42,23,19,4
BAJA CALIFORNIA SUR,3,MULEGÉ,002,PUNTA ABREOJOS,4,202,97,105,19
BAJA CALIFORNIA SUR,3,MULEGÉ,002,PUNTA PRIETA,3,27,12,15,4
BAJA CALIFORNIA SUR,3,MULEGÉ,002,SAN BRUNO,4,152,81,71,13
BAJA CALIFORNIA SUR,3,MULEGÉ,002,SAN FRANCISCO DE LA SIERRA,2,19,9,10,2
BAJA CALIFORNIA SUR,3,MULEGÉ,002,SAN GREGORIO,2,2,2,0,1
BAJA CALIFORNIA SUR,3,MULEGÉ,002,SAN GREGORITO,2,6,4,2,1
BAJA CALIFORNIA SUR,3,MULEGÉ,002,SAN HIPÓLITO,2,14,9,5,2
BAJA CALIFORNIA SUR,3,MULEGÉ,002,SAN IGNACIO,6,240,112,128,24
BAJA CALIFORNIA SUR,3,MULEGÉ,002,SAN JOSÉ DE MAGDALENA,3,22,12,10,3
BAJA CALIFORNIA SUR,3,MULEGÉ,002,SAN LINO,1,19,9,10,1
BAJA CALIFORNIA SUR,3,MULEGÉ,002,SAN PABLO,1,4,2,2,1
BAJA CALIFORNIA SUR,3,MULEGÉ,002,SANTA ÁGUEDA,2,17,7,10,2
BAJA CALIFORNIA SUR,3,MULEGÉ,002,SANTA MARTHA,1,7,3,4,1
BAJA CALIFORNIA SUR,3,MULEGÉ,002,SANTA ROSALÍA,20,3514,1726,1788,290
BAJA CALIFORNIA SUR,3,MULEGÉ,002,SANTO TOMÁS,2,114,60,54,8
BAJA CALIFORNIA SUR,3,MULEGÉ,002,VILLA ALBERTO ANDRÉS ALVARADO ARÁMBURO,17,3166,1578,1588,166
BAJA CALIFORNIA SUR,3,LA PAZ,003,AGRODELICIAS DE LA BAJA SUR,2,9,4,5,1
BAJA CALIFORNIA SUR,3,LA PAZ,003,AGROEXPORTADORA DEL NOROESTE,2,103,52,51,5
BAJA CALIFORNIA SUR,3,LA PAZ,003,AGUA AMARGA,2,57,24,33,3
BAJA CALIFORNIA SUR,3,LA PAZ,003,ALFREDO V. BONFIL,2,7,5,2,2
BAJA CALIFORNIA SUR,3,LA PAZ,003,BOCA DEL ÁLAMO,1,4,2,2,1
BAJA CALIFORNIA SUR,3,LA PAZ,003,CAROLINA (AGUA NUEVA),2,12,9,3,2
BAJA CALIFORNIA SUR,3,LA PAZ,003,CASAS DE ABAJO,2,9,3,6,2
BAJA CALIFORNIA SUR,3,LA PAZ,003,CHAMETLA,5,441,221,220,25
BAJA CALIFORNIA SUR,3,LA PAZ,003,EJIDO PLUTARCO ELÍAS CALLES,2,36,14,22,3
BAJA CALIFORNIA SUR,3,LA PAZ,003,EL ANCÓN,2,24,14,10,2
BAJA CALIFORNIA SUR,3,LA PAZ,003,EL CACHANILLA,2,29,13,16,3
BAJA CALIFORNIA SUR,3,LA PAZ,003,EL CARDONAL,4,126,74,52,11
BAJA CALIFORNIA SUR,3,LA PAZ,003,EL CARRIZAL,4,326,165,161,18
BAJA CALIFORNIA SUR,3,LA PAZ,003,EL CENTENARIO,6,1151,608,543,64
BAJA CALIFORNIA SUR,3,LA PAZ,003,EL CHAMIZAL,2,4,0,4,1
BAJA CALIFORNIA SUR,3,LA PAZ,003,EL ORGULLO,2,5,2,3,1
BAJA CALIFORNIA SUR,3,LA PAZ,003,EL PALO VERDE,3,5,4,1,2
BAJA CALIFORNIA SUR,3,LA PAZ,003,EL PESCADERO,6,1102,556,546,43
BAJA CALIFORNIA SUR,3,LA PAZ,003,EL PILAR,3,7,2,5,2
BAJA CALIFORNIA SUR,3,LA PAZ,003,EL ROSARIO,2,18,8,10,2
BAJA CALIFORNIA SUR,3,LA PAZ,003,EL SALTITO DE LOS GARCÍA,1,7,3,4,1
BAJA CALIFORNIA SUR,3,LA PAZ,003,EL SARGENTO,4,362,153,209,20
BAJA CALIFORNIA SUR,3,LA PAZ,003,EL SAUCITO,2,6,2,4,1
BAJA CALIFORNIA SUR,3,LA PAZ,003,EL TRIUNFO,2,55,25,30,3
BAJA CALIFORNIA SUR,3,LA PAZ,003,ENSENADA DE CORTÉS,2,2,0,2,1
BAJA CALIFORNIA SUR,3,LA PAZ,003,GENERAL JUAN DOMÍNGUEZ COTA,2,195,104,91,8
BAJA CALIFORNIA SUR,3,LA PAZ,003,LA ESPERANZA,2,15,7,8,2
BAJA CALIFORNIA SUR,3,LA PAZ,003,LA FORTUNA DEL BAJÍO,3,5,2,3,2
BAJA CALIFORNIA SUR,3,LA PAZ,003,LA HIGUERA,2,12,7,5,3
BAJA CALIFORNIA SUR,3,LA PAZ,003,LA LAGUNITA,2,17,12,5,3
BAJA CALIFORNIA SUR,3,LA PAZ,003,LA MATANCITA,1,4,2,2,1
BAJA CALIFORNIA SUR,3,LA PAZ,003,LA MATANZA,3,85,43,42,7
BAJA CALIFORNIA SUR,3,LA PAZ,003,LA PAZ,309,70932,35790,35142,4994
BAJA CALIFORNIA SUR,3,LA PAZ,003,LA SOLEDAD,3,29,16,13,6
BAJA CALIFORNIA SUR,3,LA PAZ,003,LA TRINIDAD,2,35,13,22,3
BAJA CALIFORNIA SUR,3,LA PAZ,003,LA VENTANA,2,62,29,33,3
BAJA CALIFORNIA SUR,3,LA PAZ,003,LAS ÁNIMAS,3,14,6,8,2
BAJA CALIFORNIA SUR,3,LA PAZ,003,LAS POCITAS,4,144,72,72,11
BAJA CALIFORNIA SUR,3,LA PAZ,003,LEY FEDERAL DE REFORMA AGRARIA NO. 2,2,26,11,15,2
BAJA CALIFORNIA SUR,3,LA PAZ,003,LEY FEDERAL DE REFORMA AGRARIA NÚMERO UNO,2,24,10,14,2
BAJA CALIFORNIA SUR,3,LA PAZ,003,LOS BARRILES,4,608,305,303,32
BAJA CALIFORNIA SUR,3,LA PAZ,003,LOS HORCONCITOS,3,14,8,6,2
BAJA CALIFORNIA SUR,3,LA PAZ,003,LOS TAMALES,2,8,4,4,1
BAJA CALIFORNIA SUR,3,LA PAZ,003,MELITÓN ALBÁÑEZ DOMÍNGUEZ,6,476,235,241,30
BAJA CALIFORNIA SUR,3,LA PAZ,003,NCPE CONQUISTA AGRARIA,4,49,24,25,6
BAJA CALIFORNIA SUR,3,LA PAZ,003,OLAS ALTAS,1,64,37,27,3
BAJA CALIFORNIA SUR,3,LA PAZ,003,PUERTO CHALE,3,88,43,45,7
BAJA CALIFORNIA SUR,3,LA PAZ,003,PUNTA ALTA,2,2,1,1,1
BAJA CALIFORNIA SUR,3,LA PAZ,003,PUNTA COYOTE,2,4,2,2,1
BAJA CALIFORNIA SUR,3,LA PAZ,003,RANCHO GEM,2,8,6,2,2
BAJA CALIFORNIA SUR,3,LA PAZ,003,SAN ANTONIO,4,117,58,59,16
BAJA CALIFORNIA SUR,3,LA PAZ,003,SAN BARTOLO,2,69,28,41,4
BAJA CALIFORNIA SUR,3,LA PAZ,003,SAN EVARISTO,1,8,5,3,1
BAJA CALIFORNIA SUR,3,LA PAZ,003,SAN HILARIO,2,16,8,8,2
BAJA CALIFORNIA SUR,3,LA PAZ,003,SAN JOSÉ DE LA PALMILLA,2,22,10,12,2
BAJA CALIFORNIA SUR,3,LA PAZ,003,SAN JUAN DE LA COSTA,4,33,14,19,6
BAJA CALIFORNIA SUR,3,LA PAZ,003,SAN JUAN DE LOS PLANES,4,525,273,252,46
BAJA CALIFORNIA SUR,3,LA PAZ,003,SAN PEDRO,4,165,81,84,14
BAJA CALIFORNIA SUR,3,LA PAZ,003,SAN RAMÓN,2,6,4,2,1
BAJA CALIFORNIA SUR,3,LA PAZ,003,SAN SIMÓN,2,18,8,10,2
BAJA CALIFORNIA SUR,3,LA PAZ,003,SAN VICENTE DE LA SIERRA,2,8,5,3,3
BAJA CALIFORNIA SUR,3,LA PAZ,003,SANTA LIDIA [AGRÍCOLA],2,7,2,5,2
BAJA CALIFORNIA SUR,3,LA PAZ,003,SANTA MARÍA DE TORIS,3,22,9,13,3
BAJA CALIFORNIA SUR,3,LA PAZ,003,SANTA RITA,4,68,32,36,7
BAJA CALIFORNIA SUR,3,LA PAZ,003,SANTA TERESA,2,4,2,2,2
BAJA CALIFORNIA SUR,3,LA PAZ,003,TEPEYAC SANTA FE,1,5,2,3,1
BAJA CALIFORNIA SUR,3,LA PAZ,003,TIERRA BLANCA,2,3,2,1,1
BAJA CALIFORNIA SUR,3,LA PAZ,003,TODOS SANTOS,11,1911,911,1000,99
BAJA CALIFORNIA SUR,3,LOS CABOS,008,AGUA CALIENTE,2,18,7,11,2
BAJA CALIFORNIA SUR,3,LOS CABOS,008,BUENAVISTA,2,76,32,44,4
BAJA CALIFORNIA SUR,3,LOS CABOS,008,CABO PULMO,3,31,15,16,3
BAJA CALIFORNIA SUR,3,LOS CABOS,008,CABO SAN LUCAS,224,55716,28233,27483,3090
BAJA CALIFORNIA SUR,3,LOS CABOS,008,CADUAÑO,2,43,13,30,3
BAJA CALIFORNIA SUR,3,LOS CABOS,008,COLONIA REAL DEL MONTE,2,14,8,6,3
BAJA CALIFORNIA SUR,3,LOS CABOS,008,EL CAMPAMENTO,3,250,127,123,11
BAJA CALIFORNIA SUR,3,LOS CABOS,008,EL RANCHITO,1,14,5,9,1
BAJA CALIFORNIA SUR,3,LOS CABOS,008,EL SAUZAL,3,6,1,5,2
BAJA CALIFORNIA SUR,3,LOS CABOS,008,FUENTE DEL CABO,3,10,4,6,3
BAJA CALIFORNIA SUR,3,LOS CABOS,008,LA CANDELARIA,3,50,21,29,5
BAJA CALIFORNIA SUR,3,LOS CABOS,008,LA CHOYA,1,17,6,11,1
BAJA CALIFORNIA SUR,3,LOS CABOS,008,LA PLAYA,4,392,177,215,18
BAJA CALIFORNIA SUR,3,LOS CABOS,008,LA RIBERA,4,567,278,289,27
BAJA CALIFORNIA SUR,3,LOS CABOS,008,LA TRINIDAD,3,7,5,2,2
BAJA CALIFORNIA SUR,3,LOS CABOS,008,LAS ÁNIMAS ALTAS,1,25,16,9,2
BAJA CALIFORNIA SUR,3,LOS CABOS,008,LAS ÁNIMAS BAJAS,2,75,35,40,5
BAJA CALIFORNIA SUR,3,LOS CABOS,008,LOS POZOS,2,9,4,5,1
BAJA CALIFORNIA SUR,3,LOS CABOS,008,MATANCITAS,2,41,15,26,3
BAJA CALIFORNIA SUR,3,LOS CABOS,008,MIGRIÑO,3,31,15,16,3
BAJA CALIFORNIA SUR,3,LOS CABOS,008,MIRAFLORES,4,400,192,208,24
BAJA CALIFORNIA SUR,3,LOS CABOS,008,PALO ESCOPETA,3,33,17,16,3
BAJA CALIFORNIA SUR,3,LOS CABOS,008,SAN JOSÉ DEL CABO,162,39596,19753,19843,2182
BAJA CALIFORNIA SUR,3,LOS CABOS,008,SAN JOSÉ VIEJO,4,99,38,61,5
BAJA CALIFORNIA SUR,3,LOS CABOS,008,SANTA ANITA,4,751,350,401,34
BAJA CALIFORNIA SUR,3,LOS CABOS,008,SANTA CATARINA,3,135,59,76,9
BAJA CALIFORNIA SUR,3,LOS CABOS,008,SANTA CRUZ,2,62,32,30,3
BAJA CALIFORNIA SUR,3,LOS CABOS,008,SANTIAGO,5,744,370,374,60
BAJA CALIFORNIA SUR,3,LORETO,009,EL AGUA BONITA,2,4,2,2,1
BAJA CALIFORNIA SUR,3,LORETO,009,EL MEZQUITE,1,5,4,1,1
BAJA CALIFORNIA SUR,3,LORETO,009,EL PELOTEADO,1,2,1,1,1
BAJA CALIFORNIA SUR,3,LORETO,009,ENSENADA BLANCA,1,10,7,3,1
BAJA CALIFORNIA SUR,3,LORETO,009,LIGÜÍ,4,100,46,54,11
BAJA CALIFORNIA SUR,3,LORETO,009,LORETO,22,4325,2163,2162,246
BAJA CALIFORNIA SUR,3,LORETO,009,LOS DOLORES,2,5,4,1,2
BAJA CALIFORNIA SUR,3,LORETO,009,PUERTO AGUA VERDE,4,66,35,31,8
BAJA CALIFORNIA SUR,3,LORETO,009,SAN JAVIER,3,44,19,25,5
BAJA CALIFORNIA SUR,3,LORETO,009,SAN JUAN LONDÓ,1,5,4,1,1
BAJA CALIFORNIA SUR,3,LORETO,009,SAN JUANIQUITO,3,6,5,1,2
BAJA CALIFORNIA SUR,3,LORETO,009,SAN NICOLÁS,2,4,1,3,1
CAMPECHE,4,CALKINÍ,001,BÉCAL,14,1590,789,801,83
CAMPECHE,4,CALKINÍ,001,CALKINÍ,31,7220,3571,3649,483
CAMPECHE,4,CALKINÍ,001,CONCEPCIÓN,3,79,39,40,4
CAMPECHE,4,CALKINÍ,001,ISLA ARENA,5,239,130,109,15
CAMPECHE,4,CALKINÍ,001,NUNKINÍ,15,1783,900,883,110
CAMPECHE,4,CALKINÍ,001,PUCNACHÉN,4,242,118,124,13
CAMPECHE,4,CALKINÍ,001,SAN AGUSTÍN CHUNHUÁS,3,142,82,60,7
CAMPECHE,4,CALKINÍ,001,SAN ANTONIO SAHCABCHÉN,4,620,292,328,36
CAMPECHE,4,CALKINÍ,001,SAN NICOLÁS,3,67,34,33,5
CAMPECHE,4,CALKINÍ,001,SANTA CRUZ EX-HACIENDA,4,418,210,208,17
CAMPECHE,4,CALKINÍ,001,SANTA CRUZ PUEBLO,4,503,265,238,25
CAMPECHE,4,CALKINÍ,001,SANTA MARÍA,3,54,24,30,4
CAMPECHE,4,CALKINÍ,001,TANKUCHÉ,4,273,119,154,20
CAMPECHE,4,CALKINÍ,001,TEPAKÁN,3,324,155,169,18
CAMPECHE,4,CALKINÍ,001,XKAKOCH,2,65,34,31,4
CAMPECHE,4,CAMPECHE,002,ADOLFO RUIZ CORTÍNEZ,4,94,45,49,8
CAMPECHE,4,CAMPECHE,002,ALFREDO V. BONFIL,4,955,518,437,88
CAMPECHE,4,CAMPECHE,002,BETHANIA,4,215,103,112,11
CAMPECHE,4,CAMPECHE,002,BOLONCHÉN CAHUICH,2,45,21,24,3
CAMPECHE,4,CAMPECHE,002,CARLOS CANO CRUZ (LOS TLAXCALTECAS),2,43,19,24,3
CAMPECHE,4,CAMPECHE,002,CASTAMAY,3,232,107,125,11
CAMPECHE,4,CAMPECHE,002,CAYAL,3,91,47,44,5
CAMPECHE,4,CAMPECHE,002,CHEMBLÁS,3,108,63,45,6
CAMPECHE,4,CAMPECHE,002,CHINÁ,10,2420,1064,1356,131
CAMPECHE,4,CAMPECHE,002,CRUCERO OXÁ,2,56,25,31,3
CAMPECHE,4,CAMPECHE,002,EDZNÁ [ZONA ARQUEOLÓGICA],1,13,8,5,1
CAMPECHE,4,CAMPECHE,002,EX-HACIENDA SANTA CRISTINA (CBTA NÚMERO 15),1,206,89,117,44
CAMPECHE,4,CAMPECHE,002,HAMPOLOL,3,319,139,180,14
CAMPECHE,4,CAMPECHE,002,HOBOMÓ,3,59,27,32,4
CAMPECHE,4,CAMPECHE,002,IMÍ,5,14090,8736,5354,130
CAMPECHE,4,CAMPECHE,002,KIKAB,3,158,85,73,9
CAMPECHE,4,CAMPECHE,002,LA LIBERTAD,1,20,10,10,2
CAMPECHE,4,CAMPECHE,002,LERMA,11,3154,1325,1829,221
CAMPECHE,4,CAMPECHE,002,LOS LAURELES,4,659,301,358,31
CAMPECHE,4,CAMPECHE,002,MELCHOR OCAMPO,3,243,124,119,11
CAMPECHE,4,CAMPECHE,002,MUCUYCHAKÁN,3,35,16,19,3
CAMPECHE,4,CAMPECHE,002,NILCHÍ,4,286,149,137,13
CAMPECHE,4,CAMPECHE,002,NOHAKAL,4,272,143,129,14
CAMPECHE,4,CAMPECHE,002,NUEVO PÉNJAMO,1,5,2,3,1
CAMPECHE,4,CAMPECHE,002,PICH,5,593,305,288,41
CAMPECHE,4,CAMPECHE,002,POCYAXUM,3,100,44,56,6
CAMPECHE,4,CAMPECHE,002,PUEBLO NUEVO,3,125,73,52,6
CAMPECHE,4,CAMPECHE,002,QUETZAL EDZNÁ,3,331,155,176,15
CAMPECHE,4,CAMPECHE,002,SAN AGUSTÍN OLÁ,1,10,7,3,1
CAMPECHE,4,CAMPECHE,002,SAN ANTONIO BOBOLÁ,3,46,24,22,4
CAMPECHE,4,CAMPECHE,002,SAN CAMILO (CHENCOLLÍ),2,57,27,30,3
CAMPECHE,4,CAMPECHE,002,SAN FRANCISCO DE CAMPECHE,324,66760,34158,32602,4902
CAMPECHE,4,CAMPECHE,002,SAN FRANCISCO KOBÉN,3,256,125,131,12
CAMPECHE,4,CAMPECHE,002,SAN LUCIANO,2,67,34,33,3
CAMPECHE,4,CAMPECHE,002,SAN MIGUEL ALLENDE,2,45,23,22,3
CAMPECHE,4,CAMPECHE,002,TIKINMUL,5,485,226,259,21
CAMPECHE,4,CAMPECHE,002,TIXMUCUY,3,132,66,66,6
CAMPECHE,4,CAMPECHE,002,UAYAMÓN,2,25,12,13,2
CAMPECHE,4,CAMPECHE,002,UZAHZIL-EDZNÁ (NOHYAXCHÉ),2,41,21,20,3
CAMPECHE,4,CARMEN,003,ABELARDO L. RODRÍGUEZ,3,275,126,149,13
CAMPECHE,4,CARMEN,003,ADOLFO LÓPEZ MATEOS,2,9,4,5,2
CAMPECHE,4,CARMEN,003,ATASTA,8,1114,530,584,52
CAMPECHE,4,CARMEN,003,BELISARIO DOMÍNGUEZ,2,28,13,15,2
CAMPECHE,4,CARMEN,003,CALAX,3,48,27,21,4
CAMPECHE,4,CARMEN,003,CENTAURO DEL NORTE,3,65,29,36,4
CAMPECHE,4,CARMEN,003,CHEKUBUL,3,374,189,185,20
CAMPECHE,4,CARMEN,003,CHICBUL,4,915,474,441,47
CAMPECHE,4,CARMEN,003,CIUDAD DEL CARMEN,231,47871,24315,23556,3954
CAMPECHE,4,CARMEN,003,COLONIA EMILIANO ZAPATA,4,355,181,174,16
CAMPECHE,4,CARMEN,003,CONQUISTA CAMPESINA,4,289,130,159,18
CAMPECHE,4,CARMEN,003,EL AGUACATAL,4,550,269,281,32
CAMPECHE,4,CARMEN,003,EL ARCA,1,8,3,5,1
CAMPECHE,4,CARMEN,003,EL CARMEN,2,10,6,4,2
CAMPECHE,4,CARMEN,003,EL CEPILLO,2,16,5,11,2
CAMPECHE,4,CARMEN,003,EL CHINAL,2,43,23,20,2
CAMPECHE,4,CARMEN,003,EL ENCANTO,2,9,5,4,2
CAMPECHE,4,CARMEN,003,EL JAZMÍN,2,6,1,5,1
CAMPECHE,4,CARMEN,003,EL MANGO,1,4,3,1,2
CAMPECHE,4,CARMEN,003,EL SACRIFICIO,2,16,10,6,2
CAMPECHE,4,CARMEN,003,EL TRIUNFO,3,25,11,14,3
CAMPECHE,4,CARMEN,003,EL ZAPOTE,3,68,31,37,5
CAMPECHE,4,CARMEN,003,ENRIQUE RODRÍGUEZ CANO,2,107,51,56,5
CAMPECHE,4,CARMEN,003,FELIPE ÁNGELES,3,124,63,61,7
CAMPECHE,4,CARMEN,003,FERNANDO FOGLIO MIRAMONTES,2,25,10,15,2
CAMPECHE,4,CARMEN,003,IGNACIO GUTIÉRREZ,3,242,122,120,12
CAMPECHE,4,CARMEN,003,IGNACIO ZARAGOZA,3,84,40,44,6
CAMPECHE,4,CARMEN,003,INDEPENDENCIA,2,96,44,52,4
CAMPECHE,4,CARMEN,003,ISLA AGUADA,9,1782,887,895,91
CAMPECHE,4,CARMEN,003,JOSÉ MARÍA PINO SUÁREZ,2,61,36,25,3
CAMPECHE,4,CARMEN,003,JUAN DE LA CABADA VERA,3,132,63,69,8
CAMPECHE,4,CARMEN,003,JUSTO SIERRA,2,9,4,5,1
CAMPECHE,4,CARMEN,003,KILÓMETRO 59,2,33,19,14,3
CAMPECHE,4,CARMEN,003,LA ANTORCHA,2,36,16,20,3
CAMPECHE,4,CARMEN,003,LA CRISTALINA,3,213,102,111,16
CAMPECHE,4,CARMEN,003,LA LAGARTERA,1,25,14,11,2
CAMPECHE,4,CARMEN,003,LA NUEVA ESPERANZA,3,58,31,27,4
CAMPECHE,4,CARMEN,003,LICENCIADO GUSTAVO DÍAZ ORDAZ (18 DE MARZO),4,337,160,177,18
CAMPECHE,4,CARMEN,003,LOS MANANTIALES,1,13,7,6,1
CAMPECHE,4,CARMEN,003,MAMANTEL (PANCHO VILLA),4,787,391,396,40
CAMPECHE,4,CARMEN,003,MURALLAS DE CAMPECHE,3,76,40,36,6
CAMPECHE,4,CARMEN,003,NICOLÁS BRAVO,2,61,27,34,4
CAMPECHE,4,CARMEN,003,NUEVA CHONTALPA,2,135,57,78,8
CAMPECHE,4,CARMEN,003,NUEVO CAMPECHITO,2,82,38,44,4
CAMPECHE,4,CARMEN,003,NUEVO PROGRESO,7,1611,797,814,65
CAMPECHE,4,CARMEN,003,OJO DE AGUA,3,125,61,64,7
CAMPECHE,4,CARMEN,003,OXCABAL,4,251,124,127,15
CAMPECHE,4,CARMEN,003,PITAL NUEVO,2,119,60,59,7
CAMPECHE,4,CARMEN,003,PITAL VIEJO,2,60,26,34,3
CAMPECHE,4,CARMEN,003,PLAN DE AYALA,2,152,76,76,8
CAMPECHE,4,CARMEN,003,PUERTO RICO,3,247,115,132,11
CAMPECHE,4,CARMEN,003,QUEBRACHE,3,88,35,53,5
CAMPECHE,4,CARMEN,003,RANCHERÍA PEJELAGARTO,1,6,2,4,1
CAMPECHE,4,CARMEN,003,RIBERA DE SAN FRANCISCO,1,15,7,8,1
CAMPECHE,4,CARMEN,003,SABANCUY,9,1981,967,1014,91
CAMPECHE,4,CARMEN,003,SAN ANTONIO CÁRDENAS,5,2339,951,1388,278
CAMPECHE,4,CARMEN,003,SAN ISIDRO,3,113,63,50,8
CAMPECHE,4,CARMEN,003,SANTA RITA,2,49,29,20,4
CAMPECHE,4,CARMEN,003,TRES POTRILLOS,1,18,8,10,1
CAMPECHE,4,CARMEN,003,VENUSTIANO CARRANZA,3,93,47,46,6
CAMPECHE,4,CARMEN,003,VISTA ALEGRE,3,30,18,12,3
CAMPECHE,4,CHAMPOTÓN,004,AH-KIM-PECH,1,11,8,3,1
CAMPECHE,4,CHAMPOTÓN,004,AQUILES SERDÁN (CHUINÁ),2,183,91,92,9
CAMPECHE,4,CHAMPOTÓN,004,ARELLANO,2,99,48,51,4
CAMPECHE,4,CHAMPOTÓN,004,BUENAVENTURA,2,29,15,14,2
CAMPECHE,4,CHAMPOTÓN,004,CANASAYAB,3,40,25,15,4
CAMPECHE,4,CHAMPOTÓN,004,CAÑAVERAL,3,72,39,33,5
CAMPECHE,4,CHAMPOTÓN,004,CARLOS SALINAS DE GORTARI,4,178,84,94,12
CAMPECHE,4,CHAMPOTÓN,004,CARRILLO PUERTO,7,1229,603,626,125
CAMPECHE,4,CHAMPOTÓN,004,CHAC CHAITO,3,90,47,43,4
CAMPECHE,4,CHAMPOTÓN,004,CHAMPOTÓN,54,9913,4870,5043,651
CAMPECHE,4,CHAMPOTÓN,004,CHILAM BALAM,4,225,107,118,12
CAMPECHE,4,CHAMPOTÓN,004,CINCO DE FEBRERO,3,229,120,109,11
CAMPECHE,4,CHAMPOTÓN,004,CIUDAD DEL SOL,3,218,98,120,25
CAMPECHE,4,CHAMPOTÓN,004,CORONEL ORTIZ ÁVILA,3,17,7,10,3
CAMPECHE,4,CHAMPOTÓN,004,DZACABUCHÉN,2,56,27,29,3
CAMPECHE,4,CHAMPOTÓN,004,EL PORVENIR,3,87,49,38,4
CAMPECHE,4,CHAMPOTÓN,004,EL ZAPOTE,2,17,7,10,2
CAMPECHE,4,CHAMPOTÓN,004,GENERAL ORTIZ ÁVILA,3,156,90,66,9
CAMPECHE,4,CHAMPOTÓN,004,HOOL,3,205,108,97,13
CAMPECHE,4,CHAMPOTÓN,004,IGNACIO LÓPEZ RAYÓN,1,15,7,8,1
CAMPECHE,4,CHAMPOTÓN,004,JOSÉ MARÍA MORELOS Y PAVÓN,4,209,107,102,13
CAMPECHE,4,CHAMPOTÓN,004,KILÓMETRO SESENTA Y SIETE (VENUSTIANO CARRANZA),2,68,35,33,4
CAMPECHE,4,CHAMPOTÓN,004,LA JOYA,2,217,109,108,10
CAMPECHE,4,CHAMPOTÓN,004,LÁZARO CÁRDENAS,2,50,23,27,4
CAMPECHE,4,CHAMPOTÓN,004,LEY FEDERAL DE REFORMA AGRARIA,5,865,409,456,43
CAMPECHE,4,CHAMPOTÓN,004,LÓPEZ MATEOS (LA DESCONFIANZA),2,75,43,32,4
CAMPECHE,4,CHAMPOTÓN,004,LÓPEZ PORTILLO NÚMERO 2,2,14,8,6,2
CAMPECHE,4,CHAMPOTÓN,004,MAYA TECÚN I,4,318,153,165,18
CAMPECHE,4,CHAMPOTÓN,004,MAYA TECÚN II,3,274,136,138,14
CAMPECHE,4,CHAMPOTÓN,004,MIGUEL ALLENDE,1,15,9,6,1
CAMPECHE,4,CHAMPOTÓN,004,MIGUEL COLORADO,4,296,151,145,15
CAMPECHE,4,CHAMPOTÓN,004,MOQUEL,3,157,83,74,7
CAMPECHE,4,CHAMPOTÓN,004,NAYARIT CASTELLOT,4,137,65,72,10
CAMPECHE,4,CHAMPOTÓN,004,NUEVA ESPERANZA NÚMERO 2 (SANTO DOMINGO),3,57,32,25,4
CAMPECHE,4,CHAMPOTÓN,004,NUEVO MICHOACÁN,1,8,4,4,1
CAMPECHE,4,CHAMPOTÓN,004,NUEVO PARAÍSO [MÓDULO],1,12,6,6,1
CAMPECHE,4,CHAMPOTÓN,004,PIXOYAL,3,130,59,71,8
CAMPECHE,4,CHAMPOTÓN,004,PROFESOR GRACIANO SÁNCHEZ,3,147,77,70,7
CAMPECHE,4,CHAMPOTÓN,004,PUNTA XEN,3,53,27,26,3
CAMPECHE,4,CHAMPOTÓN,004,PUSTUNICH,3,179,91,88,8
CAMPECHE,4,CHAMPOTÓN,004,REVOLUCIÓN,3,161,78,83,7
CAMPECHE,4,CHAMPOTÓN,004,SAN ANTONIO DEL RÍO,2,35,9,26,3
CAMPECHE,4,CHAMPOTÓN,004,SAN ANTONIO YACASAY,3,106,47,59,7
CAMPECHE,4,CHAMPOTÓN,004,SAN JOSÉ CARPIZO DOS,2,50,23,27,3
CAMPECHE,4,CHAMPOTÓN,004,SAN JOSÉ CARPIZO UNO (SAN FERNANDO),3,115,51,64,7
CAMPECHE,4,CHAMPOTÓN,004,SAN JUAN CARPIZO,2,60,24,36,3
CAMPECHE,4,CHAMPOTÓN,004,SAN MIGUEL,3,50,26,24,4
CAMPECHE,4,CHAMPOTÓN,004,SAN PABLO PIXTÚN,4,384,193,191,20
CAMPECHE,4,CHAMPOTÓN,004,SANTA CRUZ DE ROVIRA,1,15,12,3,1
CAMPECHE,4,CHAMPOTÓN,004,SANTO DOMINGO KESTÉ,5,1022,521,501,62
CAMPECHE,4,CHAMPOTÓN,004,SIHOCHAC,7,740,362,378,58
CAMPECHE,4,CHAMPOTÓN,004,TRES DE MAYO,3,45,20,25,5
CAMPECHE,4,CHAMPOTÓN,004,ULUMAL,3,164,79,85,10
CAMPECHE,4,CHAMPOTÓN,004,VALLE DE QUETZALCÓATL,2,42,23,19,3
CAMPECHE,4,CHAMPOTÓN,004,VICENTE GUERRERO,2,50,28,22,3
CAMPECHE,4,CHAMPOTÓN,004,VILLA DE GUADALUPE,3,148,79,69,8
CAMPECHE,4,CHAMPOTÓN,004,VILLA DE LAS FLORES,3,61,27,34,5
CAMPECHE,4,CHAMPOTÓN,004,VILLAMAR,3,119,60,59,7
CAMPECHE,4,CHAMPOTÓN,004,XBACAB,4,945,475,470,47
CAMPECHE,4,CHAMPOTÓN,004,YOHALTÚN,5,252,125,127,15
CAMPECHE,4,HECELCHAKÁN,005,BLANCA FLOR,3,71,36,35,4
CAMPECHE,4,HECELCHAKÁN,005,CBTA NÚMERO CIENTO SESENTA Y NUEVE,1,331,184,147,39
CAMPECHE,4,HECELCHAKÁN,005,CHUNKANÁN,5,368,182,186,18
CAMPECHE,4,HECELCHAKÁN,005,CUMPICH,7,642,301,341,26
CAMPECHE,4,HECELCHAKÁN,005,DZITNUP,4,243,117,126,14
CAMPECHE,4,HECELCHAKÁN,005,DZOTCHÉN,3,68,33,35,4
CAMPECHE,4,HECELCHAKÁN,005,HECELCHAKÁN,18,3007,1521,1486,197
CAMPECHE,4,HECELCHAKÁN,005,MONTEBELLO,3,68,32,36,4
CAMPECHE,4,HECELCHAKÁN,005,NOHALAL,4,135,67,68,10
CAMPECHE,4,HECELCHAKÁN,005,POCBOC,5,330,153,177,15
CAMPECHE,4,HECELCHAKÁN,005,POMUCH,15,2606,1331,1275,161
CAMPECHE,4,HECELCHAKÁN,005,SANTA CRUZ,4,212,98,114,10
CAMPECHE,4,HECELCHAKÁN,005,ZODZIL,3,69,36,33,4
CAMPECHE,4,HOPELCHÉN,006,BECANCHÉN,4,272,124,148,14
CAMPECHE,4,HOPELCHÉN,006,BOLONCHÉN DE REJÓN,9,1103,524,579,61
CAMPECHE,4,HOPELCHÉN,006,CANCABCHÉN,4,174,87,87,9
CAMPECHE,4,HOPELCHÉN,006,CHAN-CHEN,3,78,45,33,5
CAMPECHE,4,HOPELCHÉN,006,CHENCOH,4,107,54,53,9
CAMPECHE,4,HOPELCHÉN,006,CHUNCHINTOK,5,311,153,158,16
CAMPECHE,4,HOPELCHÉN,006,CHUN-EK,3,58,28,30,4
CAMPECHE,4,HOPELCHÉN,006,CHUNYAXNIC,3,94,52,42,5
CAMPECHE,4,HOPELCHÉN,006,CRUCERO SAN LUIS,3,105,48,57,5
CAMPECHE,4,HOPELCHÉN,006,DZIBALCHÉN,8,724,378,346,41
CAMPECHE,4,HOPELCHÉN,006,EL PEDREGAL,2,15,12,3,2
CAMPECHE,4,HOPELCHÉN,006,EL POSTE,3,64,33,31,4
CAMPECHE,4,HOPELCHÉN,006,HOPELCHÉN,10,2995,1461,1534,146
CAMPECHE,4,HOPELCHÉN,006,ICH-EK,3,172,84,88,9
CAMPECHE,4,HOPELCHÉN,006,KATAB,3,100,52,48,6
CAMPECHE,4,HOPELCHÉN,006,KOMCHÉN,4,140,71,69,9
CAMPECHE,4,HOPELCHÉN,006,PACHUITZ,3,69,32,37,4
CAMPECHE,4,HOPELCHÉN,006,PAKCHÉN,3,59,30,29,4
CAMPECHE,4,HOPELCHÉN,006,RAMÓN CORONA,4,49,22,27,4
CAMPECHE,4,HOPELCHÉN,006,SAN ANTONIO YAXCHÉ,4,181,98,83,9
CAMPECHE,4,HOPELCHÉN,006,SAN JUAN BAUTISTA SAHCABCHÉN,4,91,38,53,7
CAMPECHE,4,HOPELCHÉN,006,SUC-TUC,5,467,246,221,20
CAMPECHE,4,HOPELCHÉN,006,UKUM,6,794,384,410,34
CAMPECHE,4,HOPELCHÉN,006,VICENTE GUERRERO,6,902,467,435,38
CAMPECHE,4,HOPELCHÉN,006,XCALOT AKAL,2,50,25,25,2
CAMPECHE,4,HOPELCHÉN,006,XCANAHALTÚN HUECHIL UNIDOS,2,31,13,18,2
CAMPECHE,4,HOPELCHÉN,006,X-CANHÁ,4,147,65,82,7
CAMPECHE,4,HOPELCHÉN,006,XCULOC,4,154,63,91,8
CAMPECHE,4,HOPELCHÉN,006,XCUPIL,4,156,77,79,11
CAMPECHE,4,HOPELCHÉN,006,XMABÉN,4,422,195,227,21
CAMPECHE,4,HOPELCHÉN,006,XMEJÍA,4,136,66,70,8
CAMPECHE,4,HOPELCHÉN,006,YAXCHÉ AKAL,2,24,11,13,2
CAMPECHE,4,PALIZADA,007,ALAMILLA,2,47,21,26,3
CAMPECHE,4,PALIZADA,007,CANALES UNO,2,12,6,6,2
CAMPECHE,4,PALIZADA,007,EL BORBOTÓN,2,6,4,2,2
CAMPECHE,4,PALIZADA,007,EL CUYO,2,70,32,38,4
CAMPECHE,4,PALIZADA,007,EL JUNCAL,5,344,176,168,22
CAMPECHE,4,PALIZADA,007,EL MANGAL,2,24,8,16,2
CAMPECHE,4,PALIZADA,007,EL PARAÍSO,2,27,14,13,3
CAMPECHE,4,PALIZADA,007,EL PORVENIR,3,18,8,10,3
CAMPECHE,4,PALIZADA,007,GARDENIAS,1,7,3,4,1
CAMPECHE,4,PALIZADA,007,ISLA DE SAN ISIDRO,2,205,105,100,10
CAMPECHE,4,PALIZADA,007,LA GUADALUPE,3,19,11,8,3
CAMPECHE,4,PALIZADA,007,LA SOLEDAD,3,26,15,11,3
CAMPECHE,4,PALIZADA,007,LA TOZA,1,20,9,11,1
CAMPECHE,4,PALIZADA,007,LAGÓN DULCE,3,22,14,8,5
CAMPECHE,4,PALIZADA,007,LAS BODEGAS,3,29,14,15,3
CAMPECHE,4,PALIZADA,007,LOS LAURELES,2,10,6,4,2
CAMPECHE,4,PALIZADA,007,PALIZADA,4,818,422,396,73
CAMPECHE,4,PALIZADA,007,PUERTO ARTURO,3,28,14,14,3
CAMPECHE,4,PALIZADA,007,RIBERA BOCA CHICA,2,9,6,3,1
CAMPECHE,4,PALIZADA,007,RIBERA DE LA CORRIENTE,3,60,29,31,5
CAMPECHE,4,PALIZADA,007,RIBERA GÓMEZ,2,23,14,9,3
CAMPECHE,4,PALIZADA,007,RIBERA SAN EDUARDO,3,43,22,21,3
CAMPECHE,4,PALIZADA,007,RÍO BLANCO,1,3,0,3,1
CAMPECHE,4,PALIZADA,007,RIVERA DE LA VIUDA,1,15,8,7,1
CAMPECHE,4,PALIZADA,007,SAN AGUSTÍN (LA REBEZA),2,46,25,21,3
CAMPECHE,4,PALIZADA,007,SAN JUAN,2,22,12,10,2
CAMPECHE,4,PALIZADA,007,SAN MIGUEL VICTORIA,2,14,7,7,2
CAMPECHE,4,PALIZADA,007,SANTA CRUZ,2,16,7,9,2
CAMPECHE,4,PALIZADA,007,SANTA ISABEL,3,154,75,79,9
CAMPECHE,4,PALIZADA,007,SANTA ROSA,2,8,4,4,2
CAMPECHE,4,PALIZADA,007,TILA,2,44,22,22,3
CAMPECHE,4,PALIZADA,007,TUMBO DE LA MONTAÑA 1,2,52,23,29,4
CAMPECHE,4,TENABO,008,EMILIANO ZAPATA,3,89,43,46,5
CAMPECHE,4,TENABO,008,KANKÍ,4,61,35,26,5
CAMPECHE,4,TENABO,008,SANTA ROSA,1,8,5,3,1
CAMPECHE,4,TENABO,008,TENABO,11,2263,1117,1146,128
CAMPECHE,4,TENABO,008,TINÚN,3,182,90,92,11
CAMPECHE,4,TENABO,008,XKUNCHEIL,2,16,9,7,2
CAMPECHE,4,ESCÁRCEGA,009,ADOLFO LÓPEZ MATEOS,3,242,139,103,15
CAMPECHE,4,ESCÁRCEGA,009,ALTAMIRA DE ZINÁPARO,3,276,131,145,12
CAMPECHE,4,ESCÁRCEGA,009,BELÉN,2,50,26,24,3
CAMPECHE,4,ESCÁRCEGA,009,BENITO JUÁREZ NÚMERO 2 (LA POLLA),3,152,74,78,7
CAMPECHE,4,ESCÁRCEGA,009,BENITO JUÁREZ NÚMERO 3,3,82,45,37,5
CAMPECHE,4,ESCÁRCEGA,009,CENTENARIO,3,355,174,181,21
CAMPECHE,4,ESCÁRCEGA,009,CHAN LAGUNA,3,134,63,71,7
CAMPECHE,4,ESCÁRCEGA,009,COLONIA SAN FRANCISCO (EL CINCO),2,28,10,18,2
CAMPECHE,4,ESCÁRCEGA,009,DIVISIÓN DEL NORTE,4,774,382,392,44
CAMPECHE,4,ESCÁRCEGA,009,DON SAMUEL,4,531,266,265,25
CAMPECHE,4,ESCÁRCEGA,009,EL CORRIENTAL,2,10,5,5,2
CAMPECHE,4,ESCÁRCEGA,009,EL GALLO,2,49,25,24,3
CAMPECHE,4,ESCÁRCEGA,009,EL HUIRO,3,97,44,53,5
CAMPECHE,4,ESCÁRCEGA,009,EL JOBAL,3,42,24,18,3
CAMPECHE,4,ESCÁRCEGA,009,EL LECHUGAL,3,155,71,84,11
CAMPECHE,4,ESCÁRCEGA,009,ESCÁRCEGA,52,9822,5040,4782,640
CAMPECHE,4,ESCÁRCEGA,009,FLOR DE CHIAPAS,3,91,40,51,5
CAMPECHE,4,ESCÁRCEGA,009,FRANCISCO I. MADERO,2,66,25,41,3
CAMPECHE,4,ESCÁRCEGA,009,GENERAL RODOLFO FIERROS,2,18,9,9,2
CAMPECHE,4,ESCÁRCEGA,009,GUADALAJARA,2,20,13,7,2
CAMPECHE,4,ESCÁRCEGA,009,HARO,3,258,122,136,13
CAMPECHE,4,ESCÁRCEGA,009,JOSÉ DE LA CRUZ BLANCO,3,337,175,162,13
CAMPECHE,4,ESCÁRCEGA,009,JOSÉ LÓPEZ PORTILLO,3,100,50,50,6
CAMPECHE,4,ESCÁRCEGA,009,JUAN DE LA BARRERA,3,56,26,30,4
CAMPECHE,4,ESCÁRCEGA,009,JUAN ESCUTIA,2,59,36,23,3
CAMPECHE,4,ESCÁRCEGA,009,JUSTICIA SOCIAL,3,178,89,89,11
CAMPECHE,4,ESCÁRCEGA,009,KILÓMETRO SETENTA Y CUATRO,3,103,49,54,6
CAMPECHE,4,ESCÁRCEGA,009,KILÓMETRO TREINTA Y SEIS,3,186,85,101,11
CAMPECHE,4,ESCÁRCEGA,009,LA ASUNCIÓN,3,72,38,34,5
CAMPECHE,4,ESCÁRCEGA,009,LA CHIQUITA,2,51,29,22,3
CAMPECHE,4,ESCÁRCEGA,009,LA ESPERANZA,2,30,12,18,2
CAMPECHE,4,ESCÁRCEGA,009,LA FLOR,1,36,12,24,2
CAMPECHE,4,ESCÁRCEGA,009,LA JERINGA,2,52,28,24,4
CAMPECHE,4,ESCÁRCEGA,009,LA LIBERTAD,4,555,267,288,32
CAMPECHE,4,ESCÁRCEGA,009,LA VICTORIA,4,312,155,157,15
CAMPECHE,4,ESCÁRCEGA,009,LAGUNA GRANDE,4,341,170,171,16
CAMPECHE,4,ESCÁRCEGA,009,LAS MARAVILLAS,2,21,14,7,2
CAMPECHE,4,ESCÁRCEGA,009,LICENCIADO ANDRÉS MANUEL LÓPEZ OBRADOR,1,3,1,2,1
CAMPECHE,4,ESCÁRCEGA,009,LUNA,3,185,86,99,11
CAMPECHE,4,ESCÁRCEGA,009,MATAMOROS,3,388,201,187,21
CAMPECHE,4,ESCÁRCEGA,009,MIGUEL DE LA MADRID,2,54,22,32,4
CAMPECHE,4,ESCÁRCEGA,009,MIGUEL HIDALGO (CARACOL),3,71,36,35,5
CAMPECHE,4,ESCÁRCEGA,009,MIGUEL HIDALGO Y COSTILLA,2,211,120,91,9
CAMPECHE,4,ESCÁRCEGA,009,NUEVO CAMPECHE (TRES AGUADAS),3,124,62,62,7
CAMPECHE,4,ESCÁRCEGA,009,NUEVO PROGRESO DOS,3,177,78,99,9
CAMPECHE,4,ESCÁRCEGA,009,SAN JOSÉ,2,28,11,17,2
CAMPECHE,4,ESCÁRCEGA,009,SANTA ISABEL,3,12,10,2,3
CAMPECHE,4,ESCÁRCEGA,009,SANTA MARTHA (EL NARANJITO),1,5,1,4,1
CAMPECHE,4,ESCÁRCEGA,009,SILVITUC,2,224,103,121,8
CAMPECHE,4,CALAKMUL,010,BECÁN,3,72,36,36,5
CAMPECHE,4,CALAKMUL,010,BEL-HÁ,3,60,34,26,4
CAMPECHE,4,CALAKMUL,010,BELLA UNIÓN VERACRUZ (LOS CHINOS),4,47,22,25,4
CAMPECHE,4,CALAKMUL,010,CAÑA BRAVA,4,76,34,42,6
CAMPECHE,4,CALAKMUL,010,CENTAUROS DEL NORTE,3,88,37,51,6
CAMPECHE,4,CALAKMUL,010,CONCEPCIÓN,2,60,37,23,3
CAMPECHE,4,CALAKMUL,010,CONSTITUCIÓN,4,464,249,215,21
CAMPECHE,4,CALAKMUL,010,CRISTÓBAL COLÓN,3,71,28,43,4
CAMPECHE,4,CALAKMUL,010,DOS LAGUNAS,3,78,32,46,4
CAMPECHE,4,CALAKMUL,010,DOS NACIONES,4,118,64,54,7
CAMPECHE,4,CALAKMUL,010,EL CARMEN II (LAS CARMELAS),5,215,102,113,14
CAMPECHE,4,CALAKMUL,010,EL CHICHONAL,2,32,18,14,2
CAMPECHE,4,CALAKMUL,010,EL MANANTIAL,4,161,79,82,9
CAMPECHE,4,CALAKMUL,010,EL REFUGIO,2,30,11,19,2
CAMPECHE,4,CALAKMUL,010,EL TESORO,5,206,107,99,14
CAMPECHE,4,CALAKMUL,010,EMILIANO ZAPATA,2,17,6,11,2
CAMPECHE,4,CALAKMUL,010,EUGENIO ECHEVERRÍA CASTELLOT (EL CARRIZAL),2,42,25,17,3
CAMPECHE,4,CALAKMUL,010,FELIPE ÁNGELES II,3,21,7,14,3
CAMPECHE,4,CALAKMUL,010,GUSTAVO DÍAZ ORDAZ (SAN ANTONIO SODA),4,181,80,101,8
CAMPECHE,4,CALAKMUL,010,HERIBERTO JARA CORONA,4,128,66,62,6
CAMPECHE,4,CALAKMUL,010,INGENIERO EUGENIO ECHEVERRÍA CASTELLOT,4,53,20,33,5
CAMPECHE,4,CALAKMUL,010,INGENIERO RICARDO PAYRO JENE (POLO NORTE),4,209,95,114,11
CAMPECHE,4,CALAKMUL,010,JOSÉ MARÍA MORELOS Y PAVÓN (CIVALITO),1,81,37,44,6
CAMPECHE,4,CALAKMUL,010,JOSEFA ORTÍZ DE DOMÍNGUEZ (ICAICHÉ),3,34,16,18,3
CAMPECHE,4,CALAKMUL,010,KILÓMETRO CIENTO VEINTE,3,28,17,11,5
CAMPECHE,4,CALAKMUL,010,LA GUADALUPE,4,122,62,60,8
CAMPECHE,4,CALAKMUL,010,LA LUCHA,4,63,28,35,5
CAMPECHE,4,CALAKMUL,010,LA VICTORIA,3,72,35,37,4
CAMPECHE,4,CALAKMUL,010,LA VIRGENCITA DE LA CANDELARIA,4,144,62,82,8
CAMPECHE,4,CALAKMUL,010,LÁZARO CÁRDENAS NÚMERO 2 (OJO DE AGUA),3,88,39,49,5
CAMPECHE,4,CALAKMUL,010,LEY DE FOMENTO AGROPECUARIO (LA MISTERIOSA),4,189,90,99,8
CAMPECHE,4,CALAKMUL,010,LOS ALACRANES,2,29,11,18,2
CAMPECHE,4,CALAKMUL,010,LOS ÁNGELES,2,50,17,33,4
CAMPECHE,4,CALAKMUL,010,MANUEL CASTILLA BRITO,4,156,76,80,9
CAMPECHE,4,CALAKMUL,010,NARCIZO MENDOZA,4,195,93,102,9
CAMPECHE,4,CALAKMUL,010,NIÑOS HÉROES,3,66,34,32,4
CAMPECHE,4,CALAKMUL,010,NUEVA VIDA,3,140,77,63,7
CAMPECHE,4,CALAKMUL,010,NUEVO BÉCAL (EL 19),4,167,78,89,8
CAMPECHE,4,CALAKMUL,010,NUEVO CAMPANARIO,3,101,59,42,6
CAMPECHE,4,CALAKMUL,010,NUEVO CONHUÁS,3,236,128,108,12
CAMPECHE,4,CALAKMUL,010,NUEVO PROGRESO,3,18,13,5,2
CAMPECHE,4,CALAKMUL,010,NUEVO SAN JOSÉ,3,83,40,43,5
CAMPECHE,4,CALAKMUL,010,ONCE DE MAYO,4,94,50,44,6
CAMPECHE,4,CALAKMUL,010,PABLO GARCÍA,2,181,84,97,9
CAMPECHE,4,CALAKMUL,010,PIONEROS DEL RÍO XNOHÁ,3,83,50,33,5
CAMPECHE,4,CALAKMUL,010,PUEBLA DE MORELIA,3,45,27,18,3
CAMPECHE,4,CALAKMUL,010,QUICHÉ DE LAS PAILAS,4,118,57,61,7
CAMPECHE,4,CALAKMUL,010,RICARDO FLORES MAGÓN (LAGUNA COOXLÍ),4,115,55,60,6
CAMPECHE,4,CALAKMUL,010,SAN MIGUEL,4,42,21,21,4
CAMPECHE,4,CALAKMUL,010,SANTA LUCÍA,2,49,29,20,3
CAMPECHE,4,CALAKMUL,010,SANTA ROSA,2,41,21,20,3
CAMPECHE,4,CALAKMUL,010,SANTO DOMINGO (EL SACRIFICIO),4,234,118,116,12
CAMPECHE,4,CALAKMUL,010,TOMÁS AZNAR BARBACHANO (LA MOZA),2,24,15,9,2
CAMPECHE,4,CALAKMUL,010,UNIDAD Y TRABAJO,3,33,20,13,3
CAMPECHE,4,CALAKMUL,010,UNIÓN 20 DE JUNIO (MANCOLONA),4,223,108,115,12
CAMPECHE,4,CALAKMUL,010,VALENTÍN GÓMEZ FARÍAS,3,89,54,35,6
CAMPECHE,4,CALAKMUL,010,VEINTE DE NOVIEMBRE,3,99,37,62,5
CAMPECHE,4,CALAKMUL,010,VEINTIUNO DE MAYO (LECHUGAL),1,8,7,1,1
CAMPECHE,4,CALAKMUL,010,XBONIL,3,146,66,80,8
CAMPECHE,4,CALAKMUL,010,XPUJIL,12,3118,1621,1497,156
CAMPECHE,4,CALAKMUL,010,ZOH-LAGUNA (ÁLVARO OBREGÓN),4,423,220,203,33
CAMPECHE,4,CANDELARIA,011,ADOLFO LÓPEZ MATEOS,3,41,18,23,3
CAMPECHE,4,CANDELARIA,011,AGUA AZUL,3,118,58,60,6
CAMPECHE,4,CANDELARIA,011,AGUAS MALAS (TRES CRUCES),2,19,13,6,2
CAMPECHE,4,CANDELARIA,011,ALIANZA PRODUCTORA,3,56,33,23,4
CAMPECHE,4,CANDELARIA,011,ARROYO DE CUBA,3,35,15,20,3
CAMPECHE,4,CANDELARIA,011,ARROYO DEL JULUBAL,1,17,7,10,1
CAMPECHE,4,CANDELARIA,011,ARROYO SAN JUAN (LAS GOLONDRINAS),3,142,66,76,8
CAMPECHE,4,CANDELARIA,011,ARROYO VEINTICUATRO DE MAYO,3,44,23,21,4
CAMPECHE,4,CANDELARIA,011,BALANCANCITO,3,24,10,14,3
CAMPECHE,4,CANDELARIA,011,BALANKAX,3,33,17,16,4
CAMPECHE,4,CANDELARIA,011,BENITO JUÁREZ UNO,3,338,200,138,19
CAMPECHE,4,CANDELARIA,011,CANDELARIA,19,3492,1771,1721,202
CAMPECHE,4,CANDELARIA,011,CARLOS SANSORES PÉREZ (LA PAZ),3,35,22,13,3
CAMPECHE,4,CANDELARIA,011,CHAMPAS QUEMADAS,3,11,2,9,3
CAMPECHE,4,CANDELARIA,011,CHILAM BALAM,3,88,37,51,5
CAMPECHE,4,CANDELARIA,011,CORTE PAJARAL,3,53,27,26,4
CAMPECHE,4,CANDELARIA,011,CUAUHTÉMOC,2,48,24,24,4
CAMPECHE,4,CANDELARIA,011,EL CAYUCO,1,5,2,3,1
CAMPECHE,4,CANDELARIA,011,EL CHECHENAL,3,18,8,10,3
CAMPECHE,4,CANDELARIA,011,EL CHILAR,3,66,35,31,5
CAMPECHE,4,CANDELARIA,011,EL DESENGAÑO,4,545,287,258,22
CAMPECHE,4,CANDELARIA,011,EL DESTINO,1,4,1,3,1
CAMPECHE,4,CANDELARIA,011,EL ENCANTO,3,52,23,29,4
CAMPECHE,4,CANDELARIA,011,EL ENCANTO 2,2,35,19,16,3
CAMPECHE,4,CANDELARIA,011,EL FANTASMA (LOS CHILEROS),2,18,8,10,1
CAMPECHE,4,CANDELARIA,011,EL MACHETAZO,3,72,45,27,5
CAMPECHE,4,CANDELARIA,011,EL MAMEY,3,72,36,36,4
CAMPECHE,4,CANDELARIA,011,EL MIRADOR PRIMERO,3,94,53,41,6
CAMPECHE,4,CANDELARIA,011,EL NARANJO,4,328,161,167,17
CAMPECHE,4,CANDELARIA,011,EL NUEVO PARAGUAS,2,22,9,13,2
CAMPECHE,4,CANDELARIA,011,EL PARAGUAS,3,87,26,61,5
CAMPECHE,4,CANDELARIA,011,EL PEDREGAL,3,109,50,59,7
CAMPECHE,4,CANDELARIA,011,EL PIMIENTAL DOS,3,72,35,37,6
CAMPECHE,4,CANDELARIA,011,EL POCITO,3,114,52,62,6
CAMPECHE,4,CANDELARIA,011,EL PORVENIR,3,95,51,44,6
CAMPECHE,4,CANDELARIA,011,EL PORVENIR EL PUEBLO INDÍGENA,3,27,11,16,4
CAMPECHE,4,CANDELARIA,011,EL RAMONAL,2,49,25,24,3
CAMPECHE,4,CANDELARIA,011,EL RAMONAL II (LOS MANGUITOS),1,7,1,6,1
CAMPECHE,4,CANDELARIA,011,EL SACRIFICIO II,3,13,6,7,2
CAMPECHE,4,CANDELARIA,011,EL TABLÓN,3,61,35,26,4
CAMPECHE,4,CANDELARIA,011,EL TAZIZTAL,3,30,14,16,3
CAMPECHE,4,CANDELARIA,011,EL TIGRE,3,34,16,18,4
CAMPECHE,4,CANDELARIA,011,EL TRIUNFO (LOS TOCHOS),2,5,1,4,2
CAMPECHE,4,CANDELARIA,011,EL TULIPÁN (EL IMPOSIBLE),2,26,13,13,2
CAMPECHE,4,CANDELARIA,011,EMILIANO ZAPATA,3,91,47,44,5
CAMPECHE,4,CANDELARIA,011,EMILIANO ZAPATA III,3,87,40,47,5
CAMPECHE,4,CANDELARIA,011,ESPERANZA,3,60,34,26,4
CAMPECHE,4,CANDELARIA,011,ESTADO DE MÉXICO,3,77,41,36,6
CAMPECHE,4,CANDELARIA,011,ESTRELLA DEL SUR,3,96,43,53,6
CAMPECHE,4,CANDELARIA,011,FLOR DE CHIAPAS,3,97,47,50,7
CAMPECHE,4,CANDELARIA,011,FRANCISCO I. MADERO,3,60,31,29,5
CAMPECHE,4,CANDELARIA,011,GENERAL FRANCISCO J. MÚJICA,4,451,219,232,52
CAMPECHE,4,CANDELARIA,011,HÉCTOR PÉREZ MORALES,2,44,18,26,3
CAMPECHE,4,CANDELARIA,011,HERMANOS CRUZ,2,6,5,1,2
CAMPECHE,4,CANDELARIA,011,IGNACIO ZARAGOZA (EL SALVAJE),3,97,51,46,6
CAMPECHE,4,CANDELARIA,011,ISLA DEL PARAÍSO,3,83,40,43,4
CAMPECHE,4,CANDELARIA,011,JUSTO SIERRA MÉNDEZ,3,108,57,51,8
CAMPECHE,4,CANDELARIA,011,LA ESMERALDA,4,240,124,116,13
CAMPECHE,4,CANDELARIA,011,LA ESPERANCITA,2,16,8,8,2
CAMPECHE,4,CANDELARIA,011,LA FLORIDA (EL CUATRO),3,33,20,13,4
CAMPECHE,4,CANDELARIA,011,LA FLORIDA TRES,1,3,2,1,1
CAMPECHE,4,CANDELARIA,011,LA FORTUNA,1,6,1,5,1
CAMPECHE,4,CANDELARIA,011,LA ILUSIÓN,1,6,3,3,1
CAMPECHE,4,CANDELARIA,011,LA LUCHA,3,38,17,21,3
CAMPECHE,4,CANDELARIA,011,LA MISTERIOSA,3,82,45,37,5
CAMPECHE,4,CANDELARIA,011,LA NUEVA LUCHA,2,36,20,16,3
CAMPECHE,4,CANDELARIA,011,LA OLLA,3,60,32,28,4
CAMPECHE,4,CANDELARIA,011,LA PELUSA,2,16,8,8,2
CAMPECHE,4,CANDELARIA,011,LA PEREGRINA,3,136,74,62,5
CAMPECHE,4,CANDELARIA,011,LA TIGRA,3,23,13,10,3
CAMPECHE,4,CANDELARIA,011,LA TÓMBOLA,3,70,39,31,5
CAMPECHE,4,CANDELARIA,011,LA UNIÓN (DOS ARROYOS),3,66,27,39,3
CAMPECHE,4,CANDELARIA,011,LA ZANJA (LA PALMA),3,29,19,10,3
CAMPECHE,4,CANDELARIA,011,LAGUNA DE ORO,3,34,14,20,3
CAMPECHE,4,CANDELARIA,011,LAGUNA LA PERDIDA,3,84,38,46,5
CAMPECHE,4,CANDELARIA,011,LAGUNA LAS ISABELES,2,8,3,5,2
CAMPECHE,4,CANDELARIA,011,LAS DELICIAS,2,79,37,42,4
CAMPECHE,4,CANDELARIA,011,LAS GOLONDRINAS,2,132,59,73,8
CAMPECHE,4,CANDELARIA,011,LAS MARAVILLAS 1 [CAMPO MENONITA],1,29,16,13,2
CAMPECHE,4,CANDELARIA,011,LÁZARO CÁRDENAS,2,92,49,43,5
CAMPECHE,4,CANDELARIA,011,LICENCIADO JOSÉ ANTONIO GONZÁLEZ CURI,3,30,20,10,3
CAMPECHE,4,CANDELARIA,011,LOS CARDENALES,1,4,3,1,1
CAMPECHE,4,CANDELARIA,011,LOS LAURELES DOS,1,6,4,2,1
CAMPECHE,4,CANDELARIA,011,LUINAL,2,39,21,18,3
CAMPECHE,4,CANDELARIA,011,MIGUEL ALEMÁN,3,278,133,145,13
CAMPECHE,4,CANDELARIA,011,MIGUEL DE LA MADRID (EL PAÑUELO),3,175,85,90,9
CAMPECHE,4,CANDELARIA,011,MIGUEL HIDALGO Y COSTILLA,4,655,335,320,72
CAMPECHE,4,CANDELARIA,011,MONCLOVA,3,93,47,46,7
CAMPECHE,4,CANDELARIA,011,NUEVA DELICIAS II,3,61,31,30,4
CAMPECHE,4,CANDELARIA,011,NUEVA ESPERANZA,3,129,59,70,8
CAMPECHE,4,CANDELARIA,011,NUEVA ROSITA,3,172,81,91,11
CAMPECHE,4,CANDELARIA,011,NUEVA ROSITA II,3,46,20,26,4
CAMPECHE,4,CANDELARIA,011,NUEVAS DELICIAS I,3,33,18,15,4
CAMPECHE,4,CANDELARIA,011,NUEVO COAHUILA,2,82,40,42,4
CAMPECHE,4,CANDELARIA,011,NUEVO COMALCALCO,3,82,47,35,4
CAMPECHE,4,CANDELARIA,011,NUEVO COMALCALCO II,2,20,9,11,2
CAMPECHE,4,CANDELARIA,011,NUEVO RELÁMPAGO,1,3,2,1,1
CAMPECHE,4,CANDELARIA,011,NUEVO TABASCO,3,74,41,33,5
CAMPECHE,4,CANDELARIA,011,PABLO GARCÍA,4,197,92,105,14
CAMPECHE,4,CANDELARIA,011,PABLO TORRES BURGOS,3,85,40,45,6
CAMPECHE,4,CANDELARIA,011,PARAÍSO NUEVO,3,82,33,49,6
CAMPECHE,4,CANDELARIA,011,PEDRO BARANDA,2,65,30,35,4
CAMPECHE,4,CANDELARIA,011,PEJELAGARTO,3,217,106,111,11
CAMPECHE,4,CANDELARIA,011,PRIMER PRESIDENTE DE MÉXICO (GUADALUPE VICTORIA),3,72,36,36,6
CAMPECHE,4,CANDELARIA,011,PULGUERO II,1,6,3,3,1
CAMPECHE,4,CANDELARIA,011,RÍO CARIBE (CARIBE),2,99,54,45,4
CAMPECHE,4,CANDELARIA,011,SAN ANTONIO,1,9,7,2,1
CAMPECHE,4,CANDELARIA,011,SAN ANTONIO NÚMERO 2,3,55,24,31,4
CAMPECHE,4,CANDELARIA,011,SAN DIMAS,2,82,40,42,4
CAMPECHE,4,CANDELARIA,011,SAN FERNANDO,3,16,4,12,3
CAMPECHE,4,CANDELARIA,011,SAN GABRIEL,1,5,3,2,1
CAMPECHE,4,CANDELARIA,011,SAN JOSÉ DE LAS MONTAÑAS,4,198,100,98,11
CAMPECHE,4,CANDELARIA,011,SAN JUAN,3,112,54,58,7
CAMPECHE,4,CANDELARIA,011,SAN MANUEL NUEVO CANUTILLO,3,111,58,53,6
CAMPECHE,4,CANDELARIA,011,SAN MIGUEL,3,140,72,68,8
CAMPECHE,4,CANDELARIA,011,SAN RAFAEL DEL RÍO CARIBE,1,5,1,4,1
CAMPECHE,4,CANDELARIA,011,SAN ROMÁN,3,53,25,28,4
CAMPECHE,4,CANDELARIA,011,SANTA LUCÍA,3,78,41,37,5
CAMPECHE,4,CANDELARIA,011,SANTA ROSA,2,54,30,24,3
CAMPECHE,4,CANDELARIA,011,SANTO DOMINGO,2,30,17,13,3
CAMPECHE,4,CANDELARIA,011,SANTO DOMINGO (EL CUYO),2,3,1,2,2
CAMPECHE,4,CANDELARIA,011,SOLIDARIDAD,2,33,15,18,2
CAMPECHE,4,CANDELARIA,011,TENANCINGO,1,15,6,9,1
CAMPECHE,4,CANDELARIA,011,TRES DE MAYO DOS,2,6,4,2,2
CAMPECHE,4,CANDELARIA,011,TRES DE MAYO TRES,3,38,19,19,4
CAMPECHE,4,CANDELARIA,011,TRES PIEDRAS,3,45,21,24,4
CAMPECHE,4,CANDELARIA,011,TRES REYES,2,19,8,11,2
CAMPECHE,4,CANDELARIA,011,VENUSTIANO CARRANZA,3,207,113,94,11
CAMPECHE,4,CANDELARIA,011,VICENTE GUERRERO,3,68,34,34,5
CAMPECHE,4,CANDELARIA,011,VICENTE LOMBARDO TOLEDANO,3,54,28,26,4
CAMPECHE,4,SEYBAPLAYA,012,SEYBAPLAYA,13,2265,1123,1142,92
CAMPECHE,4,SEYBAPLAYA,012,VILLA MADERO,4,940,479,461,46
CAMPECHE,4,SEYBAPLAYA,012,XKEULIL,3,182,93,89,11
CAMPECHE,4,DZITBALCHÉ,013,BACABCHÉN,5,773,392,381,31
CAMPECHE,4,DZITBALCHÉ,013,DZITBALCHÉ,20,3611,1792,1819,226
CAMPECHE,4,DZITBALCHÉ,013,XBILINCOC,2,15,6,9,2
CHIAPAS,7,ACACOYAGUA,001,ACACOYAGUA,15,2713,1396,1317,137
CHIAPAS,7,ACACOYAGUA,001,BUENAVISTA,1,8,3,5,1
CHIAPAS,7,ACACOYAGUA,001,BUENOS AIRES,1,6,3,3,1
CHIAPAS,7,ACACOYAGUA,001,CONSTITUCIÓN,3,112,51,61,6
CHIAPAS,7,ACACOYAGUA,001,DIEZ DE ABRIL (TEXCOCO),1,8,2,6,1
CHIAPAS,7,ACACOYAGUA,001,EL CASTAÑO,2,89,40,49,5
CHIAPAS,7,ACACOYAGUA,001,EL TUMBADOR,2,20,12,8,2
CHIAPAS,7,ACACOYAGUA,001,EMILIANO ZAPATA (PUERTO ARTURO),2,13,2,11,2
CHIAPAS,7,ACACOYAGUA,001,FLOR DEL CARMEN UNO,2,31,12,19,2
CHIAPAS,7,ACACOYAGUA,001,HIDALGO,3,334,167,167,15
CHIAPAS,7,ACACOYAGUA,001,HUISISIL DOS,2,18,8,10,2
CHIAPAS,7,ACACOYAGUA,001,HUISISIL UNO,2,29,18,11,2
CHIAPAS,7,ACACOYAGUA,001,JALAPA,2,178,79,99,8
CHIAPAS,7,ACACOYAGUA,001,LA ARGENTINA,3,42,23,19,4
CHIAPAS,7,ACACOYAGUA,001,LA CADENA,1,11,3,8,1
CHIAPAS,7,ACACOYAGUA,001,LA NUEVA ESPERANZA,2,16,10,6,2
CHIAPAS,7,ACACOYAGUA,001,LA VIOLETA,3,28,17,11,4
CHIAPAS,7,ACACOYAGUA,001,LAGUNA ARENAL,2,21,11,10,2
CHIAPAS,7,ACACOYAGUA,001,LAGUNAS,3,52,25,27,5
CHIAPAS,7,ACACOYAGUA,001,LAS BRISAS,1,20,14,6,1
CHIAPAS,7,ACACOYAGUA,001,LAS CADENAS,1,27,9,18,1
CHIAPAS,7,ACACOYAGUA,001,LAS CRUCES,1,10,7,3,1
CHIAPAS,7,ACACOYAGUA,001,LAS GOLONDRINAS,2,68,38,30,3
CHIAPAS,7,ACACOYAGUA,001,LAS LIMAS,1,10,6,4,1
CHIAPAS,7,ACACOYAGUA,001,LOS AMATES,2,145,73,72,6
CHIAPAS,7,ACACOYAGUA,001,LOS ANDES DE ZAPATA,2,27,4,23,2
CHIAPAS,7,ACACOYAGUA,001,LOS CACAOS,4,418,183,235,18
CHIAPAS,7,ACACOYAGUA,001,MAGNOLIA,2,29,16,13,2
CHIAPAS,7,ACACOYAGUA,001,MARÍA ESTHER ZUNO DE ECHEVERRÍA,3,117,52,65,6
CHIAPAS,7,ACACOYAGUA,001,NUEVA ALIANZA,2,19,8,11,2
CHIAPAS,7,ACACOYAGUA,001,NUEVA LIBERTAD,4,260,130,130,16
CHIAPAS,7,ACACOYAGUA,001,NUEVA REFORMA,3,168,75,93,8
CHIAPAS,7,ACACOYAGUA,001,PLAYA INÉS SECCIÓN UNO,1,41,15,26,2
CHIAPAS,7,ACACOYAGUA,001,QUINCE DE SEPTIEMBRE,2,38,25,13,3
CHIAPAS,7,ACACOYAGUA,001,ROSARIO ZACATONAL,3,47,26,21,4
CHIAPAS,7,ACACOYAGUA,001,SAN PEDRO,1,9,5,4,1
CHIAPAS,7,ACACOYAGUA,001,SANTA ANITA,2,42,25,17,3
CHIAPAS,7,ACACOYAGUA,001,SATÉLITE MORELIA,2,31,18,13,2
CHIAPAS,7,ACACOYAGUA,001,VÍCTOR MANUEL CASTILLO (ESPAÑA),2,11,6,5,2
CHIAPAS,7,ACALA,002,ACALA,19,3337,1684,1653,165
CHIAPAS,7,ACALA,002,ADOLFO LÓPEZ MATEOS,4,159,81,78,10
CHIAPAS,7,ACALA,002,BELÉN,1,65,38,27,2
CHIAPAS,7,ACALA,002,EL CHILAR,2,27,12,15,3
CHIAPAS,7,ACALA,002,EL PAQUESCH,3,497,265,232,12
CHIAPAS,7,ACALA,002,EL RECREO,1,5,2,3,1
CHIAPAS,7,ACALA,002,EL ROSARITO,2,36,22,14,2
CHIAPAS,7,ACALA,002,FRONTERA DE GRIJALVA,1,12,5,7,1
CHIAPAS,7,ACALA,002,LAGARTERO,1,4,2,2,1
CHIAPAS,7,ACALA,002,LAS MINAS,3,43,19,24,4
CHIAPAS,7,ACALA,002,MONTE DE LOS OLIVOS,3,89,41,48,5
CHIAPAS,7,ACALA,002,MONTE SINAÍ,3,30,19,11,3
CHIAPAS,7,ACALA,002,NUEVA LIBERTAD,3,27,9,18,3
CHIAPAS,7,ACALA,002,NUEVO ALTAMIRA,1,11,6,5,1
CHIAPAS,7,ACALA,002,RIZO DE ORO,2,54,27,27,3
CHIAPAS,7,ACALA,002,ROBERTO ALBORES GUILLÉN,1,23,9,14,2
CHIAPAS,7,ACALA,002,SAN JOSÉ DE JESÚS,2,18,13,5,2
CHIAPAS,7,ACALA,002,SAN PEDRO NICHI,3,90,39,51,19
CHIAPAS,7,ACALA,002,SAN PEDRO PEDERNAL,2,67,35,32,4
CHIAPAS,7,ACALA,002,SANTA ROSA,1,35,23,12,2
CHIAPAS,7,ACALA,002,UNIÓN BUENAVISTA,4,417,194,223,20
CHIAPAS,7,ACAPETAHUA,003,ABSALÓN CASTELLANOS DOMÍNGUEZ,4,451,235,216,18
CHIAPAS,7,ACAPETAHUA,003,ACAPETAHUA,14,2872,1592,1280,174
CHIAPAS,7,ACAPETAHUA,003,BARRA ZACAPULCO,3,146,82,64,7
CHIAPAS,7,ACAPETAHUA,003,BARRIO NUEVO,2,90,38,52,4
CHIAPAS,7,ACAPETAHUA,003,BENITO JUÁREZ,1,12,9,3,1
CHIAPAS,7,ACAPETAHUA,003,CENTAURO DEL NORTE,2,38,19,19,3
CHIAPAS,7,ACAPETAHUA,003,COLOMBIA,3,131,62,69,7
CHIAPAS,7,ACAPETAHUA,003,CONSUELO ULAPA,4,512,264,248,22
CHIAPAS,7,ACAPETAHUA,003,EL ARENAL,3,399,169,230,17
CHIAPAS,7,ACAPETAHUA,003,EL CHILAR,3,40,18,22,4
CHIAPAS,7,ACAPETAHUA,003,EL COROSAL,2,28,14,14,3
CHIAPAS,7,ACAPETAHUA,003,EL HERRADO,3,12,4,8,3
CHIAPAS,7,ACAPETAHUA,003,EL MADRONAL,2,106,54,52,5
CHIAPAS,7,ACAPETAHUA,003,EL PATASTE,1,18,8,10,2
CHIAPAS,7,ACAPETAHUA,003,EL PROGRESO,2,38,17,21,3
CHIAPAS,7,ACAPETAHUA,003,EMBARCADERO LAS GARZAS,1,10,7,3,1
CHIAPAS,7,ACAPETAHUA,003,FRACCIÓN DOÑA MARÍA,1,27,13,14,1
CHIAPAS,7,ACAPETAHUA,003,FRANCISCO VILLA,2,39,23,16,2
CHIAPAS,7,ACAPETAHUA,003,JIQUILPAN (ESTACIÓN BONANZA),5,526,286,240,32
CHIAPAS,7,ACAPETAHUA,003,JIQUILPAN (NUEVO MILENIO),1,4,2,2,2
CHIAPAS,7,ACAPETAHUA,003,JIQUILPAN (RANCHO QUEMADO),3,82,44,38,6
CHIAPAS,7,ACAPETAHUA,003,LA ESMERALDA,2,37,11,26,3
CHIAPAS,7,ACAPETAHUA,003,LA LUPE,2,30,12,18,2
CHIAPAS,7,ACAPETAHUA,003,LA NUEVA ESPERANZA,2,46,21,25,3
CHIAPAS,7,ACAPETAHUA,003,LA PALMA,4,124,63,61,9
CHIAPAS,7,ACAPETAHUA,003,LA SOLEDAD,1,8,3,5,1
CHIAPAS,7,ACAPETAHUA,003,LAS CRUCES,2,202,99,103,9
CHIAPAS,7,ACAPETAHUA,003,LAS GARZAS,1,18,10,8,1
CHIAPAS,7,ACAPETAHUA,003,LAS LAURAS,3,95,53,42,5
CHIAPAS,7,ACAPETAHUA,003,LAS MERCEDES,2,52,25,27,3
CHIAPAS,7,ACAPETAHUA,003,LAS MORENAS,1,27,15,12,2
CHIAPAS,7,ACAPETAHUA,003,LAS MURALLAS,4,170,77,93,9
CHIAPAS,7,ACAPETAHUA,003,LOS CERRITOS,2,45,19,26,3
CHIAPAS,7,ACAPETAHUA,003,LUIS ESPINOZA,3,187,90,97,9
CHIAPAS,7,ACAPETAHUA,003,MARIANO MATAMOROS,4,469,244,225,20
CHIAPAS,7,ACAPETAHUA,003,NUÑEZ,1,19,11,8,1
CHIAPAS,7,ACAPETAHUA,003,ONCE DE MARZO,1,21,9,12,1
CHIAPAS,7,ACAPETAHUA,003,PALO BLANCO,1,16,5,11,1
CHIAPAS,7,ACAPETAHUA,003,PALOMA BLANCA,1,11,5,6,1
CHIAPAS,7,ACAPETAHUA,003,QUINCE DE ABRIL,2,38,19,19,2
CHIAPAS,7,ACAPETAHUA,003,QUINCE DE JUNIO DOS,2,10,5,5,2
CHIAPAS,7,ACAPETAHUA,003,RÍO ARRIBA,3,137,75,62,8
CHIAPAS,7,ACAPETAHUA,003,RÍO NEGRO,2,40,22,18,3
CHIAPAS,7,ACAPETAHUA,003,SAN JOSÉ,1,8,3,5,1
CHIAPAS,7,ACAPETAHUA,003,SAN JOSÉ AGUAJAL,2,39,22,17,2
CHIAPAS,7,ACAPETAHUA,003,SANTA ELENA (LA ESPERANZA),2,47,21,26,4
CHIAPAS,7,ACAPETAHUA,003,SOCONUSCO,5,941,463,478,46
CHIAPAS,7,ACAPETAHUA,003,VEINTE DE ABRIL,2,119,58,61,6
CHIAPAS,7,ACAPETAHUA,003,ZACAPULCO,1,17,11,6,1
CHIAPAS,7,ALTAMIRANO,004,12 DE OCTUBRE,2,64,31,33,2
CHIAPAS,7,ALTAMIRANO,004,AGUA ESCONDIDA (RANCHO ALEGRE),3,48,21,27,3
CHIAPAS,7,ALTAMIRANO,004,AGUA ESCONDIDA EL OCOTAL,1,18,8,10,2
CHIAPAS,7,ALTAMIRANO,004,AGUA ESCONDIDA LA FLORINDA,3,81,36,45,3
CHIAPAS,7,ALTAMIRANO,004,AGUA ESCONDIDA LAS ESPERANZAS,2,60,34,26,5
CHIAPAS,7,ALTAMIRANO,004,ALTAMIRANO,21,3361,1664,1697,161
CHIAPAS,7,ALTAMIRANO,004,ANEXO SANTA RITA,1,27,18,9,2
CHIAPAS,7,ALTAMIRANO,004,BELISARIO DOMÍNGUEZ,4,373,177,196,16
CHIAPAS,7,ALTAMIRANO,004,CANDELARIA,3,110,60,50,6
CHIAPAS,7,ALTAMIRANO,004,CARMEN RUSIA,3,166,77,89,8
CHIAPAS,7,ALTAMIRANO,004,CHENCHOJ LA CUMBRE,3,45,22,23,3
CHIAPAS,7,ALTAMIRANO,004,EL ARBOLITO,2,30,12,18,3
CHIAPAS,7,ALTAMIRANO,004,EL CALVARIO,1,6,2,4,1
CHIAPAS,7,ALTAMIRANO,004,EL NANCE,2,75,42,33,3
CHIAPAS,7,ALTAMIRANO,004,EL NUEVO JARDÍN,1,25,13,12,1
CHIAPAS,7,ALTAMIRANO,004,EL OCOTAL,2,40,24,16,2
CHIAPAS,7,ALTAMIRANO,004,EL ORIENTE,1,21,9,12,2
CHIAPAS,7,ALTAMIRANO,004,EL ORIENTE (CAÑADA DE ÁLVAREZ),1,9,4,5,1
CHIAPAS,7,ALTAMIRANO,004,EL ROSARIO,1,16,11,5,1
CHIAPAS,7,ALTAMIRANO,004,EL SAUCE,1,6,3,3,1
CHIAPAS,7,ALTAMIRANO,004,EL TRIUNFO,3,207,99,108,7
CHIAPAS,7,ALTAMIRANO,004,EMILIANO ZAPATA,2,65,32,33,3
CHIAPAS,7,ALTAMIRANO,004,GETZEMANÍ,2,35,19,16,3
CHIAPAS,7,ALTAMIRANO,004,GUADALUPE VICTORIA,2,90,42,48,3
CHIAPAS,7,ALTAMIRANO,004,JALISCO,3,244,124,120,12
CHIAPAS,7,ALTAMIRANO,004,JOAQUÍN MIGUEL GUTIÉRREZ (RANCHO MATEO),4,181,76,105,10
CHIAPAS,7,ALTAMIRANO,004,LA FLORIDA,3,188,83,105,7
CHIAPAS,7,ALTAMIRANO,004,LA GRANDEZA,2,158,77,81,4
CHIAPAS,7,ALTAMIRANO,004,LA LAGUNA,4,508,274,234,31
CHIAPAS,7,ALTAMIRANO,004,LA TRINIDAD,3,84,40,44,4
CHIAPAS,7,ALTAMIRANO,004,LAGUNA EL PARAÍSO,1,6,2,4,1
CHIAPAS,7,ALTAMIRANO,004,LAS NUBES,1,12,6,6,1
CHIAPAS,7,ALTAMIRANO,004,LAS PERLAS,3,24,8,16,3
CHIAPAS,7,ALTAMIRANO,004,LINDAVISTA,1,20,11,9,1
CHIAPAS,7,ALTAMIRANO,004,LOS BAMBÚES,2,85,52,33,3
CHIAPAS,7,ALTAMIRANO,004,LUIS ESPINOZA,4,548,264,284,19
CHIAPAS,7,ALTAMIRANO,004,MORELIA (VICTÓRICO RODOLFO GRAJALES),4,552,279,273,26
CHIAPAS,7,ALTAMIRANO,004,NAZARET,2,22,12,10,3
CHIAPAS,7,ALTAMIRANO,004,NUEVA ESPERANZA,2,34,12,22,2
CHIAPAS,7,ALTAMIRANO,004,NUEVA GALILEA,4,227,93,134,10
CHIAPAS,7,ALTAMIRANO,004,NUEVA VIRGINIA,3,250,117,133,10
CHIAPAS,7,ALTAMIRANO,004,NUEVO CENTRO GETZEMANÍ,2,20,8,12,2
CHIAPAS,7,ALTAMIRANO,004,NUEVO JERUSALÉN,2,18,10,8,2
CHIAPAS,7,ALTAMIRANO,004,NUEVO JOAQUÍN MIGUEL GUTIÉRREZ,2,37,20,17,2
CHIAPAS,7,ALTAMIRANO,004,NUEVO SAN CARLOS,3,156,70,86,7
CHIAPAS,7,ALTAMIRANO,004,PALESTINA,2,40,19,21,3
CHIAPAS,7,ALTAMIRANO,004,PUEBLA NUEVO,1,16,8,8,1
CHIAPAS,7,ALTAMIRANO,004,PUEBLA VIEJO,1,29,14,15,1
CHIAPAS,7,ALTAMIRANO,004,PUERTO RICO,4,322,146,176,14
CHIAPAS,7,ALTAMIRANO,004,RANCHO ALEGRE,2,39,21,18,3
CHIAPAS,7,ALTAMIRANO,004,SALTILLO,2,72,36,36,3
CHIAPAS,7,ALTAMIRANO,004,SAN ANTONIO MONTERREY,1,12,7,5,1
CHIAPAS,7,ALTAMIRANO,004,SAN FRANCISCO,4,375,175,200,10
CHIAPAS,7,ALTAMIRANO,004,SAN ISIDRO,1,29,15,14,2
CHIAPAS,7,ALTAMIRANO,004,SAN JOSÉ EL ORIENTE,1,14,7,7,1
CHIAPAS,7,ALTAMIRANO,004,SAN JUAN DEL BOSQUE,2,17,9,8,2
CHIAPAS,7,ALTAMIRANO,004,SAN LUIS POTOSÍ,3,362,186,176,11
CHIAPAS,7,ALTAMIRANO,004,SAN LUIS POTOSÍ DOS,2,50,21,29,4
CHIAPAS,7,ALTAMIRANO,004,SAN MARCOS,2,192,92,100,4
CHIAPAS,7,ALTAMIRANO,004,SAN MIGUEL CHIPTIC,3,203,93,110,7
CHIAPAS,7,ALTAMIRANO,004,SANTA CECILIA,2,34,13,21,3
CHIAPAS,7,ALTAMIRANO,004,SANTA CRUZ,1,7,5,2,1
CHIAPAS,7,ALTAMIRANO,004,SINALOA,2,18,11,7,2
CHIAPAS,7,ALTAMIRANO,004,SOCIEDAD LA VICTORIA,2,69,31,38,3
CHIAPAS,7,ALTAMIRANO,004,TIERRA Y LIBERTAD,2,28,13,15,2
CHIAPAS,7,ALTAMIRANO,004,VENUSTIANO CARRANZA,4,321,141,180,16
CHIAPAS,7,AMATÁN,005,ACAPULCO,2,22,11,11,2
CHIAPAS,7,AMATÁN,005,ADOLFO LÓPEZ MATEOS,2,66,28,38,3
CHIAPAS,7,AMATÁN,005,AMATÁN,12,1415,688,727,64
CHIAPAS,7,AMATÁN,005,ANEXO LA LOMA,2,40,26,14,3
CHIAPAS,7,AMATÁN,005,ANEXO LAS MARGARITAS (SAN MARTÍN),2,57,30,27,4
CHIAPAS,7,AMATÁN,005,ARROYO SECO,2,29,18,11,3
CHIAPAS,7,AMATÁN,005,BENITO JUÁREZ,2,91,38,53,3
CHIAPAS,7,AMATÁN,005,BERLÍN,3,61,37,24,5
CHIAPAS,7,AMATÁN,005,BUENAVISTA,3,67,44,23,5
CHIAPAS,7,AMATÁN,005,BUENOS AIRES (LIMONCITO),2,29,16,13,3
CHIAPAS,7,AMATÁN,005,CAMPO VERDE,1,20,1,19,1
CHIAPAS,7,AMATÁN,005,CARMEN JUCUMA,2,94,49,45,4
CHIAPAS,7,AMATÁN,005,CERRO BLANCO,2,99,50,49,5
CHIAPAS,7,AMATÁN,005,CHASPA,2,25,9,16,3
CHIAPAS,7,AMATÁN,005,CONGREGACIÓN LA LOMA 2DA. SECCIÓN,2,45,22,23,3
CHIAPAS,7,AMATÁN,005,CONSTITUCIÓN,2,53,24,29,3
CHIAPAS,7,AMATÁN,005,EL BELÉN,1,7,3,4,1
CHIAPAS,7,AMATÁN,005,EL CALVARIO,4,463,235,228,18
CHIAPAS,7,AMATÁN,005,EL CARMEN,2,34,17,17,2
CHIAPAS,7,AMATÁN,005,EL CARMEN EL AZUFRE,2,20,13,7,2
CHIAPAS,7,AMATÁN,005,EL CERRITO PUYACATENGO,4,61,25,36,5
CHIAPAS,7,AMATÁN,005,EL CHINAL,2,9,6,3,1
CHIAPAS,7,AMATÁN,005,EL LIMÓN,3,247,107,140,10
CHIAPAS,7,AMATÁN,005,EL MIRADOR (BERLÍN),2,110,48,62,6
CHIAPAS,7,AMATÁN,005,EL NARANJO 1RA.,2,28,12,16,2
CHIAPAS,7,AMATÁN,005,EL NARANJO 2DA. SECCIÓN,3,42,16,26,4
CHIAPAS,7,AMATÁN,005,EL PARAÍSO,2,15,6,9,2
CHIAPAS,7,AMATÁN,005,EL PLATANAR,3,40,19,21,3
CHIAPAS,7,AMATÁN,005,EL PORVENIR TRES PICOS,4,288,133,155,11
CHIAPAS,7,AMATÁN,005,EL PORVENIR TRES PICOS 2DA. SECCIÓN,2,83,36,47,4
CHIAPAS,7,AMATÁN,005,EL REMOLINO,3,85,33,52,6
CHIAPAS,7,AMATÁN,005,EL RETIRO,3,105,46,59,8
CHIAPAS,7,AMATÁN,005,EL SANTUARIO,1,131,68,63,4
CHIAPAS,7,AMATÁN,005,EMILIANO ZAPATA,3,72,23,49,5
CHIAPAS,7,AMATÁN,005,ESCALÓN,1,33,17,16,2
CHIAPAS,7,AMATÁN,005,ESCALÓN 1RA. FRACCIÓN (EL BARIL),2,71,30,41,4
CHIAPAS,7,AMATÁN,005,ESQUIPULAS,2,81,44,37,4
CHIAPAS,7,AMATÁN,005,ESTRELLA,1,32,15,17,2
CHIAPAS,7,AMATÁN,005,FLOR DEL RÍO,2,27,15,12,2
CHIAPAS,7,AMATÁN,005,FRANCISCO I. MADERO,3,219,121,98,10
CHIAPAS,7,AMATÁN,005,FRANCISCO VILLA,2,129,67,62,6
CHIAPAS,7,AMATÁN,005,GUADALUPE VICTORIA,3,240,121,119,10
CHIAPAS,7,AMATÁN,005,LA CANDELARIA,2,12,7,5,2
CHIAPAS,7,AMATÁN,005,LA ESPERANZA,4,323,164,159,12
CHIAPAS,7,AMATÁN,005,LA GRANJA,1,5,3,2,1
CHIAPAS,7,AMATÁN,005,LA LOMA 1RA. SECCIÓN,2,20,7,13,2
CHIAPAS,7,AMATÁN,005,LA LOMA EL LLANO,1,8,3,5,1
CHIAPAS,7,AMATÁN,005,LA LOMITA,1,15,7,8,1
CHIAPAS,7,AMATÁN,005,LAS GARDENIAS,1,7,5,2,1
CHIAPAS,7,AMATÁN,005,LINDA VISTA ARROYO GRANDE,2,24,8,16,2
CHIAPAS,7,AMATÁN,005,LINDAVISTA,1,13,4,9,1
CHIAPAS,7,AMATÁN,005,LINDAVISTA (PALESTINA),1,15,9,6,1
CHIAPAS,7,AMATÁN,005,LONCHÉN,2,25,12,13,2
CHIAPAS,7,AMATÁN,005,LOS CARACOLES,2,99,46,53,4
CHIAPAS,7,AMATÁN,005,LOS OLIVARES,1,32,16,16,1
CHIAPAS,7,AMATÁN,005,MIGUEL HIDALGO,2,31,12,19,2
CHIAPAS,7,AMATÁN,005,MORELIA,3,193,105,88,7
CHIAPAS,7,AMATÁN,005,MORELIA 2DA. SECCIÓN,2,102,60,42,4
CHIAPAS,7,AMATÁN,005,MORELOS,2,22,10,12,3
CHIAPAS,7,AMATÁN,005,NANCHITAL,2,35,18,17,2
CHIAPAS,7,AMATÁN,005,NUEVA BUENAVISTA,2,15,8,7,2
CHIAPAS,7,AMATÁN,005,NUEVA ESTRELLA,1,6,6,0,1
CHIAPAS,7,AMATÁN,005,NUEVO ARENAL 1RA. SECCIÓN,2,62,37,25,3
CHIAPAS,7,AMATÁN,005,NUEVO TERÁN,2,73,39,34,3
CHIAPAS,7,AMATÁN,005,PIEDRA BLANCA,2,105,60,45,6
CHIAPAS,7,AMATÁN,005,PRIMAVERA,3,31,15,16,4
CHIAPAS,7,AMATÁN,005,PUEBLO NUEVO DE LA NUEVA CONSTITUCIÓN,3,27,13,14,4
CHIAPAS,7,AMATÁN,005,REFORMA Y PLANADA,5,566,268,298,24
CHIAPAS,7,AMATÁN,005,ROSARIO 1RA. SECCIÓN,2,30,19,11,2
CHIAPAS,7,AMATÁN,005,ROSARIO 2DA. SECCIÓN,3,79,46,33,5
CHIAPAS,7,AMATÁN,005,ROSARIO TERCERA SECCIÓN,2,15,4,11,2
CHIAPAS,7,AMATÁN,005,SAN ANDRÉS,2,43,20,23,2
CHIAPAS,7,AMATÁN,005,SAN ANDRÉS TRES PICOS,2,21,10,11,2
CHIAPAS,7,AMATÁN,005,SAN ANTONIO TRES PICOS,3,302,144,158,13
CHIAPAS,7,AMATÁN,005,SAN FERNANDO,2,32,15,17,2
CHIAPAS,7,AMATÁN,005,SAN JOSÉ (BARTOLO),2,45,26,19,3
CHIAPAS,7,AMATÁN,005,SAN JOSÉ BUENAVISTA,2,34,15,19,2
CHIAPAS,7,AMATÁN,005,SAN JOSÉ LA LOMA,3,41,25,16,4
CHIAPAS,7,AMATÁN,005,SAN LORENZO,9,386,198,188,40
CHIAPAS,7,AMATÁN,005,SAN MIGUEL TRES PICOS,2,61,29,32,2
CHIAPAS,7,AMATÁN,005,SAN SEBASTIÁN,2,18,3,15,2
CHIAPAS,7,AMATÁN,005,SANTA CRUZ,1,5,3,2,1
CHIAPAS,7,AMATÁN,005,SANTA CRUZ EL AZUFRE,1,6,2,4,1
CHIAPAS,7,AMATÁN,005,SONORA,3,76,45,31,5
CHIAPAS,7,AMATÁN,005,SUMIDERO,1,6,4,2,1
CHIAPAS,7,AMATÁN,005,TIERRA MORADA,2,29,13,16,2
CHIAPAS,7,AMATÁN,005,VALENTÍN DE LA SIERRA,2,39,23,16,2
CHIAPAS,7,AMATÁN,005,VILLA LUZ,3,67,31,36,4
CHIAPAS,7,AMATENANGO DE LA FRONTERA,006,AGUACATILLO,2,57,34,23,3
CHIAPAS,7,AMATENANGO DE LA FRONTERA,006,ALTAMIRANO,4,79,43,36,6
CHIAPAS,7,AMATENANGO DE LA FRONTERA,006,AMATENANGO DE LA FRONTERA,8,401,200,201,26
CHIAPAS,7,AMATENANGO DE LA FRONTERA,006,BIENESTAR SOCIAL,1,7,5,2,1
CHIAPAS,7,AMATENANGO DE LA FRONTERA,006,BUENAVISTA,2,83,40,43,5
CHIAPAS,7,AMATENANGO DE LA FRONTERA,006,BUENOS AIRES,1,5,2,3,1
CHIAPAS,7,AMATENANGO DE LA FRONTERA,006,CARRIZALITO,1,23,12,11,1
CHIAPAS,7,AMATENANGO DE LA FRONTERA,006,CHIQUISBIL,3,77,39,38,4
CHIAPAS,7,AMATENANGO DE LA FRONTERA,006,CINCO DE MAYO,2,14,9,5,2
CHIAPAS,7,AMATENANGO DE LA FRONTERA,006,EL LIMÓN,1,12,8,4,1
CHIAPAS,7,AMATENANGO DE LA FRONTERA,006,EL NANCITO,2,6,4,2,1
CHIAPAS,7,AMATENANGO DE LA FRONTERA,006,EL PACAYAL,5,935,455,480,47
CHIAPAS,7,AMATENANGO DE LA FRONTERA,006,EL PINO,3,60,33,27,4
CHIAPAS,7,AMATENANGO DE LA FRONTERA,006,EL PROGRESO,2,15,8,7,2
CHIAPAS,7,AMATENANGO DE LA FRONTERA,006,EL RETIRO,2,69,28,41,4
CHIAPAS,7,AMATENANGO DE LA FRONTERA,006,EL TABLÓN CHIQUITO (DESVÍO LOS RAMÍREZ),2,9,4,5,2
CHIAPAS,7,AMATENANGO DE LA FRONTERA,006,EL ZAPOTAL,3,71,35,36,7
CHIAPAS,7,AMATENANGO DE LA FRONTERA,006,ESCOBILLAL,4,177,78,99,10
CHIAPAS,7,AMATENANGO DE LA FRONTERA,006,FLOR DE MAYO,2,84,38,46,3
CHIAPAS,7,AMATENANGO DE LA FRONTERA,006,FRANCISCO I. MADERO,3,296,152,144,13
CHIAPAS,7,AMATENANGO DE LA FRONTERA,006,GRANADILLAL,2,76,41,35,3
CHIAPAS,7,AMATENANGO DE LA FRONTERA,006,GRANADILLAL UNO,2,32,12,20,2
CHIAPAS,7,AMATENANGO DE LA FRONTERA,006,GUADALUPE VICTORIA,5,484,242,242,29
CHIAPAS,7,AMATENANGO DE LA FRONTERA,006,HOJA BLANCA,1,9,4,5,1
CHIAPAS,7,AMATENANGO DE LA FRONTERA,006,HUIXQUILAR,2,32,17,15,3
CHIAPAS,7,AMATENANGO DE LA FRONTERA,006,LA LAGUNITA,3,202,98,104,9
CHIAPAS,7,AMATENANGO DE LA FRONTERA,006,LA MONTAÑA,2,89,52,37,5
CHIAPAS,7,AMATENANGO DE LA FRONTERA,006,LA PLAYA,1,7,2,5,1
CHIAPAS,7,AMATENANGO DE LA FRONTERA,006,LA PUREZA,1,30,16,14,2
CHIAPAS,7,AMATENANGO DE LA FRONTERA,006,LA RINCONADA,2,94,48,46,5
CHIAPAS,7,AMATENANGO DE LA FRONTERA,006,LAS CRUCES,1,8,4,4,1
CHIAPAS,7,AMATENANGO DE LA FRONTERA,006,LAS MARÍAS,2,66,29,37,4
CHIAPAS,7,AMATENANGO DE LA FRONTERA,006,LOMA REAL,1,5,2,3,1
CHIAPAS,7,AMATENANGO DE LA FRONTERA,006,LOS ÁNGELES,3,73,39,34,5
CHIAPAS,7,AMATENANGO DE LA FRONTERA,006,LOS MEZCALES,1,6,4,2,1
CHIAPAS,7,AMATENANGO DE LA FRONTERA,006,MÉXICO NUEVO,2,27,11,16,2
CHIAPAS,7,AMATENANGO DE LA FRONTERA,006,MIGUEL HIDALGO,4,258,142,116,10
CHIAPAS,7,AMATENANGO DE LA FRONTERA,006,MIRA MORELIA,1,7,3,4,1
CHIAPAS,7,AMATENANGO DE LA FRONTERA,006,MONTE ORDÓÑEZ,4,235,120,115,14
CHIAPAS,7,AMATENANGO DE LA FRONTERA,006,MONTE VERDE,4,112,50,62,7
CHIAPAS,7,AMATENANGO DE LA FRONTERA,006,MONUMENTO LOS PILATOS,1,7,6,1,1
CHIAPAS,7,AMATENANGO DE LA FRONTERA,006,NARANJAL,2,32,15,17,2
CHIAPAS,7,AMATENANGO DE LA FRONTERA,006,NUEVA AMÉRICA,2,69,27,42,2
CHIAPAS,7,AMATENANGO DE LA FRONTERA,006,NUEVA ESPERANZA,2,10,6,4,2
CHIAPAS,7,AMATENANGO DE LA FRONTERA,006,NUEVA LIBERTAD,2,67,34,33,4
CHIAPAS,7,AMATENANGO DE LA FRONTERA,006,NUEVA MORELIA,3,334,166,168,15
CHIAPAS,7,AMATENANGO DE LA FRONTERA,006,NUEVA PROVIDENCIA,4,123,54,69,9
CHIAPAS,7,AMATENANGO DE LA FRONTERA,006,NUEVA VICTORIA,1,16,7,9,1
CHIAPAS,7,AMATENANGO DE LA FRONTERA,006,NUEVO AMATENANGO,6,605,307,298,24
CHIAPAS,7,AMATENANGO DE LA FRONTERA,006,NUEVO BELÉN,2,50,19,31,3
CHIAPAS,7,AMATENANGO DE LA FRONTERA,006,NUEVO OCOTAL,2,33,17,16,3
CHIAPAS,7,AMATENANGO DE LA FRONTERA,006,NUEVO RECUERDO,3,91,35,56,4
CHIAPAS,7,AMATENANGO DE LA FRONTERA,006,OJO DE AGUA,2,31,11,20,3
CHIAPAS,7,AMATENANGO DE LA FRONTERA,006,OJO DE AGUA LAS CRUCES,3,112,61,51,6
CHIAPAS,7,AMATENANGO DE LA FRONTERA,006,PACAYALITO,3,257,127,130,14
CHIAPAS,7,AMATENANGO DE LA FRONTERA,006,PALESTINA,2,59,32,27,4
CHIAPAS,7,AMATENANGO DE LA FRONTERA,006,PEÑA BERMEJA,2,38,24,14,3
CHIAPAS,7,AMATENANGO DE LA FRONTERA,006,PLAN GRANDE,2,58,26,32,3
CHIAPAS,7,AMATENANGO DE LA FRONTERA,006,PLATANILLO,1,48,23,25,1
CHIAPAS,7,AMATENANGO DE LA FRONTERA,006,POTRERILLO,4,650,346,304,28
CHIAPAS,7,AMATENANGO DE LA FRONTERA,006,REGADILLO,2,44,23,21,2
CHIAPAS,7,AMATENANGO DE LA FRONTERA,006,RÍO GUERRERO,3,319,148,171,14
CHIAPAS,7,AMATENANGO DE LA FRONTERA,006,SABINALITO,2,89,48,41,4
CHIAPAS,7,AMATENANGO DE LA FRONTERA,006,SAN CRISTOBALITO,1,5,3,2,1
CHIAPAS,7,AMATENANGO DE LA FRONTERA,006,SAN JERÓNIMO,2,34,21,13,3
CHIAPAS,7,AMATENANGO DE LA FRONTERA,006,SAN JOSÉ,1,8,5,3,1
CHIAPAS,7,AMATENANGO DE LA FRONTERA,006,SAN JOSÉ DE LOS POZOS,1,14,9,5,1
CHIAPAS,7,AMATENANGO DE LA FRONTERA,006,SONORA,2,78,44,34,5
CHIAPAS,7,AMATENANGO DE LA FRONTERA,006,TAPITZALÁ NÚMERO DOS,3,277,128,149,15
CHIAPAS,7,AMATENANGO DE LA FRONTERA,006,VADO REAL,2,21,10,11,2
CHIAPAS,7,AMATENANGO DE LA FRONTERA,006,VEINTE DE NOVIEMBRE,3,315,139,176,13
CHIAPAS,7,AMATENANGO DE LA FRONTERA,006,VILLA HIDALGO,2,43,23,20,2
CHIAPAS,7,AMATENANGO DEL VALLE,007,AMATENANGO DEL VALLE,18,1244,538,706,53
CHIAPAS,7,AMATENANGO DEL VALLE,007,BENITO JUÁREZ,5,268,117,151,13
CHIAPAS,7,AMATENANGO DEL VALLE,007,CAMPO ALEGRE,1,7,2,5,1
CHIAPAS,7,AMATENANGO DEL VALLE,007,CAMPO GRANDE,3,36,17,19,4
CHIAPAS,7,AMATENANGO DEL VALLE,007,CRUZ QUEMADA,2,26,10,16,2
CHIAPAS,7,AMATENANGO DEL VALLE,007,EL MADRONAL,2,160,80,80,6
CHIAPAS,7,AMATENANGO DEL VALLE,007,GUADALUPE PORVENIR,2,22,7,15,3
CHIAPAS,7,AMATENANGO DEL VALLE,007,LA MERCED,3,119,56,63,6
CHIAPAS,7,AMATENANGO DEL VALLE,007,LA TEJONERA,2,43,24,19,4
CHIAPAS,7,AMATENANGO DEL VALLE,007,LOS CIPRESES,2,15,8,7,2
CHIAPAS,7,AMATENANGO DEL VALLE,007,MANZANILLO,2,28,12,16,3
CHIAPAS,7,AMATENANGO DEL VALLE,007,MONTE SINAÍ,2,30,17,13,3
CHIAPAS,7,AMATENANGO DEL VALLE,007,NUEVO JERUSALÉN,2,27,9,18,3
CHIAPAS,7,AMATENANGO DEL VALLE,007,NUEVO POBLADO EL SACRIFICIO,1,5,1,4,1
CHIAPAS,7,AMATENANGO DEL VALLE,007,RANCHO ALEGRE,1,6,2,4,1
CHIAPAS,7,AMATENANGO DEL VALLE,007,RANCHO NUEVO,2,57,25,32,4
CHIAPAS,7,AMATENANGO DEL VALLE,007,SAN ANTONIO BUENAVISTA,2,45,22,23,2
CHIAPAS,7,AMATENANGO DEL VALLE,007,SAN CARALAMPIO,3,44,13,31,5
CHIAPAS,7,AMATENANGO DEL VALLE,007,SAN CARALAMPIO CHAVÍN,4,254,122,132,13
CHIAPAS,7,AMATENANGO DEL VALLE,007,SAN CARALAMPIO DOS,1,20,12,8,1
CHIAPAS,7,AMATENANGO DEL VALLE,007,SAN CARLOS,1,8,6,2,1
CHIAPAS,7,AMATENANGO DEL VALLE,007,SAN GREGORIO,2,35,13,22,2
CHIAPAS,7,AMATENANGO DEL VALLE,007,SAN JOSÉ LA REFORMA,2,33,17,16,3
CHIAPAS,7,AMATENANGO DEL VALLE,007,SAN JOSÉ LA VENTANA,2,24,12,12,3
CHIAPAS,7,AMATENANGO DEL VALLE,007,SAN JOSÉ YOJULÚN,2,72,35,37,4
CHIAPAS,7,AMATENANGO DEL VALLE,007,SAN JUAN DEL RÍO,2,12,7,5,2
CHIAPAS,7,AMATENANGO DEL VALLE,007,SAN MIGUEL EL ALTO,2,54,30,24,4
CHIAPAS,7,AMATENANGO DEL VALLE,007,SAN PEDRO LAS FLORES,1,5,3,2,1
CHIAPAS,7,AMATENANGO DEL VALLE,007,SAN RAMÓN BUENAVISTA,3,47,23,24,5
CHIAPAS,7,AMATENANGO DEL VALLE,007,SAN VICENTE LA PIEDRA,2,120,64,56,5
CHIAPAS,7,AMATENANGO DEL VALLE,007,TULANCA,3,54,22,32,3
CHIAPAS,7,AMATENANGO DEL VALLE,007,UNIÓN BUENAVISTA,2,44,18,26,2
CHIAPAS,7,ÁNGEL ALBINO CORZO,008,ARGENTINA,2,39,15,24,3
CHIAPAS,7,ÁNGEL ALBINO CORZO,008,BARRIO EL 9,3,35,19,16,4
CHIAPAS,7,ÁNGEL ALBINO CORZO,008,CHIQUINILLAL,2,55,25,30,3
CHIAPAS,7,ÁNGEL ALBINO CORZO,008,CIUDAD RURAL ANGEL ALBINO CORZO,1,261,125,136,9
CHIAPAS,7,ÁNGEL ALBINO CORZO,008,EL PUERTO (EL CEÑIDO),1,6,2,4,1
CHIAPAS,7,ÁNGEL ALBINO CORZO,008,FRANCISCO I. MADERO,4,437,218,219,19
CHIAPAS,7,ÁNGEL ALBINO CORZO,008,GUADALUPE,3,28,13,15,3
CHIAPAS,7,ÁNGEL ALBINO CORZO,008,GUADALUPE VICTORIA (YERBASANTA),2,48,19,29,3
CHIAPAS,7,ÁNGEL ALBINO CORZO,008,JALTENANGO DE LA PAZ (ÁNGEL ALBINO CORZO),25,4173,2131,2042,228
CHIAPAS,7,ÁNGEL ALBINO CORZO,008,JERICÓ,2,19,12,7,2
CHIAPAS,7,ÁNGEL ALBINO CORZO,008,JERUSALÉN,3,237,111,126,10
CHIAPAS,7,ÁNGEL ALBINO CORZO,008,LA ESTRELLA,3,35,17,18,4
CHIAPAS,7,ÁNGEL ALBINO CORZO,008,LA PAZ,3,165,77,88,8
CHIAPAS,7,ÁNGEL ALBINO CORZO,008,LIBERTAD DEL PAJAL,4,344,171,173,15
CHIAPAS,7,ÁNGEL ALBINO CORZO,008,MONTE GRANDE,3,36,19,17,4
CHIAPAS,7,ÁNGEL ALBINO CORZO,008,MONTEBELLO ALTAMIRA,2,107,43,64,4
CHIAPAS,7,ÁNGEL ALBINO CORZO,008,NUEVA COLOMBIA,4,252,127,125,14
CHIAPAS,7,ÁNGEL ALBINO CORZO,008,NUEVA INDEPENDENCIA,4,457,225,232,21
CHIAPAS,7,ÁNGEL ALBINO CORZO,008,NUEVA PALESTINA,6,1135,577,558,42
CHIAPAS,7,ÁNGEL ALBINO CORZO,008,NUEVO MILENIO QUINCE DE SEPTIEMBRE,2,31,14,17,3
CHIAPAS,7,ÁNGEL ALBINO CORZO,008,NUEVO PROGRESO,2,31,18,13,2
CHIAPAS,7,ÁNGEL ALBINO CORZO,008,PACAYAL,1,7,5,2,1
CHIAPAS,7,ÁNGEL ALBINO CORZO,008,PLAN DE AYUTLA,5,250,125,125,15
CHIAPAS,7,ÁNGEL ALBINO CORZO,008,QUERÉTARO,5,564,281,283,25
CHIAPAS,7,ÁNGEL ALBINO CORZO,008,SALVADOR URBINA,4,256,126,130,11
CHIAPAS,7,ÁNGEL ALBINO CORZO,008,SAN FRANCISCO,2,95,43,52,4
CHIAPAS,7,ÁNGEL ALBINO CORZO,008,SANTA RITA,3,71,38,33,4
CHIAPAS,7,ÁNGEL ALBINO CORZO,008,SIETE DE OCTUBRE,3,74,44,30,4
CHIAPAS,7,ARRIAGA,009,5 DE MAYO,3,59,30,29,4
CHIAPAS,7,ARRIAGA,009,AGRÍCOLA VEINTE DE NOVIEMBRE,3,28,16,12,3
CHIAPAS,7,ARRIAGA,009,AGUA FRÍA,1,23,12,11,1
CHIAPAS,7,ARRIAGA,009,ARRIAGA,56,6840,3441,3399,443
CHIAPAS,7,ARRIAGA,009,AZTECA (LA PUNTA),4,246,120,126,21
CHIAPAS,7,ARRIAGA,009,EBEN EZER,2,14,5,9,2
CHIAPAS,7,ARRIAGA,009,EL ARENAL,2,33,17,16,2
CHIAPAS,7,ARRIAGA,009,EL PLEITO,2,39,21,18,2
CHIAPAS,7,ARRIAGA,009,EMILIANO ZAPATA,6,925,470,455,41
CHIAPAS,7,ARRIAGA,009,FRACCIÓN LA ESPERANZA,2,210,110,100,11
CHIAPAS,7,ARRIAGA,009,LA GLORIA,4,398,218,180,17
CHIAPAS,7,ARRIAGA,009,LA LÍNEA,3,377,187,190,19
CHIAPAS,7,ARRIAGA,009,LA SOLEDAD,2,31,14,17,2
CHIAPAS,7,ARRIAGA,009,LAS ARENAS,2,24,13,11,2
CHIAPAS,7,ARRIAGA,009,LÁZARO CÁRDENAS,3,248,117,131,11
CHIAPAS,7,ARRIAGA,009,MALPASO,1,17,7,10,1
CHIAPAS,7,ARRIAGA,009,NICOLÁS BRAVO (EL HONDO),3,102,44,58,10
CHIAPAS,7,ARRIAGA,009,NUEVO PROGRESO (ABSALÓN CASTELLANOS D.),3,24,13,11,3
CHIAPAS,7,ARRIAGA,009,NUEVO SAN PABLO,2,42,14,28,3
CHIAPAS,7,ARRIAGA,009,OAXAQUITA,3,55,26,29,4
CHIAPAS,7,ARRIAGA,009,POZA GALANA,3,22,12,10,3
CHIAPAS,7,ARRIAGA,009,PUNTA FLOR,4,217,98,119,13
CHIAPAS,7,ARRIAGA,009,SAN ISIDRO,1,20,12,8,1
CHIAPAS,7,ARRIAGA,009,SANTA LUCÍA,1,291,149,142,37
CHIAPAS,7,ARRIAGA,009,VILLA DEL MAR,4,150,83,67,10
CHIAPAS,7,ARRIAGA,009,VISTA FLOR,1,30,12,18,2
CHIAPAS,7,BEJUCAL DE OCAMPO,010,ALTAMIRANO,2,52,23,29,2
CHIAPAS,7,BEJUCAL DE OCAMPO,010,BEJUCAL DE OCAMPO,4,179,93,86,9
CHIAPAS,7,BEJUCAL DE OCAMPO,010,BUENAVISTA,2,44,20,24,3
CHIAPAS,7,BEJUCAL DE OCAMPO,010,CRESTÓN DEL GALLO,1,8,4,4,1
CHIAPAS,7,BEJUCAL DE OCAMPO,010,EL CABALLETE,1,20,13,7,1
CHIAPAS,7,BEJUCAL DE OCAMPO,010,EL CERCADILLO,3,56,25,31,3
CHIAPAS,7,BEJUCAL DE OCAMPO,010,EL MOLINO,2,115,54,61,5
CHIAPAS,7,BEJUCAL DE OCAMPO,010,EL PALMAR GRANDE,1,8,3,5,1
CHIAPAS,7,BEJUCAL DE OCAMPO,010,EL PARAÍSO,2,12,6,6,2
CHIAPAS,7,BEJUCAL DE OCAMPO,010,EL PINO,2,78,35,43,5
CHIAPAS,7,BEJUCAL DE OCAMPO,010,EL TRIUNFO,2,23,9,14,2
CHIAPAS,7,BEJUCAL DE OCAMPO,010,JUSTO SIERRA,1,22,3,19,2
CHIAPAS,7,BEJUCAL DE OCAMPO,010,LA HACIENDA,1,74,52,22,5
CHIAPAS,7,BEJUCAL DE OCAMPO,010,LA LAGUNA,3,136,61,75,7
CHIAPAS,7,BEJUCAL DE OCAMPO,010,LA NUEVA LIBERTAD,2,53,24,29,3
CHIAPAS,7,BEJUCAL DE OCAMPO,010,LA SOLEDAD,2,28,17,11,2
CHIAPAS,7,BEJUCAL DE OCAMPO,010,LAS PILAS,2,43,25,18,2
CHIAPAS,7,BEJUCAL DE OCAMPO,010,LAS PILAS DEL SICIL,2,70,35,35,4
CHIAPAS,7,BEJUCAL DE OCAMPO,010,LAS TABLAS,3,156,77,79,8
CHIAPAS,7,BEJUCAL DE OCAMPO,010,LOS AGUACATALES,2,107,52,55,6
CHIAPAS,7,BEJUCAL DE OCAMPO,010,NUEVO PARRALITO,1,14,10,4,1
CHIAPAS,7,BEJUCAL DE OCAMPO,010,NUEVO ROSARIO,2,12,6,6,1
CHIAPAS,7,BEJUCAL DE OCAMPO,010,OJO DE AGUA CENTRO,5,324,164,160,18
CHIAPAS,7,BEJUCAL DE OCAMPO,010,OJO DE AGUA GRANDE,3,138,69,69,8
CHIAPAS,7,BEJUCAL DE OCAMPO,010,REFORMA,3,309,155,154,15
CHIAPAS,7,BEJUCAL DE OCAMPO,010,YALINCÚN,2,20,10,10,2
CHIAPAS,7,BELLA VISTA,011,ALLENDE,2,33,16,17,2
CHIAPAS,7,BELLA VISTA,011,BELLA VISTA,5,705,352,353,42
CHIAPAS,7,BELLA VISTA,011,BUENAVISTA,2,21,10,11,2
CHIAPAS,7,BELLA VISTA,011,CABALLO BLANCO,1,16,6,10,1
CHIAPAS,7,BELLA VISTA,011,CÁRDENAS OJO DE AGUA,2,80,42,38,5
CHIAPAS,7,BELLA VISTA,011,CHEMIC,2,58,23,35,3
CHIAPAS,7,BELLA VISTA,011,CUATRO CAMINOS,2,55,25,30,3
CHIAPAS,7,BELLA VISTA,011,CUEVA DEL ARCO,2,83,43,40,3
CHIAPAS,7,BELLA VISTA,011,EL CABALLETE,2,70,24,46,2
CHIAPAS,7,BELLA VISTA,011,EL CEDRO,1,12,9,3,1
CHIAPAS,7,BELLA VISTA,011,EL CHILAR,1,8,4,4,1
CHIAPAS,7,BELLA VISTA,011,EL CIPRÉS,3,57,29,28,3
CHIAPAS,7,BELLA VISTA,011,EL PARAÍSO,2,39,22,17,3
CHIAPAS,7,BELLA VISTA,011,EL PLATANAR,3,133,66,67,8
CHIAPAS,7,BELLA VISTA,011,EL PROGRESO,5,385,190,195,20
CHIAPAS,7,BELLA VISTA,011,EL SABINALITO,1,10,6,4,1
CHIAPAS,7,BELLA VISTA,011,EL VERGEL LA RINCONADA,1,10,3,7,1
CHIAPAS,7,BELLA VISTA,011,EMILIANO ZAPATA,4,441,216,225,20
CHIAPAS,7,BELLA VISTA,011,ESMERALDA EL RECUERDO,2,11,7,4,2
CHIAPAS,7,BELLA VISTA,011,GUADALUPE,5,105,52,53,7
CHIAPAS,7,BELLA VISTA,011,LA DELICIA,3,30,16,14,4
CHIAPAS,7,BELLA VISTA,011,LA HACIENDA,3,145,76,69,9
CHIAPAS,7,BELLA VISTA,011,LA INDEPENDENCIA,4,484,231,253,23
CHIAPAS,7,BELLA VISTA,011,LA LAGUNA,4,57,29,28,4
CHIAPAS,7,BELLA VISTA,011,LA LUCHA,2,25,13,12,2
CHIAPAS,7,BELLA VISTA,011,LA LUCHA SAN MARCOS,2,19,9,10,2
CHIAPAS,7,BELLA VISTA,011,LA MESILLA,1,5,2,3,1
CHIAPAS,7,BELLA VISTA,011,LA NORIA,2,38,17,21,3
CHIAPAS,7,BELLA VISTA,011,LA PINADITA,3,39,16,23,4
CHIAPAS,7,BELLA VISTA,011,LA RINCONADA,5,277,128,149,14
CHIAPAS,7,BELLA VISTA,011,LAS CHICHARRAS,3,344,190,154,18
CHIAPAS,7,BELLA VISTA,011,LAS FLORES,2,145,70,75,8
CHIAPAS,7,BELLA VISTA,011,LAS NUBES,4,163,79,84,10
CHIAPAS,7,BELLA VISTA,011,LAS TABLAS,1,9,5,4,1
CHIAPAS,7,BELLA VISTA,011,LIBERTAD LA FUENTE,5,113,62,51,8
CHIAPAS,7,BELLA VISTA,011,LOS LAGOS,2,59,29,30,3
CHIAPAS,7,BELLA VISTA,011,LOS LLANITOS,1,5,2,3,1
CHIAPAS,7,BELLA VISTA,011,LOS POCITOS,3,39,15,24,4
CHIAPAS,7,BELLA VISTA,011,LOS RAMÍREZ,1,6,3,3,1
CHIAPAS,7,BELLA VISTA,011,LOS TRES PUENTES,1,8,6,2,1
CHIAPAS,7,BELLA VISTA,011,MINERVA,2,67,30,37,2
CHIAPAS,7,BELLA VISTA,011,MONTE FLOR,2,20,11,9,2
CHIAPAS,7,BELLA VISTA,011,NUEVA ESTRELLA,1,8,2,6,1
CHIAPAS,7,BELLA VISTA,011,NUEVO PACAYAL,4,370,186,184,17
CHIAPAS,7,BELLA VISTA,011,NUEVO YUCATÁN,3,123,57,66,6
CHIAPAS,7,BELLA VISTA,011,OJO DE AGUA,3,40,19,21,3
CHIAPAS,7,BELLA VISTA,011,PACAYAL VIEJO,3,114,62,52,4
CHIAPAS,7,BELLA VISTA,011,SAN ANTONIO,2,53,21,32,4
CHIAPAS,7,BELLA VISTA,011,SAN FRANCISCO,2,29,13,16,3
CHIAPAS,7,BELLA VISTA,011,SAN JOSÉ LAS CHICHARRAS,5,321,180,141,17
CHIAPAS,7,BELLA VISTA,011,SAN JUAN PROGRESO,2,91,43,48,4
CHIAPAS,7,BELLA VISTA,011,UNIÓN PROGRESO,2,87,52,35,5
CHIAPAS,7,BELLA VISTA,011,VEINTE DE NOVIEMBRE,2,25,13,12,2
CHIAPAS,7,BELLA VISTA,011,ZARAGOZA,2,49,25,24,3
CHIAPAS,7,BERRIOZÁBAL,012,AMENDU,3,164,79,85,7
CHIAPAS,7,BERRIOZÁBAL,012,BENITO JUÁREZ,3,97,52,45,6
CHIAPAS,7,BERRIOZÁBAL,012,BENITO QUEZADA,2,25,13,12,3
CHIAPAS,7,BERRIOZÁBAL,012,BERLÍN,2,101,50,51,4
CHIAPAS,7,BERRIOZÁBAL,012,BERRIOZÁBAL,52,11290,5633,5657,514
CHIAPAS,7,BERRIOZÁBAL,012,BUENAVISTA,3,52,22,30,5
CHIAPAS,7,BERRIOZÁBAL,012,CHICOZAPOTE,3,66,32,34,5
CHIAPAS,7,BERRIOZÁBAL,012,CIUDAD MAYA,4,1065,515,550,49
CHIAPAS,7,BERRIOZÁBAL,012,COLONIA EJIDAL,2,100,57,43,5
CHIAPAS,7,BERRIOZÁBAL,012,CUCHUMBAC,3,44,20,24,4
CHIAPAS,7,BERRIOZÁBAL,012,EFRAÍN A. GUTIÉRREZ,4,239,118,121,13
CHIAPAS,7,BERRIOZÁBAL,012,EL CARACOL,3,56,30,26,5
CHIAPAS,7,BERRIOZÁBAL,012,EL DANUBIO,3,61,31,30,5
CHIAPAS,7,BERRIOZÁBAL,012,EL DIVISADERO,3,33,15,18,4
CHIAPAS,7,BERRIOZÁBAL,012,EL HIGUITO,2,27,13,14,3
CHIAPAS,7,BERRIOZÁBAL,012,EL LIMÓN,3,25,12,13,3
CHIAPAS,7,BERRIOZÁBAL,012,EL MIRADOR,2,13,7,6,2
CHIAPAS,7,BERRIOZÁBAL,012,EL NUEVO TRIUNFO (EL ESPADÍN),3,25,11,14,3
CHIAPAS,7,BERRIOZÁBAL,012,EL PALMAR,1,31,12,19,2
CHIAPAS,7,BERRIOZÁBAL,012,EL PALO VERDE,1,10,4,6,1
CHIAPAS,7,BERRIOZÁBAL,012,EL SABINITO,3,68,36,32,5
CHIAPAS,7,BERRIOZÁBAL,012,EL TIROL,3,30,15,15,3
CHIAPAS,7,BERRIOZÁBAL,012,EMILIANO ZAPATA,2,41,27,14,4
CHIAPAS,7,BERRIOZÁBAL,012,IGNACIO ZARAGOZA,4,404,205,199,8
CHIAPAS,7,BERRIOZÁBAL,012,INDEPENDENCIA,3,260,142,118,17
CHIAPAS,7,BERRIOZÁBAL,012,JOAQUÍN MIGUEL GUTIÉRREZ,3,62,33,29,4
CHIAPAS,7,BERRIOZÁBAL,012,LA CARIDAD,2,42,15,27,3
CHIAPAS,7,BERRIOZÁBAL,012,LA LIBERTAD,3,404,211,193,12
CHIAPAS,7,BERRIOZÁBAL,012,LA NUEVA ESPERANZA,3,98,51,47,7
CHIAPAS,7,BERRIOZÁBAL,012,LAS CAMELIAS,3,205,96,109,10
CHIAPAS,7,BERRIOZÁBAL,012,LAS LIMAS,2,5,1,4,2
CHIAPAS,7,BERRIOZÁBAL,012,LAS MARAVILLAS,4,267,137,130,13
CHIAPAS,7,BERRIOZÁBAL,012,LINDOS AIRES,1,11,3,8,1
CHIAPAS,7,BERRIOZÁBAL,012,MONTE BONITO,2,13,6,7,2
CHIAPAS,7,BERRIOZÁBAL,012,NUEVO CHACACAL,2,32,17,15,2
CHIAPAS,7,BERRIOZÁBAL,012,NUEVO MONTECRISTO,2,69,33,36,4
CHIAPAS,7,BERRIOZÁBAL,012,NUEVO PROGRESO,2,32,11,21,3
CHIAPAS,7,BERRIOZÁBAL,012,PASO DEL BURRO,3,121,61,60,8
CHIAPAS,7,BERRIOZÁBAL,012,PASO LIMÓN,3,35,26,9,4
CHIAPAS,7,BERRIOZÁBAL,012,REVOLUCIÓN,3,78,44,34,6
CHIAPAS,7,BERRIOZÁBAL,012,RÍO BLANCO,3,64,31,33,5
CHIAPAS,7,BERRIOZÁBAL,012,SAN ANTONIO BOMBANO,2,163,77,86,8
CHIAPAS,7,BERRIOZÁBAL,012,SAN FRANCISCO,2,34,21,13,4
CHIAPAS,7,BERRIOZÁBAL,012,SAN ISIDRO,2,27,11,16,3
CHIAPAS,7,BERRIOZÁBAL,012,SAN JERONIMO (SOLIDARIDAD),3,84,33,51,6
CHIAPAS,7,BERRIOZÁBAL,012,SAN JOSÉ EL PARAÍSO,1,6,5,1,1
CHIAPAS,7,BERRIOZÁBAL,012,SAN JOSÉ LA FLOR,1,6,3,3,1
CHIAPAS,7,BERRIOZÁBAL,012,SAN JUAN,2,15,7,8,2
CHIAPAS,7,BERRIOZÁBAL,012,SAN MARTÍN,1,15,4,11,1
CHIAPAS,7,BERRIOZÁBAL,012,SAN PEDRO BOMBANO,3,51,26,25,4
CHIAPAS,7,BERRIOZÁBAL,012,SANTA INÉS BUENAVISTA,6,567,267,300,50
CHIAPAS,7,BERRIOZÁBAL,012,SANTA MARTHA,3,75,32,43,6
CHIAPAS,7,BERRIOZÁBAL,012,SINAÍ,1,6,3,3,1
CHIAPAS,7,BERRIOZÁBAL,012,TIERRA Y LIBERTAD,1,30,15,15,1
CHIAPAS,7,BERRIOZÁBAL,012,VISTAHERMOSA,4,155,75,80,7
CHIAPAS,7,BOCHIL,013,AGUA BENDITA,2,51,24,27,4
CHIAPAS,7,BOCHIL,013,AJILÓ,4,524,270,254,20
CHIAPAS,7,BOCHIL,013,ALLENDE ESQUIPULAS,5,358,187,171,16
CHIAPAS,7,BOCHIL,013,BOCHIL,30,5843,2964,2879,304
CHIAPAS,7,BOCHIL,013,CANTÉ,1,10,2,8,1
CHIAPAS,7,BOCHIL,013,CERRO MATASANO,3,22,12,10,3
CHIAPAS,7,BOCHIL,013,CERRO PALMITA,2,52,27,25,3
CHIAPAS,7,BOCHIL,013,EL AMATE,4,232,111,121,13
CHIAPAS,7,BOCHIL,013,EL CERRO,2,35,18,17,2
CHIAPAS,7,BOCHIL,013,EL COPAL,4,535,285,250,19
CHIAPAS,7,BOCHIL,013,EL MIRADOR,1,109,56,53,6
CHIAPAS,7,BOCHIL,013,EL OCOTAL,2,26,16,10,3
CHIAPAS,7,BOCHIL,013,EL OCOTE,1,4,2,2,1
CHIAPAS,7,BOCHIL,013,EL PALMARCITO,2,12,6,6,2
CHIAPAS,7,BOCHIL,013,EMILIANO ZAPATA,3,153,80,73,6
CHIAPAS,7,BOCHIL,013,FRANCISCO VILLA,2,14,8,6,2
CHIAPAS,7,BOCHIL,013,GARRIDO CANAVAL (CHAVARRÍA),4,324,161,163,15
CHIAPAS,7,BOCHIL,013,GUADALUPE,5,37,15,22,5
CHIAPAS,7,BOCHIL,013,HIERBABUENA EL NARANJO,1,9,3,6,1
CHIAPAS,7,BOCHIL,013,LA CAÑADA,2,118,56,62,4
CHIAPAS,7,BOCHIL,013,LA LAGUNA,3,228,113,115,9
CHIAPAS,7,BOCHIL,013,LA LAGUNITA,2,75,37,38,2
CHIAPAS,7,BOCHIL,013,LA LIBERTAD,2,22,15,7,2
CHIAPAS,7,BOCHIL,013,LA NARANJA,1,59,35,24,2
CHIAPAS,7,BOCHIL,013,LA PITAHAYA,3,59,24,35,4
CHIAPAS,7,BOCHIL,013,LA YERBABUENA,3,220,124,96,11
CHIAPAS,7,BOCHIL,013,LAS LIMAS,3,32,15,17,3
CHIAPAS,7,BOCHIL,013,LAS LOMAS,3,35,20,15,4
CHIAPAS,7,BOCHIL,013,LLANO GRANDE,3,271,122,149,11
CHIAPAS,7,BOCHIL,013,LOS PINITOS,1,18,8,10,1
CHIAPAS,7,BOCHIL,013,LUIS ESPINOZA,4,512,250,262,24
CHIAPAS,7,BOCHIL,013,MONTE CHICO,2,54,29,25,2
CHIAPAS,7,BOCHIL,013,MONTE GRANDE,2,270,144,126,9
CHIAPAS,7,BOCHIL,013,MONTE VERDE,3,16,8,8,2
CHIAPAS,7,BOCHIL,013,NÍHO,5,230,117,113,13
CHIAPAS,7,BOCHIL,013,NUEVA ESPERANZA,3,31,15,16,3
CHIAPAS,7,BOCHIL,013,NUEVA LIBERTAD,1,60,34,26,2
CHIAPAS,7,BOCHIL,013,NUEVO CHUCHILTÓN,2,21,9,12,2
CHIAPAS,7,BOCHIL,013,PALMA REAL,3,39,22,17,4
CHIAPAS,7,BOCHIL,013,PASHAMUM,3,21,12,9,3
CHIAPAS,7,BOCHIL,013,PLAN DE AYALA,3,74,37,37,6
CHIAPAS,7,BOCHIL,013,POCITO CAULOTE,3,102,43,59,5
CHIAPAS,7,BOCHIL,013,POMILÓ,2,87,40,47,3
CHIAPAS,7,BOCHIL,013,REFORMA 2000,2,91,39,52,6
CHIAPAS,7,BOCHIL,013,SAN ANTONIO LA PITAHAYA,2,78,46,32,3
CHIAPAS,7,BOCHIL,013,SAN ANTONIO POMILÓ,2,29,19,10,2
CHIAPAS,7,BOCHIL,013,SAN GREGORIO,2,38,19,19,2
CHIAPAS,7,BOCHIL,013,SAN JOSÉ EL EDÉN,2,27,11,16,3
CHIAPAS,7,BOCHIL,013,SAN JOSÉ MORELOS,2,83,41,42,5
CHIAPAS,7,BOCHIL,013,SAN JOSÉ MUJULAR,1,32,14,18,1
CHIAPAS,7,BOCHIL,013,SAN PEDRO EL ACHIOTE (SAN PEDRO MÁRTIR),2,219,105,114,9
CHIAPAS,7,BOCHIL,013,SAN VICENTE,3,203,95,108,11
CHIAPAS,7,BOCHIL,013,SANTA CRUZ BUENAVISTA,3,42,26,16,4
CHIAPAS,7,BOCHIL,013,SANTA CRUZ NIHO,1,18,11,7,1
CHIAPAS,7,BOCHIL,013,SANTO DOMINGO,2,169,86,83,6
CHIAPAS,7,BOCHIL,013,SHASHALPA,3,138,78,60,5
CHIAPAS,7,BOCHIL,013,SITETIC,2,83,39,44,3
CHIAPAS,7,BOCHIL,013,TIERRA COLORADA,2,345,168,177,13
CHIAPAS,7,BOCHIL,013,VENUSTIANO CARRANZA,2,253,139,114,9
CHIAPAS,7,BOCHIL,013,YERBABUENA ISBONTICK,3,576,266,310,20
CHIAPAS,7,EL BOSQUE,014,ALTAGRACIA,3,164,82,82,10
CHIAPAS,7,EL BOSQUE,014,ÁLVARO OBREGÓN,4,503,249,254,22
CHIAPAS,7,EL BOSQUE,014,ARGENTINA,2,66,29,37,3
CHIAPAS,7,EL BOSQUE,014,CARMEN EL OCOTAL,1,42,22,20,2
CHIAPAS,7,EL BOSQUE,014,CARMEN GUAYABAL,3,50,20,30,4
CHIAPAS,7,EL BOSQUE,014,CARMEN GUAYABAL DOS,3,51,21,30,4
CHIAPAS,7,EL BOSQUE,014,CHABAJEBAL,3,465,235,230,21
CHIAPAS,7,EL BOSQUE,014,EL BOSQUE,11,1967,995,972,84
CHIAPAS,7,EL BOSQUE,014,EL CARRIZAL,3,278,152,126,10
CHIAPAS,7,EL BOSQUE,014,EL PALMAR,2,21,11,10,2
CHIAPAS,7,EL BOSQUE,014,EL PEDREGAL,1,108,61,47,4
CHIAPAS,7,EL BOSQUE,014,FLORENCIA,2,84,41,43,3
CHIAPAS,7,EL BOSQUE,014,LA TRINIDAD,2,73,33,40,3
CHIAPAS,7,EL BOSQUE,014,LAS DELICIAS,5,271,120,151,11
CHIAPAS,7,EL BOSQUE,014,LOS ÁNGELES,2,244,111,133,9
CHIAPAS,7,EL BOSQUE,014,MERCEDES LA ILUSIÓN,2,101,53,48,4
CHIAPAS,7,EL BOSQUE,014,NUEVA ESPERANZA,2,39,22,17,3
CHIAPAS,7,EL BOSQUE,014,NUEVA JERUSALÉN,2,42,18,24,2
CHIAPAS,7,EL BOSQUE,014,NUEVA UCRANIA,2,9,6,3,2
CHIAPAS,7,EL BOSQUE,014,PLÁTANOS,4,1126,561,565,38
CHIAPAS,7,EL BOSQUE,014,SABINOTIC,2,94,52,42,4
CHIAPAS,7,EL BOSQUE,014,SAN ANDRÉS LA LAGUNA,2,215,115,100,7
CHIAPAS,7,EL BOSQUE,014,SAN ANTONIO EL BRILLANTE,2,183,89,94,6
CHIAPAS,7,EL BOSQUE,014,SAN CAYETANO,4,915,451,464,42
CHIAPAS,7,EL BOSQUE,014,SAN CRISTÓBAL LA GLORIA,1,10,7,3,1
CHIAPAS,7,EL BOSQUE,014,SAN FRANCISCO CONHÓ,2,53,29,24,3
CHIAPAS,7,EL BOSQUE,014,SAN MIGUEL,3,168,81,87,7
CHIAPAS,7,EL BOSQUE,014,SAN PEDRO NICHTALUCUM,6,886,421,465,36
CHIAPAS,7,EL BOSQUE,014,SANTA TERESA,2,11,4,7,1
CHIAPAS,7,EL BOSQUE,014,TIERRA CALIENTE,2,97,52,45,4
CHIAPAS,7,EL BOSQUE,014,UNIÓN PROGRESO,3,38,16,22,3
CHIAPAS,7,EL BOSQUE,014,UNIÓN TIERRA TZOTZIL,2,35,17,18,3
CHIAPAS,7,EL BOSQUE,014,VERGEL,2,14,5,9,2
CHIAPAS,7,CACAHOATÁN,015,AGUA CALIENTE,4,308,155,153,11
CHIAPAS,7,CACAHOATÁN,015,AGUSTÍN DE ITURBIDE,5,800,372,428,36
CHIAPAS,7,CACAHOATÁN,015,AHUACATLÁN,4,693,366,327,25
CHIAPAS,7,CACAHOATÁN,015,ALIANZA,2,14,8,6,2
CHIAPAS,7,CACAHOATÁN,015,ALPUJARRAS,3,157,80,77,8
CHIAPAS,7,CACAHOATÁN,015,AZTECA,3,92,39,53,6
CHIAPAS,7,CACAHOATÁN,015,BELLAVISTA,3,214,107,107,9
CHIAPAS,7,CACAHOATÁN,015,BENITO JUÁREZ,3,400,205,195,18
CHIAPAS,7,CACAHOATÁN,015,BENITO JUÁREZ EL PLAN,2,121,57,64,5
CHIAPAS,7,CACAHOATÁN,015,BENITO JUÁREZ MONTECRISTO,2,73,32,41,3
CHIAPAS,7,CACAHOATÁN,015,CACAHOATÁN,21,5895,2898,2997,224
CHIAPAS,7,CACAHOATÁN,015,CAMAMBÉ,2,64,30,34,3
CHIAPAS,7,CACAHOATÁN,015,DOS DE MAYO,2,124,61,63,4
CHIAPAS,7,CACAHOATÁN,015,EL ÁGUILA,4,300,155,145,15
CHIAPAS,7,CACAHOATÁN,015,EL CARMEN,1,51,25,26,2
CHIAPAS,7,CACAHOATÁN,015,EL PLATANAR,4,269,122,147,12
CHIAPAS,7,CACAHOATÁN,015,EL PROGRESO,2,169,97,72,7
CHIAPAS,7,CACAHOATÁN,015,FAJA DE ORO,4,1003,467,536,45
CHIAPAS,7,CACAHOATÁN,015,FRACCIÓN AZTECA,2,57,28,29,3
CHIAPAS,7,CACAHOATÁN,015,GUATIMOC,3,208,91,117,9
CHIAPAS,7,CACAHOATÁN,015,ICUL (PLAN CHIAPAS),1,17,12,5,1
CHIAPAS,7,CACAHOATÁN,015,LA BOQUILLA,1,60,26,34,2
CHIAPAS,7,CACAHOATÁN,015,LA PRIMAVERA,2,64,29,35,3
CHIAPAS,7,CACAHOATÁN,015,LA SOLEDAD,2,96,53,43,4
CHIAPAS,7,CACAHOATÁN,015,LAS NUBES GUATIMOC,2,216,95,121,9
CHIAPAS,7,CACAHOATÁN,015,LAS NUBES LOS PATIOS,1,5,5,0,1
CHIAPAS,7,CACAHOATÁN,015,LOS PANES,1,66,26,40,3
CHIAPAS,7,CACAHOATÁN,015,MIRAMAR,2,57,31,26,3
CHIAPAS,7,CACAHOATÁN,015,MIXCUM,4,483,223,260,22
CHIAPAS,7,CACAHOATÁN,015,NUEVA ALIANZA,1,19,10,9,1
CHIAPAS,7,CACAHOATÁN,015,PIEDRA PARADA,4,97,49,48,6
CHIAPAS,7,CACAHOATÁN,015,PLATANILLO,3,46,25,21,4
CHIAPAS,7,CACAHOATÁN,015,PUENTE COLORADO,2,64,28,36,3
CHIAPAS,7,CACAHOATÁN,015,RANCHO QUEMADO,1,21,15,6,1
CHIAPAS,7,CACAHOATÁN,015,ROSALES,2,119,50,69,6
CHIAPAS,7,CACAHOATÁN,015,ROSARIO IXTAL,6,481,224,257,37
CHIAPAS,7,CACAHOATÁN,015,SALVADOR URBINA,4,883,433,450,35
CHIAPAS,7,CACAHOATÁN,015,SAN MIGUEL,1,6,3,3,1
CHIAPAS,7,CACAHOATÁN,015,SANTA LUCÍA,1,50,24,26,2
CHIAPAS,7,CACAHOATÁN,015,SANTA MARÍA LA VEGA,2,94,55,39,4
CHIAPAS,7,CACAHOATÁN,015,TECOYTAC,3,73,37,36,4
CHIAPAS,7,CACAHOATÁN,015,TOQUIÁN LAS NUBES (TOQUIÁN GUARUMO),2,200,112,88,8
CHIAPAS,7,CACAHOATÁN,015,TOQUIÁN Y LAS NUBES,3,133,66,67,7
CHIAPAS,7,CACAHOATÁN,015,UNIÓN ROJA,4,660,333,327,29
CHIAPAS,7,CATAZAJÁ,016,AGUA FRÍA,4,231,124,107,12
CHIAPAS,7,CATAZAJÁ,016,BAJO USUMACINTA,1,7,4,3,1
CHIAPAS,7,CATAZAJÁ,016,BOCA DEL RÍO CHICO,1,6,3,3,1
CHIAPAS,7,CATAZAJÁ,016,BUENAVISTA DAMASCO,2,13,10,3,2
CHIAPAS,7,CATAZAJÁ,016,CATAZAJÁ,11,2108,970,1138,106
CHIAPAS,7,CATAZAJÁ,016,CRUCERO EL CUYO,1,48,20,28,3
CHIAPAS,7,CATAZAJÁ,016,CUAUHTÉMOC,2,117,60,57,5
CHIAPAS,7,CATAZAJÁ,016,CUAUHTEMOC QUEMADO,2,59,28,31,4
CHIAPAS,7,CATAZAJÁ,016,CUYO (ÁLVARO OBREGÓN),3,173,80,93,12
CHIAPAS,7,CATAZAJÁ,016,CUYO SANTA CRUZ,2,18,9,9,2
CHIAPAS,7,CATAZAJÁ,016,DOBLE A,1,11,7,4,1
CHIAPAS,7,CATAZAJÁ,016,EL CAOBA,1,5,3,2,1
CHIAPAS,7,CATAZAJÁ,016,EL DESENGAÑO,2,9,2,7,2
CHIAPAS,7,CATAZAJÁ,016,EL PAJONAL,2,36,22,14,2
CHIAPAS,7,CATAZAJÁ,016,EL PARAÍSO,4,153,75,78,10
CHIAPAS,7,CATAZAJÁ,016,EL REMOLINO 1RA. SECCIÓN,2,22,13,9,2
CHIAPAS,7,CATAZAJÁ,016,EL REMOLINO 2DA. SECCIÓN,2,11,5,6,2
CHIAPAS,7,CATAZAJÁ,016,EL ROSARIO,5,260,132,128,14
CHIAPAS,7,CATAZAJÁ,016,EL TINTO BONSHÁN,3,38,27,11,3
CHIAPAS,7,CATAZAJÁ,016,EMILIANO ZAPATA (SAN JOAQUÍN),2,37,19,18,3
CHIAPAS,7,CATAZAJÁ,016,ESTACIÓN LA UNIÓN,3,274,126,148,11
CHIAPAS,7,CATAZAJÁ,016,FAMILIA GONZÁLEZ RÍO,1,17,7,10,2
CHIAPAS,7,CATAZAJÁ,016,FRANCISCO J. GRAJALES,3,96,54,42,5
CHIAPAS,7,CATAZAJÁ,016,IGNACIO ZARAGOZA,3,145,63,82,9
CHIAPAS,7,CATAZAJÁ,016,JICALANGO,2,12,5,7,2
CHIAPAS,7,CATAZAJÁ,016,JUAN ALDAMA,2,26,11,15,3
CHIAPAS,7,CATAZAJÁ,016,LA PERLA,1,42,22,20,3
CHIAPAS,7,CATAZAJÁ,016,LA SIRIA 1RA. SECCIÓN,2,50,20,30,4
CHIAPAS,7,CATAZAJÁ,016,LA SIRIA 2DA. SECCIÓN,2,23,7,16,3
CHIAPAS,7,CATAZAJÁ,016,LA TUZA (MACEO),3,86,38,48,7
CHIAPAS,7,CATAZAJÁ,016,LANDERO CÁRDENAS,2,14,7,7,1
CHIAPAS,7,CATAZAJÁ,016,LAS DELICIAS,1,11,7,4,1
CHIAPAS,7,CATAZAJÁ,016,LÁZARO CÁRDENAS,2,19,9,10,2
CHIAPAS,7,CATAZAJÁ,016,LINDA VISTA 1RA. SECCIÓN,2,21,8,13,2
CHIAPAS,7,CATAZAJÁ,016,LINDAVISTA 2DA. SECCIÓN,1,7,1,6,1
CHIAPAS,7,CATAZAJÁ,016,LOMA BONITA,3,206,111,95,13
CHIAPAS,7,CATAZAJÁ,016,PATRICIO LOS ÁNGELES,2,20,11,9,2
CHIAPAS,7,CATAZAJÁ,016,PATRICIO TAMARINDO,2,35,17,18,2
CHIAPAS,7,CATAZAJÁ,016,PUNTA ARENA,4,245,107,138,11
CHIAPAS,7,CATAZAJÁ,016,SAN AGUSTÍN,1,14,7,7,1
CHIAPAS,7,CATAZAJÁ,016,SAN SIMÓN,2,17,9,8,2
CHIAPAS,7,CATAZAJÁ,016,SANTA CRUZ 2DA. SECCIÓN DE LOMA BONITA,2,58,28,30,3
CHIAPAS,7,CATAZAJÁ,016,SANTA ROSA,1,14,7,7,1
CHIAPAS,7,CATAZAJÁ,016,TECOLPA,1,22,9,13,1
CHIAPAS,7,CATAZAJÁ,016,VICTORICO R. GRAJALES,2,31,19,12,3
CHIAPAS,7,CINTALAPA DE FIGUEROA,017,ABELARDO L. RODRÍGUEZ,4,333,168,165,14
CHIAPAS,7,CINTALAPA DE FIGUEROA,017,ADOLFO LÓPEZ MATEOS,4,377,186,191,16
CHIAPAS,7,CINTALAPA DE FIGUEROA,017,AMATÁN (CERRO BRUJO),2,25,13,12,4
CHIAPAS,7,CINTALAPA DE FIGUEROA,017,ANDRÉS GÓMEZ,1,5,3,2,1
CHIAPAS,7,CINTALAPA DE FIGUEROA,017,BENITO JUÁREZ DOS,1,38,17,21,2
CHIAPAS,7,CINTALAPA DE FIGUEROA,017,BETHEL,3,44,22,22,3
CHIAPAS,7,CINTALAPA DE FIGUEROA,017,CINTALAPA DE FIGUEROA,90,15530,7487,8043,852
CHIAPAS,7,CINTALAPA DE FIGUEROA,017,CONSTITUCIÓN (EL CHAYOTAL),4,218,111,107,12
CHIAPAS,7,CINTALAPA DE FIGUEROA,017,CORAZÓN DEL VALLE,2,34,20,14,3
CHIAPAS,7,CINTALAPA DE FIGUEROA,017,DIEZ DE ABRIL,3,37,15,22,3
CHIAPAS,7,CINTALAPA DE FIGUEROA,017,EL CARMEN,3,24,12,12,3
CHIAPAS,7,CINTALAPA DE FIGUEROA,017,EL CHICHONAL,2,13,3,10,1
CHIAPAS,7,CINTALAPA DE FIGUEROA,017,EL DANUBIO,1,7,4,3,1
CHIAPAS,7,CINTALAPA DE FIGUEROA,017,EL MIRADOR,3,160,74,86,7
CHIAPAS,7,CINTALAPA DE FIGUEROA,017,EL NUEVO EDÉN,2,23,11,12,2
CHIAPAS,7,CINTALAPA DE FIGUEROA,017,EL PORVENIR,2,16,11,5,2
CHIAPAS,7,CINTALAPA DE FIGUEROA,017,EL PROGRESO,3,42,18,24,4
CHIAPAS,7,CINTALAPA DE FIGUEROA,017,EL ROSARIO,3,31,16,15,3
CHIAPAS,7,CINTALAPA DE FIGUEROA,017,EMILIANO ZAPATA,6,616,295,321,28
CHIAPAS,7,CINTALAPA DE FIGUEROA,017,ESPERANZA DE LOS POBRES,3,286,140,146,10
CHIAPAS,7,CINTALAPA DE FIGUEROA,017,ESTORACÓN,3,35,14,21,3
CHIAPAS,7,CINTALAPA DE FIGUEROA,017,FRANCISCO I. MADERO,4,561,297,264,23
CHIAPAS,7,CINTALAPA DE FIGUEROA,017,FRANCISCO SARABIA,2,13,6,7,2
CHIAPAS,7,CINTALAPA DE FIGUEROA,017,FRANCISCO VILLA,2,7,3,4,1
CHIAPAS,7,CINTALAPA DE FIGUEROA,017,GENERAL CÁRDENAS,2,120,57,63,5
CHIAPAS,7,CINTALAPA DE FIGUEROA,017,GRACIAS A DIOS,2,48,20,28,4
CHIAPAS,7,CINTALAPA DE FIGUEROA,017,GUADALUPE VICTORIA,4,134,72,62,7
CHIAPAS,7,CINTALAPA DE FIGUEROA,017,GUADALUPE VICTORIA UNO (LA HERRADURA),1,5,2,3,1
CHIAPAS,7,CINTALAPA DE FIGUEROA,017,IGNACIO ZARAGOZA,3,103,51,52,7
CHIAPAS,7,CINTALAPA DE FIGUEROA,017,INGENIERO ELOY BORRAS AGUILAR,2,58,32,26,3
CHIAPAS,7,CINTALAPA DE FIGUEROA,017,INTEGRAL ADOLFO LÓPEZ MATEOS,3,73,26,47,5
CHIAPAS,7,CINTALAPA DE FIGUEROA,017,JACINTO TIRADO,3,221,101,120,11
CHIAPAS,7,CINTALAPA DE FIGUEROA,017,JORGE DE LA VEGA DOMÍNGUEZ (LAS PAVAS),3,59,25,34,4
CHIAPAS,7,CINTALAPA DE FIGUEROA,017,JOSÉ CASTILLO TIELMANS,2,111,49,62,3
CHIAPAS,7,CINTALAPA DE FIGUEROA,017,JUAN SABINES GUERRERO,2,30,14,16,2
CHIAPAS,7,CINTALAPA DE FIGUEROA,017,LA ASUNCIÓN,2,35,16,19,2
CHIAPAS,7,CINTALAPA DE FIGUEROA,017,LA BANDERA,2,13,7,6,2
CHIAPAS,7,CINTALAPA DE FIGUEROA,017,LA FLORIDA,3,142,60,82,8
CHIAPAS,7,CINTALAPA DE FIGUEROA,017,LA PANELITA,2,18,8,10,2
CHIAPAS,7,CINTALAPA DE FIGUEROA,017,LAS CARMELITAS,2,41,24,17,2
CHIAPAS,7,CINTALAPA DE FIGUEROA,017,LAS GARDENIAS,1,5,2,3,1
CHIAPAS,7,CINTALAPA DE FIGUEROA,017,LAS MERCEDITAS,2,37,18,19,3
CHIAPAS,7,CINTALAPA DE FIGUEROA,017,LAS PALMAS,2,42,24,18,2
CHIAPAS,7,CINTALAPA DE FIGUEROA,017,LÁZARO CÁRDENAS,6,784,388,396,31
CHIAPAS,7,CINTALAPA DE FIGUEROA,017,LINDAVISTA,3,12,5,7,3
CHIAPAS,7,CINTALAPA DE FIGUEROA,017,LOS HORCONES,2,15,7,8,2
CHIAPAS,7,CINTALAPA DE FIGUEROA,017,LOS JOAQUINES,2,41,24,17,2
CHIAPAS,7,CINTALAPA DE FIGUEROA,017,LOS OLACHEA (SAN ANTONIO VALDIVIANA),2,38,14,24,3
CHIAPAS,7,CINTALAPA DE FIGUEROA,017,MARIANO PÉREZ DÍAZ (LA JOYA),3,64,34,30,5
CHIAPAS,7,CINTALAPA DE FIGUEROA,017,MÉRIDA,3,308,162,146,11
CHIAPAS,7,CINTALAPA DE FIGUEROA,017,MONTE DE LOS OLIVOS (LA MONA),2,115,55,60,3
CHIAPAS,7,CINTALAPA DE FIGUEROA,017,MONTE OREB,3,52,21,31,4
CHIAPAS,7,CINTALAPA DE FIGUEROA,017,MONTE SINAÍ DOS (EL FÉNIX),3,175,88,87,6
CHIAPAS,7,CINTALAPA DE FIGUEROA,017,MONTE SINAÍ DOS (LOS HORCONES),3,15,6,9,3
CHIAPAS,7,CINTALAPA DE FIGUEROA,017,MONTERREY,3,46,18,28,5
CHIAPAS,7,CINTALAPA DE FIGUEROA,017,NIÑOS HÉROES,3,35,14,21,3
CHIAPAS,7,CINTALAPA DE FIGUEROA,017,NUEVA ESPERANZA 2DA. SECCIÓN,3,41,25,16,4
CHIAPAS,7,CINTALAPA DE FIGUEROA,017,NUEVA LIBERACIÓN,3,66,34,32,4
CHIAPAS,7,CINTALAPA DE FIGUEROA,017,NUEVA LIBERTAD,2,54,23,31,4
CHIAPAS,7,CINTALAPA DE FIGUEROA,017,NUEVA PIMIENTA,3,27,8,19,4
CHIAPAS,7,CINTALAPA DE FIGUEROA,017,NUEVA REFORMA (EL RECREO),3,83,47,36,5
CHIAPAS,7,CINTALAPA DE FIGUEROA,017,NUEVA TENOCHTITLÁN (RIZO DE ORO),4,437,213,224,21
CHIAPAS,7,CINTALAPA DE FIGUEROA,017,NUEVAS MARAVILLAS,4,342,180,162,11
CHIAPAS,7,CINTALAPA DE FIGUEROA,017,NUEVO AMANECER TENEJAPA,3,35,17,18,4
CHIAPAS,7,CINTALAPA DE FIGUEROA,017,NUEVO COYOACÁN,2,47,21,26,2
CHIAPAS,7,CINTALAPA DE FIGUEROA,017,ONCE DE JUNIO,2,23,9,14,2
CHIAPAS,7,CINTALAPA DE FIGUEROA,017,PIMIENTA BERLÍN,2,44,14,30,2
CHIAPAS,7,CINTALAPA DE FIGUEROA,017,POMPOSO CASTELLANOS,4,448,235,213,20
CHIAPAS,7,CINTALAPA DE FIGUEROA,017,RAFAEL CAL Y MAYOR,1,133,61,72,6
CHIAPAS,7,CINTALAPA DE FIGUEROA,017,RINCÓN ANTONIO,3,40,23,17,3
CHIAPAS,7,CINTALAPA DE FIGUEROA,017,ROBERTO BARRIOS,3,67,34,33,4
CHIAPAS,7,CINTALAPA DE FIGUEROA,017,ROSENDO SALAZAR,3,225,114,111,13
CHIAPAS,7,CINTALAPA DE FIGUEROA,017,SAN CARLOS,1,18,13,5,1
CHIAPAS,7,CINTALAPA DE FIGUEROA,017,SAN MARCOS,3,182,86,96,9
CHIAPAS,7,CINTALAPA DE FIGUEROA,017,SAN PEDRO,1,6,3,3,1
CHIAPAS,7,CINTALAPA DE FIGUEROA,017,SAN SEBASTIÁN,2,30,13,17,2
CHIAPAS,7,CINTALAPA DE FIGUEROA,017,SANTA FE,2,23,8,15,2
CHIAPAS,7,CINTALAPA DE FIGUEROA,017,SANTA MARÍA,2,6,1,5,1
CHIAPAS,7,CINTALAPA DE FIGUEROA,017,SANTA RITA LAGUNA SECA,2,26,12,14,2
CHIAPAS,7,CINTALAPA DE FIGUEROA,017,SANTA ROSA,1,22,11,11,1
CHIAPAS,7,CINTALAPA DE FIGUEROA,017,SIMÓN BOLÍVAR (EL TRANSVAL),2,15,7,8,2
CHIAPAS,7,CINTALAPA DE FIGUEROA,017,TEHUACAN,3,112,60,52,6
CHIAPAS,7,CINTALAPA DE FIGUEROA,017,TRIUNFO DE MADERO,4,287,143,144,14
CHIAPAS,7,CINTALAPA DE FIGUEROA,017,TUXTLITA,1,14,6,8,1
CHIAPAS,7,CINTALAPA DE FIGUEROA,017,UNIDAD MODELO,3,157,76,81,5
CHIAPAS,7,CINTALAPA DE FIGUEROA,017,VALLE DE CORZO (SAN FERNANDO),2,14,5,9,2
CHIAPAS,7,CINTALAPA DE FIGUEROA,017,VALLE DORADO,2,9,4,5,1
CHIAPAS,7,CINTALAPA DE FIGUEROA,017,VENUSTIANO CARRANZA,3,173,85,88,6
CHIAPAS,7,CINTALAPA DE FIGUEROA,017,VILLA DEL RÍO,3,11,6,5,2
CHIAPAS,7,CINTALAPA DE FIGUEROA,017,VILLAMORELOS,5,538,266,272,45
CHIAPAS,7,CINTALAPA DE FIGUEROA,017,VISTA HERMOSA,4,272,123,149,13
CHIAPAS,7,CINTALAPA DE FIGUEROA,017,YERBASANTA,1,35,20,15,1
CHIAPAS,7,COAPILLA,018,BUENAVISTA (MATASANOS),4,542,270,272,24
CHIAPAS,7,COAPILLA,018,COAPILLA,11,1206,593,613,55
CHIAPAS,7,COAPILLA,018,ESQUIPULAS,2,28,15,13,2
CHIAPAS,7,COAPILLA,018,GUADALUPE,1,14,6,8,1
CHIAPAS,7,COAPILLA,018,JOSÉ MARÍA MORELOS Y PAVÓN,3,460,237,223,19
CHIAPAS,7,COAPILLA,018,LA TRINIDAD,2,42,16,26,2
CHIAPAS,7,COAPILLA,018,LLANO GRANDE,3,248,118,130,12
CHIAPAS,7,COAPILLA,018,MONTE GRANDE,2,10,5,5,2
CHIAPAS,7,COAPILLA,018,MORELIA,4,98,44,54,6
CHIAPAS,7,COAPILLA,018,PIEDRA GRANDE,1,25,9,16,1
CHIAPAS,7,COAPILLA,018,SAN JUAN BAUTISTA,3,62,32,30,4
CHIAPAS,7,COAPILLA,018,SAN SEBASTIÁN,2,70,35,35,5
CHIAPAS,7,COAPILLA,018,SANTO DOMINGO,2,23,14,9,2
CHIAPAS,7,COAPILLA,018,UNIÓN PORTES GIL (SAN PEDRO),3,90,42,48,4
CHIAPAS,7,COAPILLA,018,VICENTE GUERRERO,4,211,98,113,11
CHIAPAS,7,COMITÁN DE DOMÍNGUEZ,019,ABELARDO L. RODRÍGUEZ,3,217,109,108,10
CHIAPAS,7,COMITÁN DE DOMÍNGUEZ,019,AGUA ESCONDIDA,1,7,3,4,1
CHIAPAS,7,COMITÁN DE DOMÍNGUEZ,019,AJAYAXCH,2,80,36,44,4
CHIAPAS,7,COMITÁN DE DOMÍNGUEZ,019,ARTURO ALBORES VELASCO,2,53,25,28,4
CHIAPAS,7,COMITÁN DE DOMÍNGUEZ,019,BASQUÉN,3,32,19,13,3
CHIAPAS,7,COMITÁN DE DOMÍNGUEZ,019,BOLANTÓN,2,51,25,26,3
CHIAPAS,7,COMITÁN DE DOMÍNGUEZ,019,BUENAVISTA EL OCOTE,1,7,2,5,1
CHIAPAS,7,COMITÁN DE DOMÍNGUEZ,019,BUENAVISTA GRACIAS A DIOS,2,33,12,21,2
CHIAPAS,7,COMITÁN DE DOMÍNGUEZ,019,BUENAVISTA VILLAFLORES,2,21,12,9,2
CHIAPAS,7,COMITÁN DE DOMÍNGUEZ,019,CAJCAM,2,104,55,49,3
CHIAPAS,7,COMITÁN DE DOMÍNGUEZ,019,CANALUM,2,66,31,35,3
CHIAPAS,7,COMITÁN DE DOMÍNGUEZ,019,CASH,2,288,140,148,10
CHIAPAS,7,COMITÁN DE DOMÍNGUEZ,019,CHACALJOCOM,3,347,155,192,13
CHIAPAS,7,COMITÁN DE DOMÍNGUEZ,019,CHICHIMÁ ACAPETAHUA,2,57,25,32,3
CHIAPAS,7,COMITÁN DE DOMÍNGUEZ,019,CHICHIMÁ SABINAL,2,140,61,79,7
CHIAPAS,7,COMITÁN DE DOMÍNGUEZ,019,CHITIJÁ,2,74,35,39,3
CHIAPAS,7,COMITÁN DE DOMÍNGUEZ,019,CHUJALÁ,2,13,5,8,2
CHIAPAS,7,COMITÁN DE DOMÍNGUEZ,019,COMITÁN DE DOMÍNGUEZ,173,34881,17469,17412,2039
CHIAPAS,7,COMITÁN DE DOMÍNGUEZ,019,CONCEPCIÓN YOCNAJAB,2,28,13,15,2
CHIAPAS,7,COMITÁN DE DOMÍNGUEZ,019,CORRALA,3,264,118,146,11
CHIAPAS,7,COMITÁN DE DOMÍNGUEZ,019,DOS CRUCES,2,39,18,21,2
CHIAPAS,7,COMITÁN DE DOMÍNGUEZ,019,EFRAÍN A. GUTIÉRREZ,4,492,226,266,22
CHIAPAS,7,COMITÁN DE DOMÍNGUEZ,019,EL CARMEN CANDELARIA (LAGUNA SECA),1,5,3,2,1
CHIAPAS,7,COMITÁN DE DOMÍNGUEZ,019,EL DURAZNO,2,24,13,11,2
CHIAPAS,7,COMITÁN DE DOMÍNGUEZ,019,EL MEMBRILLO,1,14,7,7,1
CHIAPAS,7,COMITÁN DE DOMÍNGUEZ,019,EL PRADO,2,101,50,51,5
CHIAPAS,7,COMITÁN DE DOMÍNGUEZ,019,EL ROSARIO,1,14,5,9,1
CHIAPAS,7,COMITÁN DE DOMÍNGUEZ,019,EL TANQUE,2,43,19,24,3
CHIAPAS,7,COMITÁN DE DOMÍNGUEZ,019,EL TUILAÍTO PUNTA DE DIAMANTE,2,30,8,22,2
CHIAPAS,7,COMITÁN DE DOMÍNGUEZ,019,EL VERGEL DOLORES,1,6,1,5,1
CHIAPAS,7,COMITÁN DE DOMÍNGUEZ,019,FRANCISCO J. MÚJICA,3,159,76,83,7
CHIAPAS,7,COMITÁN DE DOMÍNGUEZ,019,FRANCISCO SARABIA,4,640,319,321,26
CHIAPAS,7,COMITÁN DE DOMÍNGUEZ,019,GUADALUPE BUENAVISTA,3,255,125,130,10
CHIAPAS,7,COMITÁN DE DOMÍNGUEZ,019,GUADALUPE EL JAGÜEY,3,33,17,16,4
CHIAPAS,7,COMITÁN DE DOMÍNGUEZ,019,GUADALUPE PALMIRA,3,314,141,173,13
CHIAPAS,7,COMITÁN DE DOMÍNGUEZ,019,GUADALUPE QUISTAJ,2,122,58,64,5
CHIAPAS,7,COMITÁN DE DOMÍNGUEZ,019,GUADALUPE SALVATIERRA,2,24,11,13,2
CHIAPAS,7,COMITÁN DE DOMÍNGUEZ,019,GUADALUPE YOCNAJAB,1,12,7,5,1
CHIAPAS,7,COMITÁN DE DOMÍNGUEZ,019,HIDALGO,2,89,37,52,4
CHIAPAS,7,COMITÁN DE DOMÍNGUEZ,019,ISLAPÁ (EL ROSARIO),1,6,4,2,1
CHIAPAS,7,COMITÁN DE DOMÍNGUEZ,019,JUAN SABINES GUERRERO,4,212,118,94,10
CHIAPAS,7,COMITÁN DE DOMÍNGUEZ,019,JUZNAJAB LA LAGUNA,4,283,139,144,11
CHIAPAS,7,COMITÁN DE DOMÍNGUEZ,019,LA CANDELARIA,1,222,106,116,7
CHIAPAS,7,COMITÁN DE DOMÍNGUEZ,019,LA FLORESTA,4,690,308,382,30
CHIAPAS,7,COMITÁN DE DOMÍNGUEZ,019,LA SOMBRA,2,18,8,10,2
CHIAPAS,7,COMITÁN DE DOMÍNGUEZ,019,LAGUNA CHAMULA,2,16,9,7,2
CHIAPAS,7,COMITÁN DE DOMÍNGUEZ,019,LAGUNA FLORECILLA,1,11,10,1,1
CHIAPAS,7,COMITÁN DE DOMÍNGUEZ,019,LAGUNA LARGA,3,87,48,39,5
CHIAPAS,7,COMITÁN DE DOMÍNGUEZ,019,LAGUNA SECA,2,28,16,12,2
CHIAPAS,7,COMITÁN DE DOMÍNGUEZ,019,LAS CANOAS,2,13,5,8,1
CHIAPAS,7,COMITÁN DE DOMÍNGUEZ,019,LAS FLORES,2,128,65,63,4
CHIAPAS,7,COMITÁN DE DOMÍNGUEZ,019,LAS PALMAS,2,60,25,35,3
CHIAPAS,7,COMITÁN DE DOMÍNGUEZ,019,LOS LAURELES,2,45,22,23,3
CHIAPAS,7,COMITÁN DE DOMÍNGUEZ,019,LOS RIEGOS,5,570,284,286,24
CHIAPAS,7,COMITÁN DE DOMÍNGUEZ,019,LOS SABINOS,1,330,178,152,12
CHIAPAS,7,COMITÁN DE DOMÍNGUEZ,019,MIGUEL DE LA MADRID,2,62,38,24,4
CHIAPAS,7,COMITÁN DE DOMÍNGUEZ,019,NUEVA ERA COMITECA,1,31,12,19,1
CHIAPAS,7,COMITÁN DE DOMÍNGUEZ,019,OQUISTÓN CANDELARIA,1,8,4,4,1
CHIAPAS,7,COMITÁN DE DOMÍNGUEZ,019,PAMALA,2,105,58,47,5
CHIAPAS,7,COMITÁN DE DOMÍNGUEZ,019,PASHTÓN ACAPULCO,4,990,483,507,31
CHIAPAS,7,COMITÁN DE DOMÍNGUEZ,019,POZO NUEVO,2,72,41,31,3
CHIAPAS,7,COMITÁN DE DOMÍNGUEZ,019,PRIMERO DE MAYO,4,310,154,156,15
CHIAPAS,7,COMITÁN DE DOMÍNGUEZ,019,QUIJÁ,3,341,176,165,13
CHIAPAS,7,COMITÁN DE DOMÍNGUEZ,019,RINCÓN GUADALUPE,1,10,6,4,1
CHIAPAS,7,COMITÁN DE DOMÍNGUEZ,019,RÍO GRANDE,2,425,207,218,15
CHIAPAS,7,COMITÁN DE DOMÍNGUEZ,019,SAN ANTONIO BELLAVISTA,2,42,25,17,3
CHIAPAS,7,COMITÁN DE DOMÍNGUEZ,019,SAN ANTONIO COPALAR,2,61,30,31,3
CHIAPAS,7,COMITÁN DE DOMÍNGUEZ,019,SAN ANTONIO LAS LABORES,1,6,5,1,1
CHIAPAS,7,COMITÁN DE DOMÍNGUEZ,019,SAN ANTONIO LAS MINAS,1,7,1,6,1
CHIAPAS,7,COMITÁN DE DOMÍNGUEZ,019,SAN ANTONIO OGOTZIL,2,143,71,72,7
CHIAPAS,7,COMITÁN DE DOMÍNGUEZ,019,SAN ANTONIO Z,1,18,7,11,1
CHIAPAS,7,COMITÁN DE DOMÍNGUEZ,019,SAN FRANCISCO EL ARENAL,1,20,5,15,1
CHIAPAS,7,COMITÁN DE DOMÍNGUEZ,019,SAN FRANCISCO EL DESENGAÑO,1,30,16,14,1
CHIAPAS,7,COMITÁN DE DOMÍNGUEZ,019,SAN FRANCISCO EL RINCÓN,2,88,36,52,4
CHIAPAS,7,COMITÁN DE DOMÍNGUEZ,019,SAN FRANCISCO LA PRIMAVERA,1,7,0,7,1
CHIAPAS,7,COMITÁN DE DOMÍNGUEZ,019,SAN FRANCISCO UNINAJAB,3,38,17,21,4
CHIAPAS,7,COMITÁN DE DOMÍNGUEZ,019,SAN ISIDRO,3,32,20,12,4
CHIAPAS,7,COMITÁN DE DOMÍNGUEZ,019,SAN ISIDRO CANDELARIA,1,15,7,8,1
CHIAPAS,7,COMITÁN DE DOMÍNGUEZ,019,SAN ISIDRO TINAJAB,1,42,29,13,3
CHIAPAS,7,COMITÁN DE DOMÍNGUEZ,019,SAN JOSÉ BERLÍN,3,92,44,48,6
CHIAPAS,7,COMITÁN DE DOMÍNGUEZ,019,SAN JOSÉ EL ARENAL,1,12,2,10,1
CHIAPAS,7,COMITÁN DE DOMÍNGUEZ,019,SAN JOSÉ LAS ROSAS,2,43,24,19,3
CHIAPAS,7,COMITÁN DE DOMÍNGUEZ,019,SAN JOSÉ YALACEVO,1,8,5,3,1
CHIAPAS,7,COMITÁN DE DOMÍNGUEZ,019,SAN JOSÉ YOCNAJAB,3,649,324,325,24
CHIAPAS,7,COMITÁN DE DOMÍNGUEZ,019,SAN MATEO,1,7,5,2,1
CHIAPAS,7,COMITÁN DE DOMÍNGUEZ,019,SAN MIGUEL LA CAÑADA,2,15,5,10,2
CHIAPAS,7,COMITÁN DE DOMÍNGUEZ,019,SAN MIGUEL TINAJAB,2,62,30,32,4
CHIAPAS,7,COMITÁN DE DOMÍNGUEZ,019,SAN PEDRO UNINAJAB,1,20,12,8,1
CHIAPAS,7,COMITÁN DE DOMÍNGUEZ,019,SAN RAFAEL CHACALJEMEL,1,7,4,3,1
CHIAPAS,7,COMITÁN DE DOMÍNGUEZ,019,SAN RAFAEL JOCOM,2,113,58,55,5
CHIAPAS,7,COMITÁN DE DOMÍNGUEZ,019,SAN RAMÓN,2,28,12,16,2
CHIAPAS,7,COMITÁN DE DOMÍNGUEZ,019,SAN VICENTE BUENAVISTA,1,8,5,3,1
CHIAPAS,7,COMITÁN DE DOMÍNGUEZ,019,SAN VICENTE CANDELARIA,3,37,20,17,4
CHIAPAS,7,COMITÁN DE DOMÍNGUEZ,019,SANTA ANA CALUNCHUY (PUEBLO NUEVO),2,47,26,21,3
CHIAPAS,7,COMITÁN DE DOMÍNGUEZ,019,SANTA ELENA DE LAS AGUJAS,1,20,10,10,1
CHIAPAS,7,COMITÁN DE DOMÍNGUEZ,019,SANTA LUCÍA,1,6,3,3,1
CHIAPAS,7,COMITÁN DE DOMÍNGUEZ,019,SANTA MARTHA LAS PALMAS,1,28,13,15,1
CHIAPAS,7,COMITÁN DE DOMÍNGUEZ,019,SANTA RITA UNINAJAB,3,48,23,25,5
CHIAPAS,7,COMITÁN DE DOMÍNGUEZ,019,SANTA ROSA,1,10,6,4,1
CHIAPAS,7,COMITÁN DE DOMÍNGUEZ,019,SANTA ROSALÍA,2,354,179,175,11
CHIAPAS,7,COMITÁN DE DOMÍNGUEZ,019,SANTO DOMINGO DE LAS GRANADAS,2,104,47,57,4
CHIAPAS,7,COMITÁN DE DOMÍNGUEZ,019,SEÑOR DEL POZO,3,189,97,92,8
CHIAPAS,7,COMITÁN DE DOMÍNGUEZ,019,TIERRA BLANCA,2,91,42,49,5
CHIAPAS,7,COMITÁN DE DOMÍNGUEZ,019,TIERRA NEGRA,1,7,3,4,1
CHIAPAS,7,COMITÁN DE DOMÍNGUEZ,019,TUILA EL GRANDE,2,22,10,12,2
CHIAPAS,7,COMITÁN DE DOMÍNGUEZ,019,VILLAHERMOSA YALUMÁ,3,597,291,306,23
CHIAPAS,7,COMITÁN DE DOMÍNGUEZ,019,YALTACHÉ BUENAVISTA,1,11,8,3,1
CHIAPAS,7,COMITÁN DE DOMÍNGUEZ,019,YALTZI TRES LAGUNAS,4,359,171,188,16
CHIAPAS,7,COMITÁN DE DOMÍNGUEZ,019,YOCNAJAB EL ROSARIO,3,333,153,180,14
CHIAPAS,7,COMITÁN DE DOMÍNGUEZ,019,ZARAGOZA LA MONTAÑA,4,528,271,257,24
CHIAPAS,7,LA CONCORDIA,020,30 DE AGOSTO,2,10,8,2,2
CHIAPAS,7,LA CONCORDIA,020,AGUAS BLANCAS,2,11,6,5,2
CHIAPAS,7,LA CONCORDIA,020,ANTIGUA MARAVILLAS,2,26,12,14,2
CHIAPAS,7,LA CONCORDIA,020,BÉLGICA UNO,1,7,2,5,1
CHIAPAS,7,LA CONCORDIA,020,BENITO JUÁREZ,3,600,283,317,32
CHIAPAS,7,LA CONCORDIA,020,BERLÍN,2,30,20,10,3
CHIAPAS,7,LA CONCORDIA,020,BUENAVISTA,2,24,13,11,2
CHIAPAS,7,LA CONCORDIA,020,CABAÑAS,2,38,16,22,3
CHIAPAS,7,LA CONCORDIA,020,CANDELARIA Y NUEVA ESPERANZA,2,17,9,8,2
CHIAPAS,7,LA CONCORDIA,020,CORAZÓN DE JESÚS,1,9,6,3,1
CHIAPAS,7,LA CONCORDIA,020,CUSTEPEC,3,91,47,44,8
CHIAPAS,7,LA CONCORDIA,020,DOLORES JALTENANGO,4,522,260,262,25
CHIAPAS,7,LA CONCORDIA,020,EL ALTILLO,3,112,58,54,5
CHIAPAS,7,LA CONCORDIA,020,EL ÁMBAR (EL ÁMBAR DE ECHEVERRÍA),3,795,396,399,36
CHIAPAS,7,LA CONCORDIA,020,EL ARROYÓN,3,41,16,25,4
CHIAPAS,7,LA CONCORDIA,020,EL CAIRO,1,4,2,2,1
CHIAPAS,7,LA CONCORDIA,020,EL CARMEN,1,5,1,4,1
CHIAPAS,7,LA CONCORDIA,020,EL CARRIZAL,1,7,2,5,1
CHIAPAS,7,LA CONCORDIA,020,EL CIPRÉS,4,118,57,61,9
CHIAPAS,7,LA CONCORDIA,020,EL DIAMANTE DE ECHEVERRÍA,4,589,290,299,27
CHIAPAS,7,LA CONCORDIA,020,EL ESPINAL,3,51,27,24,4
CHIAPAS,7,LA CONCORDIA,020,EL FORTÍN,1,58,27,31,2
CHIAPAS,7,LA CONCORDIA,020,EL LAUREL,1,5,3,2,1
CHIAPAS,7,LA CONCORDIA,020,EL MIRADOR,2,8,3,5,1
CHIAPAS,7,LA CONCORDIA,020,EL OLVIDO,2,17,9,8,2
CHIAPAS,7,LA CONCORDIA,020,EL PACAYAL,2,17,9,8,2
CHIAPAS,7,LA CONCORDIA,020,EL PARAÍSO,1,6,1,5,1
CHIAPAS,7,LA CONCORDIA,020,EL PASTAL,2,14,5,9,2
CHIAPAS,7,LA CONCORDIA,020,EL RAMAL (PORVENIR),2,152,72,80,9
CHIAPAS,7,LA CONCORDIA,020,EL RETIRO,4,185,106,79,11
CHIAPAS,7,LA CONCORDIA,020,EMILIANO ZAPATA,3,66,31,35,6
CHIAPAS,7,LA CONCORDIA,020,GARDENIAS,1,7,1,6,1
CHIAPAS,7,LA CONCORDIA,020,GUADALUPE MARAVILLAS,3,172,88,84,9
CHIAPAS,7,LA CONCORDIA,020,GUADALUPE VICTORIA,4,263,142,121,14
CHIAPAS,7,LA CONCORDIA,020,IGNACIO ZARAGOZA,4,325,149,176,15
CHIAPAS,7,LA CONCORDIA,020,INDEPENDENCIA,5,910,429,481,63
CHIAPAS,7,LA CONCORDIA,020,JUAN SABINES GUTIÉRREZ,2,65,29,36,3
CHIAPAS,7,LA CONCORDIA,020,LA CONCORDIA,13,2369,1149,1220,114
CHIAPAS,7,LA CONCORDIA,020,LA CRUZ BLANCA,2,12,6,6,2
CHIAPAS,7,LA CONCORDIA,020,LA GRANJA,1,7,3,4,1
CHIAPAS,7,LA CONCORDIA,020,LA SOLEDAD,2,40,23,17,4
CHIAPAS,7,LA CONCORDIA,020,LA TIGRILLA,3,572,276,296,24
CHIAPAS,7,LA CONCORDIA,020,LAS BRISAS,1,8,3,5,1
CHIAPAS,7,LA CONCORDIA,020,LAS DELICIAS,1,7,3,4,1
CHIAPAS,7,LA CONCORDIA,020,LAS GARDENIAS,3,21,8,13,3
CHIAPAS,7,LA CONCORDIA,020,LAS JOYAS,1,5,1,4,1
CHIAPAS,7,LA CONCORDIA,020,LAS TORONJAS,2,46,20,26,3
CHIAPAS,7,LA CONCORDIA,020,LAS VIOLETAS,3,34,18,16,3
CHIAPAS,7,LA CONCORDIA,020,LLANO GRANDE,3,37,19,18,3
CHIAPAS,7,LA CONCORDIA,020,LOS ALPES,1,12,7,5,1
CHIAPAS,7,LA CONCORDIA,020,LOS JUANES,1,26,15,11,1
CHIAPAS,7,LA CONCORDIA,020,MARÍA AUXILIADORA,1,8,5,3,1
CHIAPAS,7,LA CONCORDIA,020,MÉRIDA,1,7,4,3,1
CHIAPAS,7,LA CONCORDIA,020,MONCLOVA,3,45,19,26,4
CHIAPAS,7,LA CONCORDIA,020,MONTE ALBÁN,3,49,27,22,4
CHIAPAS,7,LA CONCORDIA,020,MONTE NARANJO (EMILIANO ZAPATA),2,16,7,9,2
CHIAPAS,7,LA CONCORDIA,020,MONTE VERDE MARAVILLAS,1,8,4,4,1
CHIAPAS,7,LA CONCORDIA,020,MONTERREY,2,120,66,54,8
CHIAPAS,7,LA CONCORDIA,020,MORELIA,1,5,2,3,1
CHIAPAS,7,LA CONCORDIA,020,NATIVIDAD,2,7,2,5,1
CHIAPAS,7,LA CONCORDIA,020,NAYARIT,2,41,13,28,4
CHIAPAS,7,LA CONCORDIA,020,NIÑOS HÉROES,3,204,87,117,11
CHIAPAS,7,LA CONCORDIA,020,NUEVA JERUSALÉN,3,81,39,42,8
CHIAPAS,7,LA CONCORDIA,020,NUEVA LIBERTAD,3,277,127,150,11
CHIAPAS,7,LA CONCORDIA,020,NUEVO COPAL,3,57,27,30,4
CHIAPAS,7,LA CONCORDIA,020,NUEVO PARAÍSO,4,410,213,197,16
CHIAPAS,7,LA CONCORDIA,020,NUEVO RESPLANDOR,4,335,170,165,17
CHIAPAS,7,LA CONCORDIA,020,NUEVO SAN JUAN,2,33,15,18,3
CHIAPAS,7,LA CONCORDIA,020,NUEVO SONORA,3,78,39,39,5
CHIAPAS,7,LA CONCORDIA,020,NUEVO VERGEL,1,7,2,5,1
CHIAPAS,7,LA CONCORDIA,020,PERLA DEL GRIJALVA,3,57,33,24,4
CHIAPAS,7,LA CONCORDIA,020,PIEDRA BLANCA (LA VEGA DEL PALMAR),3,45,29,16,3
CHIAPAS,7,LA CONCORDIA,020,PLAN DE AGUA PRIETA,3,523,241,282,21
CHIAPAS,7,LA CONCORDIA,020,PLAN DE LA LIBERTAD,5,363,187,176,19
CHIAPAS,7,LA CONCORDIA,020,PLAN DE LA LIBERTAD BAJA (EL RECREO),2,169,65,104,7
CHIAPAS,7,LA CONCORDIA,020,QUETZAL 4 (SAN BLAS),1,5,3,2,1
CHIAPAS,7,LA CONCORDIA,020,RANCHO ALEGRE,1,5,4,1,1
CHIAPAS,7,LA CONCORDIA,020,REFORMA,4,324,166,158,15
CHIAPAS,7,LA CONCORDIA,020,RIZO DE ORO,4,425,220,205,22
CHIAPAS,7,LA CONCORDIA,020,SAJONIA,1,4,1,3,1
CHIAPAS,7,LA CONCORDIA,020,SALITRAL,2,13,3,10,2
CHIAPAS,7,LA CONCORDIA,020,SAN ANTONIO (SANTA ISABEL POBLAZÓN),3,35,17,18,4
CHIAPAS,7,LA CONCORDIA,020,SAN CARLOS,2,4,2,2,1
CHIAPAS,7,LA CONCORDIA,020,SAN FRANCISCO,3,59,28,31,4
CHIAPAS,7,LA CONCORDIA,020,SAN GREGORIO,2,48,26,22,4
CHIAPAS,7,LA CONCORDIA,020,SAN ISIDRO,3,66,31,35,4
CHIAPAS,7,LA CONCORDIA,020,SAN JOSÉ MAGALLANES,2,15,7,8,2
CHIAPAS,7,LA CONCORDIA,020,SAN JOSÉ MARAVILLAS,3,70,39,31,5
CHIAPAS,7,LA CONCORDIA,020,SAN LUIS,2,31,11,20,3
CHIAPAS,7,LA CONCORDIA,020,SAN MARCOS,4,67,39,28,5
CHIAPAS,7,LA CONCORDIA,020,SAN NICOLÁS,2,124,68,56,5
CHIAPAS,7,LA CONCORDIA,020,SAN PEDRO,5,93,43,50,8
CHIAPAS,7,LA CONCORDIA,020,SAN RAFAEL,3,59,27,32,5
CHIAPAS,7,LA CONCORDIA,020,SANTA ANITA,2,33,20,13,3
CHIAPAS,7,LA CONCORDIA,020,SANTA ELENA,2,13,7,6,2
CHIAPAS,7,LA CONCORDIA,020,SANTA MARTHA,1,8,3,5,1
CHIAPAS,7,LA CONCORDIA,020,SANTA RITA,1,5,3,2,1
CHIAPAS,7,LA CONCORDIA,020,SANTA ROSA,1,10,4,6,1
CHIAPAS,7,LA CONCORDIA,020,SOLO DIOS,2,24,15,9,2
CHIAPAS,7,LA CONCORDIA,020,TRES DE MAYO,3,46,20,26,4
CHIAPAS,7,COPAINALÁ,021,ADOLFO LÓPEZ MATEOS,3,97,50,47,4
CHIAPAS,7,COPAINALÁ,021,AGUSTÍN DE ITURBIDE,4,235,121,114,13
CHIAPAS,7,COPAINALÁ,021,ÁNGEL ALBINO CORZO (GUADALUPE),6,585,304,281,30
CHIAPAS,7,COPAINALÁ,021,BELLAVISTA,4,40,21,19,4
CHIAPAS,7,COPAINALÁ,021,BENITO JUÁREZ,4,433,215,218,22
CHIAPAS,7,COPAINALÁ,021,CAMPECHE,3,181,81,100,11
CHIAPAS,7,COPAINALÁ,021,CANDELARIA,3,59,26,33,3
CHIAPAS,7,COPAINALÁ,021,CHILPANCINGO,2,55,22,33,3
CHIAPAS,7,COPAINALÁ,021,COPAINALÁ,21,2844,1429,1415,167
CHIAPAS,7,COPAINALÁ,021,COPANO,2,13,5,8,2
CHIAPAS,7,COPAINALÁ,021,COSTA ALEGRE,2,21,8,13,3
CHIAPAS,7,COPAINALÁ,021,DIVISIÓN DEL NORTE (LA LAGUNA Y SAN VICENTE),3,40,21,19,4
CHIAPAS,7,COPAINALÁ,021,EL BAQUETAL,3,47,21,26,3
CHIAPAS,7,COPAINALÁ,021,EL CIPRÉS,4,209,110,99,11
CHIAPAS,7,COPAINALÁ,021,EL LIMÓN (EL AGUACATE),2,17,8,9,2
CHIAPAS,7,COPAINALÁ,021,EL ROSARIO,2,106,46,60,6
CHIAPAS,7,COPAINALÁ,021,FRANCISCO SARABIA,2,48,24,24,3
CHIAPAS,7,COPAINALÁ,021,GENERAL SANDINO,2,64,25,39,3
CHIAPAS,7,COPAINALÁ,021,HONDURAS,1,8,2,6,1
CHIAPAS,7,COPAINALÁ,021,IGNACIO ZARAGOZA,5,256,120,136,14
CHIAPAS,7,COPAINALÁ,021,INDEPENDENCIA,2,16,8,8,1
CHIAPAS,7,COPAINALÁ,021,JOSÉ MARÍA MORELOS Y PAVÓN,2,65,38,27,3
CHIAPAS,7,COPAINALÁ,021,JULIÁN GRAJALES (SAN ANTONIO),2,70,35,35,6
CHIAPAS,7,COPAINALÁ,021,LA ESPERANZA,3,20,7,13,3
CHIAPAS,7,COPAINALÁ,021,LA NUEVA,3,165,81,84,9
CHIAPAS,7,COPAINALÁ,021,LA PROVIDENCIA,2,49,25,24,3
CHIAPAS,7,COPAINALÁ,021,LA TRINIDAD,2,25,15,10,2
CHIAPAS,7,COPAINALÁ,021,LÁZARO CÁRDENAS,3,95,55,40,6
CHIAPAS,7,COPAINALÁ,021,MIGUEL HIDALGO (ZACALAPA),3,220,106,114,11
CHIAPAS,7,COPAINALÁ,021,NUEVO PROGRESO,1,6,4,2,1
CHIAPAS,7,COPAINALÁ,021,NUEVO VERGEL,2,54,29,25,3
CHIAPAS,7,COPAINALÁ,021,RÍO GRANDE,2,43,20,23,2
CHIAPAS,7,COPAINALÁ,021,SAN GERÓNIMO,2,42,22,20,3
CHIAPAS,7,COPAINALÁ,021,SAN ISIDRO,2,60,35,25,5
CHIAPAS,7,COPAINALÁ,021,SAN ISIDRO (SAN ANTONIO),1,6,3,3,1
CHIAPAS,7,COPAINALÁ,021,SAN JOSÉ,1,9,5,4,1
CHIAPAS,7,COPAINALÁ,021,SAN JOSÉ (SAN MARCOS),1,18,8,10,1
CHIAPAS,7,COPAINALÁ,021,SAN JOSÉ MOTEJÉN,2,70,31,39,3
CHIAPAS,7,COPAINALÁ,021,SAN MARCOS I,2,24,12,12,3
CHIAPAS,7,COPAINALÁ,021,SAN MIGUEL,1,8,5,3,1
CHIAPAS,7,COPAINALÁ,021,SAN PEDRO,2,13,7,6,2
CHIAPAS,7,COPAINALÁ,021,SAN VICENTE (RIBERA HIDALGO),2,26,12,14,2
CHIAPAS,7,COPAINALÁ,021,SANTA CATALINA,1,22,11,11,1
CHIAPAS,7,COPAINALÁ,021,SANTA CATARINA,2,58,26,32,4
CHIAPAS,7,COPAINALÁ,021,SANTA LUCÍA,2,21,11,10,2
CHIAPAS,7,COPAINALÁ,021,TIERRA BLANCA,2,49,27,22,3
CHIAPAS,7,COPAINALÁ,021,TRES PICOS,2,25,15,10,2
CHIAPAS,7,COPAINALÁ,021,TUÑAJÉN (SAN RAFAEL),2,43,22,21,3
CHIAPAS,7,COPAINALÁ,021,VISTA HERMOSA,2,14,5,9,2
CHIAPAS,7,CHALCHIHUITÁN,022,BALUNACO,2,213,112,101,8
CHIAPAS,7,CHALCHIHUITÁN,022,BEJELTÓN,1,17,9,8,1
CHIAPAS,7,CHALCHIHUITÁN,022,BOLOLCHOJÓN,1,8,5,3,1
CHIAPAS,7,CHALCHIHUITÁN,022,BUENAVISTA,1,18,10,8,1
CHIAPAS,7,CHALCHIHUITÁN,022,CANALUMTIC,3,301,141,160,9
CHIAPAS,7,CHALCHIHUITÁN,022,CANECH,2,166,84,82,7
CHIAPAS,7,CHALCHIHUITÁN,022,CANTEAL,3,397,163,234,25
CHIAPAS,7,CHALCHIHUITÁN,022,CHALCHIHUITÁN,4,978,469,509,48
CHIAPAS,7,CHALCHIHUITÁN,022,CH'ENMUT,2,153,77,76,4
CHIAPAS,7,CHALCHIHUITÁN,022,CHIQUINSHULUM,4,953,460,493,31
CHIAPAS,7,CHALCHIHUITÁN,022,CRUZ K'AK'ANAM,2,25,9,16,2
CHIAPAS,7,CHALCHIHUITÁN,022,CRUZTÓN,2,210,92,118,7
CHIAPAS,7,CHALCHIHUITÁN,022,EMILIANO ZAPATA,2,144,74,70,4
CHIAPAS,7,CHALCHIHUITÁN,022,ESPERANZA,2,23,8,15,2
CHIAPAS,7,CHALCHIHUITÁN,022,ISRAEL,2,165,80,85,5
CHIAPAS,7,CHALCHIHUITÁN,022,JOLIK'ALUM,2,164,79,85,7
CHIAPAS,7,CHALCHIHUITÁN,022,JOLITONTIC,2,349,176,173,12
CHIAPAS,7,CHALCHIHUITÁN,022,JOLKINTÚN,2,19,10,9,2
CHIAPAS,7,CHALCHIHUITÁN,022,JOLTEALAL,3,421,195,226,10
CHIAPAS,7,CHALCHIHUITÁN,022,JOVELTIC,2,174,74,100,4
CHIAPAS,7,CHALCHIHUITÁN,022,LOBOLALTIC (TOJTIC),2,192,107,85,6
CHIAPAS,7,CHALCHIHUITÁN,022,MEONLÚM,2,49,28,21,4
CHIAPAS,7,CHALCHIHUITÁN,022,NATILHUITZ,1,9,4,5,1
CHIAPAS,7,CHALCHIHUITÁN,022,PACANAM,2,176,87,89,5
CHIAPAS,7,CHALCHIHUITÁN,022,PATCHENTIC,2,89,52,37,2
CHIAPAS,7,CHALCHIHUITÁN,022,PATKANTEAL,2,144,76,68,4
CHIAPAS,7,CHALCHIHUITÁN,022,POM,2,462,244,218,14
CHIAPAS,7,CHALCHIHUITÁN,022,PUEBLO NUEVO,1,8,4,4,1
CHIAPAS,7,CHALCHIHUITÁN,022,SACLUM,2,235,121,114,7
CHIAPAS,7,CHALCHIHUITÁN,022,SHISHIMTONTIC,1,103,53,50,4
CHIAPAS,7,CHALCHIHUITÁN,022,SISIM,2,215,107,108,6
CHIAPAS,7,CHALCHIHUITÁN,022,TULANTIC,2,108,48,60,3
CHIAPAS,7,CHALCHIHUITÁN,022,TZACUCUM,2,475,221,254,14
CHIAPAS,7,CHALCHIHUITÁN,022,TZ'AK,2,53,27,26,4
CHIAPAS,7,CHALCHIHUITÁN,022,TZOMOLTÓN,2,71,35,36,3
CHIAPAS,7,CHALCHIHUITÁN,022,TZUNUNIL,3,492,261,231,12
CHIAPAS,7,CHALCHIHUITÁN,022,XIXIMTONTIC,1,41,19,22,2
CHIAPAS,7,CHALCHIHUITÁN,022,YUT UK'UM,1,12,7,5,1
CHIAPAS,7,CHAMULA,023,AGIL SANTA RITA,2,138,73,65,5
CHIAPAS,7,CHAMULA,023,AGUA AZUL,2,80,44,36,4
CHIAPAS,7,CHAMULA,023,AJTETIC,2,37,16,21,2
CHIAPAS,7,CHAMULA,023,ARVENZA DOS,2,148,74,74,5
CHIAPAS,7,CHAMULA,023,ARVENZA UNO,2,405,197,208,16
CHIAPAS,7,CHAMULA,023,BACHÉN,2,154,94,60,6
CHIAPAS,7,CHAMULA,023,BAHOSIL,2,450,215,235,16
CHIAPAS,7,CHAMULA,023,BAHUKUM,2,10,6,4,1
CHIAPAS,7,CHAMULA,023,BANABOLOB,2,107,45,62,3
CHIAPAS,7,CHAMULA,023,BASHEQUEN,2,164,82,82,7
CHIAPAS,7,CHAMULA,023,BATOJTIC,2,96,54,42,5
CHIAPAS,7,CHAMULA,023,BATOJTIC I,2,28,11,17,2
CHIAPAS,7,CHAMULA,023,BAUTISTA CHICO,2,524,249,275,18
CHIAPAS,7,CHAMULA,023,BAUTISTA GRANDE,2,411,216,195,14
CHIAPAS,7,CHAMULA,023,BECHIJTIC,2,117,64,53,4
CHIAPAS,7,CHAMULA,023,BOTATULÁN,2,162,85,77,5
CHIAPAS,7,CHAMULA,023,BOTATULÁN II,3,197,84,113,7
CHIAPAS,7,CHAMULA,023,CALLEJÓN,2,235,119,116,11
CHIAPAS,7,CHAMULA,023,CALVARIO ALCOCH'EN,1,28,13,15,1
CHIAPAS,7,CHAMULA,023,CATISHTIC,2,295,153,142,12
CHIAPAS,7,CHAMULA,023,CENTRO CRUZ OBISPO,1,9,2,7,1
CHIAPAS,7,CHAMULA,023,CENTRO YALVANTE,2,46,17,29,2
CHIAPAS,7,CHAMULA,023,CHAMULA,5,1471,708,763,56
CHIAPAS,7,CHAMULA,023,CHICUMTANTIC,3,640,318,322,24
CHIAPAS,7,CHAMULA,023,CHICVILTENAL,3,339,178,161,15
CHIAPAS,7,CHAMULA,023,CHILIMJOVELTIC,3,195,92,103,8
CHIAPAS,7,CHAMULA,023,CHIMTIC,2,25,12,13,2
CHIAPAS,7,CHAMULA,023,CHIOTIC,2,387,193,194,13
CHIAPAS,7,CHAMULA,023,CH'ULTIC,2,137,55,82,5
CHIAPAS,7,CHAMULA,023,CORRALITO,3,236,119,117,7
CHIAPAS,7,CHAMULA,023,CRUZ CHOT,1,46,18,28,2
CHIAPAS,7,CHAMULA,023,CRUZ CH'OT I,2,17,10,7,2
CHIAPAS,7,CHAMULA,023,CRUZ OBISPO,3,76,40,36,3
CHIAPAS,7,CHAMULA,023,CRUZ OBISPO I,1,89,44,45,3
CHIAPAS,7,CHAMULA,023,CRUZ QUEMADA,2,203,101,102,8
CHIAPAS,7,CHAMULA,023,CRUZTÓN,2,370,158,212,15
CHIAPAS,7,CHAMULA,023,CUCHULUMTIC,2,394,216,178,13
CHIAPAS,7,CHAMULA,023,EL CIPRÉS,2,86,49,37,3
CHIAPAS,7,CHAMULA,023,EL CRUCERO,3,370,187,183,14
CHIAPAS,7,CHAMULA,023,EL DURAZNAL,2,14,5,9,2
CHIAPAS,7,CHAMULA,023,EL POZO,3,662,313,349,20
CHIAPAS,7,CHAMULA,023,EPALCHÉN,2,398,193,205,11
CHIAPAS,7,CHAMULA,023,ICALUMTIC,3,299,138,161,15
CHIAPAS,7,CHAMULA,023,ICHILHO,2,89,50,39,5
CHIAPAS,7,CHAMULA,023,ICHINTÓN,2,138,78,60,6
CHIAPAS,7,CHAMULA,023,IK'ALUMTIK II,1,6,2,4,1
CHIAPAS,7,CHAMULA,023,JECH TIC,2,25,15,10,2
CHIAPAS,7,CHAMULA,023,JECHBOTIK,2,117,49,68,4
CHIAPAS,7,CHAMULA,023,JOLBÓN,3,84,39,45,6
CHIAPAS,7,CHAMULA,023,JOLCH'ENTIK,1,29,17,12,1
CHIAPAS,7,CHAMULA,023,JOLCHIJTIK,2,82,37,45,4
CHIAPAS,7,CHAMULA,023,JOLNAJOJTIC,2,96,52,44,4
CHIAPAS,7,CHAMULA,023,JOLPAJALTÓN,2,91,46,45,4
CHIAPAS,7,CHAMULA,023,JOLTOJTIC,2,93,47,46,4
CHIAPAS,7,CHAMULA,023,JOLTZEMÉN,3,341,161,180,12
CHIAPAS,7,CHAMULA,023,JOMALHO,2,328,165,163,12
CHIAPAS,7,CHAMULA,023,JOMTEALHÓ,2,116,47,69,5
CHIAPAS,7,CHAMULA,023,JTZAV,2,186,93,93,7
CHIAPAS,7,CHAMULA,023,KOTOLTÉ,3,599,302,297,19
CHIAPAS,7,CHAMULA,023,LA SELVA,2,31,14,17,2
CHIAPAS,7,CHAMULA,023,LA VENTANA,2,217,113,104,9
CHIAPAS,7,CHAMULA,023,LA VENTANA 1,2,68,32,36,4
CHIAPAS,7,CHAMULA,023,LAGUNA GRANDE,2,107,56,51,5
CHIAPAS,7,CHAMULA,023,LAGUNA PETEJ,2,193,103,90,9
CHIAPAS,7,CHAMULA,023,LAS MINAS,2,85,42,43,4
CHIAPAS,7,CHAMULA,023,LAS NUBES,2,13,7,6,2
CHIAPAS,7,CHAMULA,023,LAS OLLAS,3,374,181,193,13
CHIAPAS,7,CHAMULA,023,LINDAVISTA,2,174,83,91,6
CHIAPAS,7,CHAMULA,023,LOMHO,2,71,36,35,3
CHIAPAS,7,CHAMULA,023,LOMHO I,2,48,26,22,2
CHIAPAS,7,CHAMULA,023,LOS RANCHOS,2,139,64,75,7
CHIAPAS,7,CHAMULA,023,MACVILHO,2,328,160,168,14
CHIAPAS,7,CHAMULA,023,MAJOMUT,3,448,218,230,19
CHIAPAS,7,CHAMULA,023,MANZANATIC,2,30,16,14,3
CHIAPAS,7,CHAMULA,023,MILPOLETA,2,187,95,92,8
CHIAPAS,7,CHAMULA,023,MONTE BONITO,1,40,25,15,1
CHIAPAS,7,CHAMULA,023,MUQUÉN,4,570,294,276,22
CHIAPAS,7,CHAMULA,023,NACHAUC,2,294,150,144,8
CHIAPAS,7,CHAMULA,023,NARVÁEZ,4,754,411,343,23
CHIAPAS,7,CHAMULA,023,NAXIC,2,151,75,76,6
CHIAPAS,7,CHAMULA,023,NET AK'TIK,3,37,22,15,4
CHIAPAS,7,CHAMULA,023,NICHÉN,2,149,77,72,6
CHIAPAS,7,CHAMULA,023,NICHÉN 2,2,42,20,22,2
CHIAPAS,7,CHAMULA,023,NICHNAMTIC,3,485,250,235,21
CHIAPAS,7,CHAMULA,023,NICHTE,1,168,81,87,7
CHIAPAS,7,CHAMULA,023,NITIJOM,1,53,24,29,2
CHIAPAS,7,CHAMULA,023,NOCTIC,2,125,75,50,3
CHIAPAS,7,CHAMULA,023,PAJALTÓN ALTO,3,454,220,234,13
CHIAPAS,7,CHAMULA,023,PAJALTÓN BAJO,4,553,270,283,22
CHIAPAS,7,CHAMULA,023,PALMILLA,1,6,1,5,1
CHIAPAS,7,CHAMULA,023,PATBÓN,2,74,37,37,2
CHIAPAS,7,CHAMULA,023,PATHUITZ,2,252,135,117,8
CHIAPAS,7,CHAMULA,023,PATSANUL,3,44,18,26,4
CHIAPAS,7,CHAMULA,023,PATYALEMTÓN,2,53,23,30,3
CHIAPAS,7,CHAMULA,023,PILALCHÉN,2,161,87,74,7
CHIAPAS,7,CHAMULA,023,POZUELOS,2,181,77,104,7
CHIAPAS,7,CHAMULA,023,PUGCHÉN CHICO,3,319,172,147,11
CHIAPAS,7,CHAMULA,023,PUGCHÉN MUMUNTIC,3,443,230,213,18
CHIAPAS,7,CHAMULA,023,PULUMSIBAK,2,165,88,77,6
CHIAPAS,7,CHAMULA,023,RASIÉN,2,120,60,60,5
CHIAPAS,7,CHAMULA,023,RÍO JORDÁN,1,24,15,9,1
CHIAPAS,7,CHAMULA,023,ROMERILLO,4,626,300,326,34
CHIAPAS,7,CHAMULA,023,SACLAMANTÓN,3,436,213,223,18
CHIAPAS,7,CHAMULA,023,SACTZU,2,163,80,83,7
CHIAPAS,7,CHAMULA,023,SAKCH'EN,2,89,39,50,4
CHIAPAS,7,CHAMULA,023,SANTA ANA,3,418,209,209,12
CHIAPAS,7,CHAMULA,023,SAT VO,2,41,23,18,3
CHIAPAS,7,CHAMULA,023,SETELTÓN,2,148,77,71,6
CHIAPAS,7,CHAMULA,023,SHUCUTÓN,2,203,94,109,8
CHIAPAS,7,CHAMULA,023,TAKITETIC,2,41,18,23,2
CHIAPAS,7,CHAMULA,023,TENTIC,4,533,237,296,30
CHIAPAS,7,CHAMULA,023,TIKOMÓN,2,62,30,32,3
CHIAPAS,7,CHAMULA,023,TILIL CENTRO,3,73,42,31,6
CHIAPAS,7,CHAMULA,023,TINAILCHÉN,2,29,15,14,3
CHIAPAS,7,CHAMULA,023,TOJTIC,2,149,70,79,8
CHIAPAS,7,CHAMULA,023,TRES CRUCES,2,85,49,36,3
CHIAPAS,7,CHAMULA,023,TRES FLORES,1,15,10,5,1
CHIAPAS,7,CHAMULA,023,TZAJALCHÉN,2,130,73,57,3
CHIAPAS,7,CHAMULA,023,TZAJALCHEN TRES,1,77,42,35,3
CHIAPAS,7,CHAMULA,023,TZAJALTETIC,1,149,73,76,6
CHIAPAS,7,CHAMULA,023,TZAJALUM,2,183,90,93,6
CHIAPAS,7,CHAMULA,023,TZALATOM,2,147,72,75,5
CHIAPAS,7,CHAMULA,023,TZELOPATIC,2,66,34,32,4
CHIAPAS,7,CHAMULA,023,TZOJLUM (TIERRA COLORADA),2,85,43,42,3
CHIAPAS,7,CHAMULA,023,TZONTEHUITZ,3,570,250,320,20
CHIAPAS,7,CHAMULA,023,TZOTOMTETIC,2,33,22,11,3
CHIAPAS,7,CHAMULA,023,TZOTOMTETIC CENTRO,2,63,38,25,4
CHIAPAS,7,CHAMULA,023,UKUMTIC,2,343,182,161,14
CHIAPAS,7,CHAMULA,023,VA'ALCH'EN,2,218,111,107,8
CHIAPAS,7,CHAMULA,023,VOTAMESTE,2,213,106,107,7
CHIAPAS,7,CHAMULA,023,YAALHICHÍN,2,114,58,56,4
CHIAPAS,7,CHAMULA,023,YAALTZ'UNUN,1,180,92,88,6
CHIAPAS,7,CHAMULA,023,YAKAMPOT (YOKPOT),2,124,68,56,4
CHIAPAS,7,CHAMULA,023,YALCHITOM,3,339,179,160,12
CHIAPAS,7,CHAMULA,023,YALTEM,4,804,368,436,25
CHIAPAS,7,CHAMULA,023,YALVANTÉ,3,271,140,131,12
CHIAPAS,7,CHAMULA,023,YITIC,2,337,167,170,12
CHIAPAS,7,CHAMULA,023,YOLÓN JOL CHUMTIC,1,107,53,54,6
CHIAPAS,7,CHAMULA,023,YOLONAM CONCONTIC,2,179,95,84,7
CHIAPAS,7,CHAMULA,023,YOLONCHÉN,2,207,92,115,8
CHIAPAS,7,CHAMULA,023,YOLONCHEN DOS,2,15,8,7,2
CHIAPAS,7,CHAMULA,023,YOLONHUITZ,2,108,50,58,4
CHIAPAS,7,CHAMULA,023,YUT BASH UNO,2,39,24,15,2
CHIAPAS,7,CHAMULA,023,YUT OSIL DOS,2,36,17,19,2
CHIAPAS,7,CHAMULA,023,YUT OSIL UNO,1,66,32,34,2
CHIAPAS,7,CHAMULA,023,YUT UK'UM,2,112,55,57,4
CHIAPAS,7,CHAMULA,023,YUTBASH,2,27,16,11,2
CHIAPAS,7,CHAMULA,023,YUTNIOTIC,2,163,75,88,9
CHIAPAS,7,CHAMULA,023,YUTOSIL TRES,2,93,38,55,4
CHIAPAS,7,CHANAL,024,CHANAL,21,3961,2021,1940,139
CHIAPAS,7,CHANAL,024,CHANALITO,2,40,23,17,3
CHIAPAS,7,CHANAL,024,CRUZTANAJ,3,31,14,17,3
CHIAPAS,7,CHANAL,024,FRONTERA MEXIQUITO,2,113,64,49,4
CHIAPAS,7,CHANAL,024,LA MENDOZA,2,35,8,27,2
CHIAPAS,7,CHANAL,024,LA VENTANA,2,50,26,24,3
CHIAPAS,7,CHANAL,024,MONTE BONITO,2,20,8,12,2
CHIAPAS,7,CHANAL,024,NARANJAL,2,20,8,12,2
CHIAPAS,7,CHANAL,024,NATILTÓN,4,487,227,260,32
CHIAPAS,7,CHANAL,024,NUEVO PORVENIR,2,40,18,22,2
CHIAPAS,7,CHANAL,024,ONILJA,2,134,71,63,5
CHIAPAS,7,CHANAL,024,PUERTO MORELOS,2,26,15,11,3
CHIAPAS,7,CHANAL,024,SAKCHILBATE,2,34,22,12,2
CHIAPAS,7,CHANAL,024,SAN ISIDRO LA FLORECILLA,2,17,8,9,2
CHIAPAS,7,CHANAL,024,SAN JOSÉ TZIBALCHÉ,2,81,41,40,4
CHIAPAS,7,CHANAL,024,SAQUILCHÉN,2,19,6,13,2
CHIAPAS,7,CHANAL,024,SIBERIA,3,418,204,214,15
CHIAPAS,7,CHANAL,024,TZAJALNICH,3,235,119,116,10
CHIAPAS,7,CHAPULTENANGO,025,BUENOS AIRES,3,125,62,63,7
CHIAPAS,7,CHAPULTENANGO,025,CARACOL SANTO DOMINGO,3,36,15,21,4
CHIAPAS,7,CHAPULTENANGO,025,CARMEN TONAPAC,2,58,20,38,3
CHIAPAS,7,CHAPULTENANGO,025,CHAPULTENANGO,10,1256,618,638,50
CHIAPAS,7,CHAPULTENANGO,025,CUMBRE VALTIERRA,3,38,21,17,3
CHIAPAS,7,CHAPULTENANGO,025,ESQUIPULAS GUAYABAL,3,46,25,21,5
CHIAPAS,7,CHAPULTENANGO,025,GUADALUPE VICTORIA,5,233,108,125,12
CHIAPAS,7,CHAPULTENANGO,025,LOS SÁNCHEZ,2,13,8,5,2
CHIAPAS,7,CHAPULTENANGO,025,MOVAC,1,4,2,2,1
CHIAPAS,7,CHAPULTENANGO,025,MOVAC 1RA. SECCIÓN,3,53,29,24,5
CHIAPAS,7,CHAPULTENANGO,025,NANCHITAL SAN ANTONIO 3RA. SECCIÓN,2,17,9,8,3
CHIAPAS,7,CHAPULTENANGO,025,RÍO NEGRO,3,202,102,100,11
CHIAPAS,7,CHAPULTENANGO,025,SAN ANTONIO ACAMBAC,3,82,36,46,6
CHIAPAS,7,CHAPULTENANGO,025,SAN FRANCISCO NANCHITAL 2DA. SECCIÓN,2,14,5,9,2
CHIAPAS,7,CHAPULTENANGO,025,SAN JOSÉ PARAÍSO,3,49,25,24,5
CHIAPAS,7,CHAPULTENANGO,025,SAN JOSÉ VALTIERRA,1,5,4,1,1
CHIAPAS,7,CHAPULTENANGO,025,SAN MIGUEL BUENAVISTA,2,102,49,53,5
CHIAPAS,7,CHAPULTENANGO,025,SAN PEDRO NANCHITAL,3,35,16,19,3
CHIAPAS,7,CHAPULTENANGO,025,VALTIERRA CENTRO,2,24,14,10,2
CHIAPAS,7,CHAPULTENANGO,025,VOLCÁN CHICHONAL,1,6,5,1,1
CHIAPAS,7,CHENALHÓ,026,ACTEAL,6,270,134,136,9
CHIAPAS,7,CHENALHÓ,026,AGUA VIVA,2,115,56,59,3
CHIAPAS,7,CHENALHÓ,026,AJTIC,1,12,7,5,1
CHIAPAS,7,CHENALHÓ,026,ÁNGELES LA LIBERTAD,2,19,4,15,2
CHIAPAS,7,CHENALHÓ,026,ATZAMILHO,2,176,92,84,6
CHIAPAS,7,CHENALHÓ,026,BACHEN,1,117,58,59,6
CHIAPAS,7,CHENALHÓ,026,BACHÉN DE POCONICHIM,1,55,31,24,2
CHIAPAS,7,CHENALHÓ,026,BAJOVELTIC,2,159,83,76,6
CHIAPAS,7,CHENALHÓ,026,BAJXULUM,2,337,168,169,8
CHIAPAS,7,CHENALHÓ,026,BELISARIO DOMÍNGUEZ,3,691,366,325,36
CHIAPAS,7,CHENALHÓ,026,BENITO JUÁREZ,3,102,54,48,4
CHIAPAS,7,CHENALHÓ,026,BEUMPALE,2,260,124,136,7
CHIAPAS,7,CHENALHÓ,026,CAMPO LOS TOROS,2,197,95,102,6
CHIAPAS,7,CHENALHÓ,026,CANOLAL,5,533,255,278,18
CHIAPAS,7,CHENALHÓ,026,CANVINIC,3,65,33,32,4
CHIAPAS,7,CHENALHÓ,026,CARIDAD SAN ANTONIO,2,160,86,74,6
CHIAPAS,7,CHENALHÓ,026,CHA'COJTON,2,19,9,10,2
CHIAPAS,7,CHENALHÓ,026,CHEN HOC,2,94,65,29,5
CHIAPAS,7,CHENALHÓ,026,CHENALHÓ,8,1726,822,904,93
CHIAPAS,7,CHENALHÓ,026,CHIMIX DOS,3,447,194,253,16
CHIAPAS,7,CHENALHÓ,026,CHIMIX TRES,2,47,29,18,2
CHIAPAS,7,CHENALHÓ,026,CHIMTIC,2,198,101,97,6
CHIAPAS,7,CHENALHÓ,026,CHIXILTÓN,2,221,114,107,8
CHIAPAS,7,CHENALHÓ,026,CHOJOLHÓ,3,139,58,81,7
CHIAPAS,7,CHENALHÓ,026,CHUCHTIC,2,123,68,55,4
CHIAPAS,7,CHENALHÓ,026,CRUZTÓN,2,201,108,93,7
CHIAPAS,7,CHENALHÓ,026,EL TZAC,3,38,15,23,4
CHIAPAS,7,CHENALHÓ,026,FRACCIÓN POLHÓ,1,144,79,65,2
CHIAPAS,7,CHENALHÓ,026,GUADALUPE YAXGEMEL,1,12,8,4,1
CHIAPAS,7,CHENALHÓ,026,GUAYABAL,2,287,139,148,7
CHIAPAS,7,CHENALHÓ,026,IK'ALTE'IL,1,61,23,38,2
CHIAPAS,7,CHENALHÓ,026,JAVALTÓN,2,127,59,68,4
CHIAPAS,7,CHENALHÓ,026,JOLTOJTIC,1,72,36,36,5
CHIAPAS,7,CHENALHÓ,026,JOLXIC,1,82,32,50,3
CHIAPAS,7,CHENALHÓ,026,JUAN DIEGO X'OYEP,2,82,35,47,3
CHIAPAS,7,CHENALHÓ,026,KAKET IXIM,1,11,4,7,1
CHIAPAS,7,CHENALHÓ,026,LA ESPERANZA,2,200,105,95,4
CHIAPAS,7,CHENALHÓ,026,LA LIBERTAD,4,499,245,254,22
CHIAPAS,7,CHENALHÓ,026,LA MERCED,2,48,19,29,3
CHIAPAS,7,CHENALHÓ,026,LA MESA,2,39,18,21,3
CHIAPAS,7,CHENALHÓ,026,LAS LIMAS,2,209,112,97,8
CHIAPAS,7,CHENALHÓ,026,LAS PALMAS,2,24,13,11,2
CHIAPAS,7,CHENALHÓ,026,LINDAVISTA,2,111,51,60,3
CHIAPAS,7,CHENALHÓ,026,MACUSHTETIC,2,85,38,47,3
CHIAPAS,7,CHENALHÓ,026,MAJOMUT,2,134,57,77,4
CHIAPAS,7,CHENALHÓ,026,MAJONPEPENTIK,4,299,137,162,11
CHIAPAS,7,CHENALHÓ,026,MAJUMCHÓN,3,75,38,37,3
CHIAPAS,7,CHENALHÓ,026,MAJUMCHÓN 2DA. FRACCIÓN,1,8,5,3,1
CHIAPAS,7,CHENALHÓ,026,MIGUEL HIDALGO Y COSTILLA,1,5,1,4,1
CHIAPAS,7,CHENALHÓ,026,MIGUEL UTRILLA (LOS CHORROS),6,1647,782,865,47
CHIAPAS,7,CHENALHÓ,026,NARANJATIC ALTO,2,203,105,98,7
CHIAPAS,7,CHENALHÓ,026,NARANJATIC BAJO,2,198,110,88,6
CHIAPAS,7,CHENALHÓ,026,NATIVIDAD,2,209,96,113,7
CHIAPAS,7,CHENALHÓ,026,NIJOJ,3,27,16,11,3
CHIAPAS,7,CHENALHÓ,026,NUEVO YAXALUMIL,1,32,16,16,2
CHIAPAS,7,CHENALHÓ,026,NUEVO YIBELJOJ,1,91,30,61,4
CHIAPAS,7,CHENALHÓ,026,OXIMBO,1,16,5,11,1
CHIAPAS,7,CHENALHÓ,026,PAJALTOJ,1,21,10,11,2
CHIAPAS,7,CHENALHÓ,026,PECHIQUIL,2,206,98,108,6
CHIAPAS,7,CHENALHÓ,026,POCONICHIM,2,214,104,110,7
CHIAPAS,7,CHENALHÓ,026,POLHÓ,2,321,157,164,12
CHIAPAS,7,CHENALHÓ,026,PUEBLA,3,778,392,386,18
CHIAPAS,7,CHENALHÓ,026,QUESHTIC,5,168,70,98,8
CHIAPAS,7,CHENALHÓ,026,SAC LUM,3,436,191,245,17
CHIAPAS,7,CHENALHÓ,026,SACCHÉN,3,29,13,16,4
CHIAPAS,7,CHENALHÓ,026,SAN JOSÉ MAJOMUT,2,137,67,70,4
CHIAPAS,7,CHENALHÓ,026,SAN PEDRO,2,70,35,35,3
CHIAPAS,7,CHENALHÓ,026,SANTO CH'EN,1,60,26,34,2
CHIAPAS,7,CHENALHÓ,026,SHUNUCH,3,246,116,130,9
CHIAPAS,7,CHENALHÓ,026,TAKIUKUM PRIMERA FRACCIÓN,3,582,263,319,24
CHIAPAS,7,CHENALHÓ,026,TANATE,2,82,39,43,3
CHIAPAS,7,CHENALHÓ,026,TEPEYAC,3,102,38,64,6
CHIAPAS,7,CHENALHÓ,026,TICHÉN,2,12,7,5,2
CHIAPAS,7,CHENALHÓ,026,TOROSTIC,1,13,8,5,1
CHIAPAS,7,CHENALHÓ,026,TZABALHÓ,2,326,158,168,12
CHIAPAS,7,CHENALHÓ,026,TZAJALCHÉN,3,439,234,205,9
CHIAPAS,7,CHENALHÓ,026,TZAJALHUCUM,2,138,64,74,4
CHIAPAS,7,CHENALHÓ,026,TZANEMBOLOM,2,209,86,123,6
CHIAPAS,7,CHENALHÓ,026,XINICHILVO,2,118,60,58,4
CHIAPAS,7,CHENALHÓ,026,XOKIL-UK'UM,2,60,30,30,2
CHIAPAS,7,CHENALHÓ,026,XOLOMTOJ,2,32,13,19,3
CHIAPAS,7,CHENALHÓ,026,YABTECLUM (PUEBLO VIEJO),3,1021,490,531,27
CHIAPAS,7,CHENALHÓ,026,YABTECLUM FRACCIÓN UNO,3,74,34,40,5
CHIAPAS,7,CHENALHÓ,026,YAXALUMIL,2,228,107,121,8
CHIAPAS,7,CHENALHÓ,026,YAXGEMEL UNIÓN,2,186,102,84,6
CHIAPAS,7,CHENALHÓ,026,YIBELJOJ,4,496,250,246,14
CHIAPAS,7,CHENALHÓ,026,YOKVENTANA,3,250,121,129,7
CHIAPAS,7,CHENALHÓ,026,YOLONCHÉN,2,57,25,32,4
CHIAPAS,7,CHENALHÓ,026,YUT-UK'UM,2,83,33,50,3
CHIAPAS,7,CHIAPA DE CORZO,027,AMATAL,5,286,148,138,12
CHIAPAS,7,CHIAPA DE CORZO,027,AMÉRICA LIBRE,5,816,377,439,61
CHIAPAS,7,CHIAPA DE CORZO,027,ÁNGEL ALBINO CORZO,2,66,36,30,3
CHIAPAS,7,CHIAPA DE CORZO,027,AURORA BUENAVISTA,1,13,7,6,1
CHIAPAS,7,CHIAPA DE CORZO,027,BARRANCA HONDA,2,83,38,45,4
CHIAPAS,7,CHIAPA DE CORZO,027,CABEZA DE AGUA (SAN ANTONIO),2,51,23,28,3
CHIAPAS,7,CHIAPA DE CORZO,027,CARRILLO PUERTO,3,99,57,42,6
CHIAPAS,7,CHIAPA DE CORZO,027,CHIAPA DE CORZO,73,13699,6622,7077,801
CHIAPAS,7,CHIAPA DE CORZO,027,CHILE VERDE,3,97,51,46,5
CHIAPAS,7,CHIAPA DE CORZO,027,CUPASMÍ,2,142,71,71,8
CHIAPAS,7,CHIAPA DE CORZO,027,DISTRITO FEDERAL,2,206,95,111,8
CHIAPAS,7,CHIAPA DE CORZO,027,DOCTOR MANUEL VELASCO SUÁREZ,4,226,130,96,10
CHIAPAS,7,CHIAPA DE CORZO,027,EL CACAO,3,39,22,17,4
CHIAPAS,7,CHIAPA DE CORZO,027,EL CANELAR,2,97,55,42,4
CHIAPAS,7,CHIAPA DE CORZO,027,EL HORIZONTE,3,369,187,182,14
CHIAPAS,7,CHIAPA DE CORZO,027,EL MANGUITO (PLATANAR),2,144,70,74,6
CHIAPAS,7,CHIAPA DE CORZO,027,EL PALMAR (SAN GABRIEL),4,619,306,313,28
CHIAPAS,7,CHIAPA DE CORZO,027,EL TEJAR,2,97,45,52,5
CHIAPAS,7,CHIAPA DE CORZO,027,EMILIANO ZAPATA,1,38,18,20,3
CHIAPAS,7,CHIAPA DE CORZO,027,EMILIANO ZAPATA UNO,3,184,82,102,10
CHIAPAS,7,CHIAPA DE CORZO,027,FRANCISCO SARABIA,3,252,120,132,11
CHIAPAS,7,CHIAPA DE CORZO,027,GALECIO NARCÍA,3,450,224,226,19
CHIAPAS,7,CHIAPA DE CORZO,027,GENERAL EMILIANO ZAPATA DOS,1,109,50,59,5
CHIAPAS,7,CHIAPA DE CORZO,027,IGNACIO ALLENDE,3,1562,881,681,86
CHIAPAS,7,CHIAPA DE CORZO,027,JARDINES DEL GRIJALVA,3,1166,569,597,52
CHIAPAS,7,CHIAPA DE CORZO,027,JUAN DEL GRIJALVA,3,658,304,354,27
CHIAPAS,7,CHIAPA DE CORZO,027,JULIÁN GRAJALES,7,1149,570,579,47
CHIAPAS,7,CHIAPA DE CORZO,027,LA CANDELARIA,1,20,11,9,1
CHIAPAS,7,CHIAPA DE CORZO,027,LA CANDELARIA (CHANCALENGE),2,75,38,37,4
CHIAPAS,7,CHIAPA DE CORZO,027,LA ESPERANZA,1,25,13,12,2
CHIAPAS,7,CHIAPA DE CORZO,027,LA HACIENDITA,1,18,9,9,2
CHIAPAS,7,CHIAPA DE CORZO,027,LA UNIÓN,2,82,42,40,4
CHIAPAS,7,CHIAPA DE CORZO,027,LAS FLECHAS,4,645,310,335,29
CHIAPAS,7,CHIAPA DE CORZO,027,LAS MARÍAS,3,38,22,16,3
CHIAPAS,7,CHIAPA DE CORZO,027,LAS TUNAS,1,26,10,16,2
CHIAPAS,7,CHIAPA DE CORZO,027,LINDAVISTA,1,54,25,29,2
CHIAPAS,7,CHIAPA DE CORZO,027,LOMA BONITA,2,10,7,3,1
CHIAPAS,7,CHIAPA DE CORZO,027,LOS FLAMBOYANES 1,3,65,29,36,6
CHIAPAS,7,CHIAPA DE CORZO,027,MARÍA CANDELARIA,1,47,25,22,2
CHIAPAS,7,CHIAPA DE CORZO,027,MIGUEL HIDALGO,3,255,118,137,12
CHIAPAS,7,CHIAPA DE CORZO,027,NARCISO MENDOZA,3,254,124,130,13
CHIAPAS,7,CHIAPA DE CORZO,027,NICOLÁS BRAVO,3,373,182,191,15
CHIAPAS,7,CHIAPA DE CORZO,027,NUCATILI,3,199,88,111,11
CHIAPAS,7,CHIAPA DE CORZO,027,NUEVA PALESTINA (NANDAYACUTI),3,235,121,114,11
CHIAPAS,7,CHIAPA DE CORZO,027,NUEVO BOCHIL,2,218,112,106,7
CHIAPAS,7,CHIAPA DE CORZO,027,NUEVO CARMEN TONAPAC,4,376,188,188,15
CHIAPAS,7,CHIAPA DE CORZO,027,NUEVO PORVENIR (BERGANTÍN),2,85,43,42,4
CHIAPAS,7,CHIAPA DE CORZO,027,PASO ACHIOTE,2,40,22,18,2
CHIAPAS,7,CHIAPA DE CORZO,027,PLAYA VISTA,2,232,115,117,8
CHIAPAS,7,CHIAPA DE CORZO,027,RANCHO CHICO,2,53,25,28,3
CHIAPAS,7,CHIAPA DE CORZO,027,RIBERA CUPÍA (LA MESA),2,105,48,57,5
CHIAPAS,7,CHIAPA DE CORZO,027,RIBERA DE MONTE RICO (NACAMUCUYI),3,264,132,132,11
CHIAPAS,7,CHIAPA DE CORZO,027,RIVERA EL VERGEL,2,81,42,39,4
CHIAPAS,7,CHIAPA DE CORZO,027,SALVADOR URBINA,6,687,328,359,27
CHIAPAS,7,CHIAPA DE CORZO,027,SAN ANTONIO BUENAVISTA,2,13,7,6,2
CHIAPAS,7,CHIAPA DE CORZO,027,SAN CAYETANO II,2,57,31,26,3
CHIAPAS,7,CHIAPA DE CORZO,027,SAN JORGE (SAN MIGUEL NANDAMBÚA),3,196,90,106,10
CHIAPAS,7,CHIAPA DE CORZO,027,SAN PEDRO AGUA AZUL,3,40,20,20,4
CHIAPAS,7,CHIAPA DE CORZO,027,SANTO DOMINGO [ESTACIÓN DE AFORACIÓN],2,94,49,45,4
CHIAPAS,7,CHIAPA DE CORZO,027,UNIÓN EL PALMAR,2,135,67,68,6
CHIAPAS,7,CHIAPA DE CORZO,027,UNIÓN Y PROGRESO,2,21,11,10,2
CHIAPAS,7,CHIAPA DE CORZO,027,VENUSTIANO CARRANZA,4,474,228,246,20
CHIAPAS,7,CHIAPILLA,028,CHIAPILLA,8,1332,670,662,50
CHIAPAS,7,CHIAPILLA,028,DOCTOR MANUEL VELASCO SUÁREZ,2,85,41,44,4
CHIAPAS,7,CHIAPILLA,028,LÁZARO CÁRDENAS,3,205,111,94,10
CHIAPAS,7,CHICOASÉN,029,CACAHUANO,3,27,16,11,3
CHIAPAS,7,CHICOASÉN,029,CHICOASÉN,6,1074,503,571,45
CHIAPAS,7,CHICOASÉN,029,CM 31-E (JUY JUY),2,29,16,13,3
CHIAPAS,7,CHICOASÉN,029,EL OCOTE,3,49,22,27,4
CHIAPAS,7,CHICOASÉN,029,EL PIÑÓN,2,13,6,7,2
CHIAPAS,7,CHICOASÉN,029,EL SABINAL,1,11,6,5,1
CHIAPAS,7,CHICOASÉN,029,LA REPRESA,3,62,32,30,6
CHIAPAS,7,CHICOASÉN,029,LAS PILAS,4,139,57,82,7
CHIAPAS,7,CHICOASÉN,029,MONTE GRANDE,2,17,8,9,2
CHIAPAS,7,CHICOASÉN,029,ZOQUIPAK,1,43,24,19,2
CHIAPAS,7,CHICOMUSELO,030,16 DE SEPTIEMBRE (RANCHO ALEGRE),3,31,16,15,4
CHIAPAS,7,CHICOMUSELO,030,18 DE MAYO,3,17,8,9,3
CHIAPAS,7,CHICOMUSELO,030,1RO. DE ENERO,3,52,20,32,5
CHIAPAS,7,CHICOMUSELO,030,1RO. DE MAYO,2,44,21,23,2
CHIAPAS,7,CHICOMUSELO,030,20 DE NOVIEMBRE,5,289,138,151,10
CHIAPAS,7,CHICOMUSELO,030,ABSALÓN CASTELLANOS DOMÍNGUEZ (SANTO DOMINGO),2,29,11,18,2
CHIAPAS,7,CHICOMUSELO,030,ALFONSO CORONA DEL ROSAL,2,36,19,17,2
CHIAPAS,7,CHICOMUSELO,030,ARGENTINA,1,4,2,2,1
CHIAPAS,7,CHICOMUSELO,030,BENITO JUÁREZ,4,176,89,87,11
CHIAPAS,7,CHICOMUSELO,030,BUENAVISTA (TUJU BUENAVISTA),2,13,7,6,2
CHIAPAS,7,CHICOMUSELO,030,BUENAVISTA DOS,1,8,2,6,1
CHIAPAS,7,CHICOMUSELO,030,BUENAVISTA UNO,3,68,30,38,4
CHIAPAS,7,CHICOMUSELO,030,BUENOS AIRES,2,23,12,11,2
CHIAPAS,7,CHICOMUSELO,030,CHASCHAHUAL,2,11,7,4,2
CHIAPAS,7,CHICOMUSELO,030,CHICOMUSELO,12,1641,822,819,192
CHIAPAS,7,CHICOMUSELO,030,CUATRO CAMINOS,3,46,19,27,4
CHIAPAS,7,CHICOMUSELO,030,DOLORES HIDALGO,2,66,33,33,2
CHIAPAS,7,CHICOMUSELO,030,EL CASTAÑO,1,4,1,3,1
CHIAPAS,7,CHICOMUSELO,030,EL CERECILLO,2,124,74,50,6
CHIAPAS,7,CHICOMUSELO,030,EL CIPRÉS,1,59,28,31,3
CHIAPAS,7,CHICOMUSELO,030,EL COFRE ALTO,2,24,8,16,2
CHIAPAS,7,CHICOMUSELO,030,EL COFRE BAJO (CANTA RANA),2,78,40,38,4
CHIAPAS,7,CHICOMUSELO,030,EL LIMONAR,3,66,31,35,3
CHIAPAS,7,CHICOMUSELO,030,EL MIRADOR DOS,2,44,17,27,4
CHIAPAS,7,CHICOMUSELO,030,EL NARANJO,2,22,10,12,2
CHIAPAS,7,CHICOMUSELO,030,EL OBRAJE,1,4,1,3,1
CHIAPAS,7,CHICOMUSELO,030,EL RAIZAL,3,113,49,64,7
CHIAPAS,7,CHICOMUSELO,030,EL RECUERDO,2,16,10,6,2
CHIAPAS,7,CHICOMUSELO,030,EL REGADILLO,2,41,19,22,3
CHIAPAS,7,CHICOMUSELO,030,EL REPARO,1,5,4,1,1
CHIAPAS,7,CHICOMUSELO,030,EL ROBLAR,2,9,5,4,2
CHIAPAS,7,CHICOMUSELO,030,EL ROSARIO,1,5,2,3,1
CHIAPAS,7,CHICOMUSELO,030,EL SABINALITO,3,63,33,30,4
CHIAPAS,7,CHICOMUSELO,030,FLOR DE MAYO,3,38,21,17,3
CHIAPAS,7,CHICOMUSELO,030,FRANCISCO I. MADERO,1,26,16,10,1
CHIAPAS,7,CHICOMUSELO,030,GALICIA,2,58,28,30,3
CHIAPAS,7,CHICOMUSELO,030,GRECIA,4,308,152,156,16
CHIAPAS,7,CHICOMUSELO,030,HUANACASTLE,2,23,12,11,2
CHIAPAS,7,CHICOMUSELO,030,JOLENTÓN,2,48,20,28,3
CHIAPAS,7,CHICOMUSELO,030,JOSEFA ORTIZ DE DOMÍNGUEZ (LA FORTUNA),3,162,67,95,8
CHIAPAS,7,CHICOMUSELO,030,LA AMARGURA,2,16,4,12,2
CHIAPAS,7,CHICOMUSELO,030,LA ESPERANZA,1,19,12,7,1
CHIAPAS,7,CHICOMUSELO,030,LA LAJA,2,31,15,16,3
CHIAPAS,7,CHICOMUSELO,030,LA LUCHA,2,46,23,23,5
CHIAPAS,7,CHICOMUSELO,030,LA MESILLA,1,13,8,5,1
CHIAPAS,7,CHICOMUSELO,030,LA PIEDAD,3,84,38,46,4
CHIAPAS,7,CHICOMUSELO,030,LA PINTA,2,34,14,20,2
CHIAPAS,7,CHICOMUSELO,030,LA ZACUALPA,3,140,73,67,9
CHIAPAS,7,CHICOMUSELO,030,LAS BRISAS,3,34,18,16,3
CHIAPAS,7,CHICOMUSELO,030,LAS FLORES,4,155,77,78,10
CHIAPAS,7,CHICOMUSELO,030,LAS MARGARITAS,2,50,28,22,3
CHIAPAS,7,CHICOMUSELO,030,LAS SALINAS,2,67,30,37,4
CHIAPAS,7,CHICOMUSELO,030,LÁZARO CÁRDENAS,5,643,326,317,28
CHIAPAS,7,CHICOMUSELO,030,LOMA BONITA,2,13,10,3,2
CHIAPAS,7,CHICOMUSELO,030,LOS ARROYOS,3,52,18,34,5
CHIAPAS,7,CHICOMUSELO,030,LOS LAURELES,1,5,2,3,1
CHIAPAS,7,CHICOMUSELO,030,MAYOR JULIO SABINES,2,15,7,8,2
CHIAPAS,7,CHICOMUSELO,030,MIGUEL ALEMÁN,6,175,92,83,12
CHIAPAS,7,CHICOMUSELO,030,MIRAMAR,1,7,4,3,1
CHIAPAS,7,CHICOMUSELO,030,MONTE SINAÍ,4,238,117,121,15
CHIAPAS,7,CHICOMUSELO,030,MORELOS,3,47,23,24,4
CHIAPAS,7,CHICOMUSELO,030,NAVARRA,1,18,9,9,3
CHIAPAS,7,CHICOMUSELO,030,NUEVA AMÉRICA,4,434,213,221,19
CHIAPAS,7,CHICOMUSELO,030,NUEVA GRECIA (SAN ANTOLÍN),2,14,6,8,2
CHIAPAS,7,CHICOMUSELO,030,NUEVA LINDA,2,21,12,9,2
CHIAPAS,7,CHICOMUSELO,030,NUEVA MORELIA,5,296,156,140,18
CHIAPAS,7,CHICOMUSELO,030,NUEVA REFORMA,3,94,50,44,6
CHIAPAS,7,CHICOMUSELO,030,NUEVA REFORMA AGRARIA,1,7,3,4,1
CHIAPAS,7,CHICOMUSELO,030,NUEVO AMANECER,2,22,10,12,2
CHIAPAS,7,CHICOMUSELO,030,NUEVO HUANACASTLE,1,7,2,5,1
CHIAPAS,7,CHICOMUSELO,030,NUEVO LAREDO,2,11,9,2,2
CHIAPAS,7,CHICOMUSELO,030,NUEVO PORTAL,3,45,24,21,4
CHIAPAS,7,CHICOMUSELO,030,NUEVO SINAÍ,2,43,22,21,3
CHIAPAS,7,CHICOMUSELO,030,NUEVO TENEJAPA,3,37,15,22,4
CHIAPAS,7,CHICOMUSELO,030,OJO DE AGUA,1,38,22,16,2
CHIAPAS,7,CHICOMUSELO,030,OJO DE AGUA 2,1,13,5,8,1
CHIAPAS,7,CHICOMUSELO,030,PABLO L. SIDAR,6,962,506,456,39
CHIAPAS,7,CHICOMUSELO,030,PIEDRA LABRADA,6,323,161,162,19
CHIAPAS,7,CHICOMUSELO,030,PLAN DE AYALA,3,124,65,59,5
CHIAPAS,7,CHICOMUSELO,030,PLAN GRANDE,1,7,2,5,1
CHIAPAS,7,CHICOMUSELO,030,POTRERILLOS,2,71,34,37,4
CHIAPAS,7,CHICOMUSELO,030,RICARDO FLORES MAGÓN,3,136,67,69,6
CHIAPAS,7,CHICOMUSELO,030,SABINAL,4,30,16,14,4
CHIAPAS,7,CHICOMUSELO,030,SAN AGUSTÍN,2,56,24,32,3
CHIAPAS,7,CHICOMUSELO,030,SAN ANTONIO LA ESPERANZA DOS,2,25,10,15,2
CHIAPAS,7,CHICOMUSELO,030,SAN ANTONIO OCOTAL,3,144,69,75,8
CHIAPAS,7,CHICOMUSELO,030,SAN FRANCISCO LAS PALMAS,1,6,4,2,1
CHIAPAS,7,CHICOMUSELO,030,SAN JUAN,2,34,21,13,2
CHIAPAS,7,CHICOMUSELO,030,SAN MARCOS,2,21,7,14,2
CHIAPAS,7,CHICOMUSELO,030,SAN RAMÓN,3,37,17,20,4
CHIAPAS,7,CHICOMUSELO,030,SANTA ELENA (DULCE NOMBRE),3,47,25,22,4
CHIAPAS,7,CHICOMUSELO,030,SANTA MARÍA,2,31,17,14,2
CHIAPAS,7,CHICOMUSELO,030,SANTO DOMINGO,2,15,9,6,2
CHIAPAS,7,CHICOMUSELO,030,UNIÓN BUENAVISTA,4,300,150,150,15
CHIAPAS,7,CHICOMUSELO,030,VADO ANCHO,3,34,18,16,4
CHIAPAS,7,CHICOMUSELO,030,VAREJONAL,1,6,1,5,1
CHIAPAS,7,CHICOMUSELO,030,VILLA NUEVA,2,43,19,24,2
CHIAPAS,7,CHILÓN,031,1RA. YALXEX,2,70,32,38,3
CHIAPAS,7,CHILÓN,031,ACHALELJÁ,2,70,35,35,3
CHIAPAS,7,CHILÓN,031,AGUA AZUL CHICO,1,63,29,34,3
CHIAPAS,7,CHILÓN,031,AGUA VERDE,4,118,50,68,10
CHIAPAS,7,CHILÓN,031,AKTELJÁ,1,44,26,18,2
CHIAPAS,7,CHILÓN,031,ALÁN BOLONTINÁ,2,73,37,36,3
CHIAPAS,7,CHILÓN,031,ALÁN BOLONTINÁ 2DA. SECCIÓN,2,29,11,18,2
CHIAPAS,7,CHILÓN,031,ALÁN CACUALÁ,2,46,27,19,3
CHIAPAS,7,CHILÓN,031,ALÁN CAMPO,2,124,68,56,4
CHIAPAS,7,CHILÓN,031,ALÁN K'ANTAJAL,2,72,33,39,2
CHIAPAS,7,CHILÓN,031,ALÁN-SAC'JÚN,4,1169,544,625,39
CHIAPAS,7,CHILÓN,031,ALBANIA PAKALNÁ,1,21,9,12,1
CHIAPAS,7,CHILÓN,031,AMAYTIC,2,90,44,46,3
CHIAPAS,7,CHILÓN,031,ARGENTINA,1,21,8,13,1
CHIAPAS,7,CHILÓN,031,ARROYO MUSTANJA,3,51,19,32,4
CHIAPAS,7,CHILÓN,031,AURORA GRANDE,4,475,226,249,16
CHIAPAS,7,CHILÓN,031,BA AXUPJA,2,77,46,31,3
CHIAPAS,7,CHILÓN,031,BACHAJÓN,17,3810,1870,1940,168
CHIAPAS,7,CHILÓN,031,BAH CRUZ,2,22,11,11,2
CHIAPAS,7,CHILÓN,031,BAH WITZ VENTANA,2,42,26,16,2
CHIAPAS,7,CHILÓN,031,BAHTAJ,3,45,29,16,5
CHIAPAS,7,CHILÓN,031,BAHTAJ 2DA. SECCIÓN,2,23,12,11,3
CHIAPAS,7,CHILÓN,031,BAHTRANCA,2,67,35,32,4
CHIAPAS,7,CHILÓN,031,BAHTZIBILTIC,3,89,38,51,3
CHIAPAS,7,CHILÓN,031,BAHTZIBILTIC SEGUNDA SECCIÓN,1,25,9,16,1
CHIAPAS,7,CHILÓN,031,BAJ MUCULWITZ,2,48,29,19,2
CHIAPAS,7,CHILÓN,031,BAJÁ,2,85,45,40,3
CHIAPAS,7,CHILÓN,031,BAJ-PUS,2,27,16,11,2
CHIAPAS,7,CHILÓN,031,BAJYULUBMAX,3,100,50,50,6
CHIAPAS,7,CHILÓN,031,BAMINAS,2,98,52,46,3
CHIAPAS,7,CHILÓN,031,BAMINAS PRIMERA SECCIÓN,3,88,48,40,7
CHIAPAS,7,CHILÓN,031,BA-NABIL,2,9,3,6,2
CHIAPAS,7,CHILÓN,031,BANACAXÁ,1,26,6,20,1
CHIAPAS,7,CHILÓN,031,BAPAXILÁ,5,129,70,59,7
CHIAPAS,7,CHILÓN,031,BAPAXILÁ SAN SEBASTIÁN,1,16,8,8,1
CHIAPAS,7,CHILÓN,031,BATZEL,2,54,27,27,3
CHIAPAS,7,CHILÓN,031,BATZEL BELEN,2,13,5,8,2
CHIAPAS,7,CHILÓN,031,BATZEL CACUALÁ,1,4,2,2,1
CHIAPAS,7,CHILÓN,031,BATZEL PAMALHÁ,2,66,37,29,3
CHIAPAS,7,CHILÓN,031,BATZEL TIAQUIL,2,18,9,9,2
CHIAPAS,7,CHILÓN,031,BATZEL-AK'TETIC,2,26,12,14,2
CHIAPAS,7,CHILÓN,031,BAWITZ,2,27,15,12,3
CHIAPAS,7,CHILÓN,031,BAWITZ GUADALUPE,2,60,33,27,3
CHIAPAS,7,CHILÓN,031,BAWITZ JERUSALÉN,1,10,7,3,1
CHIAPAS,7,CHILÓN,031,BAWITZ LIMONAL,2,27,11,16,3
CHIAPAS,7,CHILÓN,031,BAWITZ MANGO,2,45,22,23,3
CHIAPAS,7,CHILÓN,031,BAWITZ SAMARIA,3,56,26,30,5
CHIAPAS,7,CHILÓN,031,BAWITZ SAMARIA 2DA. SECCIÓN,2,43,23,20,4
CHIAPAS,7,CHILÓN,031,BAWITZ SINAÍ,2,23,12,11,2
CHIAPAS,7,CHILÓN,031,BAWITZ TUTZILTIK,3,115,57,58,7
CHIAPAS,7,CHILÓN,031,BAYULUMAX SINÁI,1,15,8,7,1
CHIAPAS,7,CHILÓN,031,BELÉN,2,186,91,95,6
CHIAPAS,7,CHILÓN,031,BENITO JUÁREZ,2,128,72,56,3
CHIAPAS,7,CHILÓN,031,BEREA BUENAVISTA,1,11,5,6,1
CHIAPAS,7,CHILÓN,031,BETANIA,2,36,16,20,2
CHIAPAS,7,CHILÓN,031,BISPUILJÁ,2,148,83,65,6
CHIAPAS,7,CHILÓN,031,BOLONTÓN,2,95,43,52,3
CHIAPAS,7,CHILÓN,031,BRETAÑA,2,26,16,10,3
CHIAPAS,7,CHILÓN,031,BUENAVISTA SAN JOSÉ NAPILÁ,2,233,111,122,8
CHIAPAS,7,CHILÓN,031,BUENAVISTA SAN SEBASTIÁN,2,28,14,14,3
CHIAPAS,7,CHILÓN,031,BUENAVISTA TENOJIB,2,95,42,53,3
CHIAPAS,7,CHILÓN,031,BUENAVISTA TZASIBILTIC,1,41,17,24,2
CHIAPAS,7,CHILÓN,031,CACATEEL,8,699,309,390,20
CHIAPAS,7,CHILÓN,031,CACAWILJA,2,47,24,23,2
CHIAPAS,7,CHILÓN,031,CALVARIO,2,30,15,15,2
CHIAPAS,7,CHILÓN,031,CAMPO BOLONTINÁ,3,411,202,209,15
CHIAPAS,7,CHILÓN,031,CANAL ULUB,2,63,30,33,3
CHIAPAS,7,CHILÓN,031,CANCHAJÁ,2,30,18,12,3
CHIAPAS,7,CHILÓN,031,CANTAJAL,2,21,8,13,2
CHIAPAS,7,CHILÓN,031,CANTELÁ,2,24,17,7,3
CHIAPAS,7,CHILÓN,031,CANTETIC,2,64,30,34,3
CHIAPAS,7,CHILÓN,031,CANXANIL,2,85,38,47,3
CHIAPAS,7,CHILÓN,031,CANXANIL SEGUNDA SECCIÓN,2,15,6,9,2
CHIAPAS,7,CHILÓN,031,CAQUEMTE'EL (K'AQUEMTEEL 1RA. SECCIÓN),3,94,48,46,4
CHIAPAS,7,CHILÓN,031,CARMEN ICOCILA,2,25,14,11,3
CHIAPAS,7,CHILÓN,031,CARMEN XAQUILÁ,3,137,71,66,8
CHIAPAS,7,CHILÓN,031,CENTRO CACUALÁ,3,250,126,124,10
CHIAPAS,7,CHILÓN,031,CENTRO CHEWAL,2,69,38,31,3
CHIAPAS,7,CHILÓN,031,CENTRO CHICH,5,749,335,414,27
CHIAPAS,7,CHILÓN,031,CENTRO JOLAKIL,1,22,11,11,1
CHIAPAS,7,CHILÓN,031,CENTRO MAJCHUM,2,41,27,14,2
CHIAPAS,7,CHILÓN,031,CENTRO MUQUIL,3,289,141,148,10
CHIAPAS,7,CHILÓN,031,CENTRO TZÓ OLJÁ,3,327,138,189,12
CHIAPAS,7,CHILÓN,031,CENTRO YOC CACUALA,2,27,14,13,3
CHIAPAS,7,CHILÓN,031,CHABÁN,5,502,273,229,22
CHIAPAS,7,CHILÓN,031,CH'ACHAB,2,41,17,24,2
CHIAPAS,7,CHILÓN,031,CHAJTETIC,2,76,32,44,2
CHIAPAS,7,CHILÓN,031,CHAKAJ NAVIL,2,22,10,12,3
CHIAPAS,7,CHILÓN,031,CHALAMCHEM,2,27,15,12,2
CHIAPAS,7,CHILÓN,031,CHAPUYIL,2,74,31,43,4
CHIAPAS,7,CHILÓN,031,CHEN'HUCH MAJASIL,3,51,22,29,4
CHIAPAS,7,CHILÓN,031,CH'ENTIKILHA,1,10,4,6,1
CHIAPAS,7,CHILÓN,031,CHEWAL CACATEEL,2,62,28,34,2
CHIAPAS,7,CHILÓN,031,CHEWAL CACATEEL 1RA. SECCIÓN,2,66,36,30,3
CHIAPAS,7,CHILÓN,031,CHEWAL CHICO,2,24,13,11,2
CHIAPAS,7,CHILÓN,031,CHEWAL MUQUENAL,1,5,1,4,1
CHIAPAS,7,CHILÓN,031,CHICH 2DA. SECCIÓN,1,25,16,9,1
CHIAPAS,7,CHILÓN,031,CHICHABANTELJÁ,2,73,31,42,3
CHIAPAS,7,CHILÓN,031,CHI'JTONTIK,1,21,11,10,1
CHIAPAS,7,CHILÓN,031,CHIK AKIL POJCOL,3,202,101,101,8
CHIAPAS,7,CHILÓN,031,CHIKAKTIC,1,17,8,9,2
CHIAPAS,7,CHILÓN,031,CHILÓN,16,3172,1544,1628,126
CHIAPAS,7,CHILÓN,031,CHIQUINIVAL,6,650,298,352,25
CHIAPAS,7,CHILÓN,031,CHOXILTIC,3,113,52,61,6
CHIAPAS,7,CHILÓN,031,CH'UCHTEEL,2,97,51,46,3
CHIAPAS,7,CHILÓN,031,CHUTALILJÁ,2,75,40,35,3
CHIAPAS,7,CHILÓN,031,COJTOMIL,2,172,94,78,6
CHIAPAS,7,CHILÓN,031,COLOLTEEL,2,68,34,34,4
CHIAPAS,7,CHILÓN,031,COLOQUILJÁ,2,33,16,17,3
CHIAPAS,7,CHILÓN,031,COQUILTÉEL 1RA. SECCIÓN,2,110,51,59,4
CHIAPAS,7,CHILÓN,031,COQUILTÉEL 2DA. SECCIÓN,2,60,32,28,3
CHIAPAS,7,CHILÓN,031,COROSTIC,2,175,92,83,6
CHIAPAS,7,CHILÓN,031,CORRALCHÉN,1,43,26,17,2
CHIAPAS,7,CHILÓN,031,CRUCERO ASHUPÁ,2,11,3,8,1
CHIAPAS,7,CHILÓN,031,CRUCERO BAWITZ ARENAL,1,4,3,1,1
CHIAPAS,7,CHILÓN,031,CRUCERO CHICH,2,58,29,29,3
CHIAPAS,7,CHILÓN,031,CRUCERO SACÚN SAQUILÁ,2,18,10,8,2
CHIAPAS,7,CHILÓN,031,CRUCERO SAN ANTONIO,2,33,15,18,3
CHIAPAS,7,CHILÓN,031,CRUZ GABRIEL,2,99,45,54,3
CHIAPAS,7,CHILÓN,031,CRUZ GABRIEL 2DA. SECCIÓN,1,25,9,16,2
CHIAPAS,7,CHILÓN,031,CUMBRE NACHOJ,2,39,23,16,2
CHIAPAS,7,CHILÓN,031,CUXULJÁ,3,23,12,11,3
CHIAPAS,7,CHILÓN,031,DAMASCO MAJASIL,2,84,42,42,3
CHIAPAS,7,CHILÓN,031,DELINA ALTA,4,134,61,73,6
CHIAPAS,7,CHILÓN,031,EL CARMEN,3,359,161,198,12
CHIAPAS,7,CHILÓN,031,EL DURAZNAL SANTA FE,2,149,76,73,6
CHIAPAS,7,CHILÓN,031,EL EDÉN,2,63,31,32,3
CHIAPAS,7,CHILÓN,031,EL JARDÍN,2,50,21,29,2
CHIAPAS,7,CHILÓN,031,EL LIMONAL,1,17,5,12,2
CHIAPAS,7,CHILÓN,031,EL MANANTIAL,1,5,2,3,1
CHIAPAS,7,CHILÓN,031,EL MANGO,3,356,182,174,18
CHIAPAS,7,CHILÓN,031,EL MIRADOR,2,16,9,7,2
CHIAPAS,7,CHILÓN,031,EL NARANJO LIQUILWITZ,3,92,45,47,7
CHIAPAS,7,CHILÓN,031,EL PARAÍSO,2,88,47,41,3
CHIAPAS,7,CHILÓN,031,EL PIEDRÓN,3,289,146,143,10
CHIAPAS,7,CHILÓN,031,EL PIÑAL,2,72,40,32,4
CHIAPAS,7,CHILÓN,031,EL REFUGIO (GENERAL LÁZARO CÁRDENAS),1,6,5,1,1
CHIAPAS,7,CHILÓN,031,EL ROSARIO,1,10,7,3,1
CHIAPAS,7,CHILÓN,031,EL SITIM,2,90,45,45,4
CHIAPAS,7,CHILÓN,031,ELEMUXIL,2,61,36,25,4
CHIAPAS,7,CHILÓN,031,EMILIANO ZAPATA,3,74,36,38,6
CHIAPAS,7,CHILÓN,031,ESTRELLA DE BELÉN,3,35,14,21,3
CHIAPAS,7,CHILÓN,031,FILADELFIA,2,195,98,97,7
CHIAPAS,7,CHILÓN,031,FRACCIÓN BUENAVISTA,1,33,16,17,1
CHIAPAS,7,CHILÓN,031,FRANCISCO VILLA,1,17,12,5,1
CHIAPAS,7,CHILÓN,031,GEMEL,1,45,25,20,2
CHIAPAS,7,CHILÓN,031,GOLOLTÓN,3,332,170,162,12
CHIAPAS,7,CHILÓN,031,GOLOTÓN LA RAYA,1,44,19,25,2
CHIAPAS,7,CHILÓN,031,GUADALUPE BATZEL,1,9,2,7,1
CHIAPAS,7,CHILÓN,031,GUADALUPE BAWITZ,2,11,4,7,2
CHIAPAS,7,CHILÓN,031,GUADALUPE CATARRAYA,1,17,8,9,2
CHIAPAS,7,CHILÓN,031,GUADALUPE CATARRAYA YETALTAJALTIC,2,14,5,9,2
CHIAPAS,7,CHILÓN,031,GUADALUPE GELWITZ,2,71,33,38,3
CHIAPAS,7,CHILÓN,031,GUADALUPE LIQUILWITZ,1,4,1,3,1
CHIAPAS,7,CHILÓN,031,GUADALUPE PAXILÁ,5,717,323,394,25
CHIAPAS,7,CHILÓN,031,GUADALUPE POJCOL,1,70,37,33,1
CHIAPAS,7,CHILÓN,031,GUADALUPE TZAJALUCUM,1,4,3,1,1
CHIAPAS,7,CHILÓN,031,GUADALUPE XAQUILÁ,2,49,26,23,3
CHIAPAS,7,CHILÓN,031,GUALEASIL,3,62,35,27,3
CHIAPAS,7,CHILÓN,031,GUALEASIL 2DA. SECCIÓN,2,24,15,9,3
CHIAPAS,7,CHILÓN,031,GUAQUITEPEC,8,1636,776,860,78
CHIAPAS,7,CHILÓN,031,GUAYAZA,2,169,84,85,7
CHIAPAS,7,CHILÓN,031,HIC'BATIL,2,120,53,67,3
CHIAPAS,7,CHILÓN,031,HIDALGO,2,26,14,12,2
CHIAPAS,7,CHILÓN,031,HORIZONTE AMAWITZ,3,127,65,62,5
CHIAPAS,7,CHILÓN,031,ICOSILJA,2,13,6,7,2
CHIAPAS,7,CHILÓN,031,IGNACIO ZARAGOZA,2,64,43,21,4
CHIAPAS,7,CHILÓN,031,INDEPENDENCIA,1,6,4,2,1
CHIAPAS,7,CHILÓN,031,ISRAEL,2,17,7,10,2
CHIAPAS,7,CHILÓN,031,JALALAL 1RA. SECCIÓN,2,25,12,13,3
CHIAPAS,7,CHILÓN,031,JET MESIL,2,81,41,40,4
CHIAPAS,7,CHILÓN,031,JET UCUM,2,8,3,5,1
CHIAPAS,7,CHILÓN,031,JET-JÁ,6,851,417,434,23
CHIAPAS,7,CHILÓN,031,JITETIC,1,10,5,5,1
CHIAPAS,7,CHILÓN,031,JITONTIC BAWITZ,2,10,5,5,2
CHIAPAS,7,CHILÓN,031,JOL AQUIL 1RA. SECCIÓN,2,16,8,8,2
CHIAPAS,7,CHILÓN,031,JOL ASHUPÁ,2,28,12,16,3
CHIAPAS,7,CHILÓN,031,JOL CACATEEL,1,55,22,33,2
CHIAPAS,7,CHILÓN,031,JOL CACUALÁ,2,43,22,21,3
CHIAPAS,7,CHILÓN,031,JOL CANTELÁ,2,62,30,32,3
CHIAPAS,7,CHILÓN,031,JOL CATARRAYA,4,181,87,94,12
CHIAPAS,7,CHILÓN,031,JOL CATARRAYA 1RA. SECCIÓN,3,117,64,53,4
CHIAPAS,7,CHILÓN,031,JOL CHALHA,2,21,9,12,3
CHIAPAS,7,CHILÓN,031,JOL CHAMENJÁ,2,48,23,25,4
CHIAPAS,7,CHILÓN,031,JOL CHEWAL,2,52,22,30,3
CHIAPAS,7,CHILÓN,031,JOL DIAMANTE,1,9,5,4,1
CHIAPAS,7,CHILÓN,031,JOL HIC'BATIL,5,370,195,175,13
CHIAPAS,7,CHILÓN,031,JOL MUC'ULJA',2,129,71,58,5
CHIAPAS,7,CHILÓN,031,JOL PAXILA,2,75,35,40,3
CHIAPAS,7,CHILÓN,031,JOL SACÚN,4,740,368,372,23
CHIAPAS,7,CHILÓN,031,JOL TANCHIVIL,3,62,32,30,3
CHIAPAS,7,CHILÓN,031,JOL XAQUILÁ,1,40,19,21,3
CHIAPAS,7,CHILÓN,031,JOL YAXTELA 2DA. SECCIÓN,1,19,8,11,1
CHIAPAS,7,CHILÓN,031,JOLAKIL,4,176,86,90,8
CHIAPAS,7,CHILÓN,031,JOLAMALTZAC,3,121,64,57,6
CHIAPAS,7,CHILÓN,031,JOLCHUTALILJA,2,66,38,28,4
CHIAPAS,7,CHILÓN,031,JOLTACANTEAL,2,58,30,28,3
CHIAPAS,7,CHILÓN,031,JOTOLA,5,201,102,99,9
CHIAPAS,7,CHILÓN,031,JOTOLÁ BELISARIO DOMÍNGUEZ,2,39,17,22,4
CHIAPAS,7,CHILÓN,031,JOY JOY CHÉN,2,21,11,10,2
CHIAPAS,7,CHILÓN,031,JOYBÉ,3,380,177,203,12
CHIAPAS,7,CHILÓN,031,JUAN SABINES VERAPAZ,3,365,179,186,15
CHIAPAS,7,CHILÓN,031,JUXUHECHEJ,1,78,35,43,2
CHIAPAS,7,CHILÓN,031,JUYUMPANTÉ,1,11,9,2,1
CHIAPAS,7,CHILÓN,031,K'ANJÁ,3,53,26,27,3
CHIAPAS,7,CHILÓN,031,K'ANTAJTIK 2DA. SECCIÓN,2,49,23,26,3
CHIAPAS,7,CHILÓN,031,K'LSISAL,3,103,44,59,4
CHIAPAS,7,CHILÓN,031,LA ALBORADA,1,18,10,8,2
CHIAPAS,7,CHILÓN,031,LA BETANIA,1,22,8,14,1
CHIAPAS,7,CHILÓN,031,LA CUMBRE VERAPAZ,1,27,12,15,1
CHIAPAS,7,CHILÓN,031,LA ESCONDIDA,2,23,10,13,2
CHIAPAS,7,CHILÓN,031,LA ESTANCIA,1,19,10,9,1
CHIAPAS,7,CHILÓN,031,LA ESTANCIA 2DA. SECCIÓN,1,4,2,2,1
CHIAPAS,7,CHILÓN,031,LA GUADALUPANA,1,9,6,3,1
CHIAPAS,7,CHILÓN,031,LA ILUSIÓN,2,90,44,46,3
CHIAPAS,7,CHILÓN,031,LA LIBERTAD,2,55,30,25,2
CHIAPAS,7,CHILÓN,031,LA PALMA,2,91,53,38,3
CHIAPAS,7,CHILÓN,031,LA PIEDRECITA,2,25,15,10,3
CHIAPAS,7,CHILÓN,031,LA PIMIENTA,2,91,53,38,4
CHIAPAS,7,CHILÓN,031,LA PROVIDENCIA,1,30,19,11,2
CHIAPAS,7,CHILÓN,031,LA RAYA EL LIMÓN,1,45,20,25,2
CHIAPAS,7,CHILÓN,031,LA VICTORIA,2,115,63,52,4
CHIAPAS,7,CHILÓN,031,LAGUNA BUENAVISTA,2,23,15,8,2
CHIAPAS,7,CHILÓN,031,LAGUNA VERDE,1,25,11,14,1
CHIAPAS,7,CHILÓN,031,LAMALTZAC,2,65,32,33,3
CHIAPAS,7,CHILÓN,031,LAS DELICIAS,2,38,21,17,3
CHIAPAS,7,CHILÓN,031,LAS GARDENIAS,1,13,2,11,1
CHIAPAS,7,CHILÓN,031,LAS GOLONDRINAS,2,15,7,8,2
CHIAPAS,7,CHILÓN,031,LAS LIMAS,2,60,26,34,3
CHIAPAS,7,CHILÓN,031,LAS MONTAÑAS,3,95,48,47,7
CHIAPAS,7,CHILÓN,031,LAS PALMAS,1,29,14,15,1
CHIAPAS,7,CHILÓN,031,LÁZARO CÁRDENAS,7,185,84,101,9
CHIAPAS,7,CHILÓN,031,LÁZARO CÁRDENAS 2DA. SECCIÓN,1,20,11,9,2
CHIAPAS,7,CHILÓN,031,LIMONAL,2,15,8,7,2
CHIAPAS,7,CHILÓN,031,LIQUILWITZ (LA CURVA),3,91,50,41,5
CHIAPAS,7,CHILÓN,031,LOS MANGOS,3,410,219,191,13
CHIAPAS,7,CHILÓN,031,MAJ CHUM,3,187,99,88,7
CHIAPAS,7,CHILÓN,031,MAJASIL,2,52,23,29,2
CHIAPAS,7,CHILÓN,031,MAP,1,7,4,3,1
CHIAPAS,7,CHILÓN,031,MAPIL,2,50,24,26,2
CHIAPAS,7,CHILÓN,031,MAQUINCHAB,1,50,18,32,2
CHIAPAS,7,CHILÓN,031,MASANILJA,4,90,34,56,5
CHIAPAS,7,CHILÓN,031,MAZANILJÁ,2,4,0,4,1
CHIAPAS,7,CHILÓN,031,MEBATÓN,2,24,13,11,3
CHIAPAS,7,CHILÓN,031,MEQUEJA,3,406,204,202,13
CHIAPAS,7,CHILÓN,031,MOBALTÉ,4,29,16,13,4
CHIAPAS,7,CHILÓN,031,MOHA,1,67,31,36,2
CHIAPAS,7,CHILÓN,031,MOJONERA JOLTUBO,1,10,5,5,1
CHIAPAS,7,CHILÓN,031,MONTE AZUL,3,52,32,20,5
CHIAPAS,7,CHILÓN,031,MONTE SINAÍ,2,22,10,12,2
CHIAPAS,7,CHILÓN,031,MONTEPÍO,2,60,28,32,3
CHIAPAS,7,CHILÓN,031,MORELITOS,2,47,29,18,2
CHIAPAS,7,CHILÓN,031,MORELITOS 1RA. SECCIÓN,3,33,20,13,3
CHIAPAS,7,CHILÓN,031,MUC'AQUIL,2,116,60,56,4
CHIAPAS,7,CHILÓN,031,MUC'ULJA',2,94,43,51,4
CHIAPAS,7,CHILÓN,031,MUQUENAL,3,72,37,35,4
CHIAPAS,7,CHILÓN,031,NAHILTÉ 1RA. SECCIÓN,4,95,53,42,6
CHIAPAS,7,CHILÓN,031,NAHILTÉ 2DA. SECCIÓN,1,5,3,2,1
CHIAPAS,7,CHILÓN,031,NAHILTÉ 3RA. SECCIÓN,4,584,282,302,19
CHIAPAS,7,CHILÓN,031,NAVITEEL,2,48,25,23,3
CHIAPAS,7,CHILÓN,031,NAZARETH,3,168,79,89,7
CHIAPAS,7,CHILÓN,031,NAZARETH SAN JERÓNIMO BACHAJÓN,2,17,9,8,2
CHIAPAS,7,CHILÓN,031,NICHTEEL,3,96,38,58,5
CHIAPAS,7,CHILÓN,031,NUEVA ESPERANZA,1,6,2,4,1
CHIAPAS,7,CHILÓN,031,NUEVA GENERACIÓN,2,22,9,13,2
CHIAPAS,7,CHILÓN,031,NUEVA JERUSALÉN,4,139,74,65,8
CHIAPAS,7,CHILÓN,031,NUEVA LINDAVISTA,2,19,10,9,2
CHIAPAS,7,CHILÓN,031,NUEVA TIERRA BLANCA,2,62,41,21,3
CHIAPAS,7,CHILÓN,031,NUEVO JOTOAQUIL,2,103,45,58,5
CHIAPAS,7,CHILÓN,031,NUEVO LIMONAL,3,31,16,15,3
CHIAPAS,7,CHILÓN,031,NUEVO PECHTÓN,2,82,49,33,3
CHIAPAS,7,CHILÓN,031,NUEVO PINO SUÁREZ,1,8,3,5,1
CHIAPAS,7,CHILÓN,031,NUEVO PROGRESO,4,343,153,190,15
CHIAPAS,7,CHILÓN,031,NUEVO TEPEYAC,2,43,19,24,4
CHIAPAS,7,CHILÓN,031,NUEVO TILA,1,14,7,7,1
CHIAPAS,7,CHILÓN,031,NUEVO VILLAFLORES,1,11,7,4,1
CHIAPAS,7,CHILÓN,031,OCOTAL,1,18,11,7,1
CHIAPAS,7,CHILÓN,031,OJO DE AGUA,1,44,23,21,2
CHIAPAS,7,CHILÓN,031,OJO DE AGUA LIQUILWITZ,2,40,20,20,2
CHIAPAS,7,CHILÓN,031,ONTEEL,2,61,37,24,3
CHIAPAS,7,CHILÓN,031,ORIZABA,2,16,9,7,2
CHIAPAS,7,CHILÓN,031,OXJETJÁ,3,99,47,52,4
CHIAPAS,7,CHILÓN,031,OXJETJÁ 2DA. SECCIÓN (MUC'ULVE),1,12,7,5,1
CHIAPAS,7,CHILÓN,031,PALMA XHANAIL,2,13,8,5,2
CHIAPAS,7,CHILÓN,031,PAMAL NAVIL,4,431,200,231,15
CHIAPAS,7,CHILÓN,031,PAMALHÁ 1RA. SECCIÓN,1,21,8,13,1
CHIAPAS,7,CHILÓN,031,PAMALHÁ 2DA. SECCIÓN,3,93,47,46,4
CHIAPAS,7,CHILÓN,031,PANTELHÁ,2,117,52,65,5
CHIAPAS,7,CHILÓN,031,PANTEMAJAS,3,111,53,58,5
CHIAPAS,7,CHILÓN,031,PARAÍSO TULIJÁ,2,90,44,46,4
CHIAPAS,7,CHILÓN,031,PASHILA 1RA. SECCIÓN,1,7,4,3,1
CHIAPAS,7,CHILÓN,031,PATALILJÁ,2,36,20,16,3
CHIAPAS,7,CHILÓN,031,PATATEHEL,3,326,159,167,12
CHIAPAS,7,CHILÓN,031,PATBAXIL,2,139,68,71,4
CHIAPAS,7,CHILÓN,031,PATELNÁ,4,244,117,127,10
CHIAPAS,7,CHILÓN,031,PATELNA 2DA. SECCIÓN,3,137,72,65,5
CHIAPAS,7,CHILÓN,031,PATHUITZ,2,97,53,44,4
CHIAPAS,7,CHILÓN,031,PAXILA,2,30,15,15,2
CHIAPAS,7,CHILÓN,031,PAXILÁ ANTIOQUÍA,2,44,21,23,2
CHIAPAS,7,CHILÓN,031,PAXILÁ LIQUILWITZ,1,14,5,9,1
CHIAPAS,7,CHILÓN,031,PECHTÓN ICOLSIJÁ,2,68,42,26,3
CHIAPAS,7,CHILÓN,031,PEDREGAL,2,14,7,7,2
CHIAPAS,7,CHILÓN,031,PEÑA FUERTE,2,91,51,40,3
CHIAPAS,7,CHILÓN,031,PINABETAL,2,148,71,77,7
CHIAPAS,7,CHILÓN,031,PIQUINTEEL,2,24,15,9,2
CHIAPAS,7,CHILÓN,031,PIQUINTEEL SAN ANTONIO,1,4,1,3,1
CHIAPAS,7,CHILÓN,031,POQUIL,1,42,15,27,2
CHIAPAS,7,CHILÓN,031,PUERTA TÓN,2,31,17,14,2
CHIAPAS,7,CHILÓN,031,QUEXIL,2,19,7,12,2
CHIAPAS,7,CHILÓN,031,RAMOSIL (TZAJALNABIL),4,319,167,152,17
CHIAPAS,7,CHILÓN,031,RAYA OJO DE AGUA,1,26,16,10,2
CHIAPAS,7,CHILÓN,031,REFORMA K'ANAKIL,1,20,8,12,1
CHIAPAS,7,CHILÓN,031,SACLUMIL,3,63,30,33,3
CHIAPAS,7,CHILÓN,031,SACÚN CUBWITZ,5,775,358,417,31
CHIAPAS,7,CHILÓN,031,SACÚN GUADALUPE (BAXAC),2,70,37,33,3
CHIAPAS,7,CHILÓN,031,SACÚN PALMA,2,27,13,14,2
CHIAPAS,7,CHILÓN,031,SACÚN SAN MIGUEL,2,8,3,5,2
CHIAPAS,7,CHILÓN,031,SACÚN SAN PEDRO,1,19,12,7,1
CHIAPAS,7,CHILÓN,031,SACUN SAQUILÁ,2,136,70,66,4
CHIAPAS,7,CHILÓN,031,SALTO DEL TIGRE,2,33,13,20,3
CHIAPAS,7,CHILÓN,031,SAMARIA,1,46,25,21,1
CHIAPAS,7,CHILÓN,031,SAMARIA JOL-ACH' ALELJÁ,1,6,4,2,1
CHIAPAS,7,CHILÓN,031,SAMARIA K'ANTAJAL,2,17,11,6,2
CHIAPAS,7,CHILÓN,031,SAMARIA LIQUILWITZ,2,8,4,4,1
CHIAPAS,7,CHILÓN,031,SAN ANTONIO BULUJIB,3,540,255,285,23
CHIAPAS,7,CHILÓN,031,SAN ANTONIO EL PROGRESO,2,25,16,9,3
CHIAPAS,7,CHILÓN,031,SAN ANTONIO LAS PALOMAS,2,99,56,43,4
CHIAPAS,7,CHILÓN,031,SAN FELIPE,2,64,25,39,2
CHIAPAS,7,CHILÓN,031,SAN FRANCISCO,2,16,10,6,2
CHIAPAS,7,CHILÓN,031,SAN FRANCISCO CHAMENJA,2,40,22,18,4
CHIAPAS,7,CHILÓN,031,SAN FRANCISCO DURAZNAL,2,104,58,46,4
CHIAPAS,7,CHILÓN,031,SAN GABRIEL,5,121,59,62,6
CHIAPAS,7,CHILÓN,031,SAN GABRIEL (CENTRO),1,10,5,5,1
CHIAPAS,7,CHILÓN,031,SAN GABRIEL 2DA. SECCIÓN,1,13,9,4,1
CHIAPAS,7,CHILÓN,031,SAN ISIDRO,1,63,39,24,2
CHIAPAS,7,CHILÓN,031,SAN ISIDRO TULIJÁ,1,20,13,7,2
CHIAPAS,7,CHILÓN,031,SAN JACINTO,4,50,23,27,5
CHIAPAS,7,CHILÓN,031,SAN JERÓNIMO,1,19,13,6,2
CHIAPAS,7,CHILÓN,031,SAN JERÓNIMO PAXILA,2,16,6,10,2
CHIAPAS,7,CHILÓN,031,SAN JERÓNIMO TULIJÁ,5,947,460,487,38
CHIAPAS,7,CHILÓN,031,SAN JOSÉ,2,24,11,13,2
CHIAPAS,7,CHILÓN,031,SAN JOSÉ AVENTURA,2,9,4,5,2
CHIAPAS,7,CHILÓN,031,SAN JOSÉ BAWITZ,1,25,12,13,1
CHIAPAS,7,CHILÓN,031,SAN JOSÉ DE LOS MANGOS,1,17,11,6,1
CHIAPAS,7,CHILÓN,031,SAN JOSÉ EDÉN,2,46,21,25,2
CHIAPAS,7,CHILÓN,031,SAN JOSÉ EL CHAPAPUYIL,2,87,50,37,3
CHIAPAS,7,CHILÓN,031,SAN JOSÉ GUAYAQUIL,1,44,15,29,1
CHIAPAS,7,CHILÓN,031,SAN JOSÉ NANCITÉ,1,24,15,9,1
CHIAPAS,7,CHILÓN,031,SAN JOSÉ PATBAXIL,2,61,26,35,3
CHIAPAS,7,CHILÓN,031,SAN JOSÉ PATHUITZ,4,770,361,409,28
CHIAPAS,7,CHILÓN,031,SAN JOSÉ PULEMAL,2,51,32,19,2
CHIAPAS,7,CHILÓN,031,SAN JOSÉ SACLUMIL,1,6,2,4,1
CHIAPAS,7,CHILÓN,031,SAN JOSÉ TENOJIB,2,30,17,13,3
CHIAPAS,7,CHILÓN,031,SAN JOSÉ TENOJID 1RA. SECCIÓN,1,10,4,6,1
CHIAPAS,7,CHILÓN,031,SAN JOSÉ VERACRUZ,2,29,19,10,2
CHIAPAS,7,CHILÓN,031,SAN JUAN BAWITZ,3,109,48,61,4
CHIAPAS,7,CHILÓN,031,SAN JUAN CANTAJAL,2,17,6,11,2
CHIAPAS,7,CHILÓN,031,SAN JUAN CATARRAYA,3,43,22,21,4
CHIAPAS,7,CHILÓN,031,SAN JUAN CHICH'NIHTIC,2,54,27,27,2
CHIAPAS,7,CHILÓN,031,SAN JUAN ERMITA,2,10,6,4,2
CHIAPAS,7,CHILÓN,031,SAN LUIS NAPILÁ,2,49,25,24,3
CHIAPAS,7,CHILÓN,031,SAN MARCOS AVILÉS,2,203,102,101,6
CHIAPAS,7,CHILÓN,031,SAN MARCOS BAJÁ,2,26,11,15,3
CHIAPAS,7,CHILÓN,031,SAN MARCOS EL CARMEN,2,48,23,25,3
CHIAPAS,7,CHILÓN,031,SAN MARCOS TULIJÁ,2,64,36,28,3
CHIAPAS,7,CHILÓN,031,SAN MARTÍN CRUZTÓN,2,143,65,78,5
CHIAPAS,7,CHILÓN,031,SAN MATEO NAHTIL CRUZ LAS CONCHITAS,1,14,10,4,1
CHIAPAS,7,CHILÓN,031,SAN MIGUEL CANXANIL,3,146,84,62,6
CHIAPAS,7,CHILÓN,031,SAN MIGUEL CATARRAYA,2,44,22,22,2
CHIAPAS,7,CHILÓN,031,SAN MIGUEL JOCOTAQUÍN,2,31,17,14,3
CHIAPAS,7,CHILÓN,031,SAN MIGUEL JOTOAQUIL,2,29,19,10,3
CHIAPAS,7,CHILÓN,031,SAN MIGUEL TULIJÁ,2,59,29,30,2
CHIAPAS,7,CHILÓN,031,SAN PEDRO PAXILA,2,13,7,6,2
CHIAPAS,7,CHILÓN,031,SAN PEDRO PULEMAL,2,27,17,10,3
CHIAPAS,7,CHILÓN,031,SAN PEDRO TULIJÁ,2,126,63,63,5
CHIAPAS,7,CHILÓN,031,SAN PEDRO YOC NAVIL,3,28,12,16,4
CHIAPAS,7,CHILÓN,031,SAN PEDRO ZAPOTAL,2,18,10,8,2
CHIAPAS,7,CHILÓN,031,SAN SEBASTIÁN PAXILÁ,1,6,3,3,1
CHIAPAS,7,CHILÓN,031,SANTA ANITA,2,18,12,6,2
CHIAPAS,7,CHILÓN,031,SANTA CRUZ TULIJÁ,2,20,12,8,2
CHIAPAS,7,CHILÓN,031,SANTA ROSA,1,29,16,13,1
CHIAPAS,7,CHILÓN,031,SANTA ROSA MAMALIK,2,147,80,67,6
CHIAPAS,7,CHILÓN,031,SANTIAGO POJCOL,5,618,304,314,22
CHIAPAS,7,CHILÓN,031,SANTO TON,3,60,29,31,5
CHIAPAS,7,CHILÓN,031,SAQUILTEEL,2,33,15,18,2
CHIAPAS,7,CHILÓN,031,SAQUIL-ULUB,2,66,29,37,3
CHIAPAS,7,CHILÓN,031,SASAMTIC,1,40,24,16,2
CHIAPAS,7,CHILÓN,031,SEGUNDA PALMA,1,5,3,2,1
CHIAPAS,7,CHILÓN,031,SEGUNDO JOLAMALTZAC,1,9,3,6,1
CHIAPAS,7,CHILÓN,031,SEGUNDO TIAQUIL,2,24,13,11,3
CHIAPAS,7,CHILÓN,031,SEGUNDO TZAJALCHÉN,2,116,63,53,3
CHIAPAS,7,CHILÓN,031,SEPEL ACTÉ,3,75,30,45,7
CHIAPAS,7,CHILÓN,031,SIBALACTIC,1,10,6,4,1
CHIAPAS,7,CHILÓN,031,SIBAQÚIL,2,98,46,52,3
CHIAPAS,7,CHILÓN,031,SJUKLES,2,29,11,18,3
CHIAPAS,7,CHILÓN,031,SOTEEL,3,101,51,50,4
CHIAPAS,7,CHILÓN,031,SULUPHUITZ,4,431,207,224,15
CHIAPAS,7,CHILÓN,031,SUYALÁ,1,25,16,9,1
CHIAPAS,7,CHILÓN,031,TACUBA NUEVA,4,790,380,410,25
CHIAPAS,7,CHILÓN,031,TACUBA VIEJA,2,86,46,40,3
CHIAPAS,7,CHILÓN,031,TAKINJÁ,1,23,9,14,1
CHIAPAS,7,CHILÓN,031,TAKINUKUM,2,20,7,13,2
CHIAPAS,7,CHILÓN,031,TANCHIVIL,2,17,7,10,2
CHIAPAS,7,CHILÓN,031,TANIYAL,1,25,7,18,1
CHIAPAS,7,CHILÓN,031,TEMÓ,4,528,222,306,16
CHIAPAS,7,CHILÓN,031,TIAQUIL,2,133,59,74,5
CHIAPAS,7,CHILÓN,031,TIERRA ARENAL,2,8,5,3,1
CHIAPAS,7,CHILÓN,031,TIERRA PLANADA,2,15,9,6,2
CHIAPAS,7,CHILÓN,031,TIERRA Y LIBERTAD,2,51,25,26,3
CHIAPAS,7,CHILÓN,031,TIM,2,104,49,55,4
CHIAPAS,7,CHILÓN,031,TOPOTEEL,2,25,9,16,3
CHIAPAS,7,CHILÓN,031,TOPOTEEL SAN SEBASTIÁN,2,20,10,10,2
CHIAPAS,7,CHILÓN,031,TUNAPAZ,2,69,37,32,3
CHIAPAS,7,CHILÓN,031,TUT ASHUPÁ,2,10,6,4,2
CHIAPAS,7,CHILÓN,031,TZAJALÁ,9,959,491,468,37
CHIAPAS,7,CHILÓN,031,TZAJALÁ JERICÓ,2,73,33,40,3
CHIAPAS,7,CHILÓN,031,TZAJALCHÉN 1RA. SECCIÓN,2,110,69,41,3
CHIAPAS,7,CHILÓN,031,TZAJALTEEL,2,27,13,14,2
CHIAPAS,7,CHILÓN,031,TZAJALUCUM,3,86,44,42,3
CHIAPAS,7,CHILÓN,031,TZAJAL-UCUM 2DA. SECCIÓN,2,26,12,14,3
CHIAPAS,7,CHILÓN,031,TZASIBILTIC,2,203,106,97,7
CHIAPAS,7,CHILÓN,031,TZINTEEL,2,72,35,37,3
CHIAPAS,7,CHILÓN,031,TZOBOJITLE JOTOAQUIL,4,651,292,359,28
CHIAPAS,7,CHILÓN,031,TZUBUTEEL (LA ROSITA),1,21,14,7,1
CHIAPAS,7,CHILÓN,031,UJCAYIL,2,78,30,48,4
CHIAPAS,7,CHILÓN,031,UXYOQUET,2,111,56,55,3
CHIAPAS,7,CHILÓN,031,VIRGEN DE DOLORES,1,22,12,10,1
CHIAPAS,7,CHILÓN,031,VISTA HERMOSA,2,16,6,10,2
CHIAPAS,7,CHILÓN,031,WILIBJÁ,5,111,57,54,6
CHIAPAS,7,CHILÓN,031,XANIL,3,290,141,149,11
CHIAPAS,7,CHILÓN,031,XANIL II SECCIÓN,2,45,20,25,4
CHIAPAS,7,CHILÓN,031,XAQUILÁ,2,75,37,38,3
CHIAPAS,7,CHILÓN,031,XAXAJATIC,3,331,180,151,9
CHIAPAS,7,CHILÓN,031,XEXAL,2,65,26,39,3
CHIAPAS,7,CHILÓN,031,XEXAL JOCOTAQUÍN,2,38,18,20,2
CHIAPAS,7,CHILÓN,031,XEXALJÁ SEGUNDA SECCIÓN,2,48,26,22,3
CHIAPAS,7,CHILÓN,031,XHANAIL,2,98,57,41,4
CHIAPAS,7,CHILÓN,031,XIXINTONAL,1,45,22,23,1
CHIAPAS,7,CHILÓN,031,XIXINTONIL,1,8,4,4,1
CHIAPAS,7,CHILÓN,031,XLEMLAJANTÓN 2DA. SECCIÓN,2,21,8,13,2
CHIAPAS,7,CHILÓN,031,XOTXOTJÁ LAS CANCHAS,3,281,135,146,12
CHIAPAS,7,CHILÓN,031,YA'ALTZEMEN,2,107,59,48,4
CHIAPAS,7,CHILÓN,031,YALEMESIL,1,20,13,7,1
CHIAPAS,7,CHILÓN,031,YAXHUINIC,1,5,2,3,1
CHIAPAS,7,CHILÓN,031,YAXTELJÁ,2,75,37,38,3
CHIAPAS,7,CHILÓN,031,YETAL MOBALTE,2,14,2,12,2
CHIAPAS,7,CHILÓN,031,YETAL-TZ'AC,2,40,10,30,2
CHIAPAS,7,CHILÓN,031,YOC CACUALÁ,2,13,7,6,2
CHIAPAS,7,CHILÓN,031,YOC'HA XHANAIL 1RA. SECCIÓN,2,59,32,27,2
CHIAPAS,7,CHILÓN,031,YOCHIBJÁ,1,39,15,24,1
CHIAPAS,7,CHILÓN,031,YOCJÁ,2,119,58,61,4
CHIAPAS,7,CHILÓN,031,YOCNAVIL,2,34,15,19,2
CHIAPAS,7,CHILÓN,031,YOC-SAC'JÚN,2,72,42,30,2
CHIAPAS,7,CHILÓN,031,YULUBMAX,2,117,63,54,4
CHIAPAS,7,ESCUINTLA,032,15 DE JUNIO DOS,1,9,3,6,1
CHIAPAS,7,ESCUINTLA,032,4 DE OCTUBRE,2,82,33,49,4
CHIAPAS,7,ESCUINTLA,032,5 DE OCTUBRE,1,7,4,3,1
CHIAPAS,7,ESCUINTLA,032,BELÉN,3,34,18,16,3
CHIAPAS,7,ESCUINTLA,032,BELISARIO DOMÍNGUEZ,2,39,19,20,3
CHIAPAS,7,ESCUINTLA,032,BOLIVIA,2,13,5,8,2
CHIAPAS,7,ESCUINTLA,032,BRISAS DEL SOCONUSCO,2,40,15,25,3
CHIAPAS,7,ESCUINTLA,032,BUENAVISTA,4,88,46,42,6
CHIAPAS,7,ESCUINTLA,032,BUENAVISTA III,2,17,7,10,2
CHIAPAS,7,ESCUINTLA,032,CATORCE DE NOVIEMBRE,2,15,7,8,2
CHIAPAS,7,ESCUINTLA,032,CINTALAPA,3,279,130,149,12
CHIAPAS,7,ESCUINTLA,032,COLOMBIA DOS,2,32,11,21,3
CHIAPAS,7,ESCUINTLA,032,CUAUHTÉMOC CHACHALACA,2,33,16,17,2
CHIAPAS,7,ESCUINTLA,032,DOCTOR BELISARIO DOMÍNGUEZ,2,17,6,11,2
CHIAPAS,7,ESCUINTLA,032,EL ARENAL,3,125,54,71,7
CHIAPAS,7,ESCUINTLA,032,EL BARRIAL,1,9,4,5,1
CHIAPAS,7,ESCUINTLA,032,EL CARMEN,2,17,10,7,2
CHIAPAS,7,ESCUINTLA,032,EL HORIZONTE,3,71,31,40,4
CHIAPAS,7,ESCUINTLA,032,EL JILGUERO,1,9,5,4,1
CHIAPAS,7,ESCUINTLA,032,EL JORDÁN,1,11,6,5,1
CHIAPAS,7,ESCUINTLA,032,EL MANANTIAL,1,100,53,47,5
CHIAPAS,7,ESCUINTLA,032,EL NARANJO,1,17,9,8,2
CHIAPAS,7,ESCUINTLA,032,EL NARANJO 2,2,11,7,4,2
CHIAPAS,7,ESCUINTLA,032,EL QUICHÉ,1,8,6,2,1
CHIAPAS,7,ESCUINTLA,032,EL RECUERDO,2,28,15,13,3
CHIAPAS,7,ESCUINTLA,032,EL TEXANITO,2,12,8,4,2
CHIAPAS,7,ESCUINTLA,032,EL TRÁNSITO,1,34,10,24,3
CHIAPAS,7,ESCUINTLA,032,EL TRIUNFO,8,1086,548,538,79
CHIAPAS,7,ESCUINTLA,032,ESCUINTLA,15,3475,1755,1720,151
CHIAPAS,7,ESCUINTLA,032,FRACCIÓN BANDERA,1,18,11,7,1
CHIAPAS,7,ESCUINTLA,032,FRANCISCO VILLA,2,55,27,28,5
CHIAPAS,7,ESCUINTLA,032,GRIJALVA,2,31,13,18,3
CHIAPAS,7,ESCUINTLA,032,HÉCTOR ALVARADO HERRERA,2,24,10,14,3
CHIAPAS,7,ESCUINTLA,032,HOJA BLANCA,4,101,48,53,8
CHIAPAS,7,ESCUINTLA,032,INDEPENDENCIA I,2,112,58,54,5
CHIAPAS,7,ESCUINTLA,032,INDEPENDENCIA II,1,8,5,3,1
CHIAPAS,7,ESCUINTLA,032,JALAPA,3,112,55,57,6
CHIAPAS,7,ESCUINTLA,032,LA ESPERANZA,2,30,18,12,3
CHIAPAS,7,ESCUINTLA,032,LA INDEPENDENCIA,3,304,154,150,14
CHIAPAS,7,ESCUINTLA,032,LA VEGUITA,2,38,21,17,2
CHIAPAS,7,ESCUINTLA,032,LAS FLORES,1,4,2,2,1
CHIAPAS,7,ESCUINTLA,032,LAS MALVINAS,3,85,45,40,3
CHIAPAS,7,ESCUINTLA,032,LAS NUBES,3,40,17,23,3
CHIAPAS,7,ESCUINTLA,032,LLANO GRANDE,1,7,1,6,1
CHIAPAS,7,ESCUINTLA,032,LOS CIMIENTOS,2,16,7,9,2
CHIAPAS,7,ESCUINTLA,032,LOS COSTEÑOS,2,16,11,5,2
CHIAPAS,7,ESCUINTLA,032,LOS LIMONES,2,24,16,8,2
CHIAPAS,7,ESCUINTLA,032,LOS MANGOS (REFORMA),1,18,9,9,1
CHIAPAS,7,ESCUINTLA,032,MANACAL LLANO GRANDE,2,76,32,44,4
CHIAPAS,7,ESCUINTLA,032,MONTAGUA,1,13,4,9,1
CHIAPAS,7,ESCUINTLA,032,NUEVA CALIFORNIA,1,8,4,4,1
CHIAPAS,7,ESCUINTLA,032,NUEVA FRANCIA,2,124,58,66,6
CHIAPAS,7,ESCUINTLA,032,NUEVA MORELIA,3,67,33,34,4
CHIAPAS,7,ESCUINTLA,032,NUEVA REFORMA,3,46,22,24,4
CHIAPAS,7,ESCUINTLA,032,NUEVA SONORA,1,5,4,1,1
CHIAPAS,7,ESCUINTLA,032,NUEVO LLANO GRANDE,5,332,162,170,14
CHIAPAS,7,ESCUINTLA,032,NUEVO MILENIO (NUEVA FRANCIA),2,193,82,111,9
CHIAPAS,7,ESCUINTLA,032,OJO DE AGUA,2,35,19,16,3
CHIAPAS,7,ESCUINTLA,032,OJO DE AGUA II,2,14,8,6,2
CHIAPAS,7,ESCUINTLA,032,OVANDO LA PIÑUELA,3,94,56,38,5
CHIAPAS,7,ESCUINTLA,032,OVANDO TURQUÍA,3,134,73,61,7
CHIAPAS,7,ESCUINTLA,032,RICARDO FLORES MAGÓN,2,45,22,23,3
CHIAPAS,7,ESCUINTLA,032,RINCÓN VERACRUZ,4,437,210,227,20
CHIAPAS,7,ESCUINTLA,032,ROSARITO LA PIÑUELA,2,15,9,6,2
CHIAPAS,7,ESCUINTLA,032,SAN ANTONIO MIRAMAR,4,174,80,94,9
CHIAPAS,7,ESCUINTLA,032,SAN BENITO,1,17,6,11,1
CHIAPAS,7,ESCUINTLA,032,SAN FELIPE TIZAPA,4,570,262,308,23
CHIAPAS,7,ESCUINTLA,032,SAN JUAN PANAMÁ,4,131,73,58,7
CHIAPAS,7,ESCUINTLA,032,SAN LUCAS,1,16,8,8,1
CHIAPAS,7,ESCUINTLA,032,SANTA CRUZ,1,17,10,7,2
CHIAPAS,7,ESCUINTLA,032,SANTA ISABEL,3,47,24,23,4
CHIAPAS,7,ESCUINTLA,032,SANTA ROSA,3,68,37,31,6
CHIAPAS,7,ESCUINTLA,032,UNIÓN JAMAICA,5,378,190,188,17
CHIAPAS,7,ESCUINTLA,032,VEGA DE JUÁREZ,1,10,4,6,1
CHIAPAS,7,ESCUINTLA,032,ZACUALPA DOS,2,43,22,21,3
CHIAPAS,7,FRANCISCO LEÓN,033,ARROYO CARACOL (MONTE DE OLIVO),3,62,33,29,4
CHIAPAS,7,FRANCISCO LEÓN,033,ARROYO SANGRE,2,18,10,8,2
CHIAPAS,7,FRANCISCO LEÓN,033,AZAPAC AMATAL,5,197,107,90,12
CHIAPAS,7,FRANCISCO LEÓN,033,CANDELARIA,1,7,3,4,1
CHIAPAS,7,FRANCISCO LEÓN,033,CARRIZAL,2,21,9,12,3
CHIAPAS,7,FRANCISCO LEÓN,033,EL GAVILÁN,1,11,5,6,1
CHIAPAS,7,FRANCISCO LEÓN,033,GUADALUPE SARDINA,3,71,30,41,4
CHIAPAS,7,FRANCISCO LEÓN,033,LAS CRUCES,3,36,18,18,4
CHIAPAS,7,FRANCISCO LEÓN,033,NARANJO,3,160,72,88,8
CHIAPAS,7,FRANCISCO LEÓN,033,NUEVA CANDELARIA,2,21,11,10,3
CHIAPAS,7,FRANCISCO LEÓN,033,NUEVA TRINIDAD (TZIMBAC),3,24,7,17,3
CHIAPAS,7,FRANCISCO LEÓN,033,NUEVO CARMEN,1,6,2,4,1
CHIAPAS,7,FRANCISCO LEÓN,033,NUEVO CRISTO REY,3,116,58,58,6
CHIAPAS,7,FRANCISCO LEÓN,033,NUEVO PARAÍSO,3,33,17,16,3
CHIAPAS,7,FRANCISCO LEÓN,033,NUEVO TILA,2,30,12,18,2
CHIAPAS,7,FRANCISCO LEÓN,033,PARAÍSO,2,29,16,13,2
CHIAPAS,7,FRANCISCO LEÓN,033,RÍO NEGRO,3,79,36,43,5
CHIAPAS,7,FRANCISCO LEÓN,033,RIVERA EL VIEJO CARMEN,5,300,152,148,15
CHIAPAS,7,FRANCISCO LEÓN,033,SAN ANTONIO MASPAC,2,39,21,18,2
CHIAPAS,7,FRANCISCO LEÓN,033,SAN JOSÉ MASPAC,4,346,166,180,15
CHIAPAS,7,FRANCISCO LEÓN,033,SAN MIGUEL,1,6,4,2,1
CHIAPAS,7,FRANCISCO LEÓN,033,SAN MIGUEL BUENAVISTA,2,12,4,8,2
CHIAPAS,7,FRANCISCO LEÓN,033,SAN MIGUEL LA SARDINA,5,421,202,219,17
CHIAPAS,7,FRANCISCO LEÓN,033,SAN PABLO TUMBAC,2,36,12,24,2
CHIAPAS,7,FRANCISCO LEÓN,033,SANTA MARTHA,3,31,14,17,4
CHIAPAS,7,FRANCISCO LEÓN,033,SANTO DOMINGO,2,10,5,5,2
CHIAPAS,7,FRANCISCO LEÓN,033,SIETE ARROYOS (EL AMPARO),2,8,5,3,2
CHIAPAS,7,FRANCISCO LEÓN,033,VICENTE GUERRERO,5,239,104,135,13
CHIAPAS,7,FRONTERA COMALAPA,034,20 DE MAYO,1,18,11,7,1
CHIAPAS,7,FRONTERA COMALAPA,034,AGUA ZARCA,2,430,209,221,16
CHIAPAS,7,FRONTERA COMALAPA,034,BELLAVISTA DEL NORTE,3,207,97,110,11
CHIAPAS,7,FRONTERA COMALAPA,034,BENITO JUÁREZ,5,488,235,253,19
CHIAPAS,7,FRONTERA COMALAPA,034,BUENOS AIRES,2,9,3,6,2
CHIAPAS,7,FRONTERA COMALAPA,034,CIUDAD CUAUHTÉMOC,3,762,372,390,30
CHIAPAS,7,FRONTERA COMALAPA,034,COSTA RICA,3,200,104,96,11
CHIAPAS,7,FRONTERA COMALAPA,034,DOCTOR RODULFO FIGUEROA (TIERRA BLANCA),3,438,213,225,21
CHIAPAS,7,FRONTERA COMALAPA,034,EL ANONAL,3,202,101,101,11
CHIAPAS,7,FRONTERA COMALAPA,034,EL AZUFRE,1,85,47,38,4
CHIAPAS,7,FRONTERA COMALAPA,034,EL FRAMBOYÁN,2,323,147,176,16
CHIAPAS,7,FRONTERA COMALAPA,034,EL JOCOTE,1,15,8,7,1
CHIAPAS,7,FRONTERA COMALAPA,034,EL PORTAL,3,346,180,166,15
CHIAPAS,7,FRONTERA COMALAPA,034,EL RECUERDO,2,37,14,23,3
CHIAPAS,7,FRONTERA COMALAPA,034,EL TRIUNFO DE LAS TRES MARAVILLAS,3,394,201,193,17
CHIAPAS,7,FRONTERA COMALAPA,034,FLOR DE GRIJALVA,1,6,1,5,1
CHIAPAS,7,FRONTERA COMALAPA,034,FRONTERA COMALAPA,36,6732,3522,3210,548
CHIAPAS,7,FRONTERA COMALAPA,034,GUADALUPE GRIJALVA,4,311,161,150,14
CHIAPAS,7,FRONTERA COMALAPA,034,HUIXNAYAL,3,230,123,107,11
CHIAPAS,7,FRONTERA COMALAPA,034,JOAQUÍN MIGUEL GUTIÉRREZ (QUESPALA),3,402,182,220,16
CHIAPAS,7,FRONTERA COMALAPA,034,LA LIMA,3,402,198,204,19
CHIAPAS,7,FRONTERA COMALAPA,034,LA MESILLA,3,37,17,20,4
CHIAPAS,7,FRONTERA COMALAPA,034,LA NORIA,2,41,23,18,2
CHIAPAS,7,FRONTERA COMALAPA,034,LA REFORMA,3,131,68,63,9
CHIAPAS,7,FRONTERA COMALAPA,034,LA SABINADA,3,212,121,91,11
CHIAPAS,7,FRONTERA COMALAPA,034,LAGUNETAS,2,58,31,27,3
CHIAPAS,7,FRONTERA COMALAPA,034,LAS CHAMPAS,3,161,85,76,6
CHIAPAS,7,FRONTERA COMALAPA,034,LAS MARAVILLAS,1,18,9,9,2
CHIAPAS,7,FRONTERA COMALAPA,034,LINDAVISTA,1,24,12,12,1
CHIAPAS,7,FRONTERA COMALAPA,034,LOMA BONITA,2,167,96,71,8
CHIAPAS,7,FRONTERA COMALAPA,034,LOS LAURELES,2,64,29,35,4
CHIAPAS,7,FRONTERA COMALAPA,034,MARCHA CAMPESINA,1,9,6,3,1
CHIAPAS,7,FRONTERA COMALAPA,034,MONTE REDONDO,3,281,125,156,14
CHIAPAS,7,FRONTERA COMALAPA,034,NICOLÁS BRAVO,4,129,64,65,9
CHIAPAS,7,FRONTERA COMALAPA,034,NUEVA DELICIAS,2,47,24,23,3
CHIAPAS,7,FRONTERA COMALAPA,034,NUEVA INDEPENDENCIA (LAJERÍO),4,507,246,261,27
CHIAPAS,7,FRONTERA COMALAPA,034,NUEVA LIBERTAD,4,388,175,213,21
CHIAPAS,7,FRONTERA COMALAPA,034,NUEVA LINDA,3,105,52,53,6
CHIAPAS,7,FRONTERA COMALAPA,034,NUEVA REVOLUCIÓN,4,204,98,106,11
CHIAPAS,7,FRONTERA COMALAPA,034,NUEVO AMANECER,1,8,4,4,1
CHIAPAS,7,FRONTERA COMALAPA,034,NUEVO COMALAPA,2,50,28,22,3
CHIAPAS,7,FRONTERA COMALAPA,034,NUEVO LLANO GRANDE,3,98,53,45,6
CHIAPAS,7,FRONTERA COMALAPA,034,NUEVO MAZAPA,4,271,126,145,14
CHIAPAS,7,FRONTERA COMALAPA,034,NUEVO MEXICALAPA,2,60,26,34,3
CHIAPAS,7,FRONTERA COMALAPA,034,NUEVO MÉXICO,2,130,61,69,6
CHIAPAS,7,FRONTERA COMALAPA,034,NUEVO SAN FRANCISCO PLAYA GRANDE,1,40,16,24,2
CHIAPAS,7,FRONTERA COMALAPA,034,NUEVO SAN GERÓNIMO,2,34,12,22,2
CHIAPAS,7,FRONTERA COMALAPA,034,NUEVO SAN GREGORIO,1,197,102,95,9
CHIAPAS,7,FRONTERA COMALAPA,034,NUEVO SAN JUAN CARRIZAL,2,52,32,20,2
CHIAPAS,7,FRONTERA COMALAPA,034,NUEVO SANTO DOMINGO,2,15,9,6,2
CHIAPAS,7,FRONTERA COMALAPA,034,NUEVO SILTEPEC,2,48,22,26,3
CHIAPAS,7,FRONTERA COMALAPA,034,NUEVO VILLA LEY,2,12,8,4,2
CHIAPAS,7,FRONTERA COMALAPA,034,OJO DE AGUA LA CRUZ,1,8,4,4,1
CHIAPAS,7,FRONTERA COMALAPA,034,PARAÍSO,2,40,18,22,2
CHIAPAS,7,FRONTERA COMALAPA,034,PASO HONDO,6,1352,656,696,60
CHIAPAS,7,FRONTERA COMALAPA,034,PEÑA BLANCA,2,123,54,69,6
CHIAPAS,7,FRONTERA COMALAPA,034,PONCIO PILATOS,1,8,3,5,1
CHIAPAS,7,FRONTERA COMALAPA,034,RINCÓN EL CABALLAR,2,128,60,68,4
CHIAPAS,7,FRONTERA COMALAPA,034,RINCONADA,2,66,28,38,4
CHIAPAS,7,FRONTERA COMALAPA,034,SABINALITO,3,603,296,307,27
CHIAPAS,7,FRONTERA COMALAPA,034,SAN CARALAMPIO,4,465,237,228,20
CHIAPAS,7,FRONTERA COMALAPA,034,SAN FRANCISCO PLAYA GRANDE (EL GRAVAL),1,80,42,38,3
CHIAPAS,7,FRONTERA COMALAPA,034,SAN GREGORIO CHAMIC,1,57,26,31,3
CHIAPAS,7,FRONTERA COMALAPA,034,SAN JOSÉ DE LAS PALMAS,2,49,21,28,3
CHIAPAS,7,FRONTERA COMALAPA,034,SAN JOSÉ MONTENEGRO,2,82,43,39,4
CHIAPAS,7,FRONTERA COMALAPA,034,SAN LUCAS,1,6,2,4,1
CHIAPAS,7,FRONTERA COMALAPA,034,SAN LUIS,1,28,13,15,2
CHIAPAS,7,FRONTERA COMALAPA,034,SANTA MARTHA,1,20,8,12,2
CHIAPAS,7,FRONTERA COMALAPA,034,SANTA RITA,3,273,149,124,12
CHIAPAS,7,FRONTERA COMALAPA,034,SANTA ROSA,3,229,122,107,12
CHIAPAS,7,FRONTERA COMALAPA,034,SANTA TERESA LLANO GRANDE,3,224,105,119,11
CHIAPAS,7,FRONTERA COMALAPA,034,SANTO DOMINGO,1,23,13,10,1
CHIAPAS,7,FRONTERA COMALAPA,034,SELEGUA,1,30,15,15,2
CHIAPAS,7,FRONTERA COMALAPA,034,SINALOA,3,328,143,185,12
CHIAPAS,7,FRONTERA COMALAPA,034,TAMAULIPAS,2,76,38,38,4
CHIAPAS,7,FRONTERA COMALAPA,034,TAMPICO,2,64,30,34,3
CHIAPAS,7,FRONTERA COMALAPA,034,TRES LAGUNAS,3,108,63,45,3
CHIAPAS,7,FRONTERA COMALAPA,034,TRES PINOS,2,26,10,16,2
CHIAPAS,7,FRONTERA COMALAPA,034,VEINTICUATRO DE FEBRERO,4,501,243,258,20
CHIAPAS,7,FRONTERA COMALAPA,034,VERAPAZ,3,438,211,227,21
CHIAPAS,7,FRONTERA COMALAPA,034,VILLA DE GUADALUPE,2,38,13,25,2
CHIAPAS,7,FRONTERA COMALAPA,034,VILLA NUEVA (LA CURVITA),2,25,9,16,3
CHIAPAS,7,FRONTERA COMALAPA,034,VIVALEY EL SABINO,2,28,15,13,2
CHIAPAS,7,FRONTERA HIDALGO,035,CANTÓN SANTA CRUZ,2,53,33,20,3
CHIAPAS,7,FRONTERA HIDALGO,035,EJIDO FRANCISCO I. MADERO,4,507,247,260,27
CHIAPAS,7,FRONTERA HIDALGO,035,EL CARMEN,2,84,37,47,4
CHIAPAS,7,FRONTERA HIDALGO,035,FRONTERA HIDALGO,8,1757,871,886,78
CHIAPAS,7,FRONTERA HIDALGO,035,GUSTAVO DÍAZ ORDAZ,3,249,135,114,11
CHIAPAS,7,FRONTERA HIDALGO,035,IGNACIO ZARAGOZA,4,865,418,447,33
CHIAPAS,7,FRONTERA HIDALGO,035,POBLADO FRANCISCO I. MADERO,3,390,186,204,13
CHIAPAS,7,FRONTERA HIDALGO,035,SAN JUAN CINTAHUAYATE,2,43,21,22,3
CHIAPAS,7,FRONTERA HIDALGO,035,SANTA LUCÍA I,2,54,23,31,3
CHIAPAS,7,FRONTERA HIDALGO,035,TEXCALTIC,2,316,164,152,12
CHIAPAS,7,LA GRANDEZA,036,AGUA ESCONDIDA,1,19,11,8,1
CHIAPAS,7,LA GRANDEZA,036,ALTAVISTA,2,25,9,16,2
CHIAPAS,7,LA GRANDEZA,036,BANDERAS,2,50,25,25,3
CHIAPAS,7,LA GRANDEZA,036,BARTOLOMÉ DE LAS CASAS,2,53,22,31,4
CHIAPAS,7,LA GRANDEZA,036,DESVÍO SAN JOSÉ,1,7,2,5,1
CHIAPAS,7,LA GRANDEZA,036,EL CASBIL,2,43,24,19,3
CHIAPAS,7,LA GRANDEZA,036,EL CIPRÉS,1,7,5,2,1
CHIAPAS,7,LA GRANDEZA,036,EL ENCUENTRO,2,38,23,15,3
CHIAPAS,7,LA GRANDEZA,036,EL PINO,3,35,20,15,3
CHIAPAS,7,LA GRANDEZA,036,FRANCISCO I. MADERO,1,25,14,11,1
CHIAPAS,7,LA GRANDEZA,036,GUADALUPE VICTORIA,2,31,15,16,2
CHIAPAS,7,LA GRANDEZA,036,LA GRANDEZA,7,843,447,396,34
CHIAPAS,7,LA GRANDEZA,036,LA PINADA,3,84,40,44,6
CHIAPAS,7,LA GRANDEZA,036,LAS PALMAS,2,18,9,9,2
CHIAPAS,7,LA GRANDEZA,036,LLANO GRANDE,5,408,201,207,20
CHIAPAS,7,LA GRANDEZA,036,LOMA BONITA,2,9,7,2,1
CHIAPAS,7,LA GRANDEZA,036,MAÍZ BLANCO,2,36,19,17,3
CHIAPAS,7,LA GRANDEZA,036,MIRAMAR,4,75,36,39,4
CHIAPAS,7,LA GRANDEZA,036,NUEVA PROVIDENCIA,2,40,15,25,2
CHIAPAS,7,LA GRANDEZA,036,PINO SUÁREZ,2,55,29,26,4
CHIAPAS,7,LA GRANDEZA,036,REFORMA CASBIL,2,50,22,28,3
CHIAPAS,7,LA GRANDEZA,036,SAN MIGUEL,1,17,7,10,1
CHIAPAS,7,LA GRANDEZA,036,TOQUÍN,2,74,35,39,4
CHIAPAS,7,LA GRANDEZA,036,VICENTE GUERRERO,2,59,28,31,4
CHIAPAS,7,HUEHUETÁN,037,6 DE ABRIL,1,7,3,4,1
CHIAPAS,7,HUEHUETÁN,037,AGUA ESCONDIDA,1,13,4,9,1
CHIAPAS,7,HUEHUETÁN,037,ALIANZA PARA LA PRODUCCIÓN,2,79,37,42,4
CHIAPAS,7,HUEHUETÁN,037,BELISARIO DOMÍNGUEZ (EL BÚCARO),3,99,41,58,7
CHIAPAS,7,HUEHUETÁN,037,CANTÓN EL BÚCARO,1,29,12,17,2
CHIAPAS,7,HUEHUETÁN,037,CANTÓN EL OTOÑO,1,21,13,8,1
CHIAPAS,7,HUEHUETÁN,037,CANTÓN EL PROGRESO,1,10,7,3,1
CHIAPAS,7,HUEHUETÁN,037,CANTÓN EL TAMARINDAL,2,32,16,16,2
CHIAPAS,7,HUEHUETÁN,037,CANTÓN EL TÍVOLI,2,52,24,28,3
CHIAPAS,7,HUEHUETÁN,037,CANTÓN EL TRIUNFO,2,138,69,69,5
CHIAPAS,7,HUEHUETÁN,037,CANTÓN ESPERANCITA,3,24,11,13,3
CHIAPAS,7,HUEHUETÁN,037,CANTÓN FLORIDA,2,25,13,12,2
CHIAPAS,7,HUEHUETÁN,037,CANTÓN LA LIMA,2,71,38,33,4
CHIAPAS,7,HUEHUETÁN,037,CANTÓN LA SIRIA,2,60,34,26,3
CHIAPAS,7,HUEHUETÁN,037,CANTÓN LA UNIDAD,2,60,30,30,3
CHIAPAS,7,HUEHUETÁN,037,CANTÓN NEXAPA,2,54,22,32,3
CHIAPAS,7,HUEHUETÁN,037,CANTÓN NUEVO HORIZONTE,2,16,8,8,2
CHIAPAS,7,HUEHUETÁN,037,CANTÓN SAN LUIS,2,48,24,24,4
CHIAPAS,7,HUEHUETÁN,037,CANTÓN VILLAHERMOSA,1,13,8,5,1
CHIAPAS,7,HUEHUETÁN,037,CARRETERA NUEVA,2,45,22,23,3
CHIAPAS,7,HUEHUETÁN,037,CHAMULAPA,3,221,111,110,21
CHIAPAS,7,HUEHUETÁN,037,CHAMULAPITA,4,560,285,275,33
CHIAPAS,7,HUEHUETÁN,037,COAPANTES EL JOBAL,2,25,13,12,3
CHIAPAS,7,HUEHUETÁN,037,CUNTALAPA,2,66,26,40,3
CHIAPAS,7,HUEHUETÁN,037,CUYAMIAPA,3,281,138,143,11
CHIAPAS,7,HUEHUETÁN,037,EL CAIRO,2,50,30,20,3
CHIAPAS,7,HUEHUETÁN,037,EL CARMEN,2,23,10,13,2
CHIAPAS,7,HUEHUETÁN,037,FLOR DE UN DÍA,2,61,28,33,4
CHIAPAS,7,HUEHUETÁN,037,GIBRALTAR,2,26,13,13,2
CHIAPAS,7,HUEHUETÁN,037,GUACHIPILÍN,3,256,128,128,10
CHIAPAS,7,HUEHUETÁN,037,GUADALUPE,4,579,296,283,32
CHIAPAS,7,HUEHUETÁN,037,HUEHUETÁN,13,3798,1721,2077,231
CHIAPAS,7,HUEHUETÁN,037,HUEHUETÁN ESTACIÓN FFCC,8,1752,845,907,91
CHIAPAS,7,HUEHUETÁN,037,INDEPENDENCIA 96,1,17,10,7,2
CHIAPAS,7,HUEHUETÁN,037,LA LIBERTAD,2,24,13,11,3
CHIAPAS,7,HUEHUETÁN,037,LÁZARO CÁRDENAS EL ALTO,2,45,23,22,2
CHIAPAS,7,HUEHUETÁN,037,LUIS DONALDO COLOSIO MURRIETA,2,45,23,22,3
CHIAPAS,7,HUEHUETÁN,037,NUEVA VICTORIA,4,338,178,160,15
CHIAPAS,7,HUEHUETÁN,037,PLAN DE AYALA,4,625,331,294,26
CHIAPAS,7,HUEHUETÁN,037,PLAN DE IGUALA,2,134,71,63,6
CHIAPAS,7,HUEHUETÁN,037,SAN JOSÉ EL AMATE,2,157,76,81,8
CHIAPAS,7,HUEHUETÁN,037,SANTA CECILIA,2,89,36,53,4
CHIAPAS,7,HUEHUETÁN,037,SANTA ELENA,2,90,53,37,4
CHIAPAS,7,HUEHUETÁN,037,SINAÍ,3,22,7,15,3
CHIAPAS,7,HUEHUETÁN,037,SOMBRA (SAN RAMÓN) [AGROFORESTAL],1,5,2,3,1
CHIAPAS,7,HUEHUETÁN,037,TEPEHUITZ,4,310,145,165,13
CHIAPAS,7,HUEHUETÁN,037,TEXPUYO,2,51,22,29,3
CHIAPAS,7,HUEHUETÁN,037,TOLIMÁN,2,68,34,34,4
CHIAPAS,7,HUIXTÁN,038,ADOLFO LÓPEZ MATEOS,3,198,97,101,10
CHIAPAS,7,HUIXTÁN,038,ALAJ CHAM,1,8,2,6,1
CHIAPAS,7,HUIXTÁN,038,BAZOM,2,27,12,15,3
CHIAPAS,7,HUIXTÁN,038,BOCHILTE,2,132,65,67,4
CHIAPAS,7,HUIXTÁN,038,BUENAVISTA,3,104,52,52,4
CHIAPAS,7,HUIXTÁN,038,CARMEN YALCHUCH,3,606,322,284,21
CHIAPAS,7,HUIXTÁN,038,CHAQUILOC,2,39,15,24,3
CHIAPAS,7,HUIXTÁN,038,CHEMPIL,3,225,105,120,7
CHIAPAS,7,HUIXTÁN,038,CH'ENCHIBTIK,2,15,8,7,2
CHIAPAS,7,HUIXTÁN,038,CHIGTÓN,2,27,16,11,2
CHIAPAS,7,HUIXTÁN,038,CHISHTÉ 1,2,57,30,27,4
CHIAPAS,7,HUIXTÁN,038,DOLORES CHEMPIL,2,11,4,7,2
CHIAPAS,7,HUIXTÁN,038,DURAZNAL,1,6,0,6,1
CHIAPAS,7,HUIXTÁN,038,ESHPUILHO,2,165,69,96,7
CHIAPAS,7,HUIXTÁN,038,HUIXTÁN,8,962,473,489,55
CHIAPAS,7,HUIXTÁN,038,JOCOSIC,3,266,131,135,11
CHIAPAS,7,HUIXTÁN,038,LA ERA,3,111,46,65,7
CHIAPAS,7,HUIXTÁN,038,LA INDEPENDENCIA,3,274,122,152,11
CHIAPAS,7,HUIXTÁN,038,LA LIBERTAD,4,420,206,214,17
CHIAPAS,7,HUIXTÁN,038,LA VENTANA,2,15,9,6,2
CHIAPAS,7,HUIXTÁN,038,LAS LAJAS,1,5,1,4,1
CHIAPAS,7,HUIXTÁN,038,LAS LOMAS,1,8,2,6,1
CHIAPAS,7,HUIXTÁN,038,LÁZARO CÁRDENAS (CHILIL),3,300,153,147,14
CHIAPAS,7,HUIXTÁN,038,LOS POZOS,4,707,327,380,27
CHIAPAS,7,HUIXTÁN,038,LOS RANCHOS,2,58,36,22,2
CHIAPAS,7,HUIXTÁN,038,MONTE BONITO,2,144,80,64,5
CHIAPAS,7,HUIXTÁN,038,OQUEM,2,146,69,77,8
CHIAPAS,7,HUIXTÁN,038,PAYTAGIL,3,38,16,22,4
CHIAPAS,7,HUIXTÁN,038,POBLACIÓN,2,44,18,26,3
CHIAPAS,7,HUIXTÁN,038,REFORMA AGRARIA,2,30,13,17,2
CHIAPAS,7,HUIXTÁN,038,RÍO FLORIDO (YACHA),2,34,16,18,2
CHIAPAS,7,HUIXTÁN,038,SAN ANDRÉS PUERTO RICO,3,288,132,156,12
CHIAPAS,7,HUIXTÁN,038,SAN ANTONIO,1,5,3,2,1
CHIAPAS,7,HUIXTÁN,038,SAN ANTONIO BALASHILNA,2,134,68,66,5
CHIAPAS,7,HUIXTÁN,038,SAN FERNANDO,2,183,86,97,7
CHIAPAS,7,HUIXTÁN,038,SAN GREGORIO DE LAS CASAS,2,254,117,137,10
CHIAPAS,7,HUIXTÁN,038,SAN ISIDRO,2,27,10,17,2
CHIAPAS,7,HUIXTÁN,038,SAN JOSÉ,2,46,23,23,3
CHIAPAS,7,HUIXTÁN,038,SAN JOSÉ EL PORVENIR,3,88,40,48,4
CHIAPAS,7,HUIXTÁN,038,SAN JOSÉ LA NUEVA,2,136,59,77,6
CHIAPAS,7,HUIXTÁN,038,SAN JOSÉ LAS FLORES,1,23,13,10,1
CHIAPAS,7,HUIXTÁN,038,SAN MARTÍN POR NO VENCIDO,2,21,9,12,3
CHIAPAS,7,HUIXTÁN,038,SAN PEDRO LA TEJERÍA,2,186,81,105,7
CHIAPAS,7,HUIXTÁN,038,SAN PEDRO PEDERNAL,4,512,246,266,19
CHIAPAS,7,HUIXTÁN,038,SANTA ROSA,2,41,22,19,4
CHIAPAS,7,HUIXTÁN,038,SNA OQUIL,2,61,25,36,3
CHIAPAS,7,HUIXTÁN,038,TZAJALHÓ,2,45,22,23,3
CHIAPAS,7,HUIXTÁN,038,TZELEPAT,1,68,31,37,3
CHIAPAS,7,HUIXTÁN,038,VEINTE DE NOVIEMBRE,4,338,183,155,15
CHIAPAS,7,HUIXTÁN,038,YALCUC,2,62,32,30,4
CHIAPAS,7,HUIXTÁN,038,ZITIM,1,14,5,9,1
CHIAPAS,7,HUITIUPÁN,039,ACAPULQUITO,1,19,8,11,1
CHIAPAS,7,HUITIUPÁN,039,AGUSTÍN RUBIO (RÍO TORO),2,187,103,84,6
CHIAPAS,7,HUITIUPÁN,039,ÁLVARO OBREGÓN,2,59,24,35,2
CHIAPAS,7,HUITIUPÁN,039,BENITO JUÁREZ,3,80,45,35,3
CHIAPAS,7,HUITIUPÁN,039,BUEN PASO (SHOCTIC),3,92,46,46,5
CHIAPAS,7,HUITIUPÁN,039,BUENOS AIRES,2,33,17,16,3
CHIAPAS,7,HUITIUPÁN,039,CACATEAL PITAL,2,119,49,70,4
CHIAPAS,7,HUITIUPÁN,039,CAMPO ALEGRE,1,6,3,3,1
CHIAPAS,7,HUITIUPÁN,039,CARMITO DOS,1,9,4,5,1
CHIAPAS,7,HUITIUPÁN,039,CERRO LA PAVA,1,33,14,19,2
CHIAPAS,7,HUITIUPÁN,039,CHANIVAL,2,136,72,64,5
CHIAPAS,7,HUITIUPÁN,039,CINCO DE MAYO,3,74,33,41,5
CHIAPAS,7,HUITIUPÁN,039,DIECIOCHO DE ABRIL,3,196,88,108,9
CHIAPAS,7,HUITIUPÁN,039,EL AZUFRE,4,233,117,116,11
CHIAPAS,7,HUITIUPÁN,039,EL DESENGAÑO,2,58,29,29,4
CHIAPAS,7,HUITIUPÁN,039,EL OCOTAL,4,338,166,172,15
CHIAPAS,7,HUITIUPÁN,039,EL REMOLINO,2,43,25,18,3
CHIAPAS,7,HUITIUPÁN,039,EMILIANO ZAPATA,4,306,140,166,15
CHIAPAS,7,HUITIUPÁN,039,ENRIQUE RODRÍGUEZ CANO,2,55,30,25,4
CHIAPAS,7,HUITIUPÁN,039,FRANCISCO VILLA,2,44,20,24,3
CHIAPAS,7,HUITIUPÁN,039,GUAYABAL SINAÍ,2,51,27,24,3
CHIAPAS,7,HUITIUPÁN,039,HUANAL,3,350,173,177,12
CHIAPAS,7,HUITIUPÁN,039,HUITIUPÁN,11,1364,668,696,58
CHIAPAS,7,HUITIUPÁN,039,JOSÉ MARÍA MORELOS Y PAVÓN,4,395,196,199,16
CHIAPAS,7,HUITIUPÁN,039,LA CASCADA,3,75,40,35,5
CHIAPAS,7,HUITIUPÁN,039,LA COMPETENCIA,3,406,194,212,18
CHIAPAS,7,HUITIUPÁN,039,LA CORONA,2,41,25,16,2
CHIAPAS,7,HUITIUPÁN,039,LA FLORIDA,3,33,18,15,3
CHIAPAS,7,HUITIUPÁN,039,LA LABRANZA (EL ROSARIO),2,15,11,4,2
CHIAPAS,7,HUITIUPÁN,039,LA MARIPOSA,3,58,31,27,5
CHIAPAS,7,HUITIUPÁN,039,LA VENTANA (SAN JULIAN),2,159,84,75,6
CHIAPAS,7,HUITIUPÁN,039,LÁZARO CÁRDENAS,4,239,91,148,10
CHIAPAS,7,HUITIUPÁN,039,LINDAVISTA ALMANDRO,3,69,34,35,4
CHIAPAS,7,HUITIUPÁN,039,LINDAVISTA LAS LAMINAS,2,12,6,6,1
CHIAPAS,7,HUITIUPÁN,039,NAQUEM,1,42,25,17,2
CHIAPAS,7,HUITIUPÁN,039,NARANJO PITAL,2,16,9,7,2
CHIAPAS,7,HUITIUPÁN,039,NUEVA GENERACIÓN EMILIANO ZAPATA,2,62,30,32,3
CHIAPAS,7,HUITIUPÁN,039,NUEVA REFORMA,2,37,17,20,2
CHIAPAS,7,HUITIUPÁN,039,NUEVO SAN PEDRO PABUCHIL,3,275,155,120,11
CHIAPAS,7,HUITIUPÁN,039,PABUCHIL COVADONGA,2,91,53,38,4
CHIAPAS,7,HUITIUPÁN,039,PITAL VILLA LUZ (ALMANDRO VIEJO),2,7,5,2,1
CHIAPAS,7,HUITIUPÁN,039,PLANADA VILLA LUZ,2,52,25,27,3
CHIAPAS,7,HUITIUPÁN,039,PLANADA ZAPOTAL,2,11,3,8,1
CHIAPAS,7,HUITIUPÁN,039,PLATANARCITO,1,8,4,4,1
CHIAPAS,7,HUITIUPÁN,039,QUINCE DE AGOSTO,2,62,29,33,3
CHIAPAS,7,HUITIUPÁN,039,RAMOS CUBILETE,4,321,152,169,13
CHIAPAS,7,HUITIUPÁN,039,SAN FRANCISCO DOS,2,25,15,10,2
CHIAPAS,7,HUITIUPÁN,039,SAN FRANCISCO LA FRONTERA,2,57,27,30,3
CHIAPAS,7,HUITIUPÁN,039,SAN JOSÉ DOLORES,3,24,13,11,3
CHIAPAS,7,HUITIUPÁN,039,SAN JOSÉ LA UNIÓN,3,116,62,54,6
CHIAPAS,7,HUITIUPÁN,039,SAN JUAN EL AGUAJE,2,55,24,31,3
CHIAPAS,7,HUITIUPÁN,039,SAN MARTÍN BUENAVISTA,2,45,20,25,2
CHIAPAS,7,HUITIUPÁN,039,SAN PEDRO PABUCHIL UNO (FRANCISCO I. MADERO),2,68,29,39,4
CHIAPAS,7,HUITIUPÁN,039,SANTA CATARINA DE LAS PALMAS,3,126,69,57,5
CHIAPAS,7,HUITIUPÁN,039,SANTA CLARA,2,69,37,32,3
CHIAPAS,7,HUITIUPÁN,039,SANTA CLARA ARROYO SECO,2,13,5,8,1
CHIAPAS,7,HUITIUPÁN,039,SANTA MARÍA DE LOS ÁNGELES,2,70,32,38,3
CHIAPAS,7,HUITIUPÁN,039,SANTUARIO DEL POZO ESQUIPULAS,2,81,38,43,4
CHIAPAS,7,HUITIUPÁN,039,SEIS DE NOVIEMBRE,2,35,13,22,2
CHIAPAS,7,HUITIUPÁN,039,SINAÍ DÍAZ ORDAZ,1,11,3,8,1
CHIAPAS,7,HUITIUPÁN,039,SOMBRA CARRIZAL,4,495,230,265,17
CHIAPAS,7,HUITIUPÁN,039,SOMBRA LAGUNITA,3,98,59,39,5
CHIAPAS,7,HUITIUPÁN,039,TRIUNFO DE LAS PALMAS,1,17,6,11,1
CHIAPAS,7,HUITIUPÁN,039,VICENTE GUERRERO,2,38,19,19,3
CHIAPAS,7,HUITIUPÁN,039,VILLA LUZ,3,191,84,107,9
CHIAPAS,7,HUITIUPÁN,039,ZACAJTIC,3,200,95,105,11
CHIAPAS,7,HUITIUPÁN,039,ZACATONAL DE JUÁREZ,4,668,324,344,27
CHIAPAS,7,HUIXTLA,040,ALTAMIRA (LA PROVIDENCIA),2,51,26,25,3
CHIAPAS,7,HUIXTLA,040,AQUILES SERDÁN,4,602,266,336,55
CHIAPAS,7,HUIXTLA,040,AZTLÁN,4,176,86,90,11
CHIAPAS,7,HUIXTLA,040,BELLAVISTA,1,6,1,5,1
CHIAPAS,7,HUIXTLA,040,BRASIL,3,86,43,43,5
CHIAPAS,7,HUIXTLA,040,BUENAVISTA,3,29,20,9,4
CHIAPAS,7,HUIXTLA,040,CANTÓN CAHULOTAL,2,39,15,24,3
CHIAPAS,7,HUIXTLA,040,CANTÓN CINCO DE MARZO,2,43,14,29,3
CHIAPAS,7,HUIXTLA,040,CANTÓN EL CEDRAL,2,74,43,31,4
CHIAPAS,7,HUIXTLA,040,CANTÓN EL TARRAL,3,80,38,42,5
CHIAPAS,7,HUIXTLA,040,CANTÓN LA ESPERANZA,2,43,18,25,2
CHIAPAS,7,HUIXTLA,040,CANTÓN LAS DELICIAS,4,785,399,386,35
CHIAPAS,7,HUIXTLA,040,CANTÓN LAS MORENAS,2,63,28,35,4
CHIAPAS,7,HUIXTLA,040,CANTÓN PANAMÁ,1,20,9,11,2
CHIAPAS,7,HUIXTLA,040,CANTÓN PLAYA GRANDE,3,305,135,170,14
CHIAPAS,7,HUIXTLA,040,CANTÓN RANCHO NUEVO,2,211,105,106,8
CHIAPAS,7,HUIXTLA,040,CANTÓN SAN FERNANDO,1,19,8,11,1
CHIAPAS,7,HUIXTLA,040,CANTÓN SAN JORGE,1,16,11,5,1
CHIAPAS,7,HUIXTLA,040,COLONIA OBRERA,1,36,18,18,3
CHIAPAS,7,HUIXTLA,040,EFRAÍN A. GUTIÉRREZ,3,284,141,143,12
CHIAPAS,7,HUIXTLA,040,EL ARENAL,2,207,95,112,9
CHIAPAS,7,HUIXTLA,040,EL CONSUELO,1,10,7,3,1
CHIAPAS,7,HUIXTLA,040,EL PROGRESO,2,153,72,81,8
CHIAPAS,7,HUIXTLA,040,ESTRELLA ROJA,2,72,41,31,5
CHIAPAS,7,HUIXTLA,040,FLOR DE MAYO,2,26,16,10,2
CHIAPAS,7,HUIXTLA,040,FRANCISCO I. MADERO,4,816,387,429,38
CHIAPAS,7,HUIXTLA,040,HUIXTLA,44,9268,4600,4668,503
CHIAPAS,7,HUIXTLA,040,JOSÉ MARÍA MORELOS Y PAVÓN,4,179,100,79,10
CHIAPAS,7,HUIXTLA,040,LA CEIBA,3,46,19,27,4
CHIAPAS,7,HUIXTLA,040,LA ESPERANCITA,1,14,6,8,1
CHIAPAS,7,HUIXTLA,040,LA LUCHA,1,11,4,7,1
CHIAPAS,7,HUIXTLA,040,LA PIEDRA,3,39,23,16,3
CHIAPAS,7,HUIXTLA,040,LA UNIÓN,3,268,118,150,9
CHIAPAS,7,HUIXTLA,040,LAS BRISAS DEL HUAYATE,2,41,22,19,2
CHIAPAS,7,HUIXTLA,040,LAS MERCEDES,1,31,11,20,2
CHIAPAS,7,HUIXTLA,040,LIBERTAD PIEDRA CANOA,3,76,42,34,5
CHIAPAS,7,HUIXTLA,040,LOMA BONITA,1,8,6,2,1
CHIAPAS,7,HUIXTLA,040,LOS ALPES,1,6,2,4,1
CHIAPAS,7,HUIXTLA,040,MEXIQUITO MORELOS,3,46,20,26,5
CHIAPAS,7,HUIXTLA,040,MONTECRISTO,3,101,50,51,6
CHIAPAS,7,HUIXTLA,040,MONTECRISTO PLAYA GRANDE,3,71,34,37,6
CHIAPAS,7,HUIXTLA,040,NUEVA AMÉRICA,3,100,51,49,7
CHIAPAS,7,HUIXTLA,040,NUEVA EUROPA,1,7,3,4,1
CHIAPAS,7,HUIXTLA,040,NUEVO TESORO,3,53,29,24,4
CHIAPAS,7,HUIXTLA,040,PRIMERO DE DICIEMBRE,2,25,13,12,2
CHIAPAS,7,HUIXTLA,040,QUINCE DE ENERO,3,102,59,43,7
CHIAPAS,7,HUIXTLA,040,REFORMA,1,17,11,6,2
CHIAPAS,7,HUIXTLA,040,SANTA RITA CORONADO,3,127,60,67,7
CHIAPAS,7,HUIXTLA,040,SEÑOR ESQUIPULAS,2,81,45,36,4
CHIAPAS,7,HUIXTLA,040,TZINACAL (BUENOS AIRES),2,101,58,43,6
CHIAPAS,7,HUIXTLA,040,UNIÓN CAMPESINA (EL ENCANTO),1,18,9,9,2
CHIAPAS,7,HUIXTLA,040,VILLAFLORES,1,10,6,4,1
CHIAPAS,7,LA INDEPENDENCIA,041,24 DE ABRIL,2,58,24,34,4
CHIAPAS,7,LA INDEPENDENCIA,041,BADENIA,2,62,31,31,3
CHIAPAS,7,LA INDEPENDENCIA,041,BRASIL,1,16,9,7,1
CHIAPAS,7,LA INDEPENDENCIA,041,BUENAVISTA,2,339,168,171,15
CHIAPAS,7,LA INDEPENDENCIA,041,CABENA,1,19,8,11,2
CHIAPAS,7,LA INDEPENDENCIA,041,CANDELARIA,2,125,64,61,5
CHIAPAS,7,LA INDEPENDENCIA,041,CHENTÓN,2,88,44,44,3
CHIAPAS,7,LA INDEPENDENCIA,041,CONCEPCIÓN,2,70,40,30,3
CHIAPAS,7,LA INDEPENDENCIA,041,EL CALVARIO,2,61,27,34,3
CHIAPAS,7,LA INDEPENDENCIA,041,EL CAMPAMENTO,2,71,36,35,3
CHIAPAS,7,LA INDEPENDENCIA,041,EL DIVISORIO,2,27,15,12,2
CHIAPAS,7,LA INDEPENDENCIA,041,EL MIRADOR,2,24,8,16,2
CHIAPAS,7,LA INDEPENDENCIA,041,EL NARANJO,3,104,59,45,6
CHIAPAS,7,LA INDEPENDENCIA,041,EL PORVENIR,4,49,22,27,4
CHIAPAS,7,LA INDEPENDENCIA,041,EL ROSARIO,3,166,88,78,8
CHIAPAS,7,LA INDEPENDENCIA,041,EL TRIUNFO,6,999,477,522,41
CHIAPAS,7,LA INDEPENDENCIA,041,EMILIANO ZAPATA,3,345,157,188,16
CHIAPAS,7,LA INDEPENDENCIA,041,FRANCISCO SARABIA,3,503,278,225,24
CHIAPAS,7,LA INDEPENDENCIA,041,GALEANA,3,260,138,122,11
CHIAPAS,7,LA INDEPENDENCIA,041,LA ALIANZA,3,23,13,10,3
CHIAPAS,7,LA INDEPENDENCIA,041,LA ESPERANZA,1,8,2,6,1
CHIAPAS,7,LA INDEPENDENCIA,041,LA ESPERANZA (EL HORIZONTE),2,67,31,36,4
CHIAPAS,7,LA INDEPENDENCIA,041,LA FINCA,2,46,26,20,2
CHIAPAS,7,LA INDEPENDENCIA,041,LA FLORIDA,2,54,29,25,3
CHIAPAS,7,LA INDEPENDENCIA,041,LA INDEPENDENCIA,8,1447,718,729,59
CHIAPAS,7,LA INDEPENDENCIA,041,LA NUEVA ESPERANZA,2,93,40,53,4
CHIAPAS,7,LA INDEPENDENCIA,041,LA PATRIA,3,217,107,110,11
CHIAPAS,7,LA INDEPENDENCIA,041,LA UNIÓN,2,94,35,59,4
CHIAPAS,7,LA INDEPENDENCIA,041,LA VICTORIA,1,5,1,4,1
CHIAPAS,7,LA INDEPENDENCIA,041,LOS ESPINOS,2,41,22,19,3
CHIAPAS,7,LA INDEPENDENCIA,041,LOS PINOS,1,16,10,6,1
CHIAPAS,7,LA INDEPENDENCIA,041,MORELIA,1,8,4,4,1
CHIAPAS,7,LA INDEPENDENCIA,041,NUEVA AURORA,2,75,41,34,5
CHIAPAS,7,LA INDEPENDENCIA,041,NUEVA CRUZ,1,7,4,3,1
CHIAPAS,7,LA INDEPENDENCIA,041,NUEVA LIBERTAD,2,69,34,35,3
CHIAPAS,7,LA INDEPENDENCIA,041,NUEVA VIRGINIA,3,90,47,43,4
CHIAPAS,7,LA INDEPENDENCIA,041,NUEVO MUNDO EL NARANJO,3,199,100,99,9
CHIAPAS,7,LA INDEPENDENCIA,041,NUEVO OJO DE AGUA,1,57,26,31,2
CHIAPAS,7,LA INDEPENDENCIA,041,NUEVO SANTO TOMÁS,1,24,18,6,2
CHIAPAS,7,LA INDEPENDENCIA,041,OJO DE AGUA,4,314,149,165,14
CHIAPAS,7,LA INDEPENDENCIA,041,OJO DE AGUA (ANEXO BADENIA),1,6,1,5,1
CHIAPAS,7,LA INDEPENDENCIA,041,PINAL DEL RÍO,2,143,75,68,7
CHIAPAS,7,LA INDEPENDENCIA,041,PLAYA AZUL,4,308,159,149,14
CHIAPAS,7,LA INDEPENDENCIA,041,QUISTAJITO,2,105,47,58,5
CHIAPAS,7,LA INDEPENDENCIA,041,RIBERA DE LA SELVA,2,41,25,16,2
CHIAPAS,7,LA INDEPENDENCIA,041,RÍO BLANCO,4,580,240,340,26
CHIAPAS,7,LA INDEPENDENCIA,041,ROSARIO LA MONTAÑA,2,38,17,21,2
CHIAPAS,7,LA INDEPENDENCIA,041,SAN ANTONIO BUENAVISTA,4,642,308,334,26
CHIAPAS,7,LA INDEPENDENCIA,041,SAN ANTONIO CHIQUINIVALTIC,2,84,41,43,5
CHIAPAS,7,LA INDEPENDENCIA,041,SAN ANTONIO GUAYAMUSEJ,2,26,11,15,2
CHIAPAS,7,LA INDEPENDENCIA,041,SAN ANTONIO PORVENIR,1,63,31,32,3
CHIAPAS,7,LA INDEPENDENCIA,041,SAN CARALAMPIO,1,20,11,9,1
CHIAPAS,7,LA INDEPENDENCIA,041,SAN CARALAMPIO (ANEXO FRANCISCO SARABIA),1,12,6,6,1
CHIAPAS,7,LA INDEPENDENCIA,041,SAN FRANCISCO,1,10,5,5,1
CHIAPAS,7,LA INDEPENDENCIA,041,SAN ISIDRO EL ZAPOTAL,3,236,112,124,10
CHIAPAS,7,LA INDEPENDENCIA,041,SAN JACINTO,1,15,8,7,1
CHIAPAS,7,LA INDEPENDENCIA,041,SAN JOSÉ BELÉN,3,63,34,29,5
CHIAPAS,7,LA INDEPENDENCIA,041,SAN JOSÉ DE LAS PALMAS,2,73,32,41,3
CHIAPAS,7,LA INDEPENDENCIA,041,SAN MARCOS,2,32,18,14,2
CHIAPAS,7,LA INDEPENDENCIA,041,SAN MIGUEL (ANEXO OJO DE AGUA),1,16,6,10,1
CHIAPAS,7,LA INDEPENDENCIA,041,SAN MIGUEL LOS ALTOS,1,9,7,2,1
CHIAPAS,7,LA INDEPENDENCIA,041,SAN PABLO YALMUTZ,1,19,11,8,1
CHIAPAS,7,LA INDEPENDENCIA,041,SANTA ANA EL PRIMOR,2,11,5,6,1
CHIAPAS,7,LA INDEPENDENCIA,041,SANTA JULIA LA VICTORIA,1,18,10,8,1
CHIAPAS,7,LA INDEPENDENCIA,041,SANTA MARÍA,3,50,22,28,3
CHIAPAS,7,LA INDEPENDENCIA,041,SANTA MARTHA,2,85,42,43,3
CHIAPAS,7,LA INDEPENDENCIA,041,SANTA RITA,1,12,7,5,1
CHIAPAS,7,LA INDEPENDENCIA,041,SANTA RITA EL VERGEL,4,235,111,124,14
CHIAPAS,7,LA INDEPENDENCIA,041,SANTA ROSA,3,46,29,17,3
CHIAPAS,7,LA INDEPENDENCIA,041,SANTO DOMINGO,2,13,6,7,2
CHIAPAS,7,LA INDEPENDENCIA,041,TIERRA BLANCA,3,101,51,50,7
CHIAPAS,7,LA INDEPENDENCIA,041,TIERRA Y LIBERTAD,3,161,77,84,8
CHIAPAS,7,LA INDEPENDENCIA,041,VENUSTIANO CARRANZA,6,1241,579,662,47
CHIAPAS,7,LA INDEPENDENCIA,041,YALMUTZ,2,52,28,24,3
CHIAPAS,7,IXHUATÁN,042,AGUA AZUL,2,19,10,9,2
CHIAPAS,7,IXHUATÁN,042,CHAPAYAL GRANDE,5,414,209,205,21
CHIAPAS,7,IXHUATÁN,042,CIUDAD RURAL SUSTENTABLE IXHUATÁN,2,120,63,57,5
CHIAPAS,7,IXHUATÁN,042,EL AGUACATE,2,17,11,6,2
CHIAPAS,7,IXHUATÁN,042,EL CACATÉ,2,26,18,8,3
CHIAPAS,7,IXHUATÁN,042,EL CARACOLAR,2,17,11,6,2
CHIAPAS,7,IXHUATÁN,042,EL CIMIENTO,1,26,11,15,1
CHIAPAS,7,IXHUATÁN,042,EL MAJAGUAL,3,72,36,36,5
CHIAPAS,7,IXHUATÁN,042,EL MIRADOR,3,39,23,16,4
CHIAPAS,7,IXHUATÁN,042,EMILIANO ZAPATA,3,74,42,32,4
CHIAPAS,7,IXHUATÁN,042,IGNACIO ZARAGOZA,5,352,173,179,16
CHIAPAS,7,IXHUATÁN,042,IXHUATÁN,11,1505,774,731,72
CHIAPAS,7,IXHUATÁN,042,LOMA DE CABALLO,2,36,22,14,3
CHIAPAS,7,IXHUATÁN,042,MONTE CHICO,2,13,4,9,2
CHIAPAS,7,IXHUATÁN,042,NUEVA ESPERANZA,1,37,17,20,2
CHIAPAS,7,IXHUATÁN,042,POJAYAL 1RA. SECCIÓN,4,124,59,65,9
CHIAPAS,7,IXHUATÁN,042,POJAYAL 2DA. SECCIÓN,1,40,15,25,3
CHIAPAS,7,IXHUATÁN,042,POJAYAL 3RA. SECCIÓN,2,31,14,17,3
CHIAPAS,7,IXHUATÁN,042,POJAYAL BUENAVISTA,2,35,20,15,3
CHIAPAS,7,IXHUATÁN,042,RIVERA EL CARMELO,2,13,5,8,2
CHIAPAS,7,IXHUATÁN,042,SAN MIGUEL,2,117,56,61,6
CHIAPAS,7,IXHUATÁN,042,SANTA ANITA,4,214,107,107,12
CHIAPAS,7,IXTACOMITÁN,043,CANDELARIA 1RA. SECCIÓN,2,20,11,9,2
CHIAPAS,7,IXTACOMITÁN,043,CANDELARIA 2DA. SECCIÓN,4,92,43,49,7
CHIAPAS,7,IXTACOMITÁN,043,EL ARENAL,2,91,47,44,4
CHIAPAS,7,IXTACOMITÁN,043,EL CALVARIO,2,12,9,3,2
CHIAPAS,7,IXTACOMITÁN,043,EL CARMEN,1,4,3,1,1
CHIAPAS,7,IXTACOMITÁN,043,EL ESCOBAL,3,139,72,67,7
CHIAPAS,7,IXTACOMITÁN,043,EMILIANO ZAPATA,3,186,93,93,9
CHIAPAS,7,IXTACOMITÁN,043,IXTACOMITÁN,13,1447,686,761,77
CHIAPAS,7,IXTACOMITÁN,043,JANA 1RA. SECCIÓN,2,24,12,12,2
CHIAPAS,7,IXTACOMITÁN,043,JANA 2DA. SECCIÓN,3,26,15,11,3
CHIAPAS,7,IXTACOMITÁN,043,JANA 3RA. SECCIÓN,2,14,5,9,2
CHIAPAS,7,IXTACOMITÁN,043,LA ESPERANZA,2,14,10,4,2
CHIAPAS,7,IXTACOMITÁN,043,LA NARANJA,2,26,14,12,3
CHIAPAS,7,IXTACOMITÁN,043,LA OTRA BANDA,2,36,17,19,3
CHIAPAS,7,IXTACOMITÁN,043,LA PROVIDENCIA,1,17,4,13,1
CHIAPAS,7,IXTACOMITÁN,043,LA REALIDAD,2,10,5,5,2
CHIAPAS,7,IXTACOMITÁN,043,LA SOLEDAD,2,143,68,75,7
CHIAPAS,7,IXTACOMITÁN,043,LOMA DE CABALLO 2DA. SECCIÓN,1,4,2,2,1
CHIAPAS,7,IXTACOMITÁN,043,MATAMOROS 1RA. SECCIÓN,3,180,85,95,9
CHIAPAS,7,IXTACOMITÁN,043,MATAMOROS 2DA. SECCIÓN,2,45,21,24,2
CHIAPAS,7,IXTACOMITÁN,043,NUEVO LINDAVISTA,3,68,31,37,6
CHIAPAS,7,IXTACOMITÁN,043,NUEVO LOMA DE CABALLO,1,16,7,9,1
CHIAPAS,7,IXTACOMITÁN,043,SAN ANTONIO DE LAS LOMAS,2,94,54,40,6
CHIAPAS,7,IXTACOMITÁN,043,SAN MIGUEL,1,8,5,3,1
CHIAPAS,7,IXTACOMITÁN,043,SAN MIGUEL ANEXO,1,4,2,2,1
CHIAPAS,7,IXTACOMITÁN,043,SAN SEBASTIÁN,1,7,2,5,1
CHIAPAS,7,IXTACOMITÁN,043,SANTA CATARINA 1RA. SECCIÓN,2,34,13,21,3
CHIAPAS,7,IXTACOMITÁN,043,SANTA CATARINA 2DA. SECCIÓN,2,21,9,12,3
CHIAPAS,7,IXTACOMITÁN,043,SANTA CRUZ,1,17,5,12,1
CHIAPAS,7,IXTACOMITÁN,043,VIEJO LINDAVISTA,3,114,61,53,7
CHIAPAS,7,IXTACOMITÁN,043,VIEJO LOMA DE CABALLO 3RA. SECCIÓN,6,90,47,43,8
CHIAPAS,7,IXTAPA,044,AZTLÁN (RANCHO NUEVO),4,479,217,262,18
CHIAPAS,7,IXTAPA,044,CACATÉ,4,554,267,287,25
CHIAPAS,7,IXTAPA,044,CARLOS A. VIDAL,3,224,117,107,11
CHIAPAS,7,IXTAPA,044,CHIGTÓN,2,208,102,106,9
CHIAPAS,7,IXTAPA,044,CINCO DE FEBRERO,3,145,59,86,8
CHIAPAS,7,IXTAPA,044,CONCEPCIÓN,3,316,157,159,16
CHIAPAS,7,IXTAPA,044,CONGREGACIÓN LAS PILAS,3,68,35,33,6
CHIAPAS,7,IXTAPA,044,CUAUHTÉMOC (SAN NICOLÁS),2,137,66,71,7
CHIAPAS,7,IXTAPA,044,EL CALVARIO,2,9,4,5,2
CHIAPAS,7,IXTAPA,044,EL LIMÓN,2,34,21,13,2
CHIAPAS,7,IXTAPA,044,EL MANGUITO BUENAVISTA,1,62,30,32,3
CHIAPAS,7,IXTAPA,044,EL NOPAL,4,853,403,450,30
CHIAPAS,7,IXTAPA,044,EL PARAÍSO,2,10,7,3,2
CHIAPAS,7,IXTAPA,044,EL ROBLÓN,2,51,22,29,3
CHIAPAS,7,IXTAPA,044,EL ZAPOTILLO,5,335,168,167,15
CHIAPAS,7,IXTAPA,044,FRANCISCO JAVIER MINA,3,183,80,103,9
CHIAPAS,7,IXTAPA,044,FRANCISCO ROMO SERRANO,2,27,15,12,2
CHIAPAS,7,IXTAPA,044,IXTAPA,12,1921,974,947,104
CHIAPAS,7,IXTAPA,044,LA TRAYA,2,86,43,43,3
CHIAPAS,7,IXTAPA,044,LAS CAÑITAS,2,119,61,58,5
CHIAPAS,7,IXTAPA,044,LINDAVISTA,2,38,22,16,2
CHIAPAS,7,IXTAPA,044,LLANO ALTO,2,89,42,47,4
CHIAPAS,7,IXTAPA,044,LLANO BAJO,2,127,70,57,6
CHIAPAS,7,IXTAPA,044,MAZANILHO,3,184,86,98,8
CHIAPAS,7,IXTAPA,044,MODELO (EL ZAPOTAL),3,311,144,167,12
CHIAPAS,7,IXTAPA,044,MULTAJO,3,244,113,131,11
CHIAPAS,7,IXTAPA,044,NUEVO POBLADO LA CIÉNEGA,3,70,24,46,5
CHIAPAS,7,IXTAPA,044,NUEVO SAN JUAN CHAMULA,2,65,24,41,2
CHIAPAS,7,IXTAPA,044,NUEVO SAN MIGUEL MITONTIC (PUNTA DE PIEDAD),4,489,245,244,15
CHIAPAS,7,IXTAPA,044,PLAN DE AYALA,2,104,60,44,5
CHIAPAS,7,IXTAPA,044,SAN GABRIEL,2,58,36,22,3
CHIAPAS,7,IXTAPA,044,SAN JOSÉ PUENTE DE TIERRA,2,38,18,20,2
CHIAPAS,7,IXTAPA,044,TELESTAQUÍN,2,107,59,48,5
CHIAPAS,7,IXTAPA,044,VICTÓRICO R. GRAJALES (IGLESIA VIEJA),3,352,174,178,12
CHIAPAS,7,IXTAPANGAJOYA,045,DOCTOR RAFAEL PASCACIO GAMBOA,3,46,17,29,5
CHIAPAS,7,IXTAPANGAJOYA,045,EL CAOBA 1RA. SECCIÓN,3,27,15,12,4
CHIAPAS,7,IXTAPANGAJOYA,045,EL CAOBA 2DA. SECCIÓN,1,7,5,2,1
CHIAPAS,7,IXTAPANGAJOYA,045,FRANCISCO I. MADERO 1RA. SECCIÓN,1,17,9,8,2
CHIAPAS,7,IXTAPANGAJOYA,045,FRANCISCO I. MADERO 2DA. SECCIÓN,4,30,13,17,4
CHIAPAS,7,IXTAPANGAJOYA,045,IXTAPANGAJOYA,5,391,188,203,19
CHIAPAS,7,IXTAPANGAJOYA,045,JANA 1RA. SECCIÓN,1,13,2,11,1
CHIAPAS,7,IXTAPANGAJOYA,045,JANA 2DA. SECCIÓN,2,34,20,14,2
CHIAPAS,7,IXTAPANGAJOYA,045,LA GLORIA,7,613,305,308,23
CHIAPAS,7,IXTAPANGAJOYA,045,LÁZARO CÁRDENAS,5,342,171,171,16
CHIAPAS,7,IXTAPANGAJOYA,045,LLANO MORELOS 3RA. SECCIÓN,1,4,3,1,1
CHIAPAS,7,IXTAPANGAJOYA,045,LLANOS MORELOS 1RA. SECCIÓN,1,9,4,5,1
CHIAPAS,7,IXTAPANGAJOYA,045,MIGUEL HIDALGO,2,62,33,29,3
CHIAPAS,7,IXTAPANGAJOYA,045,NUEVO POBLADO LLANOS MORELOS,4,84,42,42,4
CHIAPAS,7,JIQUIPILAS,046,ABSALÓN CASTELLANOS DOMÍNGUEZ,2,59,26,33,4
CHIAPAS,7,JIQUIPILAS,046,BAJA CALIFORNIA,4,242,104,138,14
CHIAPAS,7,JIQUIPILAS,046,BENITO JUÁREZ,4,448,236,212,16
CHIAPAS,7,JIQUIPILAS,046,CATORCE DE SEPTIEMBRE,3,30,13,17,3
CHIAPAS,7,JIQUIPILAS,046,CHIAPAS NUEVO,3,145,73,72,10
CHIAPAS,7,JIQUIPILAS,046,CRISTÓBAL COLÓN,3,127,66,61,8
CHIAPAS,7,JIQUIPILAS,046,CUAUHTÉMOC,3,285,155,130,12
CHIAPAS,7,JIQUIPILAS,046,EL TRIUNFO,3,159,85,74,9
CHIAPAS,7,JIQUIPILAS,046,FRANCISCO I. MADERO,4,73,45,28,4
CHIAPAS,7,JIQUIPILAS,046,FRANCISCO VILLA DOS,2,55,25,30,3
CHIAPAS,7,JIQUIPILAS,046,FRANCISCO VILLA UNO,2,27,9,18,2
CHIAPAS,7,JIQUIPILAS,046,GALICIA GALILEA,2,54,30,24,2
CHIAPAS,7,JIQUIPILAS,046,HIERBA SANTA,4,227,103,124,13
CHIAPAS,7,JIQUIPILAS,046,JERUSALÉN,2,153,65,88,4
CHIAPAS,7,JIQUIPILAS,046,JIQUIPILAS,19,3421,1709,1712,185
CHIAPAS,7,JIQUIPILAS,046,JOSÉ MARÍA PINO SUÁREZ,4,671,332,339,29
CHIAPAS,7,JIQUIPILAS,046,JULIÁN GRAJALES,4,408,219,189,18
CHIAPAS,7,JIQUIPILAS,046,LA FLORIDA (SAN RAMÓN),2,16,7,9,2
CHIAPAS,7,JIQUIPILAS,046,LA NUEVA ESPERANZA,1,22,16,6,1
CHIAPAS,7,JIQUIPILAS,046,LAS CARMELITAS MATZAM,1,31,16,15,1
CHIAPAS,7,JIQUIPILAS,046,LIBERACIÓN,3,98,45,53,6
CHIAPAS,7,JIQUIPILAS,046,LINDAVISTA,3,52,21,31,4
CHIAPAS,7,JIQUIPILAS,046,LLANO GRANDE,3,284,135,149,11
CHIAPAS,7,JIQUIPILAS,046,LUIS ESPINOSA,3,114,49,65,7
CHIAPAS,7,JIQUIPILAS,046,MACABIL DE LA LIBERTAD,2,39,17,22,3
CHIAPAS,7,JIQUIPILAS,046,MICHOACÁN,3,75,36,39,6
CHIAPAS,7,JIQUIPILAS,046,MIGUEL HIDALGO,3,198,95,103,11
CHIAPAS,7,JIQUIPILAS,046,NUEVA ESPERANZA (LA GACHUPINA),2,13,8,5,2
CHIAPAS,7,JIQUIPILAS,046,NUEVA FRANCIA,3,122,56,66,7
CHIAPAS,7,JIQUIPILAS,046,NUEVA INDEPENDENCIA,3,86,42,44,6
CHIAPAS,7,JIQUIPILAS,046,NUEVA PALESTINA,4,244,114,130,20
CHIAPAS,7,JIQUIPILAS,046,NUEVO SAN ANDRÉS (EL NARANJAL),3,58,33,25,4
CHIAPAS,7,JIQUIPILAS,046,PIEDRA PARADA,1,16,7,9,1
CHIAPAS,7,JIQUIPILAS,046,PLAN DE AYALA,3,105,48,57,6
CHIAPAS,7,JIQUIPILAS,046,QUINTANA ROO,4,332,165,167,15
CHIAPAS,7,JIQUIPILAS,046,SAN ANTONIO EL BRILLANTE,1,18,8,10,2
CHIAPAS,7,JIQUIPILAS,046,SAN DIONISIO,3,82,35,47,5
CHIAPAS,7,JIQUIPILAS,046,SAN FRANCISCO,2,18,7,11,2
CHIAPAS,7,JIQUIPILAS,046,SAN LORENZO,1,5,4,1,1
CHIAPAS,7,JIQUIPILAS,046,SANTA RITA,2,27,10,17,2
CHIAPAS,7,JIQUIPILAS,046,SANTO TOMÁS,4,114,45,69,8
CHIAPAS,7,JIQUIPILAS,046,SINALOA,4,170,83,87,12
CHIAPAS,7,JIQUIPILAS,046,SUBTENIENTE PEDRO SÁNCHEZ,3,141,68,73,6
CHIAPAS,7,JIQUIPILAS,046,TIERRA Y LIBERTAD,5,787,384,403,48
CHIAPAS,7,JIQUIPILAS,046,TILTEPEC,4,646,317,329,54
CHIAPAS,7,JIQUIPILAS,046,UNIÓN AGRARISTA,3,146,77,69,10
CHIAPAS,7,JIQUIPILAS,046,VENUSTIANO CARRANZA,3,80,34,46,4
CHIAPAS,7,JIQUIPILAS,046,VICENTE GUERRERO,3,342,177,165,16
CHIAPAS,7,JITOTOL,047,ALTAMIRANO,2,207,104,103,8
CHIAPAS,7,JITOTOL,047,AMOR DE DIOS,2,24,11,13,2
CHIAPAS,7,JITOTOL,047,BUENAVISTA,2,130,68,62,5
CHIAPAS,7,JITOTOL,047,BUENAVISTA UNO,2,12,7,5,2
CHIAPAS,7,JITOTOL,047,CACATEAL,1,5,4,1,1
CHIAPAS,7,JITOTOL,047,CAFETAL SOCORRO,2,40,20,20,2
CHIAPAS,7,JITOTOL,047,CÁLIDO,3,686,362,324,27
CHIAPAS,7,JITOTOL,047,CARMEN CHIQUITO,2,50,34,16,2
CHIAPAS,7,JITOTOL,047,CARMEN ZACATAL,7,1353,652,701,57
CHIAPAS,7,JITOTOL,047,CONGREGACIÓN EL PALMAR,3,32,17,15,3
CHIAPAS,7,JITOTOL,047,EL AMATE,2,202,103,99,7
CHIAPAS,7,JITOTOL,047,EL ÁMBAR,4,695,336,359,28
CHIAPAS,7,JITOTOL,047,EL CHEN,1,12,6,6,1
CHIAPAS,7,JITOTOL,047,EL LAUREL,6,170,97,73,10
CHIAPAS,7,JITOTOL,047,EL OCOTAL,2,55,29,26,4
CHIAPAS,7,JITOTOL,047,EL PARAÍSO,3,99,48,51,6
CHIAPAS,7,JITOTOL,047,EL ROSARIO,2,82,44,38,3
CHIAPAS,7,JITOTOL,047,ESQUIPULAS,1,17,6,11,1
CHIAPAS,7,JITOTOL,047,FLOR DE CAFÉ,2,57,25,32,5
CHIAPAS,7,JITOTOL,047,FRANCISCO I. MADERO,4,248,118,130,9
CHIAPAS,7,JITOTOL,047,JITOTOL,8,2253,1138,1115,126
CHIAPAS,7,JITOTOL,047,LA LAGUNA,2,67,35,32,3
CHIAPAS,7,JITOTOL,047,LAGUNA DE PÁJAROS AZULES,2,11,8,3,2
CHIAPAS,7,JITOTOL,047,LAS MARAVILLAS,4,991,515,476,32
CHIAPAS,7,JITOTOL,047,MADERITO,1,9,4,5,1
CHIAPAS,7,JITOTOL,047,MATASANO,3,108,53,55,6
CHIAPAS,7,JITOTOL,047,MONTERREY DOS,2,23,12,11,3
CHIAPAS,7,JITOTOL,047,MONTERREY UNO,2,13,4,9,2
CHIAPAS,7,JITOTOL,047,PARAJE SAN ANTONIO,2,29,12,17,3
CHIAPAS,7,JITOTOL,047,PLAN PAREDÓN,4,235,129,106,12
CHIAPAS,7,JITOTOL,047,RUBÉN JARAMILLO,2,157,85,72,4
CHIAPAS,7,JITOTOL,047,SACRAMENTO,3,45,27,18,4
CHIAPAS,7,JITOTOL,047,SALITRAL,2,37,23,14,3
CHIAPAS,7,JITOTOL,047,SAN ANTONIO BUENAVISTA,2,111,49,62,4
CHIAPAS,7,JITOTOL,047,SAN ANTONIO LA CUMBRE,2,31,11,20,2
CHIAPAS,7,JITOTOL,047,SAN JOSÉ,1,5,2,3,1
CHIAPAS,7,JITOTOL,047,SANTA ISABEL,2,51,28,23,4
CHIAPAS,7,JITOTOL,047,SANTA ROSA LA LIBERTAD,2,25,14,11,3
CHIAPAS,7,JITOTOL,047,TATA SANTOS,2,10,8,2,1
CHIAPAS,7,JITOTOL,047,TRÁNSITO DOS,3,81,31,50,7
CHIAPAS,7,JITOTOL,047,UNIÓN ZARAGOZA,2,181,92,89,9
CHIAPAS,7,JUÁREZ,048,ALDAMA 1RA. SECCIÓN,2,13,8,5,2
CHIAPAS,7,JUÁREZ,048,ALDAMA 2DA. SECCIÓN,3,13,8,5,3
CHIAPAS,7,JUÁREZ,048,ALLENDE 1RA. SECCIÓN,4,243,131,112,12
CHIAPAS,7,JUÁREZ,048,ALLENDE 2DA. SECCIÓN (SAN CÁNDIDO),2,68,30,38,4
CHIAPAS,7,JUÁREZ,048,CINCO DE MAYO,3,28,14,14,3
CHIAPAS,7,JUÁREZ,048,COROZAL 1RA. SECCIÓN,2,14,7,7,2
CHIAPAS,7,JUÁREZ,048,COROZAL 2DA. SECCIÓN,5,70,43,27,7
CHIAPAS,7,JUÁREZ,048,DOCTOR BELISARIO DOMÍNGUEZ,3,133,66,67,7
CHIAPAS,7,JUÁREZ,048,EL MANZANILLAL,1,5,3,2,1
CHIAPAS,7,JUÁREZ,048,EL PARAÍSO,3,277,138,139,12
CHIAPAS,7,JUÁREZ,048,EL TRIUNFO 1RA. SECCIÓN (CARDONA),4,295,145,150,16
CHIAPAS,7,JUÁREZ,048,EL TRIUNFO 2DA. SECCIÓN,5,276,120,156,15
CHIAPAS,7,JUÁREZ,048,EL TRIUNFO 3RA. SECCIÓN (EL SANTUARIO),4,22,11,11,4
CHIAPAS,7,JUÁREZ,048,EMILIANO ZAPATA,1,7,4,3,1
CHIAPAS,7,JUÁREZ,048,GALEANA 1RA. SECCIÓN,1,5,3,2,1
CHIAPAS,7,JUÁREZ,048,GALEANA 2DA. SECCIÓN (JOAQUÍN M. GUTIÉRREZ),3,42,22,20,3
CHIAPAS,7,JUÁREZ,048,HIDALGO (CAMOAPA),2,16,9,7,2
CHIAPAS,7,JUÁREZ,048,HUAPAQUE 1RA. SECCIÓN (HUAPACÓN),2,60,29,31,3
CHIAPAS,7,JUÁREZ,048,HUAPAQUE 2DA. SECCIÓN,2,52,31,21,4
CHIAPAS,7,JUÁREZ,048,JUÁREZ,16,2180,1099,1081,122
CHIAPAS,7,JUÁREZ,048,LA ARENA,2,33,17,16,2
CHIAPAS,7,JUÁREZ,048,LAS MIRANDAS,2,4,2,2,1
CHIAPAS,7,JUÁREZ,048,LIBERTAD 1RA. SECCIÓN,2,5,1,4,1
CHIAPAS,7,JUÁREZ,048,LIBERTAD 2DA. SECCIÓN,3,33,19,14,4
CHIAPAS,7,JUÁREZ,048,MARIO AGUILERA DORANTES,4,161,82,79,10
CHIAPAS,7,JUÁREZ,048,MORELOS 1RA. SECCIÓN,2,31,13,18,3
CHIAPAS,7,JUÁREZ,048,MORELOS 2DA. SECCIÓN,3,28,12,16,3
CHIAPAS,7,JUÁREZ,048,MUNDO NUEVO,3,50,23,27,4
CHIAPAS,7,JUÁREZ,048,MUNDO NUEVO ABAJO,6,166,80,86,12
CHIAPAS,7,JUÁREZ,048,MUNDO NUEVO ARRIBA,1,9,5,4,1
CHIAPAS,7,JUÁREZ,048,NICOLÁS BRAVO 1RA. SECCIÓN,2,20,9,11,2
CHIAPAS,7,JUÁREZ,048,NICOLÁS BRAVO 2DA. SECCIÓN (SAN VICENTE),2,24,13,11,2
CHIAPAS,7,JUÁREZ,048,NUEVO VOLCÁN CHICHONAL,4,549,271,278,24
CHIAPAS,7,JUÁREZ,048,PALESTINA,1,20,10,10,2
CHIAPAS,7,JUÁREZ,048,PUEBLO JUÁREZ,3,305,133,172,14
CHIAPAS,7,JUÁREZ,048,SANTA CRUZ TEPATE ABAJO,2,56,24,32,4
CHIAPAS,7,JUÁREZ,048,SANTA TERESA 1RA. SECCIÓN,5,261,140,121,14
CHIAPAS,7,JUÁREZ,048,SANTA TERESA 2DA. SECCIÓN,2,107,54,53,6
CHIAPAS,7,JUÁREZ,048,SANTA TERESA 3RA. SECCIÓN,1,7,4,3,1
CHIAPAS,7,JUÁREZ,048,TEPATE ABAJO,1,63,39,24,3
CHIAPAS,7,LARRÁINZAR,049,AJTIC CARRIZAL,2,37,18,19,2
CHIAPAS,7,LARRÁINZAR,049,ANEXO MUCTAHUITZ,3,74,34,40,5
CHIAPAS,7,LARRÁINZAR,049,ARCOCHÉN,2,17,8,9,2
CHIAPAS,7,LARRÁINZAR,049,BACHÉN,2,94,57,37,3
CHIAPAS,7,LARRÁINZAR,049,BAJOVELTIC,2,107,48,59,4
CHIAPAS,7,LARRÁINZAR,049,BASHANTIC,2,176,90,86,6
CHIAPAS,7,LARRÁINZAR,049,BATZITETIC,4,94,46,48,5
CHIAPAS,7,LARRÁINZAR,049,BAYALEMO DOS,3,478,219,259,14
CHIAPAS,7,LARRÁINZAR,049,BUENAVISTA,2,196,100,96,6
CHIAPAS,7,LARRÁINZAR,049,CAMTEALHUCUM II,2,43,15,28,3
CHIAPAS,7,LARRÁINZAR,049,CHALOTOJ,2,68,38,30,4
CHIAPAS,7,LARRÁINZAR,049,CHAUQUILHUCUM,1,6,4,2,1
CHIAPAS,7,LARRÁINZAR,049,CHICHELALHÓ,2,119,62,57,6
CHIAPAS,7,LARRÁINZAR,049,CHUCHILTÓN,3,291,158,133,10
CHIAPAS,7,LARRÁINZAR,049,CHUCHILTÓN ANEXO POTOBTIC DOS,3,461,223,238,17
CHIAPAS,7,LARRÁINZAR,049,ECH'TIK,2,20,8,12,2
CHIAPAS,7,LARRÁINZAR,049,EL CARMEN,3,104,42,62,7
CHIAPAS,7,LARRÁINZAR,049,GUACAMAYA,2,31,17,14,3
CHIAPAS,7,LARRÁINZAR,049,JOCOLHO,2,33,18,15,3
CHIAPAS,7,LARRÁINZAR,049,JOLNACHOJ,3,433,229,204,12
CHIAPAS,7,LARRÁINZAR,049,K'ANTE'EL,1,7,3,4,1
CHIAPAS,7,LARRÁINZAR,049,KAOMTEALHUCUM,2,81,45,36,4
CHIAPAS,7,LARRÁINZAR,049,LA LAGUNA I,2,159,88,71,6
CHIAPAS,7,LARRÁINZAR,049,LARRÁINZAR,6,2298,1104,1194,77
CHIAPAS,7,LARRÁINZAR,049,LATZVILTÓN II,2,228,111,117,7
CHIAPAS,7,LARRÁINZAR,049,LINDA VISTA,2,31,14,17,3
CHIAPAS,7,LARRÁINZAR,049,LOS ÁNGELES,1,5,3,2,1
CHIAPAS,7,LARRÁINZAR,049,LUQUILHO,3,150,70,80,10
CHIAPAS,7,LARRÁINZAR,049,MAJOVAL,5,391,196,195,16
CHIAPAS,7,LARRÁINZAR,049,MEHONO,3,322,158,164,11
CHIAPAS,7,LARRÁINZAR,049,MUCTAHUITZ,2,277,154,123,8
CHIAPAS,7,LARRÁINZAR,049,NA XOCH II,3,42,20,22,4
CHIAPAS,7,LARRÁINZAR,049,NACHITOM,2,59,31,28,4
CHIAPAS,7,LARRÁINZAR,049,NASHINICH,2,176,87,89,5
CHIAPAS,7,LARRÁINZAR,049,NATILYAXALTIK,2,117,48,69,4
CHIAPAS,7,LARRÁINZAR,049,NATOC,2,34,16,18,3
CHIAPAS,7,LARRÁINZAR,049,NAXOCH,2,89,47,42,4
CHIAPAS,7,LARRÁINZAR,049,NINTETIC,2,25,13,12,3
CHIAPAS,7,LARRÁINZAR,049,NOCTIC,2,63,31,32,3
CHIAPAS,7,LARRÁINZAR,049,OK'OXTON,2,39,21,18,3
CHIAPAS,7,LARRÁINZAR,049,OVENTIC GRANDE,2,48,21,27,3
CHIAPAS,7,LARRÁINZAR,049,PATENTIC,3,250,130,120,8
CHIAPAS,7,LARRÁINZAR,049,PATHUITZ,3,73,24,49,4
CHIAPAS,7,LARRÁINZAR,049,PECHTÓN II,3,93,41,52,8
CHIAPAS,7,LARRÁINZAR,049,PEÑA BLANCA,3,62,29,33,5
CHIAPAS,7,LARRÁINZAR,049,POCOLTÓN,2,107,49,58,3
CHIAPAS,7,LARRÁINZAR,049,PONTEHUITZ,2,118,58,60,6
CHIAPAS,7,LARRÁINZAR,049,SAKPUK'ANO',2,32,14,18,2
CHIAPAS,7,LARRÁINZAR,049,SAN CRISTOBALITO,5,613,282,331,19
CHIAPAS,7,LARRÁINZAR,049,SHANATE,2,84,39,45,2
CHIAPAS,7,LARRÁINZAR,049,STENLEJSOTZTETIC,4,572,266,306,16
CHIAPAS,7,LARRÁINZAR,049,SUYTIK,2,125,61,64,5
CHIAPAS,7,LARRÁINZAR,049,TAJLEBILHÓ,2,63,29,34,5
CHIAPAS,7,LARRÁINZAR,049,TALONHUITZ,2,185,99,86,8
CHIAPAS,7,LARRÁINZAR,049,TAVILHUCUM,2,57,27,30,3
CHIAPAS,7,LARRÁINZAR,049,TENTIC,2,27,20,7,2
CHIAPAS,7,LARRÁINZAR,049,TENTIC BAJO,2,82,42,40,3
CHIAPAS,7,LARRÁINZAR,049,TIABNAL ALTO,2,199,97,102,6
CHIAPAS,7,LARRÁINZAR,049,TIVO ALTO,2,145,75,70,6
CHIAPAS,7,LARRÁINZAR,049,TOJTIKILVITZ,2,61,26,35,5
CHIAPAS,7,LARRÁINZAR,049,TRES PUENTES,2,109,59,50,4
CHIAPAS,7,LARRÁINZAR,049,TRES PUENTES UNO,3,213,102,111,7
CHIAPAS,7,LARRÁINZAR,049,TZAJALHÓ,3,178,87,91,6
CHIAPAS,7,LARRÁINZAR,049,TZUTZBÉN,1,59,35,24,2
CHIAPAS,7,LARRÁINZAR,049,TZUTZBÉN BAJO,1,33,12,21,2
CHIAPAS,7,LARRÁINZAR,049,UNENALTIC,2,102,41,61,4
CHIAPAS,7,LARRÁINZAR,049,UNENALTIC I,2,76,35,41,3
CHIAPAS,7,LARRÁINZAR,049,YOLTÉ,2,153,70,83,6
CHIAPAS,7,LARRÁINZAR,049,YUTCH'ÉN,3,71,36,35,7
CHIAPAS,7,LA LIBERTAD,050,ALDAMA 1RA. SECCIÓN,2,9,6,3,2
CHIAPAS,7,LA LIBERTAD,050,ALDAMA CENTRO,1,15,8,7,1
CHIAPAS,7,LA LIBERTAD,050,BENITO JUÁREZ 1RA. SECCIÓN,4,58,28,30,4
CHIAPAS,7,LA LIBERTAD,050,BENITO JUÁREZ 2DA. SECCIÓN,1,5,2,3,1
CHIAPAS,7,LA LIBERTAD,050,BENITO JUÁREZ CENTRO,3,109,47,62,7
CHIAPAS,7,LA LIBERTAD,050,EL GUANO CENTRO,2,23,11,12,2
CHIAPAS,7,LA LIBERTAD,050,ESTRELLA DE BELÉN 2DA. SECCIÓN,3,23,8,15,3
CHIAPAS,7,LA LIBERTAD,050,ESTRELLA DE BELÉN 3RA. SECCIÓN,2,11,5,6,2
CHIAPAS,7,LA LIBERTAD,050,JOSÉ MARÍA MORELOS Y PAVÓN CENTRO,3,208,96,112,10
CHIAPAS,7,LA LIBERTAD,050,LA LIBERTAD,4,522,249,273,30
CHIAPAS,7,LA LIBERTAD,050,ZARAGOZA 1RA. SECCIÓN,3,31,14,17,3
CHIAPAS,7,LA LIBERTAD,050,ZARAGOZA 2DA. SECCIÓN,1,6,3,3,1
CHIAPAS,7,MAPASTEPEC,051,10 DE ABRIL,2,33,18,15,3
CHIAPAS,7,MAPASTEPEC,051,8 DE SEPTIEMBRE,2,24,8,16,2
CHIAPAS,7,MAPASTEPEC,051,ABRAHAM GONZÁLEZ,4,393,198,195,15
CHIAPAS,7,MAPASTEPEC,051,ABSALÓN CASTELLANOS DOMÍNGUEZ,1,16,12,4,2
CHIAPAS,7,MAPASTEPEC,051,ADOLFO LÓPEZ MATEOS,4,429,216,213,19
CHIAPAS,7,MAPASTEPEC,051,ADOLFO RUIZ CORTÍNEZ,3,146,60,86,8
CHIAPAS,7,MAPASTEPEC,051,ALPES (EL TESORO),1,19,8,11,2
CHIAPAS,7,MAPASTEPEC,051,ALTAMIRA DOS,3,96,54,42,7
CHIAPAS,7,MAPASTEPEC,051,ALTAMIRA UNO,2,48,22,26,3
CHIAPAS,7,MAPASTEPEC,051,ANTIGUO VALDIVIA,1,65,27,38,3
CHIAPAS,7,MAPASTEPEC,051,BARRANCÓN,1,6,1,5,1
CHIAPAS,7,MAPASTEPEC,051,BARRITA DE PAJÓN,3,119,59,60,7
CHIAPAS,7,MAPASTEPEC,051,BENITO JUÁREZ,4,219,126,93,9
CHIAPAS,7,MAPASTEPEC,051,BUENOS AIRES,1,7,4,3,1
CHIAPAS,7,MAPASTEPEC,051,DOCTOR SAMUEL LEÓN BRINDIS,3,168,84,84,9
CHIAPAS,7,MAPASTEPEC,051,DOROTEO ARANGO,2,27,13,14,3
CHIAPAS,7,MAPASTEPEC,051,EL AMATE,1,28,17,11,1
CHIAPAS,7,MAPASTEPEC,051,EL AYOTAL,3,27,16,11,3
CHIAPAS,7,MAPASTEPEC,051,EL CARMEN,2,44,14,30,3
CHIAPAS,7,MAPASTEPEC,051,EL ENCANTO,2,13,3,10,2
CHIAPAS,7,MAPASTEPEC,051,EL HUAMUCHE,2,32,16,16,3
CHIAPAS,7,MAPASTEPEC,051,EL PARAÍSO,1,22,10,12,2
CHIAPAS,7,MAPASTEPEC,051,EMILIANO ZAPATA,2,58,25,33,4
CHIAPAS,7,MAPASTEPEC,051,FLORES MAGÓN,2,108,52,56,7
CHIAPAS,7,MAPASTEPEC,051,FRANCISCO I. MADERO,2,44,25,19,4
CHIAPAS,7,MAPASTEPEC,051,FRANCISCO SARABIA (LA BLANCA),3,104,54,50,6
CHIAPAS,7,MAPASTEPEC,051,FRONTERITA,2,19,9,10,2
CHIAPAS,7,MAPASTEPEC,051,GENERACIÓN 2000 NUEVO MILENIO,2,312,156,156,16
CHIAPAS,7,MAPASTEPEC,051,GENERAL NICOLÁS BRAVO,3,121,55,66,6
CHIAPAS,7,MAPASTEPEC,051,GUADALUPE VICTORIA,3,133,70,63,7
CHIAPAS,7,MAPASTEPEC,051,IBARRA,3,155,75,80,7
CHIAPAS,7,MAPASTEPEC,051,JOSÉ MARÍA PINO SUÁREZ,2,54,26,28,4
CHIAPAS,7,MAPASTEPEC,051,JOSÉ PANTALEÓN DOMÍNGUEZ,4,246,105,141,9
CHIAPAS,7,MAPASTEPEC,051,JUAN ESCUTIA (LAS SALINAS),1,21,8,13,1
CHIAPAS,7,MAPASTEPEC,051,LA ALIANZA,3,318,155,163,14
CHIAPAS,7,MAPASTEPEC,051,LA CEIBA,1,45,18,27,2
CHIAPAS,7,MAPASTEPEC,051,LA FORTUNA,2,31,14,17,3
CHIAPAS,7,MAPASTEPEC,051,LA NUEVA ESPERANZA,2,50,20,30,4
CHIAPAS,7,MAPASTEPEC,051,LA PLAYA,2,23,12,11,2
CHIAPAS,7,MAPASTEPEC,051,LA VAINILLA,2,28,14,14,2
CHIAPAS,7,MAPASTEPEC,051,LA VICTORIA,2,75,44,31,3
CHIAPAS,7,MAPASTEPEC,051,LAGUNA DE LONDRES,1,6,2,4,1
CHIAPAS,7,MAPASTEPEC,051,LAS MARAVILLAS,2,15,8,7,2
CHIAPAS,7,MAPASTEPEC,051,LAS PALMAS,3,131,66,65,7
CHIAPAS,7,MAPASTEPEC,051,LOMA BONITA,1,14,5,9,1
CHIAPAS,7,MAPASTEPEC,051,LOS LIMONES,2,64,34,30,4
CHIAPAS,7,MAPASTEPEC,051,MAPASTEPEC,26,6015,2925,3090,278
CHIAPAS,7,MAPASTEPEC,051,NARCISO MENDOZA,3,38,16,22,4
CHIAPAS,7,MAPASTEPEC,051,NICOLÁS BRAVO DOS ANEXO EMILIANO ZAPATA,2,69,32,37,4
CHIAPAS,7,MAPASTEPEC,051,NICOLÁS BRAVO UNO ANEXO EMILIANO ZAPATA,5,238,117,121,13
CHIAPAS,7,MAPASTEPEC,051,NUEVA COSTA RICA,3,154,79,75,7
CHIAPAS,7,MAPASTEPEC,051,NUEVA LIBERTAD EL PROGRESO,3,69,34,35,5
CHIAPAS,7,MAPASTEPEC,051,NUEVO GUERRERO,3,37,15,22,3
CHIAPAS,7,MAPASTEPEC,051,NUEVO MILENIO VALDIVIA,2,258,122,136,11
CHIAPAS,7,MAPASTEPEC,051,PAMPA HONDA,2,29,17,12,2
CHIAPAS,7,MAPASTEPEC,051,PROGRESO DE CHIAPAS,3,131,69,62,7
CHIAPAS,7,MAPASTEPEC,051,ROBERTO BARRIOS,4,180,91,89,11
CHIAPAS,7,MAPASTEPEC,051,SAN JOSÉ,2,59,25,34,3
CHIAPAS,7,MAPASTEPEC,051,SAN RAFAEL,1,7,2,5,1
CHIAPAS,7,MAPASTEPEC,051,SANTA ISABEL,2,16,6,10,2
CHIAPAS,7,MAPASTEPEC,051,SANTA RITA DE LAS FLORES,3,97,46,51,7
CHIAPAS,7,MAPASTEPEC,051,SESECAPA,5,767,351,416,41
CHIAPAS,7,MAPASTEPEC,051,SIMÓN BOLÍVAR,2,33,19,14,2
CHIAPAS,7,MAPASTEPEC,051,SOLO DIOS,3,109,58,51,7
CHIAPAS,7,MAPASTEPEC,051,TRES DE MAYO,4,190,101,89,11
CHIAPAS,7,MAPASTEPEC,051,UNIÓN CHIAPANECA,3,55,31,24,4
CHIAPAS,7,MAPASTEPEC,051,UNIÓN SANTA ISABEL,2,29,16,13,3
CHIAPAS,7,MAPASTEPEC,051,VEINTIUNO DE MARZO,3,75,38,37,7
CHIAPAS,7,MAPASTEPEC,051,VILLANUEVA,1,18,7,11,1
CHIAPAS,7,LAS MARGARITAS,052,ABSALÓN CASTELLANOS DOMÍNGUEZ,2,53,21,32,3
CHIAPAS,7,LAS MARGARITAS,052,AGUA ESCONDIDA,2,14,5,9,1
CHIAPAS,7,LAS MARGARITAS,052,AGUA LIMPIA,1,13,8,5,1
CHIAPAS,7,LAS MARGARITAS,052,AGUA VELASCO,2,52,29,23,3
CHIAPAS,7,LAS MARGARITAS,052,AMPARO AGUA TINTA,3,449,207,242,21
CHIAPAS,7,LAS MARGARITAS,052,ANEXO CARMEN (CARMEN CHIQUITO),1,38,17,21,3
CHIAPAS,7,LAS MARGARITAS,052,ANEXO PALMA REAL,2,22,10,12,2
CHIAPAS,7,LAS MARGARITAS,052,AQUILES SERDÁN,2,151,86,65,6
CHIAPAS,7,LAS MARGARITAS,052,ARROYO EL NACIMIENTO,3,44,26,18,4
CHIAPAS,7,LAS MARGARITAS,052,ARTÍCULO 27,2,130,61,69,8
CHIAPAS,7,LAS MARGARITAS,052,BAJUCÚ,4,566,274,292,37
CHIAPAS,7,LAS MARGARITAS,052,BARRIO DE LLANO REDONDO,1,93,40,53,4
CHIAPAS,7,LAS MARGARITAS,052,BÉLGICA,2,32,21,11,3
CHIAPAS,7,LAS MARGARITAS,052,BELISARIO DOMÍNGUEZ (SAN PEDRO),2,92,52,40,5
CHIAPAS,7,LAS MARGARITAS,052,BELLO PAISAJE,1,11,4,7,1
CHIAPAS,7,LAS MARGARITAS,052,BENITO JUÁREZ,3,124,72,52,5
CHIAPAS,7,LAS MARGARITAS,052,BUENAVISTA,3,51,25,26,3
CHIAPAS,7,LAS MARGARITAS,052,BUENAVISTA BAWITZ,3,305,155,150,12
CHIAPAS,7,LAS MARGARITAS,052,BUENAVISTA PACHÁN,3,217,109,108,10
CHIAPAS,7,LAS MARGARITAS,052,BUENOS AIRES,1,5,5,0,1
CHIAPAS,7,LAS MARGARITAS,052,CANDELARIA,2,17,5,12,2
CHIAPAS,7,LAS MARGARITAS,052,CANDELARIA PACHÁN,1,36,15,21,1
CHIAPAS,7,LAS MARGARITAS,052,CARMELITO LA PIEDAD,3,68,31,37,5
CHIAPAS,7,LAS MARGARITAS,052,CARMEN CHIQUITO,2,36,18,18,3
CHIAPAS,7,LAS MARGARITAS,052,CARMEN LAS FLORES,2,328,158,170,7
CHIAPAS,7,LAS MARGARITAS,052,CARMEN VILLAFLORES,3,92,33,59,7
CHIAPAS,7,LAS MARGARITAS,052,CHACALA ANEXO SALTILLO,2,70,33,37,3
CHIAPAS,7,LAS MARGARITAS,052,CHENCHOMAJÁN,1,7,2,5,1
CHIAPAS,7,LAS MARGARITAS,052,CHIAPAS,4,540,244,296,25
CHIAPAS,7,LAS MARGARITAS,052,CIMARRÓN,2,22,11,11,2
CHIAPAS,7,LAS MARGARITAS,052,CINTALAPA,2,6,1,5,1
CHIAPAS,7,LAS MARGARITAS,052,CRUZ DEL ROSARIO,2,157,81,76,5
CHIAPAS,7,LAS MARGARITAS,052,CUATRO DE OCTUBRE,1,5,5,0,1
CHIAPAS,7,LAS MARGARITAS,052,DIEZ DE ABRIL,1,35,17,18,1
CHIAPAS,7,LAS MARGARITAS,052,DOCTOR BELISARIO DOMÍNGUEZ,4,159,76,83,9
CHIAPAS,7,LAS MARGARITAS,052,EL CARACOL,2,31,18,13,3
CHIAPAS,7,LAS MARGARITAS,052,EL CARACOLITO,3,28,15,13,4
CHIAPAS,7,LAS MARGARITAS,052,EL EDÉN,5,354,163,191,16
CHIAPAS,7,LAS MARGARITAS,052,EL ENCANTO,3,325,141,184,15
CHIAPAS,7,LAS MARGARITAS,052,EL HORIZONTE,1,14,5,9,1
CHIAPAS,7,LAS MARGARITAS,052,EL MILAGRO (SAN PEDRITO EL XOCH),2,35,17,18,3
CHIAPAS,7,LAS MARGARITAS,052,EL PARAÍSO,3,228,99,129,11
CHIAPAS,7,LAS MARGARITAS,052,EL PORVENIR,2,66,34,32,4
CHIAPAS,7,LAS MARGARITAS,052,EL PROGRESO,4,577,287,290,37
CHIAPAS,7,LAS MARGARITAS,052,EL RECUERDO,5,85,41,44,8
CHIAPAS,7,LAS MARGARITAS,052,EL RINCÓN,1,5,4,1,1
CHIAPAS,7,LAS MARGARITAS,052,EL SALVADOR,2,121,60,61,7
CHIAPAS,7,LAS MARGARITAS,052,EL SUSPIRO,1,8,6,2,6
CHIAPAS,7,LAS MARGARITAS,052,EL TRAPICHITO,2,98,44,54,5
CHIAPAS,7,LAS MARGARITAS,052,EL VERGEL,3,360,175,185,11
CHIAPAS,7,LAS MARGARITAS,052,EL VERGELITO,2,68,33,35,3
CHIAPAS,7,LAS MARGARITAS,052,EL ZAPOTE,2,48,28,20,4
CHIAPAS,7,LAS MARGARITAS,052,ESPÍRITU SANTO,3,198,91,107,8
CHIAPAS,7,LAS MARGARITAS,052,FELIPE CARRILLO PUERTO,2,87,38,49,4
CHIAPAS,7,LAS MARGARITAS,052,FLOR DE CAFÉ,1,6,2,4,1
CHIAPAS,7,LAS MARGARITAS,052,FLOR DEL RÍO,3,47,18,29,3
CHIAPAS,7,LAS MARGARITAS,052,FRANCISCO I. MADERO,4,642,302,340,27
CHIAPAS,7,LAS MARGARITAS,052,FRANCISCO VILLA,3,203,100,103,7
CHIAPAS,7,LAS MARGARITAS,052,GABINO VÁZQUEZ SAN SEBASTIÁN,2,237,119,118,10
CHIAPAS,7,LAS MARGARITAS,052,GABRIEL LEYVA VELÁZQUEZ,4,286,153,133,13
CHIAPAS,7,LAS MARGARITAS,052,GONZÁLEZ DE LEÓN,3,390,187,203,18
CHIAPAS,7,LAS MARGARITAS,052,GRACIANO SÁNCHEZ,1,25,13,12,1
CHIAPAS,7,LAS MARGARITAS,052,GUADALUPE (LAS FLORES),3,62,32,30,4
CHIAPAS,7,LAS MARGARITAS,052,GUADALUPE CHENCHOMAJÁN,1,10,4,6,1
CHIAPAS,7,LAS MARGARITAS,052,GUADALUPE CHIQUITO,2,12,5,7,1
CHIAPAS,7,LAS MARGARITAS,052,GUADALUPE LOS ALTOS,3,130,55,75,6
CHIAPAS,7,LAS MARGARITAS,052,GUADALUPE TEPEYAC,2,101,62,39,4
CHIAPAS,7,LAS MARGARITAS,052,HIDALGO,3,166,86,80,8
CHIAPAS,7,LAS MARGARITAS,052,IGNACIO ALLENDE,3,189,96,93,13
CHIAPAS,7,LAS MARGARITAS,052,IGNACIO ZARAGOZA,4,308,140,168,13
CHIAPAS,7,LAS MARGARITAS,052,JALISCO,2,626,298,328,22
CHIAPAS,7,LAS MARGARITAS,052,JERICÓ,1,11,4,7,1
CHIAPAS,7,LAS MARGARITAS,052,JERUSALÉN,5,370,194,176,25
CHIAPAS,7,LAS MARGARITAS,052,JUSTO SIERRA (SAN FRANCISCO),4,402,195,207,14
CHIAPAS,7,LAS MARGARITAS,052,LA AURORA,1,13,6,7,1
CHIAPAS,7,LAS MARGARITAS,052,LA CONQUISTA,3,120,56,64,6
CHIAPAS,7,LAS MARGARITAS,052,LA CONSTITUCIÓN,3,154,69,85,7
CHIAPAS,7,LAS MARGARITAS,052,LA ESMERALDA,2,56,25,31,3
CHIAPAS,7,LAS MARGARITAS,052,LA ESMERALDA DE LOS CIPRESES,1,14,8,6,1
CHIAPAS,7,LAS MARGARITAS,052,LA ESPERANZA,5,176,91,85,8
CHIAPAS,7,LAS MARGARITAS,052,LA ESTACIÓN,2,93,43,50,3
CHIAPAS,7,LAS MARGARITAS,052,LA FLORIDA,3,73,33,40,3
CHIAPAS,7,LAS MARGARITAS,052,LA FORTUNA,3,133,50,83,6
CHIAPAS,7,LAS MARGARITAS,052,LA FORTUNA GALLO GIRO,2,57,30,27,3
CHIAPAS,7,LAS MARGARITAS,052,LA GLORIA,2,42,21,21,4
CHIAPAS,7,LAS MARGARITAS,052,LA ILUSIÓN,2,238,119,119,8
CHIAPAS,7,LAS MARGARITAS,052,LA LIBERTAD,4,226,98,128,9
CHIAPAS,7,LAS MARGARITAS,052,LA NUEVA ESPERANZA,2,35,22,13,2
CHIAPAS,7,LAS MARGARITAS,052,LA PIEDAD,3,230,118,112,10
CHIAPAS,7,LAS MARGARITAS,052,LA POMARROSA,1,6,2,4,1
CHIAPAS,7,LAS MARGARITAS,052,LA REALIDAD TRINIDAD,3,211,106,105,9
CHIAPAS,7,LAS MARGARITAS,052,LA SOMBRA (ANEXO SAN CARLOS DEL RÍO),3,45,26,19,5
CHIAPAS,7,LAS MARGARITAS,052,LA TRINIDAD (ANEXO LA REVANCHA),1,27,13,14,3
CHIAPAS,7,LAS MARGARITAS,052,LAGUNA EL CARRIZAL,3,39,21,18,4
CHIAPAS,7,LAS MARGARITAS,052,LAS CRUCES,2,12,4,8,1
CHIAPAS,7,LAS MARGARITAS,052,LAS DELICIAS,1,9,5,4,1
CHIAPAS,7,LAS MARGARITAS,052,LAS FLORES,1,5,3,2,1
CHIAPAS,7,LAS MARGARITAS,052,LAS MARGARITAS,32,7260,3581,3679,320
CHIAPAS,7,LAS MARGARITAS,052,LAS PERLAS,2,72,29,43,3
CHIAPAS,7,LAS MARGARITAS,052,LINDAVISTA,5,84,41,43,8
CHIAPAS,7,LAS MARGARITAS,052,LOMANTÁN,3,287,127,160,12
CHIAPAS,7,LAS MARGARITAS,052,LUCHA CAMPESINA,2,97,52,45,4
CHIAPAS,7,LAS MARGARITAS,052,MARGARITA LAS BELLAS,1,9,3,6,1
CHIAPAS,7,LAS MARGARITAS,052,MATÍAS CASTELLANOS,3,90,48,42,3
CHIAPAS,7,LAS MARGARITAS,052,MEXIQUITO,3,244,105,139,10
CHIAPAS,7,LAS MARGARITAS,052,MIGUEL HIDALGO,3,63,24,39,4
CHIAPAS,7,LAS MARGARITAS,052,MONTE SINAÍ,2,23,10,13,2
CHIAPAS,7,LAS MARGARITAS,052,MORELIA,4,190,90,100,8
CHIAPAS,7,LAS MARGARITAS,052,NAVARRA,1,10,4,6,1
CHIAPAS,7,LAS MARGARITAS,052,NUEVA NICARAGUA,2,26,11,15,2
CHIAPAS,7,LAS MARGARITAS,052,NUEVA PROVIDENCIA,2,154,78,76,5
CHIAPAS,7,LAS MARGARITAS,052,NUEVA REVOLUCIÓN,3,62,34,28,4
CHIAPAS,7,LAS MARGARITAS,052,NUEVA TIERRA Y LIBERTAD,2,105,49,56,3
CHIAPAS,7,LAS MARGARITAS,052,NUEVO GUADALUPE,1,6,3,3,1
CHIAPAS,7,LAS MARGARITAS,052,NUEVO HUIXTÁN,4,409,206,203,15
CHIAPAS,7,LAS MARGARITAS,052,NUEVO MATZÁM,4,449,235,214,16
CHIAPAS,7,LAS MARGARITAS,052,NUEVO MÉXICO,3,193,93,100,8
CHIAPAS,7,LAS MARGARITAS,052,NUEVO MOMÓN,4,300,129,171,18
CHIAPAS,7,LAS MARGARITAS,052,NUEVO MONTECRISTO,3,80,41,39,5
CHIAPAS,7,LAS MARGARITAS,052,NUEVO MONTERREY ANEXO LA REVANCHA,2,34,14,20,4
CHIAPAS,7,LAS MARGARITAS,052,NUEVO PLAN DE AYALA,2,141,64,77,5
CHIAPAS,7,LAS MARGARITAS,052,NUEVO POZA RICA,3,277,134,143,11
CHIAPAS,7,LAS MARGARITAS,052,NUEVO ROSARIO RÍO BLANCO,4,112,41,71,9
CHIAPAS,7,LAS MARGARITAS,052,NUEVO SAN ANTONIO,3,43,20,23,3
CHIAPAS,7,LAS MARGARITAS,052,NUEVO SAN CRISTOBALITO,1,65,34,31,2
CHIAPAS,7,LAS MARGARITAS,052,NUEVO SAN JUAN CHAMULA (EL PACAYAL),4,759,383,376,29
CHIAPAS,7,LAS MARGARITAS,052,NUEVO SAN MARCOS,3,103,55,48,6
CHIAPAS,7,LAS MARGARITAS,052,NUEVO SANTIAGO,3,75,33,42,5
CHIAPAS,7,LAS MARGARITAS,052,NUEVO SANTO TOMÁS,3,144,71,73,5
CHIAPAS,7,LAS MARGARITAS,052,OJO DE AGUA,3,57,27,30,4
CHIAPAS,7,LAS MARGARITAS,052,OJO DE AGUA (ANEXO NUEVO SAN JUAN CHAMULA),2,104,58,46,3
CHIAPAS,7,LAS MARGARITAS,052,OJO DE AGUA SEGUNDO,3,124,58,66,8
CHIAPAS,7,LAS MARGARITAS,052,OLONJA,3,34,12,22,4
CHIAPAS,7,LAS MARGARITAS,052,PALMA REAL,2,90,35,55,3
CHIAPAS,7,LAS MARGARITAS,052,PIEDRA HUIXTLA,2,111,60,51,4
CHIAPAS,7,LAS MARGARITAS,052,PLAN DE AGUA PRIETA,2,49,23,26,3
CHIAPAS,7,LAS MARGARITAS,052,PLAN DE AYALA,4,1222,584,638,42
CHIAPAS,7,LAS MARGARITAS,052,PLAN DE GUADALUPE (ANEXO SANTA ELENA),3,29,15,14,3
CHIAPAS,7,LAS MARGARITAS,052,PLAN DE SANTO TOMÁS,2,185,96,89,6
CHIAPAS,7,LAS MARGARITAS,052,PLAN RÍO AZUL,2,108,50,58,3
CHIAPAS,7,LAS MARGARITAS,052,PLAYAS DEL CARMEN,2,56,24,32,3
CHIAPAS,7,LAS MARGARITAS,052,RAFAEL PASCACIO GAMBOA,1,69,37,32,2
CHIAPAS,7,LAS MARGARITAS,052,RAFAEL RAMÍREZ,5,438,209,229,19
CHIAPAS,7,LAS MARGARITAS,052,RANCHOS UNIDOS AGROPECUARIOS,1,9,4,5,1
CHIAPAS,7,LAS MARGARITAS,052,RÍO AMÉRICA,1,6,2,4,1
CHIAPAS,7,LAS MARGARITAS,052,RÍO COROZAL,2,167,89,78,5
CHIAPAS,7,LAS MARGARITAS,052,RIZO DE ORO,2,83,38,45,4
CHIAPAS,7,LAS MARGARITAS,052,ROSARIO BAWITZ,4,227,118,109,11
CHIAPAS,7,LAS MARGARITAS,052,ROSARIO BUENAVISTA,5,227,97,130,14
CHIAPAS,7,LAS MARGARITAS,052,ROSARIO RÍO BLANCO,2,40,19,21,2
CHIAPAS,7,LAS MARGARITAS,052,ROSARIO SANTIAGO,1,13,5,8,1
CHIAPAS,7,LAS MARGARITAS,052,RUBÉN JARAMILLO,1,18,8,10,1
CHIAPAS,7,LAS MARGARITAS,052,SALTILLO,8,496,261,235,28
CHIAPAS,7,LAS MARGARITAS,052,SAN AGUSTÍN,3,129,65,64,8
CHIAPAS,7,LAS MARGARITAS,052,SAN ANTONIO BAWITZ,3,286,140,146,12
CHIAPAS,7,LAS MARGARITAS,052,SAN ANTONIO LA ESPERANZA,2,46,22,24,4
CHIAPAS,7,LAS MARGARITAS,052,SAN ANTONIO LAS FLORES,1,18,9,9,2
CHIAPAS,7,LAS MARGARITAS,052,SAN ANTONIO LOS ALTOS,4,135,67,68,10
CHIAPAS,7,LAS MARGARITAS,052,SAN ANTONIO LOS MONTES,3,336,158,178,12
CHIAPAS,7,LAS MARGARITAS,052,SAN ANTONIO MONTERREY,2,65,29,36,3
CHIAPAS,7,LAS MARGARITAS,052,SAN ANTONIO TRES CERRITOS,1,8,3,5,1
CHIAPAS,7,LAS MARGARITAS,052,SAN ANTONIO VENECIA,2,87,41,46,6
CHIAPAS,7,LAS MARGARITAS,052,SAN ANTONIO VILLAFLORES,3,102,53,49,5
CHIAPAS,7,LAS MARGARITAS,052,SAN ARTURO LAS FLORES,3,168,81,87,5
CHIAPAS,7,LAS MARGARITAS,052,SAN BARTOLO (EL PUERTO),3,247,118,129,9
CHIAPAS,7,LAS MARGARITAS,052,SAN CARALAMPIO,4,271,133,138,10
CHIAPAS,7,LAS MARGARITAS,052,SAN CARLOS,1,7,2,5,1
CHIAPAS,7,LAS MARGARITAS,052,SAN CARLOS DEL RÍO,3,116,57,59,3
CHIAPAS,7,LAS MARGARITAS,052,SAN CRISTÓBAL BUENOS AIRES,2,55,24,31,2
CHIAPAS,7,LAS MARGARITAS,052,SAN FRANCISCO EL NARANJO,4,190,88,102,6
CHIAPAS,7,LAS MARGARITAS,052,SAN GREGORIO LA ESPERANZA,2,38,21,17,3
CHIAPAS,7,LAS MARGARITAS,052,SAN ISIDRO,3,213,110,103,10
CHIAPAS,7,LAS MARGARITAS,052,SAN JOSÉ,1,30,15,15,1
CHIAPAS,7,LAS MARGARITAS,052,SAN JOSÉ DE LAS FLORES,1,13,3,10,1
CHIAPAS,7,LAS MARGARITAS,052,SAN JOSÉ DEL RÍO,1,19,12,7,2
CHIAPAS,7,LAS MARGARITAS,052,SAN JOSÉ EL PUENTE,2,51,25,26,3
CHIAPAS,7,LAS MARGARITAS,052,SAN JOSÉ LA ESPERANZA,1,9,4,5,1
CHIAPAS,7,LAS MARGARITAS,052,SAN JOSÉ LA NUEVA ESPERANZA,2,84,38,46,3
CHIAPAS,7,LAS MARGARITAS,052,SAN JOSÉ LA REVANCHA,1,61,28,33,2
CHIAPAS,7,LAS MARGARITAS,052,SAN JOSÉ LAS PALMAS,4,228,111,117,12
CHIAPAS,7,LAS MARGARITAS,052,SAN JOSÉ ZAPOTAL,3,187,81,106,8
CHIAPAS,7,LAS MARGARITAS,052,SAN JUAN BAUTISTA,6,201,105,96,11
CHIAPAS,7,LAS MARGARITAS,052,SAN JUAN CHAMENTIC,2,14,6,8,2
CHIAPAS,7,LAS MARGARITAS,052,SAN JUAN DEL POZO,3,309,160,149,11
CHIAPAS,7,LAS MARGARITAS,052,SAN JUAN IRLANDA,1,7,3,4,1
CHIAPAS,7,LAS MARGARITAS,052,SAN JUAN PENANA,2,23,14,9,2
CHIAPAS,7,LAS MARGARITAS,052,SAN LORENZO,3,86,44,42,4
CHIAPAS,7,LAS MARGARITAS,052,SAN LORENZO UZUM,2,15,3,12,2
CHIAPAS,7,LAS MARGARITAS,052,SAN MATEO ZAPOTAL,4,395,192,203,14
CHIAPAS,7,LAS MARGARITAS,052,SAN MIGUEL DEL NORTE,2,46,22,24,2
CHIAPAS,7,LAS MARGARITAS,052,SAN PEDRO YUTNIOTIC,3,418,187,231,12
CHIAPAS,7,LAS MARGARITAS,052,SAN RAFAEL,3,66,32,34,4
CHIAPAS,7,LAS MARGARITAS,052,SAN SEBASTIÁN,4,126,67,59,8
CHIAPAS,7,LAS MARGARITAS,052,SAN VICENTE EL ENCANTO,4,385,177,208,13
CHIAPAS,7,LAS MARGARITAS,052,SANTA ANA LA LAGUNA,2,82,38,44,2
CHIAPAS,7,LAS MARGARITAS,052,SANTA ANA LAS FLORES,4,186,86,100,10
CHIAPAS,7,LAS MARGARITAS,052,SANTA CECILIA,1,6,4,2,1
CHIAPAS,7,LAS MARGARITAS,052,SANTA CRUZ EL MANANTIAL,2,36,17,19,2
CHIAPAS,7,LAS MARGARITAS,052,SANTA ELENA,5,240,112,128,15
CHIAPAS,7,LAS MARGARITAS,052,SANTA FE,3,28,14,14,3
CHIAPAS,7,LAS MARGARITAS,052,SANTA LUCÍA OJO DE AGUA,4,244,111,133,10
CHIAPAS,7,LAS MARGARITAS,052,SANTA MARGARITA AGUA AZUL,2,79,44,35,3
CHIAPAS,7,LAS MARGARITAS,052,SANTA MARGARITA LA REYNA,2,15,6,9,2
CHIAPAS,7,LAS MARGARITAS,052,SANTA MARTHA,1,7,2,5,1
CHIAPAS,7,LAS MARGARITAS,052,SANTA RITA,3,64,24,40,4
CHIAPAS,7,LAS MARGARITAS,052,SANTA RITA INVERNADERO,3,421,202,219,11
CHIAPAS,7,LAS MARGARITAS,052,SANTA RITA SONORA,3,366,191,175,12
CHIAPAS,7,LAS MARGARITAS,052,SANTA ROSA,4,199,103,96,9
CHIAPAS,7,LAS MARGARITAS,052,SANTA ROSA EL COPÁN,1,36,18,18,1
CHIAPAS,7,LAS MARGARITAS,052,SANTA TERESA,3,42,22,20,3
CHIAPAS,7,LAS MARGARITAS,052,SANTO DOMINGO CORONA,3,54,22,32,3
CHIAPAS,7,LAS MARGARITAS,052,SANTUARIO,3,91,43,48,4
CHIAPAS,7,LAS MARGARITAS,052,SANTUARIO ANEXO JUSTO SIERRA,1,13,8,5,1
CHIAPAS,7,LAS MARGARITAS,052,TABASCO,2,75,41,34,4
CHIAPAS,7,LAS MARGARITAS,052,TRINIDAD ANEXO AGUA VELASCO,2,66,30,36,2
CHIAPAS,7,LAS MARGARITAS,052,UNIÓN VICTORIA,1,12,8,4,1
CHIAPAS,7,LAS MARGARITAS,052,VALLE DORADO,2,5,4,1,2
CHIAPAS,7,LAS MARGARITAS,052,VEINTE DE NOVIEMBRE,4,894,435,459,44
CHIAPAS,7,LAS MARGARITAS,052,VERACRUZ,5,381,190,191,18
CHIAPAS,7,LAS MARGARITAS,052,VICENTE GUERRERO,4,265,131,134,15
CHIAPAS,7,LAS MARGARITAS,052,VICTORIA LA PAZ,2,53,21,32,2
CHIAPAS,7,LAS MARGARITAS,052,VICTÓRICO R. GRAJALES,3,104,57,47,4
CHIAPAS,7,LAS MARGARITAS,052,VIEJO MONTECRISTO,3,54,28,26,3
CHIAPAS,7,LAS MARGARITAS,052,VIEJO SAN MARCOS,2,18,9,9,2
CHIAPAS,7,LAS MARGARITAS,052,VILLA DE LAS ROSAS,3,36,18,18,3
CHIAPAS,7,LAS MARGARITAS,052,VILLA LAS ROSAS,2,65,29,36,2
CHIAPAS,7,LAS MARGARITAS,052,YALCOC,1,37,18,19,2
CHIAPAS,7,LAS MARGARITAS,052,YASHA,3,473,235,238,23
CHIAPAS,7,MAZAPA DE MADERO,053,BACANTÓN ALTAMIRANO,4,145,69,76,8
CHIAPAS,7,MAZAPA DE MADERO,053,BARRIO CALIFORNIA,2,43,20,23,3
CHIAPAS,7,MAZAPA DE MADERO,053,CALERA,1,5,3,2,1
CHIAPAS,7,MAZAPA DE MADERO,053,CAMBIL,1,17,10,7,1
CHIAPAS,7,MAZAPA DE MADERO,053,COLINA VICTORIA,2,17,7,10,2
CHIAPAS,7,MAZAPA DE MADERO,053,EL HORIZONTE,5,113,59,54,7
CHIAPAS,7,MAZAPA DE MADERO,053,GRANADOS TALCANAQUE,3,236,141,95,10
CHIAPAS,7,MAZAPA DE MADERO,053,HIDALGO TOCANAQUE,2,57,26,31,3
CHIAPAS,7,MAZAPA DE MADERO,053,JORDÁN II,2,24,15,9,2
CHIAPAS,7,MAZAPA DE MADERO,053,JUÁREZ CHEMALE,3,84,43,41,7
CHIAPAS,7,MAZAPA DE MADERO,053,LA VERDAD EL TRIUNFO,2,71,34,37,4
CHIAPAS,7,MAZAPA DE MADERO,053,LIBERTAD FRONTERA,3,142,75,67,7
CHIAPAS,7,MAZAPA DE MADERO,053,LOMA CHICA,2,18,10,8,2
CHIAPAS,7,MAZAPA DE MADERO,053,MAZAPA DE MADERO,5,474,232,242,27
CHIAPAS,7,MAZAPA DE MADERO,053,NIÑOS HÉROES,2,16,6,10,2
CHIAPAS,7,MAZAPA DE MADERO,053,NUEVA INDEPENDENCIA,3,58,21,37,4
CHIAPAS,7,MAZAPA DE MADERO,053,NUEVA LIBERTAD,2,30,14,16,2
CHIAPAS,7,MAZAPA DE MADERO,053,NUEVA UNIÓN,2,20,8,12,2
CHIAPAS,7,MAZAPA DE MADERO,053,NUEVO PARAÍSO,2,47,23,24,3
CHIAPAS,7,MAZAPA DE MADERO,053,NUEVO POBLADO,3,127,66,61,7
CHIAPAS,7,MAZAPA DE MADERO,053,NUEVO VERGEL,1,14,5,9,1
CHIAPAS,7,MAZAPA DE MADERO,053,OJO DE AGÜITA,1,21,5,16,2
CHIAPAS,7,MAZAPA DE MADERO,053,REFORMA,1,13,7,6,1
CHIAPAS,7,MAZAPA DE MADERO,053,REVOLUCIÓN MEXICANA,2,24,10,14,2
CHIAPAS,7,MAZAPA DE MADERO,053,SAN JOSÉ,1,16,7,9,1
CHIAPAS,7,MAZAPA DE MADERO,053,SANTA ROSA,2,8,3,5,1
CHIAPAS,7,MAZAPA DE MADERO,053,TIERRA BLANCA,3,55,22,33,3
CHIAPAS,7,MAZAPA DE MADERO,053,TIERRA VERDE,3,150,72,78,9
CHIAPAS,7,MAZAPA DE MADERO,053,TIERRA Y LIBERTAD,1,26,12,14,1
CHIAPAS,7,MAZAPA DE MADERO,053,TOQUÍN,1,17,11,6,2
CHIAPAS,7,MAZAPA DE MADERO,053,VALLE OBREGÓN,4,174,97,77,10
CHIAPAS,7,MAZAPA DE MADERO,053,VERACRUZ,3,93,53,40,6
CHIAPAS,7,MAZAPA DE MADERO,053,VIDA MEJOR (TIERRA BLANCA),1,24,11,13,1
CHIAPAS,7,MAZAPA DE MADERO,053,VILLA HIDALGO,2,62,30,32,3
CHIAPAS,7,MAZATÁN,054,19 DE ABRIL,2,27,17,10,2
CHIAPAS,7,MAZATÁN,054,ADOLFO LÓPEZ MATEOS,2,99,54,45,4
CHIAPAS,7,MAZATÁN,054,ADOLFO RUIZ CORTINES,3,167,82,85,10
CHIAPAS,7,MAZATÁN,054,AQUILES SERDÁN,4,421,194,227,22
CHIAPAS,7,MAZATÁN,054,BADENIA,2,107,48,59,5
CHIAPAS,7,MAZATÁN,054,BARRA DE SAN SIMÓN,4,55,26,29,4
CHIAPAS,7,MAZATÁN,054,BUENOS AIRES,5,1251,587,664,56
CHIAPAS,7,MAZATÁN,054,CUATRO CAMINOS,2,63,27,36,3
CHIAPAS,7,MAZATÁN,054,CUATRO CAMINOS DOS,2,30,15,15,3
CHIAPAS,7,MAZATÁN,054,EFRAÍN A. GUTIÉRREZ,3,147,71,76,8
CHIAPAS,7,MAZATÁN,054,EL AGUACATE,3,102,43,59,6
CHIAPAS,7,MAZATÁN,054,EL CORRALITO,2,109,49,60,5
CHIAPAS,7,MAZATÁN,054,EL ROBLE,1,5,2,3,1
CHIAPAS,7,MAZATÁN,054,EL TRIUNFO I (SANTA CRUZ),2,34,17,17,3
CHIAPAS,7,MAZATÁN,054,EMILIANO ZAPATA (LAS VARILLAS),2,73,41,32,4
CHIAPAS,7,MAZATÁN,054,EMILIANO ZAPATA I,2,29,18,11,2
CHIAPAS,7,MAZATÁN,054,GENARO VÁZQUEZ ROJAS,2,19,11,8,2
CHIAPAS,7,MAZATÁN,054,GUADALUPE,2,51,29,22,3
CHIAPAS,7,MAZATÁN,054,GUANACASTAL 1RA. SECCIÓN,2,29,20,9,2
CHIAPAS,7,MAZATÁN,054,LA GLORIA,1,13,9,4,1
CHIAPAS,7,MAZATÁN,054,LA VICTORIA,3,111,51,60,6
CHIAPAS,7,MAZATÁN,054,LÁZARO CÁRDENAS (LOS CUATES),2,23,10,13,2
CHIAPAS,7,MAZATÁN,054,MARTE R. GÓMEZ,3,324,162,162,15
CHIAPAS,7,MAZATÁN,054,MARTE R. GÓMEZ [PISTA AÉREA],2,30,12,18,3
CHIAPAS,7,MAZATÁN,054,MAZATÁN,12,3036,1559,1477,119
CHIAPAS,7,MAZATÁN,054,OJO DE AGUA,2,71,39,32,4
CHIAPAS,7,MAZATÁN,054,ORO VERDE,2,15,6,9,2
CHIAPAS,7,MAZATÁN,054,PAXTAL,2,75,35,40,4
CHIAPAS,7,MAZATÁN,054,ROGELIO PEÑALOSA ARROYO,1,14,8,6,1
CHIAPAS,7,MAZATÁN,054,SAN ANDRÉS SUYACAL,2,81,39,42,4
CHIAPAS,7,MAZATÁN,054,SAN JOSÉ DE LOS LLANOS,2,77,40,37,3
CHIAPAS,7,MAZATÁN,054,SAN JOSÉ EL HUEYATE (BARRA DE SAN JOSÉ),4,297,150,147,15
CHIAPAS,7,MAZATÁN,054,SANTA CLARA,3,148,64,84,7
CHIAPAS,7,MAZATÁN,054,SANTA ENE,1,17,9,8,1
CHIAPAS,7,METAPA,055,CACAHOATALES,2,75,44,31,3
CHIAPAS,7,METAPA,055,EL ARENAL,2,82,39,43,3
CHIAPAS,7,METAPA,055,LAS PILAS,2,108,56,52,4
CHIAPAS,7,METAPA,055,METAPA DE DOMÍNGUEZ,8,1430,736,694,60
CHIAPAS,7,MITONTIC,056,ALAMUL,2,308,156,152,8
CHIAPAS,7,MITONTIC,056,BACHÉN,2,58,30,28,4
CHIAPAS,7,MITONTIC,056,CHALAM,4,902,392,510,39
CHIAPAS,7,MITONTIC,056,CHIMHUCUM,2,435,218,217,9
CHIAPAS,7,MITONTIC,056,CHOCO,2,37,16,21,3
CHIAPAS,7,MITONTIC,056,CUCHUMTÓN,3,428,208,220,14
CHIAPAS,7,MITONTIC,056,JOLXOJOM' K'AKAL,2,44,20,24,3
CHIAPAS,7,MITONTIC,056,MITONTIC,6,494,227,267,25
CHIAPAS,7,MITONTIC,056,OXINAM,3,483,213,270,18
CHIAPAS,7,MITONTIC,056,PULUMSIBAC,2,222,109,113,7
CHIAPAS,7,MITONTIC,056,SUYALHÓ,2,305,156,149,10
CHIAPAS,7,MITONTIC,056,SUYTIC,3,57,32,25,5
CHIAPAS,7,MITONTIC,056,TITALTETIC,2,353,176,177,10
CHIAPAS,7,MITONTIC,056,TOJCHOTIC,2,207,105,102,6
CHIAPAS,7,MITONTIC,056,TOJTIC,2,166,75,91,5
CHIAPAS,7,MITONTIC,056,TZOEPTIC,2,555,275,280,15
CHIAPAS,7,MITONTIC,056,XOCTÓN (XOCTOCTIC),2,87,40,47,3
CHIAPAS,7,MOTOZINTLA,057,20 DE NOVIEMBRE,4,136,74,62,7
CHIAPAS,7,MOTOZINTLA,057,4 DE OCTUBRE,3,88,52,36,5
CHIAPAS,7,MOTOZINTLA,057,8 DE JULIO,1,47,26,21,2
CHIAPAS,7,MOTOZINTLA,057,AGUA DULCE,2,54,26,28,2
CHIAPAS,7,MOTOZINTLA,057,AGUA PRIETA,6,263,148,115,16
CHIAPAS,7,MOTOZINTLA,057,ALLENDE,2,78,39,39,3
CHIAPAS,7,MOTOZINTLA,057,ÁLVARO OBREGÓN,3,98,44,54,6
CHIAPAS,7,MOTOZINTLA,057,AMPLIACIÓN ARENAL,2,30,11,19,2
CHIAPAS,7,MOTOZINTLA,057,AMPLIACIÓN NUEVA REFORMA,1,18,8,10,1
CHIAPAS,7,MOTOZINTLA,057,AMPLIACIÓN TRES DE MAYO,3,87,46,41,6
CHIAPAS,7,MOTOZINTLA,057,AQUILES SERDÁN,3,154,73,81,7
CHIAPAS,7,MOTOZINTLA,057,ARGELIA ALTA LUZ,1,12,7,5,1
CHIAPAS,7,MOTOZINTLA,057,BANDERA ARGENTINA,3,122,60,62,9
CHIAPAS,7,MOTOZINTLA,057,BARRIO NUEVO,2,65,38,27,4
CHIAPAS,7,MOTOZINTLA,057,BARRIO NUEVO CHIAPAS,2,63,29,34,3
CHIAPAS,7,MOTOZINTLA,057,BELÉN,1,13,4,9,1
CHIAPAS,7,MOTOZINTLA,057,BELISARIO DOMÍNGUEZ,7,1059,539,520,64
CHIAPAS,7,MOTOZINTLA,057,BENITO JUÁREZ,6,430,224,206,19
CHIAPAS,7,MOTOZINTLA,057,BERRIOZÁBAL,4,252,129,123,15
CHIAPAS,7,MOTOZINTLA,057,BOQUERÓN BUENAVISTA,3,141,65,76,5
CHIAPAS,7,MOTOZINTLA,057,BREMEN,4,621,336,285,29
CHIAPAS,7,MOTOZINTLA,057,BUENAVISTA,5,247,128,119,13
CHIAPAS,7,MOTOZINTLA,057,BUENOS AIRES,5,202,102,100,12
CHIAPAS,7,MOTOZINTLA,057,CAMPANAS,1,6,1,5,1
CHIAPAS,7,MOTOZINTLA,057,CANOAS,2,6,4,2,1
CHIAPAS,7,MOTOZINTLA,057,CHANJUL,2,19,9,10,2
CHIAPAS,7,MOTOZINTLA,057,CHAPULTEPEC,1,10,6,4,1
CHIAPAS,7,MOTOZINTLA,057,CHECUTÉ,3,290,139,151,11
CHIAPAS,7,MOTOZINTLA,057,CHEVOLCÁN,3,179,80,99,9
CHIAPAS,7,MOTOZINTLA,057,CHINCANAQUE DE PINABETA,2,37,14,23,2
CHIAPAS,7,MOTOZINTLA,057,CINCO DE FEBRERO,2,21,7,14,2
CHIAPAS,7,MOTOZINTLA,057,CINCO DE NOVIEMBRE,1,27,13,14,1
CHIAPAS,7,MOTOZINTLA,057,CIPRÉS,2,26,10,16,3
CHIAPAS,7,MOTOZINTLA,057,CIPRESAL,2,37,14,23,2
CHIAPAS,7,MOTOZINTLA,057,CONCEPCIÓN,3,41,10,31,3
CHIAPAS,7,MOTOZINTLA,057,CONCEPCIÓN LA CUEVA,1,6,2,4,1
CHIAPAS,7,MOTOZINTLA,057,CONCEPCIÓN VILLAFLORES,3,48,24,24,4
CHIAPAS,7,MOTOZINTLA,057,CUAUHTÉMOC,2,36,20,16,3
CHIAPAS,7,MOTOZINTLA,057,DOCE DE DICIEMBRE,2,87,41,46,4
CHIAPAS,7,MOTOZINTLA,057,DOS HERMANAS,2,57,32,25,2
CHIAPAS,7,MOTOZINTLA,057,DOS HERMANAS (MONTE FLOR),1,46,20,26,1
CHIAPAS,7,MOTOZINTLA,057,EL ANONAL,2,107,55,52,3
CHIAPAS,7,MOTOZINTLA,057,EL ARENAL,5,135,65,70,8
CHIAPAS,7,MOTOZINTLA,057,EL CARRIZAL,9,363,188,175,20
CHIAPAS,7,MOTOZINTLA,057,EL GAVILÁN,2,36,21,15,2
CHIAPAS,7,MOTOZINTLA,057,EL HORIZONTE (SANTA ELENA),2,105,53,52,5
CHIAPAS,7,MOTOZINTLA,057,EL INJERTO,1,8,3,5,1
CHIAPAS,7,MOTOZINTLA,057,EL MIRADOR,3,116,63,53,5
CHIAPAS,7,MOTOZINTLA,057,EL MOJÓN,3,147,80,67,8
CHIAPAS,7,MOTOZINTLA,057,EL MOLINO,1,16,7,9,1
CHIAPAS,7,MOTOZINTLA,057,EL ORIENTE,2,33,20,13,2
CHIAPAS,7,MOTOZINTLA,057,EL PACAYAL,2,8,5,3,1
CHIAPAS,7,MOTOZINTLA,057,EL PINITO,1,7,4,3,1
CHIAPAS,7,MOTOZINTLA,057,EL PIZARRÍN,3,100,38,62,8
CHIAPAS,7,MOTOZINTLA,057,EL PROGRESO,1,41,20,21,2
CHIAPAS,7,MOTOZINTLA,057,EL REMATE,3,99,48,51,6
CHIAPAS,7,MOTOZINTLA,057,EL RETIRO,1,21,10,11,1
CHIAPAS,7,MOTOZINTLA,057,EL RODEO,1,12,5,7,1
CHIAPAS,7,MOTOZINTLA,057,EL ROSARIO,3,95,54,41,5
CHIAPAS,7,MOTOZINTLA,057,EL ROSARIO (AGUA ESCONDIDA),1,55,28,27,3
CHIAPAS,7,MOTOZINTLA,057,EL TORONJIL,1,47,23,24,3
CHIAPAS,7,MOTOZINTLA,057,EMILIANO ZAPATA,1,20,10,10,1
CHIAPAS,7,MOTOZINTLA,057,FRANCISCO I. MADERO,4,249,129,120,14
CHIAPAS,7,MOTOZINTLA,057,FUNDADORES DE MOTOZINTLA,2,46,15,31,3
CHIAPAS,7,MOTOZINTLA,057,GALEANA,2,17,8,9,2
CHIAPAS,7,MOTOZINTLA,057,IGNACIO ZARAGOZA,3,113,58,55,5
CHIAPAS,7,MOTOZINTLA,057,JICOTEPEC,1,24,9,15,2
CHIAPAS,7,MOTOZINTLA,057,JOCOTE,1,16,9,7,1
CHIAPAS,7,MOTOZINTLA,057,JOSÉ LÓPEZ PORTILLO,2,38,19,19,2
CHIAPAS,7,MOTOZINTLA,057,JUSTO SIERRA,3,47,23,24,3
CHIAPAS,7,MOTOZINTLA,057,LA ANTIGUA,1,7,3,4,1
CHIAPAS,7,MOTOZINTLA,057,LA CEIBA,1,6,4,2,1
CHIAPAS,7,MOTOZINTLA,057,LA LAGUNA,2,10,3,7,1
CHIAPAS,7,MOTOZINTLA,057,LA MINA,2,62,26,36,3
CHIAPAS,7,MOTOZINTLA,057,LA SOLEDAD,1,18,10,8,1
CHIAPAS,7,MOTOZINTLA,057,LA UNIÓN,5,157,79,78,8
CHIAPAS,7,MOTOZINTLA,057,LA VERBENA,3,185,92,93,9
CHIAPAS,7,MOTOZINTLA,057,LA VICTORIA,2,7,1,6,1
CHIAPAS,7,MOTOZINTLA,057,LAS CABAÑAS,3,92,50,42,6
CHIAPAS,7,MOTOZINTLA,057,LAS CRUCES,2,66,30,36,3
CHIAPAS,7,MOTOZINTLA,057,LAS DELICIAS,3,48,19,29,3
CHIAPAS,7,MOTOZINTLA,057,LAS FLORES BUENAVISTA,1,5,2,3,1
CHIAPAS,7,MOTOZINTLA,057,LAS NUBES,5,90,44,46,7
CHIAPAS,7,MOTOZINTLA,057,LAS PERLAS,1,5,4,1,1
CHIAPAS,7,MOTOZINTLA,057,LAS TABLAS,1,26,14,12,1
CHIAPAS,7,MOTOZINTLA,057,LÁZARO CÁRDENAS,2,42,25,17,3
CHIAPAS,7,MOTOZINTLA,057,LIBERTAD CALERA,5,181,98,83,10
CHIAPAS,7,MOTOZINTLA,057,LINDAVISTA,2,86,36,50,4
CHIAPAS,7,MOTOZINTLA,057,LINDAVISTA DOS,2,46,23,23,3
CHIAPAS,7,MOTOZINTLA,057,LLANO GRANDE,11,382,186,196,21
CHIAPAS,7,MOTOZINTLA,057,LOMA BONITA,8,307,164,143,15
CHIAPAS,7,MOTOZINTLA,057,LOS ALISOS,2,55,23,32,4
CHIAPAS,7,MOTOZINTLA,057,LOS LIMONES,2,19,11,8,2
CHIAPAS,7,MOTOZINTLA,057,LOS PINOS,3,65,28,37,5
CHIAPAS,7,MOTOZINTLA,057,MAÍZ BLANCO,4,110,60,50,6
CHIAPAS,7,MOTOZINTLA,057,MANACALITO,1,6,5,1,1
CHIAPAS,7,MOTOZINTLA,057,MATASANO,2,60,31,29,3
CHIAPAS,7,MOTOZINTLA,057,MIGUEL ALEMÁN,3,192,92,100,11
CHIAPAS,7,MOTOZINTLA,057,MIGUEL HIDALGO,1,4,2,2,1
CHIAPAS,7,MOTOZINTLA,057,MIRAMAR,2,20,11,9,2
CHIAPAS,7,MOTOZINTLA,057,MIRASOL CALERA,2,28,13,15,2
CHIAPAS,7,MOTOZINTLA,057,MONTE FLOR,1,17,12,5,2
CHIAPAS,7,MOTOZINTLA,057,MONTEBELLO,1,7,3,4,1
CHIAPAS,7,MOTOZINTLA,057,MOTOZINTLA DE MENDOZA,55,8305,4185,4120,433
CHIAPAS,7,MOTOZINTLA,057,NIQUIVIL,4,475,224,251,18
CHIAPAS,7,MOTOZINTLA,057,NUEVA ESPERANCITA,2,35,17,18,3
CHIAPAS,7,MOTOZINTLA,057,NUEVA ESPERANZA,4,96,43,53,6
CHIAPAS,7,MOTOZINTLA,057,NUEVA INDEPENDENCIA,2,25,11,14,2
CHIAPAS,7,MOTOZINTLA,057,NUEVA INDEPENDENCIA (AMPLIACIÓN CALERA),3,189,91,98,11
CHIAPAS,7,MOTOZINTLA,057,NUEVA JERUSALÉN,2,45,24,21,3
CHIAPAS,7,MOTOZINTLA,057,NUEVA MARAVILLAS,3,153,80,73,9
CHIAPAS,7,MOTOZINTLA,057,NUEVA REFORMA,3,72,33,39,4
CHIAPAS,7,MOTOZINTLA,057,NUEVA REFORMA AGRARIA,2,63,38,25,4
CHIAPAS,7,MOTOZINTLA,057,NUEVA VICTORIA,2,37,16,21,2
CHIAPAS,7,MOTOZINTLA,057,NUEVO ESFUERZO (NUEVA JERUSALÉN),1,27,13,14,1
CHIAPAS,7,MOTOZINTLA,057,NUEVO IXTEPEC,1,8,3,5,1
CHIAPAS,7,MOTOZINTLA,057,NUEVO PARAÍSO,5,172,78,94,8
CHIAPAS,7,MOTOZINTLA,057,NUEVO POBLADO EL CIPRESAL,2,28,11,17,2
CHIAPAS,7,MOTOZINTLA,057,NUEVO PROGRESO,2,39,12,27,3
CHIAPAS,7,MOTOZINTLA,057,NUEVO TRIUNFO (AÑO DE JUÁREZ),2,28,18,10,3
CHIAPAS,7,MOTOZINTLA,057,NUEVO VILLAFLORES,2,31,16,15,2
CHIAPAS,7,MOTOZINTLA,057,OJO DE AGUA,2,188,82,106,8
CHIAPAS,7,MOTOZINTLA,057,PACAYALITO,2,22,9,13,2
CHIAPAS,7,MOTOZINTLA,057,PALO MARÍA,2,14,7,7,2
CHIAPAS,7,MOTOZINTLA,057,PIEDRA PARTIDA,3,94,41,53,7
CHIAPAS,7,MOTOZINTLA,057,PLAN DE GUADALUPE,2,55,32,23,3
CHIAPAS,7,MOTOZINTLA,057,PLAN DE URBINA,2,11,6,5,2
CHIAPAS,7,MOTOZINTLA,057,PLAN GRANDE,2,67,40,27,4
CHIAPAS,7,MOTOZINTLA,057,PRIMERO DE MAYO,3,55,24,31,3
CHIAPAS,7,MOTOZINTLA,057,RINCÓN BUENAVISTA,2,22,15,7,2
CHIAPAS,7,MOTOZINTLA,057,RINCÓN DEL BOSQUE,5,74,39,35,7
CHIAPAS,7,MOTOZINTLA,057,RÍO BRAVO,1,53,33,20,2
CHIAPAS,7,MOTOZINTLA,057,RIVERA MORELOS,2,68,31,37,4
CHIAPAS,7,MOTOZINTLA,057,SALANUEVA,2,47,25,22,2
CHIAPAS,7,MOTOZINTLA,057,SAN ANTONIO,1,26,13,13,1
CHIAPAS,7,MOTOZINTLA,057,SAN ANTONIO LAS FLORES,1,8,4,4,1
CHIAPAS,7,MOTOZINTLA,057,SAN ANTONIO TUIXCUM,1,24,15,9,1
CHIAPAS,7,MOTOZINTLA,057,SAN DIMAS,2,51,24,27,3
CHIAPAS,7,MOTOZINTLA,057,SAN FELIPE,2,35,18,17,2
CHIAPAS,7,MOTOZINTLA,057,SAN FELIPE PUENTE CAMPECHE,2,44,19,25,2
CHIAPAS,7,MOTOZINTLA,057,SAN FERNANDO,3,62,31,31,5
CHIAPAS,7,MOTOZINTLA,057,SAN FRANCISCO,1,14,10,4,1
CHIAPAS,7,MOTOZINTLA,057,SAN JERÓNIMO,2,99,56,43,4
CHIAPAS,7,MOTOZINTLA,057,SAN JOSÉ IXTEPEC,7,383,208,175,18
CHIAPAS,7,MOTOZINTLA,057,SAN JUAN CALERA,4,166,89,77,10
CHIAPAS,7,MOTOZINTLA,057,SAN LUCAS,5,62,37,25,5
CHIAPAS,7,MOTOZINTLA,057,SAN LUIS,5,62,34,28,5
CHIAPAS,7,MOTOZINTLA,057,SAN MIGUEL,2,43,22,21,3
CHIAPAS,7,MOTOZINTLA,057,SAN RAMÓN,2,16,9,7,2
CHIAPAS,7,MOTOZINTLA,057,SAN VICENTE,2,22,12,10,2
CHIAPAS,7,MOTOZINTLA,057,SANTA ANA,2,31,15,16,3
CHIAPAS,7,MOTOZINTLA,057,SANTA ANA PINABETO,3,175,89,86,6
CHIAPAS,7,MOTOZINTLA,057,SANTA CRUZ EL PARRAL,2,40,22,18,2
CHIAPAS,7,MOTOZINTLA,057,SANTA ELENA,2,17,9,8,2
CHIAPAS,7,MOTOZINTLA,057,SANTA FE (LA ESPERANZA),2,17,7,10,2
CHIAPAS,7,MOTOZINTLA,057,SANTA TERESA,3,67,32,35,5
CHIAPAS,7,MOTOZINTLA,057,SIERRA GALEANA,2,58,23,35,3
CHIAPAS,7,MOTOZINTLA,057,SINALTEPEC,2,32,14,18,2
CHIAPAS,7,MOTOZINTLA,057,SONORA,2,57,27,30,3
CHIAPAS,7,MOTOZINTLA,057,TENÁN,1,9,4,5,1
CHIAPAS,7,MOTOZINTLA,057,TIERRA LINDA (VUELTA CARACOL),2,63,29,34,3
CHIAPAS,7,MOTOZINTLA,057,TOLIMAM,3,230,111,119,10
CHIAPAS,7,MOTOZINTLA,057,TONINCANAQUE,2,67,33,34,3
CHIAPAS,7,MOTOZINTLA,057,TONINCHIHUÁN,2,43,20,23,3
CHIAPAS,7,MOTOZINTLA,057,TOQUIÁN CUAUHTÉMOC,2,79,37,42,4
CHIAPAS,7,MOTOZINTLA,057,TUIXCUM BUENAVISTA,2,96,34,62,5
CHIAPAS,7,MOTOZINTLA,057,TUIXCUM CHICO,2,45,18,27,3
CHIAPAS,7,MOTOZINTLA,057,TUIXCUM GRANDE,3,207,90,117,12
CHIAPAS,7,MOTOZINTLA,057,TUXCHAMÉN,3,86,42,44,5
CHIAPAS,7,MOTOZINTLA,057,UNIÓN BUENAVISTA,1,13,8,5,2
CHIAPAS,7,MOTOZINTLA,057,UNIÓN VILLAFLORES,2,153,69,84,7
CHIAPAS,7,MOTOZINTLA,057,VARITAS,2,40,16,24,3
CHIAPAS,7,MOTOZINTLA,057,VEINTE DE ABRIL,2,97,52,45,4
CHIAPAS,7,MOTOZINTLA,057,VEINTICUATRO DE FEBRERO,1,5,3,2,1
CHIAPAS,7,MOTOZINTLA,057,VEINTISIETE DE OCTUBRE,2,28,11,17,2
CHIAPAS,7,MOTOZINTLA,057,VEINTITRÉS DE ABRIL,3,59,40,19,3
CHIAPAS,7,MOTOZINTLA,057,VERVERENA SAN JOAQUÍN,1,8,2,6,1
CHIAPAS,7,MOTOZINTLA,057,VICENTE GUERRERO,3,172,83,89,8
CHIAPAS,7,MOTOZINTLA,057,VILLA HERMOSA,1,69,30,39,3
CHIAPAS,7,MOTOZINTLA,057,VILLA NUEVA,1,5,3,2,1
CHIAPAS,7,MOTOZINTLA,057,VILLAFLORES,2,55,31,24,5
CHIAPAS,7,MOTOZINTLA,057,VILLAHERMOSA DOS,1,14,8,6,1
CHIAPAS,7,MOTOZINTLA,057,VOLVER,2,20,11,9,2
CHIAPAS,7,MOTOZINTLA,057,ZARAGOZA,1,7,4,3,1
CHIAPAS,7,NICOLÁS RUÍZ,058,NICOLÁS RUÍZ,6,1352,636,716,53
CHIAPAS,7,OCOSINGO,059,13 DE SEPTIEMBRE,3,128,68,60,8
CHIAPAS,7,OCOSINGO,059,7 DE FEBRERO,2,16,7,9,2
CHIAPAS,7,OCOSINGO,059,ABASOLO,4,1715,876,839,56
CHIAPAS,7,OCOSINGO,059,ACH LUMAL,2,85,41,44,3
CHIAPAS,7,OCOSINGO,059,ACH'LUM MONTE LÍBANO,2,297,145,152,12
CHIAPAS,7,OCOSINGO,059,AGUA AZUL,4,414,201,213,15
CHIAPAS,7,OCOSINGO,059,AGUA DULCE TEHUACAN,3,183,79,104,4
CHIAPAS,7,OCOSINGO,059,AGUA ESCONDIDA,2,28,13,15,3
CHIAPAS,7,OCOSINGO,059,ALACTÉ BUENAVISTA UNO,2,51,26,25,3
CHIAPAS,7,OCOSINGO,059,AMADOR HERNÁNDEZ,2,284,142,142,13
CHIAPAS,7,OCOSINGO,059,AMATITLÁN,6,248,115,133,12
CHIAPAS,7,OCOSINGO,059,AMAYTIC,3,71,38,33,4
CHIAPAS,7,OCOSINGO,059,AMPLIACIÓN JOL TULIJA,2,49,16,33,3
CHIAPAS,7,OCOSINGO,059,ARROYO AGUILAR,2,17,9,8,2
CHIAPAS,7,OCOSINGO,059,ARROYO GRANIZO,2,475,239,236,17
CHIAPAS,7,OCOSINGO,059,ARROYO SANTA MARÍA,1,27,14,13,1
CHIAPAS,7,OCOSINGO,059,ASIA,2,33,15,18,2
CHIAPAS,7,OCOSINGO,059,ASPULJA,1,5,2,3,1
CHIAPAS,7,OCOSINGO,059,ATOTONILCO,2,46,19,27,3
CHIAPAS,7,OCOSINGO,059,AURORA BUENAVISTA,2,87,42,45,3
CHIAPAS,7,OCOSINGO,059,BALANCÁN,1,8,5,3,1
CHIAPAS,7,OCOSINGO,059,BALAXTE,4,322,152,170,13
CHIAPAS,7,OCOSINGO,059,BENITO JUÁREZ BULWA,1,22,11,11,1
CHIAPAS,7,OCOSINGO,059,BENITO JUÁREZ MIRAMAR,3,199,98,101,6
CHIAPAS,7,OCOSINGO,059,BENITO JUÁREZ YALCHUC,2,152,80,72,6
CHIAPAS,7,OCOSINGO,059,BETANIA,2,128,55,73,6
CHIAPAS,7,OCOSINGO,059,BETEL,2,90,40,50,4
CHIAPAS,7,OCOSINGO,059,BETHEL,3,124,57,67,5
CHIAPAS,7,OCOSINGO,059,BOCA DEL CERRO,1,28,12,16,1
CHIAPAS,7,OCOSINGO,059,BONAMPAK [ZONA ARQUEOLÓGICA],1,22,5,17,1
CHIAPAS,7,OCOSINGO,059,BUENAVISTA TEAQUIL,1,19,9,10,1
CHIAPAS,7,OCOSINGO,059,BUENAVISTA TIBER,2,59,31,28,2
CHIAPAS,7,OCOSINGO,059,BUSILJÁ,3,443,216,227,18
CHIAPAS,7,OCOSINGO,059,CAMPET,4,63,27,36,5
CHIAPAS,7,OCOSINGO,059,CAMPET 2DA. SECCIÓN,1,16,5,11,1
CHIAPAS,7,OCOSINGO,059,CAMPO ALEGRE,3,138,57,81,8
CHIAPAS,7,OCOSINGO,059,CAMPO VIRGEN,2,97,44,53,4
CHIAPAS,7,OCOSINGO,059,CANDELARIA,3,237,118,119,10
CHIAPAS,7,OCOSINGO,059,CANDELARIA BULWA,1,23,7,16,1
CHIAPAS,7,OCOSINGO,059,CARMEN PATATE NUEVO,3,157,74,83,7
CHIAPAS,7,OCOSINGO,059,CARMEN PATATE VIEJO,3,43,18,25,3
CHIAPAS,7,OCOSINGO,059,CARMEN TAJALTIC,2,40,24,16,3
CHIAPAS,7,OCOSINGO,059,CHACANTEL,1,34,19,15,2
CHIAPAS,7,OCOSINGO,059,CHALAM DEL CARMEN SAN AGUSTÍN,6,239,121,118,10
CHIAPAS,7,OCOSINGO,059,CHAMOMÚN,3,38,17,21,3
CHIAPAS,7,OCOSINGO,059,CHAMPA SAN AGUSTÍN,2,109,55,54,4
CHIAPAS,7,OCOSINGO,059,CHAPAYAL,1,6,0,6,1
CHIAPAS,7,OCOSINGO,059,CHAVARICO LAS PALMAS,3,125,71,54,8
CHIAPAS,7,OCOSINGO,059,CHIC LACANWI'TS,2,45,27,18,3
CHIAPAS,7,OCOSINGO,059,CHULNA TENANGO,3,268,128,140,10
CHIAPAS,7,OCOSINGO,059,CHUNCERRO LA LAGUNA,1,21,12,9,1
CHIAPAS,7,OCOSINGO,059,CINCO DE FEBRERO,4,455,206,249,14
CHIAPAS,7,OCOSINGO,059,CINTALAPA,4,880,408,472,28
CHIAPAS,7,OCOSINGO,059,CORAZÓN DE MARÍA,2,62,28,34,3
CHIAPAS,7,OCOSINGO,059,CRISTÓBAL COLÓN,3,620,279,341,21
CHIAPAS,7,OCOSINGO,059,CUAUHTÉMOC,3,107,59,48,6
CHIAPAS,7,OCOSINGO,059,CUCJA,1,19,7,12,1
CHIAPAS,7,OCOSINGO,059,CUXULJÁ,4,781,386,395,28
CHIAPAS,7,OCOSINGO,059,DAMASCO,6,1032,532,500,62
CHIAPAS,7,OCOSINGO,059,DELICIAS CASCO,2,125,57,68,4
CHIAPAS,7,OCOSINGO,059,DOCTOR MANUEL VELASCO SUÁREZ,2,75,38,37,3
CHIAPAS,7,OCOSINGO,059,DOLORES,4,128,76,52,9
CHIAPAS,7,OCOSINGO,059,DOLORES LAS PALMAS,4,248,127,121,11
CHIAPAS,7,OCOSINGO,059,EDÉN DEL CARMEN,1,13,6,7,1
CHIAPAS,7,OCOSINGO,059,EL AVELLANAL,2,170,83,87,5
CHIAPAS,7,OCOSINGO,059,EL BOQUERÓN,2,24,11,13,2
CHIAPAS,7,OCOSINGO,059,EL BRAVO UNO,3,48,24,24,4
CHIAPAS,7,OCOSINGO,059,EL CACAO,1,36,18,18,1
CHIAPAS,7,OCOSINGO,059,EL CALVARIO,3,205,100,105,7
CHIAPAS,7,OCOSINGO,059,EL CARIBAL,1,25,16,9,1
CHIAPAS,7,OCOSINGO,059,EL CARMEN,1,51,26,25,2
CHIAPAS,7,OCOSINGO,059,EL CARRIZAL,2,36,20,16,2
CHIAPAS,7,OCOSINGO,059,EL CARRIZAL II,2,22,6,16,2
CHIAPAS,7,OCOSINGO,059,EL CENSO,5,889,454,435,31
CHIAPAS,7,OCOSINGO,059,EL DIAMANTE,3,288,148,140,13
CHIAPAS,7,OCOSINGO,059,EL EDÉN,1,26,17,9,1
CHIAPAS,7,OCOSINGO,059,EL ENCANTO,1,59,27,32,2
CHIAPAS,7,OCOSINGO,059,EL GUANAL,2,158,67,91,5
CHIAPAS,7,OCOSINGO,059,EL IXCÁN,4,363,189,174,17
CHIAPAS,7,OCOSINGO,059,EL JARDÍN,3,419,205,214,11
CHIAPAS,7,OCOSINGO,059,EL LAUREL,1,52,27,25,1
CHIAPAS,7,OCOSINGO,059,EL LIMONAR,3,625,299,326,17
CHIAPAS,7,OCOSINGO,059,EL MANGO,2,191,100,91,5
CHIAPAS,7,OCOSINGO,059,EL MILAGRO DEL CARMEN,1,20,9,11,1
CHIAPAS,7,OCOSINGO,059,EL NACIMIENTO,2,65,31,34,3
CHIAPAS,7,OCOSINGO,059,EL OCOTAL,1,18,9,9,1
CHIAPAS,7,OCOSINGO,059,EL PEDREGAL DE SAN ÁNGEL,1,84,39,45,3
CHIAPAS,7,OCOSINGO,059,EL PORVENIR,1,33,21,12,1
CHIAPAS,7,OCOSINGO,059,EL PRADO PACAYAL,3,378,200,178,11
CHIAPAS,7,OCOSINGO,059,EL PROGRESO,2,173,80,93,6
CHIAPAS,7,OCOSINGO,059,EL RECUERDO,2,45,19,26,5
CHIAPAS,7,OCOSINGO,059,EL RETIRO,3,20,14,6,3
CHIAPAS,7,OCOSINGO,059,EL ROSARIO,6,428,212,216,13
CHIAPAS,7,OCOSINGO,059,EL SIBAL,4,731,375,356,26
CHIAPAS,7,OCOSINGO,059,EL SUSPIRO,5,159,67,92,8
CHIAPAS,7,OCOSINGO,059,EL TRIUNFO DE ALFREDO DÍAZ,3,32,10,22,3
CHIAPAS,7,OCOSINGO,059,EL TUMBO,4,1009,521,488,30
CHIAPAS,7,OCOSINGO,059,EL VERGEL,1,8,6,2,1
CHIAPAS,7,OCOSINGO,059,EL ZAPOTAL,3,870,463,407,25
CHIAPAS,7,OCOSINGO,059,EMILIANO ZAPATA,8,760,374,386,23
CHIAPAS,7,OCOSINGO,059,FRANCISCO GUERRERO,3,253,132,121,10
CHIAPAS,7,OCOSINGO,059,FRANCISCO VILLA,2,62,28,34,3
CHIAPAS,7,OCOSINGO,059,FRANCISCO VILLA [LOTE 5],3,54,26,28,4
CHIAPAS,7,OCOSINGO,059,FRONTERA COROZAL,5,1598,824,774,69
CHIAPAS,7,OCOSINGO,059,GETZEMANÍ,3,182,85,97,8
CHIAPAS,7,OCOSINGO,059,GRACIAS A DIOS,2,40,21,19,3
CHIAPAS,7,OCOSINGO,059,GRANIZO,1,118,56,62,4
CHIAPAS,7,OCOSINGO,059,GUADALUPE,3,83,39,44,4
CHIAPAS,7,OCOSINGO,059,GUADALUPE CHACTAJAL,1,15,7,8,1
CHIAPAS,7,OCOSINGO,059,GUADALUPE TECOJA,2,30,20,10,3
CHIAPAS,7,OCOSINGO,059,GUADALUPE VICTORIA,2,165,80,85,5
CHIAPAS,7,OCOSINGO,059,HÉCTOR ALBORES CRUZ,2,276,143,133,11
CHIAPAS,7,OCOSINGO,059,IBARRA,2,46,24,22,2
CHIAPAS,7,OCOSINGO,059,ISRAEL,4,237,122,115,10
CHIAPAS,7,OCOSINGO,059,IXTAPA MIRADOR,2,55,28,27,2
CHIAPAS,7,OCOSINGO,059,JALAPA,2,26,9,17,3
CHIAPAS,7,OCOSINGO,059,JAVIER LÓPEZ MORENO,3,51,33,18,4
CHIAPAS,7,OCOSINGO,059,JERUSALÉN,7,464,218,246,16
CHIAPAS,7,OCOSINGO,059,JOL PACUTE,1,6,3,3,1
CHIAPAS,7,OCOSINGO,059,JOL TULIJÁ,3,392,189,203,13
CHIAPAS,7,OCOSINGO,059,JOSEFA ORTIZ DE DOMÍNGUEZ,1,11,6,5,1
CHIAPAS,7,OCOSINGO,059,LA ARENA,4,432,222,210,15
CHIAPAS,7,OCOSINGO,059,LA ARENA 2DA. SECCIÓN (MORELOS),2,32,19,13,2
CHIAPAS,7,OCOSINGO,059,LA AURORA,4,146,79,67,6
CHIAPAS,7,OCOSINGO,059,LA CHAMPA,2,38,12,26,2
CHIAPAS,7,OCOSINGO,059,LA CHAMPA CANCHANIVALTIC (LAS CHAMPITAS),2,65,31,34,4
CHIAPAS,7,OCOSINGO,059,LA CUEVA,1,21,9,12,2
CHIAPAS,7,OCOSINGO,059,LA CULEBRA,2,219,109,110,4
CHIAPAS,7,OCOSINGO,059,LA FLOR DE GETZEMANÍ,1,12,4,8,1
CHIAPAS,7,OCOSINGO,059,LA FRONTERA UNO,3,377,178,199,12
CHIAPAS,7,OCOSINGO,059,LA GARRUCHA,2,101,44,57,7
CHIAPAS,7,OCOSINGO,059,LA GLORIA,4,178,86,92,6
CHIAPAS,7,OCOSINGO,059,LA INDEPENDENCIA,2,26,14,12,2
CHIAPAS,7,OCOSINGO,059,LA LIBERTAD,2,184,94,90,5
CHIAPAS,7,OCOSINGO,059,LA MARTINICA,2,20,11,9,2
CHIAPAS,7,OCOSINGO,059,LA NUEVA ESPERANZA,1,109,50,59,4
CHIAPAS,7,OCOSINGO,059,LA PEÑA,2,96,42,54,3
CHIAPAS,7,OCOSINGO,059,LA PITA,3,65,29,36,5
CHIAPAS,7,OCOSINGO,059,LA POMARROSA EL CHORRO,2,8,4,4,1
CHIAPAS,7,OCOSINGO,059,LA REFORMA,3,520,251,269,18
CHIAPAS,7,OCOSINGO,059,LA SELVA (SAN ANDRÉS),2,43,22,21,3
CHIAPAS,7,OCOSINGO,059,LA SIRIA,3,79,33,46,3
CHIAPAS,7,OCOSINGO,059,LA SOLEDAD,3,390,171,219,11
CHIAPAS,7,OCOSINGO,059,LA SULTANA,3,239,112,127,7
CHIAPAS,7,OCOSINGO,059,LA TINTA,2,130,64,66,5
CHIAPAS,7,OCOSINGO,059,LA TRINIDAD,5,235,126,109,7
CHIAPAS,7,OCOSINGO,059,LA TRINITARIA,1,20,8,12,1
CHIAPAS,7,OCOSINGO,059,LA UNIÓN,3,114,61,53,5
CHIAPAS,7,OCOSINGO,059,LA VENTANA,2,67,29,38,2
CHIAPAS,7,OCOSINGO,059,LA VICTORIA,1,14,5,9,1
CHIAPAS,7,OCOSINGO,059,LA VIRGINIA,4,659,322,337,25
CHIAPAS,7,OCOSINGO,059,LA ZARCA,2,127,61,66,4
CHIAPAS,7,OCOSINGO,059,LACANDÓN,3,516,258,258,17
CHIAPAS,7,OCOSINGO,059,LACANJÁ CHANSAYAB,4,212,117,95,11
CHIAPAS,7,OCOSINGO,059,LACANJÁ TZELTAL,3,428,223,205,13
CHIAPAS,7,OCOSINGO,059,LAGUNA COLORADA,1,9,4,5,1
CHIAPAS,7,OCOSINGO,059,LAGUNA SANTA ELENA,1,55,35,20,1
CHIAPAS,7,OCOSINGO,059,LAS CONCHITAS,2,90,54,36,3
CHIAPAS,7,OCOSINGO,059,LAS GOLONDRINAS,1,4,1,3,1
CHIAPAS,7,OCOSINGO,059,LAS MARAVILLAS,4,111,55,56,5
CHIAPAS,7,OCOSINGO,059,LAS MARGARITAS,1,54,18,36,1
CHIAPAS,7,OCOSINGO,059,LAS PALOMAS,1,41,15,26,1
CHIAPAS,7,OCOSINGO,059,LAS TACITAS,4,253,122,131,7
CHIAPAS,7,OCOSINGO,059,LAS TAZAS,6,822,388,434,30
CHIAPAS,7,OCOSINGO,059,LÁZARO CÁRDENAS,2,75,36,39,3
CHIAPAS,7,OCOSINGO,059,LEQUILUM,1,29,16,13,1
CHIAPAS,7,OCOSINGO,059,LIMONAL,1,8,3,5,1
CHIAPAS,7,OCOSINGO,059,LOCATALUM TENANGO,1,15,11,4,1
CHIAPAS,7,OCOSINGO,059,LOMA BONITA,2,71,42,29,3
CHIAPAS,7,OCOSINGO,059,LOMAS DEL ORIENTE,2,25,18,7,2
CHIAPAS,7,OCOSINGO,059,LOS LIMARES,2,104,43,61,4
CHIAPAS,7,OCOSINGO,059,LOS PINOS,2,301,149,152,14
CHIAPAS,7,OCOSINGO,059,LOS QUINICHEZ,1,47,20,27,2
CHIAPAS,7,OCOSINGO,059,LOS RAYOS DEL SOL,2,15,10,5,2
CHIAPAS,7,OCOSINGO,059,LUCUMILJA,2,79,34,45,3
CHIAPAS,7,OCOSINGO,059,MACEDONIA,3,124,63,61,5
CHIAPAS,7,OCOSINGO,059,MIGUEL HIDALGO,5,583,261,322,15
CHIAPAS,7,OCOSINGO,059,MITONTIC,1,20,6,14,1
CHIAPAS,7,OCOSINGO,059,MONTE AZUL,1,18,11,7,1
CHIAPAS,7,OCOSINGO,059,MONTEBELLO,1,7,3,4,1
CHIAPAS,7,OCOSINGO,059,MORELIA,1,89,41,48,3
CHIAPAS,7,OCOSINGO,059,MUC'UL OTANIL,1,20,8,12,1
CHIAPAS,7,OCOSINGO,059,MUMUNTIC II (SK'INAL WINIKETIK),2,57,28,29,4
CHIAPAS,7,OCOSINGO,059,NAHA,2,45,23,22,3
CHIAPAS,7,OCOSINGO,059,NAZARETH,6,728,307,421,25
CHIAPAS,7,OCOSINGO,059,NUEVA ESPERANZA (LA ESPERANZA),3,344,189,155,13
CHIAPAS,7,OCOSINGO,059,NUEVA IBARRA,3,144,77,67,5
CHIAPAS,7,OCOSINGO,059,NUEVA ITALIA,5,100,53,47,8
CHIAPAS,7,OCOSINGO,059,NUEVA LAS TACITAS,4,144,70,74,8
CHIAPAS,7,OCOSINGO,059,NUEVA LIBERTAD,2,35,15,20,3
CHIAPAS,7,OCOSINGO,059,NUEVA MORELIA,3,206,104,102,11
CHIAPAS,7,OCOSINGO,059,NUEVA PALESTINA,17,4662,2370,2292,195
CHIAPAS,7,OCOSINGO,059,NUEVA PROVIDENCIA,4,198,97,101,6
CHIAPAS,7,OCOSINGO,059,NUEVA SAMARIA,3,248,98,150,12
CHIAPAS,7,OCOSINGO,059,NUEVO BALANCÁN,3,38,21,17,4
CHIAPAS,7,OCOSINGO,059,NUEVO BAMBÚ,2,16,7,9,2
CHIAPAS,7,OCOSINGO,059,NUEVO CANÁN,4,334,159,175,15
CHIAPAS,7,OCOSINGO,059,NUEVO CARIBAL,1,38,17,21,2
CHIAPAS,7,OCOSINGO,059,NUEVO CHAMIZAL,3,243,119,124,10
CHIAPAS,7,OCOSINGO,059,NUEVO CHAPULTEPEC,2,100,42,58,3
CHIAPAS,7,OCOSINGO,059,NUEVO DURANGO,2,99,49,50,4
CHIAPAS,7,OCOSINGO,059,NUEVO EDÉN,1,42,15,27,1
CHIAPAS,7,OCOSINGO,059,NUEVO FRANCISCO LEÓN,5,501,247,254,21
CHIAPAS,7,OCOSINGO,059,NUEVO GUADALUPE,3,68,35,33,4
CHIAPAS,7,OCOSINGO,059,NUEVO GUADALUPE EL SILENCIO,1,18,11,7,1
CHIAPAS,7,OCOSINGO,059,NUEVO GUERRERO,4,312,152,160,13
CHIAPAS,7,OCOSINGO,059,NUEVO ISRAEL,1,13,7,6,1
CHIAPAS,7,OCOSINGO,059,NUEVO JATATÉ,2,42,22,20,2
CHIAPAS,7,OCOSINGO,059,NUEVO JERUSALÉN,5,445,226,219,17
CHIAPAS,7,OCOSINGO,059,NUEVO LAREDO,2,71,28,43,3
CHIAPAS,7,OCOSINGO,059,NUEVO LEÓN,2,65,39,26,3
CHIAPAS,7,OCOSINGO,059,NUEVO MARISCAL,4,381,201,180,13
CHIAPAS,7,OCOSINGO,059,NUEVO MÉXICO,3,105,53,52,4
CHIAPAS,7,OCOSINGO,059,NUEVO MONTE LÍBANO,5,273,124,149,13
CHIAPAS,7,OCOSINGO,059,NUEVO OJO DE AGUA,3,136,74,62,7
CHIAPAS,7,OCOSINGO,059,NUEVO ORIZABA,2,37,24,13,3
CHIAPAS,7,OCOSINGO,059,NUEVO OXCHUC,2,68,37,31,3
CHIAPAS,7,OCOSINGO,059,NUEVO PARAÍSO,6,928,476,452,29
CHIAPAS,7,OCOSINGO,059,NUEVO PEDREGAL,2,111,47,64,4
CHIAPAS,7,OCOSINGO,059,NUEVO PROGRESO,3,75,38,37,5
CHIAPAS,7,OCOSINGO,059,NUEVO REAL,3,72,31,41,5
CHIAPAS,7,OCOSINGO,059,NUEVO ROSARIO,2,52,26,26,3
CHIAPAS,7,OCOSINGO,059,NUEVO SACRIFICIO,2,198,96,102,8
CHIAPAS,7,OCOSINGO,059,NUEVO SAN FRANCISCO,1,40,23,17,2
CHIAPAS,7,OCOSINGO,059,NUEVO SAN JACINTO,3,311,129,182,6
CHIAPAS,7,OCOSINGO,059,NUEVO TENEJAPA,1,30,19,11,1
CHIAPAS,7,OCOSINGO,059,NUEVO TUMBALÁ,2,61,35,26,3
CHIAPAS,7,OCOSINGO,059,NUEVO TUXTLA,2,56,32,24,3
CHIAPAS,7,OCOSINGO,059,NUPJA CHIVILTIC,2,58,24,34,2
CHIAPAS,7,OCOSINGO,059,OCOSINGO,86,20383,10249,10134,881
CHIAPAS,7,OCOSINGO,059,OJO DE AGUA,10,450,218,232,20
CHIAPAS,7,OCOSINGO,059,PAMANAVIL,2,61,34,27,3
CHIAPAS,7,OCOSINGO,059,PATIHUITZ,4,558,278,280,17
CHIAPAS,7,OCOSINGO,059,PATRIA NUEVA (LA LAGUNA),3,147,84,63,6
CHIAPAS,7,OCOSINGO,059,PATRIA NUEVA (SAN JOSÉ EL CONTENTO),2,549,268,281,23
CHIAPAS,7,OCOSINGO,059,PEÑA BLANCA,4,122,66,56,9
CHIAPAS,7,OCOSINGO,059,PEÑA CHABARICO,6,346,165,181,15
CHIAPAS,7,OCOSINGO,059,PEÑA LIMONAR,4,844,406,438,28
CHIAPAS,7,OCOSINGO,059,PERLA DE ACAPULCO,5,814,413,401,23
CHIAPAS,7,OCOSINGO,059,PICHUCALCO,2,227,111,116,9
CHIAPAS,7,OCOSINGO,059,PLÁCIDO FLORES,4,439,196,243,18
CHIAPAS,7,OCOSINGO,059,PLAN DE AYALA,1,12,9,3,1
CHIAPAS,7,OCOSINGO,059,PLAN DE AYUTLA,3,351,187,164,12
CHIAPAS,7,OCOSINGO,059,PLAN DE GUADALUPE,1,75,32,43,3
CHIAPAS,7,OCOSINGO,059,PLAN DE IGUALA,2,12,5,7,2
CHIAPAS,7,OCOSINGO,059,POMARROSA,2,16,7,9,2
CHIAPAS,7,OCOSINGO,059,PRIMER VALLE TONINÁ,2,61,27,34,3
CHIAPAS,7,OCOSINGO,059,PUEBLO NUEVO,2,43,30,13,3
CHIAPAS,7,OCOSINGO,059,PUEBLO NUEVO COATZACOALCOS,2,100,51,49,3
CHIAPAS,7,OCOSINGO,059,PUERTO BELLO METZABOK,3,35,18,17,4
CHIAPAS,7,OCOSINGO,059,QUINCE DE MARZO,3,95,44,51,4
CHIAPAS,7,OCOSINGO,059,RAFAEL MORENO,2,49,24,25,2
CHIAPAS,7,OCOSINGO,059,RAMÓN F. BALBOA,4,949,431,518,36
CHIAPAS,7,OCOSINGO,059,RANCHO ALEGRE,3,67,35,32,4
CHIAPAS,7,OCOSINGO,059,RÍO BLANCO,4,495,213,282,18
CHIAPAS,7,OCOSINGO,059,RÍO FLORIDO,3,108,54,54,6
CHIAPAS,7,OCOSINGO,059,RÍO JATATÉ,2,30,13,17,2
CHIAPAS,7,OCOSINGO,059,SABSITIC,1,26,13,13,1
CHIAPAS,7,OCOSINGO,059,SACRIFICIO LA ESPERANZA,3,252,137,115,8
CHIAPAS,7,OCOSINGO,059,SAN AGUSTÍN,3,121,66,55,5
CHIAPAS,7,OCOSINGO,059,SAN ANTONIO,3,195,84,111,5
CHIAPAS,7,OCOSINGO,059,SAN ANTONIO CARIBAL,1,21,14,7,1
CHIAPAS,7,OCOSINGO,059,SAN ANTONIO CATARRAYA,2,102,46,56,3
CHIAPAS,7,OCOSINGO,059,SAN ANTONIO ESCOBAR,2,158,80,78,5
CHIAPAS,7,OCOSINGO,059,SAN ANTONIO GUAYAQUIL,2,67,39,28,3
CHIAPAS,7,OCOSINGO,059,SAN ANTONIO LA SOMBRA,2,183,93,90,4
CHIAPAS,7,OCOSINGO,059,SAN ANTONIO LA VICTORIA,2,167,85,82,5
CHIAPAS,7,OCOSINGO,059,SAN ANTONIO LAS DELICIAS (PAMALA),4,600,294,306,25
CHIAPAS,7,OCOSINGO,059,SAN ANTONIO LAS FLORES,2,71,39,32,3
CHIAPAS,7,OCOSINGO,059,SAN ANTONIO PORVENIR,2,18,9,9,2
CHIAPAS,7,OCOSINGO,059,SAN ANTONIO PUSHILÁ,2,62,33,29,4
CHIAPAS,7,OCOSINGO,059,SAN ANTONIO SAMARIA,2,411,198,213,15
CHIAPAS,7,OCOSINGO,059,SAN ANTONIO TIJUANA,1,87,39,48,4
CHIAPAS,7,OCOSINGO,059,SAN CARALAMPIO,6,704,324,380,26
CHIAPAS,7,OCOSINGO,059,SAN CARALAMPIO AGUA DULCE,1,47,25,22,3
CHIAPAS,7,OCOSINGO,059,SAN CARLOS,1,6,3,3,1
CHIAPAS,7,OCOSINGO,059,SAN ESTEBAN,2,49,30,19,4
CHIAPAS,7,OCOSINGO,059,SAN FELIPE,2,18,11,7,2
CHIAPAS,7,OCOSINGO,059,SAN FELIPE BUENAVISTA,3,68,34,34,3
CHIAPAS,7,OCOSINGO,059,SAN FRANCISCO,9,336,163,173,14
CHIAPAS,7,OCOSINGO,059,SAN FRANCISCO LOMA BONITA,1,11,5,6,1
CHIAPAS,7,OCOSINGO,059,SAN FRANCISCO UNO,1,99,50,49,4
CHIAPAS,7,OCOSINGO,059,SAN ISIDRO,1,45,21,24,2
CHIAPAS,7,OCOSINGO,059,SAN JACINTO,4,317,134,183,16
CHIAPAS,7,OCOSINGO,059,SAN JAVIER,2,41,20,21,2
CHIAPAS,7,OCOSINGO,059,SAN JERÓNIMO,3,83,33,50,3
CHIAPAS,7,OCOSINGO,059,SAN JOSÉ,4,382,195,187,12
CHIAPAS,7,OCOSINGO,059,SAN JOSÉ NACIMIENTO,2,54,23,31,3
CHIAPAS,7,OCOSINGO,059,SAN JOSÉ OBRERO,2,59,32,27,4
CHIAPAS,7,OCOSINGO,059,SAN JOSÉ UNO,1,4,2,2,1
CHIAPAS,7,OCOSINGO,059,SAN JOSÉ VERAPAZ,2,45,25,20,3
CHIAPAS,7,OCOSINGO,059,SAN JUAN,4,45,25,20,4
CHIAPAS,7,OCOSINGO,059,SAN JUAN CHAPAYTIC,2,78,40,38,4
CHIAPAS,7,OCOSINGO,059,SAN JUAN DEL RÍO,2,148,77,71,6
CHIAPAS,7,OCOSINGO,059,SAN JUAN LA CUREÑA,2,154,77,77,7
CHIAPAS,7,OCOSINGO,059,SAN JUAN RÓMULO CALZADA,2,312,159,153,12
CHIAPAS,7,OCOSINGO,059,SAN JUANITO PASHILA,2,43,22,21,3
CHIAPAS,7,OCOSINGO,059,SAN LUIS,2,177,76,101,7
CHIAPAS,7,OCOSINGO,059,SAN LUIS (GUADALUPE),2,249,116,133,9
CHIAPAS,7,OCOSINGO,059,SAN MARCOS,5,263,129,134,12
CHIAPAS,7,OCOSINGO,059,SAN MARTÍN,3,78,37,41,5
CHIAPAS,7,OCOSINGO,059,SAN MIGUEL,4,67,39,28,5
CHIAPAS,7,OCOSINGO,059,SAN MIGUEL (LA LAGUNA),1,9,3,6,1
CHIAPAS,7,OCOSINGO,059,SAN PEDRO,1,73,32,41,3
CHIAPAS,7,OCOSINGO,059,SAN PEDRO JOMALCHÉN,2,42,20,22,2
CHIAPAS,7,OCOSINGO,059,SAN PEDRO TONINA,1,19,10,9,1
CHIAPAS,7,OCOSINGO,059,SAN QUINTÍN,4,890,437,453,24
CHIAPAS,7,OCOSINGO,059,SAN RAFAEL,1,22,13,9,1
CHIAPAS,7,OCOSINGO,059,SAN SALVADOR,4,543,248,295,17
CHIAPAS,7,OCOSINGO,059,SAN SEBASTIÁN,1,47,23,24,2
CHIAPAS,7,OCOSINGO,059,SANTA ANITA,1,7,3,4,1
CHIAPAS,7,OCOSINGO,059,SANTA CRUZ,3,62,32,30,3
CHIAPAS,7,OCOSINGO,059,SANTA CRUZ CHACSÍ,1,8,3,5,1
CHIAPAS,7,OCOSINGO,059,SANTA ELENA,8,937,477,460,54
CHIAPAS,7,OCOSINGO,059,SANTA LUCÍA,3,141,69,72,8
CHIAPAS,7,OCOSINGO,059,SANTA MARÍA DE LAS FLORES,3,237,119,118,9
CHIAPAS,7,OCOSINGO,059,SANTA MARÍA DEL CARMEN,1,11,5,6,1
CHIAPAS,7,OCOSINGO,059,SANTA MARTHA COROZAL,2,156,78,78,3
CHIAPAS,7,OCOSINGO,059,SANTA RITA,4,571,272,299,17
CHIAPAS,7,OCOSINGO,059,SANTA RITA 2DA. SECCIÓN,2,84,36,48,3
CHIAPAS,7,OCOSINGO,059,SANTA ROSA,3,77,40,37,5
CHIAPAS,7,OCOSINGO,059,SANTA ROSA (OJO DE AGUA),4,145,71,74,8
CHIAPAS,7,OCOSINGO,059,SANTA TERESA,2,111,53,58,4
CHIAPAS,7,OCOSINGO,059,SANTA TERESA DOS,1,19,7,12,1
CHIAPAS,7,OCOSINGO,059,SANTO DOMINGO,4,634,305,329,20
CHIAPAS,7,OCOSINGO,059,SANTO DOMINGO GUAYAQUIL,1,36,19,17,2
CHIAPAS,7,OCOSINGO,059,SANTO TOMÁS,7,381,201,180,16
CHIAPAS,7,OCOSINGO,059,SANTO TON,3,290,128,162,9
CHIAPAS,7,OCOSINGO,059,SAQUILJA,1,20,6,14,2
CHIAPAS,7,OCOSINGO,059,SHISHINTOTIC,1,7,5,2,1
CHIAPAS,7,OCOSINGO,059,SIBACA,3,565,275,290,25
CHIAPAS,7,OCOSINGO,059,SLOQUIB CHAY,2,77,38,39,2
CHIAPAS,7,OCOSINGO,059,SLUM CH'ULTATIK,3,76,38,38,4
CHIAPAS,7,OCOSINGO,059,SUSCHILA,3,200,93,107,9
CHIAPAS,7,OCOSINGO,059,SUSCHILA NUEVO,2,100,58,42,4
CHIAPAS,7,OCOSINGO,059,TANIPERLA,6,1201,620,581,41
CHIAPAS,7,OCOSINGO,059,TENANGO,6,2101,1077,1024,71
CHIAPAS,7,OCOSINGO,059,TIERRA BLANCA,2,175,83,92,5
CHIAPAS,7,OCOSINGO,059,TIERRA NEGRA,1,43,23,20,1
CHIAPAS,7,OCOSINGO,059,TIERRA Y LIBERTAD,1,85,45,40,1
CHIAPAS,7,OCOSINGO,059,TOMÁS MUNZER (NUEVA PATRIA),3,305,149,156,12
CHIAPAS,7,OCOSINGO,059,TZACBATUL,3,407,210,197,15
CHIAPAS,7,OCOSINGO,059,TZAJALÁ,2,31,14,17,2
CHIAPAS,7,OCOSINGO,059,TZAJALOB,3,156,73,83,5
CHIAPAS,7,OCOSINGO,059,TZAJALUCUM,2,25,15,10,3
CHIAPAS,7,OCOSINGO,059,UBILIO GARCÍA,4,668,348,320,21
CHIAPAS,7,OCOSINGO,059,UJCUMILJA,3,70,28,42,4
CHIAPAS,7,OCOSINGO,059,VEINTE DE NOVIEMBRE,2,90,45,45,4
CHIAPAS,7,OCOSINGO,059,VENUSTIANO CARRANZA,4,422,195,227,17
CHIAPAS,7,OCOSINGO,059,VICENTE GUERRERO,2,86,39,47,3
CHIAPAS,7,OCOSINGO,059,VILLA LAS ROSAS,4,213,108,105,9
CHIAPAS,7,OCOSINGO,059,VILLA LOS PINOS,2,18,6,12,2
CHIAPAS,7,OCOSINGO,059,VISTA ALEGRE,3,49,24,25,4
CHIAPAS,7,OCOSINGO,059,WOY AQUIL,1,37,19,18,1
CHIAPAS,7,OCOSINGO,059,YAXALÁ,3,92,46,46,5
CHIAPAS,7,OCOSINGO,059,YAXOQUINTELÁ,2,41,24,17,2
CHIAPAS,7,OCOSINGO,059,YOC NAVIL,2,27,9,18,3
CHIAPAS,7,OCOSINGO,059,ZARAGOZA,4,750,373,377,21
CHIAPAS,7,OCOTEPEC,060,BENITO JUÁREZ,4,51,24,27,4
CHIAPAS,7,OCOTEPEC,060,CANDELARIA,1,8,4,4,1
CHIAPAS,7,OCOTEPEC,060,CERRO BLANCO,2,54,22,32,3
CHIAPAS,7,OCOTEPEC,060,CERRO DEL MONO,2,50,24,26,3
CHIAPAS,7,OCOTEPEC,060,CERRO JAQUIMA,2,98,51,47,5
CHIAPAS,7,OCOTEPEC,060,EL PARAÍSO HUACANO,2,68,31,37,4
CHIAPAS,7,OCOTEPEC,060,ESQUIPULAS,2,86,51,35,4
CHIAPAS,7,OCOTEPEC,060,GUADALUPE VICTORIA,2,84,49,35,3
CHIAPAS,7,OCOTEPEC,060,LA GRANDEZA SAN MARTÍN,3,51,28,23,3
CHIAPAS,7,OCOTEPEC,060,LAGUNILLA DEL CARMEN,1,23,12,11,1
CHIAPAS,7,OCOTEPEC,060,LÁZARO CÁRDENAS,2,21,11,10,2
CHIAPAS,7,OCOTEPEC,060,LOMAS ALEGRES,2,113,59,54,6
CHIAPAS,7,OCOTEPEC,060,LUIS ECHEVERRÍA,2,39,18,21,3
CHIAPAS,7,OCOTEPEC,060,NAZARETH,2,32,14,18,2
CHIAPAS,7,OCOTEPEC,060,OCOTEPEC,16,2038,1098,940,81
CHIAPAS,7,OCOTEPEC,060,RÍO FRÍO TOMBACK,1,15,5,10,1
CHIAPAS,7,OCOTEPEC,060,SAGRADO CORAZÓN DE JESÚS,4,120,60,60,6
CHIAPAS,7,OCOTEPEC,060,SAN ANDRÉS CARRIZAL,3,188,97,91,8
CHIAPAS,7,OCOTEPEC,060,SAN ANTONIO BUENAVISTA,2,139,86,53,6
CHIAPAS,7,OCOTEPEC,060,SAN ANTONIO DEL MONTE,2,16,6,10,2
CHIAPAS,7,OCOTEPEC,060,SAN ANTONIO POYONO,4,201,96,105,11
CHIAPAS,7,OCOTEPEC,060,SAN FRANCISCO OCOTAL,4,307,160,147,13
CHIAPAS,7,OCOTEPEC,060,SAN ISIDRO,3,155,74,81,7
CHIAPAS,7,OCOTEPEC,060,SAN JOSÉ LOMAS ALTAS,2,38,17,21,2
CHIAPAS,7,OCOTEPEC,060,SAN JOSÉ PLAN OCOTAL,2,103,44,59,4
CHIAPAS,7,OCOTEPEC,060,SAN JUAN BOSCO,2,53,29,24,2
CHIAPAS,7,OCOTEPEC,060,SAN JUDAS TADEO,2,21,10,11,2
CHIAPAS,7,OCOTEPEC,060,SAN MARCOS BUENAVISTA,4,91,46,45,6
CHIAPAS,7,OCOTEPEC,060,SAN MIGUEL DE ALLENDE,2,32,15,17,2
CHIAPAS,7,OCOTEPEC,060,SAN PABLO HUACANO,4,810,415,395,28
CHIAPAS,7,OCOTEPEC,060,SAN PEDRO,2,54,27,27,3
CHIAPAS,7,OCOTEPEC,060,SANTA LUCÍA,2,29,13,16,3
CHIAPAS,7,OCOTEPEC,060,SANTO DOMINGO,3,82,45,37,4
CHIAPAS,7,OCOZOCOAUTLA DE ESPINOSA,061,ABSALÓN CASTELLANOS DOMÍNGUEZ,3,144,71,73,7
CHIAPAS,7,OCOZOCOAUTLA DE ESPINOSA,061,ACH'LUM TIERRA NUEVA,3,229,123,106,10
CHIAPAS,7,OCOZOCOAUTLA DE ESPINOSA,061,ALFONSO MOGUEL,5,425,211,214,16
CHIAPAS,7,OCOZOCOAUTLA DE ESPINOSA,061,ALFREDO V. BONFIL,3,167,82,85,11
CHIAPAS,7,OCOZOCOAUTLA DE ESPINOSA,061,ÁLVARO OBREGÓN,2,72,37,35,3
CHIAPAS,7,OCOZOCOAUTLA DE ESPINOSA,061,AMADOR HERNÁNDEZ GONZÁLEZ,4,257,115,142,13
CHIAPAS,7,OCOZOCOAUTLA DE ESPINOSA,061,AMÉRICA LIBRE,3,210,100,110,10
CHIAPAS,7,OCOZOCOAUTLA DE ESPINOSA,061,ANDULIO GÁLVEZ VELÁZQUEZ,1,17,12,5,2
CHIAPAS,7,OCOZOCOAUTLA DE ESPINOSA,061,AQUILES SERDÁN (KILÓMETRO 38),2,29,20,9,2
CHIAPAS,7,OCOZOCOAUTLA DE ESPINOSA,061,ARMANDO ZEBADÚA,3,221,108,113,12
CHIAPAS,7,OCOZOCOAUTLA DE ESPINOSA,061,BENITO JUÁREZ,2,50,21,29,3
CHIAPAS,7,OCOZOCOAUTLA DE ESPINOSA,061,CACAHUANO,1,9,6,3,1
CHIAPAS,7,OCOZOCOAUTLA DE ESPINOSA,061,CAMPECHE,2,22,9,13,2
CHIAPAS,7,OCOZOCOAUTLA DE ESPINOSA,061,CIUDAD BONAMPAK,2,290,138,152,14
CHIAPAS,7,OCOZOCOAUTLA DE ESPINOSA,061,CNC,3,333,174,159,13
CHIAPAS,7,OCOZOCOAUTLA DE ESPINOSA,061,CUAUHTÉMOC,2,26,14,12,3
CHIAPAS,7,OCOZOCOAUTLA DE ESPINOSA,061,CUAUHTÉMOC 1RO.,2,22,11,11,3
CHIAPAS,7,OCOZOCOAUTLA DE ESPINOSA,061,DOCTOR MANUEL VELASCO SUÁREZ II,3,277,138,139,9
CHIAPAS,7,OCOZOCOAUTLA DE ESPINOSA,061,EL AGUACERO,2,124,77,47,4
CHIAPAS,7,OCOZOCOAUTLA DE ESPINOSA,061,EL ARBOLITO,2,26,14,12,3
CHIAPAS,7,OCOZOCOAUTLA DE ESPINOSA,061,EL BÁLSAMO,1,12,7,5,1
CHIAPAS,7,OCOZOCOAUTLA DE ESPINOSA,061,EL BANCO DE ARENA,2,105,49,56,3
CHIAPAS,7,OCOZOCOAUTLA DE ESPINOSA,061,EL CALVARIO,1,4,1,3,1
CHIAPAS,7,OCOZOCOAUTLA DE ESPINOSA,061,EL CARRIZAL,2,23,16,7,2
CHIAPAS,7,OCOZOCOAUTLA DE ESPINOSA,061,EL CIELITO,1,17,8,9,2
CHIAPAS,7,OCOZOCOAUTLA DE ESPINOSA,061,EL COQUITO,3,45,25,20,4
CHIAPAS,7,OCOZOCOAUTLA DE ESPINOSA,061,EL CORAZÓN MEYAPAC,1,15,7,8,1
CHIAPAS,7,OCOZOCOAUTLA DE ESPINOSA,061,EL COROZO,1,17,11,6,2
CHIAPAS,7,OCOZOCOAUTLA DE ESPINOSA,061,EL DOMINIO,3,43,21,22,4
CHIAPAS,7,OCOZOCOAUTLA DE ESPINOSA,061,EL EMBARCADERO APIC PAC,5,113,53,60,7
CHIAPAS,7,OCOZOCOAUTLA DE ESPINOSA,061,EL FORTÍN,1,5,4,1,1
CHIAPAS,7,OCOZOCOAUTLA DE ESPINOSA,061,EL GAVILÁN,3,513,249,264,20
CHIAPAS,7,OCOZOCOAUTLA DE ESPINOSA,061,EL GUAPINOLITO,1,7,5,2,1
CHIAPAS,7,OCOZOCOAUTLA DE ESPINOSA,061,EL HORIZONTE,2,79,34,45,3
CHIAPAS,7,OCOZOCOAUTLA DE ESPINOSA,061,EL JARDÍN,1,17,8,9,1
CHIAPAS,7,OCOZOCOAUTLA DE ESPINOSA,061,EL LIMÓN,2,25,13,12,3
CHIAPAS,7,OCOZOCOAUTLA DE ESPINOSA,061,EL MILAGRO,2,22,8,14,2
CHIAPAS,7,OCOZOCOAUTLA DE ESPINOSA,061,EL NARANJO (PASO EL NARANJO),1,8,4,4,1
CHIAPAS,7,OCOZOCOAUTLA DE ESPINOSA,061,EL PEJE DE ORO,1,5,3,2,1
CHIAPAS,7,OCOZOCOAUTLA DE ESPINOSA,061,EL PORVENIR,2,161,91,70,5
CHIAPAS,7,OCOZOCOAUTLA DE ESPINOSA,061,EL TESORO,3,24,16,8,3
CHIAPAS,7,OCOZOCOAUTLA DE ESPINOSA,061,EL TRIUNFO,1,4,1,3,1
CHIAPAS,7,OCOZOCOAUTLA DE ESPINOSA,061,EL TZU-TZU,2,33,11,22,2
CHIAPAS,7,OCOZOCOAUTLA DE ESPINOSA,061,EL VERGEL,1,18,11,7,2
CHIAPAS,7,OCOZOCOAUTLA DE ESPINOSA,061,EL ZAPOTE,2,27,13,14,3
CHIAPAS,7,OCOZOCOAUTLA DE ESPINOSA,061,EMILIANO ZAPATA DOS,2,46,21,25,2
CHIAPAS,7,OCOZOCOAUTLA DE ESPINOSA,061,EMILIANO ZAPATA UNO,3,80,33,47,3
CHIAPAS,7,OCOZOCOAUTLA DE ESPINOSA,061,ESPINAL DE MORELOS,4,367,177,190,13
CHIAPAS,7,OCOZOCOAUTLA DE ESPINOSA,061,FRANCISCO I. MADERO,2,136,68,68,6
CHIAPAS,7,OCOZOCOAUTLA DE ESPINOSA,061,GENERAL FRANCISCO VILLA,4,279,147,132,15
CHIAPAS,7,OCOZOCOAUTLA DE ESPINOSA,061,GUADALUPE VICTORIA,6,504,250,254,25
CHIAPAS,7,OCOZOCOAUTLA DE ESPINOSA,061,HEBERTO CASTILLO MARTÍNEZ,1,8,2,6,1
CHIAPAS,7,OCOZOCOAUTLA DE ESPINOSA,061,HERMENEGILDO GALEANA,3,292,148,144,11
CHIAPAS,7,OCOZOCOAUTLA DE ESPINOSA,061,IGNACIO ZARAGOZA (EL MORRO),5,722,379,343,29
CHIAPAS,7,OCOZOCOAUTLA DE ESPINOSA,061,INDIO ZOQUE,1,11,5,6,1
CHIAPAS,7,OCOZOCOAUTLA DE ESPINOSA,061,JOSÉ CASTILLO TIELMANS,3,103,54,49,6
CHIAPAS,7,OCOZOCOAUTLA DE ESPINOSA,061,JOSÉ LÓPEZ PORTILLO,2,115,63,52,4
CHIAPAS,7,OCOZOCOAUTLA DE ESPINOSA,061,JOSÉ MARÍA MORELOS Y PAVÓN,3,230,112,118,9
CHIAPAS,7,OCOZOCOAUTLA DE ESPINOSA,061,JUAN DE GRIJALVA,4,307,146,161,11
CHIAPAS,7,OCOZOCOAUTLA DE ESPINOSA,061,JUAN DE GRIJALVA DOS,1,10,6,4,1
CHIAPAS,7,OCOZOCOAUTLA DE ESPINOSA,061,LA CANDELARIA,2,25,8,17,3
CHIAPAS,7,OCOZOCOAUTLA DE ESPINOSA,061,LA CEIBA,1,6,5,1,1
CHIAPAS,7,OCOZOCOAUTLA DE ESPINOSA,061,LA CHICHARRA,1,7,3,4,1
CHIAPAS,7,OCOZOCOAUTLA DE ESPINOSA,061,LA CIÉNEGA,1,23,11,12,2
CHIAPAS,7,OCOZOCOAUTLA DE ESPINOSA,061,LA CLÍNICA,2,66,39,27,3
CHIAPAS,7,OCOZOCOAUTLA DE ESPINOSA,061,LA COLMENA,3,69,36,33,6
CHIAPAS,7,OCOZOCOAUTLA DE ESPINOSA,061,LA CUMBRE,1,6,2,4,1
CHIAPAS,7,OCOZOCOAUTLA DE ESPINOSA,061,LA ESPERANZA,4,104,60,44,5
CHIAPAS,7,OCOZOCOAUTLA DE ESPINOSA,061,LA GLORIA,1,15,9,6,1
CHIAPAS,7,OCOZOCOAUTLA DE ESPINOSA,061,LA INDEPENDENCIA (LAS PILAS),2,214,114,100,7
CHIAPAS,7,OCOZOCOAUTLA DE ESPINOSA,061,LA LIBERTAD,2,69,40,29,5
CHIAPAS,7,OCOZOCOAUTLA DE ESPINOSA,061,LA LUCHA,3,124,57,67,4
CHIAPAS,7,OCOZOCOAUTLA DE ESPINOSA,061,LA MAJADA,2,52,27,25,2
CHIAPAS,7,OCOZOCOAUTLA DE ESPINOSA,061,LA NARANJA,4,145,75,70,6
CHIAPAS,7,OCOZOCOAUTLA DE ESPINOSA,061,LA SELVA,1,10,6,4,1
CHIAPAS,7,OCOZOCOAUTLA DE ESPINOSA,061,LA VENTA,1,62,26,36,2
CHIAPAS,7,OCOZOCOAUTLA DE ESPINOSA,061,LA VICTORIA,2,24,10,14,3
CHIAPAS,7,OCOZOCOAUTLA DE ESPINOSA,061,LAS AMAPOLAS,1,19,8,11,2
CHIAPAS,7,OCOZOCOAUTLA DE ESPINOSA,061,LAS CABAÑAS,1,15,9,6,2
CHIAPAS,7,OCOZOCOAUTLA DE ESPINOSA,061,LAS CAMELIAS,1,17,8,9,2
CHIAPAS,7,OCOZOCOAUTLA DE ESPINOSA,061,LAS FLORES,3,93,56,37,5
CHIAPAS,7,OCOZOCOAUTLA DE ESPINOSA,061,LAS PALMERAS,1,4,2,2,1
CHIAPAS,7,OCOZOCOAUTLA DE ESPINOSA,061,LAS PIMIENTAS,4,475,232,243,19
CHIAPAS,7,OCOZOCOAUTLA DE ESPINOSA,061,LÁZARO CÁRDENAS,3,120,61,59,7
CHIAPAS,7,OCOZOCOAUTLA DE ESPINOSA,061,LINDAVISTA,4,154,69,85,10
CHIAPAS,7,OCOZOCOAUTLA DE ESPINOSA,061,LLANO SAN JUAN,2,837,300,537,188
CHIAPAS,7,OCOZOCOAUTLA DE ESPINOSA,061,LOS CAPULINES,1,14,7,7,1
CHIAPAS,7,OCOZOCOAUTLA DE ESPINOSA,061,LOS COCOS,2,15,5,10,2
CHIAPAS,7,OCOZOCOAUTLA DE ESPINOSA,061,LUCIO CABAÑAS BARRIENTOS,5,311,143,168,15
CHIAPAS,7,OCOZOCOAUTLA DE ESPINOSA,061,LUIS ECHEVERRÍA (AGUA BLANCA),4,262,129,133,11
CHIAPAS,7,OCOZOCOAUTLA DE ESPINOSA,061,MONTE DE LOS OLIVOS,2,14,8,6,2
CHIAPAS,7,OCOZOCOAUTLA DE ESPINOSA,061,NAMBIMBO,3,50,28,22,4
CHIAPAS,7,OCOZOCOAUTLA DE ESPINOSA,061,NICOLÁS BRAVO,2,108,54,54,4
CHIAPAS,7,OCOZOCOAUTLA DE ESPINOSA,061,NINGUNO [EMILIO O. RABASA],2,14,5,9,2
CHIAPAS,7,OCOZOCOAUTLA DE ESPINOSA,061,NUEVA BETANIA (NUEVO SIVACAL),3,22,13,9,3
CHIAPAS,7,OCOZOCOAUTLA DE ESPINOSA,061,NUEVO EMBARCADERO APIC PAC (SANTA LAURA),1,25,15,10,1
CHIAPAS,7,OCOZOCOAUTLA DE ESPINOSA,061,NUEVO JALAPA (TAPUMBAC),3,65,32,33,4
CHIAPAS,7,OCOZOCOAUTLA DE ESPINOSA,061,NUEVO JERUSALÉN,3,53,26,27,3
CHIAPAS,7,OCOZOCOAUTLA DE ESPINOSA,061,NUEVO MEZCALAPA,3,245,117,128,10
CHIAPAS,7,OCOZOCOAUTLA DE ESPINOSA,061,NUEVO SAN ANTONIO,3,92,57,35,5
CHIAPAS,7,OCOZOCOAUTLA DE ESPINOSA,061,NUEVO SAN JUAN CHAMULA,4,318,161,157,12
CHIAPAS,7,OCOZOCOAUTLA DE ESPINOSA,061,NUEVO SAN LUIS,2,16,5,11,2
CHIAPAS,7,OCOZOCOAUTLA DE ESPINOSA,061,NUEVO SIMOJOVEL,3,112,62,50,6
CHIAPAS,7,OCOZOCOAUTLA DE ESPINOSA,061,OCOZOCOAUTLA DE ESPINOSA,56,12804,6608,6196,662
CHIAPAS,7,OCOZOCOAUTLA DE ESPINOSA,061,OCUILAPA DE JUÁREZ,5,1427,724,703,46
CHIAPAS,7,OCOZOCOAUTLA DE ESPINOSA,061,OJO DE AGUA,2,114,62,52,6
CHIAPAS,7,OCOZOCOAUTLA DE ESPINOSA,061,PIEDRA PARADA,4,130,67,63,9
CHIAPAS,7,OCOZOCOAUTLA DE ESPINOSA,061,PLUMA DE ORO,3,200,107,93,10
CHIAPAS,7,OCOZOCOAUTLA DE ESPINOSA,061,POZO SAGRADO,2,31,24,7,3
CHIAPAS,7,OCOZOCOAUTLA DE ESPINOSA,061,PUENTE CHIAPAS,1,46,25,21,3
CHIAPAS,7,OCOZOCOAUTLA DE ESPINOSA,061,PUERTO RICO,2,10,4,6,2
CHIAPAS,7,OCOZOCOAUTLA DE ESPINOSA,061,REFORMA LA UNIÓN,1,10,6,4,1
CHIAPAS,7,OCOZOCOAUTLA DE ESPINOSA,061,RIVERA DE DOMÍNGUEZ (LA NAVIDAD),1,7,4,3,1
CHIAPAS,7,OCOZOCOAUTLA DE ESPINOSA,061,RIZO DE ORO,1,4,2,2,1
CHIAPAS,7,OCOZOCOAUTLA DE ESPINOSA,061,SALINA CRUZ,3,55,29,26,3
CHIAPAS,7,OCOZOCOAUTLA DE ESPINOSA,061,SALVADOR URBINA,2,91,43,48,4
CHIAPAS,7,OCOZOCOAUTLA DE ESPINOSA,061,SAN ANDRÉS,2,125,63,62,6
CHIAPAS,7,OCOZOCOAUTLA DE ESPINOSA,061,SAN ANTONIO EL BAJÍO,2,61,33,28,3
CHIAPAS,7,OCOZOCOAUTLA DE ESPINOSA,061,SAN ANTONIO MAGUEYAL,3,84,35,49,6
CHIAPAS,7,OCOZOCOAUTLA DE ESPINOSA,061,SAN ANTONIO TEXAS,2,73,41,32,3
CHIAPAS,7,OCOZOCOAUTLA DE ESPINOSA,061,SAN FRANCISCO,2,63,30,33,4
CHIAPAS,7,OCOZOCOAUTLA DE ESPINOSA,061,SAN ISIDRO CARRIZAL,2,85,38,47,3
CHIAPAS,7,OCOZOCOAUTLA DE ESPINOSA,061,SAN JOAQUÍN,1,6,6,0,1
CHIAPAS,7,OCOZOCOAUTLA DE ESPINOSA,061,SAN JOAQUÍN EL ROSARIO,1,5,3,2,1
CHIAPAS,7,OCOZOCOAUTLA DE ESPINOSA,061,SAN JORGE (EL DIECIOCHO),2,34,22,12,3
CHIAPAS,7,OCOZOCOAUTLA DE ESPINOSA,061,SAN MIGUEL,1,180,86,94,7
CHIAPAS,7,OCOZOCOAUTLA DE ESPINOSA,061,SAN PEDRO LA REFORMA,2,14,5,9,2
CHIAPAS,7,OCOZOCOAUTLA DE ESPINOSA,061,SAN RAFAEL,1,9,5,4,1
CHIAPAS,7,OCOZOCOAUTLA DE ESPINOSA,061,SAN RAMÓN (LA CANDELARIA),1,551,255,296,18
CHIAPAS,7,OCOZOCOAUTLA DE ESPINOSA,061,SANTA FE,1,43,20,23,2
CHIAPAS,7,OCOZOCOAUTLA DE ESPINOSA,061,SANTA ISABEL,1,38,19,19,2
CHIAPAS,7,OCOZOCOAUTLA DE ESPINOSA,061,SANTA RITA,1,9,5,4,1
CHIAPAS,7,OCOZOCOAUTLA DE ESPINOSA,061,SOLO DIOS,1,19,8,11,2
CHIAPAS,7,OCOZOCOAUTLA DE ESPINOSA,061,TABLÓN SONORA,1,15,6,9,1
CHIAPAS,7,OCOZOCOAUTLA DE ESPINOSA,061,UNIÓN ZARAGOZA,3,99,45,54,4
CHIAPAS,7,OCOZOCOAUTLA DE ESPINOSA,061,VALLE DE CORZO (LA INDUSTRIA),2,25,14,11,2
CHIAPAS,7,OCOZOCOAUTLA DE ESPINOSA,061,VEINTE CASAS,2,64,34,30,3
CHIAPAS,7,OCOZOCOAUTLA DE ESPINOSA,061,VEINTE DE JUNIO (LA CEIBA),2,26,13,13,2
CHIAPAS,7,OCOZOCOAUTLA DE ESPINOSA,061,VELASCO SUÁREZ UNO,3,192,102,90,8
CHIAPAS,7,OCOZOCOAUTLA DE ESPINOSA,061,VENUSTIANO CARRANZA,2,66,32,34,3
CHIAPAS,7,OCOZOCOAUTLA DE ESPINOSA,061,VERAPAZ DOS,1,8,2,6,1
CHIAPAS,7,OCOZOCOAUTLA DE ESPINOSA,061,VICENTE GUERRERO (MATAMOROS),5,789,410,379,31
CHIAPAS,7,OCOZOCOAUTLA DE ESPINOSA,061,VILLAHERMOSA,2,457,212,245,14
CHIAPAS,7,OCOZOCOAUTLA DE ESPINOSA,061,VILLAHERMOSA (REYMUNDO ENRÍQUEZ),2,188,104,84,9
CHIAPAS,7,OCOZOCOAUTLA DE ESPINOSA,061,VISTAHERMOSA,1,13,6,7,1
CHIAPAS,7,OCOZOCOAUTLA DE ESPINOSA,061,YOKWITZ,1,25,9,16,1
CHIAPAS,7,OSTUACÁN,062,ALTO AMACOITE 2DA. SECCIÓN,5,51,30,21,7
CHIAPAS,7,OSTUACÁN,062,ALTO AMACOÍTE 3RA. SECCIÓN,1,10,3,7,1
CHIAPAS,7,OSTUACÁN,062,ANTONIO LEÓN,3,59,28,31,4
CHIAPAS,7,OSTUACÁN,062,BAJO AMACOÍTE,3,75,31,44,5
CHIAPAS,7,OSTUACÁN,062,CANDELARIA,1,24,13,11,3
CHIAPAS,7,OSTUACÁN,062,CATEDRAL 1RA. SECCIÓN,2,37,21,16,2
CHIAPAS,7,OSTUACÁN,062,CATEDRAL 2DA. SECCIÓN,1,5,4,1,1
CHIAPAS,7,OSTUACÁN,062,CATEDRAL DE CHIAPAS,3,175,82,93,8
CHIAPAS,7,OSTUACÁN,062,COPANO 1RA. SECCIÓN,3,44,24,20,4
CHIAPAS,7,OSTUACÁN,062,COPANO 2DA. SECCIÓN,6,74,38,36,7
CHIAPAS,7,OSTUACÁN,062,CUAUHTÉMOC,4,132,57,75,7
CHIAPAS,7,OSTUACÁN,062,EL LLANO,3,32,15,17,4
CHIAPAS,7,OSTUACÁN,062,EL PROGRESO,1,8,2,6,1
CHIAPAS,7,OSTUACÁN,062,EL TRIUNFO,4,40,26,14,5
CHIAPAS,7,OSTUACÁN,062,JUAN DEL GRIJALVA,3,298,148,150,14
CHIAPAS,7,OSTUACÁN,062,LA PEÑA 1RA. SECCIÓN,1,11,5,6,1
CHIAPAS,7,OSTUACÁN,062,LA PEÑA 2DA. SECCIÓN,1,4,3,1,1
CHIAPAS,7,OSTUACÁN,062,LAGUNA ABAJO,2,27,16,11,3
CHIAPAS,7,OSTUACÁN,062,LAGUNA ARRIBA,3,34,15,19,3
CHIAPAS,7,OSTUACÁN,062,LAGUNA LA CAMPANA,2,31,13,18,2
CHIAPAS,7,OSTUACÁN,062,LÁZARO CÁRDENAS,3,86,39,47,5
CHIAPAS,7,OSTUACÁN,062,LINDAVISTA,3,267,130,137,12
CHIAPAS,7,OSTUACÁN,062,LOMA BONITA,2,23,11,12,3
CHIAPAS,7,OSTUACÁN,062,LOS ALTOS DE PLAYA LARGA,2,15,7,8,2
CHIAPAS,7,OSTUACÁN,062,MASPAC ARRIBA 2DA. SECCIÓN,2,9,5,4,2
CHIAPAS,7,OSTUACÁN,062,MASPAC ARRIBA 3RA. SECCIÓN,3,34,12,22,3
CHIAPAS,7,OSTUACÁN,062,MUSPAC,3,24,9,15,3
CHIAPAS,7,OSTUACÁN,062,NUEVO EMILIANO ZAPATA,3,54,27,27,3
CHIAPAS,7,OSTUACÁN,062,NUEVO GUADALUPE VICTORIA,3,149,67,82,8
CHIAPAS,7,OSTUACÁN,062,NUEVO JUAN DEL GRIJALVA,3,334,171,163,32
CHIAPAS,7,OSTUACÁN,062,NUEVO MILENIO,1,37,18,19,3
CHIAPAS,7,OSTUACÁN,062,NUEVO PEÑITAS,4,121,53,68,8
CHIAPAS,7,OSTUACÁN,062,NUEVO SAYULA,3,81,34,47,5
CHIAPAS,7,OSTUACÁN,062,NUEVO XOCHIMILCO,3,539,272,267,22
CHIAPAS,7,OSTUACÁN,062,OSTUACÁN,7,1056,541,515,62
CHIAPAS,7,OSTUACÁN,062,PARAÍSO 1RA. SECCIÓN,2,19,9,10,2
CHIAPAS,7,OSTUACÁN,062,PARAÍSO 2DA. SECCIÓN,3,68,29,39,5
CHIAPAS,7,OSTUACÁN,062,PARAÍSO 3RA. SECCIÓN,3,26,14,12,3
CHIAPAS,7,OSTUACÁN,062,PARAÍSO SAN ANTONIO,1,11,6,5,1
CHIAPAS,7,OSTUACÁN,062,PEÑITAS EL MICO,4,70,38,32,4
CHIAPAS,7,OSTUACÁN,062,PLAN DE AYALA,5,703,324,379,33
CHIAPAS,7,OSTUACÁN,062,PLAYA DE PIEDRA 1RA. SECCIÓN,4,35,16,19,3
CHIAPAS,7,OSTUACÁN,062,PLAYA LARGA 1RA. SECCIÓN,5,129,60,69,8
CHIAPAS,7,OSTUACÁN,062,PLAYA LARGA 3RA. SECCIÓN,5,64,30,34,6
CHIAPAS,7,OSTUACÁN,062,SAN ANTONIO,1,5,1,4,1
CHIAPAS,7,OSTUACÁN,062,SAN LORENZO,2,12,6,6,2
CHIAPAS,7,OSTUACÁN,062,XOCHIMILCO (REYMUNDO ENRÍQUEZ),4,332,161,171,16
CHIAPAS,7,OSUMACINTA,063,CANDELARIA,2,9,4,5,2
CHIAPAS,7,OSUMACINTA,063,EL PARAÍSO,2,25,12,13,2
CHIAPAS,7,OSUMACINTA,063,LA SOMBRA,2,7,4,3,2
CHIAPAS,7,OSUMACINTA,063,LIBERTAD CAMPESINA,3,308,155,153,11
CHIAPAS,7,OSUMACINTA,063,NUEVA ESPERANZA,3,71,33,38,5
CHIAPAS,7,OSUMACINTA,063,OSUMACINTA,4,523,228,295,28
CHIAPAS,7,OSUMACINTA,063,SONORA,2,11,4,7,1
CHIAPAS,7,OSUMACINTA,063,TRIUNFO AGRARISTA,3,137,72,65,7
CHIAPAS,7,OXCHUC,064,16 DE SEPTIEMBRE,2,52,24,28,3
CHIAPAS,7,OXCHUC,064,AGUA AZUL,2,54,24,30,3
CHIAPAS,7,OXCHUC,064,AJTEALJÁ,1,6,3,3,1
CHIAPAS,7,OXCHUC,064,AMAYILJÁ,2,45,18,27,4
CHIAPAS,7,OXCHUC,064,AMAYILJÁ II,2,32,22,10,2
CHIAPAS,7,OXCHUC,064,BAJCHÉN,2,63,26,37,4
CHIAPAS,7,OXCHUC,064,BALAXIL,2,51,29,22,3
CHIAPAS,7,OXCHUC,064,BAWITS,2,46,26,20,3
CHIAPAS,7,OXCHUC,064,BELLA VISTA,2,40,20,20,4
CHIAPAS,7,OXCHUC,064,BENITO JUÁREZ,4,520,269,251,14
CHIAPAS,7,OXCHUC,064,BIQUIT LEJLEM,2,116,46,70,3
CHIAPAS,7,OXCHUC,064,BUENAVISTA,4,145,79,66,7
CHIAPAS,7,OXCHUC,064,BUMILJA,3,254,132,122,10
CHIAPAS,7,OXCHUC,064,CENTRO TIAKIL-SANTO TOMÁS,3,181,89,92,8
CHIAPAS,7,OXCHUC,064,CHACAMUC,2,79,36,43,3
CHIAPAS,7,OXCHUC,064,CHALAM JATATEAL,2,61,22,39,3
CHIAPAS,7,OXCHUC,064,CHAONIL,3,255,116,139,9
CHIAPAS,7,OXCHUC,064,CHENCHAUC,1,45,27,18,2
CHIAPAS,7,OXCHUC,064,CHENCO,1,12,8,4,1
CHIAPAS,7,OXCHUC,064,CHEN'PAKINTE (CORRALITO),1,8,4,4,1
CHIAPAS,7,OXCHUC,064,CHIJTAL,2,13,5,8,2
CHIAPAS,7,OXCHUC,064,CHIKPOMILJÁ,2,75,27,48,3
CHIAPAS,7,OXCHUC,064,CHOLOL,2,82,46,36,4
CHIAPAS,7,OXCHUC,064,CHULNA,3,497,259,238,15
CHIAPAS,7,OXCHUC,064,CONOILJA,3,138,81,57,7
CHIAPAS,7,OXCHUC,064,CRUZ AJILJÁ,1,5,2,3,1
CHIAPAS,7,OXCHUC,064,CRUZILJA (MEDIA LUNA),2,95,43,52,7
CHIAPAS,7,OXCHUC,064,CRUZTÓN,4,502,237,265,18
CHIAPAS,7,OXCHUC,064,EL ARENAL,2,12,8,4,2
CHIAPAS,7,OXCHUC,064,EL CALVARIO,3,92,44,48,5
CHIAPAS,7,OXCHUC,064,EL CIPRÉS,3,56,26,30,6
CHIAPAS,7,OXCHUC,064,EL CORRALITO,4,872,423,449,28
CHIAPAS,7,OXCHUC,064,EL EDÉN,3,52,25,27,4
CHIAPAS,7,OXCHUC,064,EL MASH,5,269,137,132,12
CHIAPAS,7,OXCHUC,064,EL MIRADOR,3,53,23,30,4
CHIAPAS,7,OXCHUC,064,EL NIZ,4,643,311,332,18
CHIAPAS,7,OXCHUC,064,EL PARAÍSO,2,98,48,50,5
CHIAPAS,7,OXCHUC,064,EL POZO,2,50,17,33,4
CHIAPAS,7,OXCHUC,064,EL RETIRO,3,256,134,122,10
CHIAPAS,7,OXCHUC,064,EL TZAY,4,800,396,404,24
CHIAPAS,7,OXCHUC,064,ELUMILJÁ,2,56,30,26,5
CHIAPAS,7,OXCHUC,064,GUADALUPE,2,59,32,27,3
CHIAPAS,7,OXCHUC,064,GUADALUPE BACJA,3,422,213,209,13
CHIAPAS,7,OXCHUC,064,GUADALUPE XOIXMAL,2,106,50,56,3
CHIAPAS,7,OXCHUC,064,IJK'ALAJAW,2,53,29,24,2
CHIAPAS,7,OXCHUC,064,JAMCÓSH,4,255,117,138,12
CHIAPAS,7,OXCHUC,064,JITÓN,2,51,22,29,5
CHIAPAS,7,OXCHUC,064,JOBILTÓN,2,93,52,41,4
CHIAPAS,7,OXCHUC,064,JOYTÓN,1,49,27,22,2
CHIAPAS,7,OXCHUC,064,JUTUBÁ,2,96,47,49,4
CHIAPAS,7,OXCHUC,064,KISTOLJÁ,2,39,21,18,3
CHIAPAS,7,OXCHUC,064,KOLOL,3,52,29,23,5
CHIAPAS,7,OXCHUC,064,KULAK'TE,2,50,30,20,5
CHIAPAS,7,OXCHUC,064,LA CUMBRE,1,12,5,7,1
CHIAPAS,7,OXCHUC,064,LA FRONTERA,2,58,29,29,4
CHIAPAS,7,OXCHUC,064,LA PROVIDENCIA,1,10,6,4,1
CHIAPAS,7,OXCHUC,064,LAGUNA ESPINAL,2,16,4,12,2
CHIAPAS,7,OXCHUC,064,LAS CAÑADAS,4,88,40,48,6
CHIAPAS,7,OXCHUC,064,LAS FLORES,1,9,4,5,1
CHIAPAS,7,OXCHUC,064,LAS PALMAS,2,61,31,30,5
CHIAPAS,7,OXCHUC,064,LELENCHIJ,3,664,335,329,33
CHIAPAS,7,OXCHUC,064,LOMENLUM,2,20,7,13,2
CHIAPAS,7,OXCHUC,064,MANZANAILJÁ,2,92,45,47,3
CHIAPAS,7,OXCHUC,064,MESBILJA,4,1025,539,486,41
CHIAPAS,7,OXCHUC,064,MONTEBELLO,1,44,16,28,3
CHIAPAS,7,OXCHUC,064,MUK'UL WITZ,2,34,13,21,4
CHIAPAS,7,OXCHUC,064,MUK'UL WITZ II,3,25,14,11,3
CHIAPAS,7,OXCHUC,064,NAJÁ,2,40,19,21,2
CHIAPAS,7,OXCHUC,064,NAT'ILTON,3,33,18,15,4
CHIAPAS,7,OXCHUC,064,NAVIL,3,291,148,143,9
CHIAPAS,7,OXCHUC,064,NAVIL TAPJA,2,99,40,59,4
CHIAPAS,7,OXCHUC,064,NUEVA BETANIA,6,221,105,116,12
CHIAPAS,7,OXCHUC,064,NUEVA ESPERANZA,2,73,34,39,3
CHIAPAS,7,OXCHUC,064,NUEVA MARAVILLA,2,49,25,24,2
CHIAPAS,7,OXCHUC,064,NUEVO SAN RAMÓN,1,19,6,13,1
CHIAPAS,7,OXCHUC,064,OJO DE AGUA,3,27,13,14,3
CHIAPAS,7,OXCHUC,064,OK'OCH NAJT'IL WITS,2,21,11,10,2
CHIAPAS,7,OXCHUC,064,OXCHUC,23,5286,2648,2638,228
CHIAPAS,7,OXCHUC,064,PACVILNÁ,3,347,162,185,12
CHIAPAS,7,OXCHUC,064,PAMAL NAVIL,2,96,54,42,3
CHIAPAS,7,OXCHUC,064,PATRIA NUEVA,2,28,14,14,3
CHIAPAS,7,OXCHUC,064,PAXTONTICJÁ,6,510,257,253,21
CHIAPAS,7,OXCHUC,064,PETMAXTIC,2,19,9,10,2
CHIAPAS,7,OXCHUC,064,PIEDRA ESCRITA,2,154,80,74,5
CHIAPAS,7,OXCHUC,064,PILALCHÉN,2,14,5,9,2
CHIAPAS,7,OXCHUC,064,PINO SUÁREZ,1,23,13,10,1
CHIAPAS,7,OXCHUC,064,PORVENIR,7,258,118,140,16
CHIAPAS,7,OXCHUC,064,POZO DE PIEDRA,2,66,33,33,5
CHIAPAS,7,OXCHUC,064,PUILJÁ,2,250,143,107,8
CHIAPAS,7,OXCHUC,064,RANCHO DEL CURA,5,675,324,351,23
CHIAPAS,7,OXCHUC,064,SAK MUK'ULJÁ,1,4,2,2,1
CHIAPAS,7,OXCHUC,064,SAK'IICH'EN,2,26,17,9,3
CHIAPAS,7,OXCHUC,064,SAKLUMILJÁ,2,130,71,59,5
CHIAPAS,7,OXCHUC,064,SAN JUAN,2,37,23,14,3
CHIAPAS,7,OXCHUC,064,SAN JUAN DEL VALLE,2,64,27,37,4
CHIAPAS,7,OXCHUC,064,SAN MARCOS,2,40,24,16,2
CHIAPAS,7,OXCHUC,064,SANTA CRUZ,2,113,63,50,4
CHIAPAS,7,OXCHUC,064,SANTA TERESA LA REFORMA,1,66,33,33,3
CHIAPAS,7,OXCHUC,064,SANTO DOMINGO,2,119,65,54,5
CHIAPAS,7,OXCHUC,064,SILAILJA,2,75,33,42,3
CHIAPAS,7,OXCHUC,064,STENLEJ AKIL,2,125,64,61,4
CHIAPAS,7,OXCHUC,064,STENLEJTUL,2,66,41,25,4
CHIAPAS,7,OXCHUC,064,TAJALTIK,3,67,33,34,7
CHIAPAS,7,OXCHUC,064,TEJK'ABALCH'EN,2,96,42,54,3
CHIAPAS,7,OXCHUC,064,TIAKIL,2,86,45,41,4
CHIAPAS,7,OXCHUC,064,TIERRA BLANCA,1,17,12,5,2
CHIAPAS,7,OXCHUC,064,TOLBILJÁ,4,650,344,306,18
CHIAPAS,7,OXCHUC,064,TS'AKUITIC,1,8,4,4,1
CHIAPAS,7,OXCHUC,064,TUXAQUILJÁ,4,273,130,143,11
CHIAPAS,7,OXCHUC,064,TZACUBILJA,2,129,57,72,4
CHIAPAS,7,OXCHUC,064,TZAJALCHÉN,2,123,61,62,4
CHIAPAS,7,OXCHUC,064,TZAJALOCOCH,2,40,22,18,4
CHIAPAS,7,OXCHUC,064,TZIBULTIK,1,20,8,12,1
CHIAPAS,7,OXCHUC,064,TZONTEALJA,3,1031,521,510,27
CHIAPAS,7,OXCHUC,064,TZOPILJA,6,824,415,409,30
CHIAPAS,7,OXCHUC,064,TZUNÚN,3,235,119,116,13
CHIAPAS,7,OXCHUC,064,TZUNUNILJÁ,2,87,35,52,5
CHIAPAS,7,OXCHUC,064,TZUTILJÁ,2,54,24,30,3
CHIAPAS,7,OXCHUC,064,VISTAHERMOSA,1,15,9,6,1
CHIAPAS,7,OXCHUC,064,XENEN,2,169,81,88,6
CHIAPAS,7,OXCHUC,064,XLOCATÓN,2,73,36,37,4
CHIAPAS,7,OXCHUC,064,YA'AL OKIL,2,59,35,24,4
CHIAPAS,7,OXCHUC,064,YAALCOTZ,2,42,21,21,2
CHIAPAS,7,OXCHUC,064,YANCHENILJÁ,2,96,51,45,5
CHIAPAS,7,OXCHUC,064,YOSHIB,9,1966,1010,956,94
CHIAPAS,7,OXCHUC,064,YUT LUMILJÁ,3,47,18,29,5
CHIAPAS,7,PALENQUE,065,20 DE FEBRERO,2,46,21,25,2
CHIAPAS,7,PALENQUE,065,20 DE NOVIEMBRE,3,129,62,67,7
CHIAPAS,7,PALENQUE,065,30 DE MARZO (EL VERGEL),2,69,34,35,3
CHIAPAS,7,PALENQUE,065,5 DE MAYO,2,55,32,23,3
CHIAPAS,7,PALENQUE,065,ACH'LUM MAYA,2,55,29,26,3
CHIAPAS,7,PALENQUE,065,ACH'LUM SAN MARCOS,3,66,31,35,6
CHIAPAS,7,PALENQUE,065,ADOLFO LÓPEZ MATEOS,2,69,35,34,3
CHIAPAS,7,PALENQUE,065,AGUA BLANCA SERRANÍA,4,861,424,437,32
CHIAPAS,7,PALENQUE,065,AGUA CRISTALINA,2,126,62,64,5
CHIAPAS,7,PALENQUE,065,ALFONSO CORONA DEL ROSAL,3,167,86,81,8
CHIAPAS,7,PALENQUE,065,ALFREDO V. BONFIL,3,120,57,63,6
CHIAPAS,7,PALENQUE,065,ÁLVARO OBREGÓN,2,89,43,46,4
CHIAPAS,7,PALENQUE,065,AMPLIACIÓN BENITO JUÁREZ,1,11,6,5,1
CHIAPAS,7,PALENQUE,065,AMPLIACIÓN PALENQUE,2,31,13,18,3
CHIAPAS,7,PALENQUE,065,ÁNGEL ALBINO CORZO 1RA. SECCIÓN,3,100,52,48,6
CHIAPAS,7,PALENQUE,065,ÁNGEL ALBINO CORZO 2DA. SECCIÓN,2,83,39,44,3
CHIAPAS,7,PALENQUE,065,ANTIOQUÍA,2,144,74,70,7
CHIAPAS,7,PALENQUE,065,ARIMATEA,3,458,210,248,17
CHIAPAS,7,PALENQUE,065,ARROYO BELÉN,2,68,32,36,3
CHIAPAS,7,PALENQUE,065,ARROYO ENCANTO II,1,7,3,4,1
CHIAPAS,7,PALENQUE,065,ARROYO JERUSALÉN,3,173,89,84,7
CHIAPAS,7,PALENQUE,065,AUGUSTO GÓMEZ VILLANUEVA,3,146,79,67,6
CHIAPAS,7,PALENQUE,065,AZTECA,2,15,9,6,2
CHIAPAS,7,PALENQUE,065,BABILONIA,2,197,91,106,7
CHIAPAS,7,PALENQUE,065,BABILONIA 1RA. SECCIÓN,3,194,95,99,10
CHIAPAS,7,PALENQUE,065,BABILONIA 3RA. SECCIÓN,2,110,50,60,5
CHIAPAS,7,PALENQUE,065,BAJADAS GRANDES,4,426,224,202,19
CHIAPAS,7,PALENQUE,065,BELISARIO DOMÍNGUEZ NORTE,4,168,79,89,10
CHIAPAS,7,PALENQUE,065,BENITO JUÁREZ,3,88,43,45,5
CHIAPAS,7,PALENQUE,065,BEREA,2,90,50,40,3
CHIAPAS,7,PALENQUE,065,BOCA DE CHANCALA,3,150,70,80,9
CHIAPAS,7,PALENQUE,065,CALATRABA,3,78,43,35,6
CHIAPAS,7,PALENQUE,065,CHACAMAX,3,91,44,47,6
CHIAPAS,7,PALENQUE,065,CHANCALA RÍO SECO,2,35,14,21,2
CHIAPAS,7,PALENQUE,065,CHANCALA ZAPOTE,2,47,25,22,3
CHIAPAS,7,PALENQUE,065,CHOCOLJAÍTO,4,139,67,72,9
CHIAPAS,7,PALENQUE,065,CIUDAD AGRARIA,3,96,51,45,7
CHIAPAS,7,PALENQUE,065,COLONIA GONZÁLEZ,2,53,20,33,4
CHIAPAS,7,PALENQUE,065,CUAUHTÉMOC CÁRDENAS,2,39,18,21,2
CHIAPAS,7,PALENQUE,065,CUAUHTÉMOC CHANCALA (EL GUANAL),2,103,54,49,4
CHIAPAS,7,PALENQUE,065,DIVISIÓN DEL NORTE,2,20,17,3,2
CHIAPAS,7,PALENQUE,065,DOCTOR MANUEL VELASCO SUÁREZ,2,71,37,34,3
CHIAPAS,7,PALENQUE,065,DOCTOR SAMUEL LEÓN BRINDIS,4,678,355,323,27
CHIAPAS,7,PALENQUE,065,EBEN EZER,3,170,76,94,6
CHIAPAS,7,PALENQUE,065,EJIDO PALENQUE,1,16,9,7,1
CHIAPAS,7,PALENQUE,065,EL BASCÁN 2DA. SECCIÓN,2,33,15,18,2
CHIAPAS,7,PALENQUE,065,EL CHINAL,6,235,119,116,13
CHIAPAS,7,PALENQUE,065,EL CLAVO,3,208,100,108,11
CHIAPAS,7,PALENQUE,065,EL DESIERTO,3,159,80,79,7
CHIAPAS,7,PALENQUE,065,EL EDÉN,3,344,164,180,12
CHIAPAS,7,PALENQUE,065,EL ESPEJO,3,35,13,22,4
CHIAPAS,7,PALENQUE,065,EL ESQUINERO,3,37,22,15,4
CHIAPAS,7,PALENQUE,065,EL GUAYACÁN,1,19,9,10,2
CHIAPAS,7,PALENQUE,065,EL LACANDÓN,2,53,30,23,3
CHIAPAS,7,PALENQUE,065,EL LIMONAR,2,13,3,10,2
CHIAPAS,7,PALENQUE,065,EL NARANJAL,2,11,6,5,2
CHIAPAS,7,PALENQUE,065,EL NARANJO,3,339,153,186,12
CHIAPAS,7,PALENQUE,065,EL PALMAR,1,6,3,3,1
CHIAPAS,7,PALENQUE,065,EL PALMAR 1RA. SECCIÓN,1,21,12,9,2
CHIAPAS,7,PALENQUE,065,EL PALMAR 2DA. SECCIÓN,3,96,48,48,5
CHIAPAS,7,PALENQUE,065,EL PORVENIR,2,60,31,29,3
CHIAPAS,7,PALENQUE,065,EL PROGRESO,2,191,105,86,6
CHIAPAS,7,PALENQUE,065,EL RECUERDO,2,12,4,8,2
CHIAPAS,7,PALENQUE,065,EL RETIRO,1,63,31,32,2
CHIAPAS,7,PALENQUE,065,EL RINCÓN DEL GUANO,3,48,27,21,5
CHIAPAS,7,PALENQUE,065,EL ROBLE,2,230,117,113,7
CHIAPAS,7,PALENQUE,065,EL SACRIFICIO,2,37,16,21,2
CHIAPAS,7,PALENQUE,065,EL SINAÍ,2,28,15,13,2
CHIAPAS,7,PALENQUE,065,EL TENAMPA,2,15,6,9,2
CHIAPAS,7,PALENQUE,065,EMILIO RABASA,3,282,137,145,11
CHIAPAS,7,PALENQUE,065,ESCUINTLA,2,25,15,10,2
CHIAPAS,7,PALENQUE,065,ESTACIÓN CHACAMAX,3,13,7,6,3
CHIAPAS,7,PALENQUE,065,ESTACIÓN SAN AGUSTÍN (LA PLACA),2,23,11,12,3
CHIAPAS,7,PALENQUE,065,ESTRELLA DE BELÉN,2,34,17,17,2
CHIAPAS,7,PALENQUE,065,FLOR DEL RÍO,2,24,12,12,3
CHIAPAS,7,PALENQUE,065,FRANCISCO I. MADERO NORTE,3,99,50,49,5
CHIAPAS,7,PALENQUE,065,FRANCISCO VILLA,5,112,62,50,6
CHIAPAS,7,PALENQUE,065,GALILEO,2,24,14,10,2
CHIAPAS,7,PALENQUE,065,GENERAL EMILIANO ZAPATA DEL VALLE,2,166,76,90,6
CHIAPAS,7,PALENQUE,065,GRACIANO SÁNCHEZ,3,135,68,67,7
CHIAPAS,7,PALENQUE,065,GUADALUPE,2,88,37,51,4
CHIAPAS,7,PALENQUE,065,HERMENEGILDO GALEANA,3,255,125,130,11
CHIAPAS,7,PALENQUE,065,JERICÓ 2DA. SECCIÓN,2,114,57,57,4
CHIAPAS,7,PALENQUE,065,JOSÉ MARÍA MORELOS Y PAVÓN,3,123,56,67,6
CHIAPAS,7,PALENQUE,065,JUAN SABINES GUERRERO,3,93,56,37,6
CHIAPAS,7,PALENQUE,065,JUNGLA MAYA,1,13,4,9,1
CHIAPAS,7,PALENQUE,065,KAN-KAN-HÁ,2,13,4,9,2
CHIAPAS,7,PALENQUE,065,LA ALIANZA,2,59,33,26,3
CHIAPAS,7,PALENQUE,065,LA ASUNCIÓN,2,31,20,11,2
CHIAPAS,7,PALENQUE,065,LA AURORA,3,129,55,74,7
CHIAPAS,7,PALENQUE,065,LA CALANDRIA,1,4,1,3,1
CHIAPAS,7,PALENQUE,065,LA CAOBA,3,108,53,55,8
CHIAPAS,7,PALENQUE,065,LA CASCADA,4,365,181,184,16
CHIAPAS,7,PALENQUE,065,LA ENSENADA CHUTALIJÁ,2,94,42,52,3
CHIAPAS,7,PALENQUE,065,LA ESCONDIDA,2,22,12,10,2
CHIAPAS,7,PALENQUE,065,LA ESPERANZA,1,195,93,102,6
CHIAPAS,7,PALENQUE,065,LA FLOR DE CHIAPAS,3,204,111,93,8
CHIAPAS,7,PALENQUE,065,LA FORTUNA,2,9,3,6,2
CHIAPAS,7,PALENQUE,065,LA GLORIA,4,110,56,54,6
CHIAPAS,7,PALENQUE,065,LA GUADALUPE,1,5,4,1,1
CHIAPAS,7,PALENQUE,065,LA JOYA,3,614,309,305,24
CHIAPAS,7,PALENQUE,065,LA LOMA,1,37,18,19,2
CHIAPAS,7,PALENQUE,065,LA PRIMAVERA,1,14,7,7,1
CHIAPAS,7,PALENQUE,065,LA REFORMA DE OCAMPO,2,113,66,47,5
CHIAPAS,7,PALENQUE,065,LA REVOLUCIÓN,4,71,45,26,6
CHIAPAS,7,PALENQUE,065,LA RUEDA,2,16,9,7,2
CHIAPAS,7,PALENQUE,065,LA SELVA,2,19,11,8,2
CHIAPAS,7,PALENQUE,065,LAGUNA EMILIANO ZAPATA,3,55,27,28,5
CHIAPAS,7,PALENQUE,065,LAS DELICIAS,4,191,93,98,12
CHIAPAS,7,PALENQUE,065,LAS DELICIAS 2DA. SECCIÓN,2,29,16,13,3
CHIAPAS,7,PALENQUE,065,LAS MARGARITAS DE PALENQUE,2,22,14,8,3
CHIAPAS,7,PALENQUE,065,LÁZARO CÁRDENAS,4,476,219,257,19
CHIAPAS,7,PALENQUE,065,LICENCIADO GUSTAVO DÍAZ ORDAZ,4,288,135,153,12
CHIAPAS,7,PALENQUE,065,LICENCIADO JOSÉ CASTILLO TIELMANS,3,147,64,83,7
CHIAPAS,7,PALENQUE,065,LINDAVISTA (CHINIQUIJÁ),2,44,16,28,2
CHIAPAS,7,PALENQUE,065,LINDAVISTA XINICH,2,116,63,53,5
CHIAPAS,7,PALENQUE,065,LOS ÁNGELES,2,38,27,11,3
CHIAPAS,7,PALENQUE,065,LOS CERRILLOS,4,87,45,42,5
CHIAPAS,7,PALENQUE,065,LOS LLANOS,1,4,3,1,1
CHIAPAS,7,PALENQUE,065,LOS OLVIDADOS,2,28,13,15,3
CHIAPAS,7,PALENQUE,065,LOS RIELES DEL PARAÍSO,1,9,4,5,1
CHIAPAS,7,PALENQUE,065,LUIS ALFREDO,2,25,8,17,3
CHIAPAS,7,PALENQUE,065,LUIS I. CABRERA (TEPEZCUINTLE),3,57,34,23,5
CHIAPAS,7,PALENQUE,065,MARGARITA MAZA DE JUÁREZ,3,143,60,83,6
CHIAPAS,7,PALENQUE,065,MEDELLÍN 1RA. SECCIÓN,2,35,17,18,2
CHIAPAS,7,PALENQUE,065,MEDELLÍN 2DA. SECCIÓN,2,91,40,51,4
CHIAPAS,7,PALENQUE,065,MIGUEL HIDALGO,2,14,7,7,1
CHIAPAS,7,PALENQUE,065,MIGUEL HIDALGO (ESTACIÓN LACANDÓN),4,321,180,141,14
CHIAPAS,7,PALENQUE,065,MONTE DE SIÓN,2,24,13,11,3
CHIAPAS,7,PALENQUE,065,MONTEBELLO,2,38,16,22,2
CHIAPAS,7,PALENQUE,065,MONTECRISTO,2,4,2,2,1
CHIAPAS,7,PALENQUE,065,NETZAHUALCÓYOTL,3,280,120,160,12
CHIAPAS,7,PALENQUE,065,NIÑOS HÉROES,1,13,8,5,1
CHIAPAS,7,PALENQUE,065,NUEVA BETANIA,3,208,109,99,10
CHIAPAS,7,PALENQUE,065,NUEVA CENTRAL,1,16,7,9,1
CHIAPAS,7,PALENQUE,065,NUEVA ESPERANZA,4,850,412,438,32
CHIAPAS,7,PALENQUE,065,NUEVA ESPERANZA 1RA. SECCIÓN,3,269,129,140,12
CHIAPAS,7,PALENQUE,065,NUEVA ESPERANZA 2DA. SECCIÓN,2,151,72,79,7
CHIAPAS,7,PALENQUE,065,NUEVA ESPERANZA PROGRESISTA,4,159,79,80,12
CHIAPAS,7,PALENQUE,065,NUEVA GALILEA,4,394,205,189,17
CHIAPAS,7,PALENQUE,065,NUEVA INDEPENDENCIA,2,37,15,22,3
CHIAPAS,7,PALENQUE,065,NUEVA JERUSALÉN (EL JAGUAR),2,110,62,48,5
CHIAPAS,7,PALENQUE,065,NUEVO ALTAMIRANO,1,12,7,5,1
CHIAPAS,7,PALENQUE,065,NUEVO EGIPTO,2,67,31,36,4
CHIAPAS,7,PALENQUE,065,NUEVO JALAPA,2,27,13,14,2
CHIAPAS,7,PALENQUE,065,NUEVO JALISCO OSUMACINTA,2,51,26,25,3
CHIAPAS,7,PALENQUE,065,NUEVO JERICÓ,2,137,62,75,5
CHIAPAS,7,PALENQUE,065,NUEVO JERUSALÉN,2,107,50,57,4
CHIAPAS,7,PALENQUE,065,NUEVO MÉRIDA,3,164,77,87,9
CHIAPAS,7,PALENQUE,065,NUEVO MÉXICO,3,176,88,88,8
CHIAPAS,7,PALENQUE,065,NUEVO MONTE ORET,2,8,5,3,1
CHIAPAS,7,PALENQUE,065,NUEVO MONTES AZULES,4,316,150,166,15
CHIAPAS,7,PALENQUE,065,NUEVO PARAÍSO,2,38,19,19,2
CHIAPAS,7,PALENQUE,065,NUEVO PLAN DE AYALA,2,109,61,48,4
CHIAPAS,7,PALENQUE,065,NUEVO RETIRO,2,53,30,23,4
CHIAPAS,7,PALENQUE,065,NUEVO SAMARITANO,2,91,45,46,4
CHIAPAS,7,PALENQUE,065,NUEVO SAN JOAQUÍN,3,142,69,73,7
CHIAPAS,7,PALENQUE,065,NUEVO SONORA,3,166,72,94,8
CHIAPAS,7,PALENQUE,065,NUEVO SUCLUMPÁ,2,15,5,10,2
CHIAPAS,7,PALENQUE,065,NUEVO TANIPERLA,2,111,53,58,5
CHIAPAS,7,PALENQUE,065,NUEVO TILA CASTAÑÓN,2,130,65,65,5
CHIAPAS,7,PALENQUE,065,NUEVO YAJALÓN,2,60,31,29,3
CHIAPAS,7,PALENQUE,065,ONCE DE JULIO 2DA. SECCIÓN (MACEDONIA),2,79,40,39,4
CHIAPAS,7,PALENQUE,065,PALENQUE,89,16522,8409,8113,1160
CHIAPAS,7,PALENQUE,065,POBLADO LA UNIÓN,3,218,110,108,10
CHIAPAS,7,PALENQUE,065,POBLADO NUEVO ARROYO,2,87,43,44,3
CHIAPAS,7,PALENQUE,065,PORTACELI,2,70,42,28,3
CHIAPAS,7,PALENQUE,065,PROFESOR ROBERTO BARRIOS,4,525,247,278,22
CHIAPAS,7,PALENQUE,065,PUEBLO NUEVO,2,29,18,11,2
CHIAPAS,7,PALENQUE,065,PUEBLO NUEVO USUMACINTA,1,42,27,15,1
CHIAPAS,7,PALENQUE,065,PUYIPA,3,208,105,103,9
CHIAPAS,7,PALENQUE,065,RAYMUNDO ENRÍQUEZ,3,101,41,60,6
CHIAPAS,7,PALENQUE,065,REFORMA AGRARIA (CHINIQUIJA),4,219,102,117,12
CHIAPAS,7,PALENQUE,065,RICARDO FLORES MAGÓN,4,73,38,35,4
CHIAPAS,7,PALENQUE,065,RÍO CHANCALÁ,6,836,430,406,40
CHIAPAS,7,PALENQUE,065,RÍO OSUMACINTA,3,23,11,12,3
CHIAPAS,7,PALENQUE,065,RÍO SAN DIEGO,2,30,11,19,2
CHIAPAS,7,PALENQUE,065,ROSA BLANCA,2,28,9,19,2
CHIAPAS,7,PALENQUE,065,SAN ANTONIO,2,155,73,82,3
CHIAPAS,7,PALENQUE,065,SAN ANTONIO CHUYIPÁ,3,73,31,42,5
CHIAPAS,7,PALENQUE,065,SAN FRANCISCO,2,83,42,41,4
CHIAPAS,7,PALENQUE,065,SAN FRANCISCO CHANCALA,3,94,47,47,5
CHIAPAS,7,PALENQUE,065,SAN FRANCISCO LAS RUINAS,4,18,11,7,3
CHIAPAS,7,PALENQUE,065,SAN FRANCISCO PALENQUE,1,47,27,20,3
CHIAPAS,7,PALENQUE,065,SAN JOSÉ (OSUMACINTA),2,51,22,29,3
CHIAPAS,7,PALENQUE,065,SAN JOSÉ CHANCALA 2DA.SECCIÓN,2,17,9,8,2
CHIAPAS,7,PALENQUE,065,SAN JOSÉ CHANCALA PRIMERA SECCIÓN,2,44,17,27,2
CHIAPAS,7,PALENQUE,065,SAN JOSÉ DEL CARMEN (EL BASCANCITO),2,10,4,6,2
CHIAPAS,7,PALENQUE,065,SAN JOSÉ LA UNIÓN,2,20,13,7,2
CHIAPAS,7,PALENQUE,065,SAN JUAN (FRACCIÓN EL DESENGAÑO),1,6,5,1,1
CHIAPAS,7,PALENQUE,065,SAN JUAN CHANCALAÍTO,3,211,97,114,11
CHIAPAS,7,PALENQUE,065,SAN JUAN TULIJA (SAN JUAN),5,510,248,262,15
CHIAPAS,7,PALENQUE,065,SAN LORENZO,1,66,35,31,3
CHIAPAS,7,PALENQUE,065,SAN LORENZO (CHOCOLJÁ),1,107,51,56,4
CHIAPAS,7,PALENQUE,065,SAN LUIS,2,80,38,42,4
CHIAPAS,7,PALENQUE,065,SAN MANUEL,2,85,43,42,4
CHIAPAS,7,PALENQUE,065,SAN MARCOS,5,87,38,49,8
CHIAPAS,7,PALENQUE,065,SAN MARTÍN CHAMIZAL,4,676,316,360,23
CHIAPAS,7,PALENQUE,065,SAN MATEO,4,201,92,109,9
CHIAPAS,7,PALENQUE,065,SAN MIGUEL ARIMATEA,3,32,19,13,4
CHIAPAS,7,PALENQUE,065,SAN PEDRO,2,45,27,18,3
CHIAPAS,7,PALENQUE,065,SAN VICENTE,2,23,9,14,2
CHIAPAS,7,PALENQUE,065,SANTA CRUZ,4,101,57,44,5
CHIAPAS,7,PALENQUE,065,SANTA ISABEL,4,29,17,12,4
CHIAPAS,7,PALENQUE,065,SANTA MARÍA 2DA. SECCIÓN,1,17,6,11,1
CHIAPAS,7,PALENQUE,065,SANTA ROSA,1,146,72,74,6
CHIAPAS,7,PALENQUE,065,SANTO DOMINGO,1,45,20,25,2
CHIAPAS,7,PALENQUE,065,SATURNINO RÍOS,3,268,124,144,10
CHIAPAS,7,PALENQUE,065,TOMÁS GARRIDO CANABAL,2,29,9,20,2
CHIAPAS,7,PALENQUE,065,TZELTAL MUKUL-JÁ,2,144,74,70,6
CHIAPAS,7,PALENQUE,065,ÚRSULO GALVÁN,1,46,23,23,3
CHIAPAS,7,PALENQUE,065,VENUSTIANO CARRANZA,3,106,59,47,6
CHIAPAS,7,PALENQUE,065,VENUSTIANO CARRANZA 2DA. SECCIÓN,2,39,17,22,3
CHIAPAS,7,PALENQUE,065,VICTORIA CAMPESINA I,2,15,10,5,2
CHIAPAS,7,PALENQUE,065,VICTORIA CAMPESINA II,2,25,9,16,3
CHIAPAS,7,PALENQUE,065,VICTÓRICO GRAJALES,3,134,63,71,6
CHIAPAS,7,PALENQUE,065,VISTAHERMOSA,2,65,32,33,3
CHIAPAS,7,PANTELHÓ,066,AQUILES SERDÁN (SANTA LUCÍA),3,361,199,162,9
CHIAPAS,7,PANTELHÓ,066,AURORA ESQUIPULAS,4,910,461,449,24
CHIAPAS,7,PANTELHÓ,066,CORRALITO PEDERNAL (ZAQUILÁ),2,42,27,15,3
CHIAPAS,7,PANTELHÓ,066,DOLORES PETAQUIL,3,46,25,21,4
CHIAPAS,7,PANTELHÓ,066,EL CAMPO,1,17,7,10,1
CHIAPAS,7,PANTELHÓ,066,EL CARMEN DURAZNAL,2,17,8,9,2
CHIAPAS,7,PANTELHÓ,066,EL OCOTAL,3,85,29,56,6
CHIAPAS,7,PANTELHÓ,066,EL PEQUEÑO ROBLAR,1,9,5,4,1
CHIAPAS,7,PANTELHÓ,066,EL PORVENIR,2,102,55,47,4
CHIAPAS,7,PANTELHÓ,066,EL ROBLAR CHISHTONTIC,4,395,200,195,13
CHIAPAS,7,PANTELHÓ,066,EL ROSARIO,2,20,4,16,2
CHIAPAS,7,PANTELHÓ,066,EMILIANO ZAPATA,2,24,9,15,3
CHIAPAS,7,PANTELHÓ,066,EMILIANO ZAPATA SEGUNDO,2,15,8,7,2
CHIAPAS,7,PANTELHÓ,066,ENCANTO CHIXTÉ,2,39,17,22,3
CHIAPAS,7,PANTELHÓ,066,FRACCIÓN SAN CARALAMPIO,2,13,8,5,2
CHIAPAS,7,PANTELHÓ,066,FRACCIÓN SAN FRANCISCO,1,7,4,3,1
CHIAPAS,7,PANTELHÓ,066,GUADALUPE DE LA PEÑA,2,66,33,33,5
CHIAPAS,7,PANTELHÓ,066,GUADALUPE LA LÁMINA,2,104,57,47,2
CHIAPAS,7,PANTELHÓ,066,GUADALUPE TEPEYAC,2,69,39,30,3
CHIAPAS,7,PANTELHÓ,066,GUADALUPE VICTORIA,3,164,81,83,5
CHIAPAS,7,PANTELHÓ,066,LA ALIANZA,3,70,46,24,5
CHIAPAS,7,PANTELHÓ,066,LA ESMERALDA,2,29,8,21,3
CHIAPAS,7,PANTELHÓ,066,LA ISLA,2,74,39,35,3
CHIAPAS,7,PANTELHÓ,066,LA PIEDAD,2,5,1,4,1
CHIAPAS,7,PANTELHÓ,066,LA PROVIDENCIA,1,62,35,27,2
CHIAPAS,7,PANTELHÓ,066,LA UNIÓN CARMEN REFORMA,3,106,48,58,7
CHIAPAS,7,PANTELHÓ,066,LA VICTORIA,1,39,17,22,1
CHIAPAS,7,PANTELHÓ,066,LAS LIMAS,2,76,41,35,3
CHIAPAS,7,PANTELHÓ,066,LAS LIMAS CHITAMUCUM,3,212,101,111,7
CHIAPAS,7,PANTELHÓ,066,LOS MANGOS,2,77,33,44,3
CHIAPAS,7,PANTELHÓ,066,NUEVA ESPERANZA,1,5,2,3,1
CHIAPAS,7,PANTELHÓ,066,NUEVA GALILEA,1,58,26,32,1
CHIAPAS,7,PANTELHÓ,066,NUEVA JERUSALÉN,2,39,21,18,3
CHIAPAS,7,PANTELHÓ,066,NUEVA LINDA,2,83,45,38,4
CHIAPAS,7,PANTELHÓ,066,NUEVA MARAVILLAS,2,17,9,8,2
CHIAPAS,7,PANTELHÓ,066,NUEVA REFORMA,3,162,73,89,5
CHIAPAS,7,PANTELHÓ,066,NUEVA SANTA CRUZ YAXTÉ,1,32,11,21,1
CHIAPAS,7,PANTELHÓ,066,NUEVA SANTA ROSA,2,31,13,18,2
CHIAPAS,7,PANTELHÓ,066,PANTELHÓ,14,1792,868,924,86
CHIAPAS,7,PANTELHÓ,066,PARAÍSO SEPELTÓN,2,73,31,42,3
CHIAPAS,7,PANTELHÓ,066,SAN ANTONIO,4,124,57,67,7
CHIAPAS,7,PANTELHÓ,066,SAN CARALAMPIO,2,89,51,38,3
CHIAPAS,7,PANTELHÓ,066,SAN CARLOS,2,87,42,45,3
CHIAPAS,7,PANTELHÓ,066,SAN CARLOS CORRALITO,2,134,77,57,6
CHIAPAS,7,PANTELHÓ,066,SAN CLEMENTE,2,38,21,17,2
CHIAPAS,7,PANTELHÓ,066,SAN FERNANDO,2,104,55,49,4
CHIAPAS,7,PANTELHÓ,066,SAN FRANCISCO,2,16,10,6,1
CHIAPAS,7,PANTELHÓ,066,SAN FRANCISCO EL TRIUNFO,2,81,46,35,3
CHIAPAS,7,PANTELHÓ,066,SAN ISIDRO VIEJO,2,27,10,17,3
CHIAPAS,7,PANTELHÓ,066,SAN JOAQUÍN,2,109,44,65,4
CHIAPAS,7,PANTELHÓ,066,SAN JOSÉ BOCHTIC,2,90,49,41,3
CHIAPAS,7,PANTELHÓ,066,SAN JOSÉ BUENAVISTA PRIMERO,3,65,35,30,3
CHIAPAS,7,PANTELHÓ,066,SAN JOSÉ BUENAVISTA SEGUNDO,1,5,3,2,1
CHIAPAS,7,PANTELHÓ,066,SAN JOSÉ BUENAVISTA TERCERO,2,60,28,32,4
CHIAPAS,7,PANTELHÓ,066,SAN JOSÉ CHACTÚ,3,52,26,26,4
CHIAPAS,7,PANTELHÓ,066,SAN JOSÉ DEL CARMEN,2,120,60,60,4
CHIAPAS,7,PANTELHÓ,066,SAN JOSÉ LA AURORA,2,9,3,6,1
CHIAPAS,7,PANTELHÓ,066,SAN LUIS USIG,2,70,42,28,4
CHIAPAS,7,PANTELHÓ,066,SAN MARTÍN CABALLERO,3,63,23,40,5
CHIAPAS,7,PANTELHÓ,066,SAN RAFAEL,1,70,45,25,2
CHIAPAS,7,PANTELHÓ,066,SANTA CRUZ (CORAZÓN DE JESÚS),1,81,38,43,3
CHIAPAS,7,PANTELHÓ,066,SANTA ELENA,2,23,12,11,3
CHIAPAS,7,PANTELHÓ,066,SANTA ROSALÍA,3,20,7,13,3
CHIAPAS,7,PANTELHÓ,066,SANTIAGO LOS SABINOS,2,24,12,12,3
CHIAPAS,7,PANTELHÓ,066,YAB MUCTANA,1,6,2,4,1
CHIAPAS,7,PANTEPEC,067,BERLÍN,2,43,18,25,4
CHIAPAS,7,PANTEPEC,067,BUENOS AIRES,2,73,36,37,3
CHIAPAS,7,PANTEPEC,067,CANALEJA,1,59,31,28,3
CHIAPAS,7,PANTEPEC,067,CANELAR,2,63,31,32,4
CHIAPAS,7,PANTEPEC,067,CONCEPCIÓN,2,11,6,5,2
CHIAPAS,7,PANTEPEC,067,EL AVELLANITO,2,13,7,6,2
CHIAPAS,7,PANTEPEC,067,EL AVELLANO,3,148,71,77,8
CHIAPAS,7,PANTEPEC,067,EL CARMEN,1,23,9,14,1
CHIAPAS,7,PANTEPEC,067,EL CARRIZAL,4,312,145,167,14
CHIAPAS,7,PANTEPEC,067,EL LIMÓN,2,100,58,42,5
CHIAPAS,7,PANTEPEC,067,EL NARANJO,3,43,17,26,4
CHIAPAS,7,PANTEPEC,067,EL TRIUNFO,2,162,82,80,8
CHIAPAS,7,PANTEPEC,067,JULIÁN GRAJALES,4,243,114,129,12
CHIAPAS,7,PANTEPEC,067,LA FLORIDA,2,41,22,19,3
CHIAPAS,7,PANTEPEC,067,LA NARANJA,3,104,52,52,7
CHIAPAS,7,PANTEPEC,067,LA NUEVA UNIÓN,3,35,20,15,3
CHIAPAS,7,PANTEPEC,067,LA SOLEDAD,4,92,48,44,7
CHIAPAS,7,PANTEPEC,067,LAGUNA CHICA,3,42,20,22,3
CHIAPAS,7,PANTEPEC,067,LAGUNA GRANDE,6,141,64,77,9
CHIAPAS,7,PANTEPEC,067,LIQUIDÁMBAR,3,161,84,77,9
CHIAPAS,7,PANTEPEC,067,NUEVA REFORMA,2,31,14,17,2
CHIAPAS,7,PANTEPEC,067,PANTEPEC,9,876,453,423,50
CHIAPAS,7,PANTEPEC,067,SAN ANTONIO 1RA. SECCIÓN,2,76,38,38,4
CHIAPAS,7,PANTEPEC,067,SAN ANTONIO 2DA. SECCIÓN,1,19,10,9,1
CHIAPAS,7,PANTEPEC,067,SAN ISIDRO LAS BANDERAS,5,732,367,365,26
CHIAPAS,7,PANTEPEC,067,SAN ISIDRO LIQUIDÁMBAR,2,14,9,5,2
CHIAPAS,7,PANTEPEC,067,SAN JOSÉ BUENAVISTA,2,30,19,11,3
CHIAPAS,7,PANTEPEC,067,SAN LUCAS,1,33,15,18,3
CHIAPAS,7,PANTEPEC,067,SANTA CRUZ,2,98,50,48,5
CHIAPAS,7,PICHUCALCO,068,BLANQUILLO 1RA. SECCIÓN,1,11,4,7,1
CHIAPAS,7,PICHUCALCO,068,BLANQUILLO 2DA. SECCIÓN,4,71,35,36,6
CHIAPAS,7,PICHUCALCO,068,CAIMBA,2,10,3,7,2
CHIAPAS,7,PICHUCALCO,068,CAMOAPA 1RA. SECCIÓN A (LA CLÍNICA),2,12,7,5,2
CHIAPAS,7,PICHUCALCO,068,CAMOAPA 1RA. SECCIÓN A (PORTACELI),6,65,31,34,6
CHIAPAS,7,PICHUCALCO,068,CAMOAPA 2DA. SECCIÓN A CENTRO,3,49,30,19,4
CHIAPAS,7,PICHUCALCO,068,CAMOAPA 2DA. SECCIÓN B (EL MIGUEL),2,14,8,6,2
CHIAPAS,7,PICHUCALCO,068,CAMOAPITA 1RA. SECCIÓN A (SAN ISIDRO),7,150,72,78,11
CHIAPAS,7,PICHUCALCO,068,CAMOAPITA 1RA. SECCIÓN B (LA CLÍNICA),1,17,8,9,2
CHIAPAS,7,PICHUCALCO,068,CAMOAPITA 2DA. SECCIÓN (EL SINAÍ),2,20,6,14,2
CHIAPAS,7,PICHUCALCO,068,CAMOAPITA 2DA. SECCIÓN A (CENTRO),3,45,20,25,3
CHIAPAS,7,PICHUCALCO,068,EL AZUFRE 1RA. SECCIÓN,9,70,36,34,9
CHIAPAS,7,PICHUCALCO,068,EL AZUFRE 2DA. SECCIÓN,10,162,75,87,11
CHIAPAS,7,PICHUCALCO,068,EL CERRO 1RA. SECCIÓN,2,36,19,17,3
CHIAPAS,7,PICHUCALCO,068,EL CERRO 2DA. SECCIÓN,3,27,13,14,3
CHIAPAS,7,PICHUCALCO,068,EL CHORRO,2,27,9,18,3
CHIAPAS,7,PICHUCALCO,068,EL CUCAYO,5,51,28,23,6
CHIAPAS,7,PICHUCALCO,068,EL SACRIFICIO,1,12,9,3,1
CHIAPAS,7,PICHUCALCO,068,EL ZAPOTE,2,35,17,18,3
CHIAPAS,7,PICHUCALCO,068,FRANCISCO VILLA,1,11,5,6,1
CHIAPAS,7,PICHUCALCO,068,IGNACIO ZARAGOZA ALTO,5,51,32,19,6
CHIAPAS,7,PICHUCALCO,068,IGNACIO ZARAGOZA BAJO,7,305,129,176,16
CHIAPAS,7,PICHUCALCO,068,LOS CASCABELES,1,5,2,3,1
CHIAPAS,7,PICHUCALCO,068,LUIS DONALDO COLOSIO MURRIETA,1,43,19,24,2
CHIAPAS,7,PICHUCALCO,068,MARIANO MATAMOROS 1RA. SECCIÓN A,5,75,37,38,7
CHIAPAS,7,PICHUCALCO,068,MARIANO MATAMOROS SEGUNDA SECCIÓN,4,72,40,32,5
CHIAPAS,7,PICHUCALCO,068,MIGUEL HIDALGO,7,67,28,39,7
CHIAPAS,7,PICHUCALCO,068,NAPANA,2,238,116,122,9
CHIAPAS,7,PICHUCALCO,068,NICOLÁS BRAVO 1RA. SECCIÓN,2,31,21,10,3
CHIAPAS,7,PICHUCALCO,068,NICOLÁS BRAVO 2DA. SECCIÓN,3,29,18,11,3
CHIAPAS,7,PICHUCALCO,068,NUEVO NICAPA,4,516,248,268,18
CHIAPAS,7,PICHUCALCO,068,NUEVO SAN CARLOS,1,13,3,10,1
CHIAPAS,7,PICHUCALCO,068,PICHUCALCO,37,6333,3315,3018,433
CHIAPAS,7,PICHUCALCO,068,PLATANAR ABAJO 1RA. SECCIÓN (LA CRIMEA),4,216,97,119,14
CHIAPAS,7,PICHUCALCO,068,PLATANAR ABAJO 2DA. SECCIÓN (UNIDAD CHIAPANECA),2,44,27,17,4
CHIAPAS,7,PICHUCALCO,068,PLATANAR ABAJO 2DA. SECCIÓN A (EL PORVENIR),1,37,21,16,2
CHIAPAS,7,PICHUCALCO,068,PLATANAR ABAJO 2DA. SECCIÓN B (BATERÍA CHIAPAS),3,18,4,14,3
CHIAPAS,7,PICHUCALCO,068,PLATANAR ARRIBA 1RA. SECCIÓN A (LOS TOPES),1,4,2,2,1
CHIAPAS,7,PICHUCALCO,068,PLATANAR ARRIBA 1RA. SECCIÓN B (LA FLORIDA),11,194,99,95,15
CHIAPAS,7,PICHUCALCO,068,PLAYAS,2,15,6,9,2
CHIAPAS,7,PICHUCALCO,068,PLUTARCO ELÍAS CALLES,3,98,41,57,6
CHIAPAS,7,PICHUCALCO,068,SAN CARLOS,3,34,15,19,4
CHIAPAS,7,PICHUCALCO,068,SAN JOAQUÍN,1,19,8,11,1
CHIAPAS,7,PICHUCALCO,068,TECTUAPAN,4,323,153,170,15
CHIAPAS,7,PICHUCALCO,068,VIEJO NICAPA,4,169,81,88,12
CHIAPAS,7,PIJIJIAPAN,069,AGUA TENDIDA,2,18,11,7,2
CHIAPAS,7,PIJIJIAPAN,069,ARTURO LUNA LUGO,2,12,8,4,2
CHIAPAS,7,PIJIJIAPAN,069,BENITO JUÁREZ,2,38,19,19,3
CHIAPAS,7,PIJIJIAPAN,069,BUENAVISTA,2,43,18,25,3
CHIAPAS,7,PIJIJIAPAN,069,BUENOS AIRES,3,66,33,33,5
CHIAPAS,7,PIJIJIAPAN,069,CACHIMBO,2,34,18,16,3
CHIAPAS,7,PIJIJIAPAN,069,CALES DE CHIAPAS,1,9,4,5,1
CHIAPAS,7,PIJIJIAPAN,069,CELESTINO GASCA VILLASEÑOR (NUEVO MILENIO),2,54,22,32,5
CHIAPAS,7,PIJIJIAPAN,069,CENICEROS,3,116,55,61,7
CHIAPAS,7,PIJIJIAPAN,069,CERRO DE LA ENCOMIENDA,2,23,11,12,2
CHIAPAS,7,PIJIJIAPAN,069,CHOCOHUITAL,2,36,18,18,3
CHIAPAS,7,PIJIJIAPAN,069,CINCO DE MAYO,1,133,66,67,5
CHIAPAS,7,PIJIJIAPAN,069,COAPA,2,64,28,36,4
CHIAPAS,7,PIJIJIAPAN,069,COLIMA,2,24,13,11,2
CHIAPAS,7,PIJIJIAPAN,069,COSTA AZUL,3,54,24,30,5
CHIAPAS,7,PIJIJIAPAN,069,EL AMATAL,2,22,8,14,3
CHIAPAS,7,PIJIJIAPAN,069,EL CAMPANILLO,1,4,2,2,1
CHIAPAS,7,PIJIJIAPAN,069,EL CARMEN,4,453,237,216,21
CHIAPAS,7,PIJIJIAPAN,069,EL CERRÓN,4,52,27,25,5
CHIAPAS,7,PIJIJIAPAN,069,EL DIAMANTE,3,30,18,12,4
CHIAPAS,7,PIJIJIAPAN,069,EL FORTÍN,2,62,28,34,3
CHIAPAS,7,PIJIJIAPAN,069,EL GOLFO,2,25,12,13,2
CHIAPAS,7,PIJIJIAPAN,069,EL OAXAQUEÑO,1,17,8,9,2
CHIAPAS,7,PIJIJIAPAN,069,EL PALMAR,2,25,13,12,3
CHIAPAS,7,PIJIJIAPAN,069,EL PALMARCITO,4,325,168,157,15
CHIAPAS,7,PIJIJIAPAN,069,EL PARAÍSO,2,30,17,13,2
CHIAPAS,7,PIJIJIAPAN,069,EL RECREO (TENEJAPA),2,30,13,17,2
CHIAPAS,7,PIJIJIAPAN,069,EL ROSARIO,3,85,42,43,6
CHIAPAS,7,PIJIJIAPAN,069,EL VERGEL,3,181,88,93,9
CHIAPAS,7,PIJIJIAPAN,069,EMILIANO ZAPATA,2,51,24,27,4
CHIAPAS,7,PIJIJIAPAN,069,ESFUERZO DEL CAMPESINO,2,16,2,14,2
CHIAPAS,7,PIJIJIAPAN,069,ESPAÑA,1,8,3,5,1
CHIAPAS,7,PIJIJIAPAN,069,ESTACIÓN ECHEGARAY,3,235,126,109,18
CHIAPAS,7,PIJIJIAPAN,069,GUANAJUATO,2,86,44,42,5
CHIAPAS,7,PIJIJIAPAN,069,GUSTAVO LÓPEZ GUTIÉRREZ,3,41,17,24,3
CHIAPAS,7,PIJIJIAPAN,069,HEBERTO CASTILLO,2,27,9,18,3
CHIAPAS,7,PIJIJIAPAN,069,HERMENEGILDO GALEANA,4,411,208,203,25
CHIAPAS,7,PIJIJIAPAN,069,ISLA MORELOS,3,84,37,47,6
CHIAPAS,7,PIJIJIAPAN,069,ISLA SAN JOSÉ,3,39,19,20,4
CHIAPAS,7,PIJIJIAPAN,069,JOAQUÍN MIGUEL GUTIÉRREZ (MARGARITAS),4,593,283,310,29
CHIAPAS,7,PIJIJIAPAN,069,LA CENTRAL,4,226,120,106,22
CHIAPAS,7,PIJIJIAPAN,069,LA CONQUISTA,4,136,67,69,10
CHIAPAS,7,PIJIJIAPAN,069,LA ESMERALDA,3,35,20,15,4
CHIAPAS,7,PIJIJIAPAN,069,LA ESPERANZA (EL ZAPOTAL),4,262,129,133,15
CHIAPAS,7,PIJIJIAPAN,069,LA GRANDE,2,12,7,5,2
CHIAPAS,7,PIJIJIAPAN,069,LA GUADALUPE,1,164,76,88,6
CHIAPAS,7,PIJIJIAPAN,069,LA PIAÑA,2,22,12,10,3
CHIAPAS,7,PIJIJIAPAN,069,LA UNIDAD,1,33,15,18,2
CHIAPAS,7,PIJIJIAPAN,069,LAS BRISAS,6,454,224,230,23
CHIAPAS,7,PIJIJIAPAN,069,LAS CUACHES,2,44,26,18,3
CHIAPAS,7,PIJIJIAPAN,069,LAS GARZAS,2,62,35,27,4
CHIAPAS,7,PIJIJIAPAN,069,LAS MERCEDES (RINCÓN DEL TORO),3,21,10,11,3
CHIAPAS,7,PIJIJIAPAN,069,LAS PERLAS,2,24,13,11,2
CHIAPAS,7,PIJIJIAPAN,069,LÁZARO CÁRDENAS DEL RÍO (CUATRO VIENTOS),4,138,57,81,10
CHIAPAS,7,PIJIJIAPAN,069,LOS CHORROS (MIGUEL UTRILLA),2,79,35,44,3
CHIAPAS,7,PIJIJIAPAN,069,LOS LIMONES,3,65,31,34,6
CHIAPAS,7,PIJIJIAPAN,069,LOS LLANOS,1,64,35,29,3
CHIAPAS,7,PIJIJIAPAN,069,LOS TULIPANES,3,59,36,23,6
CHIAPAS,7,PIJIJIAPAN,069,MANCOMÚN COMUNIDAD CARRETA,2,26,16,10,3
CHIAPAS,7,PIJIJIAPAN,069,MIGUEL ALEMÁN VALDEZ (JERICÓ),3,167,87,80,11
CHIAPAS,7,PIJIJIAPAN,069,MILENIO EL VERGEL,2,29,10,19,3
CHIAPAS,7,PIJIJIAPAN,069,MIRAMAR,1,17,9,8,1
CHIAPAS,7,PIJIJIAPAN,069,MONTECRISTO,1,5,3,2,1
CHIAPAS,7,PIJIJIAPAN,069,NUEVA CONCEPCIÓN,2,15,6,9,2
CHIAPAS,7,PIJIJIAPAN,069,NUEVA ESPERANZA,3,40,17,23,4
CHIAPAS,7,PIJIJIAPAN,069,NUEVA FLOR,5,120,51,69,10
CHIAPAS,7,PIJIJIAPAN,069,NUEVA URBINA,3,67,29,38,5
CHIAPAS,7,PIJIJIAPAN,069,NUEVO MÉXICO,1,9,6,3,1
CHIAPAS,7,PIJIJIAPAN,069,NUEVO MILENIO CELESTINO GASCA VILLASEÑOR,3,35,18,17,4
CHIAPAS,7,PIJIJIAPAN,069,NUEVO MILENIO SANTA CRUZ LA CENTRAL,1,15,9,6,2
CHIAPAS,7,PIJIJIAPAN,069,NUEVO RÍO BRAVO,2,16,8,8,2
CHIAPAS,7,PIJIJIAPAN,069,NUEVO SANTO DOMINGO,3,21,10,11,3
CHIAPAS,7,PIJIJIAPAN,069,NUEVO TOLOMITA,2,9,5,4,2
CHIAPAS,7,PIJIJIAPAN,069,PIJIJIAPAN,35,5790,2933,2857,355
CHIAPAS,7,PIJIJIAPAN,069,PLAN DE AYALA,4,393,199,194,17
CHIAPAS,7,PIJIJIAPAN,069,PLAYA GRANDE,2,44,25,19,4
CHIAPAS,7,PIJIJIAPAN,069,POLMORONA,2,19,9,10,2
CHIAPAS,7,PIJIJIAPAN,069,PROGRESO,3,186,95,91,11
CHIAPAS,7,PIJIJIAPAN,069,PUENTE MARGARITAS,1,8,5,3,1
CHIAPAS,7,PIJIJIAPAN,069,RINCÓN DEL BOSQUE,2,9,4,5,2
CHIAPAS,7,PIJIJIAPAN,069,RIÓN,2,42,23,19,3
CHIAPAS,7,PIJIJIAPAN,069,SALTO DE AGUA,2,77,36,41,5
CHIAPAS,7,PIJIJIAPAN,069,SAN ANTONIO MIRAMAR,2,56,28,28,4
CHIAPAS,7,PIJIJIAPAN,069,SAN DIEGO,1,19,8,11,1
CHIAPAS,7,PIJIJIAPAN,069,SAN ISIDRO,4,508,267,241,24
CHIAPAS,7,PIJIJIAPAN,069,SAN JOSÉ DEL ALTO (LA CRUZ DEL MANGO),1,18,9,9,2
CHIAPAS,7,PIJIJIAPAN,069,SAN JUAN UNO,2,25,13,12,2
CHIAPAS,7,PIJIJIAPAN,069,SANTA CRUZ (PALO BLANCO),3,45,16,29,5
CHIAPAS,7,PIJIJIAPAN,069,SANTA TERESA,3,18,3,15,3
CHIAPAS,7,PIJIJIAPAN,069,SANTA ÚRSULA,2,22,10,12,3
CHIAPAS,7,PIJIJIAPAN,069,SANTA VIRGINIA,3,170,91,79,10
CHIAPAS,7,PIJIJIAPAN,069,TAMAULIPAS (JOAQUÍN AMARO),4,410,203,207,20
CHIAPAS,7,PIJIJIAPAN,069,TAPACHULITA,2,31,14,17,3
CHIAPAS,7,PIJIJIAPAN,069,TOPÓN,2,51,26,25,3
CHIAPAS,7,PIJIJIAPAN,069,TUTUÁN,3,77,33,44,5
CHIAPAS,7,PIJIJIAPAN,069,UNIÓN CARRIZAL,3,78,36,42,6
CHIAPAS,7,PIJIJIAPAN,069,UNIÓN PIJIJIAPAN,3,59,37,22,6
CHIAPAS,7,PIJIJIAPAN,069,URBINA,3,35,17,18,3
CHIAPAS,7,PIJIJIAPAN,069,VILLAHERMOSA,2,30,12,18,2
CHIAPAS,7,EL PORVENIR,070,20 DE NOVIEMBRE,3,65,33,32,4
CHIAPAS,7,EL PORVENIR,070,AGUACATALES,4,163,82,81,8
CHIAPAS,7,EL PORVENIR,070,BUENAVISTA,4,49,25,24,4
CHIAPAS,7,EL PORVENIR,070,BUENAVISTA UNO,2,52,27,25,3
CHIAPAS,7,EL PORVENIR,070,CANADÁ,3,316,166,150,14
CHIAPAS,7,EL PORVENIR,070,CAPILLA,3,114,47,67,5
CHIAPAS,7,EL PORVENIR,070,CARRIZALITO,2,25,11,14,3
CHIAPAS,7,EL PORVENIR,070,CHIMALAPA,3,144,59,85,7
CHIAPAS,7,EL PORVENIR,070,CHIMALE,4,156,84,72,9
CHIAPAS,7,EL PORVENIR,070,CUATRO CAMINOS,2,53,27,26,3
CHIAPAS,7,EL PORVENIR,070,EL CAMBIL,4,400,212,188,19
CHIAPAS,7,EL PORVENIR,070,EL CORO,1,46,23,23,1
CHIAPAS,7,EL PORVENIR,070,EL MIRADOR,1,13,3,10,1
CHIAPAS,7,EL PORVENIR,070,EL PORVENIR DE VELASCO SUÁREZ,8,1012,512,500,69
CHIAPAS,7,EL PORVENIR,070,EL REMATE,1,21,12,9,1
CHIAPAS,7,EL PORVENIR,070,EL RINCONCITO,1,27,14,13,1
CHIAPAS,7,EL PORVENIR,070,EL VOLCÁN,2,40,22,18,3
CHIAPAS,7,EL PORVENIR,070,JERICÓ,1,20,11,9,1
CHIAPAS,7,EL PORVENIR,070,JORGE DE LA VEGA DOMÍNGUEZ,2,38,20,18,3
CHIAPAS,7,EL PORVENIR,070,LAS FLORES,1,5,3,2,1
CHIAPAS,7,EL PORVENIR,070,LAS MARAVILLAS UNO,1,62,32,30,3
CHIAPAS,7,EL PORVENIR,070,LAS NUBES,2,47,20,27,3
CHIAPAS,7,EL PORVENIR,070,LAS PILAS,1,21,13,8,1
CHIAPAS,7,EL PORVENIR,070,LAS SALVIAS,3,204,112,92,11
CHIAPAS,7,EL PORVENIR,070,LOS LÓPEZ,2,22,8,14,2
CHIAPAS,7,EL PORVENIR,070,LOS PINOS,1,11,9,2,1
CHIAPAS,7,EL PORVENIR,070,MALE,6,621,327,294,39
CHIAPAS,7,EL PORVENIR,070,MALE UNO,3,104,56,48,6
CHIAPAS,7,EL PORVENIR,070,MEXICALAPA,1,28,18,10,1
CHIAPAS,7,EL PORVENIR,070,MIRAVALLE,2,84,37,47,4
CHIAPAS,7,EL PORVENIR,070,MOJÓN,2,134,62,72,5
CHIAPAS,7,EL PORVENIR,070,NUEVA ALIANZA,2,20,12,8,2
CHIAPAS,7,EL PORVENIR,070,NUEVA ESPERANZA,2,173,89,84,8
CHIAPAS,7,EL PORVENIR,070,NUEVA LIBERTAD,2,76,33,43,4
CHIAPAS,7,EL PORVENIR,070,PEÑA BLANCA,2,27,10,17,2
CHIAPAS,7,EL PORVENIR,070,PORVENIR CHIQUITO,1,9,7,2,1
CHIAPAS,7,EL PORVENIR,070,UNIÓN BUENAVISTA,2,14,4,10,2
CHIAPAS,7,EL PORVENIR,070,UNIÓN BUENAVISTA 2,1,33,18,15,2
CHIAPAS,7,EL PORVENIR,070,ZAPOTILLO,3,212,89,123,11
CHIAPAS,7,VILLA COMALTITLÁN,071,23 DE ENERO,2,23,15,8,2
CHIAPAS,7,VILLA COMALTITLÁN,071,7 PIEDRAS,3,60,34,26,4
CHIAPAS,7,VILLA COMALTITLÁN,071,ADOLFO RUÍZ CORTINEZ,1,5,2,3,1
CHIAPAS,7,VILLA COMALTITLÁN,071,AGUA FRÍA,2,16,10,6,2
CHIAPAS,7,VILLA COMALTITLÁN,071,ALTAMIRA UNO,2,54,22,32,3
CHIAPAS,7,VILLA COMALTITLÁN,071,BARRIO NUEVO (GUARDIANÍA),2,118,52,66,6
CHIAPAS,7,VILLA COMALTITLÁN,071,BENITO JUÁREZ,3,74,43,31,6
CHIAPAS,7,VILLA COMALTITLÁN,071,BRUNO GÓMEZ (ACACIA),2,28,17,11,2
CHIAPAS,7,VILLA COMALTITLÁN,071,BUENAVISTA,2,65,30,35,3
CHIAPAS,7,VILLA COMALTITLÁN,071,CANTÓN CHALACA,2,76,38,38,5
CHIAPAS,7,VILLA COMALTITLÁN,071,CANTÓN EL PROGRESO,2,78,35,43,4
CHIAPAS,7,VILLA COMALTITLÁN,071,CANTÓN IGNACIO ZARAGOZA,2,32,14,18,2
CHIAPAS,7,VILLA COMALTITLÁN,071,CANTÓN IGNACIO ZARAGOZA II,1,7,4,3,1
CHIAPAS,7,VILLA COMALTITLÁN,071,CANTÓN LAS BRISAS,5,288,145,143,16
CHIAPAS,7,VILLA COMALTITLÁN,071,CANTÓN LOS TOCAYOS,2,46,25,21,3
CHIAPAS,7,VILLA COMALTITLÁN,071,CANTÓN SAN NICOLÁS,1,5,3,2,1
CHIAPAS,7,VILLA COMALTITLÁN,071,CANTÓN SANTA CRUZ LA UNIÓN,2,153,70,83,7
CHIAPAS,7,VILLA COMALTITLÁN,071,CHAPINGO,2,40,21,19,2
CHIAPAS,7,VILLA COMALTITLÁN,071,CINCO DE MARZO (SANTA ROSA),2,22,12,10,2
CHIAPAS,7,VILLA COMALTITLÁN,071,EL ESCOBO,3,198,96,102,10
CHIAPAS,7,VILLA COMALTITLÁN,071,EMILIANO ZAPATA (LOS COCOS),3,182,95,87,10
CHIAPAS,7,VILLA COMALTITLÁN,071,FRACCIÓN LA UNIDAD NÚMERO DOS,2,62,35,27,4
CHIAPAS,7,VILLA COMALTITLÁN,071,FRACCIÓN LA UNIDAD NÚMERO UNO (PIEDRA BLANCA),1,18,12,6,1
CHIAPAS,7,VILLA COMALTITLÁN,071,HIDALGO,5,967,474,493,46
CHIAPAS,7,VILLA COMALTITLÁN,071,LA ESPERANCITA,2,38,18,20,2
CHIAPAS,7,VILLA COMALTITLÁN,071,LA FLOR LOTE DOS,3,49,23,26,5
CHIAPAS,7,VILLA COMALTITLÁN,071,LA FLOR LOTE UNO,1,35,14,21,1
CHIAPAS,7,VILLA COMALTITLÁN,071,LA GRANJA,1,5,0,5,1
CHIAPAS,7,VILLA COMALTITLÁN,071,LA UNIÓN,1,15,7,8,1
CHIAPAS,7,VILLA COMALTITLÁN,071,LAS MURALLAS,2,22,7,15,2
CHIAPAS,7,VILLA COMALTITLÁN,071,LÁZARO CÁRDENAS,4,490,261,229,22
CHIAPAS,7,VILLA COMALTITLÁN,071,LIBERTAD,1,17,9,8,1
CHIAPAS,7,VILLA COMALTITLÁN,071,MANUEL ÁVILA CAMACHO,3,230,111,119,11
CHIAPAS,7,VILLA COMALTITLÁN,071,MARCOS LÓPEZ HERNÁNDEZ,2,39,16,23,3
CHIAPAS,7,VILLA COMALTITLÁN,071,MEDIO CAMINO,2,30,21,9,3
CHIAPAS,7,VILLA COMALTITLÁN,071,MIGUEL HIDALGO Y COSTILLA (SANTO DOMINGO DOS),1,26,13,13,2
CHIAPAS,7,VILLA COMALTITLÁN,071,MONTE FLOR ABAJO,2,81,53,28,3
CHIAPAS,7,VILLA COMALTITLÁN,071,MONTE FLOR ARRIBA,3,198,102,96,9
CHIAPAS,7,VILLA COMALTITLÁN,071,NUEVO BRASIL,3,152,79,73,9
CHIAPAS,7,VILLA COMALTITLÁN,071,PAXTAL,2,44,21,23,3
CHIAPAS,7,VILLA COMALTITLÁN,071,POBLADO XOCHICALCO,1,42,16,26,2
CHIAPAS,7,VILLA COMALTITLÁN,071,PROVIDENCIA,3,119,58,61,5
CHIAPAS,7,VILLA COMALTITLÁN,071,RÍO ARRIBA SALVACIÓN,3,260,132,128,10
CHIAPAS,7,VILLA COMALTITLÁN,071,SALTILLITO,2,76,41,35,5
CHIAPAS,7,VILLA COMALTITLÁN,071,SAN JOSÉ,2,22,11,11,3
CHIAPAS,7,VILLA COMALTITLÁN,071,SANTO DOMINGO UNO,3,158,81,77,8
CHIAPAS,7,VILLA COMALTITLÁN,071,TEZIUTLÁN,3,176,85,91,9
CHIAPAS,7,VILLA COMALTITLÁN,071,UNIÓN COSTA RICA,3,93,43,50,7
CHIAPAS,7,VILLA COMALTITLÁN,071,UNIÓN HERMOSILLO,3,134,65,69,8
CHIAPAS,7,VILLA COMALTITLÁN,071,VICENTE GUERRERO,3,220,116,104,11
CHIAPAS,7,VILLA COMALTITLÁN,071,VILLA COMALTITLÁN,11,2982,1544,1438,175
CHIAPAS,7,VILLA COMALTITLÁN,071,XOCHICALCO,2,149,79,70,7
CHIAPAS,7,VILLA COMALTITLÁN,071,ZACUALPA,2,287,146,141,10
CHIAPAS,7,VILLA COMALTITLÁN,071,ZAPALUTA,2,85,40,45,5
CHIAPAS,7,PUEBLO NUEVO SOLISTAHUACÁN,072,AÑO DE JUÁREZ,4,263,140,123,13
CHIAPAS,7,PUEBLO NUEVO SOLISTAHUACÁN,072,ARROYO GRANDE,3,434,202,232,20
CHIAPAS,7,PUEBLO NUEVO SOLISTAHUACÁN,072,AURORA EL DURAZNAL,2,25,7,18,2
CHIAPAS,7,PUEBLO NUEVO SOLISTAHUACÁN,072,AURORA ERMITA,3,222,114,108,11
CHIAPAS,7,PUEBLO NUEVO SOLISTAHUACÁN,072,AVELLANO BUENAVISTA,2,116,57,59,5
CHIAPAS,7,PUEBLO NUEVO SOLISTAHUACÁN,072,BELÉN BUENAVISTA,1,5,2,3,1
CHIAPAS,7,PUEBLO NUEVO SOLISTAHUACÁN,072,BENITO JUÁREZ,3,111,58,53,8
CHIAPAS,7,PUEBLO NUEVO SOLISTAHUACÁN,072,BUENAVISTA LA MONTAÑA,2,50,25,25,5
CHIAPAS,7,PUEBLO NUEVO SOLISTAHUACÁN,072,CACATEAL,3,24,17,7,3
CHIAPAS,7,PUEBLO NUEVO SOLISTAHUACÁN,072,CERRO LAS NUBES,2,24,10,14,3
CHIAPAS,7,PUEBLO NUEVO SOLISTAHUACÁN,072,COLEGIO LINDAVISTA,3,243,137,106,32
CHIAPAS,7,PUEBLO NUEVO SOLISTAHUACÁN,072,DELIRIO,2,18,7,11,2
CHIAPAS,7,PUEBLO NUEVO SOLISTAHUACÁN,072,EL CAMPAMENTO (CERRO BLANCO),2,14,8,6,2
CHIAPAS,7,PUEBLO NUEVO SOLISTAHUACÁN,072,EL CAMPANARIO,1,19,8,11,1
CHIAPAS,7,PUEBLO NUEVO SOLISTAHUACÁN,072,EL ESTORAQUE,2,168,88,80,7
CHIAPAS,7,PUEBLO NUEVO SOLISTAHUACÁN,072,EL JARDÍN,1,7,2,5,1
CHIAPAS,7,PUEBLO NUEVO SOLISTAHUACÁN,072,EL PROGRESO (NUEVO HORIZONTE),3,47,22,25,5
CHIAPAS,7,PUEBLO NUEVO SOLISTAHUACÁN,072,EL SAUZ,2,11,4,7,2
CHIAPAS,7,PUEBLO NUEVO SOLISTAHUACÁN,072,EL TRIUNFO,2,19,8,11,2
CHIAPAS,7,PUEBLO NUEVO SOLISTAHUACÁN,072,EMILIANO ZAPATA (SAN JERÓNIMO),2,86,52,34,3
CHIAPAS,7,PUEBLO NUEVO SOLISTAHUACÁN,072,ESQUIPULAS,3,15,8,7,3
CHIAPAS,7,PUEBLO NUEVO SOLISTAHUACÁN,072,GUADALUPE,2,11,3,8,1
CHIAPAS,7,PUEBLO NUEVO SOLISTAHUACÁN,072,LA SIDRA,2,44,24,20,2
CHIAPAS,7,PUEBLO NUEVO SOLISTAHUACÁN,072,LAS PALMAS,2,55,34,21,4
CHIAPAS,7,PUEBLO NUEVO SOLISTAHUACÁN,072,LÁZARO CÁRDENAS,3,240,115,125,10
CHIAPAS,7,PUEBLO NUEVO SOLISTAHUACÁN,072,LINDAVISTA,3,168,88,80,5
CHIAPAS,7,PUEBLO NUEVO SOLISTAHUACÁN,072,LOS ÁNGELES,3,60,35,25,5
CHIAPAS,7,PUEBLO NUEVO SOLISTAHUACÁN,072,LOS LOTES,2,196,101,95,8
CHIAPAS,7,PUEBLO NUEVO SOLISTAHUACÁN,072,LOS MANANTIALES,2,18,6,12,2
CHIAPAS,7,PUEBLO NUEVO SOLISTAHUACÁN,072,LOS PORTILLOS,2,22,14,8,2
CHIAPAS,7,PUEBLO NUEVO SOLISTAHUACÁN,072,MONTE OLIVO,3,150,67,83,8
CHIAPAS,7,PUEBLO NUEVO SOLISTAHUACÁN,072,NUEVO OCOTAL,2,15,10,5,2
CHIAPAS,7,PUEBLO NUEVO SOLISTAHUACÁN,072,NUEVO OCOTAL (BUENAVISTA),1,8,6,2,1
CHIAPAS,7,PUEBLO NUEVO SOLISTAHUACÁN,072,NUEVO SOCONUSCO EL AVELLANO,2,21,9,12,2
CHIAPAS,7,PUEBLO NUEVO SOLISTAHUACÁN,072,PALO BLANCO (ANÁHUAC),3,205,91,114,10
CHIAPAS,7,PUEBLO NUEVO SOLISTAHUACÁN,072,PLAN DE AYALA,2,18,6,12,2
CHIAPAS,7,PUEBLO NUEVO SOLISTAHUACÁN,072,PLAN LÁZARO CÁRDENAS,2,81,39,42,4
CHIAPAS,7,PUEBLO NUEVO SOLISTAHUACÁN,072,PUEBLO NUEVO SOLISTAHUACÁN,26,4149,2118,2031,255
CHIAPAS,7,PUEBLO NUEVO SOLISTAHUACÁN,072,PUERTO RICO,3,48,30,18,4
CHIAPAS,7,PUEBLO NUEVO SOLISTAHUACÁN,072,RINCÓN CHAMULA,1,106,45,61,3
CHIAPAS,7,PUEBLO NUEVO SOLISTAHUACÁN,072,RÍO COLORADO (LA LAGUNA),3,79,38,41,7
CHIAPAS,7,PUEBLO NUEVO SOLISTAHUACÁN,072,SAN ISIDRO,1,15,6,9,1
CHIAPAS,7,PUEBLO NUEVO SOLISTAHUACÁN,072,SAN JOSÉ CHAPAYAL,5,1037,521,516,35
CHIAPAS,7,PUEBLO NUEVO SOLISTAHUACÁN,072,SAN RAFAEL,4,448,233,215,17
CHIAPAS,7,PUEBLO NUEVO SOLISTAHUACÁN,072,SANTA RITA,3,97,52,45,6
CHIAPAS,7,PUEBLO NUEVO SOLISTAHUACÁN,072,SHUTAL,3,104,52,52,6
CHIAPAS,7,PUEBLO NUEVO SOLISTAHUACÁN,072,SOCONUSCO,3,147,63,84,9
CHIAPAS,7,PUEBLO NUEVO SOLISTAHUACÁN,072,SONORA,7,677,338,339,54
CHIAPAS,7,RAYÓN,073,AGUACATE PIJUY,1,6,2,4,1
CHIAPAS,7,RAYÓN,073,ANEXO LAS NUBES,3,54,34,20,4
CHIAPAS,7,RAYÓN,073,CACATE,1,4,4,0,1
CHIAPAS,7,RAYÓN,073,CARRIZAL,2,55,32,23,4
CHIAPAS,7,RAYÓN,073,CRUZ VERDE,1,7,4,3,1
CHIAPAS,7,RAYÓN,073,CUMBRE DE MANZANILLO,1,5,4,1,1
CHIAPAS,7,RAYÓN,073,EL MECATAL,3,45,17,28,3
CHIAPAS,7,RAYÓN,073,EL PINABETO,2,251,130,121,9
CHIAPAS,7,RAYÓN,073,EL POZO,1,7,3,4,1
CHIAPAS,7,RAYÓN,073,GUADALUPE VICTORIA,4,180,87,93,10
CHIAPAS,7,RAYÓN,073,JOSÉ DOLORES LÓPEZ DOMÍNGUEZ,2,28,14,14,2
CHIAPAS,7,RAYÓN,073,LA NARANJA,1,5,3,2,1
CHIAPAS,7,RAYÓN,073,LA SOLEDAD,2,17,9,8,2
CHIAPAS,7,RAYÓN,073,LA UNIÓN NUEVA,2,29,12,17,2
CHIAPAS,7,RAYÓN,073,MANZANILLO PINABETO,3,205,97,108,9
CHIAPAS,7,RAYÓN,073,NOPALITO,2,41,22,19,3
CHIAPAS,7,RAYÓN,073,RAYÓN,14,3130,1608,1522,134
CHIAPAS,7,RAYÓN,073,RIVERA SAN ANTONIO,2,44,27,17,3
CHIAPAS,7,RAYÓN,073,RIVERA SAN SEBASTIÁN,1,40,14,26,2
CHIAPAS,7,RAYÓN,073,RIVERA UNIÓN LAJAS,3,20,7,13,3
CHIAPAS,7,RAYÓN,073,SAN ANTONIO CANELAR,2,12,5,7,2
CHIAPAS,7,RAYÓN,073,SAN FRANCISCO,2,38,16,22,2
CHIAPAS,7,RAYÓN,073,SEBASTIÁN PÉREZ NUÑEZ,2,17,8,9,2
CHIAPAS,7,REFORMA,074,CRISTO REY,3,117,54,63,7
CHIAPAS,7,REFORMA,074,EL CARACOL,3,38,16,22,3
CHIAPAS,7,REFORMA,074,EL CARMEN (EL LIMÓN),4,844,360,484,51
CHIAPAS,7,REFORMA,074,EL LIMONCITO,3,99,39,60,5
CHIAPAS,7,REFORMA,074,EL ROSARIO,3,26,10,16,3
CHIAPAS,7,REFORMA,074,EL TRAPICHE,3,60,25,35,5
CHIAPAS,7,REFORMA,074,EMILIANO ZAPATA,4,230,115,115,12
CHIAPAS,7,REFORMA,074,FRANCISCO I. MADERO,1,28,13,15,1
CHIAPAS,7,REFORMA,074,GUSTAVO AGUIRRE BENAVIDES 1RA. SECCIÓN,1,52,20,32,2
CHIAPAS,7,REFORMA,074,IGNACIO ZARAGOZA,2,88,40,48,4
CHIAPAS,7,REFORMA,074,JUAN SABINES GUTIÉRREZ,3,30,17,13,4
CHIAPAS,7,REFORMA,074,LA CEIBA,3,91,45,46,5
CHIAPAS,7,REFORMA,074,LA UNIÓN,1,98,47,51,3
CHIAPAS,7,REFORMA,074,MACAYO 1RA. SECCIÓN (LAS MERCEDES),3,59,33,26,4
CHIAPAS,7,REFORMA,074,MACAYO 2DA. SECCIÓN,3,199,93,106,11
CHIAPAS,7,REFORMA,074,MACAYO 3RA. SECCIÓN,4,159,67,92,10
CHIAPAS,7,REFORMA,074,MACAYO 5TA. SECCIÓN,2,18,12,6,2
CHIAPAS,7,REFORMA,074,MIGUEL ALDAMA,2,30,16,14,2
CHIAPAS,7,REFORMA,074,MIGUEL HIDALGO,2,45,19,26,4
CHIAPAS,7,REFORMA,074,MORELOS 1RA. SECCIÓN,2,18,11,7,2
CHIAPAS,7,REFORMA,074,MORELOS 2DA. SECCIÓN,3,100,46,54,6
CHIAPAS,7,REFORMA,074,PRESIDENTES,1,128,65,63,6
CHIAPAS,7,REFORMA,074,RAFAEL PASCACIO GAMBOA,4,503,243,260,24
CHIAPAS,7,REFORMA,074,REFORMA,47,8724,4457,4267,485
CHIAPAS,7,REFORMA,074,SAN JOSÉ LIMONCITO,1,8,2,6,1
CHIAPAS,7,REFORMA,074,SAN MIGUEL 1RA. SECCIÓN,4,379,180,199,12
CHIAPAS,7,REFORMA,074,SAN MIGUEL 2DA. SECCIÓN,3,155,76,79,9
CHIAPAS,7,REFORMA,074,SANTA CRUZ (SITIO GRANDE),3,85,29,56,12
CHIAPAS,7,REFORMA,074,VICENTE GUERRERO,2,23,9,14,2
CHIAPAS,7,REFORMA,074,ZAPOTAL 1RA. SECCIÓN,2,42,25,17,3
CHIAPAS,7,REFORMA,074,ZAPOTAL 2DA. SECCIÓN,3,54,25,29,4
CHIAPAS,7,REFORMA,074,ZAPOTAL 3RA. SECCIÓN,2,15,7,8,1
CHIAPAS,7,LAS ROSAS,075,CANJOBITO,2,30,10,20,2
CHIAPAS,7,LAS ROSAS,075,CHITAMA,2,45,17,28,2
CHIAPAS,7,LAS ROSAS,075,CORRAL HIERBA,2,154,76,78,5
CHIAPAS,7,LAS ROSAS,075,CRUZ MORALES,3,77,39,38,4
CHIAPAS,7,LAS ROSAS,075,EL BARREÑO,1,21,12,9,1
CHIAPAS,7,LAS ROSAS,075,EL CABILDO,2,90,32,58,6
CHIAPAS,7,LAS ROSAS,075,EL CHIPILINAR,2,66,35,31,3
CHIAPAS,7,LAS ROSAS,075,EL CIPRÉS,3,56,24,32,3
CHIAPAS,7,LAS ROSAS,075,EL PIÑUELAR,1,16,5,11,1
CHIAPAS,7,LAS ROSAS,075,EL ZAPOTE,2,30,16,14,2
CHIAPAS,7,LAS ROSAS,075,EMILIANO ZAPATA,1,22,9,13,1
CHIAPAS,7,LAS ROSAS,075,GUADALUPE LAS CANOAS,2,37,18,19,3
CHIAPAS,7,LAS ROSAS,075,IXTAPILLA,5,331,165,166,17
CHIAPAS,7,LAS ROSAS,075,LA FORTUNA,2,58,31,27,3
CHIAPAS,7,LAS ROSAS,075,LAS GUAYABITAS,1,19,10,9,1
CHIAPAS,7,LAS ROSAS,075,LAS LAJAS,1,34,18,16,2
CHIAPAS,7,LAS ROSAS,075,LAS ROSAS,32,5339,2746,2593,241
CHIAPAS,7,LAS ROSAS,075,LÁZARO CÁRDENAS DEL RÍO,2,39,20,19,3
CHIAPAS,7,LAS ROSAS,075,NUEVO TEPEYAC,2,66,35,31,3
CHIAPAS,7,LAS ROSAS,075,PLANTA VIEJA,1,21,12,9,1
CHIAPAS,7,LAS ROSAS,075,SAN ANTONIO EL PARAJE,2,91,41,50,4
CHIAPAS,7,LAS ROSAS,075,SAN CARALAMPIO NEVATAJ,2,12,6,6,2
CHIAPAS,7,LAS ROSAS,075,SAN JOSÉ,2,460,240,220,14
CHIAPAS,7,LAS ROSAS,075,SAN JUAN DE LAS TUNAS,3,47,31,16,3
CHIAPAS,7,LAS ROSAS,075,SAN LUIS,1,8,4,4,1
CHIAPAS,7,LAS ROSAS,075,SAN MATEO,2,65,29,36,3
CHIAPAS,7,LAS ROSAS,075,SANTA CRUZ,1,55,26,29,3
CHIAPAS,7,LAS ROSAS,075,TRES AMORES,2,78,36,42,3
CHIAPAS,7,LAS ROSAS,075,TZUJULA II,3,23,11,12,3
CHIAPAS,7,LAS ROSAS,075,YALPALE,1,29,10,19,2
CHIAPAS,7,LAS ROSAS,075,ZACUALPA,3,187,93,94,9
CHIAPAS,7,SABANILLA,076,12 DE OCTUBRE,1,5,3,2,1
CHIAPAS,7,SABANILLA,076,20 DE NOVIEMBRE,3,173,74,99,8
CHIAPAS,7,SABANILLA,076,6 DE SEPTIEMBRE,2,19,6,13,2
CHIAPAS,7,SABANILLA,076,ALEGRÍA,2,31,18,13,3
CHIAPAS,7,SABANILLA,076,ANDRÉS QUINTANA ROO,6,576,279,297,20
CHIAPAS,7,SABANILLA,076,ASUNCIÓN HUITIUPAN,4,197,93,104,11
CHIAPAS,7,SABANILLA,076,ATOYAC NAYLUM,3,186,94,92,10
CHIAPAS,7,SABANILLA,076,BENITO JUÁREZ,2,13,5,8,2
CHIAPAS,7,SABANILLA,076,BENITO JUÁREZ 2DA. SECCIÓN,3,45,22,23,4
CHIAPAS,7,SABANILLA,076,BUENAVISTA,3,370,178,192,13
CHIAPAS,7,SABANILLA,076,CERRO BLANCO,2,67,36,31,4
CHIAPAS,7,SABANILLA,076,CERRO DE NAVA,2,87,42,45,3
CHIAPAS,7,SABANILLA,076,CHILINTIEL DE JUÁREZ,1,7,4,3,1
CHIAPAS,7,SABANILLA,076,CRISTÓBAL COLÓN,3,288,148,140,10
CHIAPAS,7,SABANILLA,076,DOCTOR MANUEL VELASCO SUÁREZ,2,69,37,32,3
CHIAPAS,7,SABANILLA,076,EL BEBEDERO,3,214,102,112,8
CHIAPAS,7,SABANILLA,076,EL CALVARIO,5,623,315,308,19
CHIAPAS,7,SABANILLA,076,EL CAPUYIL,2,20,8,12,2
CHIAPAS,7,SABANILLA,076,EL MIRADOR,2,153,72,81,4
CHIAPAS,7,SABANILLA,076,EL PARAÍSO,3,302,148,154,12
CHIAPAS,7,SABANILLA,076,EL VERGEL,2,23,8,15,2
CHIAPAS,7,SABANILLA,076,EMILIANO ZAPATA,3,69,34,35,3
CHIAPAS,7,SABANILLA,076,FLOR DE GUACAMAYA,1,14,8,6,1
CHIAPAS,7,SABANILLA,076,FRANCISCO VILLA,2,95,56,39,6
CHIAPAS,7,SABANILLA,076,FRONTERA EMILIANO ZAPATA,1,11,4,7,1
CHIAPAS,7,SABANILLA,076,GENERAL CASTELLANOS DOMÍNGUEZ,2,51,21,30,5
CHIAPAS,7,SABANILLA,076,JESÚS CARRANZA,4,295,154,141,13
CHIAPAS,7,SABANILLA,076,JUAN GONZÁLEZ ESPONDA,2,21,13,8,2
CHIAPAS,7,SABANILLA,076,LA PROVIDENCIA,2,48,25,23,2
CHIAPAS,7,SABANILLA,076,LAS ADELITAS,1,5,3,2,1
CHIAPAS,7,SABANILLA,076,LAS PALMAS SANTA CATARINA,2,133,59,74,6
CHIAPAS,7,SABANILLA,076,LÁZARO CÁRDENAS DEL RÍO,3,116,51,65,5
CHIAPAS,7,SABANILLA,076,LOS MANGOS,2,11,5,6,1
CHIAPAS,7,SABANILLA,076,LOS MARTÍNEZ,2,92,42,50,2
CHIAPAS,7,SABANILLA,076,LOS NARANJOS,7,975,489,486,36
CHIAPAS,7,SABANILLA,076,MAJASTIC,4,487,227,260,13
CHIAPAS,7,SABANILLA,076,MOYOS,5,770,379,391,45
CHIAPAS,7,SABANILLA,076,NUEVO MÉXICO,2,77,46,31,4
CHIAPAS,7,SABANILLA,076,NUEVO POBLADO SAKIJA,2,86,39,47,3
CHIAPAS,7,SABANILLA,076,PASIJA DE MORELOS 1RA. SECCIÓN,1,4,3,1,1
CHIAPAS,7,SABANILLA,076,PASIJÁ DE MORELOS 2DA. SECCIÓN,1,6,5,1,1
CHIAPAS,7,SABANILLA,076,QUIOICH,2,85,43,42,3
CHIAPAS,7,SABANILLA,076,SABANILLA,11,1966,925,1041,76
CHIAPAS,7,SABANILLA,076,SAN JUAN EL MIRADOR,2,129,68,61,2
CHIAPAS,7,SABANILLA,076,SAN MARCOS,1,39,19,20,3
CHIAPAS,7,SABANILLA,076,SAN PATRICIO,2,66,34,32,3
CHIAPAS,7,SABANILLA,076,SAN PEDRO,2,30,18,12,2
CHIAPAS,7,SABANILLA,076,SAN RAFAEL,2,30,17,13,2
CHIAPAS,7,SABANILLA,076,SANTANA,1,4,2,2,1
CHIAPAS,7,SABANILLA,076,SHUSHUPÁ,3,61,28,33,3
CHIAPAS,7,SABANILLA,076,UNIÓN HIDALGO (EL CHORRO),3,519,268,251,7
CHIAPAS,7,SABANILLA,076,UNIÓN JUÁREZ,3,496,252,244,12
CHIAPAS,7,SABANILLA,076,VILLAFLORES,2,62,30,32,4
CHIAPAS,7,SALTO DE AGUA,077,ACH'LUM MAYA,2,41,23,18,2
CHIAPAS,7,SALTO DE AGUA,077,ACTIEPA YOCHIB,4,293,146,147,13
CHIAPAS,7,SALTO DE AGUA,077,ADOLFO RUIZ CORTÍNES,3,159,83,76,8
CHIAPAS,7,SALTO DE AGUA,077,AGUA BLANCA,4,372,180,192,17
CHIAPAS,7,SALTO DE AGUA,077,AGUA CLARA,2,106,53,53,4
CHIAPAS,7,SALTO DE AGUA,077,AGUA VIVA,3,20,9,11,3
CHIAPAS,7,SALTO DE AGUA,077,AMÉRICA LIBRE,2,97,44,53,4
CHIAPAS,7,SALTO DE AGUA,077,AMUYPA CHICO,2,40,18,22,2
CHIAPAS,7,SALTO DE AGUA,077,ARROYO AGUA AZUL (MIRAFLORES),3,105,58,47,5
CHIAPAS,7,SALTO DE AGUA,077,ARROYO EL ENCANTO 1RA. SECCIÓN,3,154,64,90,7
CHIAPAS,7,SALTO DE AGUA,077,ARROYO PALENQUE,3,391,192,199,17
CHIAPAS,7,SALTO DE AGUA,077,AYOWE,1,58,32,26,2
CHIAPAS,7,SALTO DE AGUA,077,BELISARIO DOMÍNGUEZ,3,439,208,231,16
CHIAPAS,7,SALTO DE AGUA,077,BENITO JUÁREZ,2,104,37,67,4
CHIAPAS,7,SALTO DE AGUA,077,BETHEL YOCHIB,3,268,123,145,9
CHIAPAS,7,SALTO DE AGUA,077,BUENAVISTA,3,227,109,118,12
CHIAPAS,7,SALTO DE AGUA,077,CACATEEL,2,19,8,11,2
CHIAPAS,7,SALTO DE AGUA,077,CAMPANARIO CHICO,2,30,17,13,2
CHIAPAS,7,SALTO DE AGUA,077,CASCADA AMUYPA,2,47,26,21,3
CHIAPAS,7,SALTO DE AGUA,077,CENOBIO AGUILAR (LA TRINIDAD),4,766,362,404,30
CHIAPAS,7,SALTO DE AGUA,077,CERRO NORTE DON JUAN,3,194,102,92,8
CHIAPAS,7,SALTO DE AGUA,077,CHAPAYAL,2,42,19,23,2
CHIAPAS,7,SALTO DE AGUA,077,CHIVALITO 1RA. SECCIÓN,2,45,26,19,3
CHIAPAS,7,SALTO DE AGUA,077,CHIVALITO 2DA. SECCIÓN,4,236,115,121,11
CHIAPAS,7,SALTO DE AGUA,077,CHIVALITO 3RA. SECCIÓN,1,37,17,20,1
CHIAPAS,7,SALTO DE AGUA,077,CHIVALTIC NUEVO,3,283,135,148,12
CHIAPAS,7,SALTO DE AGUA,077,CHUCHUCLUMIL,3,196,100,96,9
CHIAPAS,7,SALTO DE AGUA,077,CRISTOBAL COLÓN (MIGUEL HIDALGO),1,10,5,5,1
CHIAPAS,7,SALTO DE AGUA,077,DELICIAS LAS FLORES 2DA. SECCIÓN,3,41,16,25,4
CHIAPAS,7,SALTO DE AGUA,077,DOCTOR MANUEL VELASCO SUÁREZ (PROVIDENCIA),2,50,21,29,3
CHIAPAS,7,SALTO DE AGUA,077,DOS ARROYOS 1RA. SECCIÓN,2,173,76,97,9
CHIAPAS,7,SALTO DE AGUA,077,DOS ARROYOS 2DA. SECCIÓN (LA CALZADA),2,137,56,81,6
CHIAPAS,7,SALTO DE AGUA,077,DOS RÍOS,3,75,39,36,4
CHIAPAS,7,SALTO DE AGUA,077,EGIPTO,4,628,301,327,24
CHIAPAS,7,SALTO DE AGUA,077,EL BASCÁN (LUCHA BASCÁN),2,100,47,53,5
CHIAPAS,7,SALTO DE AGUA,077,EL CONEJO,2,76,37,39,4
CHIAPAS,7,SALTO DE AGUA,077,EL COROZO (EL BAJO GRANDE),2,83,39,44,3
CHIAPAS,7,SALTO DE AGUA,077,EL FARO,2,31,13,18,2
CHIAPAS,7,SALTO DE AGUA,077,EL FARO JUSHIL,2,43,28,15,2
CHIAPAS,7,SALTO DE AGUA,077,EL GUANALITO,2,13,5,8,2
CHIAPAS,7,SALTO DE AGUA,077,EL MICHOL,2,15,9,6,2
CHIAPAS,7,SALTO DE AGUA,077,EL PROGRESO,3,264,123,141,11
CHIAPAS,7,SALTO DE AGUA,077,EL RETIRO,2,33,16,17,2
CHIAPAS,7,SALTO DE AGUA,077,EL RUBÍ TULIJA,2,59,26,33,3
CHIAPAS,7,SALTO DE AGUA,077,EL TORO,2,84,39,45,5
CHIAPAS,7,SALTO DE AGUA,077,EL TORTUGUERO 1RA. SECCIÓN,4,317,146,171,12
CHIAPAS,7,SALTO DE AGUA,077,EL TORTUGUERO 2DA. SECCIÓN,2,66,30,36,3
CHIAPAS,7,SALTO DE AGUA,077,EL TRIUNFO,1,10,3,7,1
CHIAPAS,7,SALTO DE AGUA,077,EL ZAPOTE 1RA. SECCIÓN,2,118,57,61,5
CHIAPAS,7,SALTO DE AGUA,077,EMILIANO ZAPATA,4,88,49,39,5
CHIAPAS,7,SALTO DE AGUA,077,EMILIANO ZAPATA (LA PRECIOSA),1,10,4,6,1
CHIAPAS,7,SALTO DE AGUA,077,ESTRELLA DE BELÉN,3,405,210,195,17
CHIAPAS,7,SALTO DE AGUA,077,FRANCISCO I. MADERO,2,182,86,96,9
CHIAPAS,7,SALTO DE AGUA,077,GENERACIÓN NOVENTA Y CINCO,2,37,19,18,2
CHIAPAS,7,SALTO DE AGUA,077,GUADALUPE,1,12,7,5,1
CHIAPAS,7,SALTO DE AGUA,077,GUANALITO 2DA. SECCIÓN,2,9,5,4,1
CHIAPAS,7,SALTO DE AGUA,077,HUANAL,2,12,7,5,2
CHIAPAS,7,SALTO DE AGUA,077,IGNACIO ALLENDE,2,46,25,21,2
CHIAPAS,7,SALTO DE AGUA,077,IGNACIO ZARAGOZA,5,485,207,278,17
CHIAPAS,7,SALTO DE AGUA,077,INDEPENDENCIA,2,88,43,45,4
CHIAPAS,7,SALTO DE AGUA,077,JATIEOL,2,33,13,20,2
CHIAPAS,7,SALTO DE AGUA,077,JERUSALÉN,4,537,266,271,42
CHIAPAS,7,SALTO DE AGUA,077,JESÚS NAZARENO,2,58,30,28,3
CHIAPAS,7,SALTO DE AGUA,077,JILUMIL,4,203,96,107,10
CHIAPAS,7,SALTO DE AGUA,077,JOSÉ MARÍA MORELOS Y PAVÓN,2,81,42,39,3
CHIAPAS,7,SALTO DE AGUA,077,JOSÉ MARÍA PINO SUÁREZ,2,84,41,43,3
CHIAPAS,7,SALTO DE AGUA,077,LA CASCADA SECCIÓN VII,1,5,4,1,1
CHIAPAS,7,SALTO DE AGUA,077,LA CONCORDIA (MONTE GRANDE),2,40,20,20,2
CHIAPAS,7,SALTO DE AGUA,077,LA CONFORMIDAD,2,69,35,34,3
CHIAPAS,7,SALTO DE AGUA,077,LA FLOR DE BASCÁN,2,69,36,33,3
CHIAPAS,7,SALTO DE AGUA,077,LA GRANJA,3,43,25,18,4
CHIAPAS,7,SALTO DE AGUA,077,LA ROSA DE BASCÁN 1RA. SECCIÓN,1,5,3,2,1
CHIAPAS,7,SALTO DE AGUA,077,LA TRONCONADA,2,117,62,55,6
CHIAPAS,7,SALTO DE AGUA,077,LAS COLMENAS,2,70,34,36,3
CHIAPAS,7,SALTO DE AGUA,077,LAS NUBES,3,17,7,10,3
CHIAPAS,7,SALTO DE AGUA,077,LAS PALMAS,2,65,28,37,3
CHIAPAS,7,SALTO DE AGUA,077,LAS VEGAS,1,5,2,3,1
CHIAPAS,7,SALTO DE AGUA,077,LÁZARO CÁRDENAS,3,106,59,47,5
CHIAPAS,7,SALTO DE AGUA,077,LICENCIADO LUIS ECHEVERRÍA ÁLVAREZ,2,105,50,55,4
CHIAPAS,7,SALTO DE AGUA,077,LINDAVISTA,2,22,12,10,2
CHIAPAS,7,SALTO DE AGUA,077,LOMAS DE VENADO,2,98,55,43,4
CHIAPAS,7,SALTO DE AGUA,077,LOS LUCEROS 1RA. SECCIÓN,3,149,61,88,8
CHIAPAS,7,SALTO DE AGUA,077,LOS LUCEROS 2DA. SECCIÓN,3,164,84,80,7
CHIAPAS,7,SALTO DE AGUA,077,LOTE OCHO (LA GLORIA),2,116,59,57,5
CHIAPAS,7,SALTO DE AGUA,077,LUMIJA,2,43,24,19,3
CHIAPAS,7,SALTO DE AGUA,077,LUMIJA 2DA. SECCIÓN,2,10,6,4,2
CHIAPAS,7,SALTO DE AGUA,077,LUMIJÁ 3RA. SECCIÓN,2,12,6,6,2
CHIAPAS,7,SALTO DE AGUA,077,MI PATRIA ES PRIMERO,2,44,24,20,2
CHIAPAS,7,SALTO DE AGUA,077,MIGUEL HIDALGO DOS,1,6,1,5,1
CHIAPAS,7,SALTO DE AGUA,077,MONTEBELLO FRACCIÓN I,1,11,6,5,1
CHIAPAS,7,SALTO DE AGUA,077,NAZARETH,3,160,73,87,9
CHIAPAS,7,SALTO DE AGUA,077,NUEVA ESPERANZA,2,63,28,35,3
CHIAPAS,7,SALTO DE AGUA,077,NUEVA PALESTINA (SAN JORGE),1,19,10,9,2
CHIAPAS,7,SALTO DE AGUA,077,NUEVA PRECIOSA (BULUJIB),2,89,40,49,4
CHIAPAS,7,SALTO DE AGUA,077,NUEVO BERLÍN,2,100,53,47,4
CHIAPAS,7,SALTO DE AGUA,077,NUEVO EMILIANO ZAPATA,2,14,8,6,2
CHIAPAS,7,SALTO DE AGUA,077,NUEVO JOSHIL (LOMA BONITA),1,14,4,10,1
CHIAPAS,7,SALTO DE AGUA,077,NUEVO MUNDO,5,294,152,142,12
CHIAPAS,7,SALTO DE AGUA,077,PALMA TULIJÁ,2,79,40,39,3
CHIAPAS,7,SALTO DE AGUA,077,PASO NARANJO 1RA. SECCIÓN,2,89,39,50,3
CHIAPAS,7,SALTO DE AGUA,077,PLAN DE AYALA,3,45,23,22,5
CHIAPAS,7,SALTO DE AGUA,077,POTIOJA 1RA. SECCIÓN,2,44,23,21,3
CHIAPAS,7,SALTO DE AGUA,077,POTIOJA 2DA. SECCIÓN,2,75,38,37,3
CHIAPAS,7,SALTO DE AGUA,077,PRIMERO DE ENERO,1,18,11,7,1
CHIAPAS,7,SALTO DE AGUA,077,PUEBLO NUEVO,2,43,22,21,3
CHIAPAS,7,SALTO DE AGUA,077,PUNTA BRAVA 1RA. SECCIÓN,2,109,53,56,5
CHIAPAS,7,SALTO DE AGUA,077,PUNTA BRAVA 2DA. SECCIÓN,4,222,113,109,11
CHIAPAS,7,SALTO DE AGUA,077,RECUERDO IXTELJA,1,22,12,10,1
CHIAPAS,7,SALTO DE AGUA,077,RÍO JORDÁN,3,606,273,333,20
CHIAPAS,7,SALTO DE AGUA,077,RÍO TULIJA,2,204,101,103,8
CHIAPAS,7,SALTO DE AGUA,077,SALTO DE AGUA,17,2442,1196,1246,144
CHIAPAS,7,SALTO DE AGUA,077,SAN AGUSTÍN,2,82,32,50,5
CHIAPAS,7,SALTO DE AGUA,077,SAN ANDRÉS,2,68,31,37,3
CHIAPAS,7,SALTO DE AGUA,077,SAN FRANCISCO NO TE DIJE,2,37,17,20,3
CHIAPAS,7,SALTO DE AGUA,077,SAN JOSÉ EL BASCÁN,1,7,2,5,1
CHIAPAS,7,SALTO DE AGUA,077,SAN JOSÉ IXTELJA,2,22,10,12,2
CHIAPAS,7,SALTO DE AGUA,077,SAN JOSÉ SIVALCHEN,2,43,21,22,3
CHIAPAS,7,SALTO DE AGUA,077,SAN JUAN BARTOLOMÉ,2,172,81,91,5
CHIAPAS,7,SALTO DE AGUA,077,SAN JUAN DEL ALTO 1RA. SECCIÓN,1,18,8,10,1
CHIAPAS,7,SALTO DE AGUA,077,SAN MIGUEL,3,423,208,215,20
CHIAPAS,7,SALTO DE AGUA,077,SAN MIGUEL TULIJA,3,87,48,39,4
CHIAPAS,7,SALTO DE AGUA,077,SAN PEDRO SABANA,4,365,166,199,16
CHIAPAS,7,SALTO DE AGUA,077,SAN RAFAEL,2,59,30,29,3
CHIAPAS,7,SALTO DE AGUA,077,SANTA CRUZ DE LUMIJA,3,41,19,22,4
CHIAPAS,7,SALTO DE AGUA,077,SANTA LUCÍA 1RA. SECCIÓN,2,55,25,30,3
CHIAPAS,7,SALTO DE AGUA,077,SANTA LUCÍA 2DA. SECCIÓN,3,130,79,51,7
CHIAPAS,7,SALTO DE AGUA,077,SANTA MARÍA,3,323,164,159,13
CHIAPAS,7,SALTO DE AGUA,077,SANTA ROSA,2,14,9,5,2
CHIAPAS,7,SALTO DE AGUA,077,SANTA ROSA BASCÁN,2,13,5,8,2
CHIAPAS,7,SALTO DE AGUA,077,SHINTIEJA,2,22,13,9,3
CHIAPAS,7,SALTO DE AGUA,077,SUCLUMPA,4,858,413,445,17
CHIAPAS,7,SALTO DE AGUA,077,TEANIJÁ,1,17,8,9,1
CHIAPAS,7,SALTO DE AGUA,077,TIEMOPA,3,200,113,87,11
CHIAPAS,7,SALTO DE AGUA,077,TIENTIUL GRANDE 1RA. SECCIÓN,2,52,18,34,2
CHIAPAS,7,SALTO DE AGUA,077,TIENTIUL GRANDE 2DA. SECCIÓN (AGUA POTABLE),3,200,98,102,8
CHIAPAS,7,SALTO DE AGUA,077,TIERRA Y LIBERTAD,2,70,33,37,4
CHIAPAS,7,SALTO DE AGUA,077,TIOQUIPA EL BASCÁN,3,307,146,161,12
CHIAPAS,7,SALTO DE AGUA,077,TRÁNSITO PARAÍSO,2,23,11,12,2
CHIAPAS,7,SALTO DE AGUA,077,TRAPICHE,4,270,130,140,13
CHIAPAS,7,SALTO DE AGUA,077,ÚRSULO GALVÁN,4,288,151,137,12
CHIAPAS,7,SALTO DE AGUA,077,VICENTE GUERRERO,5,729,360,369,27
CHIAPAS,7,SALTO DE AGUA,077,XUYA-HA,2,70,33,37,3
CHIAPAS,7,SALTO DE AGUA,077,YAXSCHÁ,3,63,26,37,5
CHIAPAS,7,SALTO DE AGUA,077,YIXHTIÉ,1,8,4,4,1
CHIAPAS,7,SAN CRISTÓBAL DE LAS CASAS,078,AGUA DE PAJARITO,1,147,79,68,4
CHIAPAS,7,SAN CRISTÓBAL DE LAS CASAS,078,BUENAVISTA,4,202,96,106,10
CHIAPAS,7,SAN CRISTÓBAL DE LAS CASAS,078,CAMPO GRANDE,1,16,7,9,1
CHIAPAS,7,SAN CRISTÓBAL DE LAS CASAS,078,CARRIZAL CHIQUITO (CARRIZALITO),1,6,3,3,1
CHIAPAS,7,SAN CRISTÓBAL DE LAS CASAS,078,CORAZÓN DE MARÍA,4,415,221,194,16
CHIAPAS,7,SAN CRISTÓBAL DE LAS CASAS,078,CORRALITO DOS PAZOTAL,1,20,16,4,1
CHIAPAS,7,SAN CRISTÓBAL DE LAS CASAS,078,CORRALITO UNO,3,80,39,41,5
CHIAPAS,7,SAN CRISTÓBAL DE LAS CASAS,078,CRUZ CANTULAM,2,29,11,18,3
CHIAPAS,7,SAN CRISTÓBAL DE LAS CASAS,078,DOS LAGUNAS (LA SOLEDAD FRACCIÓN DOS),2,91,44,47,4
CHIAPAS,7,SAN CRISTÓBAL DE LAS CASAS,078,EL AGUAJE (LA ALBARADA),3,810,407,403,23
CHIAPAS,7,SAN CRISTÓBAL DE LAS CASAS,078,EL BOSQUE,2,38,19,19,2
CHIAPAS,7,SAN CRISTÓBAL DE LAS CASAS,078,EL CARMEN ARCOTETE,2,77,36,41,3
CHIAPAS,7,SAN CRISTÓBAL DE LAS CASAS,078,EL CIPRÉS,2,20,9,11,2
CHIAPAS,7,SAN CRISTÓBAL DE LAS CASAS,078,EL DURAZNAL,2,65,29,36,3
CHIAPAS,7,SAN CRISTÓBAL DE LAS CASAS,078,EL ESCALÓN,3,231,127,104,10
CHIAPAS,7,SAN CRISTÓBAL DE LAS CASAS,078,EL MANZANILLO,2,74,33,41,4
CHIAPAS,7,SAN CRISTÓBAL DE LAS CASAS,078,EL MONTE DE SIÓN,3,118,57,61,4
CHIAPAS,7,SAN CRISTÓBAL DE LAS CASAS,078,EL PAISAJE,1,13,8,5,1
CHIAPAS,7,SAN CRISTÓBAL DE LAS CASAS,078,EL PINAR,3,240,118,122,11
CHIAPAS,7,SAN CRISTÓBAL DE LAS CASAS,078,EL VERGELITO,1,23,12,11,1
CHIAPAS,7,SAN CRISTÓBAL DE LAS CASAS,078,FRAY BARTOLOMÉ,2,98,37,61,4
CHIAPAS,7,SAN CRISTÓBAL DE LAS CASAS,078,GUADALUPE EL TÚNEL,1,45,27,18,1
CHIAPAS,7,SAN CRISTÓBAL DE LAS CASAS,078,GUADALUPE SHUNCALÁ,3,75,38,37,5
CHIAPAS,7,SAN CRISTÓBAL DE LAS CASAS,078,HUITEPEC OCOTAL SECCIÓN I,2,56,26,30,4
CHIAPAS,7,SAN CRISTÓBAL DE LAS CASAS,078,HUITEPEC OCOTAL SECCIÓN II,2,61,28,33,3
CHIAPAS,7,SAN CRISTÓBAL DE LAS CASAS,078,HUITEPEC SANTA ANITA,2,43,23,20,3
CHIAPAS,7,SAN CRISTÓBAL DE LAS CASAS,078,JABALTOJTIC,2,26,15,11,3
CHIAPAS,7,SAN CRISTÓBAL DE LAS CASAS,078,LA CANDELARIA,3,636,296,340,31
CHIAPAS,7,SAN CRISTÓBAL DE LAS CASAS,078,LA FLORECILLA,2,163,66,97,9
CHIAPAS,7,SAN CRISTÓBAL DE LAS CASAS,078,LA LAGUNITA,2,50,24,26,2
CHIAPAS,7,SAN CRISTÓBAL DE LAS CASAS,078,LA SELVA NATIVIDAD,2,172,90,82,8
CHIAPAS,7,SAN CRISTÓBAL DE LAS CASAS,078,LA SIERRA,2,212,107,105,7
CHIAPAS,7,SAN CRISTÓBAL DE LAS CASAS,078,LA SOLEDAD LOS CERESOS SECCIÓN UNO,1,5,4,1,1
CHIAPAS,7,SAN CRISTÓBAL DE LAS CASAS,078,LAGUNA GRANDE,2,62,33,29,4
CHIAPAS,7,SAN CRISTÓBAL DE LAS CASAS,078,LAS PALMAS HUITEPEC 3RA. SECCIÓN,1,12,7,5,1
CHIAPAS,7,SAN CRISTÓBAL DE LAS CASAS,078,LAS PERAS,1,304,140,164,3
CHIAPAS,7,SAN CRISTÓBAL DE LAS CASAS,078,LAS PIEDRECITAS,1,11,5,6,1
CHIAPAS,7,SAN CRISTÓBAL DE LAS CASAS,078,LOS LLANOS,2,174,77,97,7
CHIAPAS,7,SAN CRISTÓBAL DE LAS CASAS,078,MATASANO,1,11,5,6,1
CHIAPAS,7,SAN CRISTÓBAL DE LAS CASAS,078,MITZITÓN,4,397,192,205,16
CHIAPAS,7,SAN CRISTÓBAL DE LAS CASAS,078,MOLINO LOS ARCOS,1,114,65,49,3
CHIAPAS,7,SAN CRISTÓBAL DE LAS CASAS,078,NAPITE,4,346,174,172,14
CHIAPAS,7,SAN CRISTÓBAL DE LAS CASAS,078,NUEVO CORRAL CHE'N EL ÁNGEL,3,104,45,59,5
CHIAPAS,7,SAN CRISTÓBAL DE LAS CASAS,078,PEDERNAL,3,133,71,62,7
CHIAPAS,7,SAN CRISTÓBAL DE LAS CASAS,078,PEÑA MARÍA EL PORVENIR,2,52,21,31,3
CHIAPAS,7,SAN CRISTÓBAL DE LAS CASAS,078,POZO COLORADO,2,30,19,11,2
CHIAPAS,7,SAN CRISTÓBAL DE LAS CASAS,078,PREDIO SANTIAGO,2,56,27,29,2
CHIAPAS,7,SAN CRISTÓBAL DE LAS CASAS,078,RANCHO NUEVO,1,43,19,24,2
CHIAPAS,7,SAN CRISTÓBAL DE LAS CASAS,078,RÍO ARCOTETE,3,237,110,127,8
CHIAPAS,7,SAN CRISTÓBAL DE LAS CASAS,078,SAN ANTONIO BUENAVISTA,1,81,33,48,3
CHIAPAS,7,SAN CRISTÓBAL DE LAS CASAS,078,SAN ANTONIO DE LOS BAÑOS,2,36,18,18,3
CHIAPAS,7,SAN CRISTÓBAL DE LAS CASAS,078,SAN ANTONIO DEL MONTE,3,690,342,348,25
CHIAPAS,7,SAN CRISTÓBAL DE LAS CASAS,078,SAN ANTONIO EL PORVENIR,3,23,9,14,3
CHIAPAS,7,SAN CRISTÓBAL DE LAS CASAS,078,SAN ANTONIO LA LAGUNITA,2,30,14,16,3
CHIAPAS,7,SAN CRISTÓBAL DE LAS CASAS,078,SAN ANTONIO LAS ROSAS,2,113,55,58,4
CHIAPAS,7,SAN CRISTÓBAL DE LAS CASAS,078,SAN CRISTÓBAL DE LAS CASAS,289,62082,32026,30056,4010
CHIAPAS,7,SAN CRISTÓBAL DE LAS CASAS,078,SAN ISIDRO LAS HUERTAS,2,56,32,24,4
CHIAPAS,7,SAN CRISTÓBAL DE LAS CASAS,078,SAN ISIDRO OCOTAL,1,50,25,25,1
CHIAPAS,7,SAN CRISTÓBAL DE LAS CASAS,078,SAN JOSÉ BUENAVISTA,2,67,34,33,4
CHIAPAS,7,SAN CRISTÓBAL DE LAS CASAS,078,SAN JOSÉ DE LOS BAÑOS,2,19,14,5,2
CHIAPAS,7,SAN CRISTÓBAL DE LAS CASAS,078,SAN JOSÉ EL CARMEN,1,44,21,23,1
CHIAPAS,7,SAN CRISTÓBAL DE LAS CASAS,078,SAN JUAN BAUTISTA,2,29,18,11,3
CHIAPAS,7,SAN CRISTÓBAL DE LAS CASAS,078,SAN LUIS CHUPACTIC,2,75,37,38,3
CHIAPAS,7,SAN CRISTÓBAL DE LAS CASAS,078,SANTA LUCÍA,2,159,86,73,7
CHIAPAS,7,SAN CRISTÓBAL DE LAS CASAS,078,SANTA ROSA,3,34,15,19,4
CHIAPAS,7,SAN CRISTÓBAL DE LAS CASAS,078,SELVA NATIVIDAD DOS,1,23,11,12,1
CHIAPAS,7,SAN CRISTÓBAL DE LAS CASAS,078,TAZA DE AGUA,2,63,28,35,3
CHIAPAS,7,SAN CRISTÓBAL DE LAS CASAS,078,TAZA DE AGUA UNO,1,8,5,3,1
CHIAPAS,7,SAN CRISTÓBAL DE LAS CASAS,078,TONTIC,1,18,10,8,2
CHIAPAS,7,SAN CRISTÓBAL DE LAS CASAS,078,TZEMENI,1,37,14,23,2
CHIAPAS,7,SAN CRISTÓBAL DE LAS CASAS,078,VILLA HERMOSA,3,37,18,19,4
CHIAPAS,7,SAN CRISTÓBAL DE LAS CASAS,078,VISTAHERMOSA (CARRIZAL GRANDE),2,145,89,56,7
CHIAPAS,7,SAN CRISTÓBAL DE LAS CASAS,078,VISTAHERMOSA HUITEPEC,2,63,36,27,2
CHIAPAS,7,SAN CRISTÓBAL DE LAS CASAS,078,YAALBOC,2,77,40,37,3
CHIAPAS,7,SAN CRISTÓBAL DE LAS CASAS,078,YASHITINÍN,3,425,220,205,19
CHIAPAS,7,SAN CRISTÓBAL DE LAS CASAS,078,ZACUALPA ECATEPEC,3,296,141,155,14
CHIAPAS,7,SAN FERNANDO,079,16 DE SEPTIEMBRE,4,762,394,368,46
CHIAPAS,7,SAN FERNANDO,079,ADOLFO LÓPEZ MATEOS,3,28,16,12,3
CHIAPAS,7,SAN FERNANDO,079,ÁLVARO OBREGÓN,2,328,169,159,14
CHIAPAS,7,SAN FERNANDO,079,BENITO JUÁREZ,5,346,172,174,19
CHIAPAS,7,SAN FERNANDO,079,CANDELARIA,1,10,4,6,1
CHIAPAS,7,SAN FERNANDO,079,CUAUHTÉMOC,4,219,115,104,13
CHIAPAS,7,SAN FERNANDO,079,EL CARMELO,3,164,74,90,9
CHIAPAS,7,SAN FERNANDO,079,EL CHININAL,2,47,18,29,3
CHIAPAS,7,SAN FERNANDO,079,EL COPALAR,1,43,26,17,2
CHIAPAS,7,SAN FERNANDO,079,EL LIMÓN,2,85,36,49,4
CHIAPAS,7,SAN FERNANDO,079,EL MIRADOR,3,43,25,18,4
CHIAPAS,7,SAN FERNANDO,079,EL PACAYAL,2,24,13,11,3
CHIAPAS,7,SAN FERNANDO,079,EL PARAÍSO,2,1182,589,593,93
CHIAPAS,7,SAN FERNANDO,079,EL PORTILLO,1,43,24,19,2
CHIAPAS,7,SAN FERNANDO,079,EL PORVENIR,2,26,12,14,2
CHIAPAS,7,SAN FERNANDO,079,EL PROGRESO,5,633,285,348,30
CHIAPAS,7,SAN FERNANDO,079,EL ROSARIO,2,9,5,4,1
CHIAPAS,7,SAN FERNANDO,079,EL TZITZUN,2,49,21,28,2
CHIAPAS,7,SAN FERNANDO,079,EMILIANO ZAPATA,2,112,53,59,6
CHIAPAS,7,SAN FERNANDO,079,FRANCISCO I. MADERO,3,485,229,256,20
CHIAPAS,7,SAN FERNANDO,079,GABRIEL ESQUINCA,4,592,282,310,23
CHIAPAS,7,SAN FERNANDO,079,LA ESPERANZA,3,40,23,17,4
CHIAPAS,7,SAN FERNANDO,079,LA GLORIA,2,17,4,13,2
CHIAPAS,7,SAN FERNANDO,079,LA PIMIENTA,4,142,67,75,9
CHIAPAS,7,SAN FERNANDO,079,LAS NARANJAS,1,8,4,4,1
CHIAPAS,7,SAN FERNANDO,079,LAS PILAS,3,19,12,7,3
CHIAPAS,7,SAN FERNANDO,079,LAS ROSAS,1,4,1,3,1
CHIAPAS,7,SAN FERNANDO,079,MAURICIO MARTÍNEZ,2,54,27,27,3
CHIAPAS,7,SAN FERNANDO,079,MIGUEL HIDALGO (LENIN),3,332,150,182,15
CHIAPAS,7,SAN FERNANDO,079,MONTERREY,3,203,94,109,8
CHIAPAS,7,SAN FERNANDO,079,NIQUIDÁMBAR,3,31,13,18,4
CHIAPAS,7,SAN FERNANDO,079,NUEVA VICTORIA (GUADALUPE VICTORIA),3,153,78,75,7
CHIAPAS,7,SAN FERNANDO,079,SAN ANTONIO,3,63,32,31,5
CHIAPAS,7,SAN FERNANDO,079,SAN FERNANDO,16,3150,1594,1556,134
CHIAPAS,7,SAN FERNANDO,079,SAN JORGE,3,87,40,47,6
CHIAPAS,7,SAN FERNANDO,079,SAN JOSÉ,2,34,17,17,3
CHIAPAS,7,SAN FERNANDO,079,SAN MIGUEL,3,75,33,42,4
CHIAPAS,7,SAN FERNANDO,079,SAN PEDRO,2,34,12,22,2
CHIAPAS,7,SAN FERNANDO,079,SAN PEDRO (LA MARIMBA),1,17,11,6,2
CHIAPAS,7,SAN FERNANDO,079,SAN SEBASTIÁN TOLEMAIDA,1,4,2,2,1
CHIAPAS,7,SAN FERNANDO,079,SANTA RITA,2,41,20,21,3
CHIAPAS,7,SAN FERNANDO,079,TANKAH PAKBAL,2,9,9,0,2
CHIAPAS,7,SAN FERNANDO,079,TERRERO COPALAR,1,237,121,116,11
CHIAPAS,7,SAN FERNANDO,079,VICENTE GUERRERO,2,136,72,64,8
CHIAPAS,7,SAN FERNANDO,079,VIVA CÁRDENAS,2,383,200,183,16
CHIAPAS,7,SILTEPEC,080,20 DE NOVIEMBRE,2,72,34,38,5
CHIAPAS,7,SILTEPEC,080,3 DE MAYO,2,23,12,11,2
CHIAPAS,7,SILTEPEC,080,AÍN KARIM,2,15,7,8,2
CHIAPAS,7,SILTEPEC,080,ÁNGEL DÍAZ,1,18,8,10,1
CHIAPAS,7,SILTEPEC,080,BUENAVISTA,3,103,52,51,5
CHIAPAS,7,SILTEPEC,080,BUENAVISTA ARENAL,2,19,8,11,2
CHIAPAS,7,SILTEPEC,080,CANACALES,3,101,57,44,7
CHIAPAS,7,SILTEPEC,080,CERRO PEROTE,1,9,3,6,1
CHIAPAS,7,SILTEPEC,080,CINCO DE NOVIEMBRE,2,39,16,23,4
CHIAPAS,7,SILTEPEC,080,CIPRESAL,1,51,29,22,3
CHIAPAS,7,SILTEPEC,080,CRUZ DE PIEDRA,5,228,99,129,11
CHIAPAS,7,SILTEPEC,080,CRUZ DE PIEDRA CENTRO,2,43,24,19,4
CHIAPAS,7,SILTEPEC,080,CUMBRE VENTANAS,3,179,73,106,9
CHIAPAS,7,SILTEPEC,080,DOCE DE ABRIL,2,77,43,34,4
CHIAPAS,7,SILTEPEC,080,EL BAJÍO,2,60,31,29,3
CHIAPAS,7,SILTEPEC,080,EL CIPRESAL,2,37,16,21,2
CHIAPAS,7,SILTEPEC,080,EL GUAYABAL,2,51,20,31,3
CHIAPAS,7,SILTEPEC,080,EL LIMÓN LINDAVISTA,2,27,13,14,2
CHIAPAS,7,SILTEPEC,080,EL MADRONAL,1,21,11,10,1
CHIAPAS,7,SILTEPEC,080,EL PALMAR GRANDE,3,433,212,221,19
CHIAPAS,7,SILTEPEC,080,EL PALMARCITO,3,171,79,92,7
CHIAPAS,7,SILTEPEC,080,EL PARRALITO,2,52,24,28,2
CHIAPAS,7,SILTEPEC,080,EL RETIRO,2,58,32,26,3
CHIAPAS,7,SILTEPEC,080,EL RODEO,4,165,84,81,9
CHIAPAS,7,SILTEPEC,080,EL ROSARITO,1,50,19,31,3
CHIAPAS,7,SILTEPEC,080,EL SUSPIRO,2,25,11,14,2
CHIAPAS,7,SILTEPEC,080,ELIM MONTEBELLO,2,18,12,6,2
CHIAPAS,7,SILTEPEC,080,ESCOBILLAL,3,89,43,46,6
CHIAPAS,7,SILTEPEC,080,GETZEMANÍ,1,11,3,8,1
CHIAPAS,7,SILTEPEC,080,GUADALUPE,2,29,14,15,3
CHIAPAS,7,SILTEPEC,080,GUADALUPE VICTORIA,2,87,42,45,5
CHIAPAS,7,SILTEPEC,080,HERMOSILLO,2,43,27,16,3
CHIAPAS,7,SILTEPEC,080,JUAN SABINES,3,25,9,16,3
CHIAPAS,7,SILTEPEC,080,LA ESPERANZA,2,25,13,12,3
CHIAPAS,7,SILTEPEC,080,LA LAGUNA,7,224,113,111,14
CHIAPAS,7,SILTEPEC,080,LA MESITA,2,29,14,15,3
CHIAPAS,7,SILTEPEC,080,LA PAZ DEL ROSARIO,2,64,32,32,5
CHIAPAS,7,SILTEPEC,080,LA SOLEDAD,1,13,5,8,1
CHIAPAS,7,SILTEPEC,080,LA YAYAGUITA,1,4,1,3,1
CHIAPAS,7,SILTEPEC,080,LAGUNA VERDE,1,9,4,5,1
CHIAPAS,7,SILTEPEC,080,LAS BRISAS,3,21,11,10,3
CHIAPAS,7,SILTEPEC,080,LAS CRUCES,6,273,131,142,14
CHIAPAS,7,SILTEPEC,080,LAS MORAS,1,32,15,17,2
CHIAPAS,7,SILTEPEC,080,LAS NUBES,3,87,44,43,6
CHIAPAS,7,SILTEPEC,080,LAS PILAS,3,45,24,21,4
CHIAPAS,7,SILTEPEC,080,LIBERTAD VENTANAS,4,572,279,293,24
CHIAPAS,7,SILTEPEC,080,LOMA BONITA,3,41,23,18,3
CHIAPAS,7,SILTEPEC,080,LOMA LINDA,2,16,10,6,2
CHIAPAS,7,SILTEPEC,080,LOS CIPRESES,2,69,32,37,5
CHIAPAS,7,SILTEPEC,080,LOS JOCOTES,2,18,12,6,2
CHIAPAS,7,SILTEPEC,080,LOS MEZCALES,1,25,15,10,3
CHIAPAS,7,SILTEPEC,080,LOS TULIPANES UNO,1,7,3,4,1
CHIAPAS,7,SILTEPEC,080,MALPASO,3,86,42,44,6
CHIAPAS,7,SILTEPEC,080,MONTE VERDE,1,22,13,9,2
CHIAPAS,7,SILTEPEC,080,NAZARETH,2,17,8,9,2
CHIAPAS,7,SILTEPEC,080,NUEVA INDEPENDENCIA,2,44,23,21,2
CHIAPAS,7,SILTEPEC,080,NUEVA LIBERTAD,3,20,6,14,3
CHIAPAS,7,SILTEPEC,080,NUEVA LUCHA,1,25,12,13,1
CHIAPAS,7,SILTEPEC,080,NUEVO AMANECER LA AVANZADA,1,4,2,2,1
CHIAPAS,7,SILTEPEC,080,NUEVO CHIAPAS,2,13,7,6,2
CHIAPAS,7,SILTEPEC,080,NUEVO EDÉN,2,32,19,13,3
CHIAPAS,7,SILTEPEC,080,NUEVO LAREDO,3,31,14,17,3
CHIAPAS,7,SILTEPEC,080,NUEVO RINCÓN,1,11,5,6,1
CHIAPAS,7,SILTEPEC,080,NUEVO SAN FRANCISCO,2,40,12,28,3
CHIAPAS,7,SILTEPEC,080,NUEVO SILTEPEC,1,5,5,0,1
CHIAPAS,7,SILTEPEC,080,OJO DE AGUA,2,22,16,6,2
CHIAPAS,7,SILTEPEC,080,PIEDRA BLANCA,2,29,18,11,4
CHIAPAS,7,SILTEPEC,080,PINADA PIEDRA VENTANA,1,6,4,2,1
CHIAPAS,7,SILTEPEC,080,PLAN GRANDE,1,28,9,19,1
CHIAPAS,7,SILTEPEC,080,QUINCE DE ABRIL,2,29,13,16,2
CHIAPAS,7,SILTEPEC,080,RINCÓN ESTRELLA,3,31,18,13,3
CHIAPAS,7,SILTEPEC,080,RINCÓN VARITAS,1,5,1,4,1
CHIAPAS,7,SILTEPEC,080,SALTILLO,2,27,13,14,3
CHIAPAS,7,SILTEPEC,080,SAN ANTONIO LA PINADA,7,225,98,127,15
CHIAPAS,7,SILTEPEC,080,SAN BARTOLO,2,33,23,10,2
CHIAPAS,7,SILTEPEC,080,SAN FRANCISCO,3,71,32,39,4
CHIAPAS,7,SILTEPEC,080,SAN JOSÉ OBRERO,2,18,7,11,2
CHIAPAS,7,SILTEPEC,080,SAN LUCAS,2,82,42,40,5
CHIAPAS,7,SILTEPEC,080,SAN LUIS,3,29,14,15,3
CHIAPAS,7,SILTEPEC,080,SANTA ANA,1,4,0,4,1
CHIAPAS,7,SILTEPEC,080,SANTO DOMINGO (LA CASCADA),7,572,279,293,24
CHIAPAS,7,SILTEPEC,080,SILTEPEC,10,1548,756,792,76
CHIAPAS,7,SILTEPEC,080,TOQUIÁN GRANDE,4,283,136,147,17
CHIAPAS,7,SILTEPEC,080,TOQUIANCITO,3,86,34,52,5
CHIAPAS,7,SILTEPEC,080,UNIÓN ALTAMIRA,3,66,38,28,5
CHIAPAS,7,SILTEPEC,080,UNIÓN JUÁREZ,1,17,9,8,2
CHIAPAS,7,SILTEPEC,080,UNIÓN SAN LUCAS,3,99,53,46,6
CHIAPAS,7,SILTEPEC,080,UNIÓN VILLA NUEVA,3,105,59,46,6
CHIAPAS,7,SILTEPEC,080,VADO ANCHO,1,17,8,9,2
CHIAPAS,7,SILTEPEC,080,VEGA DE GUERRERO,3,134,71,63,7
CHIAPAS,7,SILTEPEC,080,VEGA DEL ROSARIO,3,310,155,155,13
CHIAPAS,7,SILTEPEC,080,VICENTE GUERRERO,1,8,4,4,1
CHIAPAS,7,SILTEPEC,080,VILLA HERMOSA GETZEMANÍ,1,5,1,4,1
CHIAPAS,7,SILTEPEC,080,VILLAFLORES,1,10,5,5,1
CHIAPAS,7,SIMOJOVEL,081,20 DE NOVIEMBRE,1,31,17,14,1
CHIAPAS,7,SIMOJOVEL,081,AMOR DE DIOS,2,34,22,12,2
CHIAPAS,7,SIMOJOVEL,081,BENITO JUÁREZ,3,140,66,74,5
CHIAPAS,7,SIMOJOVEL,081,BERLÍN,1,89,44,45,3
CHIAPAS,7,SIMOJOVEL,081,CAMPO LA GRANJA,3,170,77,93,6
CHIAPAS,7,SIMOJOVEL,081,CARMEN BUENAVISTA,1,18,8,10,1
CHIAPAS,7,SIMOJOVEL,081,CARMEN GRANDE BELMONTE,2,107,55,52,4
CHIAPAS,7,SIMOJOVEL,081,CARMEN LAS LIMAS,2,150,72,78,5
CHIAPAS,7,SIMOJOVEL,081,CHAPAYAL,2,167,91,76,5
CHIAPAS,7,SIMOJOVEL,081,CIELITO (LA LIBERTAD),4,268,122,146,13
CHIAPAS,7,SIMOJOVEL,081,CONCEPCIÓN BUENAVISTA,2,30,16,14,2
CHIAPAS,7,SIMOJOVEL,081,CONCEPCIÓN EL AMPARO,3,294,124,170,8
CHIAPAS,7,SIMOJOVEL,081,CONCEPCIÓN LOS CACAOS,3,126,54,72,5
CHIAPAS,7,SIMOJOVEL,081,CONSTITUCIÓN,4,647,311,336,18
CHIAPAS,7,SIMOJOVEL,081,EL CALVARIO,1,46,21,25,2
CHIAPAS,7,SIMOJOVEL,081,EL CARMITO BUENAVISTA,2,147,71,76,5
CHIAPAS,7,SIMOJOVEL,081,EL HORIZONTE,1,13,6,7,1
CHIAPAS,7,SIMOJOVEL,081,EL JARDÍN,4,1267,621,646,38
CHIAPAS,7,SIMOJOVEL,081,EL OCOTAL,2,22,11,11,2
CHIAPAS,7,SIMOJOVEL,081,EL PENCIL,2,23,8,15,3
CHIAPAS,7,SIMOJOVEL,081,EL PORVENIR,3,146,80,66,5
CHIAPAS,7,SIMOJOVEL,081,EL ROBLAR,1,19,7,12,1
CHIAPAS,7,SIMOJOVEL,081,EL SABINAL,2,91,51,40,4
CHIAPAS,7,SIMOJOVEL,081,EL VERGEL,2,101,49,52,3
CHIAPAS,7,SIMOJOVEL,081,FRANCISCO VILLA (EL CIPRÉS),2,166,76,90,5
CHIAPAS,7,SIMOJOVEL,081,GRACIAS A DIOS,2,59,28,31,5
CHIAPAS,7,SIMOJOVEL,081,GUADALUPE EL PUNTITO,2,96,55,41,4
CHIAPAS,7,SIMOJOVEL,081,GUADALUPE VICTORIA I,7,914,466,448,36
CHIAPAS,7,SIMOJOVEL,081,JOCHAMPAT CARMEN GRANDE (LAS LAMINAS),2,148,78,70,4
CHIAPAS,7,SIMOJOVEL,081,JOSÉ CASTILLO TIELEMANS,3,534,249,285,23
CHIAPAS,7,SIMOJOVEL,081,JOTOLCHÉN DOS (PLANADA NARANJAL),2,87,43,44,7
CHIAPAS,7,SIMOJOVEL,081,JUAN SABINES,2,95,51,44,4
CHIAPAS,7,SIMOJOVEL,081,LA CEIBA,4,607,252,355,23
CHIAPAS,7,SIMOJOVEL,081,LA CEIBITA,2,93,48,45,4
CHIAPAS,7,SIMOJOVEL,081,LA FRONTERA,2,22,9,13,2
CHIAPAS,7,SIMOJOVEL,081,LA ILUSIÓN UNO,2,150,78,72,5
CHIAPAS,7,SIMOJOVEL,081,LA PAZ,2,37,19,18,3
CHIAPAS,7,SIMOJOVEL,081,LA PIMIENTA,5,699,362,337,63
CHIAPAS,7,SIMOJOVEL,081,LAS LIMAS,2,321,160,161,9
CHIAPAS,7,SIMOJOVEL,081,LAS MARAVILLAS,3,433,181,252,15
CHIAPAS,7,SIMOJOVEL,081,LAS MERCEDES ESPERANZA,3,299,151,148,12
CHIAPAS,7,SIMOJOVEL,081,LÁZARO CÁRDENAS,2,209,119,90,8
CHIAPAS,7,SIMOJOVEL,081,LIBERACIÓN SOCIAL,2,34,23,11,2
CHIAPAS,7,SIMOJOVEL,081,LOS ARRAYANES,2,34,22,12,3
CHIAPAS,7,SIMOJOVEL,081,LOS POCITOS,2,106,59,47,5
CHIAPAS,7,SIMOJOVEL,081,LUIS ESPINOSA,3,226,109,117,9
CHIAPAS,7,SIMOJOVEL,081,MERCEDES ISIDORO,2,148,71,77,5
CHIAPAS,7,SIMOJOVEL,081,MIRAMAR,1,5,2,3,1
CHIAPAS,7,SIMOJOVEL,081,MONTE TABOR,2,81,37,44,6
CHIAPAS,7,SIMOJOVEL,081,MONTECRISTO,3,113,55,58,5
CHIAPAS,7,SIMOJOVEL,081,NATIVIDAD PECHUAG,3,324,168,156,11
CHIAPAS,7,SIMOJOVEL,081,NUEVO ISRAELITA,4,418,221,197,15
CHIAPAS,7,SIMOJOVEL,081,PAUCHIL DOS LOS COCOS,2,50,25,25,3
CHIAPAS,7,SIMOJOVEL,081,PLANADA BUENAVISTA,2,24,10,14,3
CHIAPAS,7,SIMOJOVEL,081,PLATANAL,2,62,27,35,3
CHIAPAS,7,SIMOJOVEL,081,POBLADO NUEVO VILLAFLORES,1,12,6,6,1
CHIAPAS,7,SIMOJOVEL,081,PORVENIR CHANALUCUM,2,98,50,48,3
CHIAPAS,7,SIMOJOVEL,081,PUEBLO NUEVO SITALA,4,1454,769,685,41
CHIAPAS,7,SIMOJOVEL,081,PUYUCUM NUEVO,1,15,4,11,1
CHIAPAS,7,SIMOJOVEL,081,REVOLUCIÓN CARDENISTA,2,43,25,18,2
CHIAPAS,7,SIMOJOVEL,081,RÍO BLANCO,2,42,20,22,3
CHIAPAS,7,SIMOJOVEL,081,RIVERA DOMÍNGUEZ 2DA. FRACCIÓN,2,60,34,26,3
CHIAPAS,7,SIMOJOVEL,081,SAL SI PUEDES,2,78,40,38,4
CHIAPAS,7,SIMOJOVEL,081,SAN ANDRÉS,2,26,11,15,3
CHIAPAS,7,SIMOJOVEL,081,SAN ANTONIO,1,116,61,55,3
CHIAPAS,7,SIMOJOVEL,081,SAN ANTONIO DEL MONTE,2,31,18,13,2
CHIAPAS,7,SIMOJOVEL,081,SAN ANTONIO EL NARANJAL,3,110,61,49,5
CHIAPAS,7,SIMOJOVEL,081,SAN ANTONIO NUEVO LEÓN,3,361,189,172,11
CHIAPAS,7,SIMOJOVEL,081,SAN ANTONIO RÍO CACATEAL,2,69,32,37,4
CHIAPAS,7,SIMOJOVEL,081,SAN FRANCISCO LAS PILAS,1,19,10,9,1
CHIAPAS,7,SIMOJOVEL,081,SAN FRANCISCO PORTUGAL,2,60,35,25,3
CHIAPAS,7,SIMOJOVEL,081,SAN ISIDRO EL LLANO,2,52,26,26,4
CHIAPAS,7,SIMOJOVEL,081,SAN JOSÉ ANEXO PIMIENTA,2,31,14,17,3
CHIAPAS,7,SIMOJOVEL,081,SANTA ANITA,2,113,55,58,5
CHIAPAS,7,SIMOJOVEL,081,SHARPES UNO,1,38,20,18,2
CHIAPAS,7,SIMOJOVEL,081,SIMOJOVEL DE ALLENDE,21,4675,2372,2303,203
CHIAPAS,7,SIMOJOVEL,081,SOLO DIOS,4,226,106,120,11
CHIAPAS,7,SIMOJOVEL,081,TEPEYAC,3,60,38,22,4
CHIAPAS,7,SIMOJOVEL,081,TIERRA BLANCA TEPEYAC,1,59,26,33,2
CHIAPAS,7,SIMOJOVEL,081,TRES CASAS,2,68,32,36,4
CHIAPAS,7,SIMOJOVEL,081,UNIÓN PUYUCÚM,3,104,53,51,4
CHIAPAS,7,SIMOJOVEL,081,VINOTÉ,2,207,118,89,8
CHIAPAS,7,SIMOJOVEL,081,VIRGINIA,2,80,41,39,4
CHIAPAS,7,SIMOJOVEL,081,YUQUÍN,4,409,201,208,17
CHIAPAS,7,SIMOJOVEL,081,ZACATÓN SANTA TERESA,3,192,93,99,7
CHIAPAS,7,SITALÁ,082,ACH'LUM EL SUSPIRO,2,66,29,37,3
CHIAPAS,7,SITALÁ,082,ARIZONA,2,20,11,9,2
CHIAPAS,7,SITALÁ,082,CHABECLUMIL,3,259,133,126,10
CHIAPAS,7,SITALÁ,082,DON PEDRO,2,146,68,78,6
CHIAPAS,7,SITALÁ,082,EL DIAMANTE,2,67,30,37,2
CHIAPAS,7,SITALÁ,082,EMILIANO ZAPATA,3,79,34,45,5
CHIAPAS,7,SITALÁ,082,GOLONCHÁN NUEVO PRIMERA FRACCIÓN,2,79,33,46,3
CHIAPAS,7,SITALÁ,082,GOLONCHÁN NUEVO SEGUNDA FRACCIÓN,2,54,24,30,2
CHIAPAS,7,SITALÁ,082,GOLONCHÁN VIEJO,3,556,264,292,17
CHIAPAS,7,SITALÁ,082,GUADALUPE CAPTETAJ,1,14,6,8,1
CHIAPAS,7,SITALÁ,082,GUADALUPE JAGUALÁ,2,73,40,33,3
CHIAPAS,7,SITALÁ,082,GUADALUPE MAZANIL,2,93,45,48,3
CHIAPAS,7,SITALÁ,082,GUADALUPE PEÑA BLANCA SEGUNDA,2,83,36,47,4
CHIAPAS,7,SITALÁ,082,INSURGENTE PICOTÉ,3,474,228,246,18
CHIAPAS,7,SITALÁ,082,LA MERCED,2,24,13,11,2
CHIAPAS,7,SITALÁ,082,LA TRINIDAD,3,126,52,74,8
CHIAPAS,7,SITALÁ,082,LA TRINITARIA,1,10,6,4,1
CHIAPAS,7,SITALÁ,082,LA UNIÓN,3,160,74,86,8
CHIAPAS,7,SITALÁ,082,MEVAJA UNO,2,34,18,16,3
CHIAPAS,7,SITALÁ,082,PARAÍSO CHICOTÁNIL,1,40,20,20,2
CHIAPAS,7,SITALÁ,082,PICOTÉ 2DA. FRACCIÓN,2,43,24,19,3
CHIAPAS,7,SITALÁ,082,PICOTÉ PAMALÁ,2,93,45,48,2
CHIAPAS,7,SITALÁ,082,POMILTIC,3,145,74,71,5
CHIAPAS,7,SITALÁ,082,PORFIRIO ENCINO,2,79,46,33,3
CHIAPAS,7,SITALÁ,082,SAN AGUSTÍN,2,63,32,31,2
CHIAPAS,7,SITALÁ,082,SAN ANTONIO EL ROSARIO,4,96,54,42,5
CHIAPAS,7,SITALÁ,082,SAN FRANCISCO LA UNIÓN,2,135,70,65,4
CHIAPAS,7,SITALÁ,082,SAN JOAQUÍN,1,50,20,30,1
CHIAPAS,7,SITALÁ,082,SAN JOSÉ ILUSIÓN,1,60,27,33,1
CHIAPAS,7,SITALÁ,082,SAN JUAN DE LA MONTAÑA,2,227,119,108,9
CHIAPAS,7,SITALÁ,082,SAN JUAN OCOTAL,1,15,12,3,1
CHIAPAS,7,SITALÁ,082,SAN JUAN SHUCAIL,1,35,18,17,1
CHIAPAS,7,SITALÁ,082,SAN JUAN VERACRUZ,1,20,7,13,2
CHIAPAS,7,SITALÁ,082,SAN LUIS XIXINTONIL,2,53,22,31,3
CHIAPAS,7,SITALÁ,082,SANTA ANITA LAS CRUCES,1,37,15,22,2
CHIAPAS,7,SITALÁ,082,SANTA BÁRBARA PRIMERA FRACCIÓN,2,73,32,41,4
CHIAPAS,7,SITALÁ,082,SANTA BÁRBARA SEGUNDA FRACCIÓN,2,91,39,52,4
CHIAPAS,7,SITALÁ,082,SANTA CRUZ EL RECREO,1,13,7,6,1
CHIAPAS,7,SITALÁ,082,SANTA CRUZ LA REFORMA,2,351,187,164,15
CHIAPAS,7,SITALÁ,082,SANTA ISABEL,2,67,35,32,2
CHIAPAS,7,SITALÁ,082,SITALÁ,8,986,444,542,49
CHIAPAS,7,SOCOLTENANGO,083,ANEXO LAS ROSAS DE GUADALUPE,2,33,22,11,2
CHIAPAS,7,SOCOLTENANGO,083,BENITO JUÁREZ,2,69,26,43,3
CHIAPAS,7,SOCOLTENANGO,083,CHIHUAHUA,2,80,45,35,4
CHIAPAS,7,SOCOLTENANGO,083,CONSTITUCIÓN 27,2,45,20,25,2
CHIAPAS,7,SOCOLTENANGO,083,DOCTOR BELISARIO DOMÍNGUEZ,2,38,14,24,3
CHIAPAS,7,SOCOLTENANGO,083,DOCTOR SAMUEL LEÓN BRINDIS,2,35,20,15,2
CHIAPAS,7,SOCOLTENANGO,083,EL BAJÍO SAN LAZARITO,2,56,30,26,3
CHIAPAS,7,SOCOLTENANGO,083,EL BANCO,2,81,48,33,4
CHIAPAS,7,SOCOLTENANGO,083,EL SABINAL,1,10,4,6,1
CHIAPAS,7,SOCOLTENANGO,083,EL SANTUARIO,3,158,80,78,8
CHIAPAS,7,SOCOLTENANGO,083,EL SANTUARIO DOS (CAÑA CASTILLA),4,122,69,53,9
CHIAPAS,7,SOCOLTENANGO,083,EMILIANO ZAPATA,2,132,63,69,6
CHIAPAS,7,SOCOLTENANGO,083,ESTRELLA ROJA,2,109,52,57,5
CHIAPAS,7,SOCOLTENANGO,083,FRANCISCO VILLA,3,174,95,79,7
CHIAPAS,7,SOCOLTENANGO,083,JORGE DE LA VEGA DOMÍNGUEZ,2,54,24,30,3
CHIAPAS,7,SOCOLTENANGO,083,LA PLANADA,2,64,34,30,3
CHIAPAS,7,SOCOLTENANGO,083,LA PRIMAVERA,2,57,27,30,3
CHIAPAS,7,SOCOLTENANGO,083,LÁZARO CÁRDENAS,2,73,41,32,3
CHIAPAS,7,SOCOLTENANGO,083,MIRAMAR,2,28,14,14,2
CHIAPAS,7,SOCOLTENANGO,083,NUEVA FLORESTA,1,15,10,5,1
CHIAPAS,7,SOCOLTENANGO,083,NUEVA JERUSALÉN CASCAJAL,1,5,3,2,1
CHIAPAS,7,SOCOLTENANGO,083,NUEVA REFORMA AGRARIA,2,64,30,34,3
CHIAPAS,7,SOCOLTENANGO,083,NUEVE DE MARZO,2,54,28,26,2
CHIAPAS,7,SOCOLTENANGO,083,NUEVO CHEJEL,3,101,51,50,5
CHIAPAS,7,SOCOLTENANGO,083,NUEVO SAN SEBASTIÁN LA CANDELARIA,3,149,75,74,6
CHIAPAS,7,SOCOLTENANGO,083,NUEVO ZACOALPA (LA ROCA),2,65,35,30,2
CHIAPAS,7,SOCOLTENANGO,083,PUERTO RICO,3,244,134,110,12
CHIAPAS,7,SOCOLTENANGO,083,SAN AGUSTÍN EL PORVENIR,2,42,16,26,2
CHIAPAS,7,SOCOLTENANGO,083,SAN ANTONIO COPALAR,2,39,15,24,3
CHIAPAS,7,SOCOLTENANGO,083,SAN ANTONIO CRUCILA,1,7,5,2,1
CHIAPAS,7,SOCOLTENANGO,083,SAN ANTONIO EL SAUZAL,2,27,7,20,2
CHIAPAS,7,SOCOLTENANGO,083,SAN JOSÉ TIERRA BLANCA,1,14,4,10,1
CHIAPAS,7,SOCOLTENANGO,083,SAN MIGUEL SOCTIC,2,22,11,11,2
CHIAPAS,7,SOCOLTENANGO,083,SAN PEDRO PEDERNAL,1,6,2,4,1
CHIAPAS,7,SOCOLTENANGO,083,SAN VICENTE,2,31,14,17,3
CHIAPAS,7,SOCOLTENANGO,083,SAN VICENTE PAUCHIL CHANIVAL,3,345,150,195,13
CHIAPAS,7,SOCOLTENANGO,083,SANTA CRUZ JOTOLÁ,1,41,24,17,2
CHIAPAS,7,SOCOLTENANGO,083,SOCOLTENANGO,10,1463,729,734,74
CHIAPAS,7,SOCOLTENANGO,083,TIERRA Y LIBERTAD,2,31,17,14,2
CHIAPAS,7,SOCOLTENANGO,083,TZINIL,3,373,196,177,17
CHIAPAS,7,SOCOLTENANGO,083,UNIÓN CAMPESINA,4,174,82,92,9
CHIAPAS,7,SOCOLTENANGO,083,UNIÓN GUADALUPE,2,67,40,27,3
CHIAPAS,7,SOLOSUCHIAPA,084,AGUSTÍN RUBIO (SANTA FE LA ZACUALPA),2,175,88,87,9
CHIAPAS,7,SOLOSUCHIAPA,084,ALDECOA ESTRADA,2,12,2,10,2
CHIAPAS,7,SOLOSUCHIAPA,084,ÁLVARO OBREGÓN,4,308,158,150,13
CHIAPAS,7,SOLOSUCHIAPA,084,CERRO LAS CAMPANAS,4,263,127,136,12
CHIAPAS,7,SOLOSUCHIAPA,084,EL BENEFICIO,2,42,18,24,4
CHIAPAS,7,SOLOSUCHIAPA,084,EL NARANJO,4,31,19,12,4
CHIAPAS,7,SOLOSUCHIAPA,084,FRANCISCO I. MADERO,3,122,56,66,7
CHIAPAS,7,SOLOSUCHIAPA,084,JANA 1RA. SECCIÓN,3,44,24,20,3
CHIAPAS,7,SOLOSUCHIAPA,084,JANA 2DA. SECCIÓN,3,66,37,29,5
CHIAPAS,7,SOLOSUCHIAPA,084,LA CARRETERA,3,31,18,13,4
CHIAPAS,7,SOLOSUCHIAPA,084,LA CONSTANCIA,2,9,3,6,2
CHIAPAS,7,SOLOSUCHIAPA,084,LA CUMBRE (LA REPRESALIA),1,4,2,2,1
CHIAPAS,7,SOLOSUCHIAPA,084,LA GUADALUPE,2,12,7,5,2
CHIAPAS,7,SOLOSUCHIAPA,084,LUCIO CABAÑAS,1,6,3,3,1
CHIAPAS,7,SOLOSUCHIAPA,084,MONTE HOREB,3,249,116,133,12
CHIAPAS,7,SOLOSUCHIAPA,084,RÍO NEGRO 2DA. SECCIÓN,1,9,6,3,1
CHIAPAS,7,SOLOSUCHIAPA,084,SAN BARTOLO,1,4,0,4,1
CHIAPAS,7,SOLOSUCHIAPA,084,SAN LUIS,2,35,15,20,3
CHIAPAS,7,SOLOSUCHIAPA,084,SAN MIGUEL (LAS GARZAS),2,75,36,39,4
CHIAPAS,7,SOLOSUCHIAPA,084,SAN SEBASTIÁN,3,48,23,25,4
CHIAPAS,7,SOLOSUCHIAPA,084,SIBERIA,2,23,7,16,3
CHIAPAS,7,SOLOSUCHIAPA,084,SOLOSUCHIAPA,8,674,337,337,50
CHIAPAS,7,SOLOSUCHIAPA,084,SONORA,3,25,10,15,4
CHIAPAS,7,SOLOSUCHIAPA,084,ÚRSULO GALVÁN,3,67,39,28,5
CHIAPAS,7,SOLOSUCHIAPA,084,VILLA SANTA FE,2,8,5,3,2
CHIAPAS,7,SOLOSUCHIAPA,084,VILLAFLORES,4,195,92,103,12
CHIAPAS,7,SOYALÓ,085,ADOLFO LÓPEZ MATEOS,2,115,43,72,5
CHIAPAS,7,SOYALÓ,085,EL PEDREGAL,1,18,9,9,2
CHIAPAS,7,SOYALÓ,085,EMILIANO ZAPATA,2,100,50,50,5
CHIAPAS,7,SOYALÓ,085,FRANCISCO SARABIA,6,827,407,420,36
CHIAPAS,7,SOYALÓ,085,LA VAINILLA,2,11,6,5,2
CHIAPAS,7,SOYALÓ,085,MORELOS,1,8,3,5,1
CHIAPAS,7,SOYALÓ,085,SAN ANTONIO ZARAGOZA,4,328,158,170,15
CHIAPAS,7,SOYALÓ,085,SAN PABLO,2,21,14,7,3
CHIAPAS,7,SOYALÓ,085,SOYALÓ,8,1575,768,807,73
CHIAPAS,7,SUCHIAPA,086,BUENAVISTA,2,93,43,50,4
CHIAPAS,7,SUCHIAPA,086,EL ARENAL,1,37,16,21,3
CHIAPAS,7,SUCHIAPA,086,EL RECREO,2,27,14,13,3
CHIAPAS,7,SUCHIAPA,086,EL TRIUNFO,1,23,14,9,2
CHIAPAS,7,SUCHIAPA,086,LA CIÉNEGA,3,17,9,8,2
CHIAPAS,7,SUCHIAPA,086,LA PALMA,4,251,129,122,14
CHIAPAS,7,SUCHIAPA,086,PACÚ,3,592,296,296,26
CHIAPAS,7,SUCHIAPA,086,PLAN DE MULUMÍ,2,81,38,43,4
CHIAPAS,7,SUCHIAPA,086,SAN JOSÉ,2,46,21,25,4
CHIAPAS,7,SUCHIAPA,086,SAN PEDRO EL SALVADOR,3,42,17,25,4
CHIAPAS,7,SUCHIAPA,086,SUCHIAPA,27,8933,4007,4926,381
CHIAPAS,7,SUCHIATE,087,15 DE SEPTIEMBRE,2,102,51,51,3
CHIAPAS,7,SUCHIATE,087,20 DE NOVIEMBRE,3,153,66,87,7
CHIAPAS,7,SUCHIATE,087,BARRA DE CAHOACÁN (EL CHICAL),3,232,111,121,11
CHIAPAS,7,SUCHIATE,087,BENITO JUÁREZ (COSALAPA),4,546,271,275,19
CHIAPAS,7,SUCHIATE,087,BRISAS DEL MAR,3,148,88,60,7
CHIAPAS,7,SUCHIATE,087,CIUDAD HIDALGO,24,5991,2987,3004,280
CHIAPAS,7,SUCHIATE,087,CUAUHTÉMOC,3,205,101,104,9
CHIAPAS,7,SUCHIATE,087,CUAUHTÉMOC CERVANTES,2,27,9,18,2
CHIAPAS,7,SUCHIATE,087,DORADO VIEJO FRACCIÓN I,1,42,20,22,1
CHIAPAS,7,SUCHIATE,087,DORADO VIEJO FRACCIÓN II,1,10,4,6,1
CHIAPAS,7,SUCHIATE,087,EJIDO SUCHIATE (FRACCIÓN LA PITA),1,100,56,44,4
CHIAPAS,7,SUCHIATE,087,EL CAMPITO,2,234,107,127,8
CHIAPAS,7,SUCHIATE,087,EL GANCHO,2,255,136,119,10
CHIAPAS,7,SUCHIATE,087,EMILIANO ZAPATA,3,177,90,87,9
CHIAPAS,7,SUCHIATE,087,EMPACADORA VIEJA,1,347,165,182,10
CHIAPAS,7,SUCHIATE,087,GENERAL MANUEL ÁVILA CAMACHO,2,201,86,115,8
CHIAPAS,7,SUCHIATE,087,IGNACIO LÓPEZ RAYÓN,3,346,185,161,13
CHIAPAS,7,SUCHIATE,087,JESÚS,2,146,71,75,7
CHIAPAS,7,SUCHIATE,087,LA LIBERTAD,5,1043,505,538,44
CHIAPAS,7,SUCHIATE,087,LUCIO CABAÑAS,1,9,3,6,1
CHIAPAS,7,SUCHIATE,087,MIGUEL ALEMÁN,2,220,96,124,9
CHIAPAS,7,SUCHIATE,087,NUEVA INDEPENDENCIA,2,57,23,34,3
CHIAPAS,7,SUCHIATE,087,NUEVO DORADO,3,219,105,114,10
CHIAPAS,7,SUCHIATE,087,QUINCE DE ABRIL,3,286,147,139,10
CHIAPAS,7,SUCHIATE,087,TIERRA Y LIBERTAD,1,79,36,43,3
CHIAPAS,7,SUCHIATE,087,TRES HERMANOS,2,51,25,26,2
CHIAPAS,7,SUNUAPA,088,EL CUCAYO 1RA. SECCIÓN,2,13,9,4,2
CHIAPAS,7,SUNUAPA,088,EL CUCAYO 2DA. SECCIÓN,1,7,1,6,1
CHIAPAS,7,SUNUAPA,088,EL CUCAYO 3RA. SECCIÓN,1,5,3,2,1
CHIAPAS,7,SUNUAPA,088,ESQUIPULAS,2,17,9,8,2
CHIAPAS,7,SUNUAPA,088,LA LIBERTAD,4,54,23,31,5
CHIAPAS,7,SUNUAPA,088,SAN PEDRO,3,93,46,47,5
CHIAPAS,7,SUNUAPA,088,SANTA CRUZ 1RA. SECCIÓN,3,32,16,16,3
CHIAPAS,7,SUNUAPA,088,SANTA CRUZ 3RA. SECCIÓN,2,37,15,22,3
CHIAPAS,7,SUNUAPA,088,SUNUAPA,4,486,228,258,20
CHIAPAS,7,TAPACHULA,089,20 DE NOVIEMBRE,4,983,506,477,31
CHIAPAS,7,TAPACHULA,089,26 DE OCTUBRE,4,481,238,243,21
CHIAPAS,7,TAPACHULA,089,5 DE MAYO,3,235,123,112,11
CHIAPAS,7,TAPACHULA,089,ACAXMAN,2,362,185,177,15
CHIAPAS,7,TAPACHULA,089,ALICIA,3,83,36,47,4
CHIAPAS,7,TAPACHULA,089,ALTAMIRA,1,18,9,9,1
CHIAPAS,7,TAPACHULA,089,ÁLVARO OBREGÓN,6,2008,982,1026,68
CHIAPAS,7,TAPACHULA,089,BADENIA (UNIÓN MEXICANA),2,42,17,25,2
CHIAPAS,7,TAPACHULA,089,BARRA DE CAHOACÁN (LAS GAVIOTAS),2,22,10,12,2
CHIAPAS,7,TAPACHULA,089,BARRIO NUEVO,2,109,65,44,2
CHIAPAS,7,TAPACHULA,089,BENITO JUÁREZ,3,213,107,106,8
CHIAPAS,7,TAPACHULA,089,BIJAHUAL,2,266,131,135,10
CHIAPAS,7,TAPACHULA,089,BOJONCITO,2,25,17,8,2
CHIAPAS,7,TAPACHULA,089,BUENAVISTA,2,367,179,188,15
CHIAPAS,7,TAPACHULA,089,BUENAVISTA (TOCHMAY),2,70,37,33,3
CHIAPAS,7,TAPACHULA,089,CANTÓN BODEGAS,1,11,6,5,1
CHIAPAS,7,TAPACHULA,089,CANTÓN BUENOS AIRES,1,14,6,8,1
CHIAPAS,7,TAPACHULA,089,CANTÓN EL CAUCHO,3,93,44,49,8
CHIAPAS,7,TAPACHULA,089,CANTÓN EL TESORO,2,226,118,108,10
CHIAPAS,7,TAPACHULA,089,CANTÓN EMPORIO EL NARANJO,1,12,7,5,1
CHIAPAS,7,TAPACHULA,089,CANTÓN HERMOSILLO,1,5,2,3,1
CHIAPAS,7,TAPACHULA,089,CANTÓN LAS CRUCES,2,79,37,42,4
CHIAPAS,7,TAPACHULA,089,CANTÓN LAS DELICIAS,1,17,8,9,1
CHIAPAS,7,TAPACHULA,089,CANTÓN MONTEBELLO,1,79,39,40,2
CHIAPAS,7,TAPACHULA,089,CANTÓN SAN LUIS,1,34,22,12,2
CHIAPAS,7,TAPACHULA,089,CANTÓN SANTA MARÍA,1,26,12,14,1
CHIAPAS,7,TAPACHULA,089,CANTÓN SINAÍ,3,283,138,145,14
CHIAPAS,7,TAPACHULA,089,CANTÓN TIRO SEGURO,2,59,33,26,3
CHIAPAS,7,TAPACHULA,089,CANTÓN VICTORIA,3,257,119,138,10
CHIAPAS,7,TAPACHULA,089,CANTÓN VILLAFLOR,3,539,262,277,21
CHIAPAS,7,TAPACHULA,089,CANTÓN ZARAGOZA,1,80,46,34,3
CHIAPAS,7,TAPACHULA,089,CARLOS SALINAS DE GORTARI,2,215,103,112,8
CHIAPAS,7,TAPACHULA,089,CARRILLO PUERTO,4,899,432,467,44
CHIAPAS,7,TAPACHULA,089,CASCO SAN NICOLÁS,2,9,1,8,2
CHIAPAS,7,TAPACHULA,089,CEBADILLA 1RA. SECCIÓN,5,1264,630,634,49
CHIAPAS,7,TAPACHULA,089,CEBADILLA 2DA. SECCIÓN,3,379,175,204,20
CHIAPAS,7,TAPACHULA,089,CHANJALÉ Y SALCHIJI,3,163,74,89,7
CHIAPAS,7,TAPACHULA,089,CHAPULTEPEC,3,73,29,44,4
CHIAPAS,7,TAPACHULA,089,CHESPAL VIEJO,2,87,37,50,4
CHIAPAS,7,TAPACHULA,089,CONGREGACIÓN EL EDÉN,3,852,422,430,38
CHIAPAS,7,TAPACHULA,089,CONGREGACIÓN REFORMA,4,756,364,392,48
CHIAPAS,7,TAPACHULA,089,CONQUISTA CAMPESINA,4,235,114,121,11
CHIAPAS,7,TAPACHULA,089,CONSEJO AGRARIO MEXICANO,1,15,7,8,1
CHIAPAS,7,TAPACHULA,089,CUEVA,1,43,14,29,1
CHIAPAS,7,TAPACHULA,089,DORADOS DE VILLA,1,9,4,5,1
CHIAPAS,7,TAPACHULA,089,EL ALAZÁN,1,75,40,35,2
CHIAPAS,7,TAPACHULA,089,EL CARMEN,1,270,135,135,12
CHIAPAS,7,TAPACHULA,089,EL CHAPARRÓN,2,92,49,43,4
CHIAPAS,7,TAPACHULA,089,EL EDÉN,2,84,45,39,4
CHIAPAS,7,TAPACHULA,089,EL FINAL,3,149,69,80,3
CHIAPAS,7,TAPACHULA,089,EL HORIZONTE,2,51,22,29,2
CHIAPAS,7,TAPACHULA,089,EL MANACAL,4,239,116,123,13
CHIAPAS,7,TAPACHULA,089,EL PINAL,3,209,106,103,10
CHIAPAS,7,TAPACHULA,089,EL PORVENIR,3,279,140,139,12
CHIAPAS,7,TAPACHULA,089,EL REFUGIO,2,33,19,14,3
CHIAPAS,7,TAPACHULA,089,EL RETIRO,1,88,46,42,3
CHIAPAS,7,TAPACHULA,089,EL RINCÓN,1,41,19,22,3
CHIAPAS,7,TAPACHULA,089,EL ROSARIO,1,19,12,7,1
CHIAPAS,7,TAPACHULA,089,EL SUNSAL,2,15,6,9,2
CHIAPAS,7,TAPACHULA,089,EL TRIUNFO,6,506,256,250,19
CHIAPAS,7,TAPACHULA,089,EL VERGEL PLÁTANO,1,367,167,200,12
CHIAPAS,7,TAPACHULA,089,EMILIANO ZAPATA,1,33,11,22,3
CHIAPAS,7,TAPACHULA,089,ESQUIPULAS,2,65,27,38,2
CHIAPAS,7,TAPACHULA,089,FINCA ARGOVIA,2,19,9,10,2
CHIAPAS,7,TAPACHULA,089,FINCA LA PATRIA,4,118,58,60,8
CHIAPAS,7,TAPACHULA,089,FINCA SANTA RITA,2,78,34,44,4
CHIAPAS,7,TAPACHULA,089,FLOR EL NARANJO (HONDURAS),1,51,23,28,1
CHIAPAS,7,TAPACHULA,089,FRACCIÓN EL PORVENIR (EL GUINEO),1,17,6,11,1
CHIAPAS,7,TAPACHULA,089,FRACCIÓN EL RETIRO,2,129,55,74,7
CHIAPAS,7,TAPACHULA,089,FRACCIÓN GALERAS,1,71,40,31,3
CHIAPAS,7,TAPACHULA,089,FRACCIÓN LA CEIBA,1,19,6,13,1
CHIAPAS,7,TAPACHULA,089,FRACCIÓN LAS PALMAS,3,104,44,60,6
CHIAPAS,7,TAPACHULA,089,FRACCIÓN MARGARITA,1,25,9,16,1
CHIAPAS,7,TAPACHULA,089,FRACCIÓN SALVADOR URBINA,2,175,94,81,7
CHIAPAS,7,TAPACHULA,089,FRACCIÓN SANTA ELENA,1,10,4,6,1
CHIAPAS,7,TAPACHULA,089,FRACCIÓN SANTA ROSALÍA 2,6,148,72,76,10
CHIAPAS,7,TAPACHULA,089,FRACCIÓN ZARAGOZA,3,46,22,24,4
CHIAPAS,7,TAPACHULA,089,FRANCISCO I. MADERO (LA BOLSA DE LA BOTELLA),3,204,102,102,9
CHIAPAS,7,TAPACHULA,089,FRONTERA 20 DE OCTUBRE,2,75,41,34,4
CHIAPAS,7,TAPACHULA,089,FULDA,1,22,12,10,3
CHIAPAS,7,TAPACHULA,089,GENARO VÁZQUEZ ROJAS,1,8,3,5,1
CHIAPAS,7,TAPACHULA,089,GÉNOVA,4,41,19,22,5
CHIAPAS,7,TAPACHULA,089,GUADALUPE ZAJU,2,13,5,8,2
CHIAPAS,7,TAPACHULA,089,HAMBURGO,2,54,25,29,3
CHIAPAS,7,TAPACHULA,089,HERMOSILLO,2,78,32,46,4
CHIAPAS,7,TAPACHULA,089,HIDALGO,3,208,92,116,9
CHIAPAS,7,TAPACHULA,089,INDEPENDENCIA,2,180,90,90,7
CHIAPAS,7,TAPACHULA,089,IRLANDA,2,41,21,20,3
CHIAPAS,7,TAPACHULA,089,ISLEVEN,1,70,33,37,3
CHIAPAS,7,TAPACHULA,089,JOAQUÍN MIGUEL GUTIÉRREZ (EL MANZANO),3,351,148,203,13
CHIAPAS,7,TAPACHULA,089,JOSÉ MARÍA MORELOS,5,875,419,456,41
CHIAPAS,7,TAPACHULA,089,JUAN SABINES GUTIÉRREZ (POSTE ROJO),3,267,116,151,11
CHIAPAS,7,TAPACHULA,089,LA CHIRIPA,3,39,17,22,4
CHIAPAS,7,TAPACHULA,089,LA CIGÜEÑA,2,79,36,43,3
CHIAPAS,7,TAPACHULA,089,LA CONCORDIA,2,83,37,46,4
CHIAPAS,7,TAPACHULA,089,LA ESPERANZA,4,149,85,64,7
CHIAPAS,7,TAPACHULA,089,LA GLORIA,1,52,27,25,3
CHIAPAS,7,TAPACHULA,089,LA JOYA,2,258,133,125,13
CHIAPAS,7,TAPACHULA,089,LA PATRIA,1,26,9,17,1
CHIAPAS,7,TAPACHULA,089,LA PRIMAVERA,1,22,14,8,1
CHIAPAS,7,TAPACHULA,089,LA PROVIDENCIA,4,84,39,45,5
CHIAPAS,7,TAPACHULA,089,LA SOLEDAD,2,23,12,11,2
CHIAPAS,7,TAPACHULA,089,LAS DELICIAS,2,94,47,47,3
CHIAPAS,7,TAPACHULA,089,LAS MARAVILLAS,2,59,29,30,2
CHIAPAS,7,TAPACHULA,089,LAS PALMERAS,1,61,31,30,3
CHIAPAS,7,TAPACHULA,089,LAS TINAJAS 2DA. SECCIÓN,3,191,96,95,11
CHIAPAS,7,TAPACHULA,089,LEONCILLOS,2,56,30,26,2
CHIAPAS,7,TAPACHULA,089,LINDAVISTA,1,9,6,3,1
CHIAPAS,7,TAPACHULA,089,LLANO DE LA LIMA,3,426,204,222,18
CHIAPAS,7,TAPACHULA,089,LOMA BONITA (EL GANADERO),3,30,19,11,3
CHIAPAS,7,TAPACHULA,089,LOS ÁNGELES,2,105,51,54,5
CHIAPAS,7,TAPACHULA,089,LOS LLANOS,2,86,44,42,4
CHIAPAS,7,TAPACHULA,089,LOS PALACIOS,1,90,46,44,4
CHIAPAS,7,TAPACHULA,089,LOS TOROS (ESTACIÓN),2,83,38,45,4
CHIAPAS,7,TAPACHULA,089,LUIS ESPINOZA,1,59,32,27,2
CHIAPAS,7,TAPACHULA,089,MANGA DE CLAVO,2,275,137,138,11
CHIAPAS,7,TAPACHULA,089,MARIO SOUZA,3,27,17,10,3
CHIAPAS,7,TAPACHULA,089,MEXIQUITO,3,119,63,56,6
CHIAPAS,7,TAPACHULA,089,MONTENEGRO,2,391,189,202,16
CHIAPAS,7,TAPACHULA,089,MURILLO,3,199,97,102,8
CHIAPAS,7,TAPACHULA,089,NINGUNO [ENRIQUE ESCOBAR CHON],2,183,104,79,7
CHIAPAS,7,TAPACHULA,089,NUEVA ESPERANZA,1,21,13,8,2
CHIAPAS,7,TAPACHULA,089,NUEVA GRANADA,2,143,66,77,7
CHIAPAS,7,TAPACHULA,089,NUEVA LIBERTAD,1,11,6,5,1
CHIAPAS,7,TAPACHULA,089,NUEVA REFORMA,1,9,6,3,1
CHIAPAS,7,TAPACHULA,089,NUEVO CHESPAL,3,215,119,96,10
CHIAPAS,7,TAPACHULA,089,PARAÍSO,2,35,22,13,3
CHIAPAS,7,TAPACHULA,089,PAVENCUL,5,808,410,398,28
CHIAPAS,7,TAPACHULA,089,PLAN CHANJALÉ,1,67,32,35,3
CHIAPAS,7,TAPACHULA,089,PLAN DE ESPERANZA ALTA,1,66,26,40,3
CHIAPAS,7,TAPACHULA,089,PLAN LAS PALMAS,2,93,44,49,4
CHIAPAS,7,TAPACHULA,089,PLAYA LINDA,2,115,55,60,5
CHIAPAS,7,TAPACHULA,089,PRIMAVERA,1,50,26,24,2
CHIAPAS,7,TAPACHULA,089,PROGRESO PUMPUAPA,2,82,37,45,4
CHIAPAS,7,TAPACHULA,089,PUERTO MADERO (SAN BENITO),15,4090,1812,2278,260
CHIAPAS,7,TAPACHULA,089,RANCHO ALEGRE,1,8,5,3,1
CHIAPAS,7,TAPACHULA,089,RAYMUNDO ENRÍQUEZ,5,1255,611,644,48
CHIAPAS,7,TAPACHULA,089,REFORMA (SAN ANTONIO),2,23,13,10,3
CHIAPAS,7,TAPACHULA,089,RÍO FLORIDO,3,355,174,181,17
CHIAPAS,7,TAPACHULA,089,SALCHIJI,2,36,20,16,3
CHIAPAS,7,TAPACHULA,089,SAN AGUSTÍN JITOTOL,2,84,40,44,4
CHIAPAS,7,TAPACHULA,089,SAN ANTONIO,4,124,72,52,8
CHIAPAS,7,TAPACHULA,089,SAN ANTONIO CHICHARRAS,4,72,36,36,5
CHIAPAS,7,TAPACHULA,089,SAN CRISTÓBAL,2,21,11,10,2
CHIAPAS,7,TAPACHULA,089,SAN CRISTÓBAL BUENAVISTA,1,78,45,33,4
CHIAPAS,7,TAPACHULA,089,SAN FRANCISCO,3,190,97,93,8
CHIAPAS,7,TAPACHULA,089,SAN JOSÉ DEL VALLE,2,30,18,12,3
CHIAPAS,7,TAPACHULA,089,SAN JOSÉ NEXAPA,2,35,18,17,3
CHIAPAS,7,TAPACHULA,089,SAN JOSÉ REFORMA,2,105,56,49,6
CHIAPAS,7,TAPACHULA,089,SAN JUAN CHICHARRAS,1,43,21,22,2
CHIAPAS,7,TAPACHULA,089,SAN LUIS NEXAPA,2,474,233,241,2
CHIAPAS,7,TAPACHULA,089,SAN NICOLÁS LAGARTERO,4,420,205,215,16
CHIAPAS,7,TAPACHULA,089,SAN VICENTE,2,65,32,33,3
CHIAPAS,7,TAPACHULA,089,SANTA ELENA,6,207,97,110,11
CHIAPAS,7,TAPACHULA,089,SIMÓN BOLÍVAR,1,6,1,5,1
CHIAPAS,7,TAPACHULA,089,SOLEDAD Y PROGRESO,1,32,14,18,2
CHIAPAS,7,TAPACHULA,089,TAPACHULA DE CÓRDOVA Y ORDÓÑEZ,352,69412,34975,34437,4598
CHIAPAS,7,TAPACHULA,089,TEOTIHUACÁN DEL VALLE,2,91,41,50,3
CHIAPAS,7,TAPACHULA,089,TINAJAS 1RA. SECCIÓN,7,443,210,233,19
CHIAPAS,7,TAPACHULA,089,TINAJAS 3RA. SECCIÓN,3,246,128,118,11
CHIAPAS,7,TAPACHULA,089,TOLUCA,5,359,180,179,18
CHIAPAS,7,TAPACHULA,089,TOLUQUITA,1,14,8,6,1
CHIAPAS,7,TAPACHULA,089,TOQUIÁN CHIQUITO,4,110,56,54,6
CHIAPAS,7,TAPACHULA,089,TOQUIÁN GRANDE,4,452,219,233,18
CHIAPAS,7,TAPACHULA,089,UNIDAD 2000,1,24,7,17,1
CHIAPAS,7,TAPACHULA,089,UNIÓN MIRAMAR,3,296,151,145,12
CHIAPAS,7,TAPACHULA,089,VEGA DE LOS MOLINOS,3,71,33,38,4
CHIAPAS,7,TAPACHULA,089,VEGA DE MALACATE,1,45,20,25,2
CHIAPAS,7,TAPACHULA,089,VEINTIUNO DE MARZO (MANUEL LAZOS),2,81,44,37,4
CHIAPAS,7,TAPACHULA,089,VIDA MEJOR I,1,194,98,96,7
CHIAPAS,7,TAPACHULA,089,VILLA FLOR,2,148,75,73,7
CHIAPAS,7,TAPACHULA,089,VILLA LAS ROSAS,2,56,30,26,3
CHIAPAS,7,TAPACHULA,089,VILLAHERMOSA,2,55,25,30,3
CHIAPAS,7,TAPACHULA,089,VIVA MÉXICO,3,863,430,433,40
CHIAPAS,7,TAPACHULA,089,ZAPOPAN,1,69,31,38,2
CHIAPAS,7,TAPACHULA,089,ZARAGOZA,8,424,212,212,22
CHIAPAS,7,TAPALAPA,090,ARROYO SECO,1,9,3,6,1
CHIAPAS,7,TAPALAPA,090,BLANCA ROSA,3,94,42,52,5
CHIAPAS,7,TAPALAPA,090,BUENA VISTA 1RA. SECCIÓN,2,12,4,8,2
CHIAPAS,7,TAPALAPA,090,BUENAVISTA,3,19,8,11,3
CHIAPAS,7,TAPALAPA,090,BUENAVISTA (LINDAVISTA),1,20,10,10,1
CHIAPAS,7,TAPALAPA,090,EL PORVENIR,3,60,32,28,3
CHIAPAS,7,TAPALAPA,090,LIQUIDÁMBAR,3,30,18,12,3
CHIAPAS,7,TAPALAPA,090,MAZONO,4,211,113,98,9
CHIAPAS,7,TAPALAPA,090,NUEVO PROGRESO,2,20,13,7,2
CHIAPAS,7,TAPALAPA,090,PALESTINA,2,46,19,27,4
CHIAPAS,7,TAPALAPA,090,SAGRADO CORAZÓN DE JESÚS,2,50,29,21,3
CHIAPAS,7,TAPALAPA,090,SAN AGUSTÍN,2,9,5,4,2
CHIAPAS,7,TAPALAPA,090,SAN ANTONIO,2,39,18,21,2
CHIAPAS,7,TAPALAPA,090,SAN ANTONIO BLANCA ROSA,3,26,12,14,3
CHIAPAS,7,TAPALAPA,090,SAN ISIDRO,1,12,5,7,1
CHIAPAS,7,TAPALAPA,090,TAPALAPA,7,825,398,427,41
CHIAPAS,7,TAPALAPA,090,VEINTE DE NOVIEMBRE,2,38,19,19,2
CHIAPAS,7,TAPILULA,091,CRUCES DE SAN ANTONIO,2,13,11,2,2
CHIAPAS,7,TAPILULA,091,EL CHORRO,2,19,9,10,2
CHIAPAS,7,TAPILULA,091,EL PAJONAL PARTE ALTA,2,17,8,9,2
CHIAPAS,7,TAPILULA,091,LA CANDELARIA,1,20,12,8,2
CHIAPAS,7,TAPILULA,091,LA PIEDAD (SAN ANTONIO),1,6,4,2,1
CHIAPAS,7,TAPILULA,091,NUEVA ESPERANZA,2,22,9,13,3
CHIAPAS,7,TAPILULA,091,PAJONAL PARTE BAJA,2,25,15,10,2
CHIAPAS,7,TAPILULA,091,PORTACELI,5,310,169,141,14
CHIAPAS,7,TAPILULA,091,PORTACELI PARTE BAJA,2,16,9,7,2
CHIAPAS,7,TAPILULA,091,PORTACELIS PARTE MEDIA,1,42,19,23,2
CHIAPAS,7,TAPILULA,091,SAN ANTONIO JACONÁ,2,9,5,4,2
CHIAPAS,7,TAPILULA,091,SAN FRANCISCO JACONÁ,3,312,157,155,14
CHIAPAS,7,TAPILULA,091,SAN ISIDRO,1,26,15,11,2
CHIAPAS,7,TAPILULA,091,SAN LORENZO ISIDRO,3,56,26,30,4
CHIAPAS,7,TAPILULA,091,SAN VICENTE AGUA CLARA,3,42,28,14,4
CHIAPAS,7,TAPILULA,091,SANTA CRUZ,2,21,8,13,2
CHIAPAS,7,TAPILULA,091,TAPILULA,15,3007,1506,1501,180
CHIAPAS,7,TAPILULA,091,VIDEME DE OCAMPO 1RA. SECCIÓN,3,111,54,57,6
CHIAPAS,7,TAPILULA,091,ZAQUÍNGUEZ,3,123,75,48,7
CHIAPAS,7,TECPATÁN,092,ADOLFO RUIZ CORTINES,4,227,118,109,10
CHIAPAS,7,TECPATÁN,092,BELLAVISTA,1,5,0,5,1
CHIAPAS,7,TECPATÁN,092,BUENAVISTA MANÓN,1,4,2,2,1
CHIAPAS,7,TECPATÁN,092,CANDELARIA,1,8,3,5,1
CHIAPAS,7,TECPATÁN,092,CANDELARIA EL JÍCARO,2,33,20,13,2
CHIAPAS,7,TECPATÁN,092,CASA BLANCA (SAN ISIDRO),2,31,18,13,2
CHIAPAS,7,TECPATÁN,092,CUCHAY GIÉN,5,97,39,58,9
CHIAPAS,7,TECPATÁN,092,EL CARMEN CERRO BLANCO,2,18,15,3,2
CHIAPAS,7,TECPATÁN,092,EL CARMEN CERRO SANTO DOS,1,8,5,3,1
CHIAPAS,7,TECPATÁN,092,EL CARMEN CERRO SANTO UNO (ATHECNHE),1,4,1,3,1
CHIAPAS,7,TECPATÁN,092,EL EDÉN (AGUA ESCONDIDA),3,147,78,69,9
CHIAPAS,7,TECPATÁN,092,EL HORIZONTE,1,4,2,2,1
CHIAPAS,7,TECPATÁN,092,EL LAUREL,1,32,16,16,1
CHIAPAS,7,TECPATÁN,092,EL MIRADOR,1,10,4,6,1
CHIAPAS,7,TECPATÁN,092,EL PORVENIR,4,236,122,114,14
CHIAPAS,7,TECPATÁN,092,EL TRIUNFO,1,7,1,6,1
CHIAPAS,7,TECPATÁN,092,EMILIANO ZAPATA,6,276,138,138,18
CHIAPAS,7,TECPATÁN,092,FRANCISCO I. MADERO,4,470,246,224,19
CHIAPAS,7,TECPATÁN,092,ISLA YOMONÓ,2,23,7,16,2
CHIAPAS,7,TECPATÁN,092,JÍCARO I,1,8,6,2,1
CHIAPAS,7,TECPATÁN,092,JUAN SABINES GUTIÉRREZ,3,209,113,96,10
CHIAPAS,7,TECPATÁN,092,LA LIBERTAD,5,199,103,96,11
CHIAPAS,7,TECPATÁN,092,LA NUEVA INDEPENDENCIA (GUAÑUTI),1,9,7,2,1
CHIAPAS,7,TECPATÁN,092,LA PALMA,1,6,3,3,1
CHIAPAS,7,TECPATÁN,092,LA PIÑITA,4,39,17,22,4
CHIAPAS,7,TECPATÁN,092,LA VENTANA,1,5,1,4,1
CHIAPAS,7,TECPATÁN,092,LAS PILAS,1,6,5,1,1
CHIAPAS,7,TECPATÁN,092,LÁZARO CÁRDENAS 2,2,25,13,12,2
CHIAPAS,7,TECPATÁN,092,LOMA LINDA,2,22,10,12,2
CHIAPAS,7,TECPATÁN,092,LOS LIRIOS,2,27,10,17,2
CHIAPAS,7,TECPATÁN,092,LUIS ESPINOSA,6,499,258,241,34
CHIAPAS,7,TECPATÁN,092,MENAPAC,2,16,10,6,2
CHIAPAS,7,TECPATÁN,092,MIGUEL ALEMÁN,3,86,46,40,4
CHIAPAS,7,TECPATÁN,092,MIGUEL HIDALGO Y COSTILLA,4,342,190,152,13
CHIAPAS,7,TECPATÁN,092,MONTE ALEGRE,2,51,24,27,3
CHIAPAS,7,TECPATÁN,092,MONTE GRANDE,1,17,8,9,1
CHIAPAS,7,TECPATÁN,092,MONTERREY,1,21,9,12,1
CHIAPAS,7,TECPATÁN,092,MONTERREY (BUENAVISTA POYOSPAC),1,5,2,3,1
CHIAPAS,7,TECPATÁN,092,NUCUPAC,2,22,11,11,2
CHIAPAS,7,TECPATÁN,092,NUEVA ESPERANZA,2,18,12,6,2
CHIAPAS,7,TECPATÁN,092,NUEVO GUADALUPE,1,5,2,3,1
CHIAPAS,7,TECPATÁN,092,NUEVO NARANJO,4,267,120,147,13
CHIAPAS,7,TECPATÁN,092,NUEVO QUECHULA,3,169,94,75,8
CHIAPAS,7,TECPATÁN,092,NUEVO QUECHULA (CHASPAC),3,83,34,49,4
CHIAPAS,7,TECPATÁN,092,NUEVO TOTOPAC,1,9,5,4,1
CHIAPAS,7,TECPATÁN,092,NUEVO VICENTE GUERRERO,2,66,36,30,3
CHIAPAS,7,TECPATÁN,092,ONDA FRÍA,1,6,1,5,1
CHIAPAS,7,TECPATÁN,092,POBLADO NUEVO GENERAL FRANCISCO VILLA,2,65,31,34,3
CHIAPAS,7,TECPATÁN,092,PORTES GIL,3,22,8,14,3
CHIAPAS,7,TECPATÁN,092,RANCHO ALEGRE,3,39,20,19,3
CHIAPAS,7,TECPATÁN,092,RÍO BLANCO,1,5,4,1,1
CHIAPAS,7,TECPATÁN,092,SAN ANTONIO AZAPAC,1,8,4,4,1
CHIAPAS,7,TECPATÁN,092,SAN ANTONIO EL CARMEN (CANDELARIA),1,13,4,9,1
CHIAPAS,7,TECPATÁN,092,SAN JOSÉ CUSHIPAC,3,162,75,87,7
CHIAPAS,7,TECPATÁN,092,SAN JOSÉ REFORMA,1,80,40,40,4
CHIAPAS,7,TECPATÁN,092,SAN LUIS,2,19,8,11,2
CHIAPAS,7,TECPATÁN,092,SAN PABLO,2,53,27,26,3
CHIAPAS,7,TECPATÁN,092,SAN VICENTE,3,31,13,18,4
CHIAPAS,7,TECPATÁN,092,SANTA CRUZ,1,24,10,14,1
CHIAPAS,7,TECPATÁN,092,SANTA CRUZ BUENAVISTA,2,28,13,15,2
CHIAPAS,7,TECPATÁN,092,SIMBAK,2,14,9,5,2
CHIAPAS,7,TECPATÁN,092,TECPATÁN,14,1861,935,926,109
CHIAPAS,7,TECPATÁN,092,TULIPÁN DE LAS FLORES,1,10,4,6,1
CHIAPAS,7,TECPATÁN,092,UNIÓN AZAPAC,3,44,25,19,4
CHIAPAS,7,TENEJAPA,093,5 DE ABRIL,2,17,7,10,2
CHIAPAS,7,TENEJAPA,093,ACHLUM,2,156,75,81,5
CHIAPAS,7,TENEJAPA,093,AMAQUIL (PATIO AMPLIO),2,210,101,109,7
CHIAPAS,7,TENEJAPA,093,BAJCHÉN,2,100,49,51,3
CHIAPAS,7,TENEJAPA,093,BAJ'LOK'ILJA,2,42,20,22,2
CHIAPAS,7,TENEJAPA,093,BALÚN CANÁN,3,179,93,86,8
CHIAPAS,7,TENEJAPA,093,BANAVIL,2,65,34,31,2
CHIAPAS,7,TENEJAPA,093,BARRIO ALTO,2,130,60,70,4
CHIAPAS,7,TENEJAPA,093,BAWITS,2,71,35,36,4
CHIAPAS,7,TENEJAPA,093,CAÑADA CHICA,2,100,50,50,5
CHIAPAS,7,TENEJAPA,093,CAÑADA GRANDE,2,146,72,74,6
CHIAPAS,7,TENEJAPA,093,CHACOMA,3,566,276,290,27
CHIAPAS,7,TENEJAPA,093,CHALAM,2,48,20,28,2
CHIAPAS,7,TENEJAPA,093,CHANA,2,121,67,54,5
CHIAPAS,7,TENEJAPA,093,CHIXALTONTIC,2,50,23,27,3
CHIAPAS,7,TENEJAPA,093,CHIXTONTIC,2,171,71,100,5
CHIAPAS,7,TENEJAPA,093,CHULJÁ,2,130,56,74,6
CHIAPAS,7,TENEJAPA,093,CRUZ PILAR,2,178,92,86,8
CHIAPAS,7,TENEJAPA,093,CRUZ TZIBALTIC,2,30,17,13,2
CHIAPAS,7,TENEJAPA,093,CRUZCHÉN,3,273,118,155,10
CHIAPAS,7,TENEJAPA,093,DOS POZOS,2,270,131,139,9
CHIAPAS,7,TENEJAPA,093,EL CORRALITO,2,123,62,61,6
CHIAPAS,7,TENEJAPA,093,EL PACH,2,60,31,29,3
CHIAPAS,7,TENEJAPA,093,EL RETIRO,3,295,145,150,9
CHIAPAS,7,TENEJAPA,093,GUADALUPE,2,25,14,11,2
CHIAPAS,7,TENEJAPA,093,JERUSALÉN,2,228,113,115,6
CHIAPAS,7,TENEJAPA,093,JOMANICHIM,3,580,290,290,25
CHIAPAS,7,TENEJAPA,093,JOSÉ LÓPEZ PORTILLO,2,29,15,14,3
CHIAPAS,7,TENEJAPA,093,JUXALJA,2,145,75,70,5
CHIAPAS,7,TENEJAPA,093,KOKIL,2,67,30,37,2
CHIAPAS,7,TENEJAPA,093,KOTOLTÉ,2,610,309,301,20
CHIAPAS,7,TENEJAPA,093,KULAKTIK,2,307,157,150,10
CHIAPAS,7,TENEJAPA,093,LA LIBERTAD,2,111,55,56,3
CHIAPAS,7,TENEJAPA,093,LAS MANZANAS,2,155,80,75,7
CHIAPAS,7,TENEJAPA,093,LOS MANGOS,2,97,48,49,4
CHIAPAS,7,TENEJAPA,093,LOS PINOS,2,116,54,62,5
CHIAPAS,7,TENEJAPA,093,MAJOSIK,4,640,280,360,24
CHIAPAS,7,TENEJAPA,093,MATZAM,5,698,326,372,36
CHIAPAS,7,TENEJAPA,093,MERCEDES,2,173,86,87,4
CHIAPAS,7,TENEJAPA,093,NARANJA SECA (VIEJO POBLADO),2,259,131,128,9
CHIAPAS,7,TENEJAPA,093,NAVIL,3,281,136,145,7
CHIAPAS,7,TENEJAPA,093,NUEVO POBLADO NARANJA SECA,4,432,192,240,17
CHIAPAS,7,TENEJAPA,093,OCOCH,3,583,245,338,21
CHIAPAS,7,TENEJAPA,093,PACTETÓN,2,234,113,121,8
CHIAPAS,7,TENEJAPA,093,PAJALTÓN,3,279,143,136,8
CHIAPAS,7,TENEJAPA,093,PATCH'EN,2,21,8,13,2
CHIAPAS,7,TENEJAPA,093,POBLADO CURVA,2,39,25,14,2
CHIAPAS,7,TENEJAPA,093,SAN ANTONIO,2,86,43,43,3
CHIAPAS,7,TENEJAPA,093,SANTA ROSA,2,65,39,26,3
CHIAPAS,7,TENEJAPA,093,SHISHINTONIL,2,333,169,164,11
CHIAPAS,7,TENEJAPA,093,SIBACTEL,3,326,168,158,10
CHIAPAS,7,TENEJAPA,093,SIBANILJÁ POCOLUM,4,961,409,552,40
CHIAPAS,7,TENEJAPA,093,SIVACTEL,1,62,32,30,2
CHIAPAS,7,TENEJAPA,093,TENEJAPA,5,1155,535,620,50
CHIAPAS,7,TENEJAPA,093,TRES CERROS,2,307,157,150,10
CHIAPAS,7,TENEJAPA,093,TRES POZOS,2,62,34,28,3
CHIAPAS,7,TENEJAPA,093,TS'AKUBILJÁ,2,36,16,20,3
CHIAPAS,7,TENEJAPA,093,TZAJALCHÉN,4,804,358,446,43
CHIAPAS,7,TENEJAPA,093,TZ'AQUIVILJOK,3,954,438,516,28
CHIAPAS,7,TENEJAPA,093,WINIKTÓN,2,252,118,134,8
CHIAPAS,7,TENEJAPA,093,YAALCHUCH,2,53,25,28,2
CHIAPAS,7,TENEJAPA,093,YANCH'EN,2,26,14,12,2
CHIAPAS,7,TENEJAPA,093,YASHANAL,3,718,356,362,20
CHIAPAS,7,TENEJAPA,093,YETZUCUM,2,375,196,179,12
CHIAPAS,7,TEOPISCA,094,AGUA ESCONDIDA,2,87,44,43,3
CHIAPAS,7,TEOPISCA,094,AMO,1,4,4,0,1
CHIAPAS,7,TEOPISCA,094,BALHUITZ,2,126,58,68,5
CHIAPAS,7,TEOPISCA,094,BELÉN LLUVIA DE GRACIA,2,96,52,44,5
CHIAPAS,7,TEOPISCA,094,BELÉN NUEVO SAN GERÓN,2,213,117,96,8
CHIAPAS,7,TEOPISCA,094,BENITO JUÁREZ,2,185,87,98,10
CHIAPAS,7,TEOPISCA,094,BETANIA,4,806,397,409,33
CHIAPAS,7,TEOPISCA,094,CAMPO SANTIAGO,4,263,134,129,15
CHIAPAS,7,TEOPISCA,094,CHIJILTEC (SAN ISIDRO),3,146,83,63,7
CHIAPAS,7,TEOPISCA,094,DAMASCO,2,78,41,37,3
CHIAPAS,7,TEOPISCA,094,DOLORES,2,250,138,112,8
CHIAPAS,7,TEOPISCA,094,DOS LAGUNAS (SAN ISIDRO),3,274,141,133,12
CHIAPAS,7,TEOPISCA,094,EL CHIVERO,3,77,43,34,6
CHIAPAS,7,TEOPISCA,094,EL NUEVO PARAÍSO,2,76,31,45,3
CHIAPAS,7,TEOPISCA,094,EL PORVENIR,4,153,70,83,9
CHIAPAS,7,TEOPISCA,094,EL SANTUARIO,2,92,37,55,4
CHIAPAS,7,TEOPISCA,094,EL VERGEL,1,79,39,40,3
CHIAPAS,7,TEOPISCA,094,EMILIANO ZAPATA,1,8,3,5,1
CHIAPAS,7,TEOPISCA,094,FLORES MAGÓN,3,160,81,79,8
CHIAPAS,7,TEOPISCA,094,GALILEA,3,273,132,141,11
CHIAPAS,7,TEOPISCA,094,GUADALUPE,3,255,124,131,12
CHIAPAS,7,TEOPISCA,094,GUADALUPE LA PROVIDENCIA (SANTA ROSA),1,15,10,5,1
CHIAPAS,7,TEOPISCA,094,JARDÍN DEL NUEVO EDÉN,2,262,138,124,8
CHIAPAS,7,TEOPISCA,094,JERUSALÉN,3,202,101,101,8
CHIAPAS,7,TEOPISCA,094,LA CEIBA (LAS CAÑAS),2,17,12,5,2
CHIAPAS,7,TEOPISCA,094,LÁZARO CÁRDENAS,2,31,20,11,3
CHIAPAS,7,TEOPISCA,094,LINDAVISTA,2,71,32,39,4
CHIAPAS,7,TEOPISCA,094,LOS LLANITOS,2,110,50,60,6
CHIAPAS,7,TEOPISCA,094,MONTE LIBANO,2,71,41,30,4
CHIAPAS,7,TEOPISCA,094,NAZARETH,2,85,45,40,3
CHIAPAS,7,TEOPISCA,094,NUEVA ESPERANZA (EL CARMELITO),2,28,11,17,3
CHIAPAS,7,TEOPISCA,094,NUEVA PALESTINA,2,62,28,34,3
CHIAPAS,7,TEOPISCA,094,NUEVO AMATENANGO (TRES TABERNAS),1,51,21,30,2
CHIAPAS,7,TEOPISCA,094,NUEVO BELEN,2,122,63,59,5
CHIAPAS,7,TEOPISCA,094,NUEVO BETHEL,2,64,36,28,4
CHIAPAS,7,TEOPISCA,094,NUEVO LEÓN,6,818,416,402,35
CHIAPAS,7,TEOPISCA,094,NUEVO SAN JUAN,2,117,51,66,6
CHIAPAS,7,TEOPISCA,094,NUEVO ZINACANTÁN,2,193,95,98,6
CHIAPAS,7,TEOPISCA,094,OJO DE AGUA,1,8,2,6,1
CHIAPAS,7,TEOPISCA,094,PATRIA NUEVA,2,12,8,4,2
CHIAPAS,7,TEOPISCA,094,RÍO BLANCO,2,19,7,12,2
CHIAPAS,7,TEOPISCA,094,RÍO JORDÁN,2,57,23,34,4
CHIAPAS,7,TEOPISCA,094,SAN ANTONIO BELLAVISTA,2,129,59,70,4
CHIAPAS,7,TEOPISCA,094,SAN ANTONIO CIPRESAL,2,62,32,30,4
CHIAPAS,7,TEOPISCA,094,SAN ANTONIO SIBACAJ,1,56,23,33,2
CHIAPAS,7,TEOPISCA,094,SAN FRANCISCO,2,73,41,32,3
CHIAPAS,7,TEOPISCA,094,SAN ISIDRO CHICHIHUISTÁN,3,159,80,79,8
CHIAPAS,7,TEOPISCA,094,SAN JERÓNIMO,1,51,29,22,2
CHIAPAS,7,TEOPISCA,094,SAN JOSÉ SHATIC,2,128,66,62,4
CHIAPAS,7,TEOPISCA,094,SAN MARCOS,2,62,33,29,3
CHIAPAS,7,TEOPISCA,094,SANTA ROSALÍA (EL MANGUITO),3,49,27,22,4
CHIAPAS,7,TEOPISCA,094,SINAÍ,2,160,78,82,6
CHIAPAS,7,TEOPISCA,094,TEOPISCA,25,5382,2686,2696,275
CHIAPAS,7,TEOPISCA,094,TEPEYAC,2,45,23,22,4
CHIAPAS,7,TEOPISCA,094,TIERRA COLORADA,2,91,37,54,6
CHIAPAS,7,TEOPISCA,094,TZAJALA,3,285,127,158,12
CHIAPAS,7,TEOPISCA,094,VIDA NUEVA,1,31,19,12,2
CHIAPAS,7,TEOPISCA,094,VISTAHERMOSA,2,156,82,74,6
CHIAPAS,7,TEOPISCA,094,YASHLUMILJA,2,137,64,73,5
CHIAPAS,7,TEOPISCA,094,ZARAGOZA VIEJA,1,123,60,63,5
CHIAPAS,7,TILA,096,3 DE MAYO,2,16,7,9,2
CHIAPAS,7,TILA,096,AGUA FRÍA,2,68,36,32,3
CHIAPAS,7,TILA,096,ÁLVARO OBREGÓN,5,318,153,165,14
CHIAPAS,7,TILA,096,BELISARIO DOMÍNGUEZ,4,95,50,45,6
CHIAPAS,7,TILA,096,CAMPANARIO,3,135,70,65,7
CHIAPAS,7,TILA,096,CANTIOC,4,468,235,233,21
CHIAPAS,7,TILA,096,CARMEN 1RA. SECCIÓN,2,6,4,2,1
CHIAPAS,7,TILA,096,CARMEN 2DA. SECCIÓN,2,48,18,30,3
CHIAPAS,7,TILA,096,CARMEN 3RA. SECCIÓN (CARMEN CHINAL),2,39,18,21,2
CHIAPAS,7,TILA,096,CERRO MISOPA,4,315,159,156,13
CHIAPAS,7,TILA,096,CHACHALACA,2,143,71,72,8
CHIAPAS,7,TILA,096,CHEBOPA,2,53,23,30,2
CHIAPAS,7,TILA,096,CHICHONAL,2,38,18,20,3
CHIAPAS,7,TILA,096,CHININTIÉ,3,370,184,186,12
CHIAPAS,7,TILA,096,CHUCTIÉJA,2,106,60,46,4
CHIAPAS,7,TILA,096,CHULUM CÁRDENAS,4,629,289,340,25
CHIAPAS,7,TILA,096,CHULUM CHICO,2,69,33,36,3
CHIAPAS,7,TILA,096,CHULUM CHICO UNO,2,71,35,36,3
CHIAPAS,7,TILA,096,CHULUM HIDALGO,3,350,164,186,10
CHIAPAS,7,TILA,096,CHULUM ITURBIDE,1,47,27,20,1
CHIAPAS,7,TILA,096,CHULUM JUÁREZ,6,1482,729,753,45
CHIAPAS,7,TILA,096,CHULUM LAS PALMAS,3,146,68,78,5
CHIAPAS,7,TILA,096,COQUIJA,4,263,120,143,12
CHIAPAS,7,TILA,096,COROZAL NUEVO,3,40,21,19,3
CHIAPAS,7,TILA,096,COROZIL VIEJO,2,47,19,28,4
CHIAPAS,7,TILA,096,CORTA FLOR,2,31,15,16,2
CHIAPAS,7,TILA,096,CRUZ PALENQUE,3,112,59,53,6
CHIAPAS,7,TILA,096,CRUZ VERDE,2,16,7,9,2
CHIAPAS,7,TILA,096,CUCUJÁ,2,34,21,13,3
CHIAPAS,7,TILA,096,DIECIOCHO DE MARZO,3,169,89,80,6
CHIAPAS,7,TILA,096,EL CALVARIO,3,99,43,56,5
CHIAPAS,7,TILA,096,EL CARRIZAL,2,314,167,147,12
CHIAPAS,7,TILA,096,EL CRUCERO,2,161,72,89,8
CHIAPAS,7,TILA,096,EL LIMAR,9,1682,828,854,67
CHIAPAS,7,TILA,096,EL OCOTAL,3,326,149,177,11
CHIAPAS,7,TILA,096,EL PARAÍSO,2,105,54,51,4
CHIAPAS,7,TILA,096,EL PORVENIR,3,81,35,46,5
CHIAPAS,7,TILA,096,EL REFUGIO,2,17,10,7,2
CHIAPAS,7,TILA,096,EL VIOLÍN,3,91,39,52,7
CHIAPAS,7,TILA,096,EMILIANO ZAPATA,4,132,67,65,7
CHIAPAS,7,TILA,096,ESPERANZA OCOTAL,3,121,60,61,8
CHIAPAS,7,TILA,096,FRANCISCO I. MADERO,2,22,14,8,3
CHIAPAS,7,TILA,096,GRACIAS A DIOS,1,15,8,7,1
CHIAPAS,7,TILA,096,GRAN PODER,2,7,4,3,1
CHIAPAS,7,TILA,096,GUAPACAL,1,8,5,3,1
CHIAPAS,7,TILA,096,HUANAL,2,70,35,35,3
CHIAPAS,7,TILA,096,JOCHINTEOL,3,129,70,59,6
CHIAPAS,7,TILA,096,JOL-AKO,2,74,30,44,3
CHIAPAS,7,TILA,096,JOLHUITZ,2,44,21,23,2
CHIAPAS,7,TILA,096,JOLJÁ,3,441,201,240,17
CHIAPAS,7,TILA,096,JOLJA TIONTIEPA,3,395,193,202,13
CHIAPAS,7,TILA,096,JOLMASOJA,3,116,68,48,6
CHIAPAS,7,TILA,096,JOLNISHTIE 1RA. SECCIÓN,2,110,51,59,5
CHIAPAS,7,TILA,096,JOLNOPA GUADALUPE,3,301,157,144,9
CHIAPAS,7,TILA,096,JOLPOKITIOC,3,262,129,133,10
CHIAPAS,7,TILA,096,JOLSIBAQUIL,4,595,312,283,19
CHIAPAS,7,TILA,096,JOMAJIL,3,109,42,67,7
CHIAPAS,7,TILA,096,KATIEJA,1,6,3,3,1
CHIAPAS,7,TILA,096,LA CRUZ,1,37,19,18,1
CHIAPAS,7,TILA,096,LA CUMBRE Y CUESTA,2,121,58,63,3
CHIAPAS,7,TILA,096,LA FUGA,3,50,23,27,5
CHIAPAS,7,TILA,096,LA INDEPENDENCIA,2,105,56,49,4
CHIAPAS,7,TILA,096,LA MONTAÑA,1,26,7,19,1
CHIAPAS,7,TILA,096,LA PRECIOSA,2,25,15,10,2
CHIAPAS,7,TILA,096,LA REVOLUCIÓN,3,477,235,242,13
CHIAPAS,7,TILA,096,LAS PALMAS,1,4,3,1,1
CHIAPAS,7,TILA,096,LIBERTAD JOLNISHTIE 2DA. SECCIÓN,7,721,349,372,22
CHIAPAS,7,TILA,096,LOS ÁNGELES,2,64,33,31,4
CHIAPAS,7,TILA,096,LOS HÉROES,2,26,15,11,3
CHIAPAS,7,TILA,096,LOS MANGOS,3,160,80,80,4
CHIAPAS,7,TILA,096,LUMIJÁ,2,69,30,39,4
CHIAPAS,7,TILA,096,MASOJA CHICO,2,51,28,23,3
CHIAPAS,7,TILA,096,MASOJA GRANDE,3,170,86,84,6
CHIAPAS,7,TILA,096,MASOJA SHUCJÁ,3,106,51,55,6
CHIAPAS,7,TILA,096,MASOJA YOCHIJA,2,61,35,26,2
CHIAPAS,7,TILA,096,MIGUEL ALEMÁN VALDEZ,3,245,115,130,9
CHIAPAS,7,TILA,096,MISIJA,3,441,235,206,13
CHIAPAS,7,TILA,096,MISOPA CHINAL,4,330,151,179,14
CHIAPAS,7,TILA,096,MONTERREY 1RA. SECCIÓN,2,32,18,14,2
CHIAPAS,7,TILA,096,MONTERREY 2DA. SECCIÓN,2,115,51,64,4
CHIAPAS,7,TILA,096,NICOLÁS BRAVO,2,74,34,40,3
CHIAPAS,7,TILA,096,NUEVA ESPERANZA,7,1553,749,804,58
CHIAPAS,7,TILA,096,NUEVA GENERACIÓN CHULUM CHICO,2,17,7,10,2
CHIAPAS,7,TILA,096,NUEVO LIMAR,6,840,416,424,31
CHIAPAS,7,TILA,096,NUEVO MÉXICO,3,58,29,29,4
CHIAPAS,7,TILA,096,OSTELUCUM,2,201,109,92,4
CHIAPAS,7,TILA,096,PALO NEGRO,3,35,19,16,4
CHIAPAS,7,TILA,096,PANCHUC COROZIL,2,75,41,34,3
CHIAPAS,7,TILA,096,PANHUITZ,2,62,35,27,2
CHIAPAS,7,TILA,096,PANHUITZ TIANIJÁ,3,143,77,66,5
CHIAPAS,7,TILA,096,PANSUTZTEOL,2,89,49,40,4
CHIAPAS,7,TILA,096,PANTIANIJA,2,40,18,22,2
CHIAPAS,7,TILA,096,PANTS'AJK,2,6,3,3,1
CHIAPAS,7,TILA,096,PASO CHINAL,3,327,165,162,9
CHIAPAS,7,TILA,096,PATASTAL,2,71,29,42,4
CHIAPAS,7,TILA,096,PETALCINGO,10,2158,1078,1080,81
CHIAPAS,7,TILA,096,RÍO GRANDE,2,182,82,100,8
CHIAPAS,7,TILA,096,SAN FRANCISCO JIMBAL,3,32,17,15,4
CHIAPAS,7,TILA,096,SAN JUAN CARRIZAL 1RA. SECCIÓN,3,179,94,85,10
CHIAPAS,7,TILA,096,SAN NICOLÁS,2,15,7,8,2
CHIAPAS,7,TILA,096,SANTA CRUZ,1,24,10,14,1
CHIAPAS,7,TILA,096,SAÑOJA 1RA. SECCIÓN,1,9,4,5,1
CHIAPAS,7,TILA,096,SAÑOJA 2DA. SECCIÓN,2,17,11,6,2
CHIAPAS,7,TILA,096,SHOCTIC,5,715,361,354,27
CHIAPAS,7,TILA,096,SUSUCLUMIL,2,12,9,3,2
CHIAPAS,7,TILA,096,TAQUINTENÁN,2,36,19,17,2
CHIAPAS,7,TILA,096,TILA,17,2926,1434,1492,172
CHIAPAS,7,TILA,096,TIONTIEPA BENITO JUÁREZ,4,344,172,172,13
CHIAPAS,7,TILA,096,TIUTZOL,3,175,96,79,8
CHIAPAS,7,TILA,096,TOCOB LEGLEMAL,5,594,282,312,22
CHIAPAS,7,TILA,096,TZA'QUIL,2,145,80,65,5
CHIAPAS,7,TILA,096,UNIÓN JUÁREZ,5,298,140,158,14
CHIAPAS,7,TILA,096,USIPA,4,636,304,332,25
CHIAPAS,7,TILA,096,VEINTE DE NOVIEMBRE,3,59,31,28,5
CHIAPAS,7,TILA,096,VENUSTIANO CARRANZA,3,106,47,59,5
CHIAPAS,7,TILA,096,VICENTE GUERRERO,2,127,67,60,5
CHIAPAS,7,TILA,096,VICTORIA,2,167,85,82,6
CHIAPAS,7,TILA,096,VILLAFLORES,2,153,76,77,5
CHIAPAS,7,TILA,096,WILIS 1RA. SECCIÓN,2,39,13,26,3
CHIAPAS,7,TILA,096,WILIS 2DA. SECCIÓN,2,101,46,55,4
CHIAPAS,7,TILA,096,WOWOSLUMIL,2,32,13,19,2
CHIAPAS,7,TILA,096,YOK POKITIOK,2,135,62,73,5
CHIAPAS,7,TILA,096,ZAQUITEL OJO DE AGUA,2,137,71,66,3
CHIAPAS,7,TONALÁ,097,ALTAMIRA,1,5,4,1,1
CHIAPAS,7,TONALÁ,097,BENITO JUÁREZ,1,34,16,18,2
CHIAPAS,7,TONALÁ,097,BENITO JUÁREZ (NUEVO MILENIO),2,29,14,15,3
CHIAPAS,7,TONALÁ,097,BOCA DEL CIELO,2,89,49,40,4
CHIAPAS,7,TONALÁ,097,BUENAVISTA,1,5,3,2,1
CHIAPAS,7,TONALÁ,097,CABEZA DE TORO,9,1291,636,655,69
CHIAPAS,7,TONALÁ,097,CALZADA DE HUACHIPILÍN,3,117,58,59,6
CHIAPAS,7,TONALÁ,097,DOCTOR BELISARIO DOMÍNGUEZ (LA BARRA),3,251,123,128,12
CHIAPAS,7,TONALÁ,097,DURANGO (VICTÓRICO R. GRAJALES),3,163,70,93,8
CHIAPAS,7,TONALÁ,097,EL ARENAL,2,7,3,4,1
CHIAPAS,7,TONALÁ,097,EL CONGRESO,2,135,75,60,5
CHIAPAS,7,TONALÁ,097,EL GUAYABO,2,46,22,24,3
CHIAPAS,7,TONALÁ,097,EL MANGUITO,3,179,95,84,10
CHIAPAS,7,TONALÁ,097,EL NARANJO,3,148,82,66,7
CHIAPAS,7,TONALÁ,097,EL OTATAL,2,21,10,11,2
CHIAPAS,7,TONALÁ,097,EL OTATE,2,29,13,16,3
CHIAPAS,7,TONALÁ,097,EL PARAÍSO,2,88,40,48,4
CHIAPAS,7,TONALÁ,097,EL ROBLE,2,41,23,18,3
CHIAPAS,7,TONALÁ,097,EL TERRERO,4,176,83,93,10
CHIAPAS,7,TONALÁ,097,EL TRÉBOL,1,152,71,81,6
CHIAPAS,7,TONALÁ,097,FRANCISCO I. MADERO,2,55,26,29,3
CHIAPAS,7,TONALÁ,097,GALEANA CALENTURA,2,41,21,20,3
CHIAPAS,7,TONALÁ,097,GENERAL ALBERTO PINEDA,4,106,57,49,8
CHIAPAS,7,TONALÁ,097,GENERAL LÁZARO CÁRDENAS (VUELTA RICA),2,33,17,16,3
CHIAPAS,7,TONALÁ,097,GUADALUPE VICTORIA,2,30,15,15,3
CHIAPAS,7,TONALÁ,097,HUACHIPILÍN CALENTURA (LA RAMADITA),2,44,22,22,3
CHIAPAS,7,TONALÁ,097,HUANACASTAL,3,221,106,115,10
CHIAPAS,7,TONALÁ,097,HUIZACHAL,5,631,312,319,28
CHIAPAS,7,TONALÁ,097,IGNACIO ALLENDE,2,12,7,5,2
CHIAPAS,7,TONALÁ,097,IGNACIO RAMÍREZ,4,533,258,275,26
CHIAPAS,7,TONALÁ,097,ING. RUBÉN MÁRQUEZ Y SU ANEXO NÚMERO DOS,2,73,39,34,5
CHIAPAS,7,TONALÁ,097,JOSÉ CASTILLO TIELMANS,2,39,17,22,2
CHIAPAS,7,TONALÁ,097,JOSEFA ORTIZ DE DOMÍNGUEZ (LA ESMERALDA),1,74,30,44,4
CHIAPAS,7,TONALÁ,097,LA ESMERALDA,1,24,14,10,2
CHIAPAS,7,TONALÁ,097,LA ESPERANZA,2,54,25,29,3
CHIAPAS,7,TONALÁ,097,LA JOYITA UNO,3,33,16,17,3
CHIAPAS,7,TONALÁ,097,LA LAGUNA,4,361,171,190,16
CHIAPAS,7,TONALÁ,097,LA MARTINICA,1,9,6,3,1
CHIAPAS,7,TONALÁ,097,LA POLKA,4,236,125,111,14
CHIAPAS,7,TONALÁ,097,LA POLKITA,3,21,10,11,3
CHIAPAS,7,TONALÁ,097,LA PROVIDENCIA,2,22,14,8,2
CHIAPAS,7,TONALÁ,097,LAS MANZANAS,2,14,6,8,2
CHIAPAS,7,TONALÁ,097,LAS PALMAS,3,37,18,19,3
CHIAPAS,7,TONALÁ,097,LAS PIEDRITAS,4,141,63,78,8
CHIAPAS,7,TONALÁ,097,LLANO LARGO,2,74,36,38,4
CHIAPAS,7,TONALÁ,097,MANUEL ÁVILA CAMACHO (PONTE DURO),4,648,331,317,25
CHIAPAS,7,TONALÁ,097,MEDIO MONTE,1,13,7,6,1
CHIAPAS,7,TONALÁ,097,MIGUEL HIDALGO NÚMERO DOS (VEINTE DE NOVIEMBRE),3,241,108,133,10
CHIAPAS,7,TONALÁ,097,MIGUEL HIDALGO NÚMERO UNO,3,100,51,49,6
CHIAPAS,7,TONALÁ,097,MORELOS (MOJARRAS),4,254,141,113,13
CHIAPAS,7,TONALÁ,097,NATALIO VÁZQUEZ PALLARES,3,94,45,49,6
CHIAPAS,7,TONALÁ,097,NOYOLA,3,277,153,124,12
CHIAPAS,7,TONALÁ,097,NUEVO BENITO JUÁREZ,2,25,15,10,3
CHIAPAS,7,TONALÁ,097,NUEVO MORELOS,2,44,26,18,3
CHIAPAS,7,TONALÁ,097,NUEVO PALO BLANCO,1,61,29,32,3
CHIAPAS,7,TONALÁ,097,PALO BLANCO,4,192,104,88,12
CHIAPAS,7,TONALÁ,097,PAREDÓN,10,1716,822,894,109
CHIAPAS,7,TONALÁ,097,PUEBLO NUEVO (SAN CAYETANO),3,369,191,178,16
CHIAPAS,7,TONALÁ,097,PUERTO ARISTA,3,226,107,119,12
CHIAPAS,7,TONALÁ,097,QUETZALAPA,2,25,14,11,2
CHIAPAS,7,TONALÁ,097,RAYMUNDO FLORES FUENTES,3,62,30,32,5
CHIAPAS,7,TONALÁ,097,RIACHUELO,2,25,10,15,2
CHIAPAS,7,TONALÁ,097,RICARDO FLORES MAGÓN,2,32,12,20,2
CHIAPAS,7,TONALÁ,097,RÍO BRAVO,2,18,9,9,2
CHIAPAS,7,TONALÁ,097,RÍO FLOR,2,24,10,14,2
CHIAPAS,7,TONALÁ,097,RÍO TILTEPEC,3,31,13,18,3
CHIAPAS,7,TONALÁ,097,SAN ANDRÉS BUENAVISTA,1,13,7,6,1
CHIAPAS,7,TONALÁ,097,SAN FELIPE,1,159,74,85,6
CHIAPAS,7,TONALÁ,097,SAN FRANCISCO EL OCOTAL,2,104,48,56,4
CHIAPAS,7,TONALÁ,097,SAN FRANCISCO TONALÁ,1,17,7,10,2
CHIAPAS,7,TONALÁ,097,SAN LUQUEÑO,4,355,182,173,16
CHIAPAS,7,TONALÁ,097,SAN NICOLÁS,2,111,49,62,5
CHIAPAS,7,TONALÁ,097,SANTA ROSA LAS LIMAS,3,84,41,43,5
CHIAPAS,7,TONALÁ,097,SANTA ROSA LAS LIMAS II,2,43,15,28,4
CHIAPAS,7,TONALÁ,097,TOMÁS GARRIDO CANABAL (SAN MARCOS),3,34,20,14,4
CHIAPAS,7,TONALÁ,097,TONALÁ,84,11765,5924,5841,919
CHIAPAS,7,TONALÁ,097,TRES PICOS,8,1414,723,691,67
CHIAPAS,7,TONALÁ,097,UNIÓN Y PROGRESO,1,18,9,9,1
CHIAPAS,7,TONALÁ,097,VALLE DEL SOL,1,8,3,5,1
CHIAPAS,7,TONALÁ,097,VEINTE DE NOVIEMBRE,3,157,77,80,8
CHIAPAS,7,TONALÁ,097,VERANO,1,11,5,6,1
CHIAPAS,7,TONALÁ,097,VICENTE GUERRERO,3,159,71,88,11
CHIAPAS,7,TONALÁ,097,VILLAHERMOSA,3,132,69,63,8
CHIAPAS,7,TOTOLAPA,098,EL GUAYABAL,1,5,1,4,1
CHIAPAS,7,TOTOLAPA,098,EL PARAÍSO,2,32,12,20,3
CHIAPAS,7,TOTOLAPA,098,EL TRIUNFO,2,52,27,25,5
CHIAPAS,7,TOTOLAPA,098,LA BODEGA,1,10,5,5,1
CHIAPAS,7,TOTOLAPA,098,LA MERCED,3,106,55,51,8
CHIAPAS,7,TOTOLAPA,098,NUEVO DOLORES,3,126,53,73,7
CHIAPAS,7,TOTOLAPA,098,PONCIANO ARRIAGA,3,181,86,95,9
CHIAPAS,7,TOTOLAPA,098,SANTA CECILIA,1,63,28,35,4
CHIAPAS,7,TOTOLAPA,098,TOTOLAPA,6,1326,654,672,51
CHIAPAS,7,TOTOLAPA,098,VILLA DE GUADALUPE,2,78,34,44,4
CHIAPAS,7,LA TRINITARIA,099,23 DE ENERO PAJAL II,2,21,15,6,2
CHIAPAS,7,LA TRINITARIA,099,6 DE MARZO,4,151,91,60,9
CHIAPAS,7,LA TRINITARIA,099,ACACHSNAJAB,1,7,3,4,1
CHIAPAS,7,LA TRINITARIA,099,ACAPULCO,3,106,48,58,5
CHIAPAS,7,LA TRINITARIA,099,ALBORES DE ZAPATA 2,1,12,7,5,1
CHIAPAS,7,LA TRINITARIA,099,ALBORES DE ZAPATA I,2,38,14,24,2
CHIAPAS,7,LA TRINITARIA,099,ALLENDE,2,209,115,94,10
CHIAPAS,7,LA TRINITARIA,099,ÁLVARO OBREGÓN,4,476,253,223,20
CHIAPAS,7,LA TRINITARIA,099,ÁNGEL ALBINO CORZO,3,190,92,98,10
CHIAPAS,7,LA TRINITARIA,099,ANTELÁ,2,93,50,43,4
CHIAPAS,7,LA TRINITARIA,099,AS DE ORO (NUEVO LLANO GRANDE),2,12,9,3,2
CHIAPAS,7,LA TRINITARIA,099,BENITO JUÁREZ,6,190,92,98,8
CHIAPAS,7,LA TRINITARIA,099,BUENAVISTA,1,37,12,25,2
CHIAPAS,7,LA TRINITARIA,099,CARMEN XHÁN,4,384,179,205,17
CHIAPAS,7,LA TRINITARIA,099,CHIHUAHUA,4,418,207,211,17
CHIAPAS,7,LA TRINITARIA,099,CRISTÓBAL COLÓN (LAGOS DE COLÓN),2,40,19,21,3
CHIAPAS,7,LA TRINITARIA,099,CUAUHTÉMOC,3,286,133,153,13
CHIAPAS,7,LA TRINITARIA,099,DOCTOR BELISARIO DOMÍNGUEZ,3,36,16,20,3
CHIAPAS,7,LA TRINITARIA,099,DOLORES CONCEPCIÓN,1,5,2,3,1
CHIAPAS,7,LA TRINITARIA,099,EL ALTO,2,237,115,122,9
CHIAPAS,7,LA TRINITARIA,099,EL BOQUERÓN,1,16,7,9,1
CHIAPAS,7,LA TRINITARIA,099,EL COCAL,2,31,16,15,2
CHIAPAS,7,LA TRINITARIA,099,EL PALMAR,2,45,25,20,3
CHIAPAS,7,LA TRINITARIA,099,EL PARAÍSO,1,70,37,33,4
CHIAPAS,7,LA TRINITARIA,099,EL PEDERNAL,1,5,4,1,1
CHIAPAS,7,LA TRINITARIA,099,EL PORVENIR (UNIÓN CAMPESINA),1,72,37,35,2
CHIAPAS,7,LA TRINITARIA,099,EL PORVENIR AGRARISTA,4,536,271,265,23
CHIAPAS,7,LA TRINITARIA,099,EL POTRERILLO,1,5,2,3,1
CHIAPAS,7,LA TRINITARIA,099,EL PROGRESO,3,312,150,162,12
CHIAPAS,7,LA TRINITARIA,099,EL RECUERDO,1,8,2,6,1
CHIAPAS,7,LA TRINITARIA,099,EL ROSARIO TIERRA BLANCA,3,158,74,84,7
CHIAPAS,7,LA TRINITARIA,099,EL SALVADOR,1,10,5,5,1
CHIAPAS,7,LA TRINITARIA,099,EL SALVADOR LA SIERRA,1,5,1,4,1
CHIAPAS,7,LA TRINITARIA,099,FLOR DE MAYO,3,416,202,214,23
CHIAPAS,7,LA TRINITARIA,099,FRANCISCO I. MADERO,4,342,155,187,13
CHIAPAS,7,LA TRINITARIA,099,FRANCISCO VILLA,4,163,82,81,10
CHIAPAS,7,LA TRINITARIA,099,GUADALUPE EL ZAPOTE,3,125,63,62,6
CHIAPAS,7,LA TRINITARIA,099,GUADALUPE PLUMAJILLO,2,27,14,13,2
CHIAPAS,7,LA TRINITARIA,099,JOSÉ CASTILLO TIÉLEMANS,3,112,52,60,7
CHIAPAS,7,LA TRINITARIA,099,JOSÉ MARÍA MORELOS,4,725,327,398,33
CHIAPAS,7,LA TRINITARIA,099,JUAN ALDAMA,2,57,31,26,3
CHIAPAS,7,LA TRINITARIA,099,JUAN SABINES GUTIÉRREZ,3,790,379,411,42
CHIAPAS,7,LA TRINITARIA,099,JUNCANÁ,2,54,19,35,3
CHIAPAS,7,LA TRINITARIA,099,LA CAMPANA,1,22,9,13,1
CHIAPAS,7,LA TRINITARIA,099,LA ESPERANZA,3,512,252,260,22
CHIAPAS,7,LA TRINITARIA,099,LA GLORIA,6,705,342,363,30
CHIAPAS,7,LA TRINITARIA,099,LA GLORIA SAN CARALAMPIO,2,12,5,7,2
CHIAPAS,7,LA TRINITARIA,099,LA TRINITARIA,22,3345,1626,1719,155
CHIAPAS,7,LA TRINITARIA,099,LA VICTORIA,2,58,27,31,2
CHIAPAS,7,LA TRINITARIA,099,LAS BOGAMBILIAS (EL OCOTAL),2,23,12,11,2
CHIAPAS,7,LA TRINITARIA,099,LAS CUMBRES,2,54,24,30,3
CHIAPAS,7,LA TRINITARIA,099,LAS DELICIAS,4,525,249,276,22
CHIAPAS,7,LA TRINITARIA,099,LÁZARO CÁRDENAS,4,1247,611,636,36
CHIAPAS,7,LA TRINITARIA,099,LIBERTAD 1RO. DE ENERO,2,37,16,21,2
CHIAPAS,7,LA TRINITARIA,099,LINDAVISTA,2,25,11,14,3
CHIAPAS,7,LA TRINITARIA,099,LOMA BONITA,1,17,5,12,1
CHIAPAS,7,LA TRINITARIA,099,LOS ENCUENTROS,1,10,4,6,1
CHIAPAS,7,LA TRINITARIA,099,LUCHA CAMPESINA II,2,37,15,22,2
CHIAPAS,7,LA TRINITARIA,099,MICHOACÁN,2,132,63,69,7
CHIAPAS,7,LA TRINITARIA,099,MIGUEL HIDALGO,3,539,269,270,23
CHIAPAS,7,LA TRINITARIA,099,MONTE VERDE,1,12,7,5,1
CHIAPAS,7,LA TRINITARIA,099,NUEVA ESPERANZA,2,64,39,25,3
CHIAPAS,7,LA TRINITARIA,099,NUEVA LIBERTAD,1,74,35,39,3
CHIAPAS,7,LA TRINITARIA,099,NUEVA LIBERTAD (EL COLORADO),3,369,165,204,17
CHIAPAS,7,LA TRINITARIA,099,NUEVA LOMA LINDA,2,39,13,26,3
CHIAPAS,7,LA TRINITARIA,099,NUEVA ROSITA,2,87,46,41,4
CHIAPAS,7,LA TRINITARIA,099,NUEVA VENECIA,3,115,59,56,6
CHIAPAS,7,LA TRINITARIA,099,NUEVO CHAPULTEPEC,2,49,21,28,3
CHIAPAS,7,LA TRINITARIA,099,NUEVO LLANO GRANDE,3,236,127,109,10
CHIAPAS,7,LA TRINITARIA,099,NUEVO PARAÍSO,1,36,14,22,1
CHIAPAS,7,LA TRINITARIA,099,NUEVO PORVENIR,3,84,40,44,4
CHIAPAS,7,LA TRINITARIA,099,NUEVO RECUERDO,2,39,18,21,2
CHIAPAS,7,LA TRINITARIA,099,NUEVO SALTILLO,2,119,57,62,6
CHIAPAS,7,LA TRINITARIA,099,NUEVO VILLAFLORES,1,54,19,35,3
CHIAPAS,7,LA TRINITARIA,099,NUEVO ZAPALUTA,2,25,12,13,3
CHIAPAS,7,LA TRINITARIA,099,OCOTAL OJO DE AGUA,2,18,9,9,2
CHIAPAS,7,LA TRINITARIA,099,ONTELA,1,16,8,8,1
CHIAPAS,7,LA TRINITARIA,099,PALO GORDO,1,11,6,5,1
CHIAPAS,7,LA TRINITARIA,099,PATROCINIO GONZÁLEZ GARRIDO,2,16,5,11,2
CHIAPAS,7,LA TRINITARIA,099,PERLA DEL GRIJALVA,3,129,70,59,8
CHIAPAS,7,LA TRINITARIA,099,PLAN DE AYALA,3,59,35,24,3
CHIAPAS,7,LA TRINITARIA,099,PLAN RÍO AZUL,1,22,5,17,1
CHIAPAS,7,LA TRINITARIA,099,PORVENIR CAMPO ALEGRE,1,8,4,4,1
CHIAPAS,7,LA TRINITARIA,099,RAFAEL CRUZ OCAÑA,2,56,24,32,3
CHIAPAS,7,LA TRINITARIA,099,RICARDO FLORES MAGÓN,1,13,3,10,1
CHIAPAS,7,LA TRINITARIA,099,RÍO DE JANEIRO,2,31,18,13,2
CHIAPAS,7,LA TRINITARIA,099,RODULFO FIGUEROA,3,534,277,257,23
CHIAPAS,7,LA TRINITARIA,099,RUBÉN JARAMILLO,2,32,10,22,2
CHIAPAS,7,LA TRINITARIA,099,SABINALITO,3,30,16,14,3
CHIAPAS,7,LA TRINITARIA,099,SAN ANTONIO LOS MONTES,1,7,3,4,1
CHIAPAS,7,LA TRINITARIA,099,SAN ANTONIO TZALANÍ,2,73,40,33,3
CHIAPAS,7,LA TRINITARIA,099,SAN ANTONIO ZANJA SECA,2,25,10,15,2
CHIAPAS,7,LA TRINITARIA,099,SAN CARALAMPIO,1,40,23,17,2
CHIAPAS,7,LA TRINITARIA,099,SAN CARALAMPIO MONTE PÁLIDO,1,126,47,79,6
CHIAPAS,7,LA TRINITARIA,099,SAN CARLOS JALAL,1,9,8,1,1
CHIAPAS,7,LA TRINITARIA,099,SAN DIEGO,4,177,83,94,12
CHIAPAS,7,LA TRINITARIA,099,SAN FRANCISCO DE ASÍS,3,264,145,119,11
CHIAPAS,7,LA TRINITARIA,099,SAN FRANCISCO LAGUNA SECA,2,10,3,7,2
CHIAPAS,7,LA TRINITARIA,099,SAN FRANCISCO OJO DE AGUA,1,45,22,23,2
CHIAPAS,7,LA TRINITARIA,099,SAN JACINTO EL PALMAR,1,49,26,23,3
CHIAPAS,7,LA TRINITARIA,099,SAN JOSÉ CANDELARIA,2,17,4,13,2
CHIAPAS,7,LA TRINITARIA,099,SAN JOSÉ GUADALUPE,2,57,27,30,3
CHIAPAS,7,LA TRINITARIA,099,SAN JOSÉ LINDA FLOR,1,14,6,8,1
CHIAPAS,7,LA TRINITARIA,099,SAN JUAN DEL VALLE,2,80,31,49,5
CHIAPAS,7,LA TRINITARIA,099,SAN LORENZO,2,70,33,37,3
CHIAPAS,7,LA TRINITARIA,099,SAN LUIS,2,176,85,91,6
CHIAPAS,7,LA TRINITARIA,099,SAN MARCOS,2,78,34,44,2
CHIAPAS,7,LA TRINITARIA,099,SAN NICOLÁS,2,120,55,65,5
CHIAPAS,7,LA TRINITARIA,099,SAN NICOLÁS BUENAVISTA,1,27,15,12,1
CHIAPAS,7,LA TRINITARIA,099,SAN NICOLÁS SACHANÁ,1,8,3,5,1
CHIAPAS,7,LA TRINITARIA,099,SAN PABLO,1,20,9,11,1
CHIAPAS,7,LA TRINITARIA,099,SAN PEDRO EL PORVENIR,2,19,8,11,2
CHIAPAS,7,LA TRINITARIA,099,SAN RAFAEL EL ARCO,1,5,2,3,1
CHIAPAS,7,LA TRINITARIA,099,SAN VICENTE,3,343,170,173,14
CHIAPAS,7,LA TRINITARIA,099,SANTA ANA,2,31,16,15,3
CHIAPAS,7,LA TRINITARIA,099,SANTA ANA EL ORIENTE,2,49,29,20,3
CHIAPAS,7,LA TRINITARIA,099,SANTA CECILIA EL ARENAL,1,40,26,14,2
CHIAPAS,7,LA TRINITARIA,099,SANTA ELENA EL LAGARTERO,1,8,4,4,1
CHIAPAS,7,LA TRINITARIA,099,SANTA MARTHA,2,42,20,22,3
CHIAPAS,7,LA TRINITARIA,099,SANTA RITA,3,274,137,137,12
CHIAPAS,7,LA TRINITARIA,099,SANTA ROSA,4,222,102,120,10
CHIAPAS,7,LA TRINITARIA,099,SANTA ROSA EL COBÁN,2,70,35,35,3
CHIAPAS,7,LA TRINITARIA,099,TIERRA BLANCA,2,52,28,24,3
CHIAPAS,7,LA TRINITARIA,099,TRECE DE SEPTIEMBRE,2,53,25,28,3
CHIAPAS,7,LA TRINITARIA,099,TRES ARBOLITOS,1,6,4,2,1
CHIAPAS,7,LA TRINITARIA,099,TZICUMALTIC,2,23,9,14,3
CHIAPAS,7,LA TRINITARIA,099,TZINTUL,2,14,7,7,2
CHIAPAS,7,LA TRINITARIA,099,TZISCAO,4,626,295,331,25
CHIAPAS,7,LA TRINITARIA,099,UNIÓN JUÁREZ,4,354,177,177,15
CHIAPAS,7,LA TRINITARIA,099,UNIÓN LAGARTERO,2,43,19,24,3
CHIAPAS,7,LA TRINITARIA,099,VALLE ALEGRE,1,17,9,8,2
CHIAPAS,7,LA TRINITARIA,099,VICENTE GUERRERO,3,178,84,94,10
CHIAPAS,7,TUMBALÁ,100,ÁLVARO OBREGÓN (PLANADA),3,160,79,81,6
CHIAPAS,7,TUMBALÁ,100,ARROYO ABÁN,2,30,19,11,3
CHIAPAS,7,TUMBALÁ,100,ARROYO LIBERTAD,2,14,8,6,2
CHIAPAS,7,TUMBALÁ,100,BENITO JUÁREZ,4,353,159,194,14
CHIAPAS,7,TUMBALÁ,100,BUENAVISTA,2,26,13,13,3
CHIAPAS,7,TUMBALÁ,100,CACAHUATAL,4,344,175,169,13
CHIAPAS,7,TUMBALÁ,100,CAMPAMENTO,1,8,1,7,1
CHIAPAS,7,TUMBALÁ,100,CHUCHUCRUZ 2DA. SECCIÓN,2,217,102,115,6
CHIAPAS,7,TUMBALÁ,100,CHUCHUCRUZ PRIMERA SECCIÓN,3,366,172,194,13
CHIAPAS,7,TUMBALÁ,100,CHUCULUMTIEL,2,107,56,51,5
CHIAPAS,7,TUMBALÁ,100,CHULAJCOB,3,29,12,17,3
CHIAPAS,7,TUMBALÁ,100,COLOLIL,2,126,72,54,5
CHIAPAS,7,TUMBALÁ,100,COLONIA AGUA AZUL,3,449,217,232,33
CHIAPAS,7,TUMBALÁ,100,COYOJIL,2,104,54,50,4
CHIAPAS,7,TUMBALÁ,100,CUCTIEPA,4,354,187,167,15
CHIAPAS,7,TUMBALÁ,100,EL CIELO,1,37,15,22,2
CHIAPAS,7,TUMBALÁ,100,EL LIMÓN,2,11,6,5,2
CHIAPAS,7,TUMBALÁ,100,EL MIRADOR,1,7,5,2,1
CHIAPAS,7,TUMBALÁ,100,EL OCOTAL,1,87,37,50,4
CHIAPAS,7,TUMBALÁ,100,EL PARAÍSO,1,9,5,4,1
CHIAPAS,7,TUMBALÁ,100,EL PORVENIR,2,43,18,25,2
CHIAPAS,7,TUMBALÁ,100,EL PRADO,3,54,27,27,3
CHIAPAS,7,TUMBALÁ,100,EL REFUGIO,1,10,5,5,1
CHIAPAS,7,TUMBALÁ,100,EMBARCADERO JOYETÁ,1,7,3,4,1
CHIAPAS,7,TUMBALÁ,100,EMILIANO ZAPATA,4,616,305,311,22
CHIAPAS,7,TUMBALÁ,100,ESPERANZA JOYETA,1,42,25,17,1
CHIAPAS,7,TUMBALÁ,100,ESTRELLA DE BELÉN,2,13,5,8,1
CHIAPAS,7,TUMBALÁ,100,FLOR DE ALIANZA,2,49,32,17,3
CHIAPAS,7,TUMBALÁ,100,FLOR DE CAFÉ,2,111,64,47,4
CHIAPAS,7,TUMBALÁ,100,FRANCISCO VILLA,2,29,7,22,3
CHIAPAS,7,TUMBALÁ,100,HIDALGO JOSHIL,4,822,425,397,28
CHIAPAS,7,TUMBALÁ,100,HUESHIB,2,14,6,8,2
CHIAPAS,7,TUMBALÁ,100,IGNACIO ALLENDE,4,374,198,176,15
CHIAPAS,7,TUMBALÁ,100,JOLJAMIL,4,187,98,89,7
CHIAPAS,7,TUMBALÁ,100,JOLJAMIL 2DA. SECCIÓN,2,30,8,22,2
CHIAPAS,7,TUMBALÁ,100,JOLONIEL,3,332,171,161,11
CHIAPAS,7,TUMBALÁ,100,JOSÉ MARÍA MORELOS Y PAVÓN,3,152,72,80,7
CHIAPAS,7,TUMBALÁ,100,JOSHIL,5,1156,567,589,38
CHIAPAS,7,TUMBALÁ,100,JOYETA,2,20,7,13,2
CHIAPAS,7,TUMBALÁ,100,LA ESPERANZA DEL PORVENIR,3,200,92,108,8
CHIAPAS,7,TUMBALÁ,100,LA ESPERANZA MÓRRIZON,4,205,112,93,10
CHIAPAS,7,TUMBALÁ,100,LA REVOLUCIÓN,1,6,3,3,1
CHIAPAS,7,TUMBALÁ,100,LA VENTANA,2,29,20,9,3
CHIAPAS,7,TUMBALÁ,100,LA VENTANA 2DA. SECCIÓN,1,6,3,3,1
CHIAPAS,7,TUMBALÁ,100,LÁZARO CÁRDENAS,3,54,25,29,5
CHIAPAS,7,TUMBALÁ,100,MARISCAL LOS JIMÉNEZ,2,45,21,24,2
CHIAPAS,7,TUMBALÁ,100,MARISCAL SUBIKUSKI,4,499,259,240,18
CHIAPAS,7,TUMBALÁ,100,MARISCAL YEHUITZ,2,124,52,72,4
CHIAPAS,7,TUMBALÁ,100,NARANJIL,2,204,105,99,7
CHIAPAS,7,TUMBALÁ,100,NICHINJÁ,2,85,45,40,4
CHIAPAS,7,TUMBALÁ,100,NUEVO CHUCHUCRUZ (KAJKAM),2,25,13,12,3
CHIAPAS,7,TUMBALÁ,100,NUEVO MARISCAL SUBIKUSKI,2,16,7,9,2
CHIAPAS,7,TUMBALÁ,100,OBREGÓN LA LOMA,1,9,4,5,1
CHIAPAS,7,TUMBALÁ,100,PACTIÚN,3,233,128,105,10
CHIAPAS,7,TUMBALÁ,100,PANCHÉN DOS,1,5,1,4,1
CHIAPAS,7,TUMBALÁ,100,PATELNÁ,3,254,127,127,9
CHIAPAS,7,TUMBALÁ,100,PROGRESO AGUA AZUL,2,91,46,45,5
CHIAPAS,7,TUMBALÁ,100,SOMBRA GRANDE,2,110,59,51,3
CHIAPAS,7,TUMBALÁ,100,TEHUACAN,2,97,47,50,4
CHIAPAS,7,TUMBALÁ,100,TIENTIUL CHICO,2,228,122,106,7
CHIAPAS,7,TUMBALÁ,100,TIOBUJÚN,2,29,14,15,2
CHIAPAS,7,TUMBALÁ,100,TUMBALÁ,15,2016,990,1026,91
CHIAPAS,7,TUMBALÁ,100,VENUSTIANO CARRANZA,3,203,89,114,9
CHIAPAS,7,TUMBALÁ,100,YEVALCHÉN,2,119,59,60,5
CHIAPAS,7,TUXTLA GUTIÉRREZ,101,COPOYA,7,3154,1563,1591,98
CHIAPAS,7,TUXTLA GUTIÉRREZ,101,DEMOCRACIA,1,396,195,201,12
CHIAPAS,7,TUXTLA GUTIÉRREZ,101,EL CARRIZAL,2,25,13,12,3
CHIAPAS,7,TUXTLA GUTIÉRREZ,101,EL JOBO,4,1295,642,653,68
CHIAPAS,7,TUXTLA GUTIÉRREZ,101,EMILIANO ZAPATA (AGUA FRÍA),3,386,182,204,14
CHIAPAS,7,TUXTLA GUTIÉRREZ,101,LA PIMIENTA,2,765,378,387,24
CHIAPAS,7,TUXTLA GUTIÉRREZ,101,LAS GRANJAS,5,2044,1013,1031,71
CHIAPAS,7,TUXTLA GUTIÉRREZ,101,LINDAVISTA,1,296,131,165,12
CHIAPAS,7,TUXTLA GUTIÉRREZ,101,PIEDRA SANTA,2,27,18,9,3
CHIAPAS,7,TUXTLA GUTIÉRREZ,101,SACRAMENTO DE JESÚS,1,18,7,11,1
CHIAPAS,7,TUXTLA GUTIÉRREZ,101,SAN JOSÉ,2,115,61,54,7
CHIAPAS,7,TUXTLA GUTIÉRREZ,101,TIERRA COLORADA,3,172,86,86,9
CHIAPAS,7,TUXTLA GUTIÉRREZ,101,TUXTLA GUTIÉRREZ,803,196211,100117,96094,12980
CHIAPAS,7,TUXTLA GUTIÉRREZ,101,YÚQUIZ,1,75,34,41,3
CHIAPAS,7,TUXTLA CHICO,102,1RA. SECCIÓN DE GUILLÉN CENTRO,1,40,22,18,2
CHIAPAS,7,TUXTLA CHICO,102,1RA. SECCIÓN DE GUILLÉN ORIENTE,1,63,39,24,3
CHIAPAS,7,TUXTLA CHICO,102,1RA. SECCIÓN DE IZAPA,2,172,73,99,8
CHIAPAS,7,TUXTLA CHICO,102,1RA. SECCIÓN DE MEDIO MONTE,6,811,422,389,36
CHIAPAS,7,TUXTLA CHICO,102,2DA. SECCIÓN DE CAHOA (BUENAVISTA),2,49,26,23,3
CHIAPAS,7,TUXTLA CHICO,102,2DA. SECCIÓN DE GUILLÉN,6,511,238,273,22
CHIAPAS,7,TUXTLA CHICO,102,2DA. SECCIÓN DE IZAPA,4,523,256,267,30
CHIAPAS,7,TUXTLA CHICO,102,2DA. SECCIÓN DE MEDIO MONTE,9,997,490,507,39
CHIAPAS,7,TUXTLA CHICO,102,EL AGUINAL,2,72,32,40,4
CHIAPAS,7,TUXTLA CHICO,102,EL ENCANTO,2,29,11,18,2
CHIAPAS,7,TUXTLA CHICO,102,EL SACRIFICIO,3,601,290,311,23
CHIAPAS,7,TUXTLA CHICO,102,EL SUR DE GUILLÉN,3,347,175,172,21
CHIAPAS,7,TUXTLA CHICO,102,FRACCIÓN LA JERINGA,2,57,31,26,3
CHIAPAS,7,TUXTLA CHICO,102,FRANCISCO VILLA,2,126,62,64,6
CHIAPAS,7,TUXTLA CHICO,102,GUADALUPE VICTORIA,4,428,189,239,40
CHIAPAS,7,TUXTLA CHICO,102,MANUEL LAZOS,4,707,337,370,27
CHIAPAS,7,TUXTLA CHICO,102,MIGUEL HIDALGO,4,224,102,122,10
CHIAPAS,7,TUXTLA CHICO,102,OMOHA,4,174,76,98,9
CHIAPAS,7,TUXTLA CHICO,102,SAN JOAQUÍN (CAMPO FLORIDO),1,15,8,7,1
CHIAPAS,7,TUXTLA CHICO,102,SECCIÓN LA GRANJA,2,136,66,70,6
CHIAPAS,7,TUXTLA CHICO,102,SECCIÓN LA TOMA,2,58,28,30,2
CHIAPAS,7,TUXTLA CHICO,102,SECCIÓN MARGARITAS (SANTA ROSA),2,77,39,38,3
CHIAPAS,7,TUXTLA CHICO,102,SECCIÓN TOMA LA GALERA,3,101,44,57,5
CHIAPAS,7,TUXTLA CHICO,102,SILVANO GATICA,3,292,149,143,13
CHIAPAS,7,TUXTLA CHICO,102,TALISMÁN,4,564,290,274,23
CHIAPAS,7,TUXTLA CHICO,102,TUXTLA CHICO,24,5425,2859,2566,296
CHIAPAS,7,TUXTLA CHICO,102,VICENTE GUERRERO,4,451,231,220,26
CHIAPAS,7,TUZANTÁN,103,BENITO JUÁREZ,2,42,21,21,2
CHIAPAS,7,TUZANTÁN,103,CANTÓN EL HULAR,2,56,22,34,3
CHIAPAS,7,TUZANTÁN,103,CANTÓN EL VADO,1,13,4,9,1
CHIAPAS,7,TUZANTÁN,103,CANTÓN RÍO NEGRO,1,48,24,24,2
CHIAPAS,7,TUZANTÁN,103,CANTÓN VEGA DE TEPUZAPA,2,50,25,25,3
CHIAPAS,7,TUZANTÁN,103,CHAPINGO,2,71,35,36,4
CHIAPAS,7,TUZANTÁN,103,CUARTO CANTÓN,2,119,54,65,7
CHIAPAS,7,TUZANTÁN,103,EL CHIPILÍN,1,24,13,11,1
CHIAPAS,7,TUZANTÁN,103,EL MANGO BUENAVISTA,1,17,9,8,1
CHIAPAS,7,TUZANTÁN,103,EL PORTILLO,1,15,7,8,1
CHIAPAS,7,TUZANTÁN,103,EL RETIRO,4,185,93,92,10
CHIAPAS,7,TUZANTÁN,103,EL TARRAL,3,209,96,113,10
CHIAPAS,7,TUZANTÁN,103,ESTACIÓN TUZANTÁN,4,574,288,286,25
CHIAPAS,7,TUZANTÁN,103,FRANCISCO SARABIA 1RA. SECCIÓN,2,84,37,47,4
CHIAPAS,7,TUZANTÁN,103,FRANCISCO SARABIA 2DA. SECCIÓN,2,40,16,24,2
CHIAPAS,7,TUZANTÁN,103,GERMANIA,2,19,12,7,2
CHIAPAS,7,TUZANTÁN,103,GUADALUPE VICTORIA,3,268,122,146,11
CHIAPAS,7,TUZANTÁN,103,GUARDIANIA,2,87,37,50,4
CHIAPAS,7,TUZANTÁN,103,ISLAMAPA,3,252,121,131,12
CHIAPAS,7,TUZANTÁN,103,ISLAMAPA XOCHILTEPEC,2,95,49,46,5
CHIAPAS,7,TUZANTÁN,103,ISLAMAPITA (LOS CERRITOS),3,169,72,97,8
CHIAPAS,7,TUZANTÁN,103,LA CRUZ DE ORO,2,40,20,20,3
CHIAPAS,7,TUZANTÁN,103,LA FLOR,1,63,26,37,3
CHIAPAS,7,TUZANTÁN,103,LOS LAURELES,2,50,25,25,4
CHIAPAS,7,TUZANTÁN,103,MANACAL,4,188,95,93,10
CHIAPAS,7,TUZANTÁN,103,NUEVA SONORA,3,97,46,51,7
CHIAPAS,7,TUZANTÁN,103,NUEVA TENOCHTITLÁN,4,435,208,227,27
CHIAPAS,7,TUZANTÁN,103,PRIMER CANTÓN,2,186,92,94,7
CHIAPAS,7,TUZANTÁN,103,PUENTE DE MATERIAL,2,40,21,19,3
CHIAPAS,7,TUZANTÁN,103,SAN CRISTÓBAL,3,122,58,64,7
CHIAPAS,7,TUZANTÁN,103,SAN LUIS,2,171,72,99,8
CHIAPAS,7,TUZANTÁN,103,SANTA FE,2,23,9,14,2
CHIAPAS,7,TUZANTÁN,103,SANTA SOFÍA,3,109,47,62,7
CHIAPAS,7,TUZANTÁN,103,SEGUNDO CANTÓN,3,185,89,96,10
CHIAPAS,7,TUZANTÁN,103,TERCER CANTÓN,2,115,56,59,5
CHIAPAS,7,TUZANTÁN,103,TUZANTÁN,9,1287,663,624,67
CHIAPAS,7,TUZANTÁN,103,VEINTINUEVE DE DICIEMBRE,4,1003,590,413,129
CHIAPAS,7,TUZANTÁN,103,VILLA HIDALGO,6,540,272,268,25
CHIAPAS,7,TUZANTÁN,103,XOCHILTEPEC,5,1561,801,760,72
CHIAPAS,7,TZIMOL,104,DOCTOR MANUEL VELASCO SUÁREZ,4,184,91,93,9
CHIAPAS,7,TZIMOL,104,FELIPE ÁNGELES,3,114,56,58,7
CHIAPAS,7,TZIMOL,104,FRANCISCO VILLA,3,293,149,144,19
CHIAPAS,7,TZIMOL,104,GUADALUPE,1,21,15,6,1
CHIAPAS,7,TZIMOL,104,GUADALUPE VICTORIA,1,20,9,11,1
CHIAPAS,7,TZIMOL,104,HÉROES DE CHAPULTEPEC (EL LIMÓN),4,351,171,180,17
CHIAPAS,7,TZIMOL,104,LAGUNA ESQUEL,1,5,4,1,1
CHIAPAS,7,TZIMOL,104,LAS GRANJAS,1,6,6,0,1
CHIAPAS,7,TZIMOL,104,LENINGRADO,2,42,22,20,2
CHIAPAS,7,TZIMOL,104,LINDA FLOR,2,40,13,27,3
CHIAPAS,7,TZIMOL,104,MAMANTIC,1,10,5,5,1
CHIAPAS,7,TZIMOL,104,NUEVA LIBERTAD,2,121,61,60,5
CHIAPAS,7,TZIMOL,104,OCHUSJOB,3,242,112,130,11
CHIAPAS,7,TZIMOL,104,PASO HONDO (GRACIAS A DIOS),2,81,34,47,4
CHIAPAS,7,TZIMOL,104,REFORMA AGRARIA DOS,2,32,13,19,2
CHIAPAS,7,TZIMOL,104,REFORMA AGRARIA UNO,2,58,30,28,3
CHIAPAS,7,TZIMOL,104,SAN CRISTOBALITO,2,24,7,17,3
CHIAPAS,7,TZIMOL,104,SAN VICENTE LA MESILLA,4,719,353,366,26
CHIAPAS,7,TZIMOL,104,SANTA CECILIA LA REJOYA,1,134,62,72,5
CHIAPAS,7,TZIMOL,104,SANTA CECILIA UNO,1,45,22,23,2
CHIAPAS,7,TZIMOL,104,SANTIAGO LA MESILLA,2,58,31,27,4
CHIAPAS,7,TZIMOL,104,TZIMOL,9,1482,709,773,57
CHIAPAS,7,TZIMOL,104,VERAPAZ,1,8,4,4,1
CHIAPAS,7,UNIÓN JUÁREZ,105,CERRO DEL CARMEN (PICO DE LORO),1,5,1,4,1
CHIAPAS,7,UNIÓN JUÁREZ,105,CHIQUIHUITE,2,92,44,48,4
CHIAPAS,7,UNIÓN JUÁREZ,105,CÓRDOVA MATASANOS,3,250,118,132,10
CHIAPAS,7,UNIÓN JUÁREZ,105,EL DESENGAÑO,2,81,36,45,4
CHIAPAS,7,UNIÓN JUÁREZ,105,EL DESENLACE,2,56,28,28,3
CHIAPAS,7,UNIÓN JUÁREZ,105,EUREKA,3,150,71,79,7
CHIAPAS,7,UNIÓN JUÁREZ,105,FRACCIÓN BARRIO NUEVO,2,33,15,18,2
CHIAPAS,7,UNIÓN JUÁREZ,105,LA PROVIDENCIA,2,60,40,20,3
CHIAPAS,7,UNIÓN JUÁREZ,105,LOS ALPES,2,47,21,26,3
CHIAPAS,7,UNIÓN JUÁREZ,105,MUXBAL,2,102,48,54,4
CHIAPAS,7,UNIÓN JUÁREZ,105,ONCE DE ABRIL,4,796,411,385,52
CHIAPAS,7,UNIÓN JUÁREZ,105,SAN ISIDRO,1,22,9,13,1
CHIAPAS,7,UNIÓN JUÁREZ,105,SAN JERÓNIMO,2,204,98,106,7
CHIAPAS,7,UNIÓN JUÁREZ,105,SAN JOSÉ,2,86,50,36,4
CHIAPAS,7,UNIÓN JUÁREZ,105,SAN RAFAEL,2,78,36,42,4
CHIAPAS,7,UNIÓN JUÁREZ,105,SANTA TERESA,2,24,12,12,2
CHIAPAS,7,UNIÓN JUÁREZ,105,SANTO DOMINGO,6,1221,602,619,51
CHIAPAS,7,UNIÓN JUÁREZ,105,SONORA,2,28,13,15,3
CHIAPAS,7,UNIÓN JUÁREZ,105,TALQUIÁN,2,115,55,60,5
CHIAPAS,7,UNIÓN JUÁREZ,105,TALQUIÁN VIEJO,2,22,12,10,3
CHIAPAS,7,UNIÓN JUÁREZ,105,TRINIDAD,2,99,49,50,5
CHIAPAS,7,UNIÓN JUÁREZ,105,UNIÓN JUÁREZ,8,987,480,507,48
CHIAPAS,7,VENUSTIANO CARRANZA,106,20 DE JUNIO,3,79,34,45,4
CHIAPAS,7,VENUSTIANO CARRANZA,106,28 DE JUNIO,2,12,9,3,2
CHIAPAS,7,VENUSTIANO CARRANZA,106,AGUA BENDITA II,2,96,30,66,3
CHIAPAS,7,VENUSTIANO CARRANZA,106,AGUACATENANGO,12,1493,730,763,56
CHIAPAS,7,VENUSTIANO CARRANZA,106,BELISARIO DOMÍNGUEZ,3,174,95,79,9
CHIAPAS,7,VENUSTIANO CARRANZA,106,CANDELARIA EL ALTO LA PASTORÍA,2,132,58,74,6
CHIAPAS,7,VENUSTIANO CARRANZA,106,CONCEPCIÓN,1,5,3,2,1
CHIAPAS,7,VENUSTIANO CARRANZA,106,CORAZÓN DE MARÍA,1,12,3,9,1
CHIAPAS,7,VENUSTIANO CARRANZA,106,CRUZTÓN,2,66,39,27,3
CHIAPAS,7,VENUSTIANO CARRANZA,106,DIECISIETE DE MARZO,2,94,56,38,4
CHIAPAS,7,VENUSTIANO CARRANZA,106,EL CARMELITO,2,93,44,49,4
CHIAPAS,7,VENUSTIANO CARRANZA,106,EL DESENGAÑO,2,22,13,9,2
CHIAPAS,7,VENUSTIANO CARRANZA,106,EL PUERTO,4,534,284,250,23
CHIAPAS,7,VENUSTIANO CARRANZA,106,EL SUMIDERO,2,30,13,17,2
CHIAPAS,7,VENUSTIANO CARRANZA,106,EMILIANO ZAPATA,1,23,10,13,1
CHIAPAS,7,VENUSTIANO CARRANZA,106,FRANCISCO HERNÁNDEZ HERNÁNDEZ,2,83,41,42,4
CHIAPAS,7,VENUSTIANO CARRANZA,106,FRANCISCO VILLA,2,51,33,18,3
CHIAPAS,7,VENUSTIANO CARRANZA,106,GRANDEZA DEL RÍO BLANCO,3,231,111,120,11
CHIAPAS,7,VENUSTIANO CARRANZA,106,GUADALUPE VICTORIA,3,391,195,196,19
CHIAPAS,7,VENUSTIANO CARRANZA,106,GUADALUPE YERBASANTA,2,68,32,36,3
CHIAPAS,7,VENUSTIANO CARRANZA,106,LA GLORIA (LA TRANCA),2,70,32,38,3
CHIAPAS,7,VENUSTIANO CARRANZA,106,LA NUEVA LIBERTAD,2,23,8,15,2
CHIAPAS,7,VENUSTIANO CARRANZA,106,LA PIEDRONA,2,7,2,5,1
CHIAPAS,7,VENUSTIANO CARRANZA,106,LA UNIÓN EL PORVENIR,1,15,10,5,1
CHIAPAS,7,VENUSTIANO CARRANZA,106,LAGUNA VERDE,2,49,26,23,3
CHIAPAS,7,VENUSTIANO CARRANZA,106,LAS DELICIAS,1,5,1,4,1
CHIAPAS,7,VENUSTIANO CARRANZA,106,LÓPEZ HERNÁNDEZ,2,152,80,72,6
CHIAPAS,7,VENUSTIANO CARRANZA,106,LOS CERRITOS (RAÍCES),2,91,42,49,4
CHIAPAS,7,VENUSTIANO CARRANZA,106,LOS LLANITOS,1,38,20,18,2
CHIAPAS,7,VENUSTIANO CARRANZA,106,LOS PINOS,2,25,11,14,2
CHIAPAS,7,VENUSTIANO CARRANZA,106,MARCOS E. BECERRA,4,170,89,81,8
CHIAPAS,7,VENUSTIANO CARRANZA,106,MARIANO MATAMOROS,3,341,154,187,14
CHIAPAS,7,VENUSTIANO CARRANZA,106,MIGUEL HIDALGO,5,938,589,349,51
CHIAPAS,7,VENUSTIANO CARRANZA,106,MONTE DE LOS OLIVOS,1,41,26,15,2
CHIAPAS,7,VENUSTIANO CARRANZA,106,MONTECRISTO,2,53,32,21,3
CHIAPAS,7,VENUSTIANO CARRANZA,106,NUEVE DE ABRIL,3,34,13,21,4
CHIAPAS,7,VENUSTIANO CARRANZA,106,NUEVO ANTONIO,1,9,5,4,1
CHIAPAS,7,VENUSTIANO CARRANZA,106,NUEVO PARAÍSO,3,36,18,18,4
CHIAPAS,7,VENUSTIANO CARRANZA,106,NUEVO SOYATITÁN,2,73,37,36,3
CHIAPAS,7,VENUSTIANO CARRANZA,106,OJOS AZULES,2,14,6,8,2
CHIAPAS,7,VENUSTIANO CARRANZA,106,PARAÍSO DEL GRIJALVA,6,733,345,388,31
CHIAPAS,7,VENUSTIANO CARRANZA,106,PISHOLTON,1,51,25,26,2
CHIAPAS,7,VENUSTIANO CARRANZA,106,PLAN DE LOS ÁNGELES,2,28,15,13,2
CHIAPAS,7,VENUSTIANO CARRANZA,106,POBLADO SAN BARTOLOMÉ DE LOS LLANOS,1,20,9,11,1
CHIAPAS,7,VENUSTIANO CARRANZA,106,PRESIDENTE ECHEVERRÍA (LAJA TENDIDA),5,687,348,339,34
CHIAPAS,7,VENUSTIANO CARRANZA,106,RANCHO ALEGRE,1,7,4,3,1
CHIAPAS,7,VENUSTIANO CARRANZA,106,RICARDO FLORES MAGÓN,6,1333,660,673,96
CHIAPAS,7,VENUSTIANO CARRANZA,106,RÍO JORDÁN,2,144,68,76,6
CHIAPAS,7,VENUSTIANO CARRANZA,106,RUBÉN JARAMILLO TRES PICOS,2,23,12,11,3
CHIAPAS,7,VENUSTIANO CARRANZA,106,SAGRADO CORAZÓN,3,25,16,9,3
CHIAPAS,7,VENUSTIANO CARRANZA,106,SAN ANTONIO EL LIMÓN DOS,1,39,26,13,2
CHIAPAS,7,VENUSTIANO CARRANZA,106,SAN ANTONIO EL LIMÓN UNO,2,16,6,10,2
CHIAPAS,7,VENUSTIANO CARRANZA,106,SAN FRANCISCO (EL CALVITO),4,368,175,193,16
CHIAPAS,7,VENUSTIANO CARRANZA,106,SAN FRANCISCO PUJILTIC,9,1708,832,876,90
CHIAPAS,7,VENUSTIANO CARRANZA,106,SAN ISIDRO LA SOCIEDAD,2,51,27,24,3
CHIAPAS,7,VENUSTIANO CARRANZA,106,SAN ISIDRO LOS LAURELES,2,20,8,12,2
CHIAPAS,7,VENUSTIANO CARRANZA,106,SAN LÁZARO,2,116,58,58,4
CHIAPAS,7,VENUSTIANO CARRANZA,106,SAN LUIS,3,134,59,75,7
CHIAPAS,7,VENUSTIANO CARRANZA,106,SAN PEDRO BUENAVISTA,2,31,19,12,2
CHIAPAS,7,VENUSTIANO CARRANZA,106,SAN PEDRO EL PUY,2,49,23,26,3
CHIAPAS,7,VENUSTIANO CARRANZA,106,SANTA ANITA,2,30,16,14,2
CHIAPAS,7,VENUSTIANO CARRANZA,106,SANTA MARÍA,2,198,96,102,9
CHIAPAS,7,VENUSTIANO CARRANZA,106,SANTA ROSA,1,22,12,10,1
CHIAPAS,7,VENUSTIANO CARRANZA,106,SANTA RUFINA,2,11,6,5,2
CHIAPAS,7,VENUSTIANO CARRANZA,106,SCHPOINÁ SANTA ROSA,2,68,38,30,3
CHIAPAS,7,VENUSTIANO CARRANZA,106,SEÑOR DEL POZO,1,40,21,19,2
CHIAPAS,7,VENUSTIANO CARRANZA,106,SOYATITÁN,7,1252,640,612,73
CHIAPAS,7,VENUSTIANO CARRANZA,106,TREINTA Y UNO DE DICIEMBRE,3,64,34,30,4
CHIAPAS,7,VENUSTIANO CARRANZA,106,TRINIDAD OQUIL,3,145,68,77,6
CHIAPAS,7,VENUSTIANO CARRANZA,106,UNIÓN EL REFUGIO,1,18,6,12,2
CHIAPAS,7,VENUSTIANO CARRANZA,106,VEINTE DE NOVIEMBRE,2,30,15,15,3
CHIAPAS,7,VENUSTIANO CARRANZA,106,VENUSTIANO CARRANZA,26,5224,2647,2577,266
CHIAPAS,7,VENUSTIANO CARRANZA,106,VICENTE GUERRERO,4,429,205,224,21
CHIAPAS,7,VILLA CORZO,107,1RO. DE MAYO,7,524,268,256,29
CHIAPAS,7,VILLA CORZO,107,20 DE NOVIEMBRE,3,52,19,33,5
CHIAPAS,7,VILLA CORZO,107,3 HEMANOS,1,9,6,3,1
CHIAPAS,7,VILLA CORZO,107,AGUA DULCE,2,16,8,8,2
CHIAPAS,7,VILLA CORZO,107,ARGENTINA,2,10,4,6,2
CHIAPAS,7,VILLA CORZO,107,BIRMANIA,1,17,9,8,2
CHIAPAS,7,VILLA CORZO,107,BOLATETE UNO,2,8,2,6,2
CHIAPAS,7,VILLA CORZO,107,BUENAVISTA,1,10,2,8,1
CHIAPAS,7,VILLA CORZO,107,CALZADA EL PROVINCIANO,3,76,32,44,4
CHIAPAS,7,VILLA CORZO,107,CRISTO REY,1,7,2,5,1
CHIAPAS,7,VILLA CORZO,107,CUATRO MILPAS,2,11,4,7,2
CHIAPAS,7,VILLA CORZO,107,DESVÍO MANUEL ÁVILA CAMACHO,1,41,25,16,3
CHIAPAS,7,VILLA CORZO,107,DOCTOR BELISARIO DOMÍNGUEZ (EL CHICHONAL),3,81,46,35,5
CHIAPAS,7,VILLA CORZO,107,EL CAMPAMENTO,1,8,1,7,1
CHIAPAS,7,VILLA CORZO,107,EL CARMEN,2,16,7,9,2
CHIAPAS,7,VILLA CORZO,107,EL CIELITO,1,70,31,39,3
CHIAPAS,7,VILLA CORZO,107,EL CIELITO (BUENAVISTA),2,11,5,6,2
CHIAPAS,7,VILLA CORZO,107,EL CIMARRÓN (LAS LIMAS),1,51,22,29,2
CHIAPAS,7,VILLA CORZO,107,EL CORRALITO,2,6,3,3,1
CHIAPAS,7,VILLA CORZO,107,EL DESENGAÑO,3,36,19,17,4
CHIAPAS,7,VILLA CORZO,107,EL EDÉN,2,10,7,3,1
CHIAPAS,7,VILLA CORZO,107,EL GRANADILLAL,2,10,7,3,1
CHIAPAS,7,VILLA CORZO,107,EL LAUREL,3,8,6,2,2
CHIAPAS,7,VILLA CORZO,107,EL NUEVO REFUGIO,1,18,9,9,1
CHIAPAS,7,VILLA CORZO,107,EL PARAÍSO,1,10,6,4,1
CHIAPAS,7,VILLA CORZO,107,EL PLACER,1,21,7,14,2
CHIAPAS,7,VILLA CORZO,107,EL PROGRESO,3,69,38,31,5
CHIAPAS,7,VILLA CORZO,107,EL RESCATE,2,7,2,5,1
CHIAPAS,7,VILLA CORZO,107,EL RETIRO,2,85,42,43,4
CHIAPAS,7,VILLA CORZO,107,EL RIEGUITO,3,20,10,10,3
CHIAPAS,7,VILLA CORZO,107,EL ROSARIO,1,10,4,6,1
CHIAPAS,7,VILLA CORZO,107,EL RUBÍ,1,8,3,5,1
CHIAPAS,7,VILLA CORZO,107,EL SUSPIRO,3,12,2,10,2
CHIAPAS,7,VILLA CORZO,107,EL TESORO,1,15,5,10,1
CHIAPAS,7,VILLA CORZO,107,EMBARCADERO DE JERICÓ (EL SIGLO),4,329,185,144,15
CHIAPAS,7,VILLA CORZO,107,EMILIANO ZAPATA,3,354,168,186,16
CHIAPAS,7,VILLA CORZO,107,FRACCIÓN MARAVILLA,3,29,17,12,3
CHIAPAS,7,VILLA CORZO,107,FRACCIÓN TIERRA BLANCA,2,15,6,9,2
CHIAPAS,7,VILLA CORZO,107,FRANCISCO I. MADERO,3,169,76,93,6
CHIAPAS,7,VILLA CORZO,107,FRANCISCO MURGUÍA,1,16,11,5,1
CHIAPAS,7,VILLA CORZO,107,GUADALUPE,3,36,18,18,4
CHIAPAS,7,VILLA CORZO,107,HOJA BLANCA,2,43,18,25,4
CHIAPAS,7,VILLA CORZO,107,IGNACIO ZARAGOZA,4,162,84,78,10
CHIAPAS,7,VILLA CORZO,107,JOAQUÍN MIGUEL GUTIÉRREZ,2,24,13,11,3
CHIAPAS,7,VILLA CORZO,107,JUAN SABINES GUTIÉRREZ,3,29,13,16,4
CHIAPAS,7,VILLA CORZO,107,LA ATLÁNTIDA,1,7,3,4,1
CHIAPAS,7,VILLA CORZO,107,LA BRAGADA,2,8,5,3,2
CHIAPAS,7,VILLA CORZO,107,LA CEIBA,3,74,34,40,5
CHIAPAS,7,VILLA CORZO,107,LA ESMERALDA,3,28,14,14,4
CHIAPAS,7,VILLA CORZO,107,LA FRAYLESCA,4,193,99,94,10
CHIAPAS,7,VILLA CORZO,107,LA HERENCIA,1,7,4,3,1
CHIAPAS,7,VILLA CORZO,107,LA LIBERTAD,4,101,50,51,8
CHIAPAS,7,VILLA CORZO,107,LA LUCHA,1,5,2,3,1
CHIAPAS,7,VILLA CORZO,107,LA NUEVA,1,6,4,2,1
CHIAPAS,7,VILLA CORZO,107,LA NUEVA ESPERANZA,1,40,19,21,2
CHIAPAS,7,VILLA CORZO,107,LA NUEVA REFORMA AGRARIA,2,26,13,13,2
CHIAPAS,7,VILLA CORZO,107,LA NUEVA TEHUACÁN,2,17,7,10,2
CHIAPAS,7,VILLA CORZO,107,LA NUEVA UNIÓN,2,21,8,13,2
CHIAPAS,7,VILLA CORZO,107,LA RAMONA,3,82,40,42,4
CHIAPAS,7,VILLA CORZO,107,LA SANDÍA,2,8,1,7,2
CHIAPAS,7,VILLA CORZO,107,LA SELVA DOS,2,24,12,12,3
CHIAPAS,7,VILLA CORZO,107,LA SIERRITA,3,98,51,47,6
CHIAPAS,7,VILLA CORZO,107,LAS BRISAS,3,28,13,15,3
CHIAPAS,7,VILLA CORZO,107,LAS CAROLINAS,2,10,5,5,2
CHIAPAS,7,VILLA CORZO,107,LAS FLORES (EMILIANO ZAPATA),3,39,16,23,4
CHIAPAS,7,VILLA CORZO,107,LAS GUAYABITAS,2,12,5,7,2
CHIAPAS,7,VILLA CORZO,107,LAS LUCES,3,27,10,17,3
CHIAPAS,7,VILLA CORZO,107,LAS MURALLAS,1,7,4,3,1
CHIAPAS,7,VILLA CORZO,107,LAS NUBES,1,7,3,4,1
CHIAPAS,7,VILLA CORZO,107,LAS PALMAS,1,4,2,2,1
CHIAPAS,7,VILLA CORZO,107,LAS PALOMAS,1,23,10,13,1
CHIAPAS,7,VILLA CORZO,107,LÁZARO CÁRDENAS,2,79,43,36,6
CHIAPAS,7,VILLA CORZO,107,LINDAVISTA,3,56,26,30,4
CHIAPAS,7,VILLA CORZO,107,LOMA BONITA,4,228,110,118,14
CHIAPAS,7,VILLA CORZO,107,LOS AMATES,4,149,84,65,9
CHIAPAS,7,VILLA CORZO,107,LOS ARBOLITOS (EL TRIUNFO),2,9,5,4,1
CHIAPAS,7,VILLA CORZO,107,LOS PINOS,1,11,3,8,1
CHIAPAS,7,VILLA CORZO,107,MALPASO,2,6,3,3,1
CHIAPAS,7,VILLA CORZO,107,MANUEL ÁVILA CAMACHO,2,251,130,121,11
CHIAPAS,7,VILLA CORZO,107,MARISCAL (LA CUMBRE),2,11,8,3,2
CHIAPAS,7,VILLA CORZO,107,MÉRIDA,2,4,1,3,2
CHIAPAS,7,VILLA CORZO,107,MICHOACÁN,1,7,3,4,1
CHIAPAS,7,VILLA CORZO,107,MONTECRISTO,2,14,7,7,2
CHIAPAS,7,VILLA CORZO,107,MONTERREY,7,890,437,453,83
CHIAPAS,7,VILLA CORZO,107,MORELIA,1,5,2,3,1
CHIAPAS,7,VILLA CORZO,107,NUEVA AURORA,1,4,1,3,1
CHIAPAS,7,VILLA CORZO,107,NUEVA CANDELARIA,3,60,33,27,6
CHIAPAS,7,VILLA CORZO,107,NUEVA ESPAÑA,1,4,2,2,1
CHIAPAS,7,VILLA CORZO,107,NUEVA ESPERANZA,2,16,12,4,2
CHIAPAS,7,VILLA CORZO,107,NUEVA YORK,1,33,18,15,3
CHIAPAS,7,VILLA CORZO,107,NUEVO EDÉN,5,63,36,27,6
CHIAPAS,7,VILLA CORZO,107,NUEVO PLAN DE AYALA,1,8,5,3,1
CHIAPAS,7,VILLA CORZO,107,NUEVO SAN JUAN,3,196,105,91,7
CHIAPAS,7,VILLA CORZO,107,NUEVO TENEJAPA,3,63,35,28,6
CHIAPAS,7,VILLA CORZO,107,NUEVO VICENTE GUERRERO,6,847,420,427,41
CHIAPAS,7,VILLA CORZO,107,OCOTAL MARAVILLAS,3,86,46,40,6
CHIAPAS,7,VILLA CORZO,107,OJO DE AGUA,1,6,3,3,1
CHIAPAS,7,VILLA CORZO,107,PATRIA CHICA,3,80,41,39,7
CHIAPAS,7,VILLA CORZO,107,PIEDRAS ALTAS,1,4,2,2,1
CHIAPAS,7,VILLA CORZO,107,PIEDRAS NEGRAS,5,50,26,24,6
CHIAPAS,7,VILLA CORZO,107,PLAN DE AYALA,3,74,39,35,5
CHIAPAS,7,VILLA CORZO,107,PLAN DE BELÉN,2,5,1,4,2
CHIAPAS,7,VILLA CORZO,107,PLÁNCIDA,2,13,6,7,2
CHIAPAS,7,VILLA CORZO,107,RANCHO NUEVO,2,38,19,19,2
CHIAPAS,7,VILLA CORZO,107,REVOLUCIÓN MEXICANA,12,2201,1062,1139,155
CHIAPAS,7,VILLA CORZO,107,RINCÓN CEIBO,1,9,4,5,1
CHIAPAS,7,VILLA CORZO,107,RINCÓN DE LAS FLORES,1,6,3,3,1
CHIAPAS,7,VILLA CORZO,107,RINCÓN DE LAS PAVAS,2,19,10,9,2
CHIAPAS,7,VILLA CORZO,107,RINCÓN GRANDE,1,6,4,2,1
CHIAPAS,7,VILLA CORZO,107,RINCÓN PABLO,1,5,4,1,1
CHIAPAS,7,VILLA CORZO,107,RINCÓN PEÑA,1,40,18,22,3
CHIAPAS,7,VILLA CORZO,107,RÍO GRANDE,3,85,47,38,6
CHIAPAS,7,VILLA CORZO,107,RIVERA BUENAVISTA,1,2,2,0,1
CHIAPAS,7,VILLA CORZO,107,RIZO DE ORO,2,14,7,7,2
CHIAPAS,7,VILLA CORZO,107,SAN ÁNGEL,1,10,8,2,1
CHIAPAS,7,VILLA CORZO,107,SAN ANTONIO,1,4,3,1,1
CHIAPAS,7,VILLA CORZO,107,SAN CARLOS,3,11,7,4,2
CHIAPAS,7,VILLA CORZO,107,SAN ESTEBAN,2,19,12,7,2
CHIAPAS,7,VILLA CORZO,107,SAN FRANCISCO,1,17,8,9,2
CHIAPAS,7,VILLA CORZO,107,SAN FRANCISCO DE ASÍS,2,24,9,15,3
CHIAPAS,7,VILLA CORZO,107,SAN ISIDRO,1,16,8,8,1
CHIAPAS,7,VILLA CORZO,107,SAN JOSÉ,2,14,6,8,2
CHIAPAS,7,VILLA CORZO,107,SAN JOSÉ DE LAS FLORES,2,29,15,14,3
CHIAPAS,7,VILLA CORZO,107,SAN JUAN DE LOS ÁNGELES,3,43,23,20,4
CHIAPAS,7,VILLA CORZO,107,SAN JULIÁN,2,51,20,31,3
CHIAPAS,7,VILLA CORZO,107,SAN MARCOS,3,33,16,17,3
CHIAPAS,7,VILLA CORZO,107,SAN PEDRO BUENAVISTA,13,2792,1383,1409,155
CHIAPAS,7,VILLA CORZO,107,SAN RAFAEL,1,6,3,3,1
CHIAPAS,7,VILLA CORZO,107,SAN RAMÓN,4,26,14,12,4
CHIAPAS,7,VILLA CORZO,107,SANTA CRUZ,1,7,3,4,1
CHIAPAS,7,VILLA CORZO,107,SANTA ISABEL,2,10,8,2,2
CHIAPAS,7,VILLA CORZO,107,SANTA ROSA,2,18,10,8,2
CHIAPAS,7,VILLA CORZO,107,SANTIAGO,2,100,59,41,5
CHIAPAS,7,VILLA CORZO,107,SANTIAGO LA MESILLA,1,8,4,4,1
CHIAPAS,7,VILLA CORZO,107,SANTO TOMÁS,3,21,10,11,3
CHIAPAS,7,VILLA CORZO,107,SIERRA MORENA,1,25,15,10,1
CHIAPAS,7,VILLA CORZO,107,SINAÍ,1,6,4,2,1
CHIAPAS,7,VILLA CORZO,107,TIERRA SANTA,4,195,117,78,12
CHIAPAS,7,VILLA CORZO,107,UNIÓN DEL CARMEN,4,114,56,58,9
CHIAPAS,7,VILLA CORZO,107,VALLE MORELOS,6,1057,542,515,44
CHIAPAS,7,VILLA CORZO,107,VEINTICUATRO DE DICIEMBRE,4,164,77,87,10
CHIAPAS,7,VILLA CORZO,107,VEINTICUATRO DE FEBRERO,4,54,18,36,6
CHIAPAS,7,VILLA CORZO,107,VEINTIUNO DE SEPTIEMBRE,3,34,18,16,4
CHIAPAS,7,VILLA CORZO,107,VERAPAZ,1,6,1,5,1
CHIAPAS,7,VILLA CORZO,107,VILLA CORZO,16,3158,1560,1598,197
CHIAPAS,7,VILLA CORZO,107,VILLA CORZO EL ROSARIO (SAN LUIS EL ALTO),2,5,3,2,1
CHIAPAS,7,VILLA CORZO,107,VILLAHERMOSA,3,35,18,17,4
CHIAPAS,7,VILLA CORZO,107,VILLALÉN,3,24,13,11,3
CHIAPAS,7,VILLA CORZO,107,YUCATÁN,1,4,3,1,1
CHIAPAS,7,VILLAFLORES,108,30 DE NOVIEMBRE,2,74,34,40,4
CHIAPAS,7,VILLAFLORES,108,AGRÓNOMOS MEXICANOS,3,328,156,172,14
CHIAPAS,7,VILLAFLORES,108,BELÉN,2,77,38,39,5
CHIAPAS,7,VILLAFLORES,108,BENITO JUÁREZ,6,1147,554,593,37
CHIAPAS,7,VILLAFLORES,108,BUENAVISTA,2,46,27,19,4
CHIAPAS,7,VILLAFLORES,108,CALIFORNIA,2,54,19,35,3
CHIAPAS,7,VILLAFLORES,108,CALZADA LARGA,3,257,123,134,13
CHIAPAS,7,VILLAFLORES,108,CARMEN EL SANTUARIO,2,14,7,7,2
CHIAPAS,7,VILLAFLORES,108,CHAMPERICO,2,21,9,12,3
CHIAPAS,7,VILLAFLORES,108,CRISTÓBAL OBREGÓN,7,1407,682,725,62
CHIAPAS,7,VILLAFLORES,108,CUAUHTÉMOC,4,926,465,461,35
CHIAPAS,7,VILLAFLORES,108,DIECISÉIS DE SEPTIEMBRE,4,415,208,207,14
CHIAPAS,7,VILLAFLORES,108,DISTRITO FEDERAL,3,24,14,10,3
CHIAPAS,7,VILLAFLORES,108,DOCTOR DOMINGO CHANONA,5,1055,522,533,41
CHIAPAS,7,VILLAFLORES,108,EL CAIRO,2,14,4,10,2
CHIAPAS,7,VILLAFLORES,108,EL CARMELO,2,49,24,25,3
CHIAPAS,7,VILLAFLORES,108,EL JARDÍN,3,16,9,7,2
CHIAPAS,7,VILLAFLORES,108,EL PALMAR,1,6,3,3,1
CHIAPAS,7,VILLAFLORES,108,EL PARAÍSO,2,5,0,5,1
CHIAPAS,7,VILLAFLORES,108,EL PARAÍSO I,2,15,7,8,2
CHIAPAS,7,VILLAFLORES,108,EL PORTILLO,2,149,66,83,7
CHIAPAS,7,VILLAFLORES,108,EL PORVENIR,6,69,32,37,7
CHIAPAS,7,VILLAFLORES,108,EL RECUERDO,2,38,17,21,2
CHIAPAS,7,VILLAFLORES,108,EL RECUERDO DOS,2,10,3,7,2
CHIAPAS,7,VILLAFLORES,108,EL SILBIDO,2,38,15,23,2
CHIAPAS,7,VILLAFLORES,108,EL TRIUNFO,4,54,33,21,5
CHIAPAS,7,VILLAFLORES,108,EL VERGEL,1,15,8,7,1
CHIAPAS,7,VILLAFLORES,108,ESFUERZO CAMPESINO MAGISTERIAL (SOCAMA),2,51,28,23,2
CHIAPAS,7,VILLAFLORES,108,ESPINAL BUENAVISTA,2,68,32,36,4
CHIAPAS,7,VILLAFLORES,108,FRACCIÓN BELÉN,1,11,5,6,1
CHIAPAS,7,VILLAFLORES,108,FRANCISCO VILLA,4,455,211,244,21
CHIAPAS,7,VILLAFLORES,108,GALEANA,2,17,10,7,2
CHIAPAS,7,VILLAFLORES,108,GUADALUPE VICTORIA,1,154,61,93,15
CHIAPAS,7,VILLAFLORES,108,GUADALUPE VICTORIA (LÁZARO CÁRDENAS),4,1142,567,575,37
CHIAPAS,7,VILLAFLORES,108,GUAYMAS,2,29,15,14,2
CHIAPAS,7,VILLAFLORES,108,HERIBERTO JARA,2,53,27,26,2
CHIAPAS,7,VILLAFLORES,108,HERMENEGILDO GALEANA,2,17,10,7,2
CHIAPAS,7,VILLAFLORES,108,HORACIO GRAJALES,2,20,10,10,2
CHIAPAS,7,VILLAFLORES,108,IGNACIO ZARAGOZA,3,233,109,124,12
CHIAPAS,7,VILLAFLORES,108,JESÚS MARÍA GARZA,7,2286,1149,1137,121
CHIAPAS,7,VILLAFLORES,108,JOAQUÍN MIGUEL GUTIÉRREZ,3,494,257,237,20
CHIAPAS,7,VILLAFLORES,108,JOSEFA ORTIZ DE DOMÍNGUEZ,3,80,37,43,5
CHIAPAS,7,VILLAFLORES,108,LA AURORA,1,7,5,2,1
CHIAPAS,7,VILLAFLORES,108,LA CEIBA,1,130,67,63,5
CHIAPAS,7,VILLAFLORES,108,LA CIÉNEGA,2,16,5,11,2
CHIAPAS,7,VILLAFLORES,108,LA LIBERTAD,1,13,8,5,1
CHIAPAS,7,VILLAFLORES,108,LA SIRENA,3,437,221,216,18
CHIAPAS,7,VILLAFLORES,108,LA SOMBRA,1,40,24,16,3
CHIAPAS,7,VILLAFLORES,108,LA SOMBRA DE LA SELVA,2,25,12,13,3
CHIAPAS,7,VILLAFLORES,108,LAS POMARROSAS,1,6,2,4,1
CHIAPAS,7,VILLAFLORES,108,LAS TUNAS,2,7,1,6,1
CHIAPAS,7,VILLAFLORES,108,LIBERTAD MELCHOR OCAMPO,3,372,178,194,14
CHIAPAS,7,VILLAFLORES,108,LOS ÁNGELES,4,305,140,165,14
CHIAPAS,7,VILLAFLORES,108,LOS INOCENTES,2,8,2,6,1
CHIAPAS,7,VILLAFLORES,108,LOS LAURELES,2,33,15,18,2
CHIAPAS,7,VILLAFLORES,108,LOS MANGUITOS,2,13,5,8,2
CHIAPAS,7,VILLAFLORES,108,MAGDALENA,2,7,4,3,1
CHIAPAS,7,VILLAFLORES,108,MATAMOROS (CUILCO),2,5,0,5,1
CHIAPAS,7,VILLAFLORES,108,MIGUEL HIDALGO (CONCEPCIÓN),2,62,32,30,4
CHIAPAS,7,VILLAFLORES,108,NIQUIDÁMBAR,2,30,18,12,2
CHIAPAS,7,VILLAFLORES,108,NUEVA ESPERANZA,3,22,5,17,3
CHIAPAS,7,VILLAFLORES,108,NUEVA INDEPENDENCIA,2,21,11,10,2
CHIAPAS,7,VILLAFLORES,108,NUEVA LIBERTAD,1,7,5,2,1
CHIAPAS,7,VILLAFLORES,108,NUEVA PALESTINA,2,113,71,42,4
CHIAPAS,7,VILLAFLORES,108,NUEVO EDÉN,2,10,6,4,1
CHIAPAS,7,VILLAFLORES,108,NUEVO HORIZONTE,1,19,12,7,1
CHIAPAS,7,VILLAFLORES,108,NUEVO LEÓN,1,53,31,22,3
CHIAPAS,7,VILLAFLORES,108,NUEVO MÉXICO,7,831,408,423,33
CHIAPAS,7,VILLAFLORES,108,NUEVO MUNDO,3,61,28,33,5
CHIAPAS,7,VILLAFLORES,108,PALENQUE DE LOS PINOS,2,90,40,50,4
CHIAPAS,7,VILLAFLORES,108,PROGRESO AGRARIO,3,75,33,42,6
CHIAPAS,7,VILLAFLORES,108,RANCHO BONITO,2,11,5,6,1
CHIAPAS,7,VILLAFLORES,108,RIBERA HORIZONTE,3,194,86,108,10
CHIAPAS,7,VILLAFLORES,108,RICARDO FLORES MAGÓN,3,142,74,68,7
CHIAPAS,7,VILLAFLORES,108,RINCÓN DE MONTECRISTO,2,15,10,5,2
CHIAPAS,7,VILLAFLORES,108,ROBLADA GRANDE,4,447,226,221,22
CHIAPAS,7,VILLAFLORES,108,SALTO DE AGUA,1,7,3,4,1
CHIAPAS,7,VILLAFLORES,108,SAN FELIPE,2,16,9,7,2
CHIAPAS,7,VILLAFLORES,108,SAN GUILLERMO,2,18,11,7,2
CHIAPAS,7,VILLAFLORES,108,SAN JOSÉ LA CUCHILLA,2,26,16,10,2
CHIAPAS,7,VILLAFLORES,108,SAN MARCOS,2,23,8,15,2
CHIAPAS,7,VILLAFLORES,108,SAN PEDRITO,1,51,16,35,2
CHIAPAS,7,VILLAFLORES,108,SANTA ROSA,2,9,2,7,1
CHIAPAS,7,VILLAFLORES,108,SIERRA ALTA,2,12,5,7,2
CHIAPAS,7,VILLAFLORES,108,SINALOA,2,21,10,11,2
CHIAPAS,7,VILLAFLORES,108,TENOCHTITLÁN,3,155,69,86,8
CHIAPAS,7,VILLAFLORES,108,TIERRA Y LIBERTAD,4,315,167,148,14
CHIAPAS,7,VILLAFLORES,108,TOLUCA,2,8,4,4,1
CHIAPAS,7,VILLAFLORES,108,TRES PICOS,4,176,84,92,11
CHIAPAS,7,VILLAFLORES,108,UNIÓN Y PROGRESO,3,153,68,85,8
CHIAPAS,7,VILLAFLORES,108,ÚRSULO GALVÁN,4,375,190,185,15
CHIAPAS,7,VILLAFLORES,108,VILLA HIDALGO,4,772,372,400,33
CHIAPAS,7,VILLAFLORES,108,VILLAFLORES,67,13322,6709,6613,891
CHIAPAS,7,VILLAFLORES,108,VILLAHERMOSA,7,257,130,127,16
CHIAPAS,7,VILLAFLORES,108,VIVA CHIAPAS,2,16,9,7,2
CHIAPAS,7,YAJALÓN,109,AGUA ESCONDIDA,1,8,5,3,1
CHIAPAS,7,YAJALÓN,109,AMADO NERVO,4,649,296,353,27
CHIAPAS,7,YAJALÓN,109,ARROYO CARRIZAL,1,24,14,10,1
CHIAPAS,7,YAJALÓN,109,AURORA BAHUITZ,1,81,42,39,2
CHIAPAS,7,YAJALÓN,109,BAHUITZ TZONEP,1,21,12,9,2
CHIAPAS,7,YAJALÓN,109,BARRANCA NABIL,2,47,20,27,2
CHIAPAS,7,YAJALÓN,109,BARRANCA NAVIL 2DA. SECCIÓN,2,30,17,13,3
CHIAPAS,7,YAJALÓN,109,BENITO JUÁREZ,1,27,15,12,1
CHIAPAS,7,YAJALÓN,109,CALLEJÓN LORENA SHASHIJÁ,3,81,44,37,6
CHIAPAS,7,YAJALÓN,109,CALVARIO BAHUITZ,2,111,46,65,4
CHIAPAS,7,YAJALÓN,109,CALVARIO BAHUITZ OJO DE AGUA,2,58,33,25,4
CHIAPAS,7,YAJALÓN,109,CALVARIO LAS DELICIAS,2,109,59,50,4
CHIAPAS,7,YAJALÓN,109,CARMEN GUAYAQUIL,1,25,11,14,1
CHIAPAS,7,YAJALÓN,109,CHILILJÁ,2,27,19,8,2
CHIAPAS,7,YAJALÓN,109,CHITALTIC,2,70,33,37,3
CHIAPAS,7,YAJALÓN,109,CHIVILTIC,3,131,72,59,4
CHIAPAS,7,YAJALÓN,109,CHUPAQUIL,2,55,25,30,3
CHIAPAS,7,YAJALÓN,109,COLIPÁ,1,8,3,5,1
CHIAPAS,7,YAJALÓN,109,COOPROPIEDAD SANTA CRUZ,2,51,29,22,4
CHIAPAS,7,YAJALÓN,109,CUXULJA,1,7,4,3,1
CHIAPAS,7,YAJALÓN,109,EL ARENAL,2,27,13,14,3
CHIAPAS,7,YAJALÓN,109,EL DELIRIO,1,20,13,7,2
CHIAPAS,7,YAJALÓN,109,EL PEDREGAL,2,18,9,9,2
CHIAPAS,7,YAJALÓN,109,EL PRADO,2,69,33,36,3
CHIAPAS,7,YAJALÓN,109,EL PROGRESO,2,41,24,17,3
CHIAPAS,7,YAJALÓN,109,EL RECREO,2,125,58,67,4
CHIAPAS,7,YAJALÓN,109,EL TZEMENTÉ,2,41,18,23,3
CHIAPAS,7,YAJALÓN,109,EMILIANO ZAPATA,2,136,74,62,4
CHIAPAS,7,YAJALÓN,109,ESPERANZA,1,70,36,34,3
CHIAPAS,7,YAJALÓN,109,ESPERANZA PORVENIR,2,48,19,29,2
CHIAPAS,7,YAJALÓN,109,ESPERANZA SÉTZER,2,75,38,37,4
CHIAPAS,7,YAJALÓN,109,ESPERANZA TAKINUKUM,1,52,25,27,2
CHIAPAS,7,YAJALÓN,109,FRACCIÓN LA AURORA,1,7,3,4,1
CHIAPAS,7,YAJALÓN,109,FRACCIÓN LA UNIÓN,1,25,10,15,1
CHIAPAS,7,YAJALÓN,109,IXCAMUT,1,14,10,4,1
CHIAPAS,7,YAJALÓN,109,JOSÉ MARÍA MORELOS Y PAVÓN (TAQUINJA),1,37,15,22,2
CHIAPAS,7,YAJALÓN,109,JOTOLA,3,47,18,29,4
CHIAPAS,7,YAJALÓN,109,LA ALDEA,1,22,11,11,2
CHIAPAS,7,YAJALÓN,109,LA BELLEZA,1,24,16,8,1
CHIAPAS,7,YAJALÓN,109,LA GLORIA BAHUITZ,1,5,3,2,1
CHIAPAS,7,YAJALÓN,109,LA ISLA,2,22,8,14,3
CHIAPAS,7,YAJALÓN,109,LA LAGUNA,2,199,99,100,8
CHIAPAS,7,YAJALÓN,109,LA LAGUNA 2DA. SECCIÓN,1,17,9,8,2
CHIAPAS,7,YAJALÓN,109,LA PERSEVERANCIA,2,71,31,40,4
CHIAPAS,7,YAJALÓN,109,LA PROVIDENCIA,2,56,24,32,2
CHIAPAS,7,YAJALÓN,109,LA REFORMA,2,31,19,12,3
CHIAPAS,7,YAJALÓN,109,LA UNIÓN (FRACCIÓN LA ESTRELLA),1,21,11,10,2
CHIAPAS,7,YAJALÓN,109,LA UNIÓN TAKINUCUM (BUENAVISTA),2,19,9,10,2
CHIAPAS,7,YAJALÓN,109,LA VENTANA,2,155,73,82,8
CHIAPAS,7,YAJALÓN,109,LÁZARO CÁRDENAS,4,580,275,305,23
CHIAPAS,7,YAJALÓN,109,LINDAVISTA VESUBIO,1,15,9,6,1
CHIAPAS,7,YAJALÓN,109,LUCIO BLANCO,5,149,73,76,6
CHIAPAS,7,YAJALÓN,109,MAJASIL,3,87,46,41,5
CHIAPAS,7,YAJALÓN,109,NUEVA ESPERANZA,1,15,9,6,1
CHIAPAS,7,YAJALÓN,109,NUEVA JERUSALÉN,1,13,5,8,1
CHIAPAS,7,YAJALÓN,109,NUEVA JERUSALÉN 1RA. SECCIÓN,2,8,4,4,1
CHIAPAS,7,YAJALÓN,109,NUEVO PARAÍSO,3,56,26,30,5
CHIAPAS,7,YAJALÓN,109,OCOT YASHWINIC,1,17,9,8,1
CHIAPAS,7,YAJALÓN,109,OCOTAL,3,178,82,96,6
CHIAPAS,7,YAJALÓN,109,SACLUMIL DOS,2,68,26,42,3
CHIAPAS,7,YAJALÓN,109,SAN ANTONIO DE LA AURORA,1,41,20,21,2
CHIAPAS,7,YAJALÓN,109,SAN ANTONIO DE LA GIRALDA,2,25,14,11,2
CHIAPAS,7,YAJALÓN,109,SAN JOSÉ ISMOCOY,2,62,29,33,3
CHIAPAS,7,YAJALÓN,109,SAN JOSÉ LA FLORIDA YOB,2,71,34,37,3
CHIAPAS,7,YAJALÓN,109,SAN JOSÉ PARAÍSO,2,58,25,33,3
CHIAPAS,7,YAJALÓN,109,SAN LUIS,1,93,39,54,2
CHIAPAS,7,YAJALÓN,109,SAN MIGUEL OJO DE AGUA,1,44,23,21,2
CHIAPAS,7,YAJALÓN,109,SAN PEDRO BUENAVISTA,3,93,43,50,4
CHIAPAS,7,YAJALÓN,109,SAN PEDRO JOTOLÁ,3,65,24,41,4
CHIAPAS,7,YAJALÓN,109,SAN VICENTE,4,121,72,49,7
CHIAPAS,7,YAJALÓN,109,SANTA BÁRBARA,2,48,29,19,3
CHIAPAS,7,YAJALÓN,109,SANTA CANDELARIA,1,38,19,19,2
CHIAPAS,7,YAJALÓN,109,SANTA CRUZ DE LA FLORECITA,2,72,36,36,4
CHIAPAS,7,YAJALÓN,109,SANTA CRUZ EL PALMAR,1,49,22,27,2
CHIAPAS,7,YAJALÓN,109,SHASHIJÁ,2,105,52,53,4
CHIAPAS,7,YAJALÓN,109,SINAÍ,2,76,36,40,3
CHIAPAS,7,YAJALÓN,109,SOLEDAD TAKINUKUM,2,61,37,24,3
CHIAPAS,7,YAJALÓN,109,TIERRA COLORADA,1,19,7,12,1
CHIAPAS,7,YAJALÓN,109,TIERRA Y LIBERTAD,3,105,53,52,7
CHIAPAS,7,YAJALÓN,109,TRES PIEDRAS TZELEJ,2,85,46,39,4
CHIAPAS,7,YAJALÓN,109,TULAQUIL,2,54,24,30,3
CHIAPAS,7,YAJALÓN,109,TZAJALUMIL,2,67,32,35,4
CHIAPAS,7,YAJALÓN,109,TZINTÓN,1,22,10,12,1
CHIAPAS,7,YAJALÓN,109,YAJALÓN,34,7560,3830,3730,362
CHIAPAS,7,SAN LUCAS,110,FRANCISCO VILLA,4,308,150,158,14
CHIAPAS,7,SAN LUCAS,110,LAGUNA DEL CARMEN,3,277,142,135,10
CHIAPAS,7,SAN LUCAS,110,SAN JOSÉ BUENAVISTA,3,200,107,93,10
CHIAPAS,7,SAN LUCAS,110,SAN LUCAS,7,1252,620,632,50
CHIAPAS,7,ZINACANTÁN,111,AJTETIC ALTO,2,44,26,18,2
CHIAPAS,7,ZINACANTÁN,111,AJTETIC BAJO,2,102,49,53,5
CHIAPAS,7,ZINACANTÁN,111,AJTETIC BAJO I,3,55,33,22,4
CHIAPAS,7,ZINACANTÁN,111,APAZ,3,270,147,123,13
CHIAPAS,7,ZINACANTÁN,111,BOCHOJBO ALTO,4,347,177,170,16
CHIAPAS,7,ZINACANTÁN,111,BOMCHEN,2,137,86,51,7
CHIAPAS,7,ZINACANTÁN,111,CHACTOJ,2,111,52,59,4
CHIAPAS,7,ZINACANTÁN,111,CHAINATIC,3,110,55,55,6
CHIAPAS,7,ZINACANTÁN,111,CHIQUINIVALVO,3,230,103,127,11
CHIAPAS,7,ZINACANTÁN,111,CONLUM,3,64,31,33,5
CHIAPAS,7,ZINACANTÁN,111,EL PIG,2,185,85,100,7
CHIAPAS,7,ZINACANTÁN,111,ELAMBÓ,3,220,119,101,15
CHIAPAS,7,ZINACANTÁN,111,ELAMBO ALTO,2,137,79,58,5
CHIAPAS,7,ZINACANTÁN,111,ELAMBO BAJO,3,292,141,151,11
CHIAPAS,7,ZINACANTÁN,111,GUADALUPE SHUCÚN,1,54,24,30,2
CHIAPAS,7,ZINACANTÁN,111,JECH CHENTIC,2,464,228,236,20
CHIAPAS,7,ZINACANTÁN,111,JECHTOCH,2,96,52,44,3
CHIAPAS,7,ZINACANTÁN,111,JECHVO,2,253,130,123,9
CHIAPAS,7,ZINACANTÁN,111,JOCOTAL,2,25,10,15,3
CHIAPAS,7,ZINACANTÁN,111,JOIGEL GRANDE,2,98,40,58,4
CHIAPAS,7,ZINACANTÁN,111,JOIGELITO,3,89,40,49,5
CHIAPAS,7,ZINACANTÁN,111,JOIGELITO ALTO,1,13,5,8,1
CHIAPAS,7,ZINACANTÁN,111,K'AQUETE,2,76,26,50,5
CHIAPAS,7,ZINACANTÁN,111,K'AQUETE BAJO,2,36,21,15,2
CHIAPAS,7,ZINACANTÁN,111,LA GRANADILLA,3,509,246,263,20
CHIAPAS,7,ZINACANTÁN,111,LA GRANADILLA ALTO,2,81,49,32,4
CHIAPAS,7,ZINACANTÁN,111,LA SELVA,2,46,26,20,3
CHIAPAS,7,ZINACANTÁN,111,MAZAM,3,37,19,18,4
CHIAPAS,7,ZINACANTÁN,111,NACHIG,5,1030,474,556,44
CHIAPAS,7,ZINACANTÁN,111,NAVENCHAUC,4,970,486,484,37
CHIAPAS,7,ZINACANTÁN,111,PASTÉ,4,870,419,451,30
CHIAPAS,7,ZINACANTÁN,111,PATOSIL,3,481,254,227,18
CHIAPAS,7,ZINACANTÁN,111,PETZTOJ BAJO,1,23,9,14,2
CHIAPAS,7,ZINACANTÁN,111,PIEDRA PARADA,2,47,18,29,3
CHIAPAS,7,ZINACANTÁN,111,PIEDRA PARADA BAJO,2,67,31,36,3
CHIAPAS,7,ZINACANTÁN,111,PINAR SALINAS,3,193,111,82,8
CHIAPAS,7,ZINACANTÁN,111,POTOBTIC,3,200,98,102,8
CHIAPAS,7,ZINACANTÁN,111,POTOBTIC BAJO,2,66,37,29,4
CHIAPAS,7,ZINACANTÁN,111,RANCHO NUEVO,2,22,11,11,2
CHIAPAS,7,ZINACANTÁN,111,SAN ANTONIO,1,21,5,16,1
CHIAPAS,7,ZINACANTÁN,111,SAN ANTONIO ALTO,1,50,26,24,2
CHIAPAS,7,ZINACANTÁN,111,SAN ISIDRO,2,64,33,31,4
CHIAPAS,7,ZINACANTÁN,111,SAN NICOLÁS BUENAVISTA,2,97,43,54,4
CHIAPAS,7,ZINACANTÁN,111,SHULVO,2,179,98,81,8
CHIAPAS,7,ZINACANTÁN,111,TIERRA BLANCA,3,223,95,128,9
CHIAPAS,7,ZINACANTÁN,111,TZAJALNAM,2,88,41,47,4
CHIAPAS,7,ZINACANTÁN,111,YAALTZI,2,69,34,35,3
CHIAPAS,7,ZINACANTÁN,111,YALENTAY (SAN JOAQUÍN),2,273,145,128,11
CHIAPAS,7,ZINACANTÁN,111,ZEQUENTIC,5,755,387,368,29
CHIAPAS,7,ZINACANTÁN,111,ZEQUENTIC BAJO,1,226,122,104,6
CHIAPAS,7,ZINACANTÁN,111,ZINACANTÁN,8,1349,669,680,75
CHIAPAS,7,SAN JUAN CANCUC,112,AXULTIC,2,120,48,72,4
CHIAPAS,7,SAN JUAN CANCUC,112,BAPUZ,1,103,54,49,3
CHIAPAS,7,SAN JUAN CANCUC,112,BAQUELCHÁN,3,406,205,201,9
CHIAPAS,7,SAN JUAN CANCUC,112,CHACTÉ,3,411,180,231,14
CHIAPAS,7,SAN JUAN CANCUC,112,CHANCOLOM,2,551,277,274,14
CHIAPAS,7,SAN JUAN CANCUC,112,CHICJÁ,2,96,48,48,2
CHIAPAS,7,SAN JUAN CANCUC,112,CHIJIL,2,240,116,124,9
CHIAPAS,7,SAN JUAN CANCUC,112,CHILOLJÁ,4,1437,639,798,58
CHIAPAS,7,SAN JUAN CANCUC,112,CHOJCHOW,1,85,51,34,4
CHIAPAS,7,SAN JUAN CANCUC,112,CRUSILJÁ,2,528,283,245,17
CHIAPAS,7,SAN JUAN CANCUC,112,CRUZTÓN,2,274,132,142,9
CHIAPAS,7,SAN JUAN CANCUC,112,EL JOOB,2,42,25,17,2
CHIAPAS,7,SAN JUAN CANCUC,112,EL POZO,4,1057,484,573,39
CHIAPAS,7,SAN JUAN CANCUC,112,EL ROSARIO,2,206,101,105,6
CHIAPAS,7,SAN JUAN CANCUC,112,EL TRIUNFO,2,20,9,11,2
CHIAPAS,7,SAN JUAN CANCUC,112,IK'ALUMIL,1,14,9,5,1
CHIAPAS,7,SAN JUAN CANCUC,112,INDEPENDENCIA,2,138,77,61,6
CHIAPAS,7,SAN JUAN CANCUC,112,IWILTIC,4,826,353,473,33
CHIAPAS,7,SAN JUAN CANCUC,112,JUCHILJÁ,3,104,53,51,5
CHIAPAS,7,SAN JUAN CANCUC,112,JUC'NIL,2,270,139,131,5
CHIAPAS,7,SAN JUAN CANCUC,112,K'ANALUMTIK,2,60,32,28,3
CHIAPAS,7,SAN JUAN CANCUC,112,LA PALMA UNO,2,239,117,122,5
CHIAPAS,7,SAN JUAN CANCUC,112,NAILCHÉN,2,388,184,204,15
CHIAPAS,7,SAN JUAN CANCUC,112,NICHTEEL SAN ANTONIO,3,887,394,493,39
CHIAPAS,7,SAN JUAN CANCUC,112,ONILTIC,3,500,237,263,19
CHIAPAS,7,SAN JUAN CANCUC,112,PALMA PAJAL UNO,2,15,10,5,2
CHIAPAS,7,SAN JUAN CANCUC,112,RÍO TANATE'EL,2,60,29,31,5
CHIAPAS,7,SAN JUAN CANCUC,112,SAN JOSÉ CHACTÉ,3,158,74,84,6
CHIAPAS,7,SAN JUAN CANCUC,112,SAN JUAN BAWITZ,2,62,42,20,2
CHIAPAS,7,SAN JUAN CANCUC,112,SAN JUAN CANCUC,8,3779,1825,1954,123
CHIAPAS,7,SAN JUAN CANCUC,112,TE'MASH,2,80,38,42,3
CHIAPAS,7,SAN JUAN CANCUC,112,TZAJALCHÉN,2,107,53,54,5
CHIAPAS,7,SAN JUAN CANCUC,112,TZAJALHUCUM,2,356,166,190,9
CHIAPAS,7,SAN JUAN CANCUC,112,TZAMETAL,2,226,103,123,9
CHIAPAS,7,SAN JUAN CANCUC,112,TZEMEN,2,77,41,36,3
CHIAPAS,7,SAN JUAN CANCUC,112,TZULUWITZ,2,322,161,161,14
CHIAPAS,7,SAN JUAN CANCUC,112,TZUMBAL,2,139,75,64,5
CHIAPAS,7,SAN JUAN CANCUC,112,TZUNJOK,2,208,105,103,6
CHIAPAS,7,SAN JUAN CANCUC,112,WUY PAJCH'UL,2,37,17,20,3
CHIAPAS,7,SAN JUAN CANCUC,112,XANAB TON,2,89,45,44,7
CHIAPAS,7,SAN JUAN CANCUC,112,YANCH'EN,2,27,11,16,3
CHIAPAS,7,SAN JUAN CANCUC,112,YASHNAIL,2,103,56,47,3
CHIAPAS,7,SAN JUAN CANCUC,112,YOCWITZ,3,523,219,304,11
CHIAPAS,7,ALDAMA,113,ALDAMA,4,845,423,422,38
CHIAPAS,7,ALDAMA,113,CHAYOMTE,3,75,33,42,3
CHIAPAS,7,ALDAMA,113,CHIVIT,1,18,5,13,2
CHIAPAS,7,ALDAMA,113,COCO,2,64,37,27,3
CHIAPAS,7,ALDAMA,113,ICO,2,28,9,19,3
CHIAPAS,7,ALDAMA,113,JUXTÓN,2,67,42,25,4
CHIAPAS,7,ALDAMA,113,REVOLUCIÓN FIU,3,278,145,133,8
CHIAPAS,7,ALDAMA,113,SAN JOSÉ FIU,2,72,34,38,3
CHIAPAS,7,ALDAMA,113,SAN PEDRO COTZILNAM,2,207,113,94,6
CHIAPAS,7,ALDAMA,113,SANTA CRUZ,1,11,6,5,1
CHIAPAS,7,ALDAMA,113,SEPELTÓN,2,110,51,59,4
CHIAPAS,7,ALDAMA,113,SLUMKA,2,60,32,28,3
CHIAPAS,7,ALDAMA,113,TABAC,2,76,36,40,3
CHIAPAS,7,ALDAMA,113,TABILHUCUM,2,20,7,13,2
CHIAPAS,7,ALDAMA,113,TZELEJPOTOBTIC,2,36,18,18,3
CHIAPAS,7,ALDAMA,113,XULUMO,2,129,72,57,5
CHIAPAS,7,ALDAMA,113,XUXCHÉN,2,236,127,109,8
CHIAPAS,7,ALDAMA,113,YETÓN,2,123,57,66,5
CHIAPAS,7,ALDAMA,113,YOCTONTIC,2,29,12,17,3
CHIAPAS,7,ALDAMA,113,YOLONHUITZ,2,13,6,7,2
CHIAPAS,7,BENEMÉRITO DE LAS AMÉRICAS,114,ARROYO DELICIAS,4,539,255,284,15
CHIAPAS,7,BENEMÉRITO DE LAS AMÉRICAS,114,BELLAVISTA,2,28,15,13,2
CHIAPAS,7,BENEMÉRITO DE LAS AMÉRICAS,114,BENEMÉRITO DE LAS AMÉRICAS,20,2700,1345,1355,146
CHIAPAS,7,BENEMÉRITO DE LAS AMÉRICAS,114,BENEMÉRITO DE LAS AMÉRICAS PRIMERA SECCIÓN,3,309,142,167,14
CHIAPAS,7,BENEMÉRITO DE LAS AMÉRICAS,114,BENITO JUÁREZ,3,227,100,127,11
CHIAPAS,7,BENEMÉRITO DE LAS AMÉRICAS,114,CRUCERO DE ZAMORA PICO DE ORO,1,140,94,46,9
CHIAPAS,7,BENEMÉRITO DE LAS AMÉRICAS,114,EL CAOBA,3,18,7,11,3
CHIAPAS,7,BENEMÉRITO DE LAS AMÉRICAS,114,EL CEDRO,2,10,2,8,1
CHIAPAS,7,BENEMÉRITO DE LAS AMÉRICAS,114,EL MOLLEJÓN SEGUNDA SECCIÓN,2,41,15,26,2
CHIAPAS,7,BENEMÉRITO DE LAS AMÉRICAS,114,FLOR DE CACAO,4,988,494,494,28
CHIAPAS,7,BENEMÉRITO DE LAS AMÉRICAS,114,FRANCISCO JULIÁN GRAJALES,2,118,61,57,4
CHIAPAS,7,BENEMÉRITO DE LAS AMÉRICAS,114,GALILEA,3,58,20,38,4
CHIAPAS,7,BENEMÉRITO DE LAS AMÉRICAS,114,LA GRAVERA,2,12,6,6,2
CHIAPAS,7,BENEMÉRITO DE LAS AMÉRICAS,114,LA NUEVA UNIÓN,3,216,115,101,7
CHIAPAS,7,BENEMÉRITO DE LAS AMÉRICAS,114,LOMA LINDA,2,77,36,41,3
CHIAPAS,7,BENEMÉRITO DE LAS AMÉRICAS,114,NUEVA MAGDALENA,2,51,31,20,2
CHIAPAS,7,BENEMÉRITO DE LAS AMÉRICAS,114,NUEVA REFORMA,3,204,98,106,10
CHIAPAS,7,BENEMÉRITO DE LAS AMÉRICAS,114,NUEVO CHIHUAHUA,4,274,135,139,15
CHIAPAS,7,BENEMÉRITO DE LAS AMÉRICAS,114,NUEVO ORIZABA,4,596,289,307,20
CHIAPAS,7,BENEMÉRITO DE LAS AMÉRICAS,114,NUEVO VERACRUZ,3,299,153,146,14
CHIAPAS,7,BENEMÉRITO DE LAS AMÉRICAS,114,QUETZALCÓATL 1RA. SECCIÓN,3,229,102,127,9
CHIAPAS,7,BENEMÉRITO DE LAS AMÉRICAS,114,QUETZALCÓATL 2DA. SECCIÓN,2,99,47,52,6
CHIAPAS,7,BENEMÉRITO DE LAS AMÉRICAS,114,ROBERTO BARRIOS,4,470,229,241,23
CHIAPAS,7,BENEMÉRITO DE LAS AMÉRICAS,114,ROBERTO BARRIOS RÍO,3,52,26,26,3
CHIAPAS,7,BENEMÉRITO DE LAS AMÉRICAS,114,SAN ANTONIO,1,18,10,8,1
CHIAPAS,7,MARAVILLA TENEJAPA,115,20 DE NOVIEMBRE,1,17,14,3,1
CHIAPAS,7,MARAVILLA TENEJAPA,115,AGUA AZUL,1,7,2,5,1
CHIAPAS,7,MARAVILLA TENEJAPA,115,AGUA DULCE,2,27,15,12,4
CHIAPAS,7,MARAVILLA TENEJAPA,115,AGUA PERLA,2,41,23,18,2
CHIAPAS,7,MARAVILLA TENEJAPA,115,AMATITLÁN,4,299,135,164,11
CHIAPAS,7,MARAVILLA TENEJAPA,115,FLOR DE CAFÉ,4,190,66,124,10
CHIAPAS,7,MARAVILLA TENEJAPA,115,GUADALUPE MIRAMAR,2,155,69,86,3
CHIAPAS,7,MARAVILLA TENEJAPA,115,LA BELLA ILUSIÓN,2,88,38,50,3
CHIAPAS,7,MARAVILLA TENEJAPA,115,LA CAÑADA,2,31,12,19,3
CHIAPAS,7,MARAVILLA TENEJAPA,115,LA DEMOCRACIA,2,87,33,54,3
CHIAPAS,7,MARAVILLA TENEJAPA,115,LAS NUBES,3,95,52,43,4
CHIAPAS,7,MARAVILLA TENEJAPA,115,LOMA BONITA,2,107,54,53,3
CHIAPAS,7,MARAVILLA TENEJAPA,115,MARAVILLA TENEJAPA,5,990,520,470,41
CHIAPAS,7,MARAVILLA TENEJAPA,115,MONTE FLOR,2,89,46,43,3
CHIAPAS,7,MARAVILLA TENEJAPA,115,MONTECRISTO RÍO ESCONDIDO,1,40,24,16,1
CHIAPAS,7,MARAVILLA TENEJAPA,115,NIÑOS HÉROES,2,108,68,40,3
CHIAPAS,7,MARAVILLA TENEJAPA,115,NUEVA ARGENTINA,2,71,35,36,3
CHIAPAS,7,MARAVILLA TENEJAPA,115,NUEVA ESPERANZA,2,110,60,50,4
CHIAPAS,7,MARAVILLA TENEJAPA,115,NUEVA LINDAVISTA,1,47,24,23,1
CHIAPAS,7,MARAVILLA TENEJAPA,115,NUEVA SABANILLA,2,329,147,182,9
CHIAPAS,7,MARAVILLA TENEJAPA,115,NUEVO RODULFO FIGUEROA,2,122,67,55,4
CHIAPAS,7,MARAVILLA TENEJAPA,115,NUEVO SAN ANDRÉS DE LA PAZ,3,113,57,56,4
CHIAPAS,7,MARAVILLA TENEJAPA,115,PLAN DE RÍO AZUL,2,164,86,78,4
CHIAPAS,7,MARAVILLA TENEJAPA,115,PLAN SANTO DOMINGO,2,66,31,35,2
CHIAPAS,7,MARAVILLA TENEJAPA,115,SALTO DE AGUA,1,83,53,30,3
CHIAPAS,7,MARAVILLA TENEJAPA,115,SAN FELIPE JATATE,3,89,43,46,4
CHIAPAS,7,MARAVILLA TENEJAPA,115,SAN LORENZO,2,24,4,20,4
CHIAPAS,7,MARAVILLA TENEJAPA,115,SAN VICENTE,2,21,10,11,2
CHIAPAS,7,MARAVILLA TENEJAPA,115,SANTO DOMINGO DE LAS PALMAS,3,541,272,269,25
CHIAPAS,7,MARAVILLA TENEJAPA,115,ZACUALTIPÁN,2,89,43,46,4
CHIAPAS,7,MARQUÉS DE COMILLAS,116,ABSALÓN CASTELLANOS DOMÍNGUEZ,2,94,48,46,3
CHIAPAS,7,MARQUÉS DE COMILLAS,116,AMÉRICA LIBRE,3,213,107,106,6
CHIAPAS,7,MARQUÉS DE COMILLAS,116,BARRIO SAN JOSÉ,4,256,127,129,10
CHIAPAS,7,MARQUÉS DE COMILLAS,116,BOCA DE CHAJUL,4,193,104,89,11
CHIAPAS,7,MARQUÉS DE COMILLAS,116,DOCTOR BELISARIO DOMÍNGUEZ,2,74,30,44,2
CHIAPAS,7,MARQUÉS DE COMILLAS,116,EL PIRÚ,2,41,24,17,2
CHIAPAS,7,MARQUÉS DE COMILLAS,116,EL PORVENIR,2,86,38,48,3
CHIAPAS,7,MARQUÉS DE COMILLAS,116,EMILIANO ZAPATA,5,583,271,312,22
CHIAPAS,7,MARQUÉS DE COMILLAS,116,FLOR DE MÁRQUEZ DE COMILLAS,3,79,39,40,4
CHIAPAS,7,MARQUÉS DE COMILLAS,116,GALACIA,3,78,34,44,6
CHIAPAS,7,MARQUÉS DE COMILLAS,116,JOSÉ LÓPEZ PORTILLO,3,81,46,35,5
CHIAPAS,7,MARQUÉS DE COMILLAS,116,LA CORONA,2,63,30,33,3
CHIAPAS,7,MARQUÉS DE COMILLAS,116,LA VICTORIA,3,129,62,67,5
CHIAPAS,7,MARQUÉS DE COMILLAS,116,LICENCIADO ADOLFO LÓPEZ MATEOS,3,76,33,43,4
CHIAPAS,7,MARQUÉS DE COMILLAS,116,NUEVO PARAÍSO,1,24,9,15,2
CHIAPAS,7,MARQUÉS DE COMILLAS,116,PLAYÓN LA GLORIA,3,73,34,39,4
CHIAPAS,7,MARQUÉS DE COMILLAS,116,QUIRINGUICHARO,3,328,161,167,13
CHIAPAS,7,MARQUÉS DE COMILLAS,116,REFORMA AGRARIA,2,58,30,28,3
CHIAPAS,7,MARQUÉS DE COMILLAS,116,RÍO SALINAS,1,33,18,15,1
CHIAPAS,7,MARQUÉS DE COMILLAS,116,SAN ISIDRO,2,178,93,85,2
CHIAPAS,7,MARQUÉS DE COMILLAS,116,SAN LÁZARO,2,77,38,39,3
CHIAPAS,7,MARQUÉS DE COMILLAS,116,SANTA MARTA EL CARACOL,1,33,21,12,2
CHIAPAS,7,MARQUÉS DE COMILLAS,116,SANTA RITA LA FRONTERA,2,69,28,41,3
CHIAPAS,7,MARQUÉS DE COMILLAS,116,TIERRA Y LIBERTAD,4,359,168,191,12
CHIAPAS,7,MARQUÉS DE COMILLAS,116,ZAMORA PICO DE ORO,5,985,484,501,30
CHIAPAS,7,MONTECRISTO DE GUERRERO,117,EL NOMINADO,2,6,3,3,1
CHIAPAS,7,MONTECRISTO DE GUERRERO,117,EL PALENQUE,5,91,50,41,7
CHIAPAS,7,MONTECRISTO DE GUERRERO,117,EMILIANO ZAPATA,2,74,32,42,4
CHIAPAS,7,MONTECRISTO DE GUERRERO,117,LA CANDELARIA,2,32,17,15,3
CHIAPAS,7,MONTECRISTO DE GUERRERO,117,LA LUCHA,3,71,36,35,5
CHIAPAS,7,MONTECRISTO DE GUERRERO,117,LA OPINIÓN,2,17,11,6,2
CHIAPAS,7,MONTECRISTO DE GUERRERO,117,LAGUNA DEL COFRE,4,529,274,255,21
CHIAPAS,7,MONTECRISTO DE GUERRERO,117,LLANO GRANDE,3,57,25,32,4
CHIAPAS,7,MONTECRISTO DE GUERRERO,117,MONTE VIRGEN CANDELARIA,2,27,14,13,3
CHIAPAS,7,MONTECRISTO DE GUERRERO,117,MONTECRISTO DE GUERRERO,6,979,515,464,39
CHIAPAS,7,MONTECRISTO DE GUERRERO,117,NUEVO MILENIO TOLUCA,2,68,33,35,4
CHIAPAS,7,MONTECRISTO DE GUERRERO,117,NUEVO MUNDO,2,25,11,14,2
CHIAPAS,7,MONTECRISTO DE GUERRERO,117,NUEVO RÍO NEGRO,2,34,22,12,3
CHIAPAS,7,MONTECRISTO DE GUERRERO,117,PUERTO RICO,3,175,84,91,8
CHIAPAS,7,MONTECRISTO DE GUERRERO,117,RANCHO BONITO,2,24,17,7,2
CHIAPAS,7,MONTECRISTO DE GUERRERO,117,REFORMA,2,18,7,11,2
CHIAPAS,7,MONTECRISTO DE GUERRERO,117,RÍO NEGRO,2,15,7,8,2
CHIAPAS,7,MONTECRISTO DE GUERRERO,117,SAN NICOLÁS PLAN DE AYUTLA,2,192,105,87,9
CHIAPAS,7,MONTECRISTO DE GUERRERO,117,TOLUCA,2,38,19,19,3
CHIAPAS,7,MONTECRISTO DE GUERRERO,117,VISTA ALEGRE,3,47,25,22,3
CHIAPAS,7,SAN ANDRÉS DURAZNAL,118,EL OCOTAL,1,15,5,10,1
CHIAPAS,7,SAN ANDRÉS DURAZNAL,118,EL PALMAR (SAN MIGUEL),2,20,10,10,2
CHIAPAS,7,SAN ANDRÉS DURAZNAL,118,EL ROBLAR,2,21,14,7,2
CHIAPAS,7,SAN ANDRÉS DURAZNAL,118,JOTOLCHÉN,2,166,85,81,6
CHIAPAS,7,SAN ANDRÉS DURAZNAL,118,LAS LIMAS DOS,2,52,27,25,2
CHIAPAS,7,SAN ANDRÉS DURAZNAL,118,LAS LIMAS UNO,1,33,17,16,3
CHIAPAS,7,SAN ANDRÉS DURAZNAL,118,LINDAVISTA 2DA. FRACCIÓN (EL RETIRO),2,18,6,12,2
CHIAPAS,7,SAN ANDRÉS DURAZNAL,118,RÍO BLANCO,2,33,11,22,2
CHIAPAS,7,SAN ANDRÉS DURAZNAL,118,RIVERA GALEANA,2,224,120,104,9
CHIAPAS,7,SAN ANDRÉS DURAZNAL,118,SAN ANDRÉS DURAZNAL,4,1275,702,573,44
CHIAPAS,7,SANTIAGO EL PINAR,119,CHIQUINCH'EN LOS TULIPANES,2,22,16,6,3
CHIAPAS,7,SANTIAGO EL PINAR,119,CHOYO,2,255,137,118,10
CHIAPAS,7,SANTIAGO EL PINAR,119,EL CARMEN,2,14,4,10,2
CHIAPAS,7,SANTIAGO EL PINAR,119,NACHÓN,2,46,24,22,3
CHIAPAS,7,SANTIAGO EL PINAR,119,NÍNAMO,2,199,102,97,9
CHIAPAS,7,SANTIAGO EL PINAR,119,PECHULTÓN,2,115,54,61,5
CHIAPAS,7,SANTIAGO EL PINAR,119,PUSILHO,1,25,15,10,2
CHIAPAS,7,SANTIAGO EL PINAR,119,SAN ANTONIO BUENAVISTA,2,25,14,11,3
CHIAPAS,7,SANTIAGO EL PINAR,119,SANTIAGO EL PINAR,4,1126,580,546,43
CHIAPAS,7,SANTIAGO EL PINAR,119,SANTIAGO EL RELICARIO,2,53,25,28,3
CHIAPAS,7,CAPITÁN LUIS ÁNGEL VIDAL,120,AGUA TIBIA,3,30,12,18,3
CHIAPAS,7,CAPITÁN LUIS ÁNGEL VIDAL,120,BEJUCAL,3,65,34,31,4
CHIAPAS,7,CAPITÁN LUIS ÁNGEL VIDAL,120,CAPITÁN LUIS ÁNGEL VIDAL,4,351,179,172,14
CHIAPAS,7,CAPITÁN LUIS ÁNGEL VIDAL,120,CONCEPCIÓN PINADA,3,108,49,59,7
CHIAPAS,7,CAPITÁN LUIS ÁNGEL VIDAL,120,EL CANACAL (TOCANAQUE),1,11,5,6,1
CHIAPAS,7,CAPITÁN LUIS ÁNGEL VIDAL,120,EL PALMAR,2,104,49,55,5
CHIAPAS,7,CAPITÁN LUIS ÁNGEL VIDAL,120,LA LAGUNITA,2,24,10,14,2
CHIAPAS,7,CAPITÁN LUIS ÁNGEL VIDAL,120,LA LUCHA,3,46,20,26,3
CHIAPAS,7,CAPITÁN LUIS ÁNGEL VIDAL,120,LAS SALINAS,3,39,19,20,3
CHIAPAS,7,CAPITÁN LUIS ÁNGEL VIDAL,120,MATASANO,3,87,41,46,5
CHIAPAS,7,CAPITÁN LUIS ÁNGEL VIDAL,120,MATASANO DOS,2,37,21,16,2
CHIAPAS,7,CAPITÁN LUIS ÁNGEL VIDAL,120,NUEVA REFORMA LAS PILAS,2,55,24,31,4
CHIAPAS,7,CAPITÁN LUIS ÁNGEL VIDAL,120,NUEVO GUAYABAL,3,34,19,15,4
CHIAPAS,7,CAPITÁN LUIS ÁNGEL VIDAL,120,PIEDRA PARADA,3,77,42,35,3
CHIAPAS,7,CAPITÁN LUIS ÁNGEL VIDAL,120,RANCHO BONITO,4,149,84,65,11
CHIAPAS,7,CAPITÁN LUIS ÁNGEL VIDAL,120,SABINALITO,1,5,3,2,1
CHIAPAS,7,CAPITÁN LUIS ÁNGEL VIDAL,120,SANTA ISABEL ZIJÁN (LA FRAILESCA),4,83,42,41,4
CHIAPAS,7,CAPITÁN LUIS ÁNGEL VIDAL,120,SANTA MARÍA,3,77,44,33,5
CHIAPAS,7,CAPITÁN LUIS ÁNGEL VIDAL,120,VILLA REFORMA,2,21,11,10,2
CHIAPAS,7,RINCÓN CHAMULA SAN PEDRO,121,EL RINCONCITO,4,130,69,61,8
CHIAPAS,7,RINCÓN CHAMULA SAN PEDRO,121,LA FLORIDA,3,270,129,141,10
CHIAPAS,7,RINCÓN CHAMULA SAN PEDRO,121,RINCÓN CHAMULA,12,1997,1018,979,77
CHIAPAS,7,RINCÓN CHAMULA SAN PEDRO,121,SAN ANTONIO LOS PINOS,2,17,8,9,2
CHIAPAS,7,RINCÓN CHAMULA SAN PEDRO,121,SAN FELIPE,3,189,82,107,8
CHIAPAS,7,RINCÓN CHAMULA SAN PEDRO,121,SAN ISIDRO CIENEGUILLA,2,24,13,11,3
CHIAPAS,7,EL PARRAL,122,EL PARRAL,13,3243,1649,1594,142
CHIAPAS,7,EL PARRAL,122,EL RETIRO,1,20,9,11,2
CHIAPAS,7,EL PARRAL,122,GUADALUPE,3,56,22,34,5
CHIAPAS,7,EL PARRAL,122,JERICÓ (PORVENIR),3,718,360,358,23
CHIAPAS,7,EL PARRAL,122,LA LIBERTAD,3,29,19,10,4
CHIAPAS,7,EL PARRAL,122,LA NUEVA,1,18,7,11,2
CHIAPAS,7,EL PARRAL,122,LAS CRUCES,2,22,9,13,2
CHIAPAS,7,EL PARRAL,122,LAS PALMAS,2,12,3,9,1
CHIAPAS,7,EL PARRAL,122,OCOTAL LINDAVISTA,3,54,28,26,4
CHIAPAS,7,EL PARRAL,122,SAN JOSÉ DEL ALTO,2,14,3,11,1
CHIAPAS,7,EMILIANO ZAPATA,123,20 DE NOVIEMBRE,8,1878,946,932,90
CHIAPAS,7,EMILIANO ZAPATA,123,BELÉN DOS,4,63,34,29,6
CHIAPAS,7,EMILIANO ZAPATA,123,CENTRAL CAMPESINA CARDENISTA,1,17,12,5,2
CHIAPAS,7,EMILIANO ZAPATA,123,CRUZ CHIQUITA,2,80,34,46,4
CHIAPAS,7,EMILIANO ZAPATA,123,EL PORVENIR,1,47,20,27,2
CHIAPAS,7,EMILIANO ZAPATA,123,FAMILIA ALFARO,2,20,12,8,2
CHIAPAS,7,EMILIANO ZAPATA,123,JAVIER LÓPEZ MORENO (LAS PALOMAS),2,70,36,34,4
CHIAPAS,7,EMILIANO ZAPATA,123,JOSÉ MARÍA MORELOS Y PAVÓN,2,21,9,12,2
CHIAPAS,7,EMILIANO ZAPATA,123,LA NUEVA ESPERANZA,2,11,8,3,2
CHIAPAS,7,EMILIANO ZAPATA,123,LUIS ECHEVERRÍA ÁLVAREZ,4,224,115,109,13
CHIAPAS,7,EMILIANO ZAPATA,123,NUEVO POBLADO CONCEPCIÓN,2,46,25,21,3
CHIAPAS,7,EMILIANO ZAPATA,123,NUEVO SAN ISIDRO,1,7,3,4,1
CHIAPAS,7,EMILIANO ZAPATA,123,NUEVO VICENTE GUERRERO (EL CHICHONAL),4,610,309,301,27
CHIAPAS,7,EMILIANO ZAPATA,123,NUEVO VILLAHERMOSA,2,37,16,21,2
CHIAPAS,7,EMILIANO ZAPATA,123,SAN ISIDRO,1,26,12,14,1
CHIAPAS,7,EMILIANO ZAPATA,123,SAN PEDRO,3,57,30,27,6
CHIAPAS,7,MEZCALAPA,124,ACHIOTE,2,27,13,14,2
CHIAPAS,7,MEZCALAPA,124,ADOLFO LÓPEZ MATEOS,4,676,366,310,26
CHIAPAS,7,MEZCALAPA,124,ADOLFO LÓPEZ MATEOS KILÓMETRO 54,2,22,15,7,3
CHIAPAS,7,MEZCALAPA,124,ÁNGEL ALBINO CORZO,3,156,83,73,9
CHIAPAS,7,MEZCALAPA,124,BELISARIO DOMÍNGUEZ,2,138,69,69,7
CHIAPAS,7,MEZCALAPA,124,BENITO JUÁREZ LÁMINA UNO,3,82,43,39,4
CHIAPAS,7,MEZCALAPA,124,BENITO JUÁREZ VILLA RURAL,2,20,6,14,2
CHIAPAS,7,MEZCALAPA,124,BUENAVISTA,1,4,2,2,1
CHIAPAS,7,MEZCALAPA,124,CAMPAMENTO GENERAL EMILIANO ZAPATA,3,65,34,31,4
CHIAPAS,7,MEZCALAPA,124,CHINTULITO CAMPAMENTO,3,41,21,20,4
CHIAPAS,7,MEZCALAPA,124,CINCO DE MAYO,3,113,49,64,6
CHIAPAS,7,MEZCALAPA,124,EL DORADO,1,4,1,3,1
CHIAPAS,7,MEZCALAPA,124,EL ESTRECHO,2,14,6,8,2
CHIAPAS,7,MEZCALAPA,124,EL LIMÓN,1,10,7,3,1
CHIAPAS,7,MEZCALAPA,124,EL PROGRESO (CHINTUL),3,205,98,107,12
CHIAPAS,7,MEZCALAPA,124,EL SACRIFICIO,2,41,21,20,2
CHIAPAS,7,MEZCALAPA,124,ESPERANZA DE LOS POBRES,3,185,99,86,8
CHIAPAS,7,MEZCALAPA,124,FRANCISCO VILLA,3,44,21,23,4
CHIAPAS,7,MEZCALAPA,124,GENARO VÁZQUEZ ROJAS,3,53,33,20,4
CHIAPAS,7,MEZCALAPA,124,GUSTAVO DÍAZ ORDAZ,4,166,92,74,9
CHIAPAS,7,MEZCALAPA,124,JOSÉ LÓPEZ PORTILLO,2,44,17,27,2
CHIAPAS,7,MEZCALAPA,124,LA ALIANZA,4,192,85,107,11
CHIAPAS,7,MEZCALAPA,124,LA ESPERANZA,1,4,3,1,1
CHIAPAS,7,MEZCALAPA,124,LA FLORESTA,2,28,14,14,2
CHIAPAS,7,MEZCALAPA,124,LA FLORIDA UNO,1,16,8,8,1
CHIAPAS,7,MEZCALAPA,124,LA PRIMAVERA,2,20,8,12,2
CHIAPAS,7,MEZCALAPA,124,LA VENTA,2,50,23,27,2
CHIAPAS,7,MEZCALAPA,124,LA VICTORIA,3,29,14,15,3
CHIAPAS,7,MEZCALAPA,124,LAS ALMENDRAS,1,17,9,8,1
CHIAPAS,7,MEZCALAPA,124,LAS ARENAS (EL COROZO),1,4,4,0,1
CHIAPAS,7,MEZCALAPA,124,LÁZARO CÁRDENAS,4,176,76,100,9
CHIAPAS,7,MEZCALAPA,124,LOS DIAMANTES,3,35,17,18,3
CHIAPAS,7,MEZCALAPA,124,MIGUEL HIDALGO LÁMINAS CUATRO,2,96,42,54,5
CHIAPAS,7,MEZCALAPA,124,MIRAVALLE,3,31,18,13,3
CHIAPAS,7,MEZCALAPA,124,NUEVA ALIANZA,2,109,46,63,4
CHIAPAS,7,MEZCALAPA,124,NUEVA ESPERANZA,3,45,19,26,3
CHIAPAS,7,MEZCALAPA,124,NUEVO CHAPULTENANGO,5,96,41,55,6
CHIAPAS,7,MEZCALAPA,124,NUEVO LIMONCITO,2,16,5,11,2
CHIAPAS,7,MEZCALAPA,124,NUEVO MÉXICO,2,96,55,41,6
CHIAPAS,7,MEZCALAPA,124,PALESTINA,2,57,33,24,3
CHIAPAS,7,MEZCALAPA,124,PASCUAL DÍAZ,1,5,4,1,1
CHIAPAS,7,MEZCALAPA,124,PLAN DE AYALA,4,200,105,95,10
CHIAPAS,7,MEZCALAPA,124,RAUDALES MALPASO,21,2494,1279,1215,128
CHIAPAS,7,MEZCALAPA,124,REACOMODO NUEVO MÉXICO (KILÓMETRO 59),2,29,15,14,2
CHIAPAS,7,MEZCALAPA,124,RICARDO FLORES MAGÓN,1,16,8,8,1
CHIAPAS,7,MEZCALAPA,124,ROBERTO BARRIOS,2,56,25,31,3
CHIAPAS,7,MEZCALAPA,124,RÓMULO CALZADA (LA HERRADURA),4,780,397,383,33
CHIAPAS,7,MEZCALAPA,124,RUBÉN JARAMILLO,3,76,38,38,4
CHIAPAS,7,MEZCALAPA,124,SAL SI PUEDES,1,9,4,5,1
CHIAPAS,7,MEZCALAPA,124,SAN ANTONIO ACAMBAC (EL FAISÁN),2,56,29,27,3
CHIAPAS,7,MEZCALAPA,124,SAN FERNANDO DÍAZ (MARITANO),3,150,72,78,6
CHIAPAS,7,MEZCALAPA,124,SAN MARCOS,2,36,17,19,2
CHIAPAS,7,MEZCALAPA,124,SANTO DOMINGO,1,13,5,8,1
CHIAPAS,7,MEZCALAPA,124,SANTOS DEGOLLADO,1,122,64,58,5
CHIAPAS,7,MEZCALAPA,124,TIERRA Y LIBERTAD,2,63,29,34,3
CHIAPAS,7,MEZCALAPA,124,TRECE DE SEPTIEMBRE,3,47,25,22,5
CHIAPAS,7,MEZCALAPA,124,UNIÓN DEL PROGRESO,2,57,29,28,3
CHIAPAS,7,MEZCALAPA,124,VICENTE GUERRERO (DIQUE DOS),3,90,43,47,4
CHIAPAS,7,HONDURAS DE LA SIERRA,125,5 DE MAYO,2,67,36,31,3
CHIAPAS,7,HONDURAS DE LA SIERRA,125,ÁNGEL DÍAZ,3,215,119,96,10
CHIAPAS,7,HONDURAS DE LA SIERRA,125,BARRANCA HONDA,1,9,3,6,1
CHIAPAS,7,HONDURAS DE LA SIERRA,125,BELISARIO DOMÍNGUEZ,2,37,12,25,2
CHIAPAS,7,HONDURAS DE LA SIERRA,125,BENITO JUÁREZ,1,6,3,3,1
CHIAPAS,7,HONDURAS DE LA SIERRA,125,BUENOS AIRES,3,203,104,99,11
CHIAPAS,7,HONDURAS DE LA SIERRA,125,CAMPO AÉREO,2,68,29,39,4
CHIAPAS,7,HONDURAS DE LA SIERRA,125,CERRO PEROTE,3,75,37,38,7
CHIAPAS,7,HONDURAS DE LA SIERRA,125,CRUZ GRANDE,2,30,17,13,3
CHIAPAS,7,HONDURAS DE LA SIERRA,125,EL JOBAL,3,93,49,44,6
CHIAPAS,7,HONDURAS DE LA SIERRA,125,EL LETRERO,4,280,141,139,12
CHIAPAS,7,HONDURAS DE LA SIERRA,125,EL LIMÓN,1,12,9,3,1
CHIAPAS,7,HONDURAS DE LA SIERRA,125,EL MANGUITO,2,28,13,15,3
CHIAPAS,7,HONDURAS DE LA SIERRA,125,EL OASIS,2,17,9,8,2
CHIAPAS,7,HONDURAS DE LA SIERRA,125,EL PARAÍSO,3,41,18,23,4
CHIAPAS,7,HONDURAS DE LA SIERRA,125,EL TESORO,2,30,15,15,2
CHIAPAS,7,HONDURAS DE LA SIERRA,125,GRACIAS A DIOS,1,7,4,3,1
CHIAPAS,7,HONDURAS DE LA SIERRA,125,HONDURAS DE LA SIERRA,4,428,214,214,16
CHIAPAS,7,HONDURAS DE LA SIERRA,125,LA LAGUNA,3,57,37,20,4
CHIAPAS,7,HONDURAS DE LA SIERRA,125,LA PINADA,2,18,6,12,3
CHIAPAS,7,HONDURAS DE LA SIERRA,125,LA PINADA (FLOR DE CAFÉ),1,6,3,3,1
CHIAPAS,7,HONDURAS DE LA SIERRA,125,LA SOLEDAD,3,267,143,124,14
CHIAPAS,7,HONDURAS DE LA SIERRA,125,LA VEGA,1,8,3,5,1
CHIAPAS,7,HONDURAS DE LA SIERRA,125,LA VEGA UNO,1,24,10,14,2
CHIAPAS,7,HONDURAS DE LA SIERRA,125,LA VIOLETA,2,37,16,21,3
CHIAPAS,7,HONDURAS DE LA SIERRA,125,LAS DELICIAS,4,241,126,115,12
CHIAPAS,7,HONDURAS DE LA SIERRA,125,LAS FLORES (LOMA BONITA),2,35,17,18,3
CHIAPAS,7,HONDURAS DE LA SIERRA,125,LAS MORAS,3,232,106,126,13
CHIAPAS,7,HONDURAS DE LA SIERRA,125,LLANO GRANDE,4,340,164,176,12
CHIAPAS,7,HONDURAS DE LA SIERRA,125,LOMA BONITA,3,79,32,47,5
CHIAPAS,7,HONDURAS DE LA SIERRA,125,LOS ÁNGELES,1,7,5,2,1
CHIAPAS,7,HONDURAS DE LA SIERRA,125,LOS CIMIENTOS,1,9,4,5,1
CHIAPAS,7,HONDURAS DE LA SIERRA,125,MONTEBELLO,2,19,5,14,2
CHIAPAS,7,HONDURAS DE LA SIERRA,125,MONTEBELLO (PACAYALITO),3,70,38,32,6
CHIAPAS,7,HONDURAS DE LA SIERRA,125,NUEVA ARGENTINA,4,181,80,101,8
CHIAPAS,7,HONDURAS DE LA SIERRA,125,NUEVA JERUSALÉN,2,24,11,13,3
CHIAPAS,7,HONDURAS DE LA SIERRA,125,NUEVA LIBERTAD 2,3,111,58,53,6
CHIAPAS,7,HONDURAS DE LA SIERRA,125,NUEVA LUCHA,2,115,47,68,5
CHIAPAS,7,HONDURAS DE LA SIERRA,125,NUEVA REFORMA,1,11,7,4,1
CHIAPAS,7,HONDURAS DE LA SIERRA,125,PABLO GALEANA,4,269,128,141,13
CHIAPAS,7,HONDURAS DE LA SIERRA,125,PLAN DE AYALA,3,64,38,26,5
CHIAPAS,7,HONDURAS DE LA SIERRA,125,RANCHO BONITO,3,23,12,11,3
CHIAPAS,7,HONDURAS DE LA SIERRA,125,SAN ANTONIO GRANDE,2,25,15,10,2
CHIAPAS,7,HONDURAS DE LA SIERRA,125,SAN JOSÉ,2,23,14,9,2
CHIAPAS,7,HONDURAS DE LA SIERRA,125,SANTA ROSA,2,30,12,18,3
CHIAPAS,7,HONDURAS DE LA SIERRA,125,VEGA DE JUÁREZ,2,104,51,53,5
CHIAPAS,7,HONDURAS DE LA SIERRA,125,VERGEL EL NARANJO,2,28,13,15,2
CHIAPAS,7,HONDURAS DE LA SIERRA,125,VILLA MORELOS,4,197,96,101,11
CHIAPAS,7,HONDURAS DE LA SIERRA,125,VILLA NUEVA,3,29,14,15,4
CHIAPAS,7,HONDURAS DE LA SIERRA,125,VILLAFLORES,1,44,24,20,2
CHIHUAHUA,8,AHUMADA,001,ÁLAMOS DE PEÑA,3,126,69,57,9
CHIHUAHUA,8,AHUMADA,001,ATOTONILCO,3,32,21,11,4
CHIHUAHUA,8,AHUMADA,001,EJIDO ZARAGOZA,2,22,9,13,2
CHIHUAHUA,8,AHUMADA,001,LAS PLAYAS,3,60,31,29,5
CHIHUAHUA,8,AHUMADA,001,MIGUEL AHUMADA,13,2497,1268,1229,126
CHIHUAHUA,8,AHUMADA,001,OJO CALIENTE [COLONIA SECA],3,130,52,78,9
CHIHUAHUA,8,AHUMADA,001,RANCHO NUEVO,1,8,6,2,1
CHIHUAHUA,8,AHUMADA,001,SAN LORENCITO,3,124,64,60,6
CHIHUAHUA,8,AHUMADA,001,VILLA AHUMADA Y ANEXAS,2,43,23,20,2
CHIHUAHUA,8,ALDAMA,002,EL PORVENIR,3,363,156,207,18
CHIHUAHUA,8,ALDAMA,002,EL POTRERO DEL LLANO (PIEDRAS NEGRAS),1,2,2,0,1
CHIHUAHUA,8,ALDAMA,002,EMILIANO ZAPATA (SAN IGNACIO),3,58,31,27,5
CHIHUAHUA,8,ALDAMA,002,JUAN ALDAMA,26,5506,2711,2795,260
CHIHUAHUA,8,ALDAMA,002,LA MESA,2,321,133,188,15
CHIHUAHUA,8,ALDAMA,002,LOS LEONES,2,31,13,18,2
CHIHUAHUA,8,ALDAMA,002,LUIS L. LEÓN (EL GRANERO),1,5,2,3,1
CHIHUAHUA,8,ALDAMA,002,MACLOVIO HERRERA (ESTACIÓN FALOMIR),4,130,67,63,9
CHIHUAHUA,8,ALDAMA,002,PLACER DE GUADALUPE,3,31,19,12,4
CHIHUAHUA,8,ALDAMA,002,SAN DIEGO DE ALCALÁ,1,4,2,2,1
CHIHUAHUA,8,ALLENDE,003,COLONIA AGUA FRÍA,1,14,1,13,1
CHIHUAHUA,8,ALLENDE,003,COLONIA BÚFALO,4,136,72,64,9
CHIHUAHUA,8,ALLENDE,003,ESTACIÓN ADELA,1,11,6,5,1
CHIHUAHUA,8,ALLENDE,003,ESTACIÓN MORITA,2,29,16,13,3
CHIHUAHUA,8,ALLENDE,003,PUEBLITO DE ALLENDE,5,407,187,220,24
CHIHUAHUA,8,ALLENDE,003,SAN ANTONIO DEL ALTO CORRALEJO,1,44,22,22,4
CHIHUAHUA,8,ALLENDE,003,SAN JUAN DE ALLENDE,1,10,1,9,1
CHIHUAHUA,8,ALLENDE,003,TALAMANTES,3,47,20,27,4
CHIHUAHUA,8,ALLENDE,003,VALLE DE IGNACIO ALLENDE,7,1468,750,718,131
CHIHUAHUA,8,AQUILES SERDÁN,004,EL POZO ARTESIANO,1,18,11,7,1
CHIHUAHUA,8,AQUILES SERDÁN,004,SAN GUILLERMO (SANTA ELENA),4,870,432,438,37
CHIHUAHUA,8,AQUILES SERDÁN,004,SANTA EULALIA,19,4844,2378,2466,189
CHIHUAHUA,8,AQUILES SERDÁN,004,SANTO DOMINGO (FRANCISCO PORTILLO),1,23,10,13,1
CHIHUAHUA,8,ASCENSIÓN,005,ASCENSIÓN,17,3592,1865,1727,169
CHIHUAHUA,8,ASCENSIÓN,005,CASA VERDE,1,31,12,19,1
CHIHUAHUA,8,ASCENSIÓN,005,COLONIA MODELO,1,32,19,13,2
CHIHUAHUA,8,ASCENSIÓN,005,GUADALUPE VICTORIA,6,236,115,121,18
CHIHUAHUA,8,ASCENSIÓN,005,LEY SEIS DE ENERO,3,231,130,101,10
CHIHUAHUA,8,ASCENSIÓN,005,LEY SEIS DE ENERO (OJOS ALTOS),1,40,25,15,3
CHIHUAHUA,8,ASCENSIÓN,005,NIÑOS HÉROES DE CHAPULTEPEC,2,24,16,8,2
CHIHUAHUA,8,ASCENSIÓN,005,PALOMAS VIEJO,3,224,111,113,20
CHIHUAHUA,8,ASCENSIÓN,005,PUERTO PALOMAS DE VILLA,4,668,329,339,29
CHIHUAHUA,8,BACHÍNIVA,006,ABRAHAM GONZÁLEZ,2,50,25,25,3
CHIHUAHUA,8,BACHÍNIVA,006,BACHÍNIVA,7,730,360,370,44
CHIHUAHUA,8,BACHÍNIVA,006,EL PORVENIR,3,157,69,88,14
CHIHUAHUA,8,BACHÍNIVA,006,FRANCISCO I. MADERO,4,131,78,53,9
CHIHUAHUA,8,BACHÍNIVA,006,RANCHO COLORADO,1,8,5,3,1
CHIHUAHUA,8,BACHÍNIVA,006,SAN BLAS,2,50,29,21,3
CHIHUAHUA,8,BALLEZA,007,ADJUNTAS DE ARRIBA,3,73,45,28,4
CHIHUAHUA,8,BALLEZA,007,ARROYO DEL RANCHO,1,12,8,4,1
CHIHUAHUA,8,BALLEZA,007,ASERRADERO PILARES,1,10,6,4,1
CHIHUAHUA,8,BALLEZA,007,BACOCHI,1,19,9,10,1
CHIHUAHUA,8,BALLEZA,007,BAGUEACHI,3,193,91,102,9
CHIHUAHUA,8,BALLEZA,007,BAÑOS DE ARRIBA (SAN FRANCISCO),1,6,4,2,1
CHIHUAHUA,8,BALLEZA,007,BAQUIRIACHI,5,168,94,74,11
CHIHUAHUA,8,BALLEZA,007,BUENAVISTA,1,80,35,45,3
CHIHUAHUA,8,BALLEZA,007,CERRO COLORADO,1,19,10,9,1
CHIHUAHUA,8,BALLEZA,007,CHAHUEACHI,1,11,3,8,1
CHIHUAHUA,8,BALLEZA,007,CHALAYOTES,1,11,5,6,1
CHIHUAHUA,8,BALLEZA,007,CHIQUIHUITE,1,5,3,2,1
CHIHUAHUA,8,BALLEZA,007,CHURICHIQUE,1,16,4,12,1
CHIHUAHUA,8,BALLEZA,007,EJIDO EL VERGEL,5,540,268,272,24
CHIHUAHUA,8,BALLEZA,007,EJIDO GUAJOLOTES,4,103,52,51,10
CHIHUAHUA,8,BALLEZA,007,EJIDO GUAZARACHI,5,98,45,53,8
CHIHUAHUA,8,BALLEZA,007,EJIDO LA PINTA,3,77,37,40,5
CHIHUAHUA,8,BALLEZA,007,EL AGUAJE,3,37,24,13,4
CHIHUAHUA,8,BALLEZA,007,EL LLANO GRANDE,2,14,7,7,2
CHIHUAHUA,8,BALLEZA,007,EL PALOMO,2,75,36,39,3
CHIHUAHUA,8,BALLEZA,007,EL PORVENIR,1,22,8,14,1
CHIHUAHUA,8,BALLEZA,007,EL QUELITE,1,7,2,5,1
CHIHUAHUA,8,BALLEZA,007,EL TIGRE (CASITA DEL ALTO),3,18,6,12,3
CHIHUAHUA,8,BALLEZA,007,EL TRIGUEÑO,1,36,17,19,2
CHIHUAHUA,8,BALLEZA,007,EL VIGUEÑO [ASERRADERO],1,18,9,9,1
CHIHUAHUA,8,BALLEZA,007,GENERAL CARLOS PACHECO (EL TERRERO),5,212,104,108,13
CHIHUAHUA,8,BALLEZA,007,GUASACHIQUE,1,52,24,28,1
CHIHUAHUA,8,BALLEZA,007,LA CEBOLLA,3,70,30,40,4
CHIHUAHUA,8,BALLEZA,007,LA HACIENDITA,1,16,10,6,1
CHIHUAHUA,8,BALLEZA,007,LA JOYA,2,71,41,30,3
CHIHUAHUA,8,BALLEZA,007,LA LABORCITA,1,16,7,9,1
CHIHUAHUA,8,BALLEZA,007,LA LAGARTIJA,1,4,2,2,1
CHIHUAHUA,8,BALLEZA,007,LA LAGUNITA,1,51,28,23,2
CHIHUAHUA,8,BALLEZA,007,LA MAGDALENA,3,148,80,68,9
CHIHUAHUA,8,BALLEZA,007,LA NOPALERA (LA CUEVA NOPALERA),1,25,12,13,1
CHIHUAHUA,8,BALLEZA,007,LAGUNA JUANOTA,3,143,65,78,6
CHIHUAHUA,8,BALLEZA,007,LAS DELICIAS,2,84,44,40,5
CHIHUAHUA,8,BALLEZA,007,LOS ÁNGELES,2,19,9,10,2
CHIHUAHUA,8,BALLEZA,007,LOS BAJÍOS DE FÉLIX,1,19,7,12,1
CHIHUAHUA,8,BALLEZA,007,LOS LIRIOS,3,52,30,22,4
CHIHUAHUA,8,BALLEZA,007,LOS LLANITOS,3,88,53,35,5
CHIHUAHUA,8,BALLEZA,007,LOS PILARES,1,7,2,5,1
CHIHUAHUA,8,BALLEZA,007,MARIANO BALLEZA,10,974,519,455,67
CHIHUAHUA,8,BALLEZA,007,MESA BLANCA,1,30,17,13,2
CHIHUAHUA,8,BALLEZA,007,MESA DEL AGUA,1,7,3,4,1
CHIHUAHUA,8,BALLEZA,007,PICHIQUE,4,312,148,164,17
CHIHUAHUA,8,BALLEZA,007,PIEDRA AGUJERADA,1,18,6,12,1
CHIHUAHUA,8,BALLEZA,007,PIEDRA BOLA,1,31,14,17,2
CHIHUAHUA,8,BALLEZA,007,PUERTO TRES HERMANOS,2,13,4,9,1
CHIHUAHUA,8,BALLEZA,007,RANCHERÍA EL QUELITE,1,45,18,27,2
CHIHUAHUA,8,BALLEZA,007,RANCHERÍA GUACHAMOACHI,3,104,57,47,6
CHIHUAHUA,8,BALLEZA,007,RANCHERÍA PINALEJO,4,73,38,35,7
CHIHUAHUA,8,BALLEZA,007,RANCHITO DE SAN JUAN,2,47,22,25,3
CHIHUAHUA,8,BALLEZA,007,SAN ANTONIO DE ABAJO,1,15,11,4,1
CHIHUAHUA,8,BALLEZA,007,SAN ANTONIO DE ARRIBA,3,71,34,37,4
CHIHUAHUA,8,BALLEZA,007,SAN CARLOS,3,68,28,40,4
CHIHUAHUA,8,BALLEZA,007,SAN CRISTÓBAL,1,5,4,1,1
CHIHUAHUA,8,BALLEZA,007,SAN JOSÉ,1,83,32,51,3
CHIHUAHUA,8,BALLEZA,007,SAN JUAN,2,144,70,74,7
CHIHUAHUA,8,BALLEZA,007,SAN JUAN DE LOS ITURRALDE,3,53,26,27,4
CHIHUAHUA,8,BALLEZA,007,SAN RAFAEL,2,17,8,9,2
CHIHUAHUA,8,BALLEZA,007,TECORICHI,2,57,28,29,3
CHIHUAHUA,8,BALLEZA,007,TIERRA BLANCA,1,35,14,21,2
CHIHUAHUA,8,BALLEZA,007,TÓNACHI,3,86,36,50,5
CHIHUAHUA,8,BALLEZA,007,VALLE EL MANZANO,2,9,7,2,2
CHIHUAHUA,8,BATOPILAS DE MANUEL GÓMEZ MORÍN,008,ABOREACHI,4,94,41,53,7
CHIHUAHUA,8,BATOPILAS DE MANUEL GÓMEZ MORÍN,008,BACUSEACHI,2,12,7,5,2
CHIHUAHUA,8,BATOPILAS DE MANUEL GÓMEZ MORÍN,008,BAQUIREACHI,2,58,31,27,4
CHIHUAHUA,8,BATOPILAS DE MANUEL GÓMEZ MORÍN,008,BATOPILAS DE MANUEL GÓMEZ MORÍN,6,346,183,163,27
CHIHUAHUA,8,BATOPILAS DE MANUEL GÓMEZ MORÍN,008,BOCA DE ARROYO,2,21,11,10,2
CHIHUAHUA,8,BATOPILAS DE MANUEL GÓMEZ MORÍN,008,BOCOYBO (REPOGUEACHI),1,18,10,8,1
CHIHUAHUA,8,BATOPILAS DE MANUEL GÓMEZ MORÍN,008,CACHIHUICHI,1,7,2,5,1
CHIHUAHUA,8,BATOPILAS DE MANUEL GÓMEZ MORÍN,008,CARBONERAS,1,6,6,0,1
CHIHUAHUA,8,BATOPILAS DE MANUEL GÓMEZ MORÍN,008,CERRO COLORADO,2,15,7,8,2
CHIHUAHUA,8,BATOPILAS DE MANUEL GÓMEZ MORÍN,008,CHAPOTILLO,2,23,13,10,2
CHIHUAHUA,8,BATOPILAS DE MANUEL GÓMEZ MORÍN,008,CHINIVO,2,17,6,11,2
CHIHUAHUA,8,BATOPILAS DE MANUEL GÓMEZ MORÍN,008,COYACHIQUE,3,94,47,47,5
CHIHUAHUA,8,BATOPILAS DE MANUEL GÓMEZ MORÍN,008,CUCHIVERACHI,2,56,27,29,3
CHIHUAHUA,8,BATOPILAS DE MANUEL GÓMEZ MORÍN,008,EL ARENAL DE LA PALMA,2,26,12,14,2
CHIHUAHUA,8,BATOPILAS DE MANUEL GÓMEZ MORÍN,008,EL CUERVO,2,108,65,43,5
CHIHUAHUA,8,BATOPILAS DE MANUEL GÓMEZ MORÍN,008,EL MANZANO,1,6,2,4,1
CHIHUAHUA,8,BATOPILAS DE MANUEL GÓMEZ MORÍN,008,EL PANDITO,2,34,18,16,2
CHIHUAHUA,8,BATOPILAS DE MANUEL GÓMEZ MORÍN,008,EL PAPANTE,1,4,1,3,1
CHIHUAHUA,8,BATOPILAS DE MANUEL GÓMEZ MORÍN,008,EL POTRERO DE CASTILLO,1,16,5,11,1
CHIHUAHUA,8,BATOPILAS DE MANUEL GÓMEZ MORÍN,008,EL REFUGIO (RANCHERÍA),3,32,19,13,3
CHIHUAHUA,8,BATOPILAS DE MANUEL GÓMEZ MORÍN,008,EL RODEO,3,54,31,23,5
CHIHUAHUA,8,BATOPILAS DE MANUEL GÓMEZ MORÍN,008,GENTILES,1,35,17,18,2
CHIHUAHUA,8,BATOPILAS DE MANUEL GÓMEZ MORÍN,008,GUACAYVO,1,29,7,22,2
CHIHUAHUA,8,BATOPILAS DE MANUEL GÓMEZ MORÍN,008,GUAYACANCITO,2,47,27,20,2
CHIHUAHUA,8,BATOPILAS DE MANUEL GÓMEZ MORÍN,008,JESÚS MARÍA,3,38,22,16,3
CHIHUAHUA,8,BATOPILAS DE MANUEL GÓMEZ MORÍN,008,KIRARE,3,118,62,56,5
CHIHUAHUA,8,BATOPILAS DE MANUEL GÓMEZ MORÍN,008,LA BOCA DEL ARROYO,1,36,19,17,2
CHIHUAHUA,8,BATOPILAS DE MANUEL GÓMEZ MORÍN,008,LA CAÑA,3,57,37,20,4
CHIHUAHUA,8,BATOPILAS DE MANUEL GÓMEZ MORÍN,008,LA GAVILANA,2,59,26,33,3
CHIHUAHUA,8,BATOPILAS DE MANUEL GÓMEZ MORÍN,008,LA LABOR,2,30,12,18,3
CHIHUAHUA,8,BATOPILAS DE MANUEL GÓMEZ MORÍN,008,LA PALMA,3,45,24,21,4
CHIHUAHUA,8,BATOPILAS DE MANUEL GÓMEZ MORÍN,008,LA SIERRITA DE BARRAZA (CASA QUEMADA),3,9,4,5,2
CHIHUAHUA,8,BATOPILAS DE MANUEL GÓMEZ MORÍN,008,LA SOMBRA,2,21,11,10,4
CHIHUAHUA,8,BATOPILAS DE MANUEL GÓMEZ MORÍN,008,LAS BREAS,2,38,25,13,2
CHIHUAHUA,8,BATOPILAS DE MANUEL GÓMEZ MORÍN,008,LAS JUNTAS,1,5,3,2,1
CHIHUAHUA,8,BATOPILAS DE MANUEL GÓMEZ MORÍN,008,LOS PARAJES,2,33,20,13,4
CHIHUAHUA,8,BATOPILAS DE MANUEL GÓMEZ MORÍN,008,MESA DE BUENAVISTA,1,5,3,2,1
CHIHUAHUA,8,BATOPILAS DE MANUEL GÓMEZ MORÍN,008,MESA DE GUACAYVO,2,17,10,7,2
CHIHUAHUA,8,BATOPILAS DE MANUEL GÓMEZ MORÍN,008,MESA DE LA YERBABUENA,5,159,88,71,12
CHIHUAHUA,8,BATOPILAS DE MANUEL GÓMEZ MORÍN,008,MEZQUITE,2,12,7,5,2
CHIHUAHUA,8,BATOPILAS DE MANUEL GÓMEZ MORÍN,008,MUNERACHI,4,211,95,116,11
CHIHUAHUA,8,BATOPILAS DE MANUEL GÓMEZ MORÍN,008,NOINA,1,44,26,18,2
CHIHUAHUA,8,BATOPILAS DE MANUEL GÓMEZ MORÍN,008,PITORREAL,2,11,7,4,2
CHIHUAHUA,8,BATOPILAS DE MANUEL GÓMEZ MORÍN,008,POLANCO (RANCHERÍA MINERAL POLANCO),4,178,98,80,14
CHIHUAHUA,8,BATOPILAS DE MANUEL GÓMEZ MORÍN,008,RANCHERÍA GÜITOCHI,1,36,10,26,2
CHIHUAHUA,8,BATOPILAS DE MANUEL GÓMEZ MORÍN,008,RANCHITO DE BÁEZ,1,4,2,2,1
CHIHUAHUA,8,BATOPILAS DE MANUEL GÓMEZ MORÍN,008,RECUBIRACHI,2,39,22,17,2
CHIHUAHUA,8,BATOPILAS DE MANUEL GÓMEZ MORÍN,008,ROCAGUACHI,2,60,31,29,3
CHIHUAHUA,8,BATOPILAS DE MANUEL GÓMEZ MORÍN,008,SAHUE,1,15,8,7,1
CHIHUAHUA,8,BATOPILAS DE MANUEL GÓMEZ MORÍN,008,SALVIAL,1,18,11,7,1
CHIHUAHUA,8,BATOPILAS DE MANUEL GÓMEZ MORÍN,008,SAN IGNACIO,4,136,79,57,7
CHIHUAHUA,8,BATOPILAS DE MANUEL GÓMEZ MORÍN,008,SAN JOSÉ DE COLIMA,3,64,36,28,4
CHIHUAHUA,8,BATOPILAS DE MANUEL GÓMEZ MORÍN,008,SAN JOSÉ DE VALENZUELA,3,82,50,32,5
CHIHUAHUA,8,BATOPILAS DE MANUEL GÓMEZ MORÍN,008,SAN JUAN DE DIOS (AGUA CALIENTE),2,33,17,16,3
CHIHUAHUA,8,BATOPILAS DE MANUEL GÓMEZ MORÍN,008,SANTA GERTRUDIS,1,16,6,10,1
CHIHUAHUA,8,BATOPILAS DE MANUEL GÓMEZ MORÍN,008,SANTA INÉS,3,12,7,5,3
CHIHUAHUA,8,BATOPILAS DE MANUEL GÓMEZ MORÍN,008,SANTA RITA,4,137,68,69,7
CHIHUAHUA,8,BATOPILAS DE MANUEL GÓMEZ MORÍN,008,SATEVÓ,3,51,26,25,4
CHIHUAHUA,8,BATOPILAS DE MANUEL GÓMEZ MORÍN,008,SONIRACHI,1,42,25,17,2
CHIHUAHUA,8,BATOPILAS DE MANUEL GÓMEZ MORÍN,008,SORICHIQUE,3,146,78,68,6
CHIHUAHUA,8,BATOPILAS DE MANUEL GÓMEZ MORÍN,008,TASAJISA,1,30,15,15,2
CHIHUAHUA,8,BATOPILAS DE MANUEL GÓMEZ MORÍN,008,YAGÜIRACHI,2,83,50,33,4
CHIHUAHUA,8,BATOPILAS DE MANUEL GÓMEZ MORÍN,008,YOQUIVO,6,255,125,130,16
CHIHUAHUA,8,BOCOYNA,009,ARACOYVO,1,23,12,11,1
CHIHUAHUA,8,BOCOYNA,009,BABUREACHI (EL DOCE),2,16,9,7,2
CHIHUAHUA,8,BOCOYNA,009,BAHUINOCACHI,3,97,50,47,8
CHIHUAHUA,8,BOCOYNA,009,BARABAGUACHI,1,9,4,5,3
CHIHUAHUA,8,BOCOYNA,009,BOCOYNA,6,253,117,136,19
CHIHUAHUA,8,BOCOYNA,009,CAHUIRARE,1,39,17,22,2
CHIHUAHUA,8,BOCOYNA,009,CHOGUITA,3,124,64,60,8
CHIHUAHUA,8,BOCOYNA,009,CIÉNEGA DE GUACAYVO,1,13,5,8,1
CHIHUAHUA,8,BOCOYNA,009,COMUNIDAD EL GUAJOLOTE,1,17,12,5,1
CHIHUAHUA,8,BOCOYNA,009,CREEL,16,2438,1364,1074,151
CHIHUAHUA,8,BOCOYNA,009,EL GUAJOLOTE,1,5,1,4,1
CHIHUAHUA,8,BOCOYNA,009,EL RANCHITO,5,80,37,43,6
CHIHUAHUA,8,BOCOYNA,009,EL SALTO,1,17,9,8,1
CHIHUAHUA,8,BOCOYNA,009,EL YEPOSO,2,21,12,9,2
CHIHUAHUA,8,BOCOYNA,009,ESTACIÓN PITORREAL,3,85,37,48,5
CHIHUAHUA,8,BOCOYNA,009,GASISUCHI (SAYAHUACHI),2,37,19,18,3
CHIHUAHUA,8,BOCOYNA,009,GONOGOCHI,4,136,59,77,11
CHIHUAHUA,8,BOCOYNA,009,GUAJURANA,3,91,44,47,5
CHIHUAHUA,8,BOCOYNA,009,GUTEACHI (GUTECHI),1,37,16,21,2
CHIHUAHUA,8,BOCOYNA,009,HOJASICHI,3,102,47,55,6
CHIHUAHUA,8,BOCOYNA,009,HUACHABETAVO,3,50,21,29,5
CHIHUAHUA,8,BOCOYNA,009,HUETOSACACHI,5,162,81,81,12
CHIHUAHUA,8,BOCOYNA,009,HUICORACHI,1,32,16,16,2
CHIHUAHUA,8,BOCOYNA,009,HUIYOCHI,2,54,24,30,3
CHIHUAHUA,8,BOCOYNA,009,HUMIRA,1,3,2,1,1
CHIHUAHUA,8,BOCOYNA,009,KILÓMETRO SETENTA Y NUEVE,2,19,10,9,3
CHIHUAHUA,8,BOCOYNA,009,LA LAGUNA,2,40,17,23,3
CHIHUAHUA,8,BOCOYNA,009,LA TINAJA,2,115,49,66,8
CHIHUAHUA,8,BOCOYNA,009,LAS AGUJAS,2,21,10,11,3
CHIHUAHUA,8,BOCOYNA,009,LOS OJITOS,3,76,38,38,4
CHIHUAHUA,8,BOCOYNA,009,MESA DE RECAÍNA,2,29,13,16,3
CHIHUAHUA,8,BOCOYNA,009,NAQUEACHI (LOS TAPANCOS),2,10,5,5,2
CHIHUAHUA,8,BOCOYNA,009,OCOROCHI (GUAGUIRARE),1,21,6,15,1
CHIHUAHUA,8,BOCOYNA,009,OJO DEL BUEY,1,5,3,2,1
CHIHUAHUA,8,BOCOYNA,009,OSACHI,1,23,10,13,1
CHIHUAHUA,8,BOCOYNA,009,PANALACHI,5,198,99,99,14
CHIHUAHUA,8,BOCOYNA,009,RANCHERÍA GUIPÍTARE,2,37,20,17,3
CHIHUAHUA,8,BOCOYNA,009,REPECHIQUE,1,25,12,13,1
CHIHUAHUA,8,BOCOYNA,009,RIQUINAPUCHI,1,16,8,8,1
CHIHUAHUA,8,BOCOYNA,009,RITUCHI,2,51,30,21,3
CHIHUAHUA,8,BOCOYNA,009,ROCHIVO,3,123,53,70,8
CHIHUAHUA,8,BOCOYNA,009,ROGUERACHI,3,57,28,29,4
CHIHUAHUA,8,BOCOYNA,009,SAGOACHI,3,66,32,34,5
CHIHUAHUA,8,BOCOYNA,009,SAN ANTONIO,2,50,22,28,3
CHIHUAHUA,8,BOCOYNA,009,SAN IGNACIO DE ARARECO,3,280,155,125,13
CHIHUAHUA,8,BOCOYNA,009,SAN JOSÉ DE GUACAYVO,4,188,87,101,11
CHIHUAHUA,8,BOCOYNA,009,SAN JUANITO,24,2567,1332,1235,169
CHIHUAHUA,8,BOCOYNA,009,SAN LUIS DE MAJIMACHI,3,95,47,48,6
CHIHUAHUA,8,BOCOYNA,009,SANTA ELENA,2,56,29,27,3
CHIHUAHUA,8,BOCOYNA,009,SEHUERACHI (CIÉNEGA DEL TÁSCATE),2,38,21,17,3
CHIHUAHUA,8,BOCOYNA,009,SEMOCHICHI (SAMACHIQUE),1,9,7,2,1
CHIHUAHUA,8,BOCOYNA,009,SISOGUICHI,8,604,354,250,44
CHIHUAHUA,8,BOCOYNA,009,SOJAHUACHI,4,134,71,63,8
CHIHUAHUA,8,BOCOYNA,009,TALAYOTES (TALAYOTES DE LOS VOLCANES),2,29,16,13,2
CHIHUAHUA,8,BOCOYNA,009,TALLARACHI,3,58,34,24,4
CHIHUAHUA,8,BOCOYNA,009,TOTORI (TUCHIRSO),2,13,8,5,2
CHIHUAHUA,8,BOCOYNA,009,TUCHEACHI,2,28,16,12,2
CHIHUAHUA,8,BUENAVENTURA,010,CARBAJAL,1,25,9,16,2
CHIHUAHUA,8,BUENAVENTURA,010,COLONIA EL VALLE,2,58,32,26,11
CHIHUAHUA,8,BUENAVENTURA,010,CONSTITUCIÓN,6,659,341,318,32
CHIHUAHUA,8,BUENAVENTURA,010,EJIDO BENITO JUÁREZ,9,1607,819,788,91
CHIHUAHUA,8,BUENAVENTURA,010,EL PROGRESO,3,73,32,41,5
CHIHUAHUA,8,BUENAVENTURA,010,FLORES MAGÓN,6,744,357,387,48
CHIHUAHUA,8,BUENAVENTURA,010,LERDO DE TEJADA (SAN ISIDRO),2,25,8,17,2
CHIHUAHUA,8,BUENAVENTURA,010,PRIMERO DE MAYO (SAN FRANCISCO),3,34,15,19,4
CHIHUAHUA,8,BUENAVENTURA,010,RODRIGO M. QUEVEDO,4,381,183,198,19
CHIHUAHUA,8,BUENAVENTURA,010,SAN BUENAVENTURA,11,1874,956,918,95
CHIHUAHUA,8,BUENAVENTURA,010,SAN LORENZO,4,170,81,89,13
CHIHUAHUA,8,CAMARGO,011,ALTA VISTA,4,165,81,84,11
CHIHUAHUA,8,CAMARGO,011,CUATRO MILPAS,1,81,41,40,3
CHIHUAHUA,8,CAMARGO,011,EJIDO LAS CUEVAS,1,13,7,6,1
CHIHUAHUA,8,CAMARGO,011,EL MOLINO,1,14,5,9,2
CHIHUAHUA,8,CAMARGO,011,EL PORVENIR,2,33,20,13,3
CHIHUAHUA,8,CAMARGO,011,EL TECUÁN,2,75,36,39,5
CHIHUAHUA,8,CAMARGO,011,ESTACIÓN DÍAZ (EJIDO SAN LEONARDO),2,20,12,8,2
CHIHUAHUA,8,CAMARGO,011,FLOREÑO,2,33,10,23,4
CHIHUAHUA,8,CAMARGO,011,LA ENRAMADA,3,48,23,25,5
CHIHUAHUA,8,CAMARGO,011,LA GLORIA,2,9,3,6,2
CHIHUAHUA,8,CAMARGO,011,LA LAGUNA,2,49,25,24,4
CHIHUAHUA,8,CAMARGO,011,LA LAGUNA DE LAS VACAS (SAN ISIDRO),2,43,18,25,3
CHIHUAHUA,8,CAMARGO,011,LA PERLA,4,57,27,30,10
CHIHUAHUA,8,CAMARGO,011,LAREÑO,1,54,26,28,3
CHIHUAHUA,8,CAMARGO,011,LEYES DE REFORMA,3,82,43,39,6
CHIHUAHUA,8,CAMARGO,011,LOS REYES,1,21,8,13,1
CHIHUAHUA,8,CAMARGO,011,MARAVILLAS,2,32,14,18,2
CHIHUAHUA,8,CAMARGO,011,ORTEGUEÑO,1,16,7,9,1
CHIHUAHUA,8,CAMARGO,011,RÍO DEL PARRAL (LA NORIA),1,4,1,3,1
CHIHUAHUA,8,CAMARGO,011,SAN IGNACIO,3,132,57,75,8
CHIHUAHUA,8,CAMARGO,011,SAN JOSÉ DEL PARRALITO,1,17,9,8,1
CHIHUAHUA,8,CAMARGO,011,SANTA ROSALÍA DE CAMARGO,56,12031,6083,5948,734
CHIHUAHUA,8,CARICHÍ,012,ARROYO DEL AGUA,2,7,3,4,2
CHIHUAHUA,8,CARICHÍ,012,BACABUREACHI,3,110,47,63,7
CHIHUAHUA,8,CARICHÍ,012,CARICHÍ,8,612,353,259,31
CHIHUAHUA,8,CARICHÍ,012,CHINEACHI,1,39,17,22,2
CHIHUAHUA,8,CARICHÍ,012,CIÉNEGA DE OJOS AZULES,4,260,136,124,13
CHIHUAHUA,8,CARICHÍ,012,COLONIA BUENAVISTA,1,24,14,10,1
CHIHUAHUA,8,CARICHÍ,012,EL ÁLAMO DE OJOS AZULES,2,12,4,8,2
CHIHUAHUA,8,CARICHÍ,012,EL CONSUELO,2,14,9,5,2
CHIHUAHUA,8,CARICHÍ,012,EL MANZANO,1,10,7,3,1
CHIHUAHUA,8,CARICHÍ,012,HUAHUACHÉRARE,3,198,109,89,9
CHIHUAHUA,8,CARICHÍ,012,MAGULLACHI,2,21,9,12,2
CHIHUAHUA,8,CARICHÍ,012,MOLINARES,1,12,4,8,1
CHIHUAHUA,8,CARICHÍ,012,NAPUCHI,1,37,20,17,2
CHIHUAHUA,8,CARICHÍ,012,NARÁRACHI,3,171,85,86,8
CHIHUAHUA,8,CARICHÍ,012,NOROGACHITO (NOROGACHI),1,7,4,3,1
CHIHUAHUA,8,CARICHÍ,012,RANCHERÍA TECUBICHI,2,57,32,25,3
CHIHUAHUA,8,CARICHÍ,012,ROMIGACHI (ROMARACHI),1,38,23,15,2
CHIHUAHUA,8,CARICHÍ,012,SAN JOSÉ BAQUEACHI,4,149,71,78,9
CHIHUAHUA,8,CARICHÍ,012,TAJIRACHI,3,44,26,18,5
CHIHUAHUA,8,CARICHÍ,012,TEHUERICHI,2,147,79,68,7
CHIHUAHUA,8,CARICHÍ,012,YEPO (HUEPO),1,18,7,11,1
CHIHUAHUA,8,CASAS GRANDES,013,CASAS GRANDES,9,2439,1237,1202,203
CHIHUAHUA,8,CASAS GRANDES,013,COLONIA CUAUHTÉMOC,3,56,30,26,4
CHIHUAHUA,8,CASAS GRANDES,013,COLONIA JUÁREZ,6,624,298,326,36
CHIHUAHUA,8,CASAS GRANDES,013,EJIDO HERNÁNDEZ (JOBALES),2,25,10,15,2
CHIHUAHUA,8,CASAS GRANDES,013,EJIDO IGNACIO ZARAGOZA (EL WILLY),4,64,35,29,7
CHIHUAHUA,8,CASAS GRANDES,013,EJIDO VICENTE GUERRERO (VALLE SECO),1,7,3,4,1
CHIHUAHUA,8,CASAS GRANDES,013,GUADALUPE VICTORIA,3,777,405,372,81
CHIHUAHUA,8,CASAS GRANDES,013,JUAN MATA ORTÍZ (PEARSON),3,177,91,86,11
CHIHUAHUA,8,CASAS GRANDES,013,LEONA VICARIO,1,9,4,5,1
CHIHUAHUA,8,CASAS GRANDES,013,SAN JOSÉ,2,13,7,6,2
CHIHUAHUA,8,CASAS GRANDES,013,SECCIÓN ENRÍQUEZ,5,144,79,65,11
CHIHUAHUA,8,CORONADO,014,EMILIANO ZAPATA,2,28,12,16,3
CHIHUAHUA,8,CORONADO,014,ITURRALDE (EL ORIENTE),1,7,4,3,1
CHIHUAHUA,8,CORONADO,014,JOSÉ ESTEBAN CORONADO,4,334,181,153,18
CHIHUAHUA,8,COYAME DEL SOTOL,015,EL MIMBRE,2,5,4,1,1
CHIHUAHUA,8,COYAME DEL SOTOL,015,LA CUESTA DE MUÑIZ,2,5,4,1,1
CHIHUAHUA,8,COYAME DEL SOTOL,015,LA PAZ DE MÉXICO,1,15,5,10,1
CHIHUAHUA,8,COYAME DEL SOTOL,015,SAN PEDRO,3,49,25,24,3
CHIHUAHUA,8,COYAME DEL SOTOL,015,SANTIAGO DE COYAME,4,212,107,105,12
CHIHUAHUA,8,LA CRUZ,016,CORRALEÑO DE JUÁREZ,3,78,39,39,5
CHIHUAHUA,8,LA CRUZ,016,LA CRUZ,7,589,259,330,35
CHIHUAHUA,8,LA CRUZ,016,SAN RAFAEL,2,51,24,27,4
CHIHUAHUA,8,CUAUHTÉMOC,017,ANÁHUAC [CUENCA LECHERA],1,22,12,10,1
CHIHUAHUA,8,CUAUHTÉMOC,017,BUSTILLOS,3,301,146,155,18
CHIHUAHUA,8,CUAUHTÉMOC,017,CAMPO 101,1,204,88,116,12
CHIHUAHUA,8,CUAUHTÉMOC,017,CAMPO NÚMERO CIENTO SEIS,3,1048,504,544,51
CHIHUAHUA,8,CUAUHTÉMOC,017,CASA COLORADA,2,51,27,24,3
CHIHUAHUA,8,CUAUHTÉMOC,017,CASA COLORADA DE ABAJO,1,39,14,25,2
CHIHUAHUA,8,CUAUHTÉMOC,017,COLONIA ANÁHUAC,14,2076,1026,1050,103
CHIHUAHUA,8,CUAUHTÉMOC,017,COLONIA OBREGÓN (RUBIO),9,1847,956,891,96
CHIHUAHUA,8,CUAUHTÉMOC,017,CUAUHTÉMOC,173,37467,19242,18225,2014
CHIHUAHUA,8,CUAUHTÉMOC,017,EJIDO EL LLORÓN,2,17,4,13,2
CHIHUAHUA,8,CUAUHTÉMOC,017,EJIDO PROGRESO (SAN IGNACIO),3,116,58,58,6
CHIHUAHUA,8,CUAUHTÉMOC,017,GRANJAS EL VENADO,1,17,12,5,1
CHIHUAHUA,8,CUAUHTÉMOC,017,GUADALUPE VICTORIA (SANTA LUCÍA),1,9,4,5,1
CHIHUAHUA,8,CUAUHTÉMOC,017,LA QUEMADA,4,339,175,164,18
CHIHUAHUA,8,CUAUHTÉMOC,017,LA UNIÓN CAMPESINA,1,27,10,17,2
CHIHUAHUA,8,CUAUHTÉMOC,017,LÁZARO CÁRDENAS,4,214,108,106,14
CHIHUAHUA,8,CUAUHTÉMOC,017,MAURILIO ORTÍZ,2,11,5,6,2
CHIHUAHUA,8,CUAUHTÉMOC,017,MIGUEL CHIQUITO,3,31,10,21,4
CHIHUAHUA,8,CUAUHTÉMOC,017,MORELOS,2,59,25,34,3
CHIHUAHUA,8,CUAUHTÉMOC,017,NAPAVECHI,3,127,71,56,7
CHIHUAHUA,8,CUAUHTÉMOC,017,NUEVO ZARAGOZA (LOS ADOBES),2,20,7,13,2
CHIHUAHUA,8,CUAUHTÉMOC,017,ZAMALOAPAN (PÉNJAMO),1,8,5,3,1
CHIHUAHUA,8,CUSIHUIRIACHI,018,BAJÍO DE ABAJO,1,8,4,4,1
CHIHUAHUA,8,CUSIHUIRIACHI,018,CAPILLA DE LOS REMEDIOS,2,55,30,25,2
CHIHUAHUA,8,CUSIHUIRIACHI,018,CARBAJAL DE ARRIBA,1,6,4,2,1
CHIHUAHUA,8,CUSIHUIRIACHI,018,CERRO PRIETO DE ARRIBA,3,127,70,57,14
CHIHUAHUA,8,CUSIHUIRIACHI,018,CHOPEQUE,3,67,21,46,4
CHIHUAHUA,8,CUSIHUIRIACHI,018,COLONIA CUSI (OJO DE AGUA),4,309,166,143,16
CHIHUAHUA,8,CUSIHUIRIACHI,018,LLANOS DE REFORMA,1,5,1,4,1
CHIHUAHUA,8,CUSIHUIRIACHI,018,LOS ÁLAMOS DE CERRO PRIETO,3,87,46,41,7
CHIHUAHUA,8,CUSIHUIRIACHI,018,RANCHO DE GONZÁLEZ,1,6,3,3,1
CHIHUAHUA,8,CUSIHUIRIACHI,018,SAN BERNABÉ,3,212,96,116,11
CHIHUAHUA,8,CUSIHUIRIACHI,018,SANTA RITA,1,16,8,8,1
CHIHUAHUA,8,CHIHUAHUA,019,CHIHUAHUA,1102,263143,133856,129287,17246
CHIHUAHUA,8,CHIHUAHUA,019,CIÉNEGA DE ORTÍZ (BOCA DE CIÉNEGA),1,82,46,36,6
CHIHUAHUA,8,CHIHUAHUA,019,COLONIA AGRÍCOLA FRANCISCO VILLA,4,853,394,459,34
CHIHUAHUA,8,CHIHUAHUA,019,COLONIA CUAUHTÉMOC (PUNTA DE AGUA),1,6,4,2,1
CHIHUAHUA,8,CHIHUAHUA,019,COLONIA NUEVO DELICIAS,4,416,206,210,21
CHIHUAHUA,8,CHIHUAHUA,019,COLONIA OCAMPO (HACIENDA EL TORREÓN),4,682,359,323,31
CHIHUAHUA,8,CHIHUAHUA,019,COLONIA SOTO,1,20,9,11,2
CHIHUAHUA,8,CHIHUAHUA,019,CUMBRES DE SACRAMENTO,2,33,14,19,3
CHIHUAHUA,8,CHIHUAHUA,019,EJIDO ESTACIÓN TERRAZAS Y MINAS DEL COBRE,2,63,24,39,4
CHIHUAHUA,8,CHIHUAHUA,019,EJIDO NUEVO SACRAMENTO,2,125,55,70,7
CHIHUAHUA,8,CHIHUAHUA,019,EL CHARCO,4,368,170,198,19
CHIHUAHUA,8,CHIHUAHUA,019,EL FRESNO,1,16,10,6,2
CHIHUAHUA,8,CHIHUAHUA,019,EL NOGALITO,1,271,131,140,12
CHIHUAHUA,8,CHIHUAHUA,019,EL PORVENIR,1,137,71,66,7
CHIHUAHUA,8,CHIHUAHUA,019,EL SAUZ,2,148,63,85,8
CHIHUAHUA,8,CHIHUAHUA,019,GUADALUPE,1,185,88,97,7
CHIHUAHUA,8,CHIHUAHUA,019,LA CASITA,2,24,6,18,2
CHIHUAHUA,8,CHIHUAHUA,019,LA ESPERANZA,3,68,37,31,5
CHIHUAHUA,8,CHIHUAHUA,019,RANCHO ENMEDIO (ESTACIÓN MÜLLER),2,142,66,76,7
CHIHUAHUA,8,CHIHUAHUA,019,SIERRA AZUL (LA COLORADA),2,170,94,76,8
CHIHUAHUA,8,CHÍNIPAS,020,BENJAMÍN M. CHAPARRO (SANTA ANA),3,53,25,28,4
CHIHUAHUA,8,CHÍNIPAS,020,BORIEGACHI,2,22,10,12,2
CHIHUAHUA,8,CHÍNIPAS,020,CANELAS,1,16,10,6,1
CHIHUAHUA,8,CHÍNIPAS,020,CHÍNIPAS DE ALMADA,9,835,418,417,48
CHIHUAHUA,8,CHÍNIPAS,020,COLONIA MONTENEGRO (SAN ANTONIO),2,32,22,10,2
CHIHUAHUA,8,CHÍNIPAS,020,EL LIMÓN,2,62,27,35,5
CHIHUAHUA,8,CHÍNIPAS,020,EL TRIGO DE RUSSO (EL TRIGO),1,6,4,2,1
CHIHUAHUA,8,CHÍNIPAS,020,EL TRIGUITO,2,14,8,6,2
CHIHUAHUA,8,CHÍNIPAS,020,GOROGACHI,3,52,36,16,3
CHIHUAHUA,8,CHÍNIPAS,020,GUADALUPE VICTORIA,3,76,33,43,5
CHIHUAHUA,8,CHÍNIPAS,020,GUASACHI,3,74,36,38,4
CHIHUAHUA,8,CHÍNIPAS,020,GUAZIZACO,3,57,28,29,4
CHIHUAHUA,8,CHÍNIPAS,020,GUERRA AL TIRANO (LA VINATA),2,25,13,12,2
CHIHUAHUA,8,CHÍNIPAS,020,IGNACIO VALENZUELA LAGARDA (LORETO),4,205,102,103,14
CHIHUAHUA,8,CHÍNIPAS,020,LA CUMBRE,1,17,7,10,1
CHIHUAHUA,8,CHÍNIPAS,020,LA LOBERA,1,16,5,11,1
CHIHUAHUA,8,CHÍNIPAS,020,LA MISIÓN DE GUADALUPE,1,13,5,8,1
CHIHUAHUA,8,CHÍNIPAS,020,LA REFORMA,1,6,5,1,1
CHIHUAHUA,8,CHÍNIPAS,020,LAS CHINACAS,4,96,51,45,7
CHIHUAHUA,8,CHÍNIPAS,020,LAS TUNAS,1,9,3,6,1
CHIHUAHUA,8,CHÍNIPAS,020,LOS DESFILADEROS,2,22,8,14,2
CHIHUAHUA,8,CHÍNIPAS,020,LOS LLANITOS,4,37,19,18,5
CHIHUAHUA,8,CHÍNIPAS,020,MESA DE ZAMORANO,1,17,7,10,1
CHIHUAHUA,8,CHÍNIPAS,020,MILPILLAS,4,241,117,124,14
CHIHUAHUA,8,CHÍNIPAS,020,ORIVO,1,93,41,52,3
CHIHUAHUA,8,CHÍNIPAS,020,PALMAREJO,4,155,78,77,12
CHIHUAHUA,8,CHÍNIPAS,020,SAN ANTONIO,1,18,9,9,1
CHIHUAHUA,8,CHÍNIPAS,020,SAN RAFAEL DE ORIVO,2,26,11,15,2
CHIHUAHUA,8,CHÍNIPAS,020,YECAROMA,2,30,18,12,2
CHIHUAHUA,8,DELICIAS,021,COLONIA ABRAHAM GONZÁLEZ (LA QUEMADA),4,313,148,165,16
CHIHUAHUA,8,DELICIAS,021,COLONIA ARMENDÁRIZ,2,55,27,28,7
CHIHUAHUA,8,DELICIAS,021,COLONIA CAMPESINA,5,453,216,237,25
CHIHUAHUA,8,DELICIAS,021,COLONIA CUAUHTÉMOC,2,75,34,41,4
CHIHUAHUA,8,DELICIAS,021,COLONIA EL ALAMITO,3,73,35,38,7
CHIHUAHUA,8,DELICIAS,021,COLONIA FRANCISCO I. MADERO (LA GOMEÑA),1,35,15,20,3
CHIHUAHUA,8,DELICIAS,021,COLONIA INDUSTRIAL SUR,1,22,8,14,1
CHIHUAHUA,8,DELICIAS,021,COLONIA LAS VIRGINIAS,1,17,9,8,1
CHIHUAHUA,8,DELICIAS,021,COLONIA MORELOS (CUATRO VIENTOS),4,249,128,121,16
CHIHUAHUA,8,DELICIAS,021,COLONIA NICOLÁS BRAVO (KILÓMETRO NOVENTA Y DOS),3,395,193,202,21
CHIHUAHUA,8,DELICIAS,021,COLONIA REVOLUCIÓN,3,368,173,195,15
CHIHUAHUA,8,DELICIAS,021,COLONIA SANTA FE (EL HACHAZO),1,6,1,5,1
CHIHUAHUA,8,DELICIAS,021,COLONIA TERRAZAS,3,922,715,207,36
CHIHUAHUA,8,DELICIAS,021,COLONIA VICENTE GUERRERO,2,169,85,84,7
CHIHUAHUA,8,DELICIAS,021,DELICIAS,178,37435,18491,18944,2294
CHIHUAHUA,8,DELICIAS,021,EJIDO KILÓMETRO OCHENTA Y SEIS CUATRO (EL DIEZ),4,177,84,93,11
CHIHUAHUA,8,DELICIAS,021,EL MIRADOR,1,363,187,176,12
CHIHUAHUA,8,DELICIAS,021,GRANJA SANTO NIÑO,1,69,33,36,4
CHIHUAHUA,8,DELICIAS,021,LA MERCED,2,12,5,7,2
CHIHUAHUA,8,DELICIAS,021,LOS ÁLAMOS [VIÑEDOS],1,30,14,16,2
CHIHUAHUA,8,DR. BELISARIO DOMÍNGUEZ,022,SAN LORENZO,4,213,106,107,13
CHIHUAHUA,8,DR. BELISARIO DOMÍNGUEZ,022,SANTA MARÍA DE CUEVAS,4,103,46,57,9
CHIHUAHUA,8,DR. BELISARIO DOMÍNGUEZ,022,SANTA ROSALÍA DE CUEVAS,1,14,8,6,1
CHIHUAHUA,8,DR. BELISARIO DOMÍNGUEZ,022,TUTUACA (SANTA BÁRBARA DE TUTUACA),4,211,112,99,15
CHIHUAHUA,8,GALEANA,023,ABDENAGO C. GARCÍA (LAGUNITAS),3,460,214,246,21
CHIHUAHUA,8,GALEANA,023,COLONIA LEBARÓN,5,1087,593,494,55
CHIHUAHUA,8,GALEANA,023,HERMENEGILDO GALEANA,4,240,123,117,14
CHIHUAHUA,8,GALEANA,023,LA ANGOSTURA,2,97,50,47,4
CHIHUAHUA,8,SANTA ISABEL,024,NUEVO PALOMAS,1,5,4,1,1
CHIHUAHUA,8,SANTA ISABEL,024,RANCHO DE PEÑA,1,9,5,4,1
CHIHUAHUA,8,SANTA ISABEL,024,SAN MIGUEL DE LOS ANCHONDO,2,23,11,12,2
CHIHUAHUA,8,SANTA ISABEL,024,SANTA ANA,1,14,4,10,1
CHIHUAHUA,8,SANTA ISABEL,024,SANTA ISABEL,6,775,418,357,46
CHIHUAHUA,8,GÓMEZ FARÍAS,025,COLONIA LIBERTAD (EL AGUAJE),1,5,5,0,1
CHIHUAHUA,8,GÓMEZ FARÍAS,025,LA PINTA,2,69,38,31,6
CHIHUAHUA,8,GÓMEZ FARÍAS,025,PABLO AMAYA (LA MARTHA),2,36,16,20,4
CHIHUAHUA,8,GÓMEZ FARÍAS,025,PEÑA BLANCA,3,260,132,128,18
CHIHUAHUA,8,GÓMEZ FARÍAS,025,SAN JOSÉ BABÍCORA,2,53,19,34,4
CHIHUAHUA,8,GÓMEZ FARÍAS,025,VALENTÍN GÓMEZ FARÍAS,9,1193,586,607,97
CHIHUAHUA,8,GRAN MORELOS,026,BUENAVISTA (LA MAJADA),1,5,3,2,1
CHIHUAHUA,8,GRAN MORELOS,026,EL AGUAJE,1,5,3,2,1
CHIHUAHUA,8,GRAN MORELOS,026,LA PAZ,3,299,141,158,15
CHIHUAHUA,8,GRAN MORELOS,026,SAN NICOLÁS DE CARRETAS,4,230,128,102,14
CHIHUAHUA,8,GRAN MORELOS,026,SANTO TORIBIO,1,5,3,2,1
CHIHUAHUA,8,GUACHOCHI,027,ABOREACHI,3,136,68,68,7
CHIHUAHUA,8,GUACHOCHI,027,ABORICHI,1,25,11,14,2
CHIHUAHUA,8,GUACHOCHI,027,AGUA AZUL,4,152,88,64,13
CHIHUAHUA,8,GUACHOCHI,027,AGUA BLANCA,2,33,19,14,3
CHIHUAHUA,8,GUACHOCHI,027,AGUA ESCONDIDA,3,131,58,73,6
CHIHUAHUA,8,GUACHOCHI,027,AGUA PUERCA,3,88,36,52,6
CHIHUAHUA,8,GUACHOCHI,027,AGUA ZARCA,3,189,104,85,9
CHIHUAHUA,8,GUACHOCHI,027,APACHOACHI,1,34,15,19,2
CHIHUAHUA,8,GUACHOCHI,027,ARROYO DE GUALAYNA,3,19,17,2,3
CHIHUAHUA,8,GUACHOCHI,027,BACHAMUCHI,2,49,21,28,3
CHIHUAHUA,8,GUACHOCHI,027,BACOCHI,1,5,2,3,1
CHIHUAHUA,8,GUACHOCHI,027,BACUSEACHI,2,61,27,34,3
CHIHUAHUA,8,GUACHOCHI,027,BAJÍO DE LA CUEVA,2,26,14,12,2
CHIHUAHUA,8,GUACHOCHI,027,BAJÍO DE LOS PALMA,1,52,23,29,3
CHIHUAHUA,8,GUACHOCHI,027,BAJÍO DE TÓNACHI,1,27,20,7,3
CHIHUAHUA,8,GUACHOCHI,027,BAJÍO LARGO,2,84,47,37,4
CHIHUAHUA,8,GUACHOCHI,027,BARBECHITOS DE ABAJO,1,18,7,11,1
CHIHUAHUA,8,GUACHOCHI,027,BASIGOCHI,5,115,59,56,8
CHIHUAHUA,8,GUACHOCHI,027,BASIGOCHI DE ABOREACHI,3,106,46,60,6
CHIHUAHUA,8,GUACHOCHI,027,BASIGOCHI DE LAS PALMAS,1,3,2,1,1
CHIHUAHUA,8,GUACHOCHI,027,BASIHUARE,4,154,75,79,14
CHIHUAHUA,8,GUACHOCHI,027,BASOREACHI,2,16,8,8,2
CHIHUAHUA,8,GUACHOCHI,027,BATOSEGACHI,1,6,5,1,1
CHIHUAHUA,8,GUACHOCHI,027,BOQUIMOBA,3,107,62,45,6
CHIHUAHUA,8,GUACHOCHI,027,CABÓRACHI,3,163,78,85,10
CHIHUAHUA,8,GUACHOCHI,027,CHARERACHI,1,7,2,5,1
CHIHUAHUA,8,GUACHOCHI,027,CHICUÉ,1,10,6,4,1
CHIHUAHUA,8,GUACHOCHI,027,CHIPUACHI,1,9,5,4,1
CHIHUAHUA,8,GUACHOCHI,027,CHOGUITA,5,295,137,158,18
CHIHUAHUA,8,GUACHOCHI,027,CHORUGUE,1,9,6,3,1
CHIHUAHUA,8,GUACHOCHI,027,CIÉNEGA DE CABORACHI,1,7,3,4,1
CHIHUAHUA,8,GUACHOCHI,027,CIÉNEGA DE NOROGACHI,5,260,119,141,17
CHIHUAHUA,8,GUACHOCHI,027,CIENEGUITA,6,263,136,127,18
CHIHUAHUA,8,GUACHOCHI,027,COCHERARE,3,27,14,13,3
CHIHUAHUA,8,GUACHOCHI,027,CORRALITOS,2,78,38,40,4
CHIHUAHUA,8,GUACHOCHI,027,CUMBRE DE GÜERACHI,2,31,17,14,3
CHIHUAHUA,8,GUACHOCHI,027,CUMBRE DEL OJITO,2,7,2,5,2
CHIHUAHUA,8,GUACHOCHI,027,CUMBRES DE GUALAYNA,1,5,4,1,1
CHIHUAHUA,8,GUACHOCHI,027,CUSÁRARE,4,265,141,124,16
CHIHUAHUA,8,GUACHOCHI,027,EL AGUAJE,3,131,57,74,7
CHIHUAHUA,8,GUACHOCHI,027,EL AGUAJE CUMBRES DEL RÍO VERDE,1,8,5,3,1
CHIHUAHUA,8,GUACHOCHI,027,EL ALAMITO,1,37,16,21,2
CHIHUAHUA,8,GUACHOCHI,027,EL ÁLAMO,2,62,31,31,3
CHIHUAHUA,8,GUACHOCHI,027,EL BAJÍO,1,174,83,91,7
CHIHUAHUA,8,GUACHOCHI,027,EL FRIJOLAR,3,24,8,16,3
CHIHUAHUA,8,GUACHOCHI,027,EL MANZANO,2,27,12,15,2
CHIHUAHUA,8,GUACHOCHI,027,EL NARANJO,2,25,11,14,3
CHIHUAHUA,8,GUACHOCHI,027,EL OJITO,1,14,7,7,1
CHIHUAHUA,8,GUACHOCHI,027,EL RANCHITO,1,7,5,2,1
CHIHUAHUA,8,GUACHOCHI,027,EL REBAJE,2,20,11,9,2
CHIHUAHUA,8,GUACHOCHI,027,GOMARACHI,1,23,10,13,1
CHIHUAHUA,8,GUACHOCHI,027,GUACARICHI,2,31,16,15,3
CHIHUAHUA,8,GUACHOCHI,027,GUACAYVO,3,60,33,27,4
CHIHUAHUA,8,GUACHOCHI,027,GUACHOCHI,36,5480,2911,2569,366
CHIHUAHUA,8,GUACHOCHI,027,GUAGÜITARE (BAJITARE),2,23,11,12,2
CHIHUAHUA,8,GUACHOCHI,027,GUAHUACHIQUE,4,261,129,132,12
CHIHUAHUA,8,GUACHOCHI,027,GÜERACHI,1,7,2,5,1
CHIHUAHUA,8,GUACHOCHI,027,GÜIRINAPUCHI (BIRINAPUCHI),2,22,14,8,2
CHIHUAHUA,8,GUACHOCHI,027,GUMISACHI,1,26,18,8,1
CHIHUAHUA,8,GUACHOCHI,027,HUARARARE,1,11,7,4,1
CHIHUAHUA,8,GUACHOCHI,027,HUELEYBO,5,204,115,89,12
CHIHUAHUA,8,GUACHOCHI,027,HUELEYVO,1,23,12,11,3
CHIHUAHUA,8,GUACHOCHI,027,HUERACHI,1,4,3,1,1
CHIHUAHUA,8,GUACHOCHI,027,HUICHABOACHI,1,18,10,8,1
CHIHUAHUA,8,GUACHOCHI,027,HUICHAGOACHI,4,211,94,117,13
CHIHUAHUA,8,GUACHOCHI,027,HUILLORARE,3,136,62,74,8
CHIHUAHUA,8,GUACHOCHI,027,HUIZAROCHI,2,279,136,143,15
CHIHUAHUA,8,GUACHOCHI,027,HUIZOMACHI,1,10,4,6,1
CHIHUAHUA,8,GUACHOCHI,027,LA GLORIA,3,133,59,74,6
CHIHUAHUA,8,GUACHOCHI,027,LA GOBERNADORA,2,29,9,20,2
CHIHUAHUA,8,GUACHOCHI,027,LA GUITARRA (LA GUITARRILLA),3,67,39,28,4
CHIHUAHUA,8,GUACHOCHI,027,LA JOYA,2,52,29,23,3
CHIHUAHUA,8,GUACHOCHI,027,LA LAJA,3,111,60,51,10
CHIHUAHUA,8,GUACHOCHI,027,LA MESA DEL CHIHUITE,3,29,16,13,4
CHIHUAHUA,8,GUACHOCHI,027,LAGUNA DE ABOREACHI,4,180,102,78,12
CHIHUAHUA,8,GUACHOCHI,027,LOMA DEL MANZANO,6,244,125,119,17
CHIHUAHUA,8,GUACHOCHI,027,LOS ARBOLITOS,2,56,33,23,3
CHIHUAHUA,8,GUACHOCHI,027,LOS CHIQUEROS,3,35,20,15,4
CHIHUAHUA,8,GUACHOCHI,027,LOS NAPUCHIS (ORERARE),2,4,1,3,1
CHIHUAHUA,8,GUACHOCHI,027,LOS PILARES,1,33,16,17,2
CHIHUAHUA,8,GUACHOCHI,027,LOS TUCEROS,2,32,21,11,2
CHIHUAHUA,8,GUACHOCHI,027,MACHOGUEACHI,1,7,4,3,1
CHIHUAHUA,8,GUACHOCHI,027,MATALIRABO,1,21,8,13,1
CHIHUAHUA,8,GUACHOCHI,027,MESA DE BASIAGUARE,1,20,7,13,1
CHIHUAHUA,8,GUACHOCHI,027,MESA DE LOS SURCOS,2,9,4,5,1
CHIHUAHUA,8,GUACHOCHI,027,MESA DEL OCOTE,3,48,25,23,5
CHIHUAHUA,8,GUACHOCHI,027,MURACHARACHI,3,171,82,89,9
CHIHUAHUA,8,GUACHOCHI,027,NACACHI,3,63,31,32,4
CHIHUAHUA,8,GUACHOCHI,027,NACASORACHI,2,38,24,14,3
CHIHUAHUA,8,GUACHOCHI,027,NACHACACHI,2,38,24,14,3
CHIHUAHUA,8,GUACHOCHI,027,NAGUEACHI,1,4,2,2,1
CHIHUAHUA,8,GUACHOCHI,027,NAPISOACHI DE ARRIBA (OJO DE AGUA),2,22,10,12,2
CHIHUAHUA,8,GUACHOCHI,027,NAPUCHI,4,133,65,68,8
CHIHUAHUA,8,GUACHOCHI,027,NINGUNO [AEROPUERTO],2,204,96,108,9
CHIHUAHUA,8,GUACHOCHI,027,NONOAVA,2,14,8,6,2
CHIHUAHUA,8,GUACHOCHI,027,NOROGACHI,3,236,136,100,12
CHIHUAHUA,8,GUACHOCHI,027,OCOCHICHI,1,19,9,10,1
CHIHUAHUA,8,GUACHOCHI,027,OTOVACHI (OTOVACHI DE ARRIBA),3,105,53,52,5
CHIHUAHUA,8,GUACHOCHI,027,PAGUINARACHI,1,13,7,6,1
CHIHUAHUA,8,GUACHOCHI,027,PAHUICHIQUE,2,31,17,14,3
CHIHUAHUA,8,GUACHOCHI,027,PAHUIRANACHI (RECOBICHI),2,70,32,38,3
CHIHUAHUA,8,GUACHOCHI,027,PAREGUACHI,2,5,5,0,2
CHIHUAHUA,8,GUACHOCHI,027,PESACHI,2,58,28,30,2
CHIHUAHUA,8,GUACHOCHI,027,RAHUIHUARACHI,3,177,89,88,10
CHIHUAHUA,8,GUACHOCHI,027,RAMUCHEACHI,3,35,13,22,3
CHIHUAHUA,8,GUACHOCHI,027,RANCHERÍA,2,14,3,11,2
CHIHUAHUA,8,GUACHOCHI,027,RANCHERÍA BABOREACHI,1,15,6,9,1
CHIHUAHUA,8,GUACHOCHI,027,RANCHERÍA CIÉNEGA PRIETA,4,117,54,63,10
CHIHUAHUA,8,GUACHOCHI,027,RANCHERÍA GUARARARE,1,31,14,17,2
CHIHUAHUA,8,GUACHOCHI,027,RANCHERÍA NANAYAHUACHI,2,60,27,33,3
CHIHUAHUA,8,GUACHOCHI,027,RANCHERÍA OCHOCACHI,2,13,7,6,2
CHIHUAHUA,8,GUACHOCHI,027,RANCHERÍA OGUIVO,2,115,61,54,5
CHIHUAHUA,8,GUACHOCHI,027,RANCHERÍA PAPAJICHI,2,50,29,21,3
CHIHUAHUA,8,GUACHOCHI,027,RANCHERÍA YEHUACHIQUE,2,16,12,4,2
CHIHUAHUA,8,GUACHOCHI,027,RARÁMUCHI,1,63,31,32,2
CHIHUAHUA,8,GUACHOCHI,027,RAYABO,1,4,4,0,1
CHIHUAHUA,8,GUACHOCHI,027,RECUZACHI,2,16,8,8,2
CHIHUAHUA,8,GUACHOCHI,027,REJOGOCHI,5,98,47,51,10
CHIHUAHUA,8,GUACHOCHI,027,REJOMACHI,2,9,5,4,2
CHIHUAHUA,8,GUACHOCHI,027,REQUEACHI,3,36,14,22,3
CHIHUAHUA,8,GUACHOCHI,027,RETOSACHI,1,8,4,4,1
CHIHUAHUA,8,GUACHOCHI,027,RIQUIRACHI,1,5,4,1,1
CHIHUAHUA,8,GUACHOCHI,027,ROCHEACHI,4,243,130,113,15
CHIHUAHUA,8,GUACHOCHI,027,ROJACHIQUE,3,111,76,35,8
CHIHUAHUA,8,GUACHOCHI,027,ROJASARARE,4,73,39,34,5
CHIHUAHUA,8,GUACHOCHI,027,ROJASARARE DE ROCHEACHI,2,39,19,20,2
CHIHUAHUA,8,GUACHOCHI,027,ROROGOCHACHI,2,17,6,11,2
CHIHUAHUA,8,GUACHOCHI,027,ROSANACHI,2,44,17,27,3
CHIHUAHUA,8,GUACHOCHI,027,RURACHI,2,12,9,3,2
CHIHUAHUA,8,GUACHOCHI,027,SAGOACHI,3,24,14,10,3
CHIHUAHUA,8,GUACHOCHI,027,SAMACHIQUE,5,514,259,255,27
CHIHUAHUA,8,GUACHOCHI,027,SAN SILVESTRE,2,13,8,5,2
CHIHUAHUA,8,GUACHOCHI,027,SANTA ANITA,4,234,131,103,12
CHIHUAHUA,8,GUACHOCHI,027,SANTA CRUZ,2,12,6,6,2
CHIHUAHUA,8,GUACHOCHI,027,SANTA RITA,2,12,5,7,2
CHIHUAHUA,8,GUACHOCHI,027,SANTA ROSA,2,20,9,11,2
CHIHUAHUA,8,GUACHOCHI,027,SARABEACHI,3,33,18,15,3
CHIHUAHUA,8,GUACHOCHI,027,SATERACHI,1,4,1,3,1
CHIHUAHUA,8,GUACHOCHI,027,SEHUERACHI,4,169,75,94,10
CHIHUAHUA,8,GUACHOCHI,027,SICACHIQUE,2,23,9,14,3
CHIHUAHUA,8,GUACHOCHI,027,SIQUIRICHI,4,207,112,95,13
CHIHUAHUA,8,GUACHOCHI,027,SITAGAPACHI,3,31,17,14,3
CHIHUAHUA,8,GUACHOCHI,027,SITANACHI,1,32,18,14,2
CHIHUAHUA,8,GUACHOCHI,027,SITEACHI,1,26,14,12,2
CHIHUAHUA,8,GUACHOCHI,027,SOMARACHI,2,62,29,33,3
CHIHUAHUA,8,GUACHOCHI,027,TAJIRACHI,2,65,28,37,3
CHIHUAHUA,8,GUACHOCHI,027,TALPA,3,81,39,42,4
CHIHUAHUA,8,GUACHOCHI,027,TATAHUICHI,4,133,58,75,7
CHIHUAHUA,8,GUACHOCHI,027,TEPORACHI,3,21,10,11,3
CHIHUAHUA,8,GUACHOCHI,027,TÓNACHI,4,252,119,133,14
CHIHUAHUA,8,GUACHOCHI,027,TUCHEACHI [ASERRADERO],2,55,32,23,3
CHIHUAHUA,8,GUACHOCHI,027,TURUCEACHI,1,21,9,12,1
CHIHUAHUA,8,GUACHOCHI,027,TURUSEACHI,3,72,45,27,6
CHIHUAHUA,8,GUACHOCHI,027,YAHUIRACHI,3,86,54,32,5
CHIHUAHUA,8,GUACHOCHI,027,YEGOCHI,3,46,21,25,4
CHIHUAHUA,8,GUACHOCHI,027,ZAPARICHI,2,34,17,17,3
CHIHUAHUA,8,GUADALUPE,028,BARREALES,2,45,18,27,3
CHIHUAHUA,8,GUADALUPE,028,DOCTOR PORFIRIO PARRA (LA CASETA),3,183,86,97,12
CHIHUAHUA,8,GUADALUPE,028,GUADALUPE,9,714,351,363,35
CHIHUAHUA,8,GUADALUPE,028,JUÁREZ Y REFORMA,2,51,22,29,3
CHIHUAHUA,8,GUADALUPE,028,RINCONADA DEL MIMBRE,2,65,32,33,4
CHIHUAHUA,8,GUADALUPE Y CALVO,029,AGUA AMARILLA,4,211,114,97,14
CHIHUAHUA,8,GUADALUPE Y CALVO,029,AGUA BLANCA,2,22,14,8,2
CHIHUAHUA,8,GUADALUPE Y CALVO,029,AGUA CALIENTE,3,27,14,13,3
CHIHUAHUA,8,GUADALUPE Y CALVO,029,AGUA FRÍA,2,23,11,12,2
CHIHUAHUA,8,GUADALUPE Y CALVO,029,ALGARROBAS,3,9,6,3,2
CHIHUAHUA,8,GUADALUPE Y CALVO,029,ALISITOS DE OLIVA (ALISITOS DE ABAJO),1,9,6,3,1
CHIHUAHUA,8,GUADALUPE Y CALVO,029,ALISOS DE ARRIBA (EL RINCÓN DE ALISOS),1,29,13,16,2
CHIHUAHUA,8,GUADALUPE Y CALVO,029,AMADOR,2,26,9,17,3
CHIHUAHUA,8,GUADALUPE Y CALVO,029,ARROYO CHIQUITO,1,6,4,2,1
CHIHUAHUA,8,GUADALUPE Y CALVO,029,ARROYO DE ALMODÓVAR,1,19,9,10,1
CHIHUAHUA,8,GUADALUPE Y CALVO,029,ARROYO DE LAS GALLINAS,2,6,3,3,2
CHIHUAHUA,8,GUADALUPE Y CALVO,029,ARROYO DE PALMILLAS,2,7,4,3,2
CHIHUAHUA,8,GUADALUPE Y CALVO,029,ARROYO DE SAN ANDRÉS,1,15,6,9,1
CHIHUAHUA,8,GUADALUPE Y CALVO,029,ARROYO DEL AGUA,1,5,0,5,1
CHIHUAHUA,8,GUADALUPE Y CALVO,029,ARROYO LARGO,2,17,8,9,2
CHIHUAHUA,8,GUADALUPE Y CALVO,029,ARROYO TENDIDO,1,21,8,13,1
CHIHUAHUA,8,GUADALUPE Y CALVO,029,ASERRADERO EL PORVENIR,1,4,1,3,1
CHIHUAHUA,8,GUADALUPE Y CALVO,029,ASERRADERO LAS DELICIAS,2,37,18,19,3
CHIHUAHUA,8,GUADALUPE Y CALVO,029,ATASCADEROS,7,460,227,233,26
CHIHUAHUA,8,GUADALUPE Y CALVO,029,BABORIGAME,9,1383,696,687,71
CHIHUAHUA,8,GUADALUPE Y CALVO,029,BAJÍO ATASCOSO,2,18,11,7,2
CHIHUAHUA,8,GUADALUPE Y CALVO,029,BAJÍO DE AGUA BLANCA,3,17,9,8,2
CHIHUAHUA,8,GUADALUPE Y CALVO,029,BAJÍO DE LA MESA,2,21,10,11,2
CHIHUAHUA,8,GUADALUPE Y CALVO,029,BAJÍO DEL ZURDO,3,26,14,12,3
CHIHUAHUA,8,GUADALUPE Y CALVO,029,BAJÍO LARGO,1,11,6,5,1
CHIHUAHUA,8,GUADALUPE Y CALVO,029,BAJÍO MANUEL,3,18,11,7,2
CHIHUAHUA,8,GUADALUPE Y CALVO,029,BAJÍO MOLINA,2,12,8,4,2
CHIHUAHUA,8,GUADALUPE Y CALVO,029,BARBECHITOS,4,160,81,79,11
CHIHUAHUA,8,GUADALUPE Y CALVO,029,BASONOPA,1,5,3,2,1
CHIHUAHUA,8,GUADALUPE Y CALVO,029,BASONOPITA DE ABAJO,3,38,19,19,4
CHIHUAHUA,8,GUADALUPE Y CALVO,029,BASONOPITA DE ARRIBA,2,24,14,10,2
CHIHUAHUA,8,GUADALUPE Y CALVO,029,BATALLAPA,3,69,32,37,5
CHIHUAHUA,8,GUADALUPE Y CALVO,029,BORREGOS QUEMADOS,1,7,1,6,1
CHIHUAHUA,8,GUADALUPE Y CALVO,029,BUENA VISTA (MESA REDONDA),3,39,21,18,10
CHIHUAHUA,8,GUADALUPE Y CALVO,029,BUENAVISTA DE REFORMA,2,72,37,35,4
CHIHUAHUA,8,GUADALUPE Y CALVO,029,CABEZA DE BORREGO,1,9,7,2,1
CHIHUAHUA,8,GUADALUPE Y CALVO,029,CACALOTE DE ABAJO,1,3,2,1,1
CHIHUAHUA,8,GUADALUPE Y CALVO,029,CALABAZAS,1,1,1,0,1
CHIHUAHUA,8,GUADALUPE Y CALVO,029,CARRICITOS,2,43,21,22,3
CHIHUAHUA,8,GUADALUPE Y CALVO,029,CASAS BLANCAS,3,38,17,21,3
CHIHUAHUA,8,GUADALUPE Y CALVO,029,CEBOLLAS,2,44,27,17,3
CHIHUAHUA,8,GUADALUPE Y CALVO,029,CERRO ALTO,3,42,26,16,4
CHIHUAHUA,8,GUADALUPE Y CALVO,029,CERRO ZACATOSO,2,18,7,11,2
CHIHUAHUA,8,GUADALUPE Y CALVO,029,CHICORIMPA,2,12,4,8,2
CHIHUAHUA,8,GUADALUPE Y CALVO,029,CHINATÚ,3,142,61,81,11
CHIHUAHUA,8,GUADALUPE Y CALVO,029,CHOREACHI,1,100,41,59,3
CHIHUAHUA,8,GUADALUPE Y CALVO,029,CIÉNEGA DE ARAUJO,4,90,50,40,8
CHIHUAHUA,8,GUADALUPE Y CALVO,029,CIÉNEGA DE SILVA,3,65,35,30,5
CHIHUAHUA,8,GUADALUPE Y CALVO,029,CINCO LLAGAS,4,103,55,48,8
CHIHUAHUA,8,GUADALUPE Y CALVO,029,COLORADAS DE LA VIRGEN,2,23,9,14,2
CHIHUAHUA,8,GUADALUPE Y CALVO,029,COLORADAS DE LOS CHÁVEZ,4,99,45,54,8
CHIHUAHUA,8,GUADALUPE Y CALVO,029,COLORADAS DE LOS VILLANUEVA (CUEVAS COLORADAS),3,52,33,19,4
CHIHUAHUA,8,GUADALUPE Y CALVO,029,CORDÓN DE LECHUGUILLA (CORDÓN DE LOS BARROS),1,13,10,3,1
CHIHUAHUA,8,GUADALUPE Y CALVO,029,CORDÓN DE LOS SOTO,2,59,35,24,3
CHIHUAHUA,8,GUADALUPE Y CALVO,029,CORRAL DE PIEDRA,1,6,2,4,1
CHIHUAHUA,8,GUADALUPE Y CALVO,029,CORRAL QUEMADO,2,67,44,23,4
CHIHUAHUA,8,GUADALUPE Y CALVO,029,CORRE COYOTE,2,29,15,14,3
CHIHUAHUA,8,GUADALUPE Y CALVO,029,DOLORES,5,209,99,110,16
CHIHUAHUA,8,GUADALUPE Y CALVO,029,DURAZNO DE ARRIBA,1,9,4,5,1
CHIHUAHUA,8,GUADALUPE Y CALVO,029,EL ARENAL,2,26,10,16,3
CHIHUAHUA,8,GUADALUPE Y CALVO,029,EL ASERRADERO,1,47,26,21,3
CHIHUAHUA,8,GUADALUPE Y CALVO,029,EL BAJÍO,1,15,10,5,1
CHIHUAHUA,8,GUADALUPE Y CALVO,029,EL BAJÍO ATASCOSO,1,5,2,3,1
CHIHUAHUA,8,GUADALUPE Y CALVO,029,EL BAJÍO LARGO DE ATASCADEROS,2,67,29,38,4
CHIHUAHUA,8,GUADALUPE Y CALVO,029,EL BALUARTE,2,14,6,8,2
CHIHUAHUA,8,GUADALUPE Y CALVO,029,EL BOSQUE,2,38,15,23,3
CHIHUAHUA,8,GUADALUPE Y CALVO,029,EL CACASTLE,2,18,8,10,2
CHIHUAHUA,8,GUADALUPE Y CALVO,029,EL CAJONCITO,1,17,11,6,1
CHIHUAHUA,8,GUADALUPE Y CALVO,029,EL CAPORAL (LA GUACAMAYA),2,6,5,1,1
CHIHUAHUA,8,GUADALUPE Y CALVO,029,EL CARNERITO,2,14,4,10,2
CHIHUAHUA,8,GUADALUPE Y CALVO,029,EL CARNERO,3,20,8,12,3
CHIHUAHUA,8,GUADALUPE Y CALVO,029,EL CARRIZO,1,6,3,3,1
CHIHUAHUA,8,GUADALUPE Y CALVO,029,EL CHAPOTE (EL MOCO),1,4,2,2,1
CHIHUAHUA,8,GUADALUPE Y CALVO,029,EL CHOAL,1,6,3,3,1
CHIHUAHUA,8,GUADALUPE Y CALVO,029,EL CORDÓN,1,70,26,44,2
CHIHUAHUA,8,GUADALUPE Y CALVO,029,EL CORDÓN DE LA CRUZ,2,23,13,10,2
CHIHUAHUA,8,GUADALUPE Y CALVO,029,EL COYOTE,3,33,10,23,3
CHIHUAHUA,8,GUADALUPE Y CALVO,029,EL CUÍDAME,3,63,39,24,4
CHIHUAHUA,8,GUADALUPE Y CALVO,029,EL DURAZNITO,1,33,14,19,1
CHIHUAHUA,8,GUADALUPE Y CALVO,029,EL DURAZNO,2,97,44,53,4
CHIHUAHUA,8,GUADALUPE Y CALVO,029,EL DURAZNO DE ABAJO,1,7,1,6,1
CHIHUAHUA,8,GUADALUPE Y CALVO,029,EL ENCINAL,1,13,6,7,1
CHIHUAHUA,8,GUADALUPE Y CALVO,029,EL GRANIZO,2,32,14,18,2
CHIHUAHUA,8,GUADALUPE Y CALVO,029,EL INGLÉS,1,14,7,7,1
CHIHUAHUA,8,GUADALUPE Y CALVO,029,EL LUCAS,1,5,3,2,1
CHIHUAHUA,8,GUADALUPE Y CALVO,029,EL MANZANO,2,39,18,21,2
CHIHUAHUA,8,GUADALUPE Y CALVO,029,EL MUERTECITO,3,66,34,32,5
CHIHUAHUA,8,GUADALUPE Y CALVO,029,EL MUERTO,2,44,26,18,3
CHIHUAHUA,8,GUADALUPE Y CALVO,029,EL NARANJITO,1,9,6,3,1
CHIHUAHUA,8,GUADALUPE Y CALVO,029,EL NARANJO,2,33,15,18,3
CHIHUAHUA,8,GUADALUPE Y CALVO,029,EL NOPAL,3,28,15,13,3
CHIHUAHUA,8,GUADALUPE Y CALVO,029,EL OCOTE,2,39,21,18,2
CHIHUAHUA,8,GUADALUPE Y CALVO,029,EL OJITO,1,8,6,2,1
CHIHUAHUA,8,GUADALUPE Y CALVO,029,EL OLVIDO,1,22,10,12,2
CHIHUAHUA,8,GUADALUPE Y CALVO,029,EL PALMITO,3,40,18,22,4
CHIHUAHUA,8,GUADALUPE Y CALVO,029,EL PARAJE,2,18,9,9,2
CHIHUAHUA,8,GUADALUPE Y CALVO,029,EL PINABETE,2,14,8,6,2
CHIHUAHUA,8,GUADALUPE Y CALVO,029,EL PINITO,2,60,29,31,4
CHIHUAHUA,8,GUADALUPE Y CALVO,029,EL PIRAME (ARROYO DE LA ONZA),2,18,10,8,2
CHIHUAHUA,8,GUADALUPE Y CALVO,029,EL PORTUGAL,2,19,10,9,2
CHIHUAHUA,8,GUADALUPE Y CALVO,029,EL POTRERO DE LOS GONZÁLEZ,3,60,34,26,4
CHIHUAHUA,8,GUADALUPE Y CALVO,029,EL PUERTO DE LOS ALAMITOS,1,11,6,5,1
CHIHUAHUA,8,GUADALUPE Y CALVO,029,EL PUERTO DEL RIÍTO,1,30,13,17,2
CHIHUAHUA,8,GUADALUPE Y CALVO,029,EL RANCHITO,1,4,2,2,1
CHIHUAHUA,8,GUADALUPE Y CALVO,029,EL RINCÓN DEL COMANCHE,2,31,11,20,2
CHIHUAHUA,8,GUADALUPE Y CALVO,029,EL RINCÓN NEGRO,2,22,16,6,3
CHIHUAHUA,8,GUADALUPE Y CALVO,029,EL SAUCITO DE ARAUJO,1,12,5,7,1
CHIHUAHUA,8,GUADALUPE Y CALVO,029,EL TALAYOTITO,3,96,42,54,6
CHIHUAHUA,8,GUADALUPE Y CALVO,029,EL TEJAMANIL DE ARRIBA (EL PUERTECITO),1,11,4,7,1
CHIHUAHUA,8,GUADALUPE Y CALVO,029,EL TRIGO DE LOS JAVALERA,2,21,10,11,2
CHIHUAHUA,8,GUADALUPE Y CALVO,029,EL TRIGUITO,2,11,5,6,1
CHIHUAHUA,8,GUADALUPE Y CALVO,029,EL TULE,2,32,20,12,3
CHIHUAHUA,8,GUADALUPE Y CALVO,029,EL TULE (RÍO TUARIPA),3,47,28,19,4
CHIHUAHUA,8,GUADALUPE Y CALVO,029,EL TUPURE (EL TUPURI),2,42,24,18,3
CHIHUAHUA,8,GUADALUPE Y CALVO,029,EL VENADITO,5,321,152,169,16
CHIHUAHUA,8,GUADALUPE Y CALVO,029,EL ZAPOTE,6,115,70,45,10
CHIHUAHUA,8,GUADALUPE Y CALVO,029,EL ZORRILLO (BAJÍO ALMAZÁN),2,14,7,7,2
CHIHUAHUA,8,GUADALUPE Y CALVO,029,GALEANA,3,31,19,12,4
CHIHUAHUA,8,GUADALUPE Y CALVO,029,GUADALUPE Y CALVO,18,2213,1178,1035,109
CHIHUAHUA,8,GUADALUPE Y CALVO,029,GUARIPANA,3,59,24,35,5
CHIHUAHUA,8,GUADALUPE Y CALVO,029,HUERTA DE LOS CARRILLO,3,48,26,22,4
CHIHUAHUA,8,GUADALUPE Y CALVO,029,INDÉ DE BABORIGAME (MINERAL DE INDÉ),1,7,5,2,1
CHIHUAHUA,8,GUADALUPE Y CALVO,029,LA CATEDRAL,4,131,57,74,8
CHIHUAHUA,8,GUADALUPE Y CALVO,029,LA CIÉNEGA,2,78,30,48,4
CHIHUAHUA,8,GUADALUPE Y CALVO,029,LA CIÉNEGA DE LOS AYALA,2,32,18,14,3
CHIHUAHUA,8,GUADALUPE Y CALVO,029,LA CIENEGUITA,2,44,23,21,3
CHIHUAHUA,8,GUADALUPE Y CALVO,029,LA CIPRIANA,1,7,3,4,1
CHIHUAHUA,8,GUADALUPE Y CALVO,029,LA COLONIA,1,5,0,5,1
CHIHUAHUA,8,GUADALUPE Y CALVO,029,LA CRUZ,3,100,49,51,6
CHIHUAHUA,8,GUADALUPE Y CALVO,029,LA CUEVA,3,15,8,7,2
CHIHUAHUA,8,GUADALUPE Y CALVO,029,LA CUEVA DEL BURRO,1,18,8,10,1
CHIHUAHUA,8,GUADALUPE Y CALVO,029,LA CUMBRE,2,10,4,6,1
CHIHUAHUA,8,GUADALUPE Y CALVO,029,LA ESCONDIDA,2,12,4,8,2
CHIHUAHUA,8,GUADALUPE Y CALVO,029,LA HACIENDA,1,6,3,3,1
CHIHUAHUA,8,GUADALUPE Y CALVO,029,LA JOYA,2,7,3,4,2
CHIHUAHUA,8,GUADALUPE Y CALVO,029,LA JOYITA,1,4,3,1,1
CHIHUAHUA,8,GUADALUPE Y CALVO,029,LA LAJA,1,5,4,1,1
CHIHUAHUA,8,GUADALUPE Y CALVO,029,LA LAJA COLORADA,2,54,26,28,4
CHIHUAHUA,8,GUADALUPE Y CALVO,029,LA MANGA,3,30,15,15,3
CHIHUAHUA,8,GUADALUPE Y CALVO,029,LA MATANZA,2,125,57,68,5
CHIHUAHUA,8,GUADALUPE Y CALVO,029,LA MESA DE LOS HONGOS,3,75,32,43,4
CHIHUAHUA,8,GUADALUPE Y CALVO,029,LA MESA DE MULATOS,3,91,44,47,5
CHIHUAHUA,8,GUADALUPE Y CALVO,029,LA NOPALERA,1,4,4,0,1
CHIHUAHUA,8,GUADALUPE Y CALVO,029,LA PORTEZUELA,2,51,28,23,5
CHIHUAHUA,8,GUADALUPE Y CALVO,029,LA QUEBRADA,2,45,26,19,3
CHIHUAHUA,8,GUADALUPE Y CALVO,029,LA RANA,2,47,23,24,2
CHIHUAHUA,8,GUADALUPE Y CALVO,029,LA SIERRITA,1,14,8,6,1
CHIHUAHUA,8,GUADALUPE Y CALVO,029,LA SOLEDAD,4,55,30,25,5
CHIHUAHUA,8,GUADALUPE Y CALVO,029,LA SOLEDAD NUEVA,1,17,10,7,2
CHIHUAHUA,8,GUADALUPE Y CALVO,029,LA SOLEDAD VIEJA,2,10,4,6,2
CHIHUAHUA,8,GUADALUPE Y CALVO,029,LA TABLETA,3,45,22,23,3
CHIHUAHUA,8,GUADALUPE Y CALVO,029,LA TRAMPA,1,11,7,4,1
CHIHUAHUA,8,GUADALUPE Y CALVO,029,LA TRINIDAD,2,29,13,16,3
CHIHUAHUA,8,GUADALUPE Y CALVO,029,LA YERBABUENA (LA LOMA),1,7,3,4,1
CHIHUAHUA,8,GUADALUPE Y CALVO,029,LA ZACATOSA,3,48,17,31,4
CHIHUAHUA,8,GUADALUPE Y CALVO,029,LA ZORRA,1,4,1,3,1
CHIHUAHUA,8,GUADALUPE Y CALVO,029,LAGUNA DE LOS CANO,3,45,25,20,4
CHIHUAHUA,8,GUADALUPE Y CALVO,029,LAS CRUCES,2,12,5,7,2
CHIHUAHUA,8,GUADALUPE Y CALVO,029,LAS ESCALERAS,1,11,4,7,1
CHIHUAHUA,8,GUADALUPE Y CALVO,029,LAS FRESAS,1,5,3,2,1
CHIHUAHUA,8,GUADALUPE Y CALVO,029,LAS JOYITAS,1,17,6,11,1
CHIHUAHUA,8,GUADALUPE Y CALVO,029,LAS JUNTAS,3,42,17,25,4
CHIHUAHUA,8,GUADALUPE Y CALVO,029,LAS JUNTAS (TURUACHITO),2,97,47,50,5
CHIHUAHUA,8,GUADALUPE Y CALVO,029,LAS JUNTAS DE ABAJO (ARROYO ABAJO),1,16,8,8,2
CHIHUAHUA,8,GUADALUPE Y CALVO,029,LAS LUCHAS,2,17,9,8,2
CHIHUAHUA,8,GUADALUPE Y CALVO,029,LAS PIEDRAS,2,8,6,2,2
CHIHUAHUA,8,GUADALUPE Y CALVO,029,LAS PILAS DEL POTRERILLO,1,11,7,4,1
CHIHUAHUA,8,GUADALUPE Y CALVO,029,LAS TROJAS,3,50,18,32,3
CHIHUAHUA,8,GUADALUPE Y CALVO,029,LAS YERBITAS [ASERRADERO],4,228,116,112,14
CHIHUAHUA,8,GUADALUPE Y CALVO,029,LLANO BLANCO,3,25,14,11,3
CHIHUAHUA,8,GUADALUPE Y CALVO,029,LLANO GRANDE,5,184,88,96,13
CHIHUAHUA,8,GUADALUPE Y CALVO,029,LOS ALISOS,1,9,0,9,1
CHIHUAHUA,8,GUADALUPE Y CALVO,029,LOS ARROYITOS,2,21,10,11,3
CHIHUAHUA,8,GUADALUPE Y CALVO,029,LOS INDIOS,1,8,3,5,1
CHIHUAHUA,8,GUADALUPE Y CALVO,029,LOS JUANICOS,2,90,49,41,4
CHIHUAHUA,8,GUADALUPE Y CALVO,029,LOS LAURELES,3,29,19,10,3
CHIHUAHUA,8,GUADALUPE Y CALVO,029,LOS NÚÑEZ (TERREROS),2,61,30,31,2
CHIHUAHUA,8,GUADALUPE Y CALVO,029,LOS OTATES DE ABAJO,2,29,14,15,3
CHIHUAHUA,8,GUADALUPE Y CALVO,029,LOS OTATES DE ARRIBA,1,6,4,2,1
CHIHUAHUA,8,GUADALUPE Y CALVO,029,LOS PARAJES,3,57,30,27,4
CHIHUAHUA,8,GUADALUPE Y CALVO,029,LOS PINOS,1,8,5,3,1
CHIHUAHUA,8,GUADALUPE Y CALVO,029,LOS PLACERES,1,11,7,4,1
CHIHUAHUA,8,GUADALUPE Y CALVO,029,LOS TARROS,2,21,11,10,2
CHIHUAHUA,8,GUADALUPE Y CALVO,029,MESA COLORADA,3,44,25,19,5
CHIHUAHUA,8,GUADALUPE Y CALVO,029,MESA DE HOLGUÍN (LA MESITA),1,6,3,3,1
CHIHUAHUA,8,GUADALUPE Y CALVO,029,MESA DE LA CRUZ,6,97,48,49,7
CHIHUAHUA,8,GUADALUPE Y CALVO,029,MESA DE LA REFORMA,1,4,2,2,1
CHIHUAHUA,8,GUADALUPE Y CALVO,029,MESA DE LOS CHAPARRO,2,7,3,4,1
CHIHUAHUA,8,GUADALUPE Y CALVO,029,MESA DE SAN JOSÉ,3,58,24,34,4
CHIHUAHUA,8,GUADALUPE Y CALVO,029,MESA DE SAN RAFAEL,4,239,121,118,20
CHIHUAHUA,8,GUADALUPE Y CALVO,029,MESA DE SATEVÓ (MESA DE LA PALMA),1,75,41,34,2
CHIHUAHUA,8,GUADALUPE Y CALVO,029,MESA DE TÉLLEZ,2,19,9,10,2
CHIHUAHUA,8,GUADALUPE Y CALVO,029,MESA DEL BARRO,1,21,8,13,2
CHIHUAHUA,8,GUADALUPE Y CALVO,029,MESA DEL DURAZNO,3,138,65,73,9
CHIHUAHUA,8,GUADALUPE Y CALVO,029,MESA DEL RIÍTO,2,12,8,4,2
CHIHUAHUA,8,GUADALUPE Y CALVO,029,MESA LISA,2,30,15,15,3
CHIHUAHUA,8,GUADALUPE Y CALVO,029,MESA LOS PERDIDOS,3,22,4,18,3
CHIHUAHUA,8,GUADALUPE Y CALVO,029,MILPILLAS DE ARRIBA,3,79,41,38,4
CHIHUAHUA,8,GUADALUPE Y CALVO,029,MOMORA,3,49,28,21,3
CHIHUAHUA,8,GUADALUPE Y CALVO,029,NABOGAME,4,143,64,79,9
CHIHUAHUA,8,GUADALUPE Y CALVO,029,NOROGACHI,1,4,1,3,1
CHIHUAHUA,8,GUADALUPE Y CALVO,029,NUESTRA SEÑORA,3,16,7,9,3
CHIHUAHUA,8,GUADALUPE Y CALVO,029,OJO FRÍO DE ARRIBA,3,43,19,24,3
CHIHUAHUA,8,GUADALUPE Y CALVO,029,OJUELOS,4,133,66,67,11
CHIHUAHUA,8,GUADALUPE Y CALVO,029,OLVIDO DE ABAJO,1,8,4,4,1
CHIHUAHUA,8,GUADALUPE Y CALVO,029,OREACHI,1,22,12,10,1
CHIHUAHUA,8,GUADALUPE Y CALVO,029,PALMILLAS,1,21,10,11,1
CHIHUAHUA,8,GUADALUPE Y CALVO,029,PALOS MUERTOS,3,190,89,101,9
CHIHUAHUA,8,GUADALUPE Y CALVO,029,PARAJE EL CUERVO COLGADO,1,19,10,9,2
CHIHUAHUA,8,GUADALUPE Y CALVO,029,PARAJE EL TIGRITO,2,18,14,4,2
CHIHUAHUA,8,GUADALUPE Y CALVO,029,PIE DE LA CUESTA,4,85,40,45,6
CHIHUAHUA,8,GUADALUPE Y CALVO,029,PINOS ALTOS,4,120,60,60,8
CHIHUAHUA,8,GUADALUPE Y CALVO,029,PUERTO BLANCO,1,12,6,6,1
CHIHUAHUA,8,GUADALUPE Y CALVO,029,PUERTO DE ÁNIMAS,3,54,27,27,4
CHIHUAHUA,8,GUADALUPE Y CALVO,029,PUERTO DE JULIÁN (RANCHO LOS JULIANES),1,19,11,8,1
CHIHUAHUA,8,GUADALUPE Y CALVO,029,PUERTO DE OJUELOS (AGUA ESCONDIDA),1,7,4,3,1
CHIHUAHUA,8,GUADALUPE Y CALVO,029,PUERTO DE TALAYOTES,1,2,0,2,1
CHIHUAHUA,8,GUADALUPE Y CALVO,029,RANCHERÍA CASA COLORADA,1,3,2,1,1
CHIHUAHUA,8,GUADALUPE Y CALVO,029,RANCHERÍA GUASACHIQUE,3,105,53,52,6
CHIHUAHUA,8,GUADALUPE Y CALVO,029,RANCHERÍA PUERTO DE SAN JOSÉ (PUERTO DE LAS GUÍAS),2,6,2,4,1
CHIHUAHUA,8,GUADALUPE Y CALVO,029,RANCHO BLANCO,1,15,7,8,2
CHIHUAHUA,8,GUADALUPE Y CALVO,029,RANCHO DE ENMEDIO,4,210,95,115,14
CHIHUAHUA,8,GUADALUPE Y CALVO,029,RANCHO DE MARES,2,22,13,9,2
CHIHUAHUA,8,GUADALUPE Y CALVO,029,RANCHO DE PEÑA,2,24,11,13,2
CHIHUAHUA,8,GUADALUPE Y CALVO,029,RANCHO DE ROCHA,2,7,5,2,2
CHIHUAHUA,8,GUADALUPE Y CALVO,029,RANCHO EL INDIO,2,31,11,20,3
CHIHUAHUA,8,GUADALUPE Y CALVO,029,RANCHO VIEJO,1,3,2,1,1
CHIHUAHUA,8,GUADALUPE Y CALVO,029,REDONDEADOS,3,57,26,31,4
CHIHUAHUA,8,GUADALUPE Y CALVO,029,RINCÓN DEL PEDREGAL,1,33,18,15,2
CHIHUAHUA,8,GUADALUPE Y CALVO,029,SAN ANTONIO,1,9,7,2,1
CHIHUAHUA,8,GUADALUPE Y CALVO,029,SAN CAYETANO,1,18,9,9,2
CHIHUAHUA,8,GUADALUPE Y CALVO,029,SAN FRANCISCO,2,87,35,52,4
CHIHUAHUA,8,GUADALUPE Y CALVO,029,SAN FRANCISCO DE CHINATÚ,3,51,21,30,4
CHIHUAHUA,8,GUADALUPE Y CALVO,029,SAN FRANCISCO DE LA JOYA,4,66,33,33,6
CHIHUAHUA,8,GUADALUPE Y CALVO,029,SAN FRANCISCO DE LOS SALGUEIRO,3,24,15,9,3
CHIHUAHUA,8,GUADALUPE Y CALVO,029,SAN IGNACIO DE CIENEGUILLA,1,8,4,4,1
CHIHUAHUA,8,GUADALUPE Y CALVO,029,SAN IGNACIO DE LOS ALMAZÁN (A. SAN IGNACIO),3,44,17,27,4
CHIHUAHUA,8,GUADALUPE Y CALVO,029,SAN IGNACIO DE LOS CANO,3,15,7,8,2
CHIHUAHUA,8,GUADALUPE Y CALVO,029,SAN IGNACIO DE LOS SOTELO,1,10,3,7,1
CHIHUAHUA,8,GUADALUPE Y CALVO,029,SAN ISIDRO,2,27,17,10,3
CHIHUAHUA,8,GUADALUPE Y CALVO,029,SAN JERÓNIMO,2,25,16,9,3
CHIHUAHUA,8,GUADALUPE Y CALVO,029,SAN JOSÉ DE LOS REYES,2,154,88,66,5
CHIHUAHUA,8,GUADALUPE Y CALVO,029,SAN JOSÉ DE TURUACHITO,2,29,17,12,2
CHIHUAHUA,8,GUADALUPE Y CALVO,029,SAN JOSÉ DEL RINCÓN,1,3,2,1,1
CHIHUAHUA,8,GUADALUPE Y CALVO,029,SAN JUAN NEPOMUCENO,4,169,97,72,13
CHIHUAHUA,8,GUADALUPE Y CALVO,029,SAN JULIÁN,4,59,24,35,5
CHIHUAHUA,8,GUADALUPE Y CALVO,029,SAN MIGUEL,3,40,21,19,5
CHIHUAHUA,8,GUADALUPE Y CALVO,029,SAN PEDRO DE CHINATÚ (RANCHERÍA SAN PEDRO),6,171,96,75,12
CHIHUAHUA,8,GUADALUPE Y CALVO,029,SAN RAFAEL,1,5,3,2,1
CHIHUAHUA,8,GUADALUPE Y CALVO,029,SAN REGIS (EL CARPINTERO),2,34,16,18,2
CHIHUAHUA,8,GUADALUPE Y CALVO,029,SAN SIMÓN,2,20,9,11,2
CHIHUAHUA,8,GUADALUPE Y CALVO,029,SAN SIMÓN (CALABAZAS),4,70,32,38,7
CHIHUAHUA,8,GUADALUPE Y CALVO,029,SANTA RITA,1,10,7,3,1
CHIHUAHUA,8,GUADALUPE Y CALVO,029,SANTA ROSALÍA DE CARRIZAL,2,31,22,9,3
CHIHUAHUA,8,GUADALUPE Y CALVO,029,SANTA ROSALÍA DE NABOGAME,4,73,43,30,6
CHIHUAHUA,8,GUADALUPE Y CALVO,029,SANTA TERESA,2,6,2,4,1
CHIHUAHUA,8,GUADALUPE Y CALVO,029,SANTA TULITA,3,92,38,54,5
CHIHUAHUA,8,GUADALUPE Y CALVO,029,SANTO DOMINGO,2,11,5,6,2
CHIHUAHUA,8,GUADALUPE Y CALVO,029,SAUCITO DE ARRIBA,2,12,3,9,2
CHIHUAHUA,8,GUADALUPE Y CALVO,029,SAUCITO DE LOS PÉREZ,1,17,6,11,1
CHIHUAHUA,8,GUADALUPE Y CALVO,029,SITANACHI,1,52,23,29,2
CHIHUAHUA,8,GUADALUPE Y CALVO,029,SOLEDAD DE AGUA BLANCA,1,9,4,5,1
CHIHUAHUA,8,GUADALUPE Y CALVO,029,TABLETEROS,2,5,2,3,1
CHIHUAHUA,8,GUADALUPE Y CALVO,029,TAHONAS [ASERRADERO],1,4,2,2,1
CHIHUAHUA,8,GUADALUPE Y CALVO,029,TALAYOTES,5,136,60,76,7
CHIHUAHUA,8,GUADALUPE Y CALVO,029,TAMBORILLO,3,35,18,17,3
CHIHUAHUA,8,GUADALUPE Y CALVO,029,TERREROS AMARILLOS,1,9,6,3,1
CHIHUAHUA,8,GUADALUPE Y CALVO,029,TIERRA BLANCA,2,31,17,14,2
CHIHUAHUA,8,GUADALUPE Y CALVO,029,TIERRA FLOJA,3,61,32,29,5
CHIHUAHUA,8,GUADALUPE Y CALVO,029,TIERRAS AMARILLAS,1,23,10,13,1
CHIHUAHUA,8,GUADALUPE Y CALVO,029,TIGRE DE SAN RAFAEL (RINCÓN DEL TIGRE),2,37,18,19,2
CHIHUAHUA,8,GUADALUPE Y CALVO,029,TOHAYANA,3,63,37,26,4
CHIHUAHUA,8,GUADALUPE Y CALVO,029,TRIANA,2,20,13,7,3
CHIHUAHUA,8,GUADALUPE Y CALVO,029,TURUACHI,6,452,230,222,28
CHIHUAHUA,8,GUADALUPE Y CALVO,029,TURUACHITO,1,5,3,2,1
CHIHUAHUA,8,GUADALUPE Y CALVO,029,VENTANAS,1,7,3,4,1
CHIHUAHUA,8,GUADALUPE Y CALVO,029,ZAPE CHICO,2,39,16,23,2
CHIHUAHUA,8,GUADALUPE Y CALVO,029,ZAPORI,1,7,3,4,1
CHIHUAHUA,8,GUAZAPARES,030,ACHICHURI,1,18,9,9,1
CHIHUAHUA,8,GUAZAPARES,030,ALGARROBAL,2,18,5,13,2
CHIHUAHUA,8,GUAZAPARES,030,APORAVO,2,85,50,35,4
CHIHUAHUA,8,GUAZAPARES,030,BAJÍOS DEL PITORREAL,2,23,14,9,2
CHIHUAHUA,8,GUAZAPARES,030,BASONAYVO,2,50,20,30,3
CHIHUAHUA,8,GUAZAPARES,030,BASORIACHI,2,17,12,5,2
CHIHUAHUA,8,GUAZAPARES,030,BATOSEGACHI,1,9,3,6,1
CHIHUAHUA,8,GUAZAPARES,030,CORARAYVO,3,153,74,79,8
CHIHUAHUA,8,GUAZAPARES,030,EL AGUAJE,2,34,15,19,3
CHIHUAHUA,8,GUAZAPARES,030,EL BATAMOTE,1,29,12,17,2
CHIHUAHUA,8,GUAZAPARES,030,EL PUERTO CHIQUITO,2,38,22,16,2
CHIHUAHUA,8,GUAZAPARES,030,ESTACIÓN TÉMORIS,2,31,15,16,3
CHIHUAHUA,8,GUAZAPARES,030,GUAJIPA,4,274,123,151,14
CHIHUAHUA,8,GUAZAPARES,030,GUATACHI,2,56,31,25,3
CHIHUAHUA,8,GUAZAPARES,030,GUAZAPARES,4,221,106,115,13
CHIHUAHUA,8,GUAZAPARES,030,HORMIGUEROS,3,37,15,22,4
CHIHUAHUA,8,GUAZAPARES,030,IRIGOYEN,3,17,6,11,3
CHIHUAHUA,8,GUAZAPARES,030,LA CIENEGUITA DE LOS BUSTILLOS,2,23,13,10,2
CHIHUAHUA,8,GUAZAPARES,030,LA SIDRA,1,18,7,11,1
CHIHUAHUA,8,GUAZAPARES,030,LOS LLANOS DE URUAPAN,2,44,20,24,3
CHIHUAHUA,8,GUAZAPARES,030,MESA DE OCOVIACHI,3,142,72,70,9
CHIHUAHUA,8,GUAZAPARES,030,MESA DEL ÁLAMO,1,17,10,7,1
CHIHUAHUA,8,GUAZAPARES,030,MONTERDE (MONTERDE VIEJO),4,242,132,110,15
CHIHUAHUA,8,GUAZAPARES,030,NACARARE,3,29,16,13,3
CHIHUAHUA,8,GUAZAPARES,030,PIEDRA BOLA,1,12,9,3,1
CHIHUAHUA,8,GUAZAPARES,030,SAN JOSÉ,2,58,32,26,3
CHIHUAHUA,8,GUAZAPARES,030,SANTA MATILDE,3,44,21,23,4
CHIHUAHUA,8,GUAZAPARES,030,TAHONITAS,1,32,13,19,2
CHIHUAHUA,8,GUAZAPARES,030,TEGORACHI,1,16,8,8,1
CHIHUAHUA,8,GUAZAPARES,030,TÉMORIS,7,1124,584,540,51
CHIHUAHUA,8,GUAZAPARES,030,TEPOCHIQUE,3,46,26,20,4
CHIHUAHUA,8,GUAZAPARES,030,TIERRA BLANCA,3,189,99,90,9
CHIHUAHUA,8,GUAZAPARES,030,VERÓNICA,2,9,6,3,2
CHIHUAHUA,8,GUAZAPARES,030,ZAPAREGACHI,1,57,28,29,3
CHIHUAHUA,8,GUERRERO,031,AGUA CALIENTE,4,78,40,38,8
CHIHUAHUA,8,GUERRERO,031,AGUA CALIENTE DE ARISIACHI,1,11,6,5,1
CHIHUAHUA,8,GUERRERO,031,AHUICHIQUE,1,4,1,3,1
CHIHUAHUA,8,GUERRERO,031,ARISIACHI (EL TERRERO),5,136,67,69,11
CHIHUAHUA,8,GUERRERO,031,ARROYO SECO,1,8,6,2,1
CHIHUAHUA,8,GUERRERO,031,ATAROS,1,15,10,5,1
CHIHUAHUA,8,GUERRERO,031,BARRIO DE SAN JOSÉ (PERROS BRAVOS),1,6,4,2,1
CHIHUAHUA,8,GUERRERO,031,BASÚCHIL,4,287,133,154,18
CHIHUAHUA,8,GUERRERO,031,BOQUILLA Y ANEXAS (BAJE DE AGUA),3,59,26,33,4
CHIHUAHUA,8,GUERRERO,031,BORJAS,2,86,47,39,4
CHIHUAHUA,8,GUERRERO,031,CHOCACHI,3,25,10,15,4
CHIHUAHUA,8,GUERRERO,031,CIENEGUITA,4,60,34,26,7
CHIHUAHUA,8,GUERRERO,031,CIUDAD GUERRERO,12,2206,1131,1075,120
CHIHUAHUA,8,GUERRERO,031,COJAHUACHI,2,40,22,18,3
CHIHUAHUA,8,GUERRERO,031,CUEVA DEL TORO (NATAHUACHI),3,45,20,25,7
CHIHUAHUA,8,GUERRERO,031,EJIDO CONSTITUCIÓN (LA TINAJA),1,5,0,5,1
CHIHUAHUA,8,GUERRERO,031,EL JAGÜEY,3,54,27,27,4
CHIHUAHUA,8,GUERRERO,031,EL MESTEÑO,3,24,14,10,3
CHIHUAHUA,8,GUERRERO,031,EL PINITO,1,9,6,3,1
CHIHUAHUA,8,GUERRERO,031,EL TERRERO,2,42,19,23,5
CHIHUAHUA,8,GUERRERO,031,ESTACIÓN TERRERO,2,61,22,39,5
CHIHUAHUA,8,GUERRERO,031,HEREDIA Y ANEXAS (LAS RANAS DE HEREDIA),3,39,19,20,4
CHIHUAHUA,8,GUERRERO,031,IGNACIO ZARAGOZA,1,5,2,3,1
CHIHUAHUA,8,GUERRERO,031,LA JUNTA,12,2510,1253,1257,136
CHIHUAHUA,8,GUERRERO,031,LA LUCIANA,1,6,5,1,1
CHIHUAHUA,8,GUERRERO,031,LA NOPALERA,3,35,21,14,3
CHIHUAHUA,8,GUERRERO,031,LA TENA DE ARRIBA,1,8,2,6,1
CHIHUAHUA,8,GUERRERO,031,LAS RANAS DE TEMEYCHI,2,27,15,12,3
CHIHUAHUA,8,GUERRERO,031,LO DE GIL (OREGIL),1,9,6,3,1
CHIHUAHUA,8,GUERRERO,031,MIÑACA,3,72,41,31,5
CHIHUAHUA,8,GUERRERO,031,NATAHUACHI,1,6,3,3,1
CHIHUAHUA,8,GUERRERO,031,NOGAL Y ANEXAS (EL PINO),1,5,3,2,1
CHIHUAHUA,8,GUERRERO,031,PACHERA,4,137,67,70,10
CHIHUAHUA,8,GUERRERO,031,PAHUÍRACHI,2,29,12,17,3
CHIHUAHUA,8,GUERRERO,031,PÁRAMO DE MORELOS,4,208,111,97,16
CHIHUAHUA,8,GUERRERO,031,PASCUAL OROZCO (SAN ISIDRO PASCUAL OROZCO),2,178,94,84,9
CHIHUAHUA,8,GUERRERO,031,PEDERNALES,4,102,53,49,8
CHIHUAHUA,8,GUERRERO,031,PICHACHÍ,1,5,2,3,1
CHIHUAHUA,8,GUERRERO,031,RANCHO BLANCO,4,108,55,53,8
CHIHUAHUA,8,GUERRERO,031,RANCHOS DE SANTIAGO,4,73,38,35,6
CHIHUAHUA,8,GUERRERO,031,RÍO VERDE,3,33,19,14,3
CHIHUAHUA,8,GUERRERO,031,SÁENZ,1,9,1,8,1
CHIHUAHUA,8,GUERRERO,031,SAN JOSÉ DE BAQUIACHI,1,8,3,5,1
CHIHUAHUA,8,GUERRERO,031,SAN JUAN DE SANTO TOMÁS,3,31,13,18,3
CHIHUAHUA,8,GUERRERO,031,SAN MIGUEL DE TEMEYCHI,1,10,4,6,1
CHIHUAHUA,8,GUERRERO,031,SAN PABLO,3,92,42,50,6
CHIHUAHUA,8,GUERRERO,031,SAN PABLO DE LA SIERRA (COCHINITOS),1,13,9,4,2
CHIHUAHUA,8,GUERRERO,031,SANTA ROSA DE ARISIACHI,4,137,69,68,11
CHIHUAHUA,8,GUERRERO,031,SANTO TOMÁS,4,147,77,70,9
CHIHUAHUA,8,GUERRERO,031,TACUBA,4,125,57,68,10
CHIHUAHUA,8,GUERRERO,031,TEMECHI (TEMEYCHI),3,36,16,20,3
CHIHUAHUA,8,GUERRERO,031,TOMOCHI,9,849,411,438,41
CHIHUAHUA,8,GUERRERO,031,TÓNACHI,1,5,0,5,1
CHIHUAHUA,8,HIDALGO DEL PARRAL,032,ÁNIMAS DE ARRIBA,1,24,11,13,1
CHIHUAHUA,8,HIDALGO DEL PARRAL,032,COMUNIDAD SAN ANDRÉS,2,112,59,53,7
CHIHUAHUA,8,HIDALGO DEL PARRAL,032,EL POSADEÑO,2,44,20,24,3
CHIHUAHUA,8,HIDALGO DEL PARRAL,032,GOMERA DE ARRIBA,1,18,11,7,1
CHIHUAHUA,8,HIDALGO DEL PARRAL,032,GUILLERMO BACA (EL COBEÑO),1,8,5,3,1
CHIHUAHUA,8,HIDALGO DEL PARRAL,032,HIDALGO DEL PARRAL,162,33449,17154,16295,2109
CHIHUAHUA,8,HIDALGO DEL PARRAL,032,MACLOVIO HERRERA (SANTA ROSA),2,63,33,30,4
CHIHUAHUA,8,HIDALGO DEL PARRAL,032,SANTA CRUZ DE VILLEGAS,2,5,3,2,1
CHIHUAHUA,8,HIDALGO DEL PARRAL,032,SAPIÉN,2,8,5,3,2
CHIHUAHUA,8,HIDALGO DEL PARRAL,032,VILLA ESCOBEDO (MINAS NUEVAS),3,28,14,14,3
CHIHUAHUA,8,HUEJOTITÁN,033,CIENEGUILLA,2,31,11,20,3
CHIHUAHUA,8,HUEJOTITÁN,033,HUEJOTITÁN,4,105,54,51,8
CHIHUAHUA,8,HUEJOTITÁN,033,LAS ERAS,2,5,3,2,1
CHIHUAHUA,8,HUEJOTITÁN,033,PICHAGUE,3,42,24,18,4
CHIHUAHUA,8,IGNACIO ZARAGOZA,034,ABRAHAM GONZÁLEZ,1,4,2,2,1
CHIHUAHUA,8,IGNACIO ZARAGOZA,034,BARRIO EL LEÓN,1,5,4,1,1
CHIHUAHUA,8,IGNACIO ZARAGOZA,034,EL SAUCITO (EL SAUZ),1,24,9,15,1
CHIHUAHUA,8,IGNACIO ZARAGOZA,034,FRANCISCO I. MADERO (SAN MIGUEL),3,79,33,46,6
CHIHUAHUA,8,IGNACIO ZARAGOZA,034,IGNACIO ALLENDE,2,105,47,58,7
CHIHUAHUA,8,IGNACIO ZARAGOZA,034,IGNACIO ZARAGOZA,8,658,324,334,41
CHIHUAHUA,8,IGNACIO ZARAGOZA,034,TRES CASTILLOS,1,7,2,5,1
CHIHUAHUA,8,JANOS,035,ALTAMIRANO,4,69,41,28,5
CHIHUAHUA,8,JANOS,035,CASA DE JANOS,3,89,43,46,6
CHIHUAHUA,8,JANOS,035,COLONIA MÉXICO,1,16,6,10,1
CHIHUAHUA,8,JANOS,035,COLONIA OAXACA (EL MARQUESOTE),1,8,4,4,1
CHIHUAHUA,8,JANOS,035,FERNÁNDEZ LEAL,5,239,116,123,15
CHIHUAHUA,8,JANOS,035,JANOS,5,672,319,353,35
CHIHUAHUA,8,JANOS,035,LÁZARO CÁRDENAS (OJO FRÍO),2,23,9,14,2
CHIHUAHUA,8,JANOS,035,MONTE VERDE (ALTAMIRA),3,234,120,114,11
CHIHUAHUA,8,JANOS,035,PANCHO VILLA (LA MORITA),4,205,103,102,14
CHIHUAHUA,8,JANOS,035,SAN PEDRO,2,111,54,57,4
CHIHUAHUA,8,JANOS,035,TRES ÁLAMOS,4,226,129,97,16
CHIHUAHUA,8,JIMÉNEZ,036,CALIFORNIA,2,92,53,39,6
CHIHUAHUA,8,JIMÉNEZ,036,EJIDO LOTE OCHO,1,12,6,6,1
CHIHUAHUA,8,JIMÉNEZ,036,EL ÁGUILA,2,39,19,20,2
CHIHUAHUA,8,JIMÉNEZ,036,EL PREDIO,1,17,7,10,1
CHIHUAHUA,8,JIMÉNEZ,036,EL TRIUNFO,2,30,19,11,2
CHIHUAHUA,8,JIMÉNEZ,036,ESCALÓN,4,219,113,106,13
CHIHUAHUA,8,JIMÉNEZ,036,JACOBO,2,21,10,11,2
CHIHUAHUA,8,JIMÉNEZ,036,JOSÉ MARIANO JIMÉNEZ,49,9671,4781,4890,489
CHIHUAHUA,8,JIMÉNEZ,036,LA GLORIA,1,11,3,8,1
CHIHUAHUA,8,JIMÉNEZ,036,LAGUNA DE PALOMAS (ESTACIÓN CARRILLO),4,96,38,58,8
CHIHUAHUA,8,JIMÉNEZ,036,LAS GLORIAS,1,43,22,21,2
CHIHUAHUA,8,JIMÉNEZ,036,LAS GLORIAS UNO,1,67,31,36,4
CHIHUAHUA,8,JIMÉNEZ,036,LIBERTAD (DOLORES),4,224,105,119,14
CHIHUAHUA,8,JIMÉNEZ,036,MIRAMONTES,3,95,46,49,4
CHIHUAHUA,8,JIMÉNEZ,036,NUEVO SAUCILLO (RANCHO NUEVO),2,46,20,26,3
CHIHUAHUA,8,JIMÉNEZ,036,NUEVO TAMPICO,1,17,5,12,1
CHIHUAHUA,8,JIMÉNEZ,036,SAN ANTONIO (LOTE NÚMERO OCHO),1,4,3,1,1
CHIHUAHUA,8,JIMÉNEZ,036,SAN FELIPE,4,124,61,63,8
CHIHUAHUA,8,JIMÉNEZ,036,SAN LUIS,2,28,9,19,2
CHIHUAHUA,8,JIMÉNEZ,036,TIERRA BLANCA,2,44,20,24,3
CHIHUAHUA,8,JIMÉNEZ,036,TORREONCITOS,4,245,120,125,13
CHIHUAHUA,8,JIMÉNEZ,036,ZARAGOZA,2,74,33,41,5
CHIHUAHUA,8,JUÁREZ,037,EL MILLÓN,1,39,20,19,3
CHIHUAHUA,8,JUÁREZ,037,JESÚS CARRANZA (LA COLORADA),2,129,62,67,6
CHIHUAHUA,8,JUÁREZ,037,JUÁREZ,1384,393489,199367,194122,18907
CHIHUAHUA,8,JUÁREZ,037,LOMA BLANCA,2,347,179,168,14
CHIHUAHUA,8,JUÁREZ,037,SAMALAYUCA,4,543,260,283,24
CHIHUAHUA,8,JUÁREZ,037,SAN AGUSTÍN,1,133,64,69,6
CHIHUAHUA,8,JUÁREZ,037,SAN ISIDRO (RÍO GRANDE),3,1634,824,810,88
CHIHUAHUA,8,JULIMES,038,ARENILLAS,1,8,6,2,1
CHIHUAHUA,8,JULIMES,038,COLONIA ESPERANZA,2,81,52,29,4
CHIHUAHUA,8,JULIMES,038,COLONIA SAN JOSÉ,1,26,9,17,1
CHIHUAHUA,8,JULIMES,038,HACIENDA HUMBOLDT (EJIDO JULIMES),2,168,86,82,8
CHIHUAHUA,8,JULIMES,038,JULIMES,5,514,255,259,27
CHIHUAHUA,8,JULIMES,038,LA REGINA,5,280,131,149,13
CHIHUAHUA,8,JULIMES,038,LABOR NUEVA,2,51,24,27,4
CHIHUAHUA,8,LÓPEZ,039,OCTAVIANO LÓPEZ,5,573,294,279,33
CHIHUAHUA,8,LÓPEZ,039,SALÁICES,4,276,132,144,18
CHIHUAHUA,8,LÓPEZ,039,SANTA ANA DE ABAJO,1,23,9,14,1
CHIHUAHUA,8,LÓPEZ,039,SANTA MARÍA,2,81,36,45,5
CHIHUAHUA,8,MADERA,040,AÑO DE HIDALGO (EL CUATROCIENTOS),3,35,16,19,4
CHIHUAHUA,8,MADERA,040,ARROYO AMPLIO (MINERAL DE DOLORES),2,31,19,12,3
CHIHUAHUA,8,MADERA,040,ARTURO GÁMIZ,3,18,12,6,3
CHIHUAHUA,8,MADERA,040,CAMPO EL DOS (DOS DE ARRIBA),1,10,4,6,1
CHIHUAHUA,8,MADERA,040,CASA COLORADA,1,10,6,4,1
CHIHUAHUA,8,MADERA,040,CHIHUAHUITA,2,96,38,58,7
CHIHUAHUA,8,MADERA,040,CHUHUICHUPA,2,30,16,14,3
CHIHUAHUA,8,MADERA,040,DOLORES (MINERAL DE DOLORES),1,13,9,4,1
CHIHUAHUA,8,MADERA,040,EJIDO JESÚS GARCÍA (EL OSO),1,8,3,5,1
CHIHUAHUA,8,MADERA,040,EL CABLE,2,14,8,6,2
CHIHUAHUA,8,MADERA,040,EL HURACÁN,2,77,35,42,6
CHIHUAHUA,8,MADERA,040,EL LARGO,6,750,370,380,42
CHIHUAHUA,8,MADERA,040,EL NORTE,2,25,8,17,2
CHIHUAHUA,8,MADERA,040,EL OJITO,1,45,23,22,2
CHIHUAHUA,8,MADERA,040,EL REFUGIO,1,8,4,4,1
CHIHUAHUA,8,MADERA,040,HUIZOPA,1,18,9,9,1
CHIHUAHUA,8,MADERA,040,LA NORTEÑA,4,142,83,59,10
CHIHUAHUA,8,MADERA,040,LAS VARAS (ESTACIÓN BABÍCORA),5,217,109,108,16
CHIHUAHUA,8,MADERA,040,LOS DESMONTES,1,17,7,10,1
CHIHUAHUA,8,MADERA,040,MADERA,29,4255,2221,2034,246
CHIHUAHUA,8,MADERA,040,MESA BLANCA,3,26,14,12,3
CHIHUAHUA,8,MADERA,040,MESA DE LA SIMONA,3,43,25,18,3
CHIHUAHUA,8,MADERA,040,MESA DEL GARABATO,1,8,6,2,1
CHIHUAHUA,8,MADERA,040,NAHUERACHI,2,24,10,14,2
CHIHUAHUA,8,MADERA,040,NICOLÁS BRAVO,7,282,151,131,25
CHIHUAHUA,8,MADERA,040,NUEVA MADERA,3,64,35,29,5
CHIHUAHUA,8,MADERA,040,PRESÓN DE GOLONDRINAS,2,33,18,15,3
CHIHUAHUA,8,MADERA,040,PRESÓN DEL TORO,3,28,12,16,3
CHIHUAHUA,8,MADERA,040,SANTA RITA,2,15,7,8,2
CHIHUAHUA,8,MADERA,040,SOCORRO RIVERA,3,62,25,37,5
CHIHUAHUA,8,MADERA,040,TRES OJITOS,3,43,23,20,3
CHIHUAHUA,8,MAGUARICHI,041,ERECHUCHIQUE,1,4,3,1,1
CHIHUAHUA,8,MAGUARICHI,041,MAGUARICHI,4,222,122,100,14
CHIHUAHUA,8,MAGUARICHI,041,SAN JERÓNIMO,1,11,4,7,2
CHIHUAHUA,8,MAGUARICHI,041,SAN JOSÉ DE LAS LAJAS,3,38,22,16,4
CHIHUAHUA,8,MAGUARICHI,041,SAN JUAN,1,5,2,3,1
CHIHUAHUA,8,MANUEL BENAVIDES,042,ÁLAMOS DE SAN ANTONIO,1,16,8,8,1
CHIHUAHUA,8,MANUEL BENAVIDES,042,MANUEL BENAVIDES,4,261,145,116,15
CHIHUAHUA,8,MATACHÍ,043,EJIDO BUENAVISTA (BUENAVISTA),3,42,19,23,4
CHIHUAHUA,8,MATACHÍ,043,MATACHÍ,6,376,177,199,23
CHIHUAHUA,8,MATACHÍ,043,TEJOLOCACHI,3,46,17,29,4
CHIHUAHUA,8,MATAMOROS,044,CIÉNEGA DE CENICEROS,3,45,21,24,4
CHIHUAHUA,8,MATAMOROS,044,EL VERANO (EJIDO DE BORJAS),3,77,33,44,5
CHIHUAHUA,8,MATAMOROS,044,INDEPENDENCIA Y REFORMA (LOS CHARCOS),1,5,4,1,1
CHIHUAHUA,8,MATAMOROS,044,MARIANO MATAMOROS,6,898,455,443,41
CHIHUAHUA,8,MATAMOROS,044,SANTA ROSALÍA (LA MAROMA),3,30,14,16,3
CHIHUAHUA,8,MATAMOROS,044,VALSEQUILLO,1,12,9,3,1
CHIHUAHUA,8,MEOQUI,045,COLONIA FELIPE ÁNGELES,5,367,188,179,21
CHIHUAHUA,8,MEOQUI,045,COLONIA FRANCISCO PORTILLO (LOS JÁQUEZ),2,57,28,29,3
CHIHUAHUA,8,MEOQUI,045,EL TORREÓN,2,100,50,50,5
CHIHUAHUA,8,MEOQUI,045,ESTACIÓN CONSUELO,5,527,257,270,26
CHIHUAHUA,8,MEOQUI,045,GRAN MORELOS (LOS CISNEROS),1,30,17,13,2
CHIHUAHUA,8,MEOQUI,045,GUADALUPE VICTORIA,4,406,196,210,20
CHIHUAHUA,8,MEOQUI,045,LAS PUENTES,2,152,78,74,8
CHIHUAHUA,8,MEOQUI,045,LÁZARO CÁRDENAS,14,2380,1214,1166,107
CHIHUAHUA,8,MEOQUI,045,LOMAS DEL CONSUELO,1,16,6,10,1
CHIHUAHUA,8,MEOQUI,045,LORETO,2,124,57,67,7
CHIHUAHUA,8,MEOQUI,045,LOS GARCÍA,2,120,65,55,7
CHIHUAHUA,8,MEOQUI,045,NUEVO LORETO,1,62,29,33,4
CHIHUAHUA,8,MEOQUI,045,NUEVO SAN LUCAS,2,192,100,92,8
CHIHUAHUA,8,MEOQUI,045,PEDRO MEOQUI,32,5358,2707,2651,317
CHIHUAHUA,8,MEOQUI,045,POTRERO DEL LLANO,2,29,16,13,3
CHIHUAHUA,8,MORELOS,046,ÁNIMAS DE ARRIBA (EJIDO),3,51,30,21,4
CHIHUAHUA,8,MORELOS,046,BACAMOBA,2,7,4,3,1
CHIHUAHUA,8,MORELOS,046,BATARAPA DE ABAJO,2,10,3,7,2
CHIHUAHUA,8,MORELOS,046,CABEZA DEL VIEJO,1,18,11,7,1
CHIHUAHUA,8,MORELOS,046,CIÉNEGA PRIETA,4,179,95,84,13
CHIHUAHUA,8,MORELOS,046,CORCOVADITO,1,5,2,3,1
CHIHUAHUA,8,MORELOS,046,CORCOVADOS,1,7,3,4,1
CHIHUAHUA,8,MORELOS,046,EL BARRANQUITO,2,9,3,6,1
CHIHUAHUA,8,MORELOS,046,EL BORDO,2,29,12,17,2
CHIHUAHUA,8,MORELOS,046,EL CARRICITOS,1,6,4,2,1
CHIHUAHUA,8,MORELOS,046,EL CHAPOTE,2,11,6,5,2
CHIHUAHUA,8,MORELOS,046,EL PUERTO,1,7,4,3,1
CHIHUAHUA,8,MORELOS,046,EL TABLÓN,4,197,101,96,11
CHIHUAHUA,8,MORELOS,046,EL TERRERO,3,16,5,11,2
CHIHUAHUA,8,MORELOS,046,GUAGUAYAPA,2,17,7,10,1
CHIHUAHUA,8,MORELOS,046,LA FÁBRICA,2,20,9,11,2
CHIHUAHUA,8,MORELOS,046,LA GAITA,3,34,24,10,3
CHIHUAHUA,8,MORELOS,046,LA HACIENDITA,1,6,4,2,1
CHIHUAHUA,8,MORELOS,046,LA TESCALAMA,2,12,5,7,2
CHIHUAHUA,8,MORELOS,046,LA TUNA,1,15,5,10,1
CHIHUAHUA,8,MORELOS,046,LA TUNITA (LA TULITA),2,21,12,9,2
CHIHUAHUA,8,MORELOS,046,LAJITAS DE PALMIRA,4,115,63,52,10
CHIHUAHUA,8,MORELOS,046,LAS CUEVAS,1,5,2,3,1
CHIHUAHUA,8,MORELOS,046,LAS JOYITAS,2,6,2,4,1
CHIHUAHUA,8,MORELOS,046,LAS PALOMAS,3,43,18,25,3
CHIHUAHUA,8,MORELOS,046,LAS TIERRAS,3,28,17,11,3
CHIHUAHUA,8,MORELOS,046,LOS BAJILLOS,1,11,8,3,2
CHIHUAHUA,8,MORELOS,046,LOS BERROS,2,8,4,4,1
CHIHUAHUA,8,MORELOS,046,LOS PLACERES,1,11,2,9,1
CHIHUAHUA,8,MORELOS,046,LOS TAJOS,1,5,1,4,1
CHIHUAHUA,8,MORELOS,046,LOS TÁSCATES,1,14,7,7,1
CHIHUAHUA,8,MORELOS,046,MASAGUIACHI,3,68,29,39,5
CHIHUAHUA,8,MORELOS,046,MESA DEL FRIJOLAR,4,100,46,54,11
CHIHUAHUA,8,MORELOS,046,MORELOS,7,589,312,277,28
CHIHUAHUA,8,MORELOS,046,PIEDRA BOLA,2,8,6,2,1
CHIHUAHUA,8,MORELOS,046,POTRERO DE LOS BOJÓRQUEZ [MINERAL],3,80,46,34,5
CHIHUAHUA,8,MORELOS,046,POTRERO DE PORTILLO,2,48,27,21,2
CHIHUAHUA,8,MORELOS,046,RANCHERÍA MATACHIQUE,1,18,9,9,1
CHIHUAHUA,8,MORELOS,046,RANCHERÍA TENORIBA,2,47,25,22,3
CHIHUAHUA,8,MORELOS,046,RANCHO MESA LOS LEALES,4,71,32,39,7
CHIHUAHUA,8,MORELOS,046,RINCÓN DEL PLEITO,3,61,26,35,4
CHIHUAHUA,8,MORELOS,046,SAN ANDRÉS,4,65,38,27,5
CHIHUAHUA,8,MORELOS,046,SAN ANTONIO DE LA HUERTA,2,39,23,16,3
CHIHUAHUA,8,MORELOS,046,SAN MIGUEL,3,70,39,31,5
CHIHUAHUA,8,MORELOS,046,SANTA ANA,4,99,44,55,7
CHIHUAHUA,8,MORELOS,046,SANTA CRUZ,1,26,12,14,1
CHIHUAHUA,8,MORELOS,046,SANTA ROSA,1,18,13,5,1
CHIHUAHUA,8,MORELOS,046,SOROBUENA,4,47,21,26,7
CHIHUAHUA,8,MORELOS,046,TASTECITOS,1,7,6,1,1
CHIHUAHUA,8,MORELOS,046,ZARUPA,1,9,3,6,1
CHIHUAHUA,8,MORIS,047,AGUAJE VERDE,3,24,10,14,3
CHIHUAHUA,8,MORIS,047,BERMÚDEZ,3,16,11,5,3
CHIHUAHUA,8,MORIS,047,CIÉNEGA DEL PILAR,3,59,24,35,4
CHIHUAHUA,8,MORIS,047,EL FRIJOLAR,2,17,12,5,2
CHIHUAHUA,8,MORIS,047,EL GAVILÁN,3,26,16,10,3
CHIHUAHUA,8,MORIS,047,EL PILAR,4,205,94,111,13
CHIHUAHUA,8,MORIS,047,LA CIENEGUITA DE RODRÍGUEZ,3,76,33,43,4
CHIHUAHUA,8,MORIS,047,LA FINCA DE PESQUEIRA,1,9,2,7,1
CHIHUAHUA,8,MORIS,047,LA OTRA BANDA,1,9,2,7,1
CHIHUAHUA,8,MORIS,047,LOS ALAMILLOS,1,3,3,0,1
CHIHUAHUA,8,MORIS,047,LOS TERREROS,1,9,5,4,1
CHIHUAHUA,8,MORIS,047,MESA COLORADA,3,16,8,8,3
CHIHUAHUA,8,MORIS,047,MESA DEL AGUA,2,3,1,2,1
CHIHUAHUA,8,MORIS,047,MORIS,6,533,250,283,31
CHIHUAHUA,8,MORIS,047,SANTA MARÍA CHIQUITA (MESA DE RENDÓN),1,11,6,5,1
CHIHUAHUA,8,MORIS,047,SIERRA OBSCURA (EL SERRUCHITO),1,4,2,2,1
CHIHUAHUA,8,MORIS,047,TALAYOTES,3,38,22,16,4
CHIHUAHUA,8,MORIS,047,TROMPA,2,30,18,12,2
CHIHUAHUA,8,NAMIQUIPA,048,ADOLFO RUIZ CORTÍNEZ (PROVIDENCIA),4,206,100,106,13
CHIHUAHUA,8,NAMIQUIPA,048,BENITO JUÁREZ,5,440,227,213,21
CHIHUAHUA,8,NAMIQUIPA,048,CRUCES,3,208,106,102,12
CHIHUAHUA,8,NAMIQUIPA,048,EJIDO VENUSTIANO CARRANZA (TESEACHI),1,6,5,1,1
CHIHUAHUA,8,NAMIQUIPA,048,EL MOLINO,5,532,255,277,33
CHIHUAHUA,8,NAMIQUIPA,048,EL OSO,2,35,19,16,3
CHIHUAHUA,8,NAMIQUIPA,048,EL PACÍFICO,2,38,18,20,3
CHIHUAHUA,8,NAMIQUIPA,048,EL TERRERO,6,663,328,335,36
CHIHUAHUA,8,NAMIQUIPA,048,GUADALUPE VICTORIA (EL PICACHO),3,61,26,35,5
CHIHUAHUA,8,NAMIQUIPA,048,INDEPENDENCIA (COLOGACHI),4,195,96,99,14
CHIHUAHUA,8,NAMIQUIPA,048,LA GUAJOLOTA,1,26,13,13,2
CHIHUAHUA,8,NAMIQUIPA,048,NAMIQUIPA,8,874,461,413,56
CHIHUAHUA,8,NAMIQUIPA,048,NUEVO NAMIQUIPA,2,48,26,22,3
CHIHUAHUA,8,NAMIQUIPA,048,NUEVO SANTA CLARA,4,95,55,40,6
CHIHUAHUA,8,NAMIQUIPA,048,OJOS AZULES,1,19,8,11,1
CHIHUAHUA,8,NAMIQUIPA,048,SALVADOR GÓMEZ Y GÓMEZ (EL NOGAL),2,27,11,16,2
CHIHUAHUA,8,NAMIQUIPA,048,SANTA ANA,6,1261,606,655,87
CHIHUAHUA,8,NAMIQUIPA,048,SANTA CATALINA DE VILLELA (SANTA CATARINA),2,223,105,118,10
CHIHUAHUA,8,NONOAVA,049,ARROYO HONDO,2,59,34,25,4
CHIHUAHUA,8,NONOAVA,049,CHARCO PINTO,2,60,28,32,4
CHIHUAHUA,8,NONOAVA,049,EL TERRERO,1,48,20,28,3
CHIHUAHUA,8,NONOAVA,049,HUMARIZA,3,43,27,16,3
CHIHUAHUA,8,NONOAVA,049,LA JUNTA DE LOS RÍOS,2,39,17,22,3
CHIHUAHUA,8,NONOAVA,049,NONOAVA,6,447,217,230,26
CHIHUAHUA,8,NUEVO CASAS GRANDES,050,BUENA FE,5,368,186,182,17
CHIHUAHUA,8,NUEVO CASAS GRANDES,050,EJIDO HIDALGO,6,404,194,210,25
CHIHUAHUA,8,NUEVO CASAS GRANDES,050,FRANCISCO I. MADERO,3,179,80,99,11
CHIHUAHUA,8,NUEVO CASAS GRANDES,050,GUADALUPE,1,31,13,18,2
CHIHUAHUA,8,NUEVO CASAS GRANDES,050,NUEVO CASAS GRANDES,86,16106,8463,7643,934
CHIHUAHUA,8,NUEVO CASAS GRANDES,050,SECCIÓN HIDALGO,2,12,5,7,2
CHIHUAHUA,8,OCAMPO,051,AGUA CALIENTE,2,19,11,8,2
CHIHUAHUA,8,OCAMPO,051,BAQUIRIACHI,1,56,31,25,2
CHIHUAHUA,8,OCAMPO,051,BASASEACHI,5,1217,601,616,56
CHIHUAHUA,8,OCAMPO,051,BASOGACHI,3,28,15,13,3
CHIHUAHUA,8,OCAMPO,051,CAHUISORI,2,145,74,71,8
CHIHUAHUA,8,OCAMPO,051,CAJURICHI,4,270,153,117,16
CHIHUAHUA,8,OCAMPO,051,CEBOLLÍN,1,6,3,3,1
CHIHUAHUA,8,OCAMPO,051,CONCHEÑO,3,10,7,3,2
CHIHUAHUA,8,OCAMPO,051,CUEVAS BLANCAS (GASACHI),3,45,21,24,4
CHIHUAHUA,8,OCAMPO,051,EL PERIQUITO (EJIDO SANTA EDUVIGES),3,76,35,41,5
CHIHUAHUA,8,OCAMPO,051,EL SAUCILLO,3,34,19,15,3
CHIHUAHUA,8,OCAMPO,051,GURICHIVO (EJIDO BASOGACHI),2,16,10,6,2
CHIHUAHUA,8,OCAMPO,051,HUAJUMAR (SAN ISIDRO HUAJUMAR),4,344,158,186,19
CHIHUAHUA,8,OCAMPO,051,HUEVACHI,4,157,69,88,9
CHIHUAHUA,8,OCAMPO,051,JESÚS DEL MONTE,1,9,4,5,1
CHIHUAHUA,8,OCAMPO,051,LA BATERÍA DE RODRÍGUEZ,1,4,3,1,1
CHIHUAHUA,8,OCAMPO,051,LA CASITA,3,59,36,23,5
CHIHUAHUA,8,OCAMPO,051,LA JOYA,1,6,2,4,1
CHIHUAHUA,8,OCAMPO,051,LAS ESTRELLAS,3,74,46,28,6
CHIHUAHUA,8,OCAMPO,051,LOS LLANITOS,2,10,7,3,2
CHIHUAHUA,8,OCAMPO,051,MELCHOR OCAMPO,4,187,95,92,12
CHIHUAHUA,8,OCAMPO,051,MEMELICHI DE ABAJO,2,22,9,13,2
CHIHUAHUA,8,OCAMPO,051,MEMELICHI DE ARRIBA (EL FRESNO),2,18,4,14,2
CHIHUAHUA,8,OCAMPO,051,SANTO DOMINGO,2,10,4,6,2
CHIHUAHUA,8,OCAMPO,051,YOQUIVO (SAN FRANCISCO DE YOQUIVO),2,26,13,13,2
CHIHUAHUA,8,OJINAGA,052,CRUCES Y ANEXAS,1,9,6,3,1
CHIHUAHUA,8,OJINAGA,052,EL MULATO,1,14,6,8,1
CHIHUAHUA,8,OJINAGA,052,EL TECOLOTE,1,329,170,159,14
CHIHUAHUA,8,OJINAGA,052,EL TRÉBOL,1,10,5,5,1
CHIHUAHUA,8,OJINAGA,052,LA COLMENA,1,6,3,3,1
CHIHUAHUA,8,OJINAGA,052,LA ESMERALDA,2,40,23,17,3
CHIHUAHUA,8,OJINAGA,052,MAIJOMA,1,9,5,4,1
CHIHUAHUA,8,OJINAGA,052,MANUEL OJINAGA,36,5622,2803,2819,299
CHIHUAHUA,8,OJINAGA,052,PALOMAS NÚMERO UNO,1,18,8,10,1
CHIHUAHUA,8,OJINAGA,052,POTRERO DEL LLANO (LA MULA),1,3,1,2,1
CHIHUAHUA,8,OJINAGA,052,TIERRAS NUEVAS,1,18,7,11,1
CHIHUAHUA,8,OJINAGA,052,VALVERDE,2,44,20,24,3
CHIHUAHUA,8,PRAXEDIS G. GUERRERO,053,COLONIA ESPERANZA,2,90,42,48,7
CHIHUAHUA,8,PRAXEDIS G. GUERRERO,053,EL PORVENIR,5,390,187,203,24
CHIHUAHUA,8,PRAXEDIS G. GUERRERO,053,GUADALUPE VICTORIA (RANCHO NUEVO),1,22,12,10,1
CHIHUAHUA,8,PRAXEDIS G. GUERRERO,053,PRAXEDIS G. GUERRERO,6,703,364,339,36
CHIHUAHUA,8,RIVA PALACIO,054,LA DESPEDIDA,1,5,4,1,1
CHIHUAHUA,8,RIVA PALACIO,054,LA NORIA DE ALDANA,1,7,1,6,1
CHIHUAHUA,8,RIVA PALACIO,054,LA NUEVA PAZ,2,32,18,14,3
CHIHUAHUA,8,RIVA PALACIO,054,SAINAPUCHI (LA GARITA),3,156,65,91,11
CHIHUAHUA,8,RIVA PALACIO,054,SAN ANDRÉS,6,640,311,329,33
CHIHUAHUA,8,ROSALES,055,BARRANCO BLANCO,3,125,56,69,8
CHIHUAHUA,8,ROSALES,055,CONGREGACIÓN DE ESTACIÓN ORTÍZ,5,588,274,314,35
CHIHUAHUA,8,ROSALES,055,EL MOLINO,3,257,119,138,14
CHIHUAHUA,8,ROSALES,055,EX-HACIENDA CASA BLANCA,2,57,33,24,4
CHIHUAHUA,8,ROSALES,055,EX-HACIENDA DELICIAS,2,59,27,32,4
CHIHUAHUA,8,ROSALES,055,KILÓMETRO NOVENTA Y NUEVE,3,105,42,63,7
CHIHUAHUA,8,ROSALES,055,LA GARITA,2,44,23,21,4
CHIHUAHUA,8,ROSALES,055,LOMA LINDA,2,19,8,11,4
CHIHUAHUA,8,ROSALES,055,ORINDA,2,23,9,14,3
CHIHUAHUA,8,ROSALES,055,SALÓN DE ACTOS (AMPLIACIÓN CUARENTA Y SIETE),4,227,121,106,14
CHIHUAHUA,8,ROSALES,055,SAN VALENTÍN,1,30,15,15,2
CHIHUAHUA,8,ROSALES,055,SANTA CRUZ DE ROSALES,10,1187,592,595,63
CHIHUAHUA,8,ROSALES,055,SANTA RITA DE CASIA (AMPLIACIÓN CUARENTA Y DOS),2,38,18,20,3
CHIHUAHUA,8,ROSARIO,056,JUAN MENDOZA,4,160,74,86,11
CHIHUAHUA,8,ROSARIO,056,SAN JAVIER,3,57,24,33,4
CHIHUAHUA,8,ROSARIO,056,SAN NICOLÁS DEL CAÑÓN,1,10,3,7,1
CHIHUAHUA,8,ROSARIO,056,VALLE DEL ROSARIO,4,232,112,120,10
CHIHUAHUA,8,SAN FRANCISCO DE BORJA,057,SAN FRANCISCO DE BORJA,6,425,218,207,23
CHIHUAHUA,8,SAN FRANCISCO DE BORJA,057,TEPORACHI,2,17,9,8,2
CHIHUAHUA,8,SAN FRANCISCO DE CONCHOS,058,BOQUILLA DE BABISAS (LA BOQUILLA DE CONCHOS),5,256,126,130,19
CHIHUAHUA,8,SAN FRANCISCO DE CONCHOS,058,EL AMPARANEÑO (EL AMPARALEÑO),2,17,8,9,2
CHIHUAHUA,8,SAN FRANCISCO DE CONCHOS,058,EL MOLINO,2,64,29,35,4
CHIHUAHUA,8,SAN FRANCISCO DE CONCHOS,058,RANCHO NUEVO,1,20,9,11,1
CHIHUAHUA,8,SAN FRANCISCO DE CONCHOS,058,SAN FRANCISCO DE CONCHOS,4,213,103,110,12
CHIHUAHUA,8,SAN FRANCISCO DEL ORO,059,BELLAVISTA,1,7,3,4,1
CHIHUAHUA,8,SAN FRANCISCO DEL ORO,059,BOQUILLA DE SAN JOSÉ,2,31,18,13,3
CHIHUAHUA,8,SAN FRANCISCO DEL ORO,059,LOS SAUCES,2,6,3,3,2
CHIHUAHUA,8,SAN FRANCISCO DEL ORO,059,SAN FRANCISCO DEL ORO,10,1187,602,585,95
CHIHUAHUA,8,SAN FRANCISCO DEL ORO,059,SAN JOSÉ DE LOS BAYLÓN,3,79,42,37,6
CHIHUAHUA,8,SANTA BÁRBARA,060,CASA COLORADA (FRANCISCO I. MADERO),2,54,28,26,4
CHIHUAHUA,8,SANTA BÁRBARA,060,CORRAL DE PIEDRAS (ZENZONTLE),1,75,34,41,3
CHIHUAHUA,8,SANTA BÁRBARA,060,PUNTO ALEGRE,4,475,240,235,21
CHIHUAHUA,8,SANTA BÁRBARA,060,SAN PEDRO (EJIDO SAN RAFAEL),2,28,10,18,2
CHIHUAHUA,8,SANTA BÁRBARA,060,SANTA BÁRBARA,16,2151,1059,1092,113
CHIHUAHUA,8,SATEVÓ,061,SAN FRANCISCO JAVIER DE SATEVÓ,4,523,274,249,29
CHIHUAHUA,8,SATEVÓ,061,SAN JOSÉ DE HERNÁNDEZ,2,12,4,8,2
CHIHUAHUA,8,SATEVÓ,061,SAN JOSÉ DEL SITIO,4,192,107,85,14
CHIHUAHUA,8,SATEVÓ,061,SAN ONOFRE,1,14,5,9,1
CHIHUAHUA,8,SAUCILLO,062,AMPLIACIÓN COLONIA ALTAMIRANO,1,8,3,5,1
CHIHUAHUA,8,SAUCILLO,062,ANCÓN DE CARROS,1,31,14,17,2
CHIHUAHUA,8,SAUCILLO,062,COLONIA ALTAMIRANO (LOMA GRANDE),1,13,6,7,1
CHIHUAHUA,8,SAUCILLO,062,COLONIA BELLAVISTA,1,5,1,4,1
CHIHUAHUA,8,SAUCILLO,062,COLONIA BENITO JUÁREZ,2,63,30,33,3
CHIHUAHUA,8,SAUCILLO,062,COLONIA CARLOS A. MADRAZO (KILÓMETRO CINCUENTA Y NUEVE),1,8,4,4,1
CHIHUAHUA,8,SAUCILLO,062,COLONIA FRANCISCO I. MADERO (EL GATO NEGRO),1,12,6,6,1
CHIHUAHUA,8,SAUCILLO,062,COLONIA VICENTE GUERRERO,1,39,19,20,2
CHIHUAHUA,8,SAUCILLO,062,EJIDO CARBONERAS,1,6,5,1,1
CHIHUAHUA,8,SAUCILLO,062,EJIDO CONCHOS,4,347,177,170,22
CHIHUAHUA,8,SAUCILLO,062,EL INDIO,1,189,90,99,12
CHIHUAHUA,8,SAUCILLO,062,ESTACIÓN CONCHOS,1,21,14,7,3
CHIHUAHUA,8,SAUCILLO,062,ESTACIÓN SAUCILLO,2,161,79,82,8
CHIHUAHUA,8,SAUCILLO,062,KILÓMETRO CINCUENTA Y NUEVE,2,11,2,9,2
CHIHUAHUA,8,SAUCILLO,062,LA CUADRA,2,61,26,35,4
CHIHUAHUA,8,SAUCILLO,062,LA VIÑA,3,423,195,228,19
CHIHUAHUA,8,SAUCILLO,062,LAS ALVAREÑAS,2,136,74,62,7
CHIHUAHUA,8,SAUCILLO,062,LAS VARAS,5,570,299,271,34
CHIHUAHUA,8,SAUCILLO,062,LOMA CHICA,2,154,80,74,8
CHIHUAHUA,8,SAUCILLO,062,NAICA,6,933,477,456,49
CHIHUAHUA,8,SAUCILLO,062,ORRANTEÑO,3,200,77,123,12
CHIHUAHUA,8,SAUCILLO,062,PARRITAS,2,48,23,25,4
CHIHUAHUA,8,SAUCILLO,062,PUERTO DEL TORO,4,185,101,84,12
CHIHUAHUA,8,SAUCILLO,062,SAN FRANCISCO DEL MEZQUITAL,2,47,24,23,3
CHIHUAHUA,8,SAUCILLO,062,SANTA GERTRUDIS (LA HACIENDA),3,143,65,78,9
CHIHUAHUA,8,SAUCILLO,062,SAUCILLO,17,3242,1847,1395,245
CHIHUAHUA,8,TEMÓSACHIC,063,AGUA CALIENTE DE TUTUACA,2,18,11,7,2
CHIHUAHUA,8,TEMÓSACHIC,063,AGUA DE LOS LEONES,2,10,5,5,2
CHIHUAHUA,8,TEMÓSACHIC,063,BABÍCORA DE CONOACHIC,4,65,34,31,5
CHIHUAHUA,8,TEMÓSACHIC,063,COCOMORACHIC,3,56,25,31,6
CHIHUAHUA,8,TEMÓSACHIC,063,JANOS,1,17,8,9,1
CHIHUAHUA,8,TEMÓSACHIC,063,LA CIÉNEGA BLANCA (LOS CHIQUEROS),2,23,11,12,2
CHIHUAHUA,8,TEMÓSACHIC,063,LAS HUERTAS DE COCOMORACHIC,1,6,4,2,1
CHIHUAHUA,8,TEMÓSACHIC,063,PIEDRAS AZULES,1,17,11,6,1
CHIHUAHUA,8,TEMÓSACHIC,063,TEMÓSACHIC,6,529,250,279,35
CHIHUAHUA,8,TEMÓSACHIC,063,TOSANACHI,3,41,21,20,5
CHIHUAHUA,8,TEMÓSACHIC,063,TUTUACA,3,44,23,21,4
CHIHUAHUA,8,TEMÓSACHIC,063,VALLECILLO,2,15,6,9,2
CHIHUAHUA,8,TEMÓSACHIC,063,YEPACHIC,5,370,187,183,20
CHIHUAHUA,8,TEMÓSACHIC,063,YEPÓMERA,2,42,18,24,2
CHIHUAHUA,8,EL TULE,064,CARLOS A. MADRAZO (EJIDO EL ÁLAMO),1,15,6,9,1
CHIHUAHUA,8,EL TULE,064,EL TULE,5,202,112,90,14
CHIHUAHUA,8,EL TULE,064,SAN MATEO,2,30,9,21,2
CHIHUAHUA,8,EL TULE,064,VAQUETEROS (SAN JOSÉ DE VAQUETEROS),3,72,37,35,4
CHIHUAHUA,8,URIQUE,065,AGUA CALIENTE,1,4,3,1,1
CHIHUAHUA,8,URIQUE,065,AGUA ZARCA (LA CASETA),3,32,18,14,3
CHIHUAHUA,8,URIQUE,065,AREPONAPUCHI,3,148,80,68,11
CHIHUAHUA,8,URIQUE,065,BACABA,1,19,10,9,1
CHIHUAHUA,8,URIQUE,065,BACAJIPARE (HUACAJIPARE),2,27,15,12,2
CHIHUAHUA,8,URIQUE,065,BAHUICHIVO,5,413,204,209,21
CHIHUAHUA,8,URIQUE,065,BAJICHI,3,97,46,51,5
CHIHUAHUA,8,URIQUE,065,BALOJAQUE,1,29,13,16,1
CHIHUAHUA,8,URIQUE,065,BARAGOMACHI VIEJO,3,35,17,18,3
CHIHUAHUA,8,URIQUE,065,BASAGOTA,3,37,11,26,3
CHIHUAHUA,8,URIQUE,065,BASIGOCHI,2,34,21,13,2
CHIHUAHUA,8,URIQUE,065,BORE,2,11,3,8,2
CHIHUAHUA,8,URIQUE,065,CEROCAHUI,7,577,321,256,27
CHIHUAHUA,8,URIQUE,065,CHURO,3,162,88,74,8
CHIHUAHUA,8,URIQUE,065,CIENEGUITA DE BARRANCA,3,105,51,54,6
CHIHUAHUA,8,URIQUE,065,CIENEGUITA LLUVIA DE ORO,3,195,106,89,11
CHIHUAHUA,8,URIQUE,065,CORAREACHI,4,247,118,129,14
CHIHUAHUA,8,URIQUE,065,CUITECO,4,207,102,105,13
CHIHUAHUA,8,URIQUE,065,EL CARRIZAL,2,64,35,29,3
CHIHUAHUA,8,URIQUE,065,EL HORMIGUERO,2,77,33,44,3
CHIHUAHUA,8,URIQUE,065,EL MANZANO,1,9,4,5,1
CHIHUAHUA,8,URIQUE,065,EL METATE,1,37,15,22,1
CHIHUAHUA,8,URIQUE,065,EL NARANJO,3,31,13,18,3
CHIHUAHUA,8,URIQUE,065,EL PINAL,1,21,9,12,1
CHIHUAHUA,8,URIQUE,065,EL RANCHITO,1,8,4,4,1
CHIHUAHUA,8,URIQUE,065,EL SAUCILLO,1,11,8,3,1
CHIHUAHUA,8,URIQUE,065,GUADALUPE CORONADO,3,153,70,83,10
CHIHUAHUA,8,URIQUE,065,GUAGUEYVO,3,235,126,109,11
CHIHUAHUA,8,URIQUE,065,GUALLENACHI,1,31,14,17,2
CHIHUAHUA,8,URIQUE,065,GUAPALAYNA,6,244,98,146,14
CHIHUAHUA,8,URIQUE,065,HUATEACHI,1,17,6,11,1
CHIHUAHUA,8,URIQUE,065,HUICOCHI,1,9,3,6,1
CHIHUAHUA,8,URIQUE,065,HUICORACHI,2,31,12,19,2
CHIHUAHUA,8,URIQUE,065,LA CARRETA,1,43,17,26,2
CHIHUAHUA,8,URIQUE,065,LA LAJA,2,45,19,26,3
CHIHUAHUA,8,URIQUE,065,LA LLUVIA DE ORO,1,73,37,36,4
CHIHUAHUA,8,URIQUE,065,LA MISIÓN,3,61,27,34,5
CHIHUAHUA,8,URIQUE,065,LA PINOSA,1,20,10,10,1
CHIHUAHUA,8,URIQUE,065,LA REFORMA,4,115,56,59,11
CHIHUAHUA,8,URIQUE,065,LAS MORAS,4,134,64,70,7
CHIHUAHUA,8,URIQUE,065,MESA DE ARTURO,3,54,30,24,4
CHIHUAHUA,8,URIQUE,065,MESA DE GÜITAYVO,2,23,7,16,2
CHIHUAHUA,8,URIQUE,065,MESA DEL CONEJO,2,13,3,10,2
CHIHUAHUA,8,URIQUE,065,MESA DEL SOMBRERO,2,19,7,12,2
CHIHUAHUA,8,URIQUE,065,MOGOTAVO,1,23,9,14,1
CHIHUAHUA,8,URIQUE,065,MORIBO,1,12,1,11,1
CHIHUAHUA,8,URIQUE,065,NARANJO AYRO,1,11,3,8,1
CHIHUAHUA,8,URIQUE,065,PAMACHI,2,140,54,86,6
CHIHUAHUA,8,URIQUE,065,PIE DE LA CUESTA,2,32,13,19,2
CHIHUAHUA,8,URIQUE,065,PIEDRA BLANCA,1,22,6,16,1
CHIHUAHUA,8,URIQUE,065,PIEDRAS VERDES (TRIGUITO),3,265,125,140,12
CHIHUAHUA,8,URIQUE,065,POROCHI,4,78,35,43,6
CHIHUAHUA,8,URIQUE,065,POTRERITO,1,15,10,5,1
CHIHUAHUA,8,URIQUE,065,PUERTO DE ACARABO,2,140,76,64,8
CHIHUAHUA,8,URIQUE,065,RANCHO ESTRELLA,1,12,8,4,1
CHIHUAHUA,8,URIQUE,065,RINCÓN DE SEGORACHI,1,5,2,3,1
CHIHUAHUA,8,URIQUE,065,SAN ALONSO,4,74,24,50,5
CHIHUAHUA,8,URIQUE,065,SAN ISIDRO,2,30,12,18,2
CHIHUAHUA,8,URIQUE,065,SAN JOSÉ DEL PINAL,2,105,41,64,5
CHIHUAHUA,8,URIQUE,065,SAN PABLO,3,85,34,51,5
CHIHUAHUA,8,URIQUE,065,SAN RAFAEL,9,887,456,431,49
CHIHUAHUA,8,URIQUE,065,SEGORACHI,1,19,6,13,1
CHIHUAHUA,8,URIQUE,065,SEHUERACHI,1,14,8,6,1
CHIHUAHUA,8,URIQUE,065,TÓNACHI,1,19,15,4,1
CHIHUAHUA,8,URIQUE,065,TUBARES,3,49,24,25,3
CHIHUAHUA,8,URIQUE,065,URIQUE,4,297,151,146,21
CHIHUAHUA,8,URUACHI,066,AGUA FRÍA,3,49,26,23,4
CHIHUAHUA,8,URUACHI,066,AGUATIACHI,2,8,4,4,1
CHIHUAHUA,8,URUACHI,066,ARACOYVO,2,12,6,6,2
CHIHUAHUA,8,URUACHI,066,ARECHUYVO,4,123,59,64,10
CHIHUAHUA,8,URUACHI,066,ARROYO DEL OSO,1,13,8,5,1
CHIHUAHUA,8,URUACHI,066,ARROYO EL OSO,1,6,5,1,1
CHIHUAHUA,8,URUACHI,066,BAHUICHIVO,1,5,2,3,1
CHIHUAHUA,8,URUACHI,066,CALAVERAS,4,90,42,48,8
CHIHUAHUA,8,URUACHI,066,CERRO PRIETO,1,7,4,3,1
CHIHUAHUA,8,URUACHI,066,CHAGAYVO,1,9,5,4,1
CHIHUAHUA,8,URUACHI,066,EL MANZANO,4,102,50,52,7
CHIHUAHUA,8,URUACHI,066,EL REBAJE,4,65,31,34,5
CHIHUAHUA,8,URUACHI,066,EL TRIGO DE URUACHI,2,18,10,8,2
CHIHUAHUA,8,URUACHI,066,GOSOGACHI,4,115,65,50,8
CHIHUAHUA,8,URUACHI,066,GUACHEACHI,3,125,63,62,6
CHIHUAHUA,8,URUACHI,066,GUASAGO,1,21,12,9,1
CHIHUAHUA,8,URUACHI,066,HACIENDA SÁENZ (SANTÍSIMO DE ABAJO),3,50,29,21,3
CHIHUAHUA,8,URUACHI,066,HÉROES DE LA TABLETA,2,4,0,4,1
CHIHUAHUA,8,URUACHI,066,JICAMORACHI,6,157,81,76,10
CHIHUAHUA,8,URUACHI,066,LA BARRANCA,1,6,2,4,1
CHIHUAHUA,8,URUACHI,066,LA CUMBRE,2,24,11,13,2
CHIHUAHUA,8,URUACHI,066,LAS CONCHAS,1,6,2,4,1
CHIHUAHUA,8,URUACHI,066,LAS TROJAS,1,11,5,6,1
CHIHUAHUA,8,URUACHI,066,LOS TEPOZANES,1,17,8,9,1
CHIHUAHUA,8,URUACHI,066,MESA DEL VALLECILLO,1,4,2,2,1
CHIHUAHUA,8,URUACHI,066,MOCORICHI DE ARRIBA,1,27,14,13,1
CHIHUAHUA,8,URUACHI,066,ORISIVO,3,37,18,19,3
CHIHUAHUA,8,URUACHI,066,PACAYVO,1,2,1,1,1
CHIHUAHUA,8,URUACHI,066,PALMARITO (AGUA CALIENTE),2,22,12,10,2
CHIHUAHUA,8,URUACHI,066,RINCÓN DEL TORO,1,5,5,0,1
CHIHUAHUA,8,URUACHI,066,ROCOROYVO,3,168,78,90,10
CHIHUAHUA,8,URUACHI,066,SAGUARAVO,1,24,8,16,1
CHIHUAHUA,8,URUACHI,066,SAN ANTONIO,3,29,13,16,3
CHIHUAHUA,8,URUACHI,066,SAN IGNACIO,1,6,5,1,1
CHIHUAHUA,8,URUACHI,066,SAN JUAN,1,33,19,14,2
CHIHUAHUA,8,URUACHI,066,SANTA ROSA,1,17,10,7,1
CHIHUAHUA,8,URUACHI,066,SANTÍSIMO DE ARRIBA,1,16,8,8,1
CHIHUAHUA,8,URUACHI,066,TACOCHIQUE,1,4,1,3,1
CHIHUAHUA,8,URUACHI,066,URUACHI,7,542,257,285,29
CHIHUAHUA,8,VALLE DE ZARAGOZA,067,COLONIA GALVÁN (RANCHO OCHO),2,176,93,83,9
CHIHUAHUA,8,VALLE DE ZARAGOZA,067,GUILLERMO QUEVEDO (EL ANCÓN DEL BURRO),1,6,5,1,1
CHIHUAHUA,8,VALLE DE ZARAGOZA,067,SALITRITO,2,48,19,29,4
CHIHUAHUA,8,VALLE DE ZARAGOZA,067,SAN FELIPE DE JESÚS,2,22,11,11,2
CHIHUAHUA,8,VALLE DE ZARAGOZA,067,VALLE DE ZARAGOZA,4,507,258,249,27
CIUDAD DE MÉXICO,9,AZCAPOTZALCO,002,AZCAPOTZALCO,400,170100,84089,86011,10247
CIUDAD DE MÉXICO,9,COYOACÁN,003,COYOACÁN,653,393514,201878,191636,53902
CIUDAD DE MÉXICO,9,CUAJIMALPA DE MORELOS,004,CUAJIMALPA DE MORELOS,295,62626,31279,31347,4148
CIUDAD DE MÉXICO,9,GUSTAVO A. MADERO,005,GUSTAVO A. MADERO,1142,411177,206960,204217,24101
CIUDAD DE MÉXICO,9,IZTACALCO,006,IZTACALCO,364,99224,48613,50611,7163
CIUDAD DE MÉXICO,9,IZTAPALAPA,007,IZTAPALAPA,1384,393500,198419,195081,24478
CIUDAD DE MÉXICO,9,LA MAGDALENA CONTRERAS,008,LA MAGDALENA CONTRERAS,197,43516,22395,21121,2719
CIUDAD DE MÉXICO,9,LA MAGDALENA CONTRERAS,008,SEGUNDO DINAMO,1,133,66,67,22
CIUDAD DE MÉXICO,9,MILPA ALTA,009,SAN BARTOLOMÉ XICOMULCO,1,195,107,88,21
CIUDAD DE MÉXICO,9,MILPA ALTA,009,SANTA ANA TLACOTENCO,1,213,141,72,9
CIUDAD DE MÉXICO,9,MILPA ALTA,009,VILLA MILPA ALTA,129,40463,21478,18985,2923
CIUDAD DE MÉXICO,9,ÁLVARO OBREGÓN,010,ÁLVARO OBREGÓN,685,326085,189015,137070,19139
CIUDAD DE MÉXICO,9,TLÁHUAC,011,SAN JUAN IXTAYOPAN,1,1216,501,715,16
CIUDAD DE MÉXICO,9,TLÁHUAC,011,SAN NICOLÁS TETELCO,1,1160,603,557,55
CIUDAD DE MÉXICO,9,TLÁHUAC,011,TLÁHUAC,287,82638,39582,43056,4344
CIUDAD DE MÉXICO,9,TLALPAN,012,SAN MIGUEL AJUSCO,3,88,41,47,6
CIUDAD DE MÉXICO,9,TLALPAN,012,SAN MIGUEL TOPILEJO,1,676,303,373,19
CIUDAD DE MÉXICO,9,TLALPAN,012,TLALPAN,613,155007,78855,76152,13499
CIUDAD DE MÉXICO,9,XOCHIMILCO,013,XOCHIMILCO,337,97323,50224,47099,6636
CIUDAD DE MÉXICO,9,BENITO JUÁREZ,014,BENITO JUÁREZ,517,218144,113075,105069,10270
CIUDAD DE MÉXICO,9,CUAUHTÉMOC,015,CUAUHTÉMOC,740,217794,112502,105292,15636
CIUDAD DE MÉXICO,9,MIGUEL HIDALGO,016,MIGUEL HIDALGO,508,137641,73717,63924,12303
CIUDAD DE MÉXICO,9,VENUSTIANO CARRANZA,017,VENUSTIANO CARRANZA,399,80855,40043,40812,5798
COAHUILA DE ZARAGOZA,5,ABASOLO,001,ABASOLO,5,184,85,99,18
COAHUILA DE ZARAGOZA,5,ABASOLO,001,LOS RODRÍGUEZ,2,38,19,19,2
COAHUILA DE ZARAGOZA,5,ACUÑA,002,BALCONES,2,42,21,21,3
COAHUILA DE ZARAGOZA,5,ACUÑA,002,BUENA VISTA,2,26,12,14,2
COAHUILA DE ZARAGOZA,5,ACUÑA,002,CALLES,4,124,60,64,9
COAHUILA DE ZARAGOZA,5,ACUÑA,002,CIUDAD ACUÑA,203,44936,22418,22518,2358
COAHUILA DE ZARAGOZA,5,ACUÑA,002,EL PILAR,1,20,9,11,1
COAHUILA DE ZARAGOZA,5,ACUÑA,002,EL VENADITO,2,21,10,11,2
COAHUILA DE ZARAGOZA,5,ACUÑA,002,JOSÉ MARÍA MORELOS,1,2,1,1,0
COAHUILA DE ZARAGOZA,5,ACUÑA,002,LA ESMERALDA,2,29,10,19,2
COAHUILA DE ZARAGOZA,5,ACUÑA,002,LAS CUEVAS,5,443,206,237,16
COAHUILA DE ZARAGOZA,5,ALLENDE,003,ALLENDE,36,5378,2760,2618,292
COAHUILA DE ZARAGOZA,5,ALLENDE,003,CHAMACUERO (EL SEIS),1,20,11,9,1
COAHUILA DE ZARAGOZA,5,ALLENDE,003,LA TEMBLADORA,2,107,50,57,4
COAHUILA DE ZARAGOZA,5,ALLENDE,003,RÍO BRAVO,4,240,118,122,14
COAHUILA DE ZARAGOZA,5,ARTEAGA,004,ARTEAGA,29,7464,3291,4173,792
COAHUILA DE ZARAGOZA,5,ARTEAGA,004,ARTESILLAS,4,136,61,75,10
COAHUILA DE ZARAGOZA,5,ARTEAGA,004,CHAPULTEPEC (CHAPUL),2,44,22,22,3
COAHUILA DE ZARAGOZA,5,ARTEAGA,004,EL ARBOLITO,1,11,9,2,1
COAHUILA DE ZARAGOZA,5,ARTEAGA,004,EL CEDRITO,2,30,15,15,2
COAHUILA DE ZARAGOZA,5,ARTEAGA,004,EL DIAMANTE,2,28,12,16,2
COAHUILA DE ZARAGOZA,5,ARTEAGA,004,EL DIECIOCHO DE MARZO (EL DIECIOCHO),2,56,24,32,3
COAHUILA DE ZARAGOZA,5,ARTEAGA,004,EL PINAR,1,6,6,0,8
COAHUILA DE ZARAGOZA,5,ARTEAGA,004,EL POLEO,2,58,30,28,3
COAHUILA DE ZARAGOZA,5,ARTEAGA,004,EL PORVENIR,2,11,6,5,2
COAHUILA DE ZARAGOZA,5,ARTEAGA,004,EL TUNAL,4,313,168,145,28
COAHUILA DE ZARAGOZA,5,ARTEAGA,004,EMILIANO ZAPATA,2,69,33,36,4
COAHUILA DE ZARAGOZA,5,ARTEAGA,004,ESCOBEDO,2,136,76,60,5
COAHUILA DE ZARAGOZA,5,ARTEAGA,004,HUACHICHIL (EL HUACHE),5,719,349,370,38
COAHUILA DE ZARAGOZA,5,ARTEAGA,004,JAME,2,54,34,20,3
COAHUILA DE ZARAGOZA,5,ARTEAGA,004,LA BIZNAGA,4,199,97,102,10
COAHUILA DE ZARAGOZA,5,ARTEAGA,004,LA CIRUELA,1,69,30,39,3
COAHUILA DE ZARAGOZA,5,ARTEAGA,004,LA EFIGENIA,2,37,19,18,2
COAHUILA DE ZARAGOZA,5,ARTEAGA,004,LA PRESA,2,57,26,31,3
COAHUILA DE ZARAGOZA,5,ARTEAGA,004,LA ROSITA,1,2,1,1,1
COAHUILA DE ZARAGOZA,5,ARTEAGA,004,LOS LIRIOS,2,124,57,67,7
COAHUILA DE ZARAGOZA,5,ARTEAGA,004,LOS LLANOS,2,48,23,25,3
COAHUILA DE ZARAGOZA,5,ARTEAGA,004,LOS QUELITES,4,53,32,21,5
COAHUILA DE ZARAGOZA,5,ARTEAGA,004,MESA DE LAS TABLAS,4,70,42,28,4
COAHUILA DE ZARAGOZA,5,ARTEAGA,004,NUNCIO,2,19,11,8,2
COAHUILA DE ZARAGOZA,5,ARTEAGA,004,PIEDRA BLANCA (EL RANCHITO),3,80,38,42,5
COAHUILA DE ZARAGOZA,5,ARTEAGA,004,POTRERO DE ÁBREGO,3,47,20,27,4
COAHUILA DE ZARAGOZA,5,ARTEAGA,004,SAN ANTONIO DE LAS ALAZANAS,6,930,494,436,40
COAHUILA DE ZARAGOZA,5,ARTEAGA,004,SAN JOSÉ DEL VERGEL,1,8,2,6,1
COAHUILA DE ZARAGOZA,5,ARTEAGA,004,SAN JUAN DE LOS DOLORES,2,50,21,29,3
COAHUILA DE ZARAGOZA,5,ARTEAGA,004,SAN JUANITO (SAN JUANITO DE LOS VALDEZ),2,44,16,28,3
COAHUILA DE ZARAGOZA,5,ARTEAGA,004,SANTA RITA,2,43,15,28,3
COAHUILA DE ZARAGOZA,5,ARTEAGA,004,SIERRA HERMOSA,4,92,52,40,7
COAHUILA DE ZARAGOZA,5,ARTEAGA,004,TIERRAS PRIETAS,2,15,6,9,2
COAHUILA DE ZARAGOZA,5,CANDELA,005,CANDELA,5,354,157,197,30
COAHUILA DE ZARAGOZA,5,CANDELA,005,EL HUIZACHAL,2,32,17,15,3
COAHUILA DE ZARAGOZA,5,CASTAÑOS,006,ACÁMBARO (ACÁMBARO VIEJO),2,23,14,9,2
COAHUILA DE ZARAGOZA,5,CASTAÑOS,006,BAJÁN (ESTACIÓN BAJÁN),2,24,10,14,2
COAHUILA DE ZARAGOZA,5,CASTAÑOS,006,CASTAÑOS,42,7469,3611,3858,320
COAHUILA DE ZARAGOZA,5,CASTAÑOS,006,DOLORES,4,69,35,34,7
COAHUILA DE ZARAGOZA,5,CASTAÑOS,006,ESPINAZO,3,34,22,12,5
COAHUILA DE ZARAGOZA,5,CASTAÑOS,006,PALO BLANCO,2,28,12,16,2
COAHUILA DE ZARAGOZA,5,CASTAÑOS,006,PRESA RODRÍGUEZ,3,29,12,17,3
COAHUILA DE ZARAGOZA,5,CASTAÑOS,006,SANTA TERESA,2,27,13,14,2
COAHUILA DE ZARAGOZA,5,CASTAÑOS,006,SOLEDAD,4,71,39,32,7
COAHUILA DE ZARAGOZA,5,CUATRO CIÉNEGAS,007,ANTIGUOS MINEROS DEL NORTE (SANTA TECLA),2,7,3,4,1
COAHUILA DE ZARAGOZA,5,CUATRO CIÉNEGAS,007,CUATES DE ABAJO (CERROS PRIETOS),2,14,6,8,1
COAHUILA DE ZARAGOZA,5,CUATRO CIÉNEGAS,007,CUATES DE AUSTRALIA,3,46,25,21,5
COAHUILA DE ZARAGOZA,5,CUATRO CIÉNEGAS,007,CUATRO CIÉNEGAS DE CARRANZA,17,2818,1428,1390,142
COAHUILA DE ZARAGOZA,5,CUATRO CIÉNEGAS,007,EL DORMIDO,2,6,5,1,2
COAHUILA DE ZARAGOZA,5,CUATRO CIÉNEGAS,007,EL OSO,2,24,13,11,2
COAHUILA DE ZARAGOZA,5,CUATRO CIÉNEGAS,007,EL VENADO,3,27,14,13,3
COAHUILA DE ZARAGOZA,5,CUATRO CIÉNEGAS,007,ESTANQUE DE LEÓN,4,93,45,48,8
COAHUILA DE ZARAGOZA,5,CUATRO CIÉNEGAS,007,ESTANQUE DE NORIAS,4,57,31,26,5
COAHUILA DE ZARAGOZA,5,CUATRO CIÉNEGAS,007,ESTANQUE DE PALOMAS (LAS PALOMAS),3,32,19,13,3
COAHUILA DE ZARAGOZA,5,CUATRO CIÉNEGAS,007,GABINO VÁZQUEZ (EL NARANJO),2,17,8,9,2
COAHUILA DE ZARAGOZA,5,CUATRO CIÉNEGAS,007,LA VEGA,2,17,12,5,2
COAHUILA DE ZARAGOZA,5,CUATRO CIÉNEGAS,007,LUCIO BLANCO (LA PELOTA),3,31,9,22,4
COAHUILA DE ZARAGOZA,5,CUATRO CIÉNEGAS,007,SAN JUAN DE BOQUILLAS (SAN JUAN),1,15,7,8,1
COAHUILA DE ZARAGOZA,5,CUATRO CIÉNEGAS,007,SANTA TERESA DE SOFÍA,3,84,34,50,8
COAHUILA DE ZARAGOZA,5,CUATRO CIÉNEGAS,007,TANQUE NUEVO (EL CINCO),4,86,44,42,8
COAHUILA DE ZARAGOZA,5,ESCOBEDO,008,AGUA DE LA HERRADURA,2,36,17,19,3
COAHUILA DE ZARAGOZA,5,ESCOBEDO,008,ESCOBEDO,2,65,33,32,4
COAHUILA DE ZARAGOZA,5,ESCOBEDO,008,OBAYOS,2,37,16,21,3
COAHUILA DE ZARAGOZA,5,ESCOBEDO,008,PRIMERO DE MAYO,4,524,256,268,41
COAHUILA DE ZARAGOZA,5,FRANCISCO I. MADERO,009,ALAMITO,2,136,57,79,7
COAHUILA DE ZARAGOZA,5,FRANCISCO I. MADERO,009,BATOPILAS,4,162,83,79,11
COAHUILA DE ZARAGOZA,5,FRANCISCO I. MADERO,009,BENITO JUÁREZ,2,131,59,72,8
COAHUILA DE ZARAGOZA,5,FRANCISCO I. MADERO,009,BUENAVISTA DE ARRIBA,2,163,75,88,8
COAHUILA DE ZARAGOZA,5,FRANCISCO I. MADERO,009,CHARCOS DE RISA,4,81,42,39,6
COAHUILA DE ZARAGOZA,5,FRANCISCO I. MADERO,009,COLÓN,1,90,40,50,6
COAHUILA DE ZARAGOZA,5,FRANCISCO I. MADERO,009,COVADONGA,2,86,41,45,5
COAHUILA DE ZARAGOZA,5,FRANCISCO I. MADERO,009,DIECIOCHO DE MARZO,2,59,26,33,3
COAHUILA DE ZARAGOZA,5,FRANCISCO I. MADERO,009,EL CÁNTABRO,2,57,30,27,4
COAHUILA DE ZARAGOZA,5,FRANCISCO I. MADERO,009,EL PORVENIR (EL PORVENIR DE ARRIBA),3,362,160,202,27
COAHUILA DE ZARAGOZA,5,FRANCISCO I. MADERO,009,EL VENADO,2,7,3,4,2
COAHUILA DE ZARAGOZA,5,FRANCISCO I. MADERO,009,FELIPE ÁNGELES,3,20,11,9,3
COAHUILA DE ZARAGOZA,5,FRANCISCO I. MADERO,009,FINISTERRE,4,164,76,88,9
COAHUILA DE ZARAGOZA,5,FRANCISCO I. MADERO,009,FLORENCIA,2,129,66,63,6
COAHUILA DE ZARAGOZA,5,FRANCISCO I. MADERO,009,FRANCISCO I. MADERO (BANCO DE LONDRES),2,23,13,10,3
COAHUILA DE ZARAGOZA,5,FRANCISCO I. MADERO,009,FRANCISCO I. MADERO,63,10357,5348,5009,631
COAHUILA DE ZARAGOZA,5,FRANCISCO I. MADERO,009,JABONCILLO,1,163,72,91,6
COAHUILA DE ZARAGOZA,5,FRANCISCO I. MADERO,009,LA CORUÑA,2,157,73,84,8
COAHUILA DE ZARAGOZA,5,FRANCISCO I. MADERO,009,LA FLORIDA,3,449,226,223,21
COAHUILA DE ZARAGOZA,5,FRANCISCO I. MADERO,009,LA PINTA,4,278,142,136,24
COAHUILA DE ZARAGOZA,5,FRANCISCO I. MADERO,009,LA TRINIDAD,1,7,4,3,1
COAHUILA DE ZARAGOZA,5,FRANCISCO I. MADERO,009,LAS MERCEDES,3,136,74,62,6
COAHUILA DE ZARAGOZA,5,FRANCISCO I. MADERO,009,LEQUEITIO,6,1004,511,493,63
COAHUILA DE ZARAGOZA,5,FRANCISCO I. MADERO,009,LINDA VISTA,1,3,0,3,1
COAHUILA DE ZARAGOZA,5,FRANCISCO I. MADERO,009,NUEVO LEÓN,2,196,93,103,9
COAHUILA DE ZARAGOZA,5,FRANCISCO I. MADERO,009,SALOÑA (TRES NORIAS),2,30,22,8,2
COAHUILA DE ZARAGOZA,5,FRANCISCO I. MADERO,009,SAN AGUSTÍN DE ULÚA,2,52,28,24,3
COAHUILA DE ZARAGOZA,5,FRANCISCO I. MADERO,009,SAN ESTEBAN DE EGIPTO,2,90,53,37,4
COAHUILA DE ZARAGOZA,5,FRANCISCO I. MADERO,009,SAN ISIDRO,2,28,14,14,2
COAHUILA DE ZARAGOZA,5,FRANCISCO I. MADERO,009,SAN JOSÉ DE LA NIÑA,4,301,147,154,28
COAHUILA DE ZARAGOZA,5,FRANCISCO I. MADERO,009,SAN JUAN DE ULÚA,2,66,36,30,3
COAHUILA DE ZARAGOZA,5,FRANCISCO I. MADERO,009,SAN SALVADOR DE ARRIBA,3,111,62,49,6
COAHUILA DE ZARAGOZA,5,FRANCISCO I. MADERO,009,SANTA MARÍA (SANTA MARÍA DE ARRIBA),2,79,34,45,4
COAHUILA DE ZARAGOZA,5,FRANCISCO I. MADERO,009,SEIS DE OCTUBRE (SANTO NIÑO),2,287,148,139,12
COAHUILA DE ZARAGOZA,5,FRANCISCO I. MADERO,009,TRES MANANTIALES (LA PARRITA),3,15,5,10,3
COAHUILA DE ZARAGOZA,5,FRANCISCO I. MADERO,009,YUCATÁN,2,57,25,32,3
COAHUILA DE ZARAGOZA,5,FRONTERA,010,FRONTERA,85,17154,8384,8770,938
COAHUILA DE ZARAGOZA,5,FRONTERA,010,NUEVO POBLADO DE FRESNILLO (FRESNILLO),2,42,18,24,2
COAHUILA DE ZARAGOZA,5,FRONTERA,010,OCHO DE ENERO,7,925,476,449,51
COAHUILA DE ZARAGOZA,5,GENERAL CEPEDA,011,BENECIO LÓPEZ PADILLA (BENITO JUÁREZ),1,12,5,7,1
COAHUILA DE ZARAGOZA,5,GENERAL CEPEDA,011,DOS DE ABRIL,2,17,11,6,2
COAHUILA DE ZARAGOZA,5,GENERAL CEPEDA,011,EL GAVILLERO,1,5,2,3,1
COAHUILA DE ZARAGOZA,5,GENERAL CEPEDA,011,EL JARALITO,2,21,13,8,2
COAHUILA DE ZARAGOZA,5,GENERAL CEPEDA,011,EL NOGAL,2,36,19,17,3
COAHUILA DE ZARAGOZA,5,GENERAL CEPEDA,011,EL PILAR DE RICHARDSON,4,160,84,76,13
COAHUILA DE ZARAGOZA,5,GENERAL CEPEDA,011,EL TANQUE SAN VICENTE,1,7,2,5,1
COAHUILA DE ZARAGOZA,5,GENERAL CEPEDA,011,EL TEJOCOTE,2,17,9,8,2
COAHUILA DE ZARAGOZA,5,GENERAL CEPEDA,011,GENERAL CEPEDA,10,2226,1164,1062,122
COAHUILA DE ZARAGOZA,5,GENERAL CEPEDA,011,GUELATAO,2,67,36,31,4
COAHUILA DE ZARAGOZA,5,GENERAL CEPEDA,011,INDEPENDENCIA,2,36,17,19,2
COAHUILA DE ZARAGOZA,5,GENERAL CEPEDA,011,JALPA,4,74,44,30,7
COAHUILA DE ZARAGOZA,5,GENERAL CEPEDA,011,LA HEDIONDA CHICA,2,36,18,18,3
COAHUILA DE ZARAGOZA,5,GENERAL CEPEDA,011,LA LUZ Y COLÓN,2,11,4,7,2
COAHUILA DE ZARAGOZA,5,GENERAL CEPEDA,011,LA NORIA DE LA SABINA,2,26,9,17,2
COAHUILA DE ZARAGOZA,5,GENERAL CEPEDA,011,LA PAZ,2,36,21,15,3
COAHUILA DE ZARAGOZA,5,GENERAL CEPEDA,011,LA PUERTA,2,37,15,22,3
COAHUILA DE ZARAGOZA,5,GENERAL CEPEDA,011,LA ROSA,4,227,111,116,18
COAHUILA DE ZARAGOZA,5,GENERAL CEPEDA,011,LA TRINIDAD,2,71,44,27,4
COAHUILA DE ZARAGOZA,5,GENERAL CEPEDA,011,MACUYÚ,3,97,47,50,4
COAHUILA DE ZARAGOZA,5,GENERAL CEPEDA,011,MARTE (ESTACIÓN MARTE),1,24,12,12,2
COAHUILA DE ZARAGOZA,5,GENERAL CEPEDA,011,PORVENIR DE JALPA,1,12,8,4,1
COAHUILA DE ZARAGOZA,5,GENERAL CEPEDA,011,PORVENIR DE TACUBAYA,4,167,85,82,9
COAHUILA DE ZARAGOZA,5,GENERAL CEPEDA,011,PRESA DE GUADALUPE (GUADALUPE),4,131,64,67,8
COAHUILA DE ZARAGOZA,5,GENERAL CEPEDA,011,RINCÓN COLORADO,1,16,6,10,1
COAHUILA DE ZARAGOZA,5,GENERAL CEPEDA,011,SAN ANTONIO DEL JARAL,2,67,38,29,4
COAHUILA DE ZARAGOZA,5,GENERAL CEPEDA,011,SAN JOSÉ DEL REFUGIO,2,50,27,23,3
COAHUILA DE ZARAGOZA,5,GENERAL CEPEDA,011,SANTA INÉS (EL OJITO),1,13,5,8,1
COAHUILA DE ZARAGOZA,5,GUERRERO,012,EL SAUCITO,1,18,8,10,1
COAHUILA DE ZARAGOZA,5,GUERRERO,012,GUADALUPE,2,39,15,24,3
COAHUILA DE ZARAGOZA,5,GUERRERO,012,GUERRERO,4,227,104,123,23
COAHUILA DE ZARAGOZA,5,GUERRERO,012,SANTA MÓNICA,4,158,62,96,10
COAHUILA DE ZARAGOZA,5,HIDALGO,013,HIDALGO,5,481,235,246,20
COAHUILA DE ZARAGOZA,5,JIMÉNEZ,014,CRISTALES,2,44,20,24,3
COAHUILA DE ZARAGOZA,5,JIMÉNEZ,014,EL DIVISADERO,4,110,59,51,8
COAHUILA DE ZARAGOZA,5,JIMÉNEZ,014,EL ORÉGANO,3,159,74,85,6
COAHUILA DE ZARAGOZA,5,JIMÉNEZ,014,EL TEPEYAC,2,40,16,24,2
COAHUILA DE ZARAGOZA,5,JIMÉNEZ,014,EMILIANO ZAPATA (SANTA ELENA),2,24,9,15,2
COAHUILA DE ZARAGOZA,5,JIMÉNEZ,014,JIMÉNEZ,6,529,288,241,29
COAHUILA DE ZARAGOZA,5,JIMÉNEZ,014,LA BANDERA (NUEVA BANDERA),2,5,3,2,1
COAHUILA DE ZARAGOZA,5,JIMÉNEZ,014,LA MURALLA,2,65,33,32,4
COAHUILA DE ZARAGOZA,5,JIMÉNEZ,014,LA POTASA,2,28,11,17,3
COAHUILA DE ZARAGOZA,5,JIMÉNEZ,014,MADERO DEL RÍO,6,191,91,100,14
COAHUILA DE ZARAGOZA,5,JIMÉNEZ,014,NUEVA JARITA,2,19,8,11,2
COAHUILA DE ZARAGOZA,5,JIMÉNEZ,014,PALMIRA (VICTORIA),4,120,61,59,9
COAHUILA DE ZARAGOZA,5,JIMÉNEZ,014,PURÍSIMA,2,56,28,28,3
COAHUILA DE ZARAGOZA,5,JIMÉNEZ,014,SAN CARLOS,6,879,458,421,50
COAHUILA DE ZARAGOZA,5,JIMÉNEZ,014,SAN VICENTE,2,17,5,12,2
COAHUILA DE ZARAGOZA,5,JIMÉNEZ,014,SANTA MARÍA,2,164,82,82,8
COAHUILA DE ZARAGOZA,5,JIMÉNEZ,014,VIEJA PALESTINA,2,28,14,14,2
COAHUILA DE ZARAGOZA,5,JUÁREZ,015,DON MARTÍN,2,68,34,34,4
COAHUILA DE ZARAGOZA,5,JUÁREZ,015,EL CUARENTA Y CINCO,1,7,3,4,1
COAHUILA DE ZARAGOZA,5,JUÁREZ,015,JUÁREZ,4,309,178,131,23
COAHUILA DE ZARAGOZA,5,JUÁREZ,015,SECCIÓN 22-0,1,17,4,13,1
COAHUILA DE ZARAGOZA,5,LAMADRID,016,LAMADRID,4,294,140,154,20
COAHUILA DE ZARAGOZA,5,MATAMOROS,017,ANDALUCÍA,2,32,17,15,3
COAHUILA DE ZARAGOZA,5,MATAMOROS,017,ATALAYA,2,102,51,51,5
COAHUILA DE ZARAGOZA,5,MATAMOROS,017,BENITO JUÁREZ,2,37,23,14,3
COAHUILA DE ZARAGOZA,5,MATAMOROS,017,COMPUERTAS,2,98,50,48,4
COAHUILA DE ZARAGOZA,5,MATAMOROS,017,COREA,2,48,22,26,3
COAHUILA DE ZARAGOZA,5,MATAMOROS,017,CORONA,4,531,277,254,36
COAHUILA DE ZARAGOZA,5,MATAMOROS,017,EL CAMBIO,6,771,380,391,39
COAHUILA DE ZARAGOZA,5,MATAMOROS,017,EL CAMPANARIO,1,49,21,28,3
COAHUILA DE ZARAGOZA,5,MATAMOROS,017,EL CONSUELO,2,129,50,79,7
COAHUILA DE ZARAGOZA,5,MATAMOROS,017,EL COYOTE,7,1368,707,661,83
COAHUILA DE ZARAGOZA,5,MATAMOROS,017,EL CUIJE,4,502,221,281,34
COAHUILA DE ZARAGOZA,5,MATAMOROS,017,EL DÓLAR,1,15,8,7,1
COAHUILA DE ZARAGOZA,5,MATAMOROS,017,EL OLIVO,2,54,29,25,5
COAHUILA DE ZARAGOZA,5,MATAMOROS,017,EL PACÍFICO,2,73,41,32,5
COAHUILA DE ZARAGOZA,5,MATAMOROS,017,EL PILAR,6,326,155,171,8
COAHUILA DE ZARAGOZA,5,MATAMOROS,017,EL REFUGIO,2,130,53,77,7
COAHUILA DE ZARAGOZA,5,MATAMOROS,017,EL SACRIFICIO,2,80,42,38,5
COAHUILA DE ZARAGOZA,5,MATAMOROS,017,ESCUADRÓN DOSCIENTOS UNO,2,173,78,95,8
COAHUILA DE ZARAGOZA,5,MATAMOROS,017,FILIPINAS (LAMPACITOS),2,31,12,19,2
COAHUILA DE ZARAGOZA,5,MATAMOROS,017,FRESNO DEL SUR (EL FRESNO),2,44,23,21,3
COAHUILA DE ZARAGOZA,5,MATAMOROS,017,GRANADA,5,467,244,223,31
COAHUILA DE ZARAGOZA,5,MATAMOROS,017,GUADALUPE VICTORIA,3,131,60,71,6
COAHUILA DE ZARAGOZA,5,MATAMOROS,017,HIDALGO,7,1272,653,619,92
COAHUILA DE ZARAGOZA,5,MATAMOROS,017,HORMIGUERO,3,401,190,211,16
COAHUILA DE ZARAGOZA,5,MATAMOROS,017,IRLANDA,2,57,30,27,4
COAHUILA DE ZARAGOZA,5,MATAMOROS,017,LA ESPERANZA,3,199,104,95,9
COAHUILA DE ZARAGOZA,5,MATAMOROS,017,LA FLOR DE MAYO Y LA BARCA,4,398,203,195,18
COAHUILA DE ZARAGOZA,5,MATAMOROS,017,LA LIBERTAD,2,91,38,53,5
COAHUILA DE ZARAGOZA,5,MATAMOROS,017,LA LUZ,6,398,176,222,37
COAHUILA DE ZARAGOZA,5,MATAMOROS,017,LAS PALOMAS,1,15,7,8,1
COAHUILA DE ZARAGOZA,5,MATAMOROS,017,MANANTIAL,5,794,432,362,80
COAHUILA DE ZARAGOZA,5,MATAMOROS,017,MARAVILLAS,2,183,90,93,8
COAHUILA DE ZARAGOZA,5,MATAMOROS,017,MATAMOROS,87,15777,8066,7711,1436
COAHUILA DE ZARAGOZA,5,MATAMOROS,017,MONTE ALEGRE,2,70,30,40,4
COAHUILA DE ZARAGOZA,5,MATAMOROS,017,MORELOS DOS (BILBAO),1,1,1,0,1
COAHUILA DE ZARAGOZA,5,MATAMOROS,017,NOACAN,2,32,13,19,2
COAHUILA DE ZARAGOZA,5,MATAMOROS,017,NUEVO MIELERAS (LA TRES),1,9,2,7,1
COAHUILA DE ZARAGOZA,5,MATAMOROS,017,PETRONILAS,3,102,55,47,6
COAHUILA DE ZARAGOZA,5,MATAMOROS,017,PURÍSIMA,2,217,101,116,9
COAHUILA DE ZARAGOZA,5,MATAMOROS,017,RANCHO DE AFUERA,2,75,36,39,5
COAHUILA DE ZARAGOZA,5,MATAMOROS,017,SAN ANTONIO DEL ALTO,2,30,12,18,2
COAHUILA DE ZARAGOZA,5,MATAMOROS,017,SAN ANTONIO DEL COYOTE,5,787,392,395,32
COAHUILA DE ZARAGOZA,5,MATAMOROS,017,SAN FELIPE AGUANAVAL,3,127,56,71,9
COAHUILA DE ZARAGOZA,5,MATAMOROS,017,SAN ISIDRO,1,9,7,2,1
COAHUILA DE ZARAGOZA,5,MATAMOROS,017,SAN JULIÁN,2,67,39,28,4
COAHUILA DE ZARAGOZA,5,MATAMOROS,017,SANTA ANA DEL PILAR,4,321,153,168,28
COAHUILA DE ZARAGOZA,5,MATAMOROS,017,SANTO NIÑO AGUANAVAL,2,346,178,168,15
COAHUILA DE ZARAGOZA,5,MATAMOROS,017,SOLIMA,3,211,100,111,8
COAHUILA DE ZARAGOZA,5,MATAMOROS,017,SOLÍS,2,39,16,23,3
COAHUILA DE ZARAGOZA,5,MATAMOROS,017,UNIÓN DEL BARREAL,2,53,26,27,3
COAHUILA DE ZARAGOZA,5,MATAMOROS,017,VEINTE DE NOVIEMBRE,4,283,130,153,12
COAHUILA DE ZARAGOZA,5,MATAMOROS,017,VICENTE GUERRERO,2,48,16,32,3
COAHUILA DE ZARAGOZA,5,MATAMOROS,017,VIZCAYA,1,20,12,8,1
COAHUILA DE ZARAGOZA,5,MONCLOVA,018,EL ORO (NUEVO POBLADO EL ORO),4,202,84,118,9
COAHUILA DE ZARAGOZA,5,MONCLOVA,018,MONCLOVA,308,67126,34236,32890,4218
COAHUILA DE ZARAGOZA,5,MONCLOVA,018,SALITRILLOS (YUCATÁN),1,3,1,2,1
COAHUILA DE ZARAGOZA,5,MORELOS,019,LOS ÁLAMOS,4,280,131,149,15
COAHUILA DE ZARAGOZA,5,MORELOS,019,MORELOS,11,1760,890,870,89
COAHUILA DE ZARAGOZA,5,MÚZQUIZ,020,BARROTERÁN [ESTACIÓN],2,51,30,21,3
COAHUILA DE ZARAGOZA,5,MÚZQUIZ,020,CIUDAD MELCHOR MÚZQUIZ,53,9455,4659,4796,441
COAHUILA DE ZARAGOZA,5,MÚZQUIZ,020,LA FLORIDA (LA HACIENDA),1,58,28,30,3
COAHUILA DE ZARAGOZA,5,MÚZQUIZ,020,LA MOTA,1,12,6,6,1
COAHUILA DE ZARAGOZA,5,MÚZQUIZ,020,LAS ESPERANZAS,6,550,270,280,32
COAHUILA DE ZARAGOZA,5,MÚZQUIZ,020,MINAS DE BARROTERÁN,10,2280,1126,1154,98
COAHUILA DE ZARAGOZA,5,MÚZQUIZ,020,MINAS LA FLORIDA (LA FLORIDA),1,142,67,75,6
COAHUILA DE ZARAGOZA,5,MÚZQUIZ,020,MORELOS (CUARTERONES),4,145,64,81,8
COAHUILA DE ZARAGOZA,5,MÚZQUIZ,020,NEGROS MASKOGOS (NACIMIENTO),4,129,64,65,9
COAHUILA DE ZARAGOZA,5,MÚZQUIZ,020,NOGALITOS,3,116,64,52,6
COAHUILA DE ZARAGOZA,5,MÚZQUIZ,020,PALAÚ,18,3423,1720,1703,162
COAHUILA DE ZARAGOZA,5,MÚZQUIZ,020,RANCHERÍAS,4,224,108,116,13
COAHUILA DE ZARAGOZA,5,NADADORES,021,LAS FLORES (ESTACIÓN CELEMANIA),3,64,30,34,6
COAHUILA DE ZARAGOZA,5,NADADORES,021,NADADORES,7,1132,623,509,54
COAHUILA DE ZARAGOZA,5,NADADORES,021,NUEVO POBLADO DE NADADORES (EL HUIZACHAL),1,11,5,6,1
COAHUILA DE ZARAGOZA,5,NADADORES,021,NUEVO POBLADO DE SARDINAS,2,20,10,10,2
COAHUILA DE ZARAGOZA,5,NADADORES,021,SAN ISIDRO (EL COYOTE),1,6,3,3,1
COAHUILA DE ZARAGOZA,5,NADADORES,021,SAN JOSÉ DEL ÁGUILA,2,35,21,14,3
COAHUILA DE ZARAGOZA,5,NADADORES,021,SANTIAGO Y PASO DE LA MORITA,1,5,4,1,1
COAHUILA DE ZARAGOZA,5,NADADORES,021,VILLA DE NADADORES,2,22,11,11,3
COAHUILA DE ZARAGOZA,5,NAVA,022,COLONIA SANTO DOMINGO,2,28,16,12,2
COAHUILA DE ZARAGOZA,5,NAVA,022,COLONIA VENUSTIANO CARRANZA,3,389,172,217,15
COAHUILA DE ZARAGOZA,5,NAVA,022,ESTACIÓN RÍO ESCONDIDO,5,1827,695,1132,103
COAHUILA DE ZARAGOZA,5,NAVA,022,MÁXIMO MARTÍNEZ,1,5,2,3,1
COAHUILA DE ZARAGOZA,5,NAVA,022,NAVA,43,7587,3806,3781,399
COAHUILA DE ZARAGOZA,5,NAVA,022,RÍO ESCONDIDO [EJIDO],1,29,16,13,1
COAHUILA DE ZARAGOZA,5,OCAMPO,023,ACEBUCHES,2,17,9,8,2
COAHUILA DE ZARAGOZA,5,OCAMPO,023,BOQUILLAS DEL CARMEN,4,79,36,43,6
COAHUILA DE ZARAGOZA,5,OCAMPO,023,BOQUILLAS DEL CARMEN (NORIAS),2,18,5,13,2
COAHUILA DE ZARAGOZA,5,OCAMPO,023,CHARCOS DE FIGUEROA (FALCÓN),4,48,23,25,5
COAHUILA DE ZARAGOZA,5,OCAMPO,023,CHULA VISTA,2,386,210,176,14
COAHUILA DE ZARAGOZA,5,OCAMPO,023,EL ALICANTE,1,8,3,5,1
COAHUILA DE ZARAGOZA,5,OCAMPO,023,EL GUAJE,1,3,2,1,1
COAHUILA DE ZARAGOZA,5,OCAMPO,023,ENTRONQUE SAN VICENTE,2,6,2,4,2
COAHUILA DE ZARAGOZA,5,OCAMPO,023,JABONCILLOS (JABONCILLOS GRANDE),2,19,11,8,2
COAHUILA DE ZARAGOZA,5,OCAMPO,023,LA ROSITA,4,39,21,18,6
COAHUILA DE ZARAGOZA,5,OCAMPO,023,LA UNIÓN Y EL OLÁN,2,16,6,10,2
COAHUILA DE ZARAGOZA,5,OCAMPO,023,LAGUNA DEL REY (QUÍMICAS DEL REY),6,912,418,494,39
COAHUILA DE ZARAGOZA,5,OCAMPO,023,LAS EUTIMIAS,3,24,9,15,3
COAHUILA DE ZARAGOZA,5,OCAMPO,023,OCAMPO,8,974,503,471,48
COAHUILA DE ZARAGOZA,5,OCAMPO,023,SALINAS DEL REY NORTE (SALINAS DEL REY),1,17,6,11,1
COAHUILA DE ZARAGOZA,5,OCAMPO,023,SAN MIGUEL,4,91,38,53,7
COAHUILA DE ZARAGOZA,5,OCAMPO,023,SAN VICENTE Y ZACATONAL,1,8,4,4,1
COAHUILA DE ZARAGOZA,5,OCAMPO,023,SANTA FE DEL PINO (LA MORITA),1,10,2,8,1
COAHUILA DE ZARAGOZA,5,PARRAS,024,ABREVADERO,2,66,34,32,4
COAHUILA DE ZARAGOZA,5,PARRAS,024,BAJÍO DEL CALABACILLAL,1,2,1,1,1
COAHUILA DE ZARAGOZA,5,PARRAS,024,BOQUILLAS DEL REFUGIO,2,15,8,7,2
COAHUILA DE ZARAGOZA,5,PARRAS,024,CIÉNEGA DEL CARMEN,2,14,11,3,2
COAHUILA DE ZARAGOZA,5,PARRAS,024,CRUZ VERDE,2,17,9,8,2
COAHUILA DE ZARAGOZA,5,PARRAS,024,CUATRO DE MARZO,3,10,4,6,2
COAHUILA DE ZARAGOZA,5,PARRAS,024,EL AMPARO (LA PEÑA),2,9,7,2,1
COAHUILA DE ZARAGOZA,5,PARRAS,024,EL CINCO (CINCO DE MAYO),2,7,4,3,1
COAHUILA DE ZARAGOZA,5,PARRAS,024,EL DURAZNO,2,20,9,11,2
COAHUILA DE ZARAGOZA,5,PARRAS,024,EL MESTEÑO,4,30,18,12,5
COAHUILA DE ZARAGOZA,5,PARRAS,024,EL MIMBRE,4,54,34,20,4
COAHUILA DE ZARAGOZA,5,PARRAS,024,EL PORVENIR DE ABAJO,3,64,30,34,6
COAHUILA DE ZARAGOZA,5,PARRAS,024,EL PROGRESO (SAN ISIDRO DEL PROGRESO),2,34,13,21,2
COAHUILA DE ZARAGOZA,5,PARRAS,024,EL SACRAMENTO (SACRAMENTO DE LA JAROSA),2,34,17,17,3
COAHUILA DE ZARAGOZA,5,PARRAS,024,EL SAUCILLO,3,42,26,16,4
COAHUILA DE ZARAGOZA,5,PARRAS,024,EL SIETE DE ENERO (EL MEZQUITE),2,25,11,14,2
COAHUILA DE ZARAGOZA,5,PARRAS,024,EL SOL,2,21,13,8,2
COAHUILA DE ZARAGOZA,5,PARRAS,024,GANIVETE,4,98,51,47,9
COAHUILA DE ZARAGOZA,5,PARRAS,024,GARAMBULLO,2,40,19,21,3
COAHUILA DE ZARAGOZA,5,PARRAS,024,HACIENDA SAN LORENZO (CASA MADERO),2,76,39,37,3
COAHUILA DE ZARAGOZA,5,PARRAS,024,HUARICHE,4,197,101,96,11
COAHUILA DE ZARAGOZA,5,PARRAS,024,LA CANDELARIA,2,30,18,12,2
COAHUILA DE ZARAGOZA,5,PARRAS,024,LA CONSTANCIA,4,99,63,36,5
COAHUILA DE ZARAGOZA,5,PARRAS,024,LA MORITA,2,14,8,6,2
COAHUILA DE ZARAGOZA,5,PARRAS,024,LA REQUENA (LA REQUENA DE FÁTIMA),1,5,3,2,1
COAHUILA DE ZARAGOZA,5,PARRAS,024,LA VEGA,2,16,9,7,2
COAHUILA DE ZARAGOZA,5,PARRAS,024,LAS GORDAS (LAS CONCHAS),1,4,0,4,1
COAHUILA DE ZARAGOZA,5,PARRAS,024,LOS ÁNGELES,1,14,4,10,1
COAHUILA DE ZARAGOZA,5,PARRAS,024,LOS HOYOS (EL POTRERO),4,184,94,90,12
COAHUILA DE ZARAGOZA,5,PARRAS,024,MADERO [ESTACIÓN],4,137,65,72,8
COAHUILA DE ZARAGOZA,5,PARRAS,024,MOLINO VIEJO (SAN LORENZO),1,47,12,35,2
COAHUILA DE ZARAGOZA,5,PARRAS,024,NOTILLAS,1,10,6,4,1
COAHUILA DE ZARAGOZA,5,PARRAS,024,NUEVO SABANILLA (SABANILLA),3,74,44,30,3
COAHUILA DE ZARAGOZA,5,PARRAS,024,PALO ALTO (EL CARRIZAL),2,9,6,3,2
COAHUILA DE ZARAGOZA,5,PARRAS,024,PARRAS DE LA FUENTE,59,9069,4424,4645,645
COAHUILA DE ZARAGOZA,5,PARRAS,024,PIEDRA BLANCA,2,84,37,47,5
COAHUILA DE ZARAGOZA,5,PARRAS,024,POMONA II,2,28,18,10,2
COAHUILA DE ZARAGOZA,5,PARRAS,024,PRESA DE SAN ANTONIO,2,8,4,4,1
COAHUILA DE ZARAGOZA,5,PARRAS,024,SAN FRANCISCO DEL BARRIAL,3,20,7,13,3
COAHUILA DE ZARAGOZA,5,PARRAS,024,SAN FRANCISCO DEL PROGRESO,2,109,51,58,7
COAHUILA DE ZARAGOZA,5,PARRAS,024,SAN ISIDRO,4,83,44,39,7
COAHUILA DE ZARAGOZA,5,PARRAS,024,SAN JOSÉ DE PATAGALANA,2,63,32,31,4
COAHUILA DE ZARAGOZA,5,PARRAS,024,SAN MIGUEL,2,20,11,9,2
COAHUILA DE ZARAGOZA,5,PARRAS,024,SAN RAFAEL DE LOS MILAGROS,3,23,9,14,3
COAHUILA DE ZARAGOZA,5,PARRAS,024,SAN RAFAEL DE LOS YEGUALES,2,4,2,2,2
COAHUILA DE ZARAGOZA,5,PARRAS,024,SANTA CECILIA (LA CECILIA),3,34,13,21,3
COAHUILA DE ZARAGOZA,5,PARRAS,024,SANTA MARÍA (SANTA MARÍA NÚMERO TRES),2,13,6,7,2
COAHUILA DE ZARAGOZA,5,PARRAS,024,SANTA MARÍA DE LAS ESPERANZAS,1,11,5,6,1
COAHUILA DE ZARAGOZA,5,PARRAS,024,SEGUÍN,4,67,27,40,6
COAHUILA DE ZARAGOZA,5,PARRAS,024,SEIS DE ENERO,2,59,33,26,5
COAHUILA DE ZARAGOZA,5,PARRAS,024,SOMBRERETILLO,3,24,13,11,3
COAHUILA DE ZARAGOZA,5,PARRAS,024,TALÍA,4,56,36,20,6
COAHUILA DE ZARAGOZA,5,PARRAS,024,TANQUE NUEVO,2,32,19,13,3
COAHUILA DE ZARAGOZA,5,PARRAS,024,TIZOC,2,8,3,5,1
COAHUILA DE ZARAGOZA,5,PARRAS,024,TRINCHERAS,2,23,16,7,2
COAHUILA DE ZARAGOZA,5,PARRAS,024,VEINTIOCHO DE AGOSTO,4,259,124,135,19
COAHUILA DE ZARAGOZA,5,PIEDRAS NEGRAS,025,EL CENTINELA,2,32,16,16,2
COAHUILA DE ZARAGOZA,5,PIEDRAS NEGRAS,025,EL MORAL,3,90,38,52,5
COAHUILA DE ZARAGOZA,5,PIEDRAS NEGRAS,025,LA NAVAJA,2,40,20,20,2
COAHUILA DE ZARAGOZA,5,PIEDRAS NEGRAS,025,LAS TINAJAS,1,15,4,11,2
COAHUILA DE ZARAGOZA,5,PIEDRAS NEGRAS,025,PIEDRAS NEGRAS,252,48698,24836,23862,3087
COAHUILA DE ZARAGOZA,5,PIEDRAS NEGRAS,025,SAN ISIDRO,2,25,15,10,2
COAHUILA DE ZARAGOZA,5,PROGRESO,026,EL SOCORRO,1,30,21,9,1
COAHUILA DE ZARAGOZA,5,PROGRESO,026,MINERAL LA LUZ (MINAS DE LA LUZ),1,70,39,31,3
COAHUILA DE ZARAGOZA,5,PROGRESO,026,PROGRESO,4,166,83,83,18
COAHUILA DE ZARAGOZA,5,PROGRESO,026,SAN ALBERTO,4,137,65,72,10
COAHUILA DE ZARAGOZA,5,PROGRESO,026,SAN JOSÉ DE AURA,7,429,238,191,28
COAHUILA DE ZARAGOZA,5,RAMOS ARIZPE,027,ANHELO,1,8,4,4,1
COAHUILA DE ZARAGOZA,5,RAMOS ARIZPE,027,CONGREGACIÓN CAÑADA ANCHA,4,243,110,133,14
COAHUILA DE ZARAGOZA,5,RAMOS ARIZPE,027,COSME,1,4,1,3,1
COAHUILA DE ZARAGOZA,5,RAMOS ARIZPE,027,EL PANAL,1,10,4,6,1
COAHUILA DE ZARAGOZA,5,RAMOS ARIZPE,027,EL PELILLAL,1,3,1,2,1
COAHUILA DE ZARAGOZA,5,RAMOS ARIZPE,027,EL TANQUE (TANQUE VIEJO),2,7,5,2,2
COAHUILA DE ZARAGOZA,5,RAMOS ARIZPE,027,FRAUSTRO,2,45,22,23,3
COAHUILA DE ZARAGOZA,5,RAMOS ARIZPE,027,GUAJARDO,1,20,6,14,1
COAHUILA DE ZARAGOZA,5,RAMOS ARIZPE,027,HIGUERAS,4,145,68,77,11
COAHUILA DE ZARAGOZA,5,RAMOS ARIZPE,027,HIPÓLITO,4,172,82,90,15
COAHUILA DE ZARAGOZA,5,RAMOS ARIZPE,027,LA LEONA,2,36,23,13,2
COAHUILA DE ZARAGOZA,5,RAMOS ARIZPE,027,LA PALOMA,1,12,7,5,1
COAHUILA DE ZARAGOZA,5,RAMOS ARIZPE,027,LA SAUCEDA (EL TANQUE),2,20,11,9,2
COAHUILA DE ZARAGOZA,5,RAMOS ARIZPE,027,LA TORTUGA,2,21,9,12,2
COAHUILA DE ZARAGOZA,5,RAMOS ARIZPE,027,LANDEROS,3,28,14,14,3
COAHUILA DE ZARAGOZA,5,RAMOS ARIZPE,027,LAS ESPERANZAS,2,16,9,7,2
COAHUILA DE ZARAGOZA,5,RAMOS ARIZPE,027,LAS NORIAS,1,15,4,11,1
COAHUILA DE ZARAGOZA,5,RAMOS ARIZPE,027,MESILLAS,2,54,35,19,4
COAHUILA DE ZARAGOZA,5,RAMOS ARIZPE,027,MESÓN DEL NORTE,2,24,12,12,2
COAHUILA DE ZARAGOZA,5,RAMOS ARIZPE,027,PAREDÓN,4,368,178,190,23
COAHUILA DE ZARAGOZA,5,RAMOS ARIZPE,027,PLAN DE GUADALUPE (LA DELFINA),4,74,43,31,6
COAHUILA DE ZARAGOZA,5,RAMOS ARIZPE,027,RAMOS ARIZPE,141,31095,15181,15914,1622
COAHUILA DE ZARAGOZA,5,RAMOS ARIZPE,027,RANCHO NUEVO,2,23,17,6,2
COAHUILA DE ZARAGOZA,5,RAMOS ARIZPE,027,REATA (GENERAL COSS),3,27,15,12,3
COAHUILA DE ZARAGOZA,5,RAMOS ARIZPE,027,SAN ANTONIO DE ACATITA,2,21,10,11,3
COAHUILA DE ZARAGOZA,5,RAMOS ARIZPE,027,SAN GREGORIO (COMUNIDAD SAN GREGORIO),2,37,20,17,3
COAHUILA DE ZARAGOZA,5,RAMOS ARIZPE,027,SAN IGNACIO,4,214,106,108,27
COAHUILA DE ZARAGOZA,5,RAMOS ARIZPE,027,SAN JOSÉ DE LOS NUNCIOS,2,31,16,15,2
COAHUILA DE ZARAGOZA,5,RAMOS ARIZPE,027,SAN JUAN BAUTISTA,1,7,5,2,1
COAHUILA DE ZARAGOZA,5,RAMOS ARIZPE,027,SAN JUAN DE AMARGOS (EX-HACIENDA DE SAN JUAN),2,11,4,7,2
COAHUILA DE ZARAGOZA,5,RAMOS ARIZPE,027,SAN MARTÍN (DOCE DE DICIEMBRE),1,9,4,5,1
COAHUILA DE ZARAGOZA,5,RAMOS ARIZPE,027,SAN MARTÍN DE LAS VACAS,1,22,12,10,3
COAHUILA DE ZARAGOZA,5,RAMOS ARIZPE,027,SAN MIGUEL,2,27,20,7,2
COAHUILA DE ZARAGOZA,5,RAMOS ARIZPE,027,SANTA MARÍA (SANTA MARÍA DEL ROSARIO),1,6,1,5,1
COAHUILA DE ZARAGOZA,5,RAMOS ARIZPE,027,SANTO DOMINGO,2,39,19,20,3
COAHUILA DE ZARAGOZA,5,SABINAS,028,AGUJITA,2,547,338,209,36
COAHUILA DE ZARAGOZA,5,SABINAS,028,CLOETE,6,577,262,315,35
COAHUILA DE ZARAGOZA,5,SABINAS,028,GUADALUPE VICTORIA (PUEBLO NUEVO),2,37,20,17,2
COAHUILA DE ZARAGOZA,5,SABINAS,028,PUENTE NEGRO,4,164,77,87,9
COAHUILA DE ZARAGOZA,5,SABINAS,028,SABINAS,91,17249,8452,8797,1142
COAHUILA DE ZARAGOZA,5,SACRAMENTO,029,SACRAMENTO,4,554,294,260,36
COAHUILA DE ZARAGOZA,5,SALTILLO,030,AGUA NUEVA,5,482,225,257,33
COAHUILA DE ZARAGOZA,5,SALTILLO,030,AGUA NUEVA [ESTACIÓN],1,84,36,48,3
COAHUILA DE ZARAGOZA,5,SALTILLO,030,ASTILLERO,1,5,2,3,1
COAHUILA DE ZARAGOZA,5,SALTILLO,030,BUÑUELOS,2,28,12,16,3
COAHUILA DE ZARAGOZA,5,SALTILLO,030,CARNEROS,2,37,19,18,2
COAHUILA DE ZARAGOZA,5,SALTILLO,030,CHAPULA,2,127,60,67,4
COAHUILA DE ZARAGOZA,5,SALTILLO,030,CINCO DE MAYO,1,7,2,5,1
COAHUILA DE ZARAGOZA,5,SALTILLO,030,CUAUHTÉMOC,3,67,33,34,5
COAHUILA DE ZARAGOZA,5,SALTILLO,030,CUAUTLA (HACIENDA CUAUTLA),2,35,18,17,3
COAHUILA DE ZARAGOZA,5,SALTILLO,030,EL CERCADO,1,10,3,7,1
COAHUILA DE ZARAGOZA,5,SALTILLO,030,EL COLORADO,2,8,2,6,2
COAHUILA DE ZARAGOZA,5,SALTILLO,030,EL DERRAMADERO,4,805,382,423,49
COAHUILA DE ZARAGOZA,5,SALTILLO,030,EL JAGÜEY DE FERNIZA,2,37,22,15,3
COAHUILA DE ZARAGOZA,5,SALTILLO,030,EL MEZQUITE,1,14,10,4,1
COAHUILA DE ZARAGOZA,5,SALTILLO,030,EL MORAL,1,9,3,6,1
COAHUILA DE ZARAGOZA,5,SALTILLO,030,EL PINO (ANEXO SAN JUAN DE LA VAQUERÍA),1,6,3,3,1
COAHUILA DE ZARAGOZA,5,SALTILLO,030,EL RANCHITO,2,20,12,8,2
COAHUILA DE ZARAGOZA,5,SALTILLO,030,EL RINCÓN DE LOS PASTORES,4,251,132,119,11
COAHUILA DE ZARAGOZA,5,SALTILLO,030,EL SALITRE,1,18,5,13,1
COAHUILA DE ZARAGOZA,5,SALTILLO,030,GÓMEZ FARÍAS,2,26,13,13,2
COAHUILA DE ZARAGOZA,5,SALTILLO,030,GUADALUPE VICTORIA,2,77,37,40,5
COAHUILA DE ZARAGOZA,5,SALTILLO,030,HEDIONDA GRANDE,4,105,52,53,8
COAHUILA DE ZARAGOZA,5,SALTILLO,030,JAZMINAL,2,25,12,13,2
COAHUILA DE ZARAGOZA,5,SALTILLO,030,LA ANGOSTURA (SALVADOR HUERTA LARA),1,114,52,62,6
COAHUILA DE ZARAGOZA,5,SALTILLO,030,LA ENCANTADA,2,45,22,23,3
COAHUILA DE ZARAGOZA,5,SALTILLO,030,LA ESPERANZA (LAS PUYAS),1,8,4,4,1
COAHUILA DE ZARAGOZA,5,SALTILLO,030,LA VENTURA,4,120,55,65,7
COAHUILA DE ZARAGOZA,5,SALTILLO,030,LAS COLONIAS,2,21,8,13,2
COAHUILA DE ZARAGOZA,5,SALTILLO,030,LAS MANGAS,2,43,24,19,2
COAHUILA DE ZARAGOZA,5,SALTILLO,030,LLANOS DE LA UNIÓN,2,33,20,13,2
COAHUILA DE ZARAGOZA,5,SALTILLO,030,NUEVO GÓMEZ FARÍAS,2,47,18,29,3
COAHUILA DE ZARAGOZA,5,SALTILLO,030,PALMA GORDA,3,61,35,26,6
COAHUILA DE ZARAGOZA,5,SALTILLO,030,PALMAS ALTAS,2,11,3,8,2
COAHUILA DE ZARAGOZA,5,SALTILLO,030,PLAN DE AYALA,2,49,21,28,3
COAHUILA DE ZARAGOZA,5,SALTILLO,030,PRESA DE LOS MUCHACHOS,2,68,40,28,4
COAHUILA DE ZARAGOZA,5,SALTILLO,030,PRESA DE SAN PEDRO,4,154,84,70,9
COAHUILA DE ZARAGOZA,5,SALTILLO,030,PROVIDENCIA,3,695,352,343,30
COAHUILA DE ZARAGOZA,5,SALTILLO,030,PUEBLA,2,52,27,25,3
COAHUILA DE ZARAGOZA,5,SALTILLO,030,PUERTO ROCAMONTES,2,18,13,5,2
COAHUILA DE ZARAGOZA,5,SALTILLO,030,PUNTA SANTA ELENA,4,65,27,38,4
COAHUILA DE ZARAGOZA,5,SALTILLO,030,PUYAS Y LAS HORMIGAS (LAS HORMIGAS),3,56,25,31,4
COAHUILA DE ZARAGOZA,5,SALTILLO,030,RANCHO NUEVO,2,74,34,40,4
COAHUILA DE ZARAGOZA,5,SALTILLO,030,SALTILLO,1148,285440,144665,140775,16681
COAHUILA DE ZARAGOZA,5,SALTILLO,030,SAN FELIPE,2,23,9,14,2
COAHUILA DE ZARAGOZA,5,SALTILLO,030,SAN FRANCISCO DEL EJIDO,3,126,65,61,7
COAHUILA DE ZARAGOZA,5,SALTILLO,030,SAN JOSÉ DE BOQUILLAS (ANGOSTURA),1,54,29,25,2
COAHUILA DE ZARAGOZA,5,SALTILLO,030,SAN JOSÉ DE LA JOYA,1,16,9,7,1
COAHUILA DE ZARAGOZA,5,SALTILLO,030,SAN JUAN DE LA VAQUERÍA,3,336,162,174,12
COAHUILA DE ZARAGOZA,5,SALTILLO,030,SAN JUAN DEL RETIRO,4,259,129,130,24
COAHUILA DE ZARAGOZA,5,SALTILLO,030,SAN MIGUEL (SAN MIGUEL DEL BANCO),2,36,18,18,3
COAHUILA DE ZARAGOZA,5,SALTILLO,030,SANTA ELENA [ESTACIÓN],1,13,6,7,1
COAHUILA DE ZARAGOZA,5,SALTILLO,030,SANTA RITA,1,17,10,7,1
COAHUILA DE ZARAGOZA,5,SALTILLO,030,SANTA ROSA,2,19,10,9,2
COAHUILA DE ZARAGOZA,5,SALTILLO,030,SANTA TERESA DE LOS MUCHACHOS,2,68,32,36,4
COAHUILA DE ZARAGOZA,5,SALTILLO,030,SANTA VICTORIA,1,4,2,2,1
COAHUILA DE ZARAGOZA,5,SALTILLO,030,TANQUE DE EMERGENCIA,1,10,4,6,1
COAHUILA DE ZARAGOZA,5,SALTILLO,030,TANQUE DEL CERRO,2,17,5,12,2
COAHUILA DE ZARAGOZA,5,SALTILLO,030,TANQUE ESCONDIDO,2,18,11,7,2
COAHUILA DE ZARAGOZA,5,SALTILLO,030,ZACATERA,4,93,48,45,7
COAHUILA DE ZARAGOZA,5,SAN BUENAVENTURA,031,EL FORTÍN,1,1,0,1,1
COAHUILA DE ZARAGOZA,5,SAN BUENAVENTURA,031,NUEVO POBLADO DEL SOMBRERETE (NUEVO SOMBRERETE),2,20,9,11,2
COAHUILA DE ZARAGOZA,5,SAN BUENAVENTURA,031,SAN ANTONIO DE LA CASCADA,4,162,69,93,10
COAHUILA DE ZARAGOZA,5,SAN BUENAVENTURA,031,SAN ANTONIO DE LAS HIGUERAS,2,15,9,6,2
COAHUILA DE ZARAGOZA,5,SAN BUENAVENTURA,031,SAN BUENAVENTURA,28,5759,2854,2905,276
COAHUILA DE ZARAGOZA,5,SAN BUENAVENTURA,031,SAN FRANCISCO,1,15,9,6,1
COAHUILA DE ZARAGOZA,5,SAN BUENAVENTURA,031,SAN LORENZO,1,3,0,3,1
COAHUILA DE ZARAGOZA,5,SAN BUENAVENTURA,031,SANTA GERTRUDIS,2,43,16,27,3
COAHUILA DE ZARAGOZA,5,SAN JUAN DE SABINAS,032,IGNACIO ZARAGOZA,3,49,30,19,3
COAHUILA DE ZARAGOZA,5,SAN JUAN DE SABINAS,032,NUEVA ROSITA,61,8225,4090,4135,489
COAHUILA DE ZARAGOZA,5,SAN JUAN DE SABINAS,032,PASO DEL COYOTE,2,57,31,26,3
COAHUILA DE ZARAGOZA,5,SAN JUAN DE SABINAS,032,PASO DEL COYOTE (PREDIO PURÍSIMA),1,5,1,4,0
COAHUILA DE ZARAGOZA,5,SAN JUAN DE SABINAS,032,RANCHO NUEVO,2,27,8,19,2
COAHUILA DE ZARAGOZA,5,SAN JUAN DE SABINAS,032,SAN JUAN DE SABINAS,7,1852,948,904,135
COAHUILA DE ZARAGOZA,5,SAN JUAN DE SABINAS,032,SANTA MARÍA,3,161,81,80,11
COAHUILA DE ZARAGOZA,5,SAN JUAN DE SABINAS,032,SAUCEDA DEL NARANJO,2,35,14,21,3
COAHUILA DE ZARAGOZA,5,SAN PEDRO,033,ALEJANDRÍA,2,27,10,17,2
COAHUILA DE ZARAGOZA,5,SAN PEDRO,033,ALEJO GONZÁLEZ (BILBAO),2,175,91,84,8
COAHUILA DE ZARAGOZA,5,SAN PEDRO,033,AQUILES SERDÁN,2,41,19,22,3
COAHUILA DE ZARAGOZA,5,SAN PEDRO,033,BOLÍVAR,2,97,50,47,5
COAHUILA DE ZARAGOZA,5,SAN PEDRO,033,CANDELARIA,2,43,16,27,3
COAHUILA DE ZARAGOZA,5,SAN PEDRO,033,CLETO,2,11,7,4,2
COAHUILA DE ZARAGOZA,5,SAN PEDRO,033,CONCORDIA (LA ROSITA),12,1854,967,887,90
COAHUILA DE ZARAGOZA,5,SAN PEDRO,033,CUAUHTÉMOC CÁRDENAS (MEDIO PULMÓN),1,22,11,11,1
COAHUILA DE ZARAGOZA,5,SAN PEDRO,033,DIEZ DE MAYO (LAS CASITAS),1,45,21,24,2
COAHUILA DE ZARAGOZA,5,SAN PEDRO,033,EL ÁNCORA (LA INDEPENDENCIA),1,28,11,17,1
COAHUILA DE ZARAGOZA,5,SAN PEDRO,033,EL ESTRIBO,2,177,98,79,8
COAHUILA DE ZARAGOZA,5,SAN PEDRO,033,EL GATUÑO,2,52,16,36,4
COAHUILA DE ZARAGOZA,5,SAN PEDRO,033,EL NILO,4,293,150,143,14
COAHUILA DE ZARAGOZA,5,SAN PEDRO,033,EL PORVENIR DE ABAJO,4,101,47,54,7
COAHUILA DE ZARAGOZA,5,SAN PEDRO,033,EL RETIRO,3,191,109,82,10
COAHUILA DE ZARAGOZA,5,SAN PEDRO,033,EL TRIÁNGULO,1,7,4,3,1
COAHUILA DE ZARAGOZA,5,SAN PEDRO,033,EL VENADO,4,113,54,59,10
COAHUILA DE ZARAGOZA,5,SAN PEDRO,033,EMILIANO ZAPATA (ALBIA),2,82,44,38,5
COAHUILA DE ZARAGOZA,5,SAN PEDRO,033,FRONTERA,4,256,126,130,21
COAHUILA DE ZARAGOZA,5,SAN PEDRO,033,GABINO VÁZQUEZ (BEGOÑA),3,104,53,51,12
COAHUILA DE ZARAGOZA,5,SAN PEDRO,033,GATAS MOCHAS,2,79,30,49,4
COAHUILA DE ZARAGOZA,5,SAN PEDRO,033,IGNACIO ZARAGOZA,2,85,42,43,4
COAHUILA DE ZARAGOZA,5,SAN PEDRO,033,LA CAROLINA (LA NUEVA CAROLINA),2,61,32,29,3
COAHUILA DE ZARAGOZA,5,SAN PEDRO,033,LA FE,2,176,87,89,7
COAHUILA DE ZARAGOZA,5,SAN PEDRO,033,LA PENTALFA,1,6,3,3,1
COAHUILA DE ZARAGOZA,5,SAN PEDRO,033,LA VICTORIA,8,477,232,245,34
COAHUILA DE ZARAGOZA,5,SAN PEDRO,033,LAGOS DE MORENO (AMPUEROS),2,30,14,16,2
COAHUILA DE ZARAGOZA,5,SAN PEDRO,033,LÁZARO CÁRDENAS (DOLORES),2,108,44,64,5
COAHUILA DE ZARAGOZA,5,SAN PEDRO,033,LUCHANA,8,1823,926,897,109
COAHUILA DE ZARAGOZA,5,SAN PEDRO,033,MALA NOCHE Y ARRACADAS,3,25,14,11,4
COAHUILA DE ZARAGOZA,5,SAN PEDRO,033,MAYRÁN,4,446,216,230,25
COAHUILA DE ZARAGOZA,5,SAN PEDRO,033,NORIA SAN LUIS,1,28,14,14,2
COAHUILA DE ZARAGOZA,5,SAN PEDRO,033,NUEVA CANDELARIA,2,27,13,14,2
COAHUILA DE ZARAGOZA,5,SAN PEDRO,033,NUEVA VICTORIA,4,69,36,33,7
COAHUILA DE ZARAGOZA,5,SAN PEDRO,033,NUEVO DELICIAS,4,128,63,65,8
COAHUILA DE ZARAGOZA,5,SAN PEDRO,033,NUEVO MUNDO,2,58,28,30,4
COAHUILA DE ZARAGOZA,5,SAN PEDRO,033,PANAMÁ,2,38,24,14,3
COAHUILA DE ZARAGOZA,5,SAN PEDRO,033,PATROCINIO,2,81,41,40,5
COAHUILA DE ZARAGOZA,5,SAN PEDRO,033,PRESA DE CLETO,2,35,18,17,3
COAHUILA DE ZARAGOZA,5,SAN PEDRO,033,PRESA DE GUADALUPE (VIDA NUEVA),2,61,23,38,4
COAHUILA DE ZARAGOZA,5,SAN PEDRO,033,PRIMERO DE MAYO (ALGORTA),2,79,35,44,4
COAHUILA DE ZARAGOZA,5,SAN PEDRO,033,PROGRESO,2,78,32,46,4
COAHUILA DE ZARAGOZA,5,SAN PEDRO,033,PURÍSIMA DE RUBIO,2,40,14,26,3
COAHUILA DE ZARAGOZA,5,SAN PEDRO,033,REYNOSA,2,68,37,31,4
COAHUILA DE ZARAGOZA,5,SAN PEDRO,033,RICARDO FLORES MAGÓN,3,30,15,15,5
COAHUILA DE ZARAGOZA,5,SAN PEDRO,033,RINCÓN DE GARCÍA (RINCÓN DE GARCÍA CHACÓN),2,8,3,5,2
COAHUILA DE ZARAGOZA,5,SAN PEDRO,033,SAN ANTONIO DE GURZA,2,94,50,44,6
COAHUILA DE ZARAGOZA,5,SAN PEDRO,033,SAN ESTEBAN DE ABAJO,4,408,225,183,28
COAHUILA DE ZARAGOZA,5,SAN PEDRO,033,SAN FELIPE (SAN FELIPE DE PURCELL),2,127,59,68,8
COAHUILA DE ZARAGOZA,5,SAN PEDRO,033,SAN FRANCISCO DE ARRIBA,2,148,72,76,8
COAHUILA DE ZARAGOZA,5,SAN PEDRO,033,SAN FRANCISCO DE GURZA (SANTA ROSA),3,44,14,30,3
COAHUILA DE ZARAGOZA,5,SAN PEDRO,033,SAN IGNACIO,6,506,250,256,45
COAHUILA DE ZARAGOZA,5,SAN PEDRO,033,SAN LORENZO,5,582,293,289,48
COAHUILA DE ZARAGOZA,5,SAN PEDRO,033,SAN MARCOS,2,192,88,104,8
COAHUILA DE ZARAGOZA,5,SAN PEDRO,033,SAN MIGUEL,2,189,104,85,8
COAHUILA DE ZARAGOZA,5,SAN PEDRO,033,SAN NICOLÁS,3,48,19,29,4
COAHUILA DE ZARAGOZA,5,SAN PEDRO,033,SAN PABLO,2,109,46,63,7
COAHUILA DE ZARAGOZA,5,SAN PEDRO,033,SAN PATRICIO,2,76,36,40,4
COAHUILA DE ZARAGOZA,5,SAN PEDRO,033,SAN PEDRO,80,14969,7504,7465,925
COAHUILA DE ZARAGOZA,5,SAN PEDRO,033,SAN RAFAEL DE ABAJO,2,82,44,38,4
COAHUILA DE ZARAGOZA,5,SAN PEDRO,033,SAN RAFAEL DE ARRIBA,4,255,131,124,14
COAHUILA DE ZARAGOZA,5,SAN PEDRO,033,SANTA ANA (SANTA ANA DE ARRIBA),2,52,22,30,4
COAHUILA DE ZARAGOZA,5,SAN PEDRO,033,SANTA BRÍGIDA,2,63,24,39,4
COAHUILA DE ZARAGOZA,5,SAN PEDRO,033,SANTA ELENA,2,138,70,68,8
COAHUILA DE ZARAGOZA,5,SAN PEDRO,033,SANTA EULALIA,4,135,72,63,8
COAHUILA DE ZARAGOZA,5,SAN PEDRO,033,SANTA MÓNICA,2,104,58,46,5
COAHUILA DE ZARAGOZA,5,SAN PEDRO,033,SANTA RITA,2,21,11,10,2
COAHUILA DE ZARAGOZA,5,SAN PEDRO,033,SANTA SOFÍA (SOFÍA DE ABAJO),4,135,63,72,8
COAHUILA DE ZARAGOZA,5,SAN PEDRO,033,SANTIAGO,4,138,62,76,8
COAHUILA DE ZARAGOZA,5,SAN PEDRO,033,SOFÍA DE ARRIBA,4,146,58,88,12
COAHUILA DE ZARAGOZA,5,SAN PEDRO,033,TACUBA,4,123,57,66,8
COAHUILA DE ZARAGOZA,5,SAN PEDRO,033,TACUBAYA,5,328,157,171,29
COAHUILA DE ZARAGOZA,5,SAN PEDRO,033,TEBAS Y PALMIRA,2,37,17,20,3
COAHUILA DE ZARAGOZA,5,SAN PEDRO,033,VEGA LARGA,2,87,39,48,4
COAHUILA DE ZARAGOZA,5,SAN PEDRO,033,VEINTE DE NOVIEMBRE (SANTA LUCÍA),2,139,83,56,7
COAHUILA DE ZARAGOZA,5,SIERRA MOJADA,034,HÉRCULES,6,499,261,238,44
COAHUILA DE ZARAGOZA,5,SIERRA MOJADA,034,LA ESMERALDA,5,356,186,170,26
COAHUILA DE ZARAGOZA,5,SIERRA MOJADA,034,SALINA DEL REY (DEL REY SUR),2,45,23,22,3
COAHUILA DE ZARAGOZA,5,SIERRA MOJADA,034,SAN JOSÉ DE CARRANZA,4,73,40,33,5
COAHUILA DE ZARAGOZA,5,SIERRA MOJADA,034,SIERRA MOJADA,2,82,37,45,4
COAHUILA DE ZARAGOZA,5,TORREÓN,035,ALBIA,2,239,122,117,9
COAHUILA DE ZARAGOZA,5,TORREÓN,035,BARREAL DE GUADALUPE,4,126,69,57,10
COAHUILA DE ZARAGOZA,5,TORREÓN,035,CIUDAD DE LOS NIÑOS,2,260,120,140,9
COAHUILA DE ZARAGOZA,5,TORREÓN,035,DOCE DE DICIEMBRE,1,7,3,4,1
COAHUILA DE ZARAGOZA,5,TORREÓN,035,EL MOSTRENCO (EUSKAL),1,17,10,7,1
COAHUILA DE ZARAGOZA,5,TORREÓN,035,EL PACÍFICO,2,47,27,20,3
COAHUILA DE ZARAGOZA,5,TORREÓN,035,EL PERÚ,5,552,306,246,27
COAHUILA DE ZARAGOZA,5,TORREÓN,035,JALISCO,2,164,78,86,8
COAHUILA DE ZARAGOZA,5,TORREÓN,035,JIMULCO,2,72,38,34,4
COAHUILA DE ZARAGOZA,5,TORREÓN,035,JUAN EUGENIO,5,459,235,224,33
COAHUILA DE ZARAGOZA,5,TORREÓN,035,LA COLONIA,3,22,10,12,3
COAHUILA DE ZARAGOZA,5,TORREÓN,035,LA CONCHA,5,1741,835,906,106
COAHUILA DE ZARAGOZA,5,TORREÓN,035,LA CONCHITA ROJA,2,42,18,24,2
COAHUILA DE ZARAGOZA,5,TORREÓN,035,LA FLOR DE JIMULCO,4,271,123,148,24
COAHUILA DE ZARAGOZA,5,TORREÓN,035,LA NUEVA COLONIA (PERALTA),3,36,17,19,3
COAHUILA DE ZARAGOZA,5,TORREÓN,035,LA PALMA,2,158,76,82,8
COAHUILA DE ZARAGOZA,5,TORREÓN,035,LA PARTIDA,7,1825,913,912,184
COAHUILA DE ZARAGOZA,5,TORREÓN,035,LA PAZ,3,868,436,432,26
COAHUILA DE ZARAGOZA,5,TORREÓN,035,LA PERLA,2,96,51,45,4
COAHUILA DE ZARAGOZA,5,TORREÓN,035,LA TRINIDAD,2,59,25,34,4
COAHUILA DE ZARAGOZA,5,TORREÓN,035,NUEVO MIELERAS (LA TRES),2,169,76,93,8
COAHUILA DE ZARAGOZA,5,TORREÓN,035,PASO DEL ÁGUILA,2,169,80,89,7
COAHUILA DE ZARAGOZA,5,TORREÓN,035,PROVIDENCIA,2,191,104,87,7
COAHUILA DE ZARAGOZA,5,TORREÓN,035,RANCHO ALEGRE,3,336,164,172,12
COAHUILA DE ZARAGOZA,5,TORREÓN,035,RICARDO FLORES MAGÓN,2,79,43,36,6
COAHUILA DE ZARAGOZA,5,TORREÓN,035,SANTA FE,2,458,228,230,15
COAHUILA DE ZARAGOZA,5,TORREÓN,035,TORREÓN,1049,193007,97137,95870,14937
COAHUILA DE ZARAGOZA,5,VIESCA,036,ALTO DEL PALOMILLO,1,22,9,13,1
COAHUILA DE ZARAGOZA,5,VIESCA,036,BAJÍO DE AHUICHILA,3,11,5,6,2
COAHUILA DE ZARAGOZA,5,VIESCA,036,BOQUILLA DE LAS PERLAS,5,797,404,393,52
COAHUILA DE ZARAGOZA,5,VIESCA,036,BUENAVISTA,3,155,69,86,10
COAHUILA DE ZARAGOZA,5,VIESCA,036,CINCO DE MAYO,3,26,13,13,3
COAHUILA DE ZARAGOZA,5,VIESCA,036,EL ESFUERZO SECTOR SEIS,1,22,12,10,1
COAHUILA DE ZARAGOZA,5,VIESCA,036,EMILIANO ZAPATA,4,246,122,124,15
COAHUILA DE ZARAGOZA,5,VIESCA,036,FLOR DE MAYO,4,268,116,152,13
COAHUILA DE ZARAGOZA,5,VIESCA,036,GABINO VÁZQUEZ (SAN LUIS),2,117,60,57,7
COAHUILA DE ZARAGOZA,5,VIESCA,036,GILITA,4,448,216,232,28
COAHUILA DE ZARAGOZA,5,VIESCA,036,GREGORIO GARCÍA (EL TACONAZO),2,119,60,59,7
COAHUILA DE ZARAGOZA,5,VIESCA,036,IGNACIO ZARAGOZA,2,85,41,44,6
COAHUILA DE ZARAGOZA,5,VIESCA,036,LA FE,3,9,2,7,2
COAHUILA DE ZARAGOZA,5,VIESCA,036,LA LEONA,1,16,8,8,1
COAHUILA DE ZARAGOZA,5,VIESCA,036,LA PRESA DE YENTI,2,20,7,13,2
COAHUILA DE ZARAGOZA,5,VIESCA,036,LA ROSITA,2,115,56,59,4
COAHUILA DE ZARAGOZA,5,VIESCA,036,LA VENTANA,5,459,255,204,24
COAHUILA DE ZARAGOZA,5,VIESCA,036,LÁZARO CÁRDENAS,1,21,12,9,2
COAHUILA DE ZARAGOZA,5,VIESCA,036,MIELERAS,2,122,68,54,8
COAHUILA DE ZARAGOZA,5,VIESCA,036,NUEVA REYNOSA,2,108,58,50,6
COAHUILA DE ZARAGOZA,5,VIESCA,036,NUEVO CUAUHTÉMOC,1,24,12,12,1
COAHUILA DE ZARAGOZA,5,VIESCA,036,NUEVO MARGARITAS,1,7,5,2,1
COAHUILA DE ZARAGOZA,5,VIESCA,036,PUNTA DE SANTO DOMINGO,2,45,20,25,3
COAHUILA DE ZARAGOZA,5,VIESCA,036,RÍO ESCONDIDO,2,53,28,25,4
COAHUILA DE ZARAGOZA,5,VIESCA,036,SAN ISIDRO,2,189,101,88,8
COAHUILA DE ZARAGOZA,5,VIESCA,036,SAN JOSÉ DEL AGUAJE,4,196,111,85,13
COAHUILA DE ZARAGOZA,5,VIESCA,036,SAN JUAN DE VILLANUEVA (VILLANUEVA),2,45,24,21,4
COAHUILA DE ZARAGOZA,5,VIESCA,036,SAN MANUEL,2,43,21,22,3
COAHUILA DE ZARAGOZA,5,VIESCA,036,SANTA CRUZ,1,62,29,33,3
COAHUILA DE ZARAGOZA,5,VIESCA,036,SANTA MARÍA SECTOR NUEVE,1,7,2,5,1
COAHUILA DE ZARAGOZA,5,VIESCA,036,SAUCILLO,1,4,4,0,1
COAHUILA DE ZARAGOZA,5,VIESCA,036,TANQUE AGUILEREÑO (EL TANQUE),4,104,51,53,7
COAHUILA DE ZARAGOZA,5,VIESCA,036,TEJABÁN DE LA ROSITA,2,63,21,42,5
COAHUILA DE ZARAGOZA,5,VIESCA,036,TEJABÁN DEL ESFUERZO (EL ESFUERZO),2,106,48,58,7
COAHUILA DE ZARAGOZA,5,VIESCA,036,TIERRA Y LIBERTAD,1,8,5,3,1
COAHUILA DE ZARAGOZA,5,VIESCA,036,VENUSTIANO CARRANZA (HACIENDA DE HORNOS),2,59,31,28,3
COAHUILA DE ZARAGOZA,5,VIESCA,036,VIESCA,7,1089,577,512,82
COAHUILA DE ZARAGOZA,5,VIESCA,036,VILLA DE BILBAO,2,45,18,27,4
COAHUILA DE ZARAGOZA,5,VILLA UNIÓN,037,LA LUZ,2,40,21,19,3
COAHUILA DE ZARAGOZA,5,VILLA UNIÓN,037,LOS CHARCOS,2,37,20,17,2
COAHUILA DE ZARAGOZA,5,VILLA UNIÓN,037,VILLA UNIÓN,10,1515,800,715,74
COAHUILA DE ZARAGOZA,5,ZARAGOZA,038,CONGREGACIÓN EL REMOLINO,4,95,42,53,8
COAHUILA DE ZARAGOZA,5,ZARAGOZA,038,LA AGRÍCOLA,2,15,3,12,2
COAHUILA DE ZARAGOZA,5,ZARAGOZA,038,LA MAROMA,3,29,15,14,3
COAHUILA DE ZARAGOZA,5,ZARAGOZA,038,LORENZO DOMÍNGUEZ MUÑOZ,3,181,94,87,10
COAHUILA DE ZARAGOZA,5,ZARAGOZA,038,PASO DEL TÍO PÍO,1,64,33,31,3
COAHUILA DE ZARAGOZA,5,ZARAGOZA,038,SAN FERNANDO (DÁVILA),1,24,14,10,1
COAHUILA DE ZARAGOZA,5,ZARAGOZA,038,SANTA EULALIA,4,70,29,41,7
COAHUILA DE ZARAGOZA,5,ZARAGOZA,038,ZARAGOZA,15,2618,1358,1260,156
COLIMA,6,ARMERÍA,001,AUGUSTO GÓMEZ VILLANUEVA (COALATILLA),4,423,210,213,21
COLIMA,6,ARMERÍA,001,CIUDAD DE ARMERÍA,24,3126,1571,1555,204
COLIMA,6,ARMERÍA,001,COFRADÍA DE JUÁREZ,11,1246,643,603,84
COLIMA,6,ARMERÍA,001,CUYUTLÁN,4,280,151,129,15
COLIMA,6,ARMERÍA,001,EL PARAÍSO [BALNEARIO],2,8,2,6,2
COLIMA,6,ARMERÍA,001,EL PUERTECITO,2,85,41,44,4
COLIMA,6,ARMERÍA,001,LA ATRAVESADA,1,3,2,1,1
COLIMA,6,ARMERÍA,001,LOS REYES (ZORRILLOS),4,150,56,94,13
COLIMA,6,ARMERÍA,001,RINCÓN DE LÓPEZ,5,528,264,264,30
COLIMA,6,COLIMA,002,ACATITÁN,2,29,15,14,3
COLIMA,6,COLIMA,002,CARDONA,2,37,17,20,3
COLIMA,6,COLIMA,002,COLIMA,337,51790,27308,24482,5084
COLIMA,6,COLIMA,002,EL ALPUYEQUITO,2,25,14,11,2
COLIMA,6,COLIMA,002,EL AMARRADERO,2,21,13,8,2
COLIMA,6,COLIMA,002,EL ASTILLERO DE ABAJO,3,57,29,28,6
COLIMA,6,COLIMA,002,EL ASTILLERO DE ARRIBA,2,33,12,21,3
COLIMA,6,COLIMA,002,EL BORDO,2,21,4,17,2
COLIMA,6,COLIMA,002,EL CHANAL,4,225,118,107,16
COLIMA,6,COLIMA,002,ESTAPILLA,4,98,50,48,9
COLIMA,6,COLIMA,002,LAS GOLONDRINAS,2,26,8,18,2
COLIMA,6,COLIMA,002,LAS GUÁSIMAS (LAS BORREGAS),4,156,81,75,11
COLIMA,6,COLIMA,002,LAS TUNAS,3,74,33,41,6
COLIMA,6,COLIMA,002,LOMA DE JUÁREZ (EL MEZQUITE),3,76,42,34,5
COLIMA,6,COLIMA,002,LOS ASMOLES,4,192,101,91,15
COLIMA,6,COLIMA,002,LOS ORTICES,3,28,16,12,3
COLIMA,6,COLIMA,002,LOS TEPAMES,5,379,192,187,34
COLIMA,6,COLIMA,002,PISCILA,4,263,126,137,20
COLIMA,6,COLIMA,002,PUERTA DE ÁNZAR,2,46,18,28,3
COLIMA,6,COLIMA,002,TINAJAS,2,23,12,11,3
COLIMA,6,COLIMA,002,TRAPICHILLOS,2,18,10,8,2
COLIMA,6,COLIMA,002,VEINTE ZM,1,17,7,10,2
COLIMA,6,COMALA,003,AGOSTO,2,27,13,14,2
COLIMA,6,COMALA,003,CAMPO CUATRO,1,4,3,1,1
COLIMA,6,COMALA,003,COFRADÍA DE SUCHITLÁN,3,291,147,144,18
COLIMA,6,COMALA,003,COMALA,16,2745,1382,1363,224
COLIMA,6,COMALA,003,EL REMUDADERO,2,42,24,18,3
COLIMA,6,COMALA,003,LA BECERRERA,3,45,25,20,5
COLIMA,6,COMALA,003,LA CAJA,4,223,100,123,15
COLIMA,6,COMALA,003,LA LOMA DEL CAMICHÍN,3,14,5,9,3
COLIMA,6,COMALA,003,LA NOGALERA,3,83,38,45,7
COLIMA,6,COMALA,003,LOS COLOMOS,4,102,43,59,7
COLIMA,6,COMALA,003,NOGUERAS,1,59,24,35,4
COLIMA,6,COMALA,003,SUCHITLÁN,6,1154,570,584,71
COLIMA,6,COMALA,003,ZACUALPAN,4,483,259,224,28
COLIMA,6,COQUIMATLÁN,004,AGUA ZARCA,2,37,20,17,3
COLIMA,6,COQUIMATLÁN,004,COQUIMATLÁN,24,5497,2431,3066,476
COLIMA,6,COQUIMATLÁN,004,CRUZ DE PIEDRA,2,18,10,8,2
COLIMA,6,COQUIMATLÁN,004,EL ALCOMÚN (LUIS ECHEVERRÍA ÁLVAREZ),1,3,0,3,1
COLIMA,6,COQUIMATLÁN,004,EL ALGODONAL,2,14,10,4,2
COLIMA,6,COQUIMATLÁN,004,EL CHICAL,4,118,65,53,10
COLIMA,6,COQUIMATLÁN,004,EL COLOMO,1,8,3,5,1
COLIMA,6,COQUIMATLÁN,004,EL POBLADO,2,32,16,16,3
COLIMA,6,COQUIMATLÁN,004,JALA,3,87,44,43,8
COLIMA,6,COQUIMATLÁN,004,LA ESPERANZA,4,176,88,88,11
COLIMA,6,COQUIMATLÁN,004,LA SIDRA,3,35,16,19,5
COLIMA,6,COQUIMATLÁN,004,LOS LIMONES,2,32,20,12,4
COLIMA,6,COQUIMATLÁN,004,PUEBLO JUÁREZ (LA MAGDALENA),4,450,240,210,34
COLIMA,6,CUAUHTÉMOC,005,ALCARACES,4,366,174,192,30
COLIMA,6,CUAUHTÉMOC,005,ALZADA,3,68,35,33,8
COLIMA,6,CUAUHTÉMOC,005,BUENAVISTA,4,193,91,102,24
COLIMA,6,CUAUHTÉMOC,005,CERRO COLORADO,1,5,3,2,1
COLIMA,6,CUAUHTÉMOC,005,CHIAPA,4,184,76,108,14
COLIMA,6,CUAUHTÉMOC,005,CUAUHTÉMOC,16,3026,1521,1505,246
COLIMA,6,CUAUHTÉMOC,005,EL CÓBANO,4,56,31,25,6
COLIMA,6,CUAUHTÉMOC,005,EL TRAPICHE,6,506,243,263,41
COLIMA,6,CUAUHTÉMOC,005,ISENCO,1,646,511,135,114
COLIMA,6,CUAUHTÉMOC,005,OCOTILLO,2,34,18,16,3
COLIMA,6,CUAUHTÉMOC,005,PALMILLAS,2,105,51,54,7
COLIMA,6,CUAUHTÉMOC,005,QUESERÍA,20,1997,977,1020,142
COLIMA,6,CUAUHTÉMOC,005,SAN JOAQUÍN,2,26,12,14,2
COLIMA,6,IXTLAHUACÁN,006,AGUA DE LA VIRGEN,3,26,11,15,3
COLIMA,6,IXTLAHUACÁN,006,AQUILES SERDÁN (TAMALA),2,51,26,25,3
COLIMA,6,IXTLAHUACÁN,006,EL CAMICHÍN (VEINTISÉIS DE JULIO),2,8,4,4,2
COLIMA,6,IXTLAHUACÁN,006,EL GALAJE,1,11,8,3,1
COLIMA,6,IXTLAHUACÁN,006,EL PLAN DEL ZAPOTE,2,14,6,8,3
COLIMA,6,IXTLAHUACÁN,006,HIGUERAS DE SANTA ROSA,1,9,5,4,1
COLIMA,6,IXTLAHUACÁN,006,IXTLAHUACÁN,6,707,335,372,46
COLIMA,6,IXTLAHUACÁN,006,LA PRESA (BARRANCA DEL REBOZO),3,100,41,59,8
COLIMA,6,IXTLAHUACÁN,006,LAS CONCHAS,4,152,75,77,11
COLIMA,6,IXTLAHUACÁN,006,LAS TRANCAS,2,26,9,17,2
COLIMA,6,IXTLAHUACÁN,006,ZINACAMITLÁN (LOS CHICOS),3,57,28,29,4
COLIMA,6,MANZANILLO,007,ASERRADERO DE LA LIMA,2,21,6,15,2
COLIMA,6,MANZANILLO,007,CAMICHÍN,1,4,2,2,1
COLIMA,6,MANZANILLO,007,CAMOTLÁN DE MIRAFLORES,4,460,203,257,31
COLIMA,6,MANZANILLO,007,CANOAS,3,50,25,25,6
COLIMA,6,MANZANILLO,007,CHANDIABLO,4,341,128,213,17
COLIMA,6,MANZANILLO,007,CIRUELITO DE LA MARINA,2,14,8,6,2
COLIMA,6,MANZANILLO,007,DON TOMÁS,2,35,14,21,4
COLIMA,6,MANZANILLO,007,EL CENTINELA DE ABAJO,1,6,3,3,1
COLIMA,6,MANZANILLO,007,EL CENTINELA DE ARRIBA,1,3,1,2,1
COLIMA,6,MANZANILLO,007,EL CHARCO,4,113,53,60,8
COLIMA,6,MANZANILLO,007,EL CHAVARÍN,4,458,236,222,19
COLIMA,6,MANZANILLO,007,EL COLOMO,14,2594,1324,1270,153
COLIMA,6,MANZANILLO,007,EL GARCERO,1,36,13,23,3
COLIMA,6,MANZANILLO,007,EL HUIZCOLOTE,3,48,18,30,5
COLIMA,6,MANZANILLO,007,EL NARANJO,4,306,146,160,17
COLIMA,6,MANZANILLO,007,EMILIANO ZAPATA,3,58,27,31,5
COLIMA,6,MANZANILLO,007,FRANCISCO VILLA,2,140,65,75,8
COLIMA,6,MANZANILLO,007,JALIPA,4,621,281,340,29
COLIMA,6,MANZANILLO,007,LA CENTRAL,4,449,212,237,21
COLIMA,6,MANZANILLO,007,LA CULEBRA (COLIMILLA),4,111,54,57,8
COLIMA,6,MANZANILLO,007,LA ROSA DE SAN JOSÉ DE LÚMBER,1,25,8,17,1
COLIMA,6,MANZANILLO,007,LAS JUNTAS (LA FLOREÑA),4,286,142,144,14
COLIMA,6,MANZANILLO,007,LLANO DE LA MARINA,4,124,71,53,11
COLIMA,6,MANZANILLO,007,LOMAS DE ÁVILA CAMACHO,1,10,6,4,1
COLIMA,6,MANZANILLO,007,LOS CEDROS,4,134,60,74,12
COLIMA,6,MANZANILLO,007,LOS PARAJES,1,4,1,3,1
COLIMA,6,MANZANILLO,007,MANZANILLO,266,42256,21243,21013,3279
COLIMA,6,MANZANILLO,007,NUEVO CUYUTLÁN,2,168,82,86,8
COLIMA,6,MANZANILLO,007,NUEVO EL PETATERO,1,26,11,15,2
COLIMA,6,MANZANILLO,007,PUERTECITO DE LAJAS,2,36,21,15,3
COLIMA,6,MANZANILLO,007,PUNTA DE AGUA DE CAMOTLÁN,3,83,35,48,6
COLIMA,6,MANZANILLO,007,RÍO MARABASCO,2,91,38,53,4
COLIMA,6,MANZANILLO,007,SAN BUENAVENTURA,3,149,78,71,10
COLIMA,6,MANZANILLO,007,SAN JOSÉ DE LÚMBER (PIEDRA REDONDA),1,6,4,2,1
COLIMA,6,MANZANILLO,007,SANTA RITA,2,97,48,49,6
COLIMA,6,MANZANILLO,007,SANTIAGO CERVANTES,2,330,160,170,12
COLIMA,6,MANZANILLO,007,VELADERO DE CAMOTLÁN,3,65,32,33,5
COLIMA,6,MANZANILLO,007,VELADERO DE LOS OTATES,2,38,13,25,3
COLIMA,6,MANZANILLO,007,VENUSTIANO CARRANZA (CUALATA),4,412,214,198,29
COLIMA,6,MINATITLÁN,008,AGUA SALADA,4,183,77,106,13
COLIMA,6,MINATITLÁN,008,BENITO JUÁREZ DE PEÑA COLORADA (EL POBLADO),3,239,132,107,13
COLIMA,6,MINATITLÁN,008,EL ARRAYANAL,1,6,2,4,1
COLIMA,6,MINATITLÁN,008,EL PLATANAR,2,32,17,15,2
COLIMA,6,MINATITLÁN,008,EL SAUZ,3,36,17,19,3
COLIMA,6,MINATITLÁN,008,EL TERRERO,3,23,11,12,3
COLIMA,6,MINATITLÁN,008,LA COCONAL,2,8,3,5,2
COLIMA,6,MINATITLÁN,008,LA LOMA,3,87,47,40,7
COLIMA,6,MINATITLÁN,008,LA PLAYA (LA PLAYITA),2,25,13,12,2
COLIMA,6,MINATITLÁN,008,LAS PESADAS,2,23,8,15,2
COLIMA,6,MINATITLÁN,008,MINATITLÁN,7,1631,792,839,82
COLIMA,6,MINATITLÁN,008,PATICAJO,4,335,171,164,16
COLIMA,6,MINATITLÁN,008,PLATANARILLOS,1,6,3,3,1
COLIMA,6,MINATITLÁN,008,POTRERO GRANDE,2,5,4,1,2
COLIMA,6,MINATITLÁN,008,SAN ANTONIO,2,21,7,14,2
COLIMA,6,TECOMÁN,009,ARTURO NORIEGA PIZANO,2,30,15,15,3
COLIMA,6,TECOMÁN,009,BOCA DE PASCUALES,3,8,5,3,2
COLIMA,6,TECOMÁN,009,CALERAS,4,425,230,195,25
COLIMA,6,TECOMÁN,009,CALLEJONES,3,73,37,36,5
COLIMA,6,TECOMÁN,009,CERRITO DE AGUILAR,2,27,14,13,2
COLIMA,6,TECOMÁN,009,CERRO DE ORTEGA,14,2182,1138,1044,120
COLIMA,6,TECOMÁN,009,CHANCHOPA,2,46,25,21,5
COLIMA,6,TECOMÁN,009,COFRADÍA DE HIDALGO (LAGUNA DE ALCUZAHUE),1,73,36,37,3
COLIMA,6,TECOMÁN,009,COFRADÍA DE MORELOS,5,672,358,314,32
COLIMA,6,TECOMÁN,009,COLONIA BAYARDO,10,1092,569,523,74
COLIMA,6,TECOMÁN,009,EL HORMIGUERO UNO,2,149,75,74,8
COLIMA,6,TECOMÁN,009,EL SAUCITO,2,45,28,17,3
COLIMA,6,TECOMÁN,009,LA CARIMACHA [LUCIO LEÓN],1,20,12,8,2
COLIMA,6,TECOMÁN,009,LA CUARTA,3,26,13,13,4
COLIMA,6,TECOMÁN,009,LA SALADA,2,7,3,4,2
COLIMA,6,TECOMÁN,009,LAGUNA DE ALCUZAHUE,2,40,18,22,4
COLIMA,6,TECOMÁN,009,LAS DOS ROSITAS,3,19,11,8,3
COLIMA,6,TECOMÁN,009,MADRID,6,709,357,352,47
COLIMA,6,TECOMÁN,009,SAN ÁNGEL,2,8,3,5,1
COLIMA,6,TECOMÁN,009,SAN JOSÉ,2,5,4,1,2
COLIMA,6,TECOMÁN,009,SAN MIGUEL DEL OJO DE AGUA,4,116,66,50,9
COLIMA,6,TECOMÁN,009,TECOLAPA,4,170,83,87,12
COLIMA,6,TECOMÁN,009,TECOMÁN,137,22216,11476,10740,1620
COLIMA,6,TECOMÁN,009,TECUANILLO [BALNEARIO],1,12,6,6,1
COLIMA,6,VILLA DE ÁLVAREZ,010,AGUA DULCE,3,44,16,28,3
COLIMA,6,VILLA DE ÁLVAREZ,010,CIUDAD DE VILLA DE ÁLVAREZ,150,28062,14075,13987,2035
COLIMA,6,VILLA DE ÁLVAREZ,010,EL CHIVATO (PROVIDENCIA),2,83,43,40,4
COLIMA,6,VILLA DE ÁLVAREZ,010,EL MIXCUATE,3,62,30,32,5
COLIMA,6,VILLA DE ÁLVAREZ,010,EL NARANJAL,2,28,13,15,2
COLIMA,6,VILLA DE ÁLVAREZ,010,EL NUEVO NARANJAL,1,11,5,6,1
COLIMA,6,VILLA DE ÁLVAREZ,010,JULUAPAN,4,176,74,102,14
COLIMA,6,VILLA DE ÁLVAREZ,010,LA LIMA,3,99,38,61,8
COLIMA,6,VILLA DE ÁLVAREZ,010,LAS JOYITAS,2,32,17,15,3
COLIMA,6,VILLA DE ÁLVAREZ,010,PUEBLO NUEVO,2,13,7,6,2
DURANGO,10,CANATLÁN,001,ARNULFO R. GÓMEZ (LOS SAUCES),3,121,53,68,8
DURANGO,10,CANATLÁN,001,BENJAMÍN ARANDA (SAN RAFAEL),2,36,15,21,3
DURANGO,10,CANATLÁN,001,BRUNO MARTÍNEZ (SAN BARTOLO),3,181,98,83,11
DURANGO,10,CANATLÁN,001,CANATLÁN,23,3656,1864,1792,267
DURANGO,10,CANATLÁN,001,CERRO GORDO,3,86,43,43,7
DURANGO,10,CANATLÁN,001,CIENEGUITAS,1,4,3,1,1
DURANGO,10,CANATLÁN,001,COLONIA ANÁHUAC (PALO BLANCO),4,214,109,105,15
DURANGO,10,CANATLÁN,001,DOLORES HIDALGO (GOGOGITO),2,23,10,13,2
DURANGO,10,CANATLÁN,001,DONATO GUERRA,3,156,73,83,15
DURANGO,10,CANATLÁN,001,EL POZOLE,1,8,5,3,1
DURANGO,10,CANATLÁN,001,EL PROGRESO (LOS PINOS),3,126,59,67,10
DURANGO,10,CANATLÁN,001,EL TULE,3,37,18,19,3
DURANGO,10,CANATLÁN,001,GENERAL MARTÍN LÓPEZ,3,153,80,73,10
DURANGO,10,CANATLÁN,001,GOMELIA,4,49,28,21,6
DURANGO,10,CANATLÁN,001,HERMENEGILDO GALEANA,2,5,2,3,2
DURANGO,10,CANATLÁN,001,IGNACIO M. ALTAMIRANO (LA LUZ),3,93,43,50,6
DURANGO,10,CANATLÁN,001,JOSÉ CRUZ GÁLVEZ (CAÑAS),3,37,19,18,4
DURANGO,10,CANATLÁN,001,JOSÉ GUADALUPE AGUILERA (SANTA LUCÍA),5,1300,462,838,128
DURANGO,10,CANATLÁN,001,LA CAÑADA,1,9,6,3,1
DURANGO,10,CANATLÁN,001,LA PLAZUELA (EL RAYO),4,108,53,55,8
DURANGO,10,CANATLÁN,001,LA SAUCEDA,2,87,29,58,8
DURANGO,10,CANATLÁN,001,LA SOLEDAD,3,170,86,84,10
DURANGO,10,CANATLÁN,001,LIRIOS DE LA SIERRA,1,4,1,3,1
DURANGO,10,CANATLÁN,001,LOS LIRIOS,1,14,7,7,1
DURANGO,10,CANATLÁN,001,MARQUESOTES DE GUADALUPE (CANELAS),4,38,20,18,4
DURANGO,10,CANATLÁN,001,MARQUEZOTES DE GUADALUPE (LOS OJITOS),1,4,1,3,1
DURANGO,10,CANATLÁN,001,MAYMORITA,3,39,15,24,4
DURANGO,10,CANATLÁN,001,MEDINA,3,37,18,19,4
DURANGO,10,CANATLÁN,001,MIGUEL HIDALGO (VIBORILLAS),2,16,4,12,2
DURANGO,10,CANATLÁN,001,NICOLÁS BRAVO,4,266,138,128,24
DURANGO,10,CANATLÁN,001,NOGALES,3,81,43,38,6
DURANGO,10,CANATLÁN,001,PREDIO SANTA CRUZ DE LAS HUERTAS,1,4,2,2,1
DURANGO,10,CANATLÁN,001,RICARDO FLORES MAGÓN,4,286,144,142,17
DURANGO,10,CANATLÁN,001,SAN DIEGO DE ALCALÁ,3,37,21,16,4
DURANGO,10,CANATLÁN,001,SAN JERÓNIMO DE JACALES,2,20,12,8,2
DURANGO,10,CANATLÁN,001,SAN JOSÉ DE GRACIA,3,243,114,129,15
DURANGO,10,CANATLÁN,001,SAN LORENZO,2,8,2,6,1
DURANGO,10,CANATLÁN,001,SANTA ROSA DE ESCAMILLAS,3,30,17,13,3
DURANGO,10,CANATLÁN,001,SANTA TERESA DE LOS PINOS,2,4,1,3,2
DURANGO,10,CANATLÁN,001,VEINTIDÓS DE MAYO,4,141,70,71,9
DURANGO,10,CANATLÁN,001,VENUSTIANO CARRANZA (OCOTÁN),4,285,135,150,21
DURANGO,10,CANELAS,002,AGUA BLANCA DE AVITIA,1,9,3,6,1
DURANGO,10,CANELAS,002,ARROYO GRANDE,3,32,9,23,3
DURANGO,10,CANELAS,002,BRASILES,2,15,8,7,2
DURANGO,10,CANELAS,002,CANELAS,5,379,179,200,19
DURANGO,10,CANELAS,002,CEBOLLAS GRANDES,2,19,10,9,2
DURANGO,10,CANELAS,002,CEBOLLITAS,1,3,2,1,1
DURANGO,10,CANELAS,002,CERRO PRIETO,1,10,7,3,1
DURANGO,10,CANELAS,002,EL AGUACATE,1,8,6,2,1
DURANGO,10,CANELAS,002,EL AGUAJE,1,7,4,3,1
DURANGO,10,CANELAS,002,EL COMEDERO DEL RODEO,2,8,2,6,2
DURANGO,10,CANELAS,002,EL DURAZNO DE LOS LÓPEZ,2,13,8,5,2
DURANGO,10,CANELAS,002,EL ENCINAL,1,3,2,1,1
DURANGO,10,CANELAS,002,EL GRANADITO,1,3,2,1,1
DURANGO,10,CANELAS,002,EL GUASIMAL,2,6,5,1,2
DURANGO,10,CANELAS,002,EL LLANO,1,1,0,1,1
DURANGO,10,CANELAS,002,EL MADROÑO (LA CUEVA),1,3,3,0,1
DURANGO,10,CANELAS,002,EL OJITO DE CAMELLONES,3,55,29,26,4
DURANGO,10,CANELAS,002,EL SALTO DE CAMELLONES,3,49,24,25,4
DURANGO,10,CANELAS,002,EL TABLÓN,1,3,2,1,1
DURANGO,10,CANELAS,002,LA ANGOSTURA,2,3,1,2,2
DURANGO,10,CANELAS,002,LA CIÉNEGA,2,21,9,12,2
DURANGO,10,CANELAS,002,LA ESPERANZA,2,6,3,3,2
DURANGO,10,CANELAS,002,LA PLOMOSA,1,3,2,1,1
DURANGO,10,CANELAS,002,LA TEMBLADORA,4,121,69,52,8
DURANGO,10,CANELAS,002,LA YERBABUENA,2,38,19,19,3
DURANGO,10,CANELAS,002,LAS TROJAS,2,19,8,11,2
DURANGO,10,CANELAS,002,LOS OTATES,1,4,2,2,1
DURANGO,10,CANELAS,002,MESA DE CHIRIMOYO,1,6,3,3,1
DURANGO,10,CANELAS,002,MESA DE GUADALUPE,1,31,12,19,2
DURANGO,10,CANELAS,002,MESA DE LA CAÑA,1,3,2,1,1
DURANGO,10,CANELAS,002,MONTE NEGRO,2,9,7,2,2
DURANGO,10,CANELAS,002,POTRERITO DE CARRASCO,2,10,6,4,2
DURANGO,10,CANELAS,002,RANCHO ESCONDIDO,3,12,6,6,3
DURANGO,10,CANELAS,002,SALSIPUEDES,2,4,2,2,2
DURANGO,10,CANELAS,002,SAN JUAN DE HUICHACÁN,2,7,2,5,2
DURANGO,10,CANELAS,002,TAUNITAS,1,4,2,2,1
DURANGO,10,CANELAS,002,TIERRA AZUL,2,17,10,7,2
DURANGO,10,CANELAS,002,VASCOGIL,3,55,29,26,4
DURANGO,10,CANELAS,002,ZAPOTES DE RODRÍGUEZ,2,20,13,7,2
DURANGO,10,CANELAS,002,ZAPOTES DE VALENCIA,3,32,19,13,3
DURANGO,10,CONETO DE COMONFORT,003,ARROYO DEL CABALLO,3,9,6,3,2
DURANGO,10,CONETO DE COMONFORT,003,CONETO DE COMONFORT,4,343,171,172,21
DURANGO,10,CONETO DE COMONFORT,003,EL PORVENIR,3,56,25,31,4
DURANGO,10,CONETO DE COMONFORT,003,EL RANCHITO,2,5,2,3,1
DURANGO,10,CONETO DE COMONFORT,003,IGNACIO ZARAGOZA (POTRILLOS),3,26,13,13,3
DURANGO,10,CONETO DE COMONFORT,003,LAS MORENAS (LA ROSA),2,20,7,13,2
DURANGO,10,CONETO DE COMONFORT,003,LOS OJITOS,3,14,6,8,2
DURANGO,10,CONETO DE COMONFORT,003,NOGALES,3,246,128,118,13
DURANGO,10,CONETO DE COMONFORT,003,PÍPILA (CHIGANAYO),3,54,25,29,4
DURANGO,10,CONETO DE COMONFORT,003,SAN FRANCISCO JAVIER DE LAJAS (LAJAS),3,130,60,70,8
DURANGO,10,CONETO DE COMONFORT,003,SAN JOSÉ DE BASOCO,3,36,18,18,4
DURANGO,10,CONETO DE COMONFORT,003,SAPIORIS,3,39,20,19,4
DURANGO,10,CONETO DE COMONFORT,003,VIZCAÍNO,3,70,27,43,4
DURANGO,10,CUENCAMÉ,004,12 DE DICIEMBRE (SOMBRERETILLO),4,244,135,109,15
DURANGO,10,CUENCAMÉ,004,CERRO GORDO,1,8,5,3,1
DURANGO,10,CUENCAMÉ,004,CERRO SANTIAGO (CERRO DE SANTIAGO),3,43,20,23,4
DURANGO,10,CUENCAMÉ,004,CINCO DE MAYO (SAN ÁNGEL),3,128,64,64,9
DURANGO,10,CUENCAMÉ,004,COLONIA CHAPALA,2,7,3,4,2
DURANGO,10,CUENCAMÉ,004,COLONIA ORIENTE,1,5,2,3,1
DURANGO,10,CUENCAMÉ,004,COMPAÑÍA GANADERA ATOTONILCO SOCIEDAD COOPERATIVA DE PRODUCCIÓN,2,3,2,1,2
DURANGO,10,CUENCAMÉ,004,CUAUHTÉMOC,5,623,311,312,52
DURANGO,10,CUENCAMÉ,004,EL ALAMILLO,3,42,20,22,4
DURANGO,10,CUENCAMÉ,004,EL TANQUE,2,46,22,24,4
DURANGO,10,CUENCAMÉ,004,EMILIANO ZAPATA,6,581,316,265,44
DURANGO,10,CUENCAMÉ,004,ESTACIÓN PROGRESO,3,46,21,25,4
DURANGO,10,CUENCAMÉ,004,ESTANCIA DE SANTIAGO,2,4,2,2,2
DURANGO,10,CUENCAMÉ,004,HÉROES DE CHAPULTEPEC (SAN SEBASTIÁN),3,61,35,26,5
DURANGO,10,CUENCAMÉ,004,IGNACIO LÓPEZ RAYÓN,3,122,53,69,8
DURANGO,10,CUENCAMÉ,004,LA FE,3,65,35,30,4
DURANGO,10,CUENCAMÉ,004,LA LAGUNILLA,3,55,27,28,4
DURANGO,10,CUENCAMÉ,004,LA PURÍSIMA,2,81,37,44,5
DURANGO,10,CUENCAMÉ,004,LA ROCA,1,4,2,2,1
DURANGO,10,CUENCAMÉ,004,LA VIRGEN,1,6,2,4,1
DURANGO,10,CUENCAMÉ,004,LAS MERCEDES,3,114,64,50,9
DURANGO,10,CUENCAMÉ,004,LOS CUATILLOS (HACIENDA DE PEDRICEÑA),2,103,55,48,7
DURANGO,10,CUENCAMÉ,004,LOS VALLECILLOS,2,21,7,14,2
DURANGO,10,CUENCAMÉ,004,PASAJE,4,315,157,158,15
DURANGO,10,CUENCAMÉ,004,PEDRICEÑA (ESTACIÓN PEDRICEÑA),4,561,292,269,30
DURANGO,10,CUENCAMÉ,004,PEDRO VÉLEZ,3,86,45,41,7
DURANGO,10,CUENCAMÉ,004,RAMÓN CORONA,4,448,227,221,23
DURANGO,10,CUENCAMÉ,004,SAN ANTONIO DE LOS GARCÍA (OJO ZARCO),3,49,24,25,4
DURANGO,10,CUENCAMÉ,004,SAN ANTONIO DEL OJO SECO,4,213,109,104,12
DURANGO,10,CUENCAMÉ,004,SAN PEDRO DE OCUILA,3,99,51,48,5
DURANGO,10,CUENCAMÉ,004,SANTA CRUZ DE LA CUCHILLA,3,119,64,55,8
DURANGO,10,CUENCAMÉ,004,TRES VECES HEROICA CUENCAMÉ DE CENICEROS,19,3910,1924,1986,245
DURANGO,10,CUENCAMÉ,004,VEINTE AMIGOS,2,48,21,27,4
DURANGO,10,CUENCAMÉ,004,VELARDEÑA,6,1089,556,533,78
DURANGO,10,CUENCAMÉ,004,VISTA HERMOSA,3,102,39,63,6
DURANGO,10,DURANGO,005,ABRAHAM GONZÁLEZ,3,180,79,101,12
DURANGO,10,DURANGO,005,ANTONIO CASTILLO,2,29,13,16,3
DURANGO,10,DURANGO,005,ANTONIO GAXIOLA (LA CARRETA),3,48,21,27,4
DURANGO,10,DURANGO,005,AQUILES SERDÁN,3,142,66,76,10
DURANGO,10,DURANGO,005,BANDERAS DEL ÁGUILA,4,416,204,212,21
DURANGO,10,DURANGO,005,BELISARIO DOMÍNGUEZ,3,139,67,72,7
DURANGO,10,DURANGO,005,CERRO PRIETO,2,7,4,3,2
DURANGO,10,DURANGO,005,CINCO DE FEBRERO,4,278,129,149,16
DURANGO,10,DURANGO,005,CINCO DE MAYO,4,801,392,409,40
DURANGO,10,DURANGO,005,COLONIA GENERAL FELIPE ÁNGELES,1,13,8,5,1
DURANGO,10,DURANGO,005,COLONIA HIDALGO,5,883,423,460,69
DURANGO,10,DURANGO,005,COLONIA JOSÉ MARÍA MORELOS,3,20,8,12,3
DURANGO,10,DURANGO,005,COLONIA LIBERACIÓN SOCIAL,1,14,4,10,1
DURANGO,10,DURANGO,005,COLONIA VALLE VERDE,1,33,11,22,2
DURANGO,10,DURANGO,005,CONTRERAS,2,234,114,120,12
DURANGO,10,DURANGO,005,CORRAL DE BARRANCO,2,33,14,19,3
DURANGO,10,DURANGO,005,CRISTÓBAL COLÓN,4,887,460,427,30
DURANGO,10,DURANGO,005,DIECIOCHO DE MARZO,3,52,23,29,4
DURANGO,10,DURANGO,005,DIECISÉIS DE SEPTIEMBRE (CIENEGUITA DE FULLMAN),3,92,40,52,6
DURANGO,10,DURANGO,005,DOLORES HIDALGO,6,908,462,446,42
DURANGO,10,DURANGO,005,ECHEVERRÍA DE LA SIERRA,3,24,13,11,3
DURANGO,10,DURANGO,005,EL ARENAL (SAN JERÓNIMO),6,261,125,136,16
DURANGO,10,DURANGO,005,EL CARMEN Y ANEXOS,3,93,45,48,6
DURANGO,10,DURANGO,005,EL CARRIZO,3,55,24,31,4
DURANGO,10,DURANGO,005,EL DURAZNO,3,96,42,54,6
DURANGO,10,DURANGO,005,EL ENCINAL,3,77,40,37,5
DURANGO,10,DURANGO,005,EL MADROÑO,2,13,6,7,2
DURANGO,10,DURANGO,005,EL NAYAR,6,819,408,411,41
DURANGO,10,DURANGO,005,EL PUEBLITO,3,170,83,87,12
DURANGO,10,DURANGO,005,EL REFUGIO,2,245,120,125,11
DURANGO,10,DURANGO,005,EL REFUGIO (EL CONEJO),1,151,78,73,6
DURANGO,10,DURANGO,005,EL REGISTRILLO,3,8,5,3,3
DURANGO,10,DURANGO,005,EL SALTITO (EL RECREO),1,176,97,79,8
DURANGO,10,DURANGO,005,EL TOBOSO,3,20,7,13,3
DURANGO,10,DURANGO,005,EL TUNAL,2,51,22,29,5
DURANGO,10,DURANGO,005,EMPALME PURÍSIMA,4,304,141,163,42
DURANGO,10,DURANGO,005,FRANCISCO VILLA NUEVO,2,41,20,21,3
DURANGO,10,DURANGO,005,FRANCISCO VILLA VIEJO,3,44,20,24,4
DURANGO,10,DURANGO,005,FRAY FRANCISCO MONTES DE OCA,4,310,154,156,19
DURANGO,10,DURANGO,005,GABINO SANTILLÁN,3,303,147,156,18
DURANGO,10,DURANGO,005,GENERAL CARLOS REAL,4,204,109,95,14
DURANGO,10,DURANGO,005,GENERAL DOMINGO ARRIETA (PASTORES),3,15,4,11,3
DURANGO,10,DURANGO,005,GENERAL FELIPE ÁNGELES (EJIDO),3,133,55,78,8
DURANGO,10,DURANGO,005,GENERAL LÁZARO CÁRDENAS (GARABITO VIEJO),2,31,9,22,3
DURANGO,10,DURANGO,005,GENERAL MARIANO MATAMOROS,3,88,45,43,5
DURANGO,10,DURANGO,005,GENERAL MÁXIMO GARCÍA (EL PINO),4,209,108,101,14
DURANGO,10,DURANGO,005,HÉROE DE NACOZARI,3,103,52,51,6
DURANGO,10,DURANGO,005,IGNACIO LÓPEZ RAYÓN,3,228,128,100,11
DURANGO,10,DURANGO,005,IGNACIO ZARAGOZA,4,117,55,62,7
DURANGO,10,DURANGO,005,INDEPENDENCIA Y LIBERTAD,4,287,152,135,14
DURANGO,10,DURANGO,005,INGENIERO PASTOR ROUAIX,3,24,13,11,3
DURANGO,10,DURANGO,005,JESÚS GONZÁLEZ ORTEGA (PERICOS),3,39,19,20,4
DURANGO,10,DURANGO,005,JOSÉ MARÍA MORELOS Y PAVÓN (LA TINAJA),3,281,130,151,17
DURANGO,10,DURANGO,005,JOSÉ MARÍA PINO SUÁREZ,4,922,495,427,46
DURANGO,10,DURANGO,005,JOSÉ REFUGIO SALCIDO,4,323,151,172,19
DURANGO,10,DURANGO,005,JUAN ALDAMA,1,4,3,1,1
DURANGO,10,DURANGO,005,JUAN B. CEBALLOS,3,134,57,77,10
DURANGO,10,DURANGO,005,LA BOCA DEL MEZQUITAL,2,15,7,8,2
DURANGO,10,DURANGO,005,LA CURVA,2,8,6,2,1
DURANGO,10,DURANGO,005,LA FERRERÍA (CUATRO DE OCTUBRE),5,509,251,258,31
DURANGO,10,DURANGO,005,LA FLOR,3,25,16,9,3
DURANGO,10,DURANGO,005,LA JOYA,3,103,58,45,8
DURANGO,10,DURANGO,005,LA LUZ,3,54,27,27,4
DURANGO,10,DURANGO,005,LA PALMITA,2,3,2,1,1
DURANGO,10,DURANGO,005,LA PERLA (SALCIDO),2,5,3,2,1
DURANGO,10,DURANGO,005,LA PUERTA DE SANTIAGO BAYACORA (PUERTA CHICA),2,44,19,25,3
DURANGO,10,DURANGO,005,LA QUINTA,3,24,12,12,3
DURANGO,10,DURANGO,005,LA SOLEDAD,3,22,10,12,3
DURANGO,10,DURANGO,005,LABOR DE GUADALUPE,3,137,65,72,8
DURANGO,10,DURANGO,005,LAS BAYAS,3,54,32,22,4
DURANGO,10,DURANGO,005,LAS GÜERAS,2,6,3,3,1
DURANGO,10,DURANGO,005,LAS HUERTAS,3,186,83,103,41
DURANGO,10,DURANGO,005,LLANO GRANDE,5,909,521,388,37
DURANGO,10,DURANGO,005,LOS ARTÍCULOS,3,4,0,4,2
DURANGO,10,DURANGO,005,LOS MIMBRES,3,42,23,19,4
DURANGO,10,DURANGO,005,LOS YESQUEROS,3,32,17,15,3
DURANGO,10,DURANGO,005,MÁLAGA,3,76,40,36,7
DURANGO,10,DURANGO,005,MESAS DE URBINA,2,27,11,16,2
DURANGO,10,DURANGO,005,METATES (TENCHONTLE),3,39,25,14,4
DURANGO,10,DURANGO,005,MI PATRIA ES PRIMERO (MESA DEL CUERVO),2,6,1,5,2
DURANGO,10,DURANGO,005,MINERVA (COLONIA),3,48,24,24,3
DURANGO,10,DURANGO,005,MORCILLO,4,290,149,141,17
DURANGO,10,DURANGO,005,NAVACOYÁN,2,41,21,20,2
DURANGO,10,DURANGO,005,NAVAJAS,3,53,26,27,4
DURANGO,10,DURANGO,005,NAVÍOS,3,20,6,14,3
DURANGO,10,DURANGO,005,NICOLÁS ROMERO,4,201,106,95,12
DURANGO,10,DURANGO,005,NUEVA PATRIA (SANTO DOMINGO),3,96,58,38,6
DURANGO,10,DURANGO,005,NUEVO CENTENARIO,3,17,11,6,3
DURANGO,10,DURANGO,005,OJO DE AGUA DEL CAZADOR (CRUZ DE PIEDRA),3,62,27,35,4
DURANGO,10,DURANGO,005,OTINAPA,3,37,21,16,4
DURANGO,10,DURANGO,005,PARQUE INDUSTRIAL LADRILLERO,2,54,28,26,3
DURANGO,10,DURANGO,005,PARRAS DE LA FUENTE,3,195,81,114,11
DURANGO,10,DURANGO,005,PILAR DE ZARAGOZA,4,257,124,133,19
DURANGO,10,DURANGO,005,PLAN DE AYALA,4,350,173,177,21
DURANGO,10,DURANGO,005,PRAXEDIS G. GUERRERO VIEJO,5,347,175,172,21
DURANGO,10,DURANGO,005,PREDIO LA CAMPANA,1,15,11,4,2
DURANGO,10,DURANGO,005,PRESIDENTE SALVADOR ALLENDE,3,23,7,16,3
DURANGO,10,DURANGO,005,PRIMERO DE MAYO,3,167,84,83,10
DURANGO,10,DURANGO,005,PUERTA DE LA CANTERA,3,172,78,94,10
DURANGO,10,DURANGO,005,QUINCE DE OCTUBRE,3,132,73,59,8
DURANGO,10,DURANGO,005,QUINCE DE SEPTIEMBRE,3,176,89,87,11
DURANGO,10,DURANGO,005,RANCHO EL DORADO,3,939,467,472,32
DURANGO,10,DURANGO,005,REGOCIJO,3,61,29,32,4
DURANGO,10,DURANGO,005,RÍO ESCONDIDO (LA LOMA),2,171,79,92,8
DURANGO,10,DURANGO,005,RÍO VERDE,3,32,16,16,4
DURANGO,10,DURANGO,005,RODRÍGUEZ PUEBLA,3,31,15,16,3
DURANGO,10,DURANGO,005,SAN ANTONIO DE LAS BASURAS,1,6,4,2,1
DURANGO,10,DURANGO,005,SAN BENITO,3,44,22,22,3
DURANGO,10,DURANGO,005,SAN CARLOS,1,31,16,15,2
DURANGO,10,DURANGO,005,SAN FRANCISCO DEL MANZANAL,3,141,63,78,7
DURANGO,10,DURANGO,005,SAN ISIDRO,3,149,65,84,9
DURANGO,10,DURANGO,005,SAN JOSÉ DE ÁNIMAS,3,65,32,33,5
DURANGO,10,DURANGO,005,SAN JOSÉ DE LA VINATA,2,17,9,8,2
DURANGO,10,DURANGO,005,SAN JOSÉ DEL MOLINO,3,92,47,45,5
DURANGO,10,DURANGO,005,SAN JUAN AGUINALDO,3,12,6,6,3
DURANGO,10,DURANGO,005,SAN MIGUEL DE LAS MARAVILLAS DE ABAJO,1,9,4,5,1
DURANGO,10,DURANGO,005,SAN MIGUEL DE LAS MARAVILLAS DE ARRIBA,3,66,23,43,4
DURANGO,10,DURANGO,005,SAN NICOLÁS,2,6,3,3,1
DURANGO,10,DURANGO,005,SAN PEDRO DE LA MÁQUINA,2,6,1,5,1
DURANGO,10,DURANGO,005,SAN PEDRO DE LOS PINOS,1,7,4,3,1
DURANGO,10,DURANGO,005,SAN SALVADOR DE CASA BLANCA,2,12,6,6,2
DURANGO,10,DURANGO,005,SAN VICENTE DE CHUPADEROS,4,287,155,132,14
DURANGO,10,DURANGO,005,SANTA BÁRBARA,1,4,3,1,1
DURANGO,10,DURANGO,005,SANTA CRUZ DE SAN JAVIER,2,28,13,15,2
DURANGO,10,DURANGO,005,SANTA ISABEL DE BATRES,3,8,5,3,2
DURANGO,10,DURANGO,005,SANTA LUCÍA,2,39,23,16,3
DURANGO,10,DURANGO,005,SANTIAGO BAYACORA,4,394,211,183,21
DURANGO,10,DURANGO,005,SEBASTIÁN LERDO DE TEJADA,4,503,241,262,30
DURANGO,10,DURANGO,005,TOMÁS URBINA,3,161,80,81,10
DURANGO,10,DURANGO,005,UNIDOS VENCEREMOS,3,81,42,39,5
DURANGO,10,DURANGO,005,UNIÓN DE RODRÍGUEZ,2,9,2,7,1
DURANGO,10,DURANGO,005,VALLE FLORIDO,3,161,84,77,10
DURANGO,10,DURANGO,005,VEINTIOCHO DE SEPTIEMBRE,3,71,34,37,6
DURANGO,10,DURANGO,005,VEINTISIETE DE NOVIEMBRE,3,70,33,37,4
DURANGO,10,DURANGO,005,VICENTE SUÁREZ,2,16,8,8,2
DURANGO,10,DURANGO,005,VICTORIA DE DURANGO,866,188065,95897,92168,13975
DURANGO,10,DURANGO,005,VILLA MONTEMORELOS,5,1056,502,554,100
DURANGO,10,GENERAL SIMÓN BOLÍVAR,006,ANTÓN MARTÍN,3,22,9,13,3
DURANGO,10,GENERAL SIMÓN BOLÍVAR,006,DIECIOCHO DE MARZO,3,64,26,38,5
DURANGO,10,GENERAL SIMÓN BOLÍVAR,006,EL REFUGIO,2,36,12,24,3
DURANGO,10,GENERAL SIMÓN BOLÍVAR,006,ENRIQUE FLORES MAGÓN,2,53,27,26,4
DURANGO,10,GENERAL SIMÓN BOLÍVAR,006,GENERAL SIMÓN BOLÍVAR,4,446,218,228,28
DURANGO,10,GENERAL SIMÓN BOLÍVAR,006,HUARICHIC (HUARICHE),3,113,60,53,7
DURANGO,10,GENERAL SIMÓN BOLÍVAR,006,IGNACIO ZARAGOZA,4,298,157,141,16
DURANGO,10,GENERAL SIMÓN BOLÍVAR,006,JOSÉ ISABEL ROBLES,3,99,51,48,9
DURANGO,10,GENERAL SIMÓN BOLÍVAR,006,JOSÉ TRINIDAD GARCÍA DE LA CADENA (SAN RAFAEL),4,146,73,73,10
DURANGO,10,GENERAL SIMÓN BOLÍVAR,006,LA GRANJA,3,27,16,11,3
DURANGO,10,GENERAL SIMÓN BOLÍVAR,006,LA PRONTITUD,2,8,2,6,2
DURANGO,10,GENERAL SIMÓN BOLÍVAR,006,ORIENTE AGUANAVAL,4,200,112,88,13
DURANGO,10,GENERAL SIMÓN BOLÍVAR,006,PEDRO CELESTINO NEGRETE,2,22,12,10,2
DURANGO,10,GENERAL SIMÓN BOLÍVAR,006,RICARDO FLORES MAGÓN,2,16,5,11,2
DURANGO,10,GENERAL SIMÓN BOLÍVAR,006,SAN ANTONIO DE ZARAGOZA,3,83,41,42,5
DURANGO,10,GENERAL SIMÓN BOLÍVAR,006,SAN JOSÉ DE REYES,4,103,54,49,14
DURANGO,10,GENERAL SIMÓN BOLÍVAR,006,SAN JOSÉ DE SAUCES (SAUCES),3,35,11,24,3
DURANGO,10,GENERAL SIMÓN BOLÍVAR,006,SAN JOSÉ DE ZARAGOZA,4,389,210,179,20
DURANGO,10,GENERAL SIMÓN BOLÍVAR,006,SAN LUIS DE COREA,2,10,4,6,2
DURANGO,10,GENERAL SIMÓN BOLÍVAR,006,SAN VICENTE DE MELONES,3,34,23,11,3
DURANGO,10,GENERAL SIMÓN BOLÍVAR,006,SANTA ROSA,3,46,23,23,4
DURANGO,10,GENERAL SIMÓN BOLÍVAR,006,SANTA ROSALÍA,2,27,17,10,2
DURANGO,10,GENERAL SIMÓN BOLÍVAR,006,SOMBRERETILLO DEL ALTO,2,35,15,20,3
DURANGO,10,GÓMEZ PALACIO,007,AMÉRICA UNO,2,57,28,29,4
DURANGO,10,GÓMEZ PALACIO,007,AQUILES SERDÁN,2,26,13,13,2
DURANGO,10,GÓMEZ PALACIO,007,ARCINAS,5,410,208,202,22
DURANGO,10,GÓMEZ PALACIO,007,ARTURO MARTÍNEZ ADAME,6,896,464,432,70
DURANGO,10,GÓMEZ PALACIO,007,BELLA UNIÓN,2,19,9,10,2
DURANGO,10,GÓMEZ PALACIO,007,BERLÍN,1,33,17,16,1
DURANGO,10,GÓMEZ PALACIO,007,BRITTINGHAM,3,108,58,50,6
DURANGO,10,GÓMEZ PALACIO,007,BUCARELI,2,57,21,36,4
DURANGO,10,GÓMEZ PALACIO,007,BUENDÍA,1,42,22,20,2
DURANGO,10,GÓMEZ PALACIO,007,CALIFORNIA,3,268,121,147,23
DURANGO,10,GÓMEZ PALACIO,007,CHIHUAHUITA (CHIHUAHUITA VIEJO),2,53,34,19,3
DURANGO,10,GÓMEZ PALACIO,007,COLONIA AGRÍCOLA BUENDÍA,2,126,60,66,7
DURANGO,10,GÓMEZ PALACIO,007,COLONIA AGRÍCOLA LA POPULAR,1,25,12,13,2
DURANGO,10,GÓMEZ PALACIO,007,CUATRO DE DICIEMBRE (SAGUNDO),2,38,12,26,3
DURANGO,10,GÓMEZ PALACIO,007,DINAMITA,7,1594,438,1156,55
DURANGO,10,GÓMEZ PALACIO,007,EL BARRO,2,116,55,61,8
DURANGO,10,GÓMEZ PALACIO,007,EL BARRO 33 (EL TREINTA Y TRES),2,23,7,16,3
DURANGO,10,GÓMEZ PALACIO,007,EL CARIÑO,3,103,47,56,7
DURANGO,10,GÓMEZ PALACIO,007,EL CASTILLO,3,160,83,77,10
DURANGO,10,GÓMEZ PALACIO,007,EL COMPÁS,1,162,77,85,6
DURANGO,10,GÓMEZ PALACIO,007,EL CONSUELO,2,51,21,30,4
DURANGO,10,GÓMEZ PALACIO,007,EL PARAÍSO,3,59,29,30,4
DURANGO,10,GÓMEZ PALACIO,007,EL QUEMADO,2,146,81,65,8
DURANGO,10,GÓMEZ PALACIO,007,EL RECUERDO,2,47,31,16,3
DURANGO,10,GÓMEZ PALACIO,007,EL RETOÑO,2,63,21,42,5
DURANGO,10,GÓMEZ PALACIO,007,EL TRIUNFO,2,36,15,21,3
DURANGO,10,GÓMEZ PALACIO,007,EL VALLE DE EUREKA,3,147,66,81,9
DURANGO,10,GÓMEZ PALACIO,007,EL VERGEL,6,2789,1404,1385,142
DURANGO,10,GÓMEZ PALACIO,007,EL VERGELITO,2,159,82,77,8
DURANGO,10,GÓMEZ PALACIO,007,ELVIRA [GRANJA],2,37,19,18,3
DURANGO,10,GÓMEZ PALACIO,007,ESMERALDA,4,561,272,289,41
DURANGO,10,GÓMEZ PALACIO,007,ESTACIÓN NOÉ,2,148,72,76,9
DURANGO,10,GÓMEZ PALACIO,007,ESTACIÓN VIÑEDO,2,145,63,82,8
DURANGO,10,GÓMEZ PALACIO,007,EUREKA DE MEDIA LUNA (EUREKA),3,210,114,96,10
DURANGO,10,GÓMEZ PALACIO,007,GLORIETA,2,89,30,59,5
DURANGO,10,GÓMEZ PALACIO,007,GÓMEZ PALACIO,396,81251,41821,39430,5381
DURANGO,10,GÓMEZ PALACIO,007,HUITRÓN,4,370,186,184,19
DURANGO,10,GÓMEZ PALACIO,007,INDEPENDENCIA,1,12,7,5,1
DURANGO,10,GÓMEZ PALACIO,007,JERUSALEM,2,45,19,26,3
DURANGO,10,GÓMEZ PALACIO,007,JIMÉNEZ (JIMÉNEZ UNO),3,268,127,141,15
DURANGO,10,GÓMEZ PALACIO,007,JOLO [PROPIEDAD PRIVADA],2,82,38,44,4
DURANGO,10,GÓMEZ PALACIO,007,JOSÉ MARÍA MORELOS Y PAVÓN,3,68,29,39,4
DURANGO,10,GÓMEZ PALACIO,007,LA AURORA,4,163,73,90,10
DURANGO,10,GÓMEZ PALACIO,007,LA COMPETENCIA,2,77,39,38,4
DURANGO,10,GÓMEZ PALACIO,007,LA FLOR,5,355,169,186,21
DURANGO,10,GÓMEZ PALACIO,007,LA FORTUNA,2,36,19,17,3
DURANGO,10,GÓMEZ PALACIO,007,LA JARITA,1,4,2,2,1
DURANGO,10,GÓMEZ PALACIO,007,LA LUZ,4,298,152,146,15
DURANGO,10,GÓMEZ PALACIO,007,LA PLATA,3,77,36,41,5
DURANGO,10,GÓMEZ PALACIO,007,LA POPULAR,6,849,427,422,41
DURANGO,10,GÓMEZ PALACIO,007,LA TEHUA,2,142,55,87,8
DURANGO,10,GÓMEZ PALACIO,007,LAS LECHUZAS (LAS BRUJAS),2,70,32,38,4
DURANGO,10,GÓMEZ PALACIO,007,LAS MACITAS,2,40,21,19,3
DURANGO,10,GÓMEZ PALACIO,007,LAS PLAYAS,2,29,11,18,2
DURANGO,10,GÓMEZ PALACIO,007,LÁZARO CÁRDENAS,2,33,18,15,2
DURANGO,10,GÓMEZ PALACIO,007,LOS ÁNGELES,2,34,15,19,3
DURANGO,10,GÓMEZ PALACIO,007,MANILA,3,92,49,43,6
DURANGO,10,GÓMEZ PALACIO,007,MARÍA ANTONIETA,2,54,30,24,3
DURANGO,10,GÓMEZ PALACIO,007,NOÉ,4,209,106,103,12
DURANGO,10,GÓMEZ PALACIO,007,NUEVO BARRO,1,11,6,5,1
DURANGO,10,GÓMEZ PALACIO,007,NUEVO GÓMEZ,1,13,9,4,1
DURANGO,10,GÓMEZ PALACIO,007,NUMANCIA,2,60,36,24,3
DURANGO,10,GÓMEZ PALACIO,007,PASTOR ROUAIX,4,618,293,325,29
DURANGO,10,GÓMEZ PALACIO,007,PASTOR ROUAIX (JABONCILLO),1,18,7,11,2
DURANGO,10,GÓMEZ PALACIO,007,PASTOR ROUAIX (PÉNJAMO),1,9,4,5,1
DURANGO,10,GÓMEZ PALACIO,007,POANAS,3,69,40,29,4
DURANGO,10,GÓMEZ PALACIO,007,PROVIDENCIA,1,39,21,18,2
DURANGO,10,GÓMEZ PALACIO,007,PUENTE DE LA TORREÑA,2,218,111,107,9
DURANGO,10,GÓMEZ PALACIO,007,REFORMA,2,70,32,38,4
DURANGO,10,GÓMEZ PALACIO,007,RINCÓN DE SANTA CRUZ,2,79,38,41,4
DURANGO,10,GÓMEZ PALACIO,007,RINCONADA,2,49,26,23,3
DURANGO,10,GÓMEZ PALACIO,007,SAN ALBERTO,3,166,86,80,11
DURANGO,10,GÓMEZ PALACIO,007,SAN FELIPE,6,1134,576,558,73
DURANGO,10,GÓMEZ PALACIO,007,SAN JOSÉ DE VIÑEDO,4,397,206,191,18
DURANGO,10,GÓMEZ PALACIO,007,SAN ROQUE,2,21,10,11,2
DURANGO,10,GÓMEZ PALACIO,007,SAN SEBASTIÁN,3,191,87,104,10
DURANGO,10,GÓMEZ PALACIO,007,SANTA CLARA,2,72,34,38,5
DURANGO,10,GÓMEZ PALACIO,007,SANTA CRUZ LUJÁN,3,437,217,220,28
DURANGO,10,GÓMEZ PALACIO,007,SEIS DE OCTUBRE,5,591,286,305,70
DURANGO,10,GÓMEZ PALACIO,007,TAJO VIEJO,1,8,4,4,1
DURANGO,10,GÓMEZ PALACIO,007,TRANSPORTE,4,617,307,310,38
DURANGO,10,GÓMEZ PALACIO,007,VENECIA,6,927,373,554,102
DURANGO,10,GÓMEZ PALACIO,007,VICENTE NAVA,2,131,66,65,7
DURANGO,10,GÓMEZ PALACIO,007,VILLA GREGORIO GARCÍA,4,1197,646,551,67
DURANGO,10,GUADALUPE VICTORIA,008,ANTONIO AMARO (SAUCILLO),5,860,444,416,57
DURANGO,10,GUADALUPE VICTORIA,008,CARBONERAS,2,4,2,2,2
DURANGO,10,GUADALUPE VICTORIA,008,DOS DE ABRIL,3,81,40,41,6
DURANGO,10,GUADALUPE VICTORIA,008,FELIPE CARRILLO PUERTO (TARABILLAS),5,440,221,219,24
DURANGO,10,GUADALUPE VICTORIA,008,GENERAL ÁLVARO OBREGÓN,3,50,28,22,4
DURANGO,10,GUADALUPE VICTORIA,008,GENERAL CALIXTO CONTRERAS (COLORADA),5,493,239,254,27
DURANGO,10,GUADALUPE VICTORIA,008,GUADALUPE VICTORIA,27,5535,2794,2741,359
DURANGO,10,GUADALUPE VICTORIA,008,IGNACIO ALLENDE,6,552,271,281,35
DURANGO,10,GUADALUPE VICTORIA,008,IGNACIO RAMÍREZ,6,476,234,242,34
DURANGO,10,GUADALUPE VICTORIA,008,JOSÉ GUADALUPE RODRÍGUEZ (PEÑUELAS),4,252,115,137,16
DURANGO,10,GUADALUPE VICTORIA,008,JOSÉ MARÍA PINO SUÁREZ (PROVIDENCIA),3,74,39,35,7
DURANGO,10,GUADALUPE VICTORIA,008,JUAN ALDAMA (MAGUEYES),3,110,51,59,6
DURANGO,10,GUADALUPE VICTORIA,008,SAN FRANCISCO DE LA PALMITA (LA PALMITA),2,26,13,13,2
DURANGO,10,GUADALUPE VICTORIA,008,SANTA CATALINA DE SIENA,4,109,63,46,8
DURANGO,10,GUANACEVÍ,009,AGUA CALIENTE,2,45,23,22,3
DURANGO,10,GUANACEVÍ,009,ARROYO DE LAJAS (LAJAS),3,156,71,85,11
DURANGO,10,GUANACEVÍ,009,ARROYO DEL HACHO (LA CRUZ),1,8,6,2,1
DURANGO,10,GUANACEVÍ,009,BIOGAME,3,22,13,9,3
DURANGO,10,GUANACEVÍ,009,BOLERAS,2,21,9,12,2
DURANGO,10,GUANACEVÍ,009,CEBOLLAS,2,4,2,2,1
DURANGO,10,GUANACEVÍ,009,CENDRADILLAS,1,8,3,5,1
DURANGO,10,GUANACEVÍ,009,CHIQUEROS,1,7,3,4,1
DURANGO,10,GUANACEVÍ,009,CIÉNEGA DE LA VACA,3,51,26,25,4
DURANGO,10,GUANACEVÍ,009,CIÉNEGA DE QUELITES (QUELITES),2,6,2,4,1
DURANGO,10,GUANACEVÍ,009,CIÉNEGA PRIETA,3,48,31,17,3
DURANGO,10,GUANACEVÍ,009,COSCOMATE,2,30,8,22,3
DURANGO,10,GUANACEVÍ,009,EL ALAMILLO,2,5,2,3,1
DURANGO,10,GUANACEVÍ,009,EL BARRO,2,23,10,13,2
DURANGO,10,GUANACEVÍ,009,EL CEBOLLÍN,2,30,13,17,2
DURANGO,10,GUANACEVÍ,009,EL CEDRO,2,19,10,9,2
DURANGO,10,GUANACEVÍ,009,EL CÓCONO,2,17,10,7,2
DURANGO,10,GUANACEVÍ,009,EL PALOMO,1,4,3,1,1
DURANGO,10,GUANACEVÍ,009,EL POTRERO VIEJO,2,5,1,4,1
DURANGO,10,GUANACEVÍ,009,EL SALITRE,2,20,6,14,2
DURANGO,10,GUANACEVÍ,009,EL ZAPE,3,88,41,47,9
DURANGO,10,GUANACEVÍ,009,EL ZORRILLO,1,6,4,2,1
DURANGO,10,GUANACEVÍ,009,ESCOBAR Y ANEXOS,2,25,11,14,2
DURANGO,10,GUANACEVÍ,009,GUANACEVÍ,6,1292,667,625,62
DURANGO,10,GUANACEVÍ,009,JOSÉ MARÍA MORELOS,3,48,23,25,4
DURANGO,10,GUANACEVÍ,009,LA LAGUNITA,3,35,15,20,3
DURANGO,10,GUANACEVÍ,009,LA QUEBRADA,2,9,6,3,1
DURANGO,10,GUANACEVÍ,009,LA ROSILLA,4,94,54,40,6
DURANGO,10,GUANACEVÍ,009,LAGUNA SECA (LAS MANGAS),3,21,6,15,3
DURANGO,10,GUANACEVÍ,009,LAJAS,1,56,35,21,3
DURANGO,10,GUANACEVÍ,009,LAS ADJUNTAS,2,10,9,1,2
DURANGO,10,GUANACEVÍ,009,LAS POMAS,3,40,25,15,3
DURANGO,10,GUANACEVÍ,009,LLANO GRANDE,1,24,11,13,2
DURANGO,10,GUANACEVÍ,009,LOS NOPALES,1,14,9,5,1
DURANGO,10,GUANACEVÍ,009,PIEDRA BOLA,1,4,3,1,1
DURANGO,10,GUANACEVÍ,009,POSTA DE JIHUITES,3,32,12,20,4
DURANGO,10,GUANACEVÍ,009,RANCHO NUEVO,2,8,3,5,2
DURANGO,10,GUANACEVÍ,009,RINCÓN DEL BAJÍO (RINCÓN DE CEBOLLAS),3,9,3,6,2
DURANGO,10,GUANACEVÍ,009,SALSIPUEDES,2,4,2,2,2
DURANGO,10,GUANACEVÍ,009,SAN FRANCISCO,1,11,6,5,1
DURANGO,10,GUANACEVÍ,009,SAN FRANCISCO DE LOS CANO,3,47,19,28,4
DURANGO,10,GUANACEVÍ,009,SAN FRANCISCO DE LOS REMEDIOS (LAS PINTAS),2,29,15,14,2
DURANGO,10,GUANACEVÍ,009,SAN PEDRO,3,40,19,21,4
DURANGO,10,GUANACEVÍ,009,ZAPE CHICO,1,6,4,2,1
DURANGO,10,HIDALGO,010,BENJAMÍN Y URÍAS (SAN ANDRÉS),2,52,30,22,5
DURANGO,10,HIDALGO,010,EL ENTRONQUE DEL CARRIZO,2,16,9,7,2
DURANGO,10,HIDALGO,010,IGNACIO VALENCIA (LOS ALAMITOS),3,65,29,36,6
DURANGO,10,HIDALGO,010,LA ESPERANZA,2,15,4,11,2
DURANGO,10,HIDALGO,010,LA ZARCA,4,201,115,86,10
DURANGO,10,HIDALGO,010,LAS PLAYAS,3,27,10,17,3
DURANGO,10,HIDALGO,010,REVOLUCIÓN (LAS VÍBORAS),4,236,120,116,18
DURANGO,10,HIDALGO,010,ROMÁN ARREOLA (LA MIMBRERA),1,3,1,2,1
DURANGO,10,HIDALGO,010,SAN BERNARDO (NUEVO SAN BERNARDO),3,36,20,16,4
DURANGO,10,HIDALGO,010,SAN FERMÍN,2,41,11,30,4
DURANGO,10,HIDALGO,010,VILLA HIDALGO,4,194,106,88,67
DURANGO,10,HIDALGO,010,VILLA UNIÓN DE MUÑOZ (VILLA UNIÓN),3,27,14,13,3
DURANGO,10,INDÉ,011,BUENOS AIRES (CHAPARRIENTAS),2,29,12,17,3
DURANGO,10,INDÉ,011,EL PALMITO,3,75,34,41,5
DURANGO,10,INDÉ,011,EL TORREÓN DE SAN ISIDRO,1,12,4,8,1
DURANGO,10,INDÉ,011,IGNACIO ALLENDE (LOS ALLENDES),1,14,7,7,1
DURANGO,10,INDÉ,011,INDÉ,4,339,181,158,21
DURANGO,10,INDÉ,011,LA GALLEGA,2,18,8,10,2
DURANGO,10,INDÉ,011,LA LOMA,1,18,9,9,1
DURANGO,10,INDÉ,011,LA PASTORÍA,2,18,9,9,2
DURANGO,10,INDÉ,011,LA PUERTA DE CABRERA (COLONIA AGRÍCOLA J. AGUIRRE),3,55,27,28,5
DURANGO,10,INDÉ,011,LA TRINIDAD,2,40,21,19,3
DURANGO,10,INDÉ,011,LA VICTORIA,1,14,7,7,1
DURANGO,10,INDÉ,011,LAS DELICIAS,3,108,52,56,6
DURANGO,10,INDÉ,011,LOS MACHOS,1,16,9,7,1
DURANGO,10,INDÉ,011,LOS ZARQUEÑOS,3,33,17,16,3
DURANGO,10,INDÉ,011,POTRERO DEL LLANO (BOQUILLA DEL MUERTO),3,51,26,25,5
DURANGO,10,INDÉ,011,RANCHO DE PEÑA,2,44,27,17,4
DURANGO,10,INDÉ,011,RANCHO NUEVO,2,30,15,15,3
DURANGO,10,INDÉ,011,SAN CRISTÓBAL,1,16,8,8,1
DURANGO,10,INDÉ,011,SAN FRANCISCO DE ASÍS,4,131,65,66,8
DURANGO,10,INDÉ,011,SAN JOSÉ DE LOS PICACHOS,1,17,7,10,1
DURANGO,10,INDÉ,011,SAN JOSÉ DEL PRADO,1,15,12,3,1
DURANGO,10,INDÉ,011,SAN JOSÉ DEL TIZONAZO (EL PUEBLO),2,78,38,40,6
DURANGO,10,INDÉ,011,SAN RAFAEL DE JICORICA,3,32,16,16,3
DURANGO,10,LERDO,012,ÁLVARO OBREGÓN,4,805,393,412,45
DURANGO,10,LERDO,012,CARLOS REAL (SAN CARLOS),3,305,135,170,15
DURANGO,10,LERDO,012,CIUDAD JUÁREZ,8,2029,1018,1011,139
DURANGO,10,LERDO,012,DOLORES (LA BORREGA),3,96,46,50,5
DURANGO,10,LERDO,012,EJIDO 21 DE MARZO,4,338,156,182,16
DURANGO,10,LERDO,012,EL HUARACHE (EL GUARACHE),2,197,97,100,8
DURANGO,10,LERDO,012,EL RANCHITO,2,18,10,8,2
DURANGO,10,LERDO,012,EL RAYO,2,147,79,68,8
DURANGO,10,LERDO,012,EL REFUGIO,2,25,15,10,2
DURANGO,10,LERDO,012,EL SACRIFICIO,1,19,9,10,2
DURANGO,10,LERDO,012,ESTACIÓN RÍO NAZAS,3,498,250,248,20
DURANGO,10,LERDO,012,FORTUNA DE RANCHO GÜERO,2,25,13,12,2
DURANGO,10,LERDO,012,FRANCISCO VILLA (PANCHO VILLA),2,28,19,9,2
DURANGO,10,LERDO,012,JAVIER ROJO GÓMEZ (LA ESPERANZA),3,22,12,10,3
DURANGO,10,LERDO,012,JUAN E. GARCÍA,4,880,448,432,48
DURANGO,10,LERDO,012,JUAN JOSÉ ROJAS,2,78,37,41,4
DURANGO,10,LERDO,012,LA CAMPANA,2,45,19,26,3
DURANGO,10,LERDO,012,LA GOLETA,2,35,16,19,3
DURANGO,10,LERDO,012,LA GOMA,2,235,126,109,12
DURANGO,10,LERDO,012,LA LOMA,5,1161,569,592,57
DURANGO,10,LERDO,012,LA LUZ,4,458,236,222,22
DURANGO,10,LERDO,012,LA MINA (EL SARNOSO),3,74,30,44,6
DURANGO,10,LERDO,012,LA UNIÓN,3,97,44,53,5
DURANGO,10,LERDO,012,LAS CUEVAS,2,209,104,105,8
DURANGO,10,LERDO,012,LAS ISABELES,2,59,27,32,5
DURANGO,10,LERDO,012,LAS PIEDRAS,2,89,49,40,4
DURANGO,10,LERDO,012,LEÓN GUZMÁN,6,1446,693,753,123
DURANGO,10,LERDO,012,LERDO,123,26847,13301,13546,1750
DURANGO,10,LERDO,012,LOS ÁNGELES,3,293,136,157,14
DURANGO,10,LERDO,012,MARGARITO MACHADO (PALOMAS),3,96,45,51,5
DURANGO,10,LERDO,012,MONTERREY,3,152,67,85,8
DURANGO,10,LERDO,012,NAZARENO,8,2339,1203,1136,123
DURANGO,10,LERDO,012,NAZARENO DE ABAJO,3,196,106,90,8
DURANGO,10,LERDO,012,NAZARENO II (NAZARENO DE ARRIBA),2,31,12,19,2
DURANGO,10,LERDO,012,NUEVO GRASEROS,3,228,101,127,11
DURANGO,10,LERDO,012,PICARDÍAS,4,492,261,231,59
DURANGO,10,LERDO,012,PUENTE DE LA TORREÑA (EL CAPRICHO),2,55,31,24,3
DURANGO,10,LERDO,012,SALAMANCA,2,156,75,81,8
DURANGO,10,LERDO,012,SAN ANTONIO (LA HORTALIZA),1,24,11,13,2
DURANGO,10,LERDO,012,SAN GERARDO,1,18,9,9,2
DURANGO,10,LERDO,012,SAN JACINTO,2,236,104,132,12
DURANGO,10,LERDO,012,SAN LUIS DEL ALTO,2,53,27,26,3
DURANGO,10,LERDO,012,SAN NICOLÁS,1,15,6,9,1
DURANGO,10,LERDO,012,SANTA ANITA,3,43,16,27,4
DURANGO,10,LERDO,012,SAPIORIS,2,308,148,160,16
DURANGO,10,LERDO,012,SEIS DE ENERO,3,355,173,182,21
DURANGO,10,LERDO,012,VICENTE NAVA (LA GOMITA),1,21,8,13,2
DURANGO,10,LERDO,012,VICENTE SUÁREZ,3,88,43,45,5
DURANGO,10,LERDO,012,VILLA DE GUADALUPE,3,448,201,247,19
DURANGO,10,MAPIMÍ,013,BERMEJILLO,13,2595,1281,1314,177
DURANGO,10,MAPIMÍ,013,BUEN DÍA,1,6,3,3,1
DURANGO,10,MAPIMÍ,013,CEBALLOS,6,1142,572,570,55
DURANGO,10,MAPIMÍ,013,EL DIAMANTE,3,38,20,18,3
DURANGO,10,MAPIMÍ,013,EL MIXTECO (SPR LÁZARO CÁRDENAS),2,26,15,11,2
DURANGO,10,MAPIMÍ,013,EL VEINTICUATRO,3,40,18,22,4
DURANGO,10,MAPIMÍ,013,EMILIANO ZAPATA (EL DERRAME),2,21,11,10,2
DURANGO,10,MAPIMÍ,013,EMILIANO ZAPATA (EL SETENTA),1,30,12,18,2
DURANGO,10,MAPIMÍ,013,ESTACIÓN YERMO,2,30,16,14,2
DURANGO,10,MAPIMÍ,013,FRANCISCO MONTES DE OCA (EL ZORRILLO),1,6,3,3,1
DURANGO,10,MAPIMÍ,013,JARALITO,3,42,21,21,4
DURANGO,10,MAPIMÍ,013,LA CADENA,1,5,4,1,1
DURANGO,10,MAPIMÍ,013,LA ESPERANZA (PALOMAS),2,51,29,22,3
DURANGO,10,MAPIMÍ,013,LAS MARÍAS,3,72,37,35,4
DURANGO,10,MAPIMÍ,013,LINDAVISTA (BALTAZAR) [PROPIEDAD PRIVADA],1,7,5,2,1
DURANGO,10,MAPIMÍ,013,MAPIMÍ,8,1790,933,857,89
DURANGO,10,MAPIMÍ,013,MARTHA,4,367,195,172,19
DURANGO,10,MAPIMÍ,013,NUEVA ESTRELLA,1,7,4,3,1
DURANGO,10,MAPIMÍ,013,SAN AGUSTÍN,3,26,11,15,3
DURANGO,10,MAPIMÍ,013,SAN ISIDRO DE YERMO,1,8,5,3,1
DURANGO,10,MAPIMÍ,013,SAN ISIDRO DEL DERRAME,3,33,15,18,3
DURANGO,10,MAPIMÍ,013,SAN JOSÉ DE BELLAVISTA,3,107,47,60,7
DURANGO,10,MAPIMÍ,013,SAN JUAN DE CAÑITAS,3,88,43,45,5
DURANGO,10,MAPIMÍ,013,SAN MARTÍN,3,26,14,12,3
DURANGO,10,MAPIMÍ,013,SANTA ELENA,3,28,10,18,3
DURANGO,10,MAPIMÍ,013,SANTA INÉS,1,9,4,5,1
DURANGO,10,MAPIMÍ,013,SANTA MARÍA DE LA PAZ (VIEJO),3,28,16,12,3
DURANGO,10,MAPIMÍ,013,TREINTA DE NOVIEMBRE,3,37,21,16,3
DURANGO,10,MAPIMÍ,013,VEINTIDÓS DE FEBRERO,4,232,103,129,14
DURANGO,10,MAPIMÍ,013,VENUSTIANO CARRANZA (EL SEIS),3,17,6,11,3
DURANGO,10,MEZQUITAL,014,AGUA CALIENTE,2,39,17,22,3
DURANGO,10,MEZQUITAL,014,AGUA FRÍA,3,54,17,37,4
DURANGO,10,MEZQUITAL,014,AGUA PRIETA,3,85,48,37,5
DURANGO,10,MEZQUITAL,014,AGUA VERDE,2,41,18,23,2
DURANGO,10,MEZQUITAL,014,AGUA ZARCA,2,12,7,5,2
DURANGO,10,MEZQUITAL,014,AGÜITA ZARCA,4,105,59,46,5
DURANGO,10,MEZQUITAL,014,ALAMITOS,2,18,6,12,2
DURANGO,10,MEZQUITAL,014,ARROYO HONDO,3,51,28,23,3
DURANGO,10,MEZQUITAL,014,BAJÍO DE CARRIZALES,3,44,24,20,5
DURANGO,10,MEZQUITAL,014,BAJÍO DE LA CHINA,4,60,29,31,4
DURANGO,10,MEZQUITAL,014,BAJÍO DE MILPILLAS (TIERRA SONANDO),1,11,5,6,1
DURANGO,10,MEZQUITAL,014,BAJÍO DEL COMAL,3,38,15,23,4
DURANGO,10,MEZQUITAL,014,BAJÍO DEL LLANO (CHICHOKTAM),3,23,9,14,3
DURANGO,10,MEZQUITAL,014,BANCO DE PINOS ALTOS,2,25,9,16,2
DURANGO,10,MEZQUITAL,014,BANCOS DE CALITIQUE,5,442,205,237,21
DURANGO,10,MEZQUITAL,014,BRASILES,3,91,49,42,5
DURANGO,10,MEZQUITAL,014,BUENA VISTA,1,29,18,11,1
DURANGO,10,MEZQUITAL,014,BUENAVISTA (LOS CHAPOTES),3,25,13,12,4
DURANGO,10,MEZQUITAL,014,CACHANTITA,2,85,43,42,5
DURANGO,10,MEZQUITAL,014,CALITIQUE,1,22,13,9,1
DURANGO,10,MEZQUITAL,014,CAMPAMENTO CANOAS,2,133,74,59,6
DURANGO,10,MEZQUITAL,014,CANDELARIA DEL ALTO,3,174,104,70,9
DURANGO,10,MEZQUITAL,014,CANDELARITA,5,94,50,44,8
DURANGO,10,MEZQUITAL,014,CANOAS,1,140,81,59,5
DURANGO,10,MEZQUITAL,014,CANOAS 3,1,20,9,11,1
DURANGO,10,MEZQUITAL,014,CANOÍTAS (CANOAS DOS),6,280,138,142,18
DURANGO,10,MEZQUITAL,014,CARDOSANTO,1,6,3,3,1
DURANGO,10,MEZQUITAL,014,CARRIZOS,1,8,5,3,1
DURANGO,10,MEZQUITAL,014,CEBOLLAS 3,2,19,8,11,2
DURANGO,10,MEZQUITAL,014,CEBOLLITAS,2,199,116,83,10
DURANGO,10,MEZQUITAL,014,CEJA DE CEBOLLETA,2,144,71,73,8
DURANGO,10,MEZQUITAL,014,CEJA DE LOS CUERVOS,1,43,20,23,1
DURANGO,10,MEZQUITAL,014,CERRITO GORDO,5,261,125,136,18
DURANGO,10,MEZQUITAL,014,CERRO AMARILLO,1,8,3,5,1
DURANGO,10,MEZQUITAL,014,CERRO BLANCO,3,54,31,23,3
DURANGO,10,MEZQUITAL,014,CERRO BOLILLO,2,11,5,6,2
DURANGO,10,MEZQUITAL,014,CERRO DE LAS PAPAS,3,98,50,48,5
DURANGO,10,MEZQUITAL,014,CERRO DEL GUAMÚCHIL,2,36,18,18,2
DURANGO,10,MEZQUITAL,014,CERRO LAS PALOMAS,3,20,11,9,3
DURANGO,10,MEZQUITAL,014,CERRO PELÓN,1,25,10,15,1
DURANGO,10,MEZQUITAL,014,CERRO VERDE,3,88,38,50,4
DURANGO,10,MEZQUITAL,014,CERROS JUNTOS,1,7,3,4,1
DURANGO,10,MEZQUITAL,014,CHACHACUAXTLE,2,8,1,7,1
DURANGO,10,MEZQUITAL,014,CHALATE 2,2,28,13,15,2
DURANGO,10,MEZQUITAL,014,CHALATES,1,26,16,10,2
DURANGO,10,MEZQUITAL,014,CHALCHIHUITILLO,4,168,93,75,10
DURANGO,10,MEZQUITAL,014,CHARCO LARGO,2,15,10,5,2
DURANGO,10,MEZQUITAL,014,CHICALTITA,3,97,40,57,6
DURANGO,10,MEZQUITAL,014,CHILAPA,2,49,30,19,3
DURANGO,10,MEZQUITAL,014,CHIMALTITA,2,27,15,12,2
DURANGO,10,MEZQUITAL,014,CIÉNEGA DE MIRASOLES,2,47,27,20,2
DURANGO,10,MEZQUITAL,014,CIÉNEGA DEL OSO,6,235,116,119,12
DURANGO,10,MEZQUITAL,014,CIÉNEGA DEL ZANCUDO UNO,3,63,28,35,6
DURANGO,10,MEZQUITAL,014,CIHUACORA,3,69,30,39,4
DURANGO,10,MEZQUITAL,014,COFRADÍA,2,25,16,9,2
DURANGO,10,MEZQUITAL,014,CONEJOS,1,30,17,13,2
DURANGO,10,MEZQUITAL,014,CONEJOS (EL LLANO),2,22,13,9,2
DURANGO,10,MEZQUITAL,014,CORDÓN DE BUENAVISTA (EL CORDÓN),3,32,18,14,3
DURANGO,10,MEZQUITAL,014,CORPUS,2,33,12,21,3
DURANGO,10,MEZQUITAL,014,CUESTA BLANCA (AGÜITA ESCONDIDA),2,23,12,11,2
DURANGO,10,MEZQUITAL,014,CUEVA MOLIDA (LA CUEVA),1,11,5,6,1
DURANGO,10,MEZQUITAL,014,CURACHITOS (BUENA VISTA),5,222,101,121,12
DURANGO,10,MEZQUITAL,014,EL CAPULLO,3,34,16,18,4
DURANGO,10,MEZQUITAL,014,EL CARRIZAL,4,32,15,17,4
DURANGO,10,MEZQUITAL,014,EL CARRIZALILLO,2,28,11,17,2
DURANGO,10,MEZQUITAL,014,EL CARRIZO,1,25,9,16,1
DURANGO,10,MEZQUITAL,014,EL CHALATE,3,23,11,12,3
DURANGO,10,MEZQUITAL,014,EL CHAPULÍN,3,68,32,36,4
DURANGO,10,MEZQUITAL,014,EL CHARCO VERDE,3,38,18,20,3
DURANGO,10,MEZQUITAL,014,EL DURAZNO (DURAZNITOS),5,213,109,104,11
DURANGO,10,MEZQUITAL,014,EL GALLO,3,41,15,26,4
DURANGO,10,MEZQUITAL,014,EL GUAYABITO,1,5,2,3,1
DURANGO,10,MEZQUITAL,014,EL LLANO,3,18,11,7,3
DURANGO,10,MEZQUITAL,014,EL MAGUEY,2,105,55,50,5
DURANGO,10,MEZQUITAL,014,EL PATIO,3,28,15,13,4
DURANGO,10,MEZQUITAL,014,EL POTRERO,3,117,55,62,7
DURANGO,10,MEZQUITAL,014,EL RANCHITO DE LA MESA,2,12,5,7,2
DURANGO,10,MEZQUITAL,014,EL REFUGIO,2,21,11,10,2
DURANGO,10,MEZQUITAL,014,EL RINCÓN,2,22,10,12,3
DURANGO,10,MEZQUITAL,014,EL RINCÓN (TRONCONES),2,29,16,13,3
DURANGO,10,MEZQUITAL,014,EL SALITRE,3,5,4,1,2
DURANGO,10,MEZQUITAL,014,EL SAUCITO,2,27,15,12,2
DURANGO,10,MEZQUITAL,014,EL TAMBOR,2,28,12,16,3
DURANGO,10,MEZQUITAL,014,EL TRONCÓN,2,137,67,70,8
DURANGO,10,MEZQUITAL,014,EL VENADO,2,21,14,7,2
DURANGO,10,MEZQUITAL,014,EL ZANCUDO UNO,2,24,14,10,2
DURANGO,10,MEZQUITAL,014,FLOR DE MAYO,1,15,11,4,1
DURANGO,10,MEZQUITAL,014,FLORES CHINA,1,10,7,3,1
DURANGO,10,MEZQUITAL,014,FORTINES (LOS FORTINES),3,108,55,53,5
DURANGO,10,MEZQUITAL,014,GAVILANES,2,95,46,49,7
DURANGO,10,MEZQUITAL,014,GUAMÚCHIL,1,33,11,22,2
DURANGO,10,MEZQUITAL,014,HUAZAMOTA,6,593,313,280,37
DURANGO,10,MEZQUITAL,014,HUAZAMOTITA,2,69,36,33,3
DURANGO,10,MEZQUITAL,014,JABALÍES,3,39,17,22,3
DURANGO,10,MEZQUITAL,014,JOYAS DE GUAMÚCHIL,2,9,6,3,1
DURANGO,10,MEZQUITAL,014,LA ARENA,3,30,15,15,3
DURANGO,10,MEZQUITAL,014,LA AVISPA,2,23,13,10,2
DURANGO,10,MEZQUITAL,014,LA CAMPANA,3,40,18,22,4
DURANGO,10,MEZQUITAL,014,LA CANDELARIA,2,203,88,115,10
DURANGO,10,MEZQUITAL,014,LA CHÍA,2,10,5,5,2
DURANGO,10,MEZQUITAL,014,LA CIÉNEGA,3,58,34,24,4
DURANGO,10,MEZQUITAL,014,LA COFRADÍA,4,77,29,48,6
DURANGO,10,MEZQUITAL,014,LA CUEVA,2,15,6,9,2
DURANGO,10,MEZQUITAL,014,LA CURVA DEL DURAZNO,2,7,3,4,1
DURANGO,10,MEZQUITAL,014,LA ESCALERA,3,19,11,8,3
DURANGO,10,MEZQUITAL,014,LA ESCONDIDA,1,9,7,2,1
DURANGO,10,MEZQUITAL,014,LA ESTANCIA,2,37,22,15,2
DURANGO,10,MEZQUITAL,014,LA FRENTE,1,5,2,3,1
DURANGO,10,MEZQUITAL,014,LA GLORIA (CANOAS),1,165,82,83,7
DURANGO,10,MEZQUITAL,014,LA GUACAMAYA,3,36,20,16,4
DURANGO,10,MEZQUITAL,014,LA GUACAMAYITA,5,252,136,116,14
DURANGO,10,MEZQUITAL,014,LA GUAJOLOTA,6,1254,676,578,74
DURANGO,10,MEZQUITAL,014,LA HACIENDA,3,38,17,21,3
DURANGO,10,MEZQUITAL,014,LA JOYA,1,9,7,2,1
DURANGO,10,MEZQUITAL,014,LA JOYA DE ATOTONILCO (ATOTONILCO),2,20,5,15,2
DURANGO,10,MEZQUITAL,014,LA JOYA DE LOS CARRIZOS,3,25,9,16,3
DURANGO,10,MEZQUITAL,014,LA JOYA DEL AGOSTADERO,1,4,3,1,1
DURANGO,10,MEZQUITAL,014,LA JOYITA ESCONDIDA,1,29,16,13,1
DURANGO,10,MEZQUITAL,014,LA LAGUNA,6,65,31,34,6
DURANGO,10,MEZQUITAL,014,LA MESA,1,54,28,26,3
DURANGO,10,MEZQUITAL,014,LA MESA DE LA GLORIA,4,97,47,50,5
DURANGO,10,MEZQUITAL,014,LA MESA DE LA VENTANA,2,118,67,51,3
DURANGO,10,MEZQUITAL,014,LA MESA DE SAN ANTONIO,3,185,94,91,11
DURANGO,10,MEZQUITAL,014,LA MESA DE SAN BUENA (SAN BUENA),3,69,28,41,5
DURANGO,10,MEZQUITAL,014,LA MESA DEL ÁGUILA,2,36,16,20,2
DURANGO,10,MEZQUITAL,014,LA MESA DEL JABALÍ (MARRANO PARADO),2,23,14,9,2
DURANGO,10,MEZQUITAL,014,LA MESITA,3,182,92,90,10
DURANGO,10,MEZQUITAL,014,LA MURALLA,3,92,51,41,6
DURANGO,10,MEZQUITAL,014,LA NOPALERA,3,16,9,7,3
DURANGO,10,MEZQUITAL,014,LA PISTA,2,66,29,37,4
DURANGO,10,MEZQUITAL,014,LA PRESA,1,20,12,8,1
DURANGO,10,MEZQUITAL,014,LA SOLEDAD,2,43,17,26,2
DURANGO,10,MEZQUITAL,014,LA TINAJA,1,4,2,2,1
DURANGO,10,MEZQUITAL,014,LA TORRECILLA,3,105,52,53,6
DURANGO,10,MEZQUITAL,014,LA VENTANA,9,242,115,127,14
DURANGO,10,MEZQUITAL,014,LAGUNA DEL BURRO,3,76,39,37,4
DURANGO,10,MEZQUITAL,014,LAGUNA DEL CHIVO,5,303,173,130,20
DURANGO,10,MEZQUITAL,014,LAS ÁGUILAS,3,39,23,16,4
DURANGO,10,MEZQUITAL,014,LAS AGUILILLAS (EL VENADO),4,74,32,42,6
DURANGO,10,MEZQUITAL,014,LAS ANONAS,3,20,7,13,3
DURANGO,10,MEZQUITAL,014,LAS ARENAS,3,41,23,18,4
DURANGO,10,MEZQUITAL,014,LAS BOTIJAS,1,37,17,20,1
DURANGO,10,MEZQUITAL,014,LAS CABEZAS,5,39,19,20,5
DURANGO,10,MEZQUITAL,014,LAS COLORADAS,1,7,5,2,1
DURANGO,10,MEZQUITAL,014,LAS CRUCES,6,152,74,78,9
DURANGO,10,MEZQUITAL,014,LAS CUEVITAS (ENTRONQUE ALAMITOS),2,20,9,11,2
DURANGO,10,MEZQUITAL,014,LAS ENRAMADAS,2,66,34,32,4
DURANGO,10,MEZQUITAL,014,LAS ESPERANZAS,2,19,7,12,2
DURANGO,10,MEZQUITAL,014,LAS ESPINAS,4,166,77,89,8
DURANGO,10,MEZQUITAL,014,LAS FLORES,2,82,44,38,6
DURANGO,10,MEZQUITAL,014,LAS GUÁSIMAS,3,32,15,17,4
DURANGO,10,MEZQUITAL,014,LAS JOYAS,5,71,37,34,6
DURANGO,10,MEZQUITAL,014,LAS LAJAS,2,23,14,9,3
DURANGO,10,MEZQUITAL,014,LAS LECHES,2,30,17,13,3
DURANGO,10,MEZQUITAL,014,LAS LOMAS,1,11,8,3,1
DURANGO,10,MEZQUITAL,014,LAS MANZANILLAS,2,19,6,13,2
DURANGO,10,MEZQUITAL,014,LAS MARIPOSAS (LAS FLORES),3,39,24,15,3
DURANGO,10,MEZQUITAL,014,LAS MESAS,1,8,4,4,1
DURANGO,10,MEZQUITAL,014,LAS MESAS DE XOCONOXTLE,2,23,13,10,2
DURANGO,10,MEZQUITAL,014,LAS MESAS DEL BAJÍO,2,40,15,25,2
DURANGO,10,MEZQUITAL,014,LAS MILPAS,3,83,35,48,5
DURANGO,10,MEZQUITAL,014,LAS MINAS,2,13,4,9,2
DURANGO,10,MEZQUITAL,014,LAS MOJONERAS,1,3,2,1,1
DURANGO,10,MEZQUITAL,014,LAS NORIAS,3,40,20,20,3
DURANGO,10,MEZQUITAL,014,LAS OREJAS,2,25,17,8,2
DURANGO,10,MEZQUITAL,014,LAS PERAS,3,79,44,35,4
DURANGO,10,MEZQUITAL,014,LAS PILAS,3,84,48,36,5
DURANGO,10,MEZQUITAL,014,LAS RAMADAS,2,50,27,23,3
DURANGO,10,MEZQUITAL,014,LAS ROSAS (MAZATA),1,7,3,4,1
DURANGO,10,MEZQUITAL,014,LAS TREMENTINAS,3,29,14,15,3
DURANGO,10,MEZQUITAL,014,LAS TRES CRUCES,2,13,7,6,2
DURANGO,10,MEZQUITAL,014,LAS VIGAS,3,157,79,78,9
DURANGO,10,MEZQUITAL,014,LECHERÍAS,1,41,20,21,1
DURANGO,10,MEZQUITAL,014,LECHUGUILLAS,2,43,23,20,2
DURANGO,10,MEZQUITAL,014,LLANO DE JACALITOS,3,98,51,47,3
DURANGO,10,MEZQUITAL,014,LLANO DE TEJÓNES,2,16,10,6,2
DURANGO,10,MEZQUITAL,014,LLANO DEL BAJÍO,1,14,5,9,1
DURANGO,10,MEZQUITAL,014,LLANO DELGADO,2,8,5,3,1
DURANGO,10,MEZQUITAL,014,LLANO GRANDE,5,468,226,242,23
DURANGO,10,MEZQUITAL,014,LOS AGUACATES,3,28,17,11,3
DURANGO,10,MEZQUITAL,014,LOS ALACRANES,5,153,71,82,10
DURANGO,10,MEZQUITAL,014,LOS ÁLAMOS,1,15,9,6,1
DURANGO,10,MEZQUITAL,014,LOS ALISOS,2,17,9,8,2
DURANGO,10,MEZQUITAL,014,LOS ALTOS,1,8,5,3,1
DURANGO,10,MEZQUITAL,014,LOS ALTOS DE LAS QUEBRADAS,2,33,18,15,2
DURANGO,10,MEZQUITAL,014,LOS AMOLES,4,82,40,42,8
DURANGO,10,MEZQUITAL,014,LOS AMOLES (LA REJA),1,42,23,19,1
DURANGO,10,MEZQUITAL,014,LOS ARENALES,1,7,3,4,1
DURANGO,10,MEZQUITAL,014,LOS ARQUITOS,1,18,12,6,1
DURANGO,10,MEZQUITAL,014,LOS BANCOS,1,6,3,3,1
DURANGO,10,MEZQUITAL,014,LOS BARRILES (BARRILITOS),2,15,6,9,2
DURANGO,10,MEZQUITAL,014,LOS BARROS,2,90,41,49,6
DURANGO,10,MEZQUITAL,014,LOS CAPULINES,5,106,43,63,7
DURANGO,10,MEZQUITAL,014,LOS CHARCOS,5,763,404,359,45
DURANGO,10,MEZQUITAL,014,LOS COCONOS,2,24,12,12,3
DURANGO,10,MEZQUITAL,014,LOS CORPOS,1,30,14,16,1
DURANGO,10,MEZQUITAL,014,LOS CORRALITOS,1,33,19,14,3
DURANGO,10,MEZQUITAL,014,LOS COYAUTES,2,35,15,20,3
DURANGO,10,MEZQUITAL,014,LOS CUERVOS,2,25,13,12,2
DURANGO,10,MEZQUITAL,014,LOS DURAZNOS,7,109,60,49,10
DURANGO,10,MEZQUITAL,014,LOS ENCINOS,2,9,6,3,2
DURANGO,10,MEZQUITAL,014,LOS ESPEJOS,2,37,12,25,2
DURANGO,10,MEZQUITAL,014,LOS FRIJOLES,1,17,10,7,1
DURANGO,10,MEZQUITAL,014,LOS GAVILANES,3,186,99,87,10
DURANGO,10,MEZQUITAL,014,LOS HONGOS,2,68,34,34,4
DURANGO,10,MEZQUITAL,014,LOS HORNOS,1,21,12,9,1
DURANGO,10,MEZQUITAL,014,LOS LOBOS,3,44,22,22,5
DURANGO,10,MEZQUITAL,014,LOS MESTEÑOS,1,22,10,12,1
DURANGO,10,MEZQUITAL,014,LOS OBSCUROS,2,24,12,12,2
DURANGO,10,MEZQUITAL,014,LOS PICACHOS,2,27,14,13,2
DURANGO,10,MEZQUITAL,014,LOS PINOS,1,8,6,2,1
DURANGO,10,MEZQUITAL,014,LOS RATONES,3,74,37,37,4
DURANGO,10,MEZQUITAL,014,LOS SALTOS,3,35,21,14,4
DURANGO,10,MEZQUITAL,014,LOS SAUCES,2,18,7,11,2
DURANGO,10,MEZQUITAL,014,LOS TEJONES,2,33,22,11,3
DURANGO,10,MEZQUITAL,014,MACHO PARADO,3,22,14,8,3
DURANGO,10,MEZQUITAL,014,MAYPURA DE JALPA,3,37,17,20,3
DURANGO,10,MEZQUITAL,014,MESA DE CONEJOS,2,37,14,23,3
DURANGO,10,MEZQUITAL,014,MESA DE LA BANDERA,1,7,2,5,1
DURANGO,10,MEZQUITAL,014,MESA DE LA ORILLA,2,24,12,12,2
DURANGO,10,MEZQUITAL,014,MESA DE LAS CRUCES,3,94,57,37,5
DURANGO,10,MEZQUITAL,014,MESA DE LAS JOYAS,3,109,57,52,6
DURANGO,10,MEZQUITAL,014,MESA DE LAS MILPAS,3,63,28,35,4
DURANGO,10,MEZQUITAL,014,MESA DE LAS NIEVES,2,13,7,6,2
DURANGO,10,MEZQUITAL,014,MESA DE LAS VACAS,3,65,26,39,5
DURANGO,10,MEZQUITAL,014,MESA DE LOS BANCOS,2,37,22,15,3
DURANGO,10,MEZQUITAL,014,MESA DE LOS HONGOS,2,25,16,9,2
DURANGO,10,MEZQUITAL,014,MESA DE LOS LOBOS (LOBITOS),2,36,22,14,2
DURANGO,10,MEZQUITAL,014,MESA DE NAVÍOS,2,19,10,9,2
DURANGO,10,MEZQUITAL,014,MESA DE SOYATES,3,51,26,25,3
DURANGO,10,MEZQUITAL,014,MESA DE TIERRAS COLORADAS,1,15,6,9,1
DURANGO,10,MEZQUITAL,014,MESA DEL LLANO,1,31,18,13,2
DURANGO,10,MEZQUITAL,014,MESA DEL VENADO (SOMBRERO QUEMADO),2,28,16,12,3
DURANGO,10,MEZQUITAL,014,MESA LA BAYONA (MESA DEL CACAYÓN),4,62,32,30,4
DURANGO,10,MEZQUITAL,014,MESILLA DE MAGUEY,1,5,1,4,1
DURANGO,10,MEZQUITAL,014,METATITA,1,9,5,4,1
DURANGO,10,MEZQUITAL,014,MEZQUITE GACHO,1,10,4,6,1
DURANGO,10,MEZQUITAL,014,MILPILLAS,1,39,19,20,2
DURANGO,10,MEZQUITAL,014,MINITAS,1,5,5,0,1
DURANGO,10,MEZQUITAL,014,MURUATA,5,379,192,187,16
DURANGO,10,MEZQUITAL,014,OAXACA,3,19,12,7,3
DURANGO,10,MEZQUITAL,014,PAURA,3,68,31,37,5
DURANGO,10,MEZQUITAL,014,PEÑASCO BLANCO,3,28,13,15,3
DURANGO,10,MEZQUITAL,014,PICACHOS,2,23,12,11,3
DURANGO,10,MEZQUITAL,014,PIEDRA DE AMOLAR,1,14,9,5,1
DURANGO,10,MEZQUITAL,014,PINITOS ALTOS,2,11,8,3,1
DURANGO,10,MEZQUITAL,014,PINO REAL (CHAPOTÁN),2,21,9,12,2
DURANGO,10,MEZQUITAL,014,PINO RODEADO,2,14,4,10,2
DURANGO,10,MEZQUITAL,014,PINOS ALTOS,2,54,27,27,3
DURANGO,10,MEZQUITAL,014,PINOS ENTERRADOS,3,54,28,26,5
DURANGO,10,MEZQUITAL,014,PLATANITOS (KARUMDAM),2,71,31,40,3
DURANGO,10,MEZQUITAL,014,PUERTA DE PERICOS,1,6,4,2,1
DURANGO,10,MEZQUITAL,014,PUERTO BLANCO,2,33,12,21,3
DURANGO,10,MEZQUITAL,014,PUERTO DEL GUAMÚCHIL,3,145,69,76,9
DURANGO,10,MEZQUITAL,014,RANCHO ARCOÍRIS (RANCHO NUEVO),2,7,1,6,1
DURANGO,10,MEZQUITAL,014,RANCHO DE LAS MANZANILLAS,2,13,4,9,2
DURANGO,10,MEZQUITAL,014,RANCHO NUEVO,4,91,53,38,7
DURANGO,10,MEZQUITAL,014,SAN ANTONIO DE PADUA,4,164,76,88,7
DURANGO,10,MEZQUITAL,014,SAN BERNABÉ,4,130,62,68,6
DURANGO,10,MEZQUITAL,014,SAN BUENAVENTURA,4,84,41,43,6
DURANGO,10,MEZQUITAL,014,SAN DIEGO,2,36,15,21,3
DURANGO,10,MEZQUITAL,014,SAN FRANCISCO DE OCOTÁN,4,424,218,206,18
DURANGO,10,MEZQUITAL,014,SAN FRANCISCO DEL MEZQUITAL,10,1377,687,690,67
DURANGO,10,MEZQUITAL,014,SAN JOSÉ DEL BAJÍO,1,44,15,29,3
DURANGO,10,MEZQUITAL,014,SAN JOSÉ DEL LLANO,3,50,26,24,3
DURANGO,10,MEZQUITAL,014,SAN JOSÉ DEL RANCHITO (EL RANCHITO),2,6,3,3,1
DURANGO,10,MEZQUITAL,014,SAN LUCAS,2,22,10,12,2
DURANGO,10,MEZQUITAL,014,SAN LUCAS DE JALPA,3,33,19,14,3
DURANGO,10,MEZQUITAL,014,SAN MIGUEL DE LAS ESPINAS,3,33,15,18,3
DURANGO,10,MEZQUITAL,014,SAN MIGUEL DE LAS MESAS,2,138,66,72,8
DURANGO,10,MEZQUITAL,014,SAN MIGUEL DE TEMOHAYA,3,35,20,15,3
DURANGO,10,MEZQUITAL,014,SAN PEDRO DE XÍCORAS,4,272,146,126,16
DURANGO,10,MEZQUITAL,014,SANTA GERTRUDIS,2,39,25,14,3
DURANGO,10,MEZQUITAL,014,SANTA MARÍA DE OCOTÁN,5,469,224,245,23
DURANGO,10,MEZQUITAL,014,SANTA MARÍA MAGDALENA DE TAXICARINGA,5,293,143,150,15
DURANGO,10,MEZQUITAL,014,SANTIAGO TENERACA,5,312,152,160,17
DURANGO,10,MEZQUITAL,014,SANTIAGUILLO,3,27,14,13,3
DURANGO,10,MEZQUITAL,014,SOMBRERO QUEMADO,2,23,13,10,2
DURANGO,10,MEZQUITAL,014,TABLA PARADA,2,15,9,6,2
DURANGO,10,MEZQUITAL,014,TACHICHILPA,4,160,84,76,8
DURANGO,10,MEZQUITAL,014,TEPALCATES,2,78,44,34,4
DURANGO,10,MEZQUITAL,014,TEPETATES,1,12,6,6,1
DURANGO,10,MEZQUITAL,014,TEPETATES DE LA SIERRA,1,5,4,1,1
DURANGO,10,MEZQUITAL,014,TIERRA ARADA,2,39,17,22,2
DURANGO,10,MEZQUITAL,014,TIERRA BLANCA,10,186,88,98,13
DURANGO,10,MEZQUITAL,014,TIERRA BLANCA (PEÑASCOS BLANCOS),2,17,7,10,2
DURANGO,10,MEZQUITAL,014,TIERRAS COLORADAS,9,221,103,118,29
DURANGO,10,MEZQUITAL,014,TONALAMPA,2,21,10,11,2
DURANGO,10,MEZQUITAL,014,TORO PARADO,2,16,2,14,2
DURANGO,10,MEZQUITAL,014,TORTILLAS,1,5,3,2,1
DURANGO,10,MEZQUITAL,014,TOYANA,2,59,26,33,4
DURANGO,10,MEZQUITAL,014,TRES MANZANILLAS,2,5,3,2,1
DURANGO,10,MEZQUITAL,014,XOCONOXTLE,3,94,48,46,4
DURANGO,10,MEZQUITAL,014,YERBANÍS,1,8,5,3,1
DURANGO,10,MEZQUITAL,014,YERBANÍZ,1,27,13,14,1
DURANGO,10,MEZQUITAL,014,YONORA,5,85,36,49,6
DURANGO,10,MEZQUITAL,014,ZALATITA,2,63,29,34,2
DURANGO,10,MEZQUITAL,014,ZANCUDO DOS,2,62,23,39,3
DURANGO,10,NAZAS,015,AGUSTÍN MELGAR,2,49,25,24,3
DURANGO,10,NAZAS,015,BENITO JUÁREZ,3,76,39,37,5
DURANGO,10,NAZAS,015,COLONIA LAS ADJUNTAS,3,37,15,22,4
DURANGO,10,NAZAS,015,CRISTÓBAL COLÓN,2,6,5,1,2
DURANGO,10,NAZAS,015,DIEZ DE ABRIL,3,61,34,27,4
DURANGO,10,NAZAS,015,DOLORES HIDALGO,3,40,19,21,3
DURANGO,10,NAZAS,015,EMILIO CARRANZA,4,271,130,141,14
DURANGO,10,NAZAS,015,EUFEMIO ZAPATA,1,6,4,2,1
DURANGO,10,NAZAS,015,GENERAL LÁZARO CÁRDENAS (PUEBLO NUEVO),4,628,373,255,75
DURANGO,10,NAZAS,015,JOSÉ GUADALUPE RODRÍGUEZ,3,34,16,18,4
DURANGO,10,NAZAS,015,LA CABRA,2,8,5,3,1
DURANGO,10,NAZAS,015,LA JARITA (SANTA CLARA),3,6,3,3,2
DURANGO,10,NAZAS,015,LA PERLA,3,128,52,76,7
DURANGO,10,NAZAS,015,MEZQUITALILLO (SALITRERAS),2,71,33,38,14
DURANGO,10,NAZAS,015,MORTEROS,2,7,1,6,2
DURANGO,10,NAZAS,015,NAZAS,9,1219,624,595,62
DURANGO,10,NAZAS,015,PASO NACIONAL,3,440,208,232,28
DURANGO,10,NAZAS,015,RANCHO GRANDE,2,10,5,5,2
DURANGO,10,NAZAS,015,SAN JOSÉ DEL PAJARITO (PAJARITO),3,57,32,25,3
DURANGO,10,NAZAS,015,SANTA BÁRBARA,3,47,19,28,4
DURANGO,10,NAZAS,015,SANTA TERESA DE LA UÑA,2,87,36,51,4
DURANGO,10,NAZAS,015,VEINTICINCO DE DICIEMBRE,2,24,13,11,2
DURANGO,10,NOMBRE DE DIOS,016,AMADO NERVO,2,155,83,72,8
DURANGO,10,NOMBRE DE DIOS,016,CUEVA BLANCA,2,62,31,31,5
DURANGO,10,NOMBRE DE DIOS,016,EL LLANO,2,42,18,24,5
DURANGO,10,NOMBRE DE DIOS,016,EL MOLINO DEL PUEBLO,2,30,16,14,3
DURANGO,10,NOMBRE DE DIOS,016,EL PARTIDOR,2,18,9,9,3
DURANGO,10,NOMBRE DE DIOS,016,EL PUEBLITO VEINTE DE NOVIEMBRE (LA FÁBRICA),2,47,24,23,5
DURANGO,10,NOMBRE DE DIOS,016,EL TOBE,2,43,19,24,4
DURANGO,10,NOMBRE DE DIOS,016,EMILIO PORTES GIL,2,36,16,20,3
DURANGO,10,NOMBRE DE DIOS,016,FRANCISCO VILLA (SAN ISIDRO),2,38,16,22,3
DURANGO,10,NOMBRE DE DIOS,016,GABRIEL HERNÁNDEZ (MANCINAS),3,218,110,108,19
DURANGO,10,NOMBRE DE DIOS,016,GENERAL FRANCISCO MURGUÍA,3,263,135,128,16
DURANGO,10,NOMBRE DE DIOS,016,GENERAL FRANCISCO VILLA (PASO REAL),2,21,13,8,2
DURANGO,10,NOMBRE DE DIOS,016,IGNACIO ZARAGOZA (LAS COTORRAS),2,54,25,29,4
DURANGO,10,NOMBRE DE DIOS,016,LA CONSTANCIA,4,241,123,118,20
DURANGO,10,NOMBRE DE DIOS,016,LAS CORRIENTES,1,17,10,7,1
DURANGO,10,NOMBRE DE DIOS,016,LAURO DEL VILLAR,3,90,44,46,8
DURANGO,10,NOMBRE DE DIOS,016,LUMBRERAS,3,29,14,15,4
DURANGO,10,NOMBRE DE DIOS,016,NIXTALPAN,2,37,17,20,3
DURANGO,10,NOMBRE DE DIOS,016,NOMBRE DE DIOS,13,1986,1014,972,123
DURANGO,10,NOMBRE DE DIOS,016,OJO DE AGUA DE SAN JUAN,2,12,7,5,2
DURANGO,10,NOMBRE DE DIOS,016,OJO DE AGUA LOS BERROS (LOS BERROS),2,31,14,17,2
DURANGO,10,NOMBRE DE DIOS,016,REVOLUCIÓN SOCIAL,2,19,8,11,2
DURANGO,10,NOMBRE DE DIOS,016,ROJAS,3,152,74,78,10
DURANGO,10,NOMBRE DE DIOS,016,SAN JOSÉ DE ACEVEDO (LA GALERA),2,14,10,4,1
DURANGO,10,NOMBRE DE DIOS,016,SAN JOSÉ DE LA PARRILLA (LA PARRILLA),4,314,146,168,26
DURANGO,10,NOMBRE DE DIOS,016,SANTA CRUZ DE GUADALUPE,3,268,133,135,14
DURANGO,10,NOMBRE DE DIOS,016,TEXCALILLO,2,53,23,30,4
DURANGO,10,NOMBRE DE DIOS,016,TUITÁN (SAN JOSÉ DE TUITÁN),4,139,76,63,18
DURANGO,10,OCAMPO,017,CANUTILLO,4,384,217,167,44
DURANGO,10,OCAMPO,017,EL CHORRO,1,3,1,2,1
DURANGO,10,OCAMPO,017,EL ENCINO DE LA PAZ,3,43,18,25,4
DURANGO,10,OCAMPO,017,EL OJITO,4,56,32,24,5
DURANGO,10,OCAMPO,017,GRACIANO SÁNCHEZ (TANQUE GRANDE),1,19,8,11,1
DURANGO,10,OCAMPO,017,LA CIMBRA,2,24,12,12,2
DURANGO,10,OCAMPO,017,LA ESTANCIA,3,32,23,9,3
DURANGO,10,OCAMPO,017,LA HACIENDITA DEL ESPÍRITU SANTO,1,7,2,5,1
DURANGO,10,OCAMPO,017,LA NAVECILLA,1,17,11,6,1
DURANGO,10,OCAMPO,017,LA PROVIDENCIA,4,89,44,45,7
DURANGO,10,OCAMPO,017,LLANOS DE COCINAS,1,13,7,6,1
DURANGO,10,OCAMPO,017,MESA DE NAVARRO,2,5,1,4,1
DURANGO,10,OCAMPO,017,MÉXICO Y LOS LIRIOS,2,21,8,13,2
DURANGO,10,OCAMPO,017,OJOS AZULES (CAMPO ALEGRE),3,30,18,12,3
DURANGO,10,OCAMPO,017,RANCHO NUEVO,3,110,46,64,23
DURANGO,10,OCAMPO,017,SAN GABRIEL,2,28,14,14,2
DURANGO,10,OCAMPO,017,SAN JOSÉ DE LA MONTAÑA,1,17,13,4,1
DURANGO,10,OCAMPO,017,SANTA ANA,2,25,13,12,3
DURANGO,10,OCAMPO,017,SAUCES DE CANUTILLO,1,13,6,7,1
DURANGO,10,OCAMPO,017,TORREÓN DE CAÑAS,3,140,64,76,10
DURANGO,10,OCAMPO,017,VILLA LAS NIEVES,5,616,303,313,48
DURANGO,10,OCAMPO,017,VILLA OCAMPO,4,398,208,190,32
DURANGO,10,OCAMPO,017,VILLA ORESTES PEREYRA (ROSARIO),3,111,54,57,7
DURANGO,10,EL ORO,018,CAMPO AGRARIO (EL BRONCO),1,16,7,9,1
DURANGO,10,EL ORO,018,CASAS BLANCAS,2,19,11,8,3
DURANGO,10,EL ORO,018,CAZUELAS,2,7,2,5,1
DURANGO,10,EL ORO,018,EL AGOSTADERO,3,29,18,11,4
DURANGO,10,EL ORO,018,EL VERGEL,1,16,6,10,1
DURANGO,10,EL ORO,018,EMILIANO MARTÍNEZ (TORRES),3,62,33,29,4
DURANGO,10,EL ORO,018,GENERAL ESCOBEDO,4,195,89,106,16
DURANGO,10,EL ORO,018,GENERAL HERMENEGILDO GALEANA (GALEANA),3,33,18,15,3
DURANGO,10,EL ORO,018,GENERAL MARIANO MATAMOROS,2,37,18,19,3
DURANGO,10,EL ORO,018,GUZMÁN Y HERNÁNDEZ (LA NORIA),3,9,1,8,2
DURANGO,10,EL ORO,018,IGNACIO MANUEL ALTAMIRANO (EL PICACHO),2,7,2,5,1
DURANGO,10,EL ORO,018,LA BELLOTA,1,13,4,9,1
DURANGO,10,EL ORO,018,LA VARA DE SAN JUAN (LA VARA),2,25,13,12,2
DURANGO,10,EL ORO,018,MAGISTRAL DEL ORO (MAGISTRAL),3,55,25,30,4
DURANGO,10,EL ORO,018,MINERAL DE SANTA CRUZ,1,13,6,7,1
DURANGO,10,EL ORO,018,MOJITOME,2,24,15,9,2
DURANGO,10,EL ORO,018,PASO DE ÁLAMOS,2,4,1,3,1
DURANGO,10,EL ORO,018,PEDRO CELESTINO NEGRETE,2,24,16,8,2
DURANGO,10,EL ORO,018,POBLADO DE PEÑA (PEÑA),3,31,14,17,4
DURANGO,10,EL ORO,018,POTRERO DE CAMPA,3,32,15,17,4
DURANGO,10,EL ORO,018,PRIMERO DE MAYO (EL QUEMADO),2,12,6,6,2
DURANGO,10,EL ORO,018,SAN CARLOS (EL RANCHITO),2,8,4,4,1
DURANGO,10,EL ORO,018,SAN JOSÉ DE BARRAZA,2,5,2,3,1
DURANGO,10,EL ORO,018,SAN JOSÉ DE RAMOS (RAMOS),3,43,21,22,4
DURANGO,10,EL ORO,018,SANTA CRUZ DE TEPEHUANES (EL PUEBLO CHILERO),3,37,18,19,4
DURANGO,10,EL ORO,018,SANTA MARÍA DEL ORO,12,2447,1278,1169,188
DURANGO,10,EL ORO,018,SANTA RITA DE CASIA,2,6,2,4,1
DURANGO,10,EL ORO,018,SANTA ROSA,1,16,7,9,1
DURANGO,10,EL ORO,018,SAUCES DE CARDONA,1,17,7,10,1
DURANGO,10,EL ORO,018,UNIÓN Y PROGRESO (LAS IGLESIAS),3,40,20,20,4
DURANGO,10,OTÁEZ,019,ARRANCA BARBAS (NUEVO PORVENIR),2,21,11,10,2
DURANGO,10,OTÁEZ,019,BAJÍO DE VACAS (BAJÍO DE ATOCHA),2,54,31,23,4
DURANGO,10,OTÁEZ,019,BANOME,3,71,28,43,4
DURANGO,10,OTÁEZ,019,CAMPANILLAS,1,14,6,8,1
DURANGO,10,OTÁEZ,019,CIÉNEGA DE OLIVOS,1,5,3,2,1
DURANGO,10,OTÁEZ,019,COANAS,2,18,5,13,2
DURANGO,10,OTÁEZ,019,EL MANZANILLO,2,5,2,3,1
DURANGO,10,OTÁEZ,019,EL PUERTO DE SAN RAFAEL,3,40,15,25,4
DURANGO,10,OTÁEZ,019,EL RINCÓN,1,41,16,25,2
DURANGO,10,OTÁEZ,019,HUAJUPA,1,12,7,5,1
DURANGO,10,OTÁEZ,019,LA CIENEGUITA,2,29,10,19,3
DURANGO,10,OTÁEZ,019,LA HACIENDITA,1,16,8,8,1
DURANGO,10,OTÁEZ,019,LA MESA DE SANTA CRUZ,1,4,2,2,1
DURANGO,10,OTÁEZ,019,LA SIERRITA,1,6,2,4,1
DURANGO,10,OTÁEZ,019,LOS ARROYOS,3,20,8,12,3
DURANGO,10,OTÁEZ,019,LOS CARDOS,3,52,21,31,4
DURANGO,10,OTÁEZ,019,LOS SAUCES,1,8,2,6,1
DURANGO,10,OTÁEZ,019,MACHO BAYO,3,38,15,23,4
DURANGO,10,OTÁEZ,019,OTÁEZ,4,298,151,147,14
DURANGO,10,OTÁEZ,019,RANCHITO DE LOS OROZCO,2,15,5,10,2
DURANGO,10,OTÁEZ,019,SAN FRANCISCO,2,5,5,0,2
DURANGO,10,OTÁEZ,019,SAN IGNACIO DE HUAPIPUJE,3,38,19,19,3
DURANGO,10,OTÁEZ,019,SAN JOSÉ DE BACIS,3,52,24,28,3
DURANGO,10,OTÁEZ,019,SAN JOSÉ DE LA CRUZ,1,6,1,5,1
DURANGO,10,OTÁEZ,019,SAN JOSÉ DE LA LAGUNA,3,39,16,23,4
DURANGO,10,OTÁEZ,019,SAN MARCOS,1,13,5,8,1
DURANGO,10,OTÁEZ,019,SAN MIGUEL DE PIÉLAGOS,2,25,11,14,2
DURANGO,10,OTÁEZ,019,SAN PEDRO DE AZAFRANES,3,34,13,21,4
DURANGO,10,OTÁEZ,019,SANTA ELENA,2,10,6,4,1
DURANGO,10,OTÁEZ,019,SANTIAGO DE BOZOS (BOZOS),3,30,10,20,3
DURANGO,10,OTÁEZ,019,SIERRA SANTA,3,35,19,16,3
DURANGO,10,OTÁEZ,019,TEPOCATITA,1,8,5,3,1
DURANGO,10,OTÁEZ,019,ZAPOTES,3,29,13,16,3
DURANGO,10,PÁNUCO DE CORONADO,020,ADOLFO LÓPEZ MATEOS (AGUINALDO),3,133,66,67,9
DURANGO,10,PÁNUCO DE CORONADO,020,DOCTOR FRANCISCO CASTILLO NÁJERA,3,56,24,32,4
DURANGO,10,PÁNUCO DE CORONADO,020,ENRIQUE CALDERÓN RODRÍGUEZ,3,32,14,18,3
DURANGO,10,PÁNUCO DE CORONADO,020,FRANCISCO I. MADERO,10,1245,636,609,75
DURANGO,10,PÁNUCO DE CORONADO,020,FRANCISCO JAVIER MINA (CORRALEJO),4,197,103,94,18
DURANGO,10,PÁNUCO DE CORONADO,020,FRANCISCO RUEDA SERRANO,3,54,23,31,6
DURANGO,10,PÁNUCO DE CORONADO,020,GENERAL ARTURO BERNAL,4,113,59,54,9
DURANGO,10,PÁNUCO DE CORONADO,020,GENERAL IGNACIO ZARAGOZA,3,148,80,68,12
DURANGO,10,PÁNUCO DE CORONADO,020,GENERAL LÁZARO CÁRDENAS,3,73,35,38,7
DURANGO,10,PÁNUCO DE CORONADO,020,HERMENEGILDO GALEANA,3,37,17,20,3
DURANGO,10,PÁNUCO DE CORONADO,020,JOSÉ JERÓNIMO HERNÁNDEZ (PORFÍAS),2,18,10,8,2
DURANGO,10,PÁNUCO DE CORONADO,020,JOSÉ LIBRADO RIVERA,2,41,21,20,3
DURANGO,10,PÁNUCO DE CORONADO,020,LOS LOBOS,3,25,11,14,3
DURANGO,10,PÁNUCO DE CORONADO,020,PÁNUCO DE CORONADO,4,352,172,180,24
DURANGO,10,PÁNUCO DE CORONADO,020,SAN JOSÉ DE AVINO,3,201,92,109,11
DURANGO,10,PÁNUCO DE CORONADO,020,VEINTIOCHO DE MAYO (SANTA RITA),4,103,46,57,9
DURANGO,10,PEÑÓN BLANCO,021,COLONIA COVADONGA,3,65,27,38,4
DURANGO,10,PEÑÓN BLANCO,021,COLONIA JUÁREZ,3,78,33,45,6
DURANGO,10,PEÑÓN BLANCO,021,GENERAL JESÚS AGUSTÍN CASTRO (INDEPENDENCIA),5,527,244,283,24
DURANGO,10,PEÑÓN BLANCO,021,IGNACIO ZARAGOZA (SAN PABLO),4,155,67,88,9
DURANGO,10,PEÑÓN BLANCO,021,LA CONCHA,3,14,8,6,3
DURANGO,10,PEÑÓN BLANCO,021,LAS CRUCES,4,171,86,85,10
DURANGO,10,PEÑÓN BLANCO,021,LUIS MOYA (SAN ISIDRO),3,170,69,101,10
DURANGO,10,PEÑÓN BLANCO,021,MATILDE LUNA ELIZALDE,1,5,1,4,1
DURANGO,10,PEÑÓN BLANCO,021,PEÑÓN BLANCO,16,1570,837,733,79
DURANGO,10,PEÑÓN BLANCO,021,SAN PEDRO DEL ÁLAMO (EL ÁLAMO),2,29,17,12,2
DURANGO,10,PEÑÓN BLANCO,021,VÍCTOR MANUEL SÁNCHEZ (JACALES),3,43,17,26,4
DURANGO,10,PEÑÓN BLANCO,021,YERBANÍS,4,131,61,70,10
DURANGO,10,POANAS,022,18 DE AGOSTO,3,177,82,95,11
DURANGO,10,POANAS,022,CIENEGUILLA,4,262,119,143,21
DURANGO,10,POANAS,022,DAMIÁN CARMONA,1,15,5,10,1
DURANGO,10,POANAS,022,EL POTOSÍ,2,111,49,62,8
DURANGO,10,POANAS,022,ESTACIÓN POANAS,2,51,24,27,4
DURANGO,10,POANAS,022,FRANCISCO ZARCO,3,52,27,25,5
DURANGO,10,POANAS,022,LA JOYA,3,451,218,233,33
DURANGO,10,POANAS,022,LA OCHOA,6,297,149,148,21
DURANGO,10,POANAS,022,LOS ÁNGELES,5,490,258,232,44
DURANGO,10,POANAS,022,NARCISO MENDOZA,3,178,91,87,10
DURANGO,10,POANAS,022,NORIA DE LOS PILARES,3,52,23,29,4
DURANGO,10,POANAS,022,ORIZABA,3,250,118,132,17
DURANGO,10,POANAS,022,SAN ATENÓGENES (LA VILLITA),4,299,150,149,19
DURANGO,10,POANAS,022,SAN MARTÍN,1,4,3,1,1
DURANGO,10,POANAS,022,VILLA UNIÓN,19,3912,1960,1952,298
DURANGO,10,PUEBLO NUEVO,023,ADOLFO RUIZ CORTINES (MARRANERAS),3,10,5,5,2
DURANGO,10,PUEBLO NUEVO,023,AGUA CALIENTE,3,43,24,19,3
DURANGO,10,PUEBLO NUEVO,023,AGUA ZARCA [DE CHOMONQUES],3,10,4,6,3
DURANGO,10,PUEBLO NUEVO,023,ARROYO HONDO,1,8,2,6,1
DURANGO,10,PUEBLO NUEVO,023,BALONTITA,1,36,16,20,2
DURANGO,10,PUEBLO NUEVO,023,CALABAZAS,2,20,4,16,2
DURANGO,10,PUEBLO NUEVO,023,CARBONERAS,4,82,36,46,6
DURANGO,10,PUEBLO NUEVO,023,CEBOLLAS,3,41,28,13,3
DURANGO,10,PUEBLO NUEVO,023,CHAVARRÍA DEL CAMPAMENTO,2,14,9,5,2
DURANGO,10,PUEBLO NUEVO,023,CHAVARRÍA NUEVO,4,189,95,94,9
DURANGO,10,PUEBLO NUEVO,023,CHAVARRÍA VIEJO,3,27,14,13,3
DURANGO,10,PUEBLO NUEVO,023,CHICHARRAS,3,29,16,13,3
DURANGO,10,PUEBLO NUEVO,023,COFRADÍA,2,41,21,20,3
DURANGO,10,PUEBLO NUEVO,023,CORRAL DE PIEDRA,1,11,6,5,1
DURANGO,10,PUEBLO NUEVO,023,CORRALITOS [DE MILPILLAS],2,5,4,1,2
DURANGO,10,PUEBLO NUEVO,023,CORRALITOS [DE PUEBLO NUEVO],3,46,25,21,4
DURANGO,10,PUEBLO NUEVO,023,COSCOMATE [DE CHAVARRIA],3,30,11,19,4
DURANGO,10,PUEBLO NUEVO,023,CUEVA MOJADA,1,9,6,3,1
DURANGO,10,PUEBLO NUEVO,023,CUEVA RASPOSA,1,18,10,8,1
DURANGO,10,PUEBLO NUEVO,023,CURACHAS,3,53,21,32,3
DURANGO,10,PUEBLO NUEVO,023,EL AMOLE,3,23,13,10,3
DURANGO,10,PUEBLO NUEVO,023,EL CAMPAMENTO,3,25,14,11,3
DURANGO,10,PUEBLO NUEVO,023,EL CARRIZO [ANEXO A PUEBLO NUEVO],1,4,2,2,1
DURANGO,10,PUEBLO NUEVO,023,EL CARRIZO [DE CHAVARRÍA],2,46,22,24,3
DURANGO,10,PUEBLO NUEVO,023,EL CARRIZO [DE LAJAS],2,16,8,8,2
DURANGO,10,PUEBLO NUEVO,023,EL CERRO DEL OSO,1,39,13,26,2
DURANGO,10,PUEBLO NUEVO,023,EL CHAPOTE,2,10,5,5,2
DURANGO,10,PUEBLO NUEVO,023,EL CIPRÉS,3,22,9,13,3
DURANGO,10,PUEBLO NUEVO,023,EL CÓSCATE,3,36,17,19,3
DURANGO,10,PUEBLO NUEVO,023,EL COSCOMATE [DE PUEBLO NUEVO],2,6,3,3,2
DURANGO,10,PUEBLO NUEVO,023,EL DESMONTE [DE LA ENRRAMADA],3,7,2,5,2
DURANGO,10,PUEBLO NUEVO,023,EL DURAZNO (EJIDO SAN PABLO),3,9,3,6,2
DURANGO,10,PUEBLO NUEVO,023,EL ENCINAL [DE LA ESCONDIDA],1,33,20,13,2
DURANGO,10,PUEBLO NUEVO,023,EL ENCINO GACHO,1,4,1,3,1
DURANGO,10,PUEBLO NUEVO,023,EL GUAYABAL,2,12,3,9,1
DURANGO,10,PUEBLO NUEVO,023,EL GÜERO DE MILPILLAS,3,48,23,25,4
DURANGO,10,PUEBLO NUEVO,023,EL HABAL,3,27,12,15,3
DURANGO,10,PUEBLO NUEVO,023,EL JOCUIXTLE,3,59,30,29,4
DURANGO,10,PUEBLO NUEVO,023,EL MAGUEY [DE LOS NARANJOS],1,15,9,6,1
DURANGO,10,PUEBLO NUEVO,023,EL MASPARILLO,2,24,16,8,2
DURANGO,10,PUEBLO NUEVO,023,EL MIL DIEZ,3,256,130,126,11
DURANGO,10,PUEBLO NUEVO,023,EL MOLINO,2,40,19,21,3
DURANGO,10,PUEBLO NUEVO,023,EL OJO DE AGUA [DEL MOLINO],1,7,4,3,1
DURANGO,10,PUEBLO NUEVO,023,EL OSO,3,6,3,3,2
DURANGO,10,PUEBLO NUEVO,023,EL PALMAR,2,33,17,16,2
DURANGO,10,PUEBLO NUEVO,023,EL SALTO,42,7845,3866,3979,422
DURANGO,10,PUEBLO NUEVO,023,EL SAUCITO [DE LAJAS],3,38,16,22,3
DURANGO,10,PUEBLO NUEVO,023,EL TALLER,2,5,2,3,1
DURANGO,10,PUEBLO NUEVO,023,EL TAPEXTLE,3,57,31,26,4
DURANGO,10,PUEBLO NUEVO,023,EL TASTITO,1,11,6,5,1
DURANGO,10,PUEBLO NUEVO,023,EL TEMPISQUE,1,22,8,14,1
DURANGO,10,PUEBLO NUEVO,023,EL TUNAL,2,11,6,5,1
DURANGO,10,PUEBLO NUEVO,023,EL VERANO,1,5,1,4,1
DURANGO,10,PUEBLO NUEVO,023,EL ZAPOTE [DE PUEBLO NUEVO],5,85,41,44,7
DURANGO,10,PUEBLO NUEVO,023,ESTACIÓN COYOTES (JOSÉ MARÍA MORELOS),1,39,22,17,2
DURANGO,10,PUEBLO NUEVO,023,GOLONDRINAS [DE CHAVARRIA],3,19,4,15,3
DURANGO,10,PUEBLO NUEVO,023,GUAJOLOTES,3,123,61,62,7
DURANGO,10,PUEBLO NUEVO,023,HACIENDA COYOTES,3,189,71,118,9
DURANGO,10,PUEBLO NUEVO,023,JAGÜEYES,3,83,44,39,5
DURANGO,10,PUEBLO NUEVO,023,LA ANGOSTURA,1,13,6,7,1
DURANGO,10,PUEBLO NUEVO,023,LA CAMPANA [DE SAN JERÓNIMO],3,78,38,40,5
DURANGO,10,PUEBLO NUEVO,023,LA CIÉNEGA [DE LOS BANCOS],1,18,9,9,1
DURANGO,10,PUEBLO NUEVO,023,LA CIUDAD,6,822,419,403,43
DURANGO,10,PUEBLO NUEVO,023,LA COLORADA,2,8,4,4,1
DURANGO,10,PUEBLO NUEVO,023,LA CRUZ [DE MILPILLAS],1,14,8,6,1
DURANGO,10,PUEBLO NUEVO,023,LA CUMBRE [DE MILPILLAS],3,109,48,61,6
DURANGO,10,PUEBLO NUEVO,023,LA ENRAMADA,1,15,3,12,1
DURANGO,10,PUEBLO NUEVO,023,LA ERMITA,3,6,2,4,2
DURANGO,10,PUEBLO NUEVO,023,LA ESCONDIDA [DE CORRALITOS],1,74,35,39,6
DURANGO,10,PUEBLO NUEVO,023,LA ESCONDIDA [DE LA MESA DE SAN PEDRO],3,105,44,61,7
DURANGO,10,PUEBLO NUEVO,023,LA ESCONDIDA [DE SAN PABLO],1,4,3,1,1
DURANGO,10,PUEBLO NUEVO,023,LA FORMACIÓN,2,23,12,11,2
DURANGO,10,PUEBLO NUEVO,023,LA LAGUNA [DE LAJAS],3,136,64,72,7
DURANGO,10,PUEBLO NUEVO,023,LA LAGUNA [DE SAN PABLO],2,15,7,8,2
DURANGO,10,PUEBLO NUEVO,023,LA LAGUNITA [DE PEÑASCO BLANCO],2,42,24,18,2
DURANGO,10,PUEBLO NUEVO,023,LA PALMA,1,16,9,7,1
DURANGO,10,PUEBLO NUEVO,023,LA PEÑA,4,365,202,163,13
DURANGO,10,PUEBLO NUEVO,023,LA PUERTA,3,108,55,53,6
DURANGO,10,PUEBLO NUEVO,023,LA PUERTA DEL GALLO,2,43,26,17,3
DURANGO,10,PUEBLO NUEVO,023,LA SIERRITA (EL TORIL),3,34,16,18,3
DURANGO,10,PUEBLO NUEVO,023,LA SOLEDAD [DE PINO GORDO],2,10,5,5,2
DURANGO,10,PUEBLO NUEVO,023,LA UNIÓN (LA PERA),4,34,22,12,4
DURANGO,10,PUEBLO NUEVO,023,LA VENTANA [DE SARCILLOS],3,73,44,29,4
DURANGO,10,PUEBLO NUEVO,023,LA VENTANA [DE TIERRAS COLORADAS],2,58,32,26,3
DURANGO,10,PUEBLO NUEVO,023,LA VINATA,1,21,11,10,1
DURANGO,10,PUEBLO NUEVO,023,LA VINATA DEL CERRO PRIETO,1,11,6,5,1
DURANGO,10,PUEBLO NUEVO,023,LA YERBABUENA [DE BALONTITA],1,22,7,15,1
DURANGO,10,PUEBLO NUEVO,023,LAS ADJUNTAS,3,63,23,40,4
DURANGO,10,PUEBLO NUEVO,023,LAS CAÑAS,2,87,47,40,4
DURANGO,10,PUEBLO NUEVO,023,LAS CEBOLLAS,3,54,14,40,4
DURANGO,10,PUEBLO NUEVO,023,LAS HIGUERAS [DE LOS NARANJOS],3,60,31,29,4
DURANGO,10,PUEBLO NUEVO,023,LAS JOYAS [DE CHOMONQUES],3,45,26,19,4
DURANGO,10,PUEBLO NUEVO,023,LAS LAGUNAS,2,46,26,20,3
DURANGO,10,PUEBLO NUEVO,023,LAS LATAS,2,87,42,45,4
DURANGO,10,PUEBLO NUEVO,023,LAS MURALLAS,1,16,7,9,1
DURANGO,10,PUEBLO NUEVO,023,LAS NEGRAS,1,98,46,52,5
DURANGO,10,PUEBLO NUEVO,023,LAS PULGAS,1,7,5,2,1
DURANGO,10,PUEBLO NUEVO,023,LLANO GRANDE DE MILPILLAS CHICO,4,255,125,130,15
DURANGO,10,PUEBLO NUEVO,023,LOS AGUACATES,2,23,13,10,2
DURANGO,10,PUEBLO NUEVO,023,LOS AGUILARES,3,92,42,50,5
DURANGO,10,PUEBLO NUEVO,023,LOS ÁNGELES,1,16,8,8,1
DURANGO,10,PUEBLO NUEVO,023,LOS ARCOS,3,45,20,25,4
DURANGO,10,PUEBLO NUEVO,023,LOS BANCOS,3,29,13,16,3
DURANGO,10,PUEBLO NUEVO,023,LOS BARREALES DE LA BUFITA,2,16,8,8,2
DURANGO,10,PUEBLO NUEVO,023,LOS BUEYEROS,2,10,5,5,1
DURANGO,10,PUEBLO NUEVO,023,LOS BULES,1,27,12,15,2
DURANGO,10,PUEBLO NUEVO,023,LOS CEDROS,1,18,8,10,1
DURANGO,10,PUEBLO NUEVO,023,LOS CHARCOS,2,5,3,2,1
DURANGO,10,PUEBLO NUEVO,023,LOS DESMONTES,3,10,3,7,2
DURANGO,10,PUEBLO NUEVO,023,LOS GUAYABOS,4,146,77,69,7
DURANGO,10,PUEBLO NUEVO,023,LOS HORCONES,2,32,17,15,2
DURANGO,10,PUEBLO NUEVO,023,LOS LAURELES [DE MILPILLAS],1,7,2,5,1
DURANGO,10,PUEBLO NUEVO,023,LOS LIMONES [DE LOS NARANJOS],2,18,11,7,2
DURANGO,10,PUEBLO NUEVO,023,LOS MIMBRES [DE MILPILLAS],3,71,35,36,4
DURANGO,10,PUEBLO NUEVO,023,LOS NARANJOS,4,158,66,92,8
DURANGO,10,PUEBLO NUEVO,023,LOS NEGROS,1,21,14,7,1
DURANGO,10,PUEBLO NUEVO,023,LOS PELONCITOS,3,6,3,3,3
DURANGO,10,PUEBLO NUEVO,023,MAGUEY [DE MILPILLAS],1,9,3,6,1
DURANGO,10,PUEBLO NUEVO,023,MAÍZ GORDO,4,85,44,41,6
DURANGO,10,PUEBLO NUEVO,023,MESA DE SAN PEDRO,5,323,154,169,17
DURANGO,10,PUEBLO NUEVO,023,PEÑASCO BLANCO 1 (LAS PILAS),3,38,12,26,3
DURANGO,10,PUEBLO NUEVO,023,PEÑASCO REDONDO,1,10,4,6,1
DURANGO,10,PUEBLO NUEVO,023,PERICOS [DE LA PEÑA],3,9,3,6,2
DURANGO,10,PUEBLO NUEVO,023,PIE DE CUESTA,3,37,20,17,3
DURANGO,10,PUEBLO NUEVO,023,PILONCILLOS [DE MILPILLAS],1,6,3,3,1
DURANGO,10,PUEBLO NUEVO,023,PINO GORDO,3,31,16,15,4
DURANGO,10,PUEBLO NUEVO,023,PORTALES DE MILPILLAS,3,24,13,11,3
DURANGO,10,PUEBLO NUEVO,023,PUEBLO NUEVO (PUEBLO DE CAÑA),4,233,116,117,10
DURANGO,10,PUEBLO NUEVO,023,QUEBRADA DEL CAMPAMENTO,2,25,13,12,2
DURANGO,10,PUEBLO NUEVO,023,RANCHO LOS MANCINAS (CHOMONQUES),2,19,8,11,2
DURANGO,10,PUEBLO NUEVO,023,RINCÓN DE AGUA CALIENTE,2,13,7,6,2
DURANGO,10,PUEBLO NUEVO,023,SAN ANTONIO DE ÁNIMAS,1,12,5,7,1
DURANGO,10,PUEBLO NUEVO,023,SAN ANTONIO Y ANEXOS,2,24,12,12,2
DURANGO,10,PUEBLO NUEVO,023,SAN BARTOLO,3,37,20,17,3
DURANGO,10,PUEBLO NUEVO,023,SAN BERNARDINO DE MILPILLAS CHICO,5,654,345,309,25
DURANGO,10,PUEBLO NUEVO,023,SAN ESTEBAN,3,26,10,16,3
DURANGO,10,PUEBLO NUEVO,023,SAN FRANCISCO DE LAJAS (LAJAS),5,366,189,177,19
DURANGO,10,PUEBLO NUEVO,023,SAN JERÓNIMO,4,392,213,179,15
DURANGO,10,PUEBLO NUEVO,023,SAN JUAN [DEL MIL DIEZ],3,42,17,25,4
DURANGO,10,PUEBLO NUEVO,023,SAN MANUEL,3,63,26,37,4
DURANGO,10,PUEBLO NUEVO,023,SAN PABLO,2,6,3,3,1
DURANGO,10,PUEBLO NUEVO,023,SAN PATRICIO [DE LOS NARANJOS],1,8,3,5,1
DURANGO,10,PUEBLO NUEVO,023,SAN PATRICIO [DE MILPILLAS],1,16,9,7,1
DURANGO,10,PUEBLO NUEVO,023,SANTA LUCÍA,3,70,36,34,4
DURANGO,10,PUEBLO NUEVO,023,SARCILLOS,1,30,16,14,2
DURANGO,10,PUEBLO NUEVO,023,TABACOTES,3,27,12,15,3
DURANGO,10,PUEBLO NUEVO,023,TIERRA BLANCA [DE LA MESA DE SAN PEDRO],4,103,58,45,7
DURANGO,10,PUEBLO NUEVO,023,TIERRAS COLORADAS [DE LA CUMBRE],2,156,81,75,9
DURANGO,10,PUEBLO NUEVO,023,TIERRAS COLORADAS [DE MAÍZ GORDO],1,37,15,22,2
DURANGO,10,PUEBLO NUEVO,023,TORTUGAS,1,7,1,6,1
DURANGO,10,PUEBLO NUEVO,023,TRES LAGUNAS,3,33,14,19,3
DURANGO,10,PUEBLO NUEVO,023,VALLE DE LA BUFA (EL RANCHITO),2,40,22,18,3
DURANGO,10,RODEO,024,ABASOLO,4,400,198,202,25
DURANGO,10,RODEO,024,ALAMILLO GALEANA,3,52,25,27,4
DURANGO,10,RODEO,024,BARRIO DE GUADALUPE,2,22,10,12,2
DURANGO,10,RODEO,024,BUENAVISTA,3,30,11,19,4
DURANGO,10,RODEO,024,EL PARÍAN,2,25,15,10,2
DURANGO,10,RODEO,024,EL REALITO,1,3,2,1,1
DURANGO,10,RODEO,024,FRANCISCO MÁRQUEZ,2,11,8,3,2
DURANGO,10,RODEO,024,FRANCISCO ZARCO (TATANTÓN),3,61,30,31,4
DURANGO,10,RODEO,024,HÉROES DE MÉXICO (LA ANGOSTURA),3,49,32,17,4
DURANGO,10,RODEO,024,HIDALGO DE SAN ANTONIO,4,177,81,96,10
DURANGO,10,RODEO,024,HIGUERAS,3,54,26,28,5
DURANGO,10,RODEO,024,JESÚS GONZÁLEZ ORTEGA,3,39,17,22,4
DURANGO,10,RODEO,024,LA CUESTA DE PALMITOS,2,31,13,18,2
DURANGO,10,RODEO,024,LA GOTERA,3,13,8,5,2
DURANGO,10,RODEO,024,LABOR DE GUADALUPE,1,14,4,10,1
DURANGO,10,RODEO,024,LAS ÁNIMAS,3,31,13,18,3
DURANGO,10,RODEO,024,LEANDRO VALLE,4,130,54,76,13
DURANGO,10,RODEO,024,LINARES DEL RÍO,3,81,39,42,6
DURANGO,10,RODEO,024,LOS AMOLES,3,44,16,28,3
DURANGO,10,RODEO,024,LOS ÁNGELES (TIERRA PRIETA),2,64,31,33,4
DURANGO,10,RODEO,024,LOS LADRILLOS,2,34,13,21,3
DURANGO,10,RODEO,024,NIÑOS HÉROES (SAN RAFAEL),3,53,21,32,5
DURANGO,10,RODEO,024,OJO DE AGUA,2,14,5,9,2
DURANGO,10,RODEO,024,RODEO,10,1945,989,956,156
DURANGO,10,RODEO,024,SAN PEDRO,3,13,4,9,3
DURANGO,10,RODEO,024,SAN SALVADOR DE HORTA,3,71,33,38,5
DURANGO,10,RODEO,024,SANTA BÁRBARA,3,194,79,115,13
DURANGO,10,RODEO,024,SANTA ISABEL DEL RESBALÓN,2,16,8,8,2
DURANGO,10,RODEO,024,TIERRA BLANCA,2,22,13,9,2
DURANGO,10,RODEO,024,UNIÓN Y PROGRESO (EL TEJABAN),2,36,16,20,3
DURANGO,10,RODEO,024,VALLE NACIONAL (EL BANCO),1,21,10,11,1
DURANGO,10,SAN BERNARDO,025,AMADOR,2,7,4,3,2
DURANGO,10,SAN BERNARDO,025,CINCO DE JULIO,1,12,4,8,1
DURANGO,10,SAN BERNARDO,025,DIVISIÓN DEL NORTE (LOS LOBOS),1,15,9,6,1
DURANGO,10,SAN BERNARDO,025,EL ALFÉREZ,2,27,12,15,3
DURANGO,10,SAN BERNARDO,025,MATALOTES,2,28,15,13,2
DURANGO,10,SAN BERNARDO,025,PÉNJAMO,1,5,3,2,1
DURANGO,10,SAN BERNARDO,025,PROVIDENCIA,2,18,9,9,2
DURANGO,10,SAN BERNARDO,025,PUEBLO NUEVO (TALAYOTES),2,27,14,13,2
DURANGO,10,SAN BERNARDO,025,SAN BERNARDO,4,186,94,92,20
DURANGO,10,SAN BERNARDO,025,SAN JOSÉ DEL TULE,1,13,6,7,1
DURANGO,10,SAN BERNARDO,025,SAN JUAN DE HEREDIA (J. GUADALUPE RODRÍGUEZ),1,17,8,9,1
DURANGO,10,SAN BERNARDO,025,SAN SIMÓN,1,9,2,7,1
DURANGO,10,SAN BERNARDO,025,SARDINAS,2,28,12,16,3
DURANGO,10,SAN BERNARDO,025,VEINTE DE ABRIL (LAS DELICIAS),3,49,21,28,4
DURANGO,10,SAN DIMAS,026,BORBOLLONES,3,68,40,28,4
DURANGO,10,SAN DIMAS,026,BUENAVISTA,2,16,7,9,2
DURANGO,10,SAN DIMAS,026,CARBONERAS (SANTA ROSA DE LOS ALVARADOS),1,6,1,5,1
DURANGO,10,SAN DIMAS,026,CIÉNEGA DE TRES ENCINOS,2,5,3,2,1
DURANGO,10,SAN DIMAS,026,CIENEGUITA,3,39,22,17,4
DURANGO,10,SAN DIMAS,026,CUATRO CAMINOS,2,26,12,14,2
DURANGO,10,SAN DIMAS,026,CUEVECILLAS,3,49,24,25,4
DURANGO,10,SAN DIMAS,026,DOCE DE MAYO,3,74,37,37,6
DURANGO,10,SAN DIMAS,026,EL ANCÓN,2,23,11,12,2
DURANGO,10,SAN DIMAS,026,EL CAJÓN,2,10,5,5,1
DURANGO,10,SAN DIMAS,026,EL CHICURAL,2,35,21,14,3
DURANGO,10,SAN DIMAS,026,EL DURAZNITO,2,20,10,10,2
DURANGO,10,SAN DIMAS,026,EL GATO,2,12,5,7,2
DURANGO,10,SAN DIMAS,026,EL GUAYABO,3,12,5,7,2
DURANGO,10,SAN DIMAS,026,EL LIMÓN,3,24,10,14,3
DURANGO,10,SAN DIMAS,026,EL LLANO,2,21,10,11,2
DURANGO,10,SAN DIMAS,026,EL PALMITO,3,26,12,14,2
DURANGO,10,SAN DIMAS,026,EL PASO DEL ARROYO,2,5,2,3,2
DURANGO,10,SAN DIMAS,026,EL RINCÓN DE TIERRA BLANCA,2,18,9,9,2
DURANGO,10,SAN DIMAS,026,EL RUSIO,3,21,14,7,3
DURANGO,10,SAN DIMAS,026,ESPADAÑAL DE SAN JERÓNIMO,3,62,26,36,4
DURANGO,10,SAN DIMAS,026,GAVILANES,3,20,9,11,3
DURANGO,10,SAN DIMAS,026,GENERAL RAFAEL BUELNA (SOCAVÓN),1,11,3,8,1
DURANGO,10,SAN DIMAS,026,GUARISAMEY,3,44,21,23,4
DURANGO,10,SAN DIMAS,026,HUACHICHILES,3,32,15,17,4
DURANGO,10,SAN DIMAS,026,HUACHIMETAS DE ABAJO,3,19,12,7,3
DURANGO,10,SAN DIMAS,026,HUACHIMETAS DE ARRIBA,3,27,12,15,3
DURANGO,10,SAN DIMAS,026,HUAHUAPAN,3,25,12,13,3
DURANGO,10,SAN DIMAS,026,HUÍZAR,3,37,23,14,3
DURANGO,10,SAN DIMAS,026,LA APLASTADA,1,3,1,2,1
DURANGO,10,SAN DIMAS,026,LA BOQUILLA DE SAN LUIS,1,9,5,4,1
DURANGO,10,SAN DIMAS,026,LA CEJA AMARILLA,1,5,4,1,1
DURANGO,10,SAN DIMAS,026,LA CIÉNEGA,2,6,2,4,1
DURANGO,10,SAN DIMAS,026,LA DESMONTADA,3,22,11,11,3
DURANGO,10,SAN DIMAS,026,LA JOYA ALEGRE,2,6,3,3,1
DURANGO,10,SAN DIMAS,026,LA LAGUNA DEL PROGRESO,3,50,24,26,4
DURANGO,10,SAN DIMAS,026,LA MESA DE LOS NEGROS,3,46,22,24,4
DURANGO,10,SAN DIMAS,026,LA OBSCURIDAD,2,22,11,11,2
DURANGO,10,SAN DIMAS,026,LA PEDREGOZA,2,4,1,3,2
DURANGO,10,SAN DIMAS,026,LA PLAZUELA,1,11,7,4,1
DURANGO,10,SAN DIMAS,026,LA VENTANA,3,41,21,20,4
DURANGO,10,SAN DIMAS,026,LA VÍBORA,2,4,2,2,1
DURANGO,10,SAN DIMAS,026,LAS ADJUNTAS,3,10,4,6,3
DURANGO,10,SAN DIMAS,026,LAS ÁGUILAS DE ARRIBA,2,4,3,1,1
DURANGO,10,SAN DIMAS,026,LAS CEBOLLAS,3,15,8,7,3
DURANGO,10,SAN DIMAS,026,LAS FLECHAS,3,31,21,10,3
DURANGO,10,SAN DIMAS,026,LAS FLORES,1,3,3,0,1
DURANGO,10,SAN DIMAS,026,LAS HUERTAS,2,10,5,5,2
DURANGO,10,SAN DIMAS,026,LAS MELADAS,3,23,13,10,3
DURANGO,10,SAN DIMAS,026,LAS PINTAS,3,22,10,12,3
DURANGO,10,SAN DIMAS,026,LAS TRUCHAS,3,18,7,11,3
DURANGO,10,SAN DIMAS,026,LOS ÁNGELES,2,4,2,2,1
DURANGO,10,SAN DIMAS,026,LOS CARDOS,3,21,11,10,3
DURANGO,10,SAN DIMAS,026,LOS FRESNOS,3,30,18,12,3
DURANGO,10,SAN DIMAS,026,LOS MACÍAS,2,11,5,6,2
DURANGO,10,SAN DIMAS,026,LOS OSCUROS,1,4,2,2,1
DURANGO,10,SAN DIMAS,026,MALA NOCHE,2,5,4,1,2
DURANGO,10,SAN DIMAS,026,METATITOS,1,3,1,2,1
DURANGO,10,SAN DIMAS,026,MORILLITOS,2,123,54,69,7
DURANGO,10,SAN DIMAS,026,NEVEROS,3,71,38,33,4
DURANGO,10,SAN DIMAS,026,PIEDRA RAJADA,2,9,5,4,1
DURANGO,10,SAN DIMAS,026,PIEDRAS DE LUMBRE,2,5,0,5,1
DURANGO,10,SAN DIMAS,026,PUENTECILLAS,3,72,34,38,5
DURANGO,10,SAN DIMAS,026,REVOLCADEROS,2,11,5,6,2
DURANGO,10,SAN DIMAS,026,RÍO DE MIRAVALLES,3,38,21,17,4
DURANGO,10,SAN DIMAS,026,SAN ANTONIO DE LA CRUZ,3,47,18,29,4
DURANGO,10,SAN DIMAS,026,SAN ANTONIO DE LAS TRUCHAS,4,105,46,59,8
DURANGO,10,SAN DIMAS,026,SAN BLAS,3,35,16,19,3
DURANGO,10,SAN DIMAS,026,SAN FRANCISCO,3,17,6,11,3
DURANGO,10,SAN DIMAS,026,SAN FRANCISCO DE LOS LOBOS,3,40,20,20,4
DURANGO,10,SAN DIMAS,026,SAN JOSÉ DE MIRAVALLES,2,19,12,7,2
DURANGO,10,SAN DIMAS,026,SAN JOSÉ DE MIRAVALLES (EL BALUARTE),1,11,3,8,1
DURANGO,10,SAN DIMAS,026,SAN LUIS DE VILLA CORONA,4,101,39,62,7
DURANGO,10,SAN DIMAS,026,SAN MANUEL DE VILLA CORONA,3,32,14,18,4
DURANGO,10,SAN DIMAS,026,SAN MIGUEL DE CRUCES,7,472,242,230,29
DURANGO,10,SAN DIMAS,026,SAN MIGUELITO,1,9,4,5,1
DURANGO,10,SAN DIMAS,026,SAN PEDRO DE VILLA CORONA,2,12,8,4,2
DURANGO,10,SAN DIMAS,026,SAN VICENTE,1,4,1,3,1
DURANGO,10,SAN DIMAS,026,SANTA RITA,3,48,21,27,4
DURANGO,10,SAN DIMAS,026,SAPIORÍS,1,40,25,15,2
DURANGO,10,SAN DIMAS,026,TAMBORES DE ABAJO (LAS VEGAS),4,113,60,53,8
DURANGO,10,SAN DIMAS,026,TAYOLTITA,15,2085,1039,1046,147
DURANGO,10,SAN DIMAS,026,UNIÓN MODELO (EL PUEBLITO),2,18,7,11,2
DURANGO,10,SAN DIMAS,026,VALDERRAMA,2,49,28,21,4
DURANGO,10,SAN DIMAS,026,VENCEDORES,4,214,102,112,13
DURANGO,10,SAN DIMAS,026,VERACRUZ DE LA SIERRA (EL PUEBLO),3,44,20,24,4
DURANGO,10,SAN DIMAS,026,YAMORIBA,4,126,70,56,7
DURANGO,10,SAN DIMAS,026,YERBANÍZ,3,33,19,14,4
DURANGO,10,SAN JUAN DE GUADALUPE,027,ACACIO (ESTACIÓN ACACIO),3,24,9,15,3
DURANGO,10,SAN JUAN DE GUADALUPE,027,AGUA NUEVA,1,4,3,1,1
DURANGO,10,SAN JUAN DE GUADALUPE,027,BENITO JUÁREZ (EL CAPADERO),3,18,9,9,3
DURANGO,10,SAN JUAN DE GUADALUPE,027,BUENAVISTA,2,9,5,4,2
DURANGO,10,SAN JUAN DE GUADALUPE,027,CIPRIANO,3,26,13,13,3
DURANGO,10,SAN JUAN DE GUADALUPE,027,EL CERRITO,2,16,11,5,2
DURANGO,10,SAN JUAN DE GUADALUPE,027,EL DURAZNO,2,8,5,3,2
DURANGO,10,SAN JUAN DE GUADALUPE,027,EL FLOREÑO,2,11,4,7,2
DURANGO,10,SAN JUAN DE GUADALUPE,027,EL GRANJENO,2,5,3,2,2
DURANGO,10,SAN JUAN DE GUADALUPE,027,EL PAVO (MINERAL EL DIEZ),3,42,18,24,4
DURANGO,10,SAN JUAN DE GUADALUPE,027,EL ZORRILLO,3,56,23,33,5
DURANGO,10,SAN JUAN DE GUADALUPE,027,FRANCISCO I. MADERO (EL PERDIDO),2,20,9,11,2
DURANGO,10,SAN JUAN DE GUADALUPE,027,GUADALUPITO,3,75,41,34,4
DURANGO,10,SAN JUAN DE GUADALUPE,027,LA BARRANCA,1,18,13,5,1
DURANGO,10,SAN JUAN DE GUADALUPE,027,LA ESCALERA,2,18,6,12,2
DURANGO,10,SAN JUAN DE GUADALUPE,027,LA PLANILLA,1,9,4,5,1
DURANGO,10,SAN JUAN DE GUADALUPE,027,LA PROVIDENCIA,2,8,6,2,1
DURANGO,10,SAN JUAN DE GUADALUPE,027,LA ROSITA,1,7,3,4,1
DURANGO,10,SAN JUAN DE GUADALUPE,027,LÁZARO CÁRDENAS (EL ZACATE),3,54,27,27,4
DURANGO,10,SAN JUAN DE GUADALUPE,027,LOS ESQUIVELES,3,52,32,20,4
DURANGO,10,SAN JUAN DE GUADALUPE,027,MAGALLANES,3,21,9,12,3
DURANGO,10,SAN JUAN DE GUADALUPE,027,NUEVA REFORMA,1,15,8,7,1
DURANGO,10,SAN JUAN DE GUADALUPE,027,PALOS ALTOS,1,3,1,2,1
DURANGO,10,SAN JUAN DE GUADALUPE,027,SABANILLA,3,13,6,7,3
DURANGO,10,SAN JUAN DE GUADALUPE,027,SALITRILLO (LA PRESITA),3,33,17,16,3
DURANGO,10,SAN JUAN DE GUADALUPE,027,SAN ANTONIO DE LA LAGUNA,2,6,4,2,2
DURANGO,10,SAN JUAN DE GUADALUPE,027,SAN FRANCISCO DE PERIBANES,3,25,11,14,3
DURANGO,10,SAN JUAN DE GUADALUPE,027,SAN JUAN DE GUADALUPE,5,573,310,263,33
DURANGO,10,SAN JUAN DE GUADALUPE,027,SANTA CRUZ DEL ORÉGANO (EL ORÉGANO),3,42,24,18,3
DURANGO,10,SAN JUAN DE GUADALUPE,027,SANTO NIÑO,3,50,25,25,4
DURANGO,10,SAN JUAN DE GUADALUPE,027,SYMON (ESTACIÓN SYMON),2,20,13,7,2
DURANGO,10,SAN JUAN DE GUADALUPE,027,VICENTE GUERRERO (SIETE ZACATES),4,114,61,53,7
DURANGO,10,SAN JUAN DEL RÍO,028,ATOTONILCO,2,14,7,7,2
DURANGO,10,SAN JUAN DEL RÍO,028,CHARCO HONDO,3,15,7,8,3
DURANGO,10,SAN JUAN DEL RÍO,028,CIÉNEGA GRANDE,5,238,121,117,15
DURANGO,10,SAN JUAN DEL RÍO,028,CORRALES BLANCOS,3,16,5,11,2
DURANGO,10,SAN JUAN DEL RÍO,028,DIEZ DE OCTUBRE (SAN LUCAS DE OCAMPO),4,356,183,173,27
DURANGO,10,SAN JUAN DEL RÍO,028,DOROTEO ARANGO (CIÉNEGA DE BASOCO),3,17,10,7,2
DURANGO,10,SAN JUAN DEL RÍO,028,EL AGUAJE,2,14,7,7,2
DURANGO,10,SAN JUAN DEL RÍO,028,EL CERRO DE LA VENTANA (LAS BURRAS),3,20,12,8,2
DURANGO,10,SAN JUAN DEL RÍO,028,EL CHABACANO,3,49,24,25,4
DURANGO,10,SAN JUAN DEL RÍO,028,EL RESBALÓN,2,53,27,26,4
DURANGO,10,SAN JUAN DEL RÍO,028,EL SAUCITO,1,9,5,4,1
DURANGO,10,SAN JUAN DEL RÍO,028,EL TERRERO,2,15,8,7,2
DURANGO,10,SAN JUAN DEL RÍO,028,ESTANCIA BLANCA,2,34,18,16,3
DURANGO,10,SAN JUAN DEL RÍO,028,FRANCISCO DE IBARRA (EL RANCHITO),1,10,5,5,1
DURANGO,10,SAN JUAN DEL RÍO,028,FRANCISCO PRIMO VERDAD (MENORES DE ABAJO),3,174,78,96,10
DURANGO,10,SAN JUAN DEL RÍO,028,GONZÁLEZ ORTEGA (SANTA ROSALÍA),3,65,30,35,5
DURANGO,10,SAN JUAN DEL RÍO,028,IGNACIO LÓPEZ RAYÓN (POTRERO DE LOS HIGOS),3,56,26,30,4
DURANGO,10,SAN JUAN DEL RÍO,028,JOSÉ MARÍA PATONI (MENORES DE ARRIBA),4,151,74,77,9
DURANGO,10,SAN JUAN DEL RÍO,028,LEONA VICARIO,4,137,73,64,8
DURANGO,10,SAN JUAN DEL RÍO,028,LLANO DEL PINO,3,30,18,12,3
DURANGO,10,SAN JUAN DEL RÍO,028,LOS CHARCOS,2,63,31,32,4
DURANGO,10,SAN JUAN DEL RÍO,028,LOS CHARCOS (LAS MINAS),1,31,13,18,1
DURANGO,10,SAN JUAN DEL RÍO,028,LOS PICACHOS,2,4,0,4,2
DURANGO,10,SAN JUAN DEL RÍO,028,OTILIO MONTAÑO (LA BOQUILLA),3,33,17,16,4
DURANGO,10,SAN JUAN DEL RÍO,028,PUEBLO NUEVO FRANCISCO DE IBARRA (EL CRUCERO),3,75,35,40,5
DURANGO,10,SAN JUAN DEL RÍO,028,RÍO GRANDE,3,26,13,13,3
DURANGO,10,SAN JUAN DEL RÍO,028,SAN AGUSTÍN DE OCAMPO,2,27,8,19,2
DURANGO,10,SAN JUAN DEL RÍO,028,SAN JUAN DEL RÍO DEL CENTAURO DEL NORTE,8,1388,757,631,111
DURANGO,10,SAN JUAN DEL RÍO,028,SAUZ DE ABAJO,3,76,35,41,5
DURANGO,10,SAN JUAN DEL RÍO,028,SAUZ DE ARRIBA,3,33,17,16,3
DURANGO,10,SAN JUAN DEL RÍO,028,TESVINO,3,27,17,10,3
DURANGO,10,SAN JUAN DEL RÍO,028,TOLEDO,2,28,16,12,3
DURANGO,10,SAN JUAN DEL RÍO,028,TRINCHERAS DE ARRIBA,3,3,2,1,2
DURANGO,10,SAN LUIS DEL CORDERO,029,LA PURÍSIMA (EL CHARCO),2,26,15,11,3
DURANGO,10,SAN LUIS DEL CORDERO,029,SAN JOSÉ DEL REFUGIO (EL COLORADO),2,45,24,21,14
DURANGO,10,SAN LUIS DEL CORDERO,029,SAN JUAN DE LAS BOQUILLAS,3,40,17,23,4
DURANGO,10,SAN LUIS DEL CORDERO,029,SAN LUIS DEL CORDERO,5,405,211,194,26
DURANGO,10,SAN LUIS DEL CORDERO,029,TEPALCATEÑO,1,12,6,6,1
DURANGO,10,SAN PEDRO DEL GALLO,030,BOQUILLA DE GERARDO,3,45,23,22,4
DURANGO,10,SAN PEDRO DEL GALLO,030,CINCO DE MAYO,1,9,5,4,1
DURANGO,10,SAN PEDRO DEL GALLO,030,CUBA,3,38,22,16,4
DURANGO,10,SAN PEDRO DEL GALLO,030,EL CASCO,3,41,18,23,4
DURANGO,10,SAN PEDRO DEL GALLO,030,PEÑOLES,1,9,6,3,1
DURANGO,10,SAN PEDRO DEL GALLO,030,SAN PEDRO DEL GALLO,4,194,102,92,11
DURANGO,10,SAN PEDRO DEL GALLO,030,SANTO DOMINGO,3,32,14,18,3
DURANGO,10,SANTA CLARA,031,DIEZ DE ABRIL,3,145,71,74,9
DURANGO,10,SANTA CLARA,031,EL NARANJO,4,110,57,53,7
DURANGO,10,SANTA CLARA,031,EL NOGALITO (NOGALES),3,43,23,20,4
DURANGO,10,SANTA CLARA,031,SAN ANTONIO DE LA LAGUNA,3,118,56,62,10
DURANGO,10,SANTA CLARA,031,SAN MARCOS (24 DE FEBRERO),4,188,102,86,12
DURANGO,10,SANTA CLARA,031,SAN VALENTÍN,2,7,1,6,2
DURANGO,10,SANTA CLARA,031,SANTA CLARA,9,1116,558,558,58
DURANGO,10,SANTIAGO PAPASQUIARO,032,ARANAS,3,30,14,16,3
DURANGO,10,SANTIAGO PAPASQUIARO,032,ATOTONILCO,3,90,45,45,7
DURANGO,10,SANTIAGO PAPASQUIARO,032,BAJÍOS DEL PINTO,3,46,19,27,4
DURANGO,10,SANTIAGO PAPASQUIARO,032,BARRAZAS,2,11,6,5,2
DURANGO,10,SANTIAGO PAPASQUIARO,032,BOCA DEL POTRERO,2,9,6,3,2
DURANGO,10,SANTIAGO PAPASQUIARO,032,CANATÁN,2,18,10,8,2
DURANGO,10,SANTIAGO PAPASQUIARO,032,CIÉNEGA DE NUESTRA SEÑORA DE GUADALUPE,4,760,403,357,43
DURANGO,10,SANTIAGO PAPASQUIARO,032,CIÉNEGA DE SALPICA EL AGUA,3,56,32,24,4
DURANGO,10,SANTIAGO PAPASQUIARO,032,CORRALES BLANCOS,3,49,15,34,4
DURANGO,10,SANTIAGO PAPASQUIARO,032,CUEVECILLAS,3,19,9,10,3
DURANGO,10,SANTIAGO PAPASQUIARO,032,EL AGUA CALIENTE,1,4,4,0,1
DURANGO,10,SANTIAGO PAPASQUIARO,032,EL ALAMITO,2,16,5,11,2
DURANGO,10,SANTIAGO PAPASQUIARO,032,EL ARCO,1,11,4,7,1
DURANGO,10,SANTIAGO PAPASQUIARO,032,EL CAZADERO,3,65,39,26,5
DURANGO,10,SANTIAGO PAPASQUIARO,032,EL COMEDERO,1,10,4,6,1
DURANGO,10,SANTIAGO PAPASQUIARO,032,EL ENCINAL,1,11,10,1,1
DURANGO,10,SANTIAGO PAPASQUIARO,032,EL GUAMÚCHIL,2,21,11,10,2
DURANGO,10,SANTIAGO PAPASQUIARO,032,EL NARANJITO,1,18,8,10,1
DURANGO,10,SANTIAGO PAPASQUIARO,032,EL PATIO DE ALTARES,1,23,15,8,1
DURANGO,10,SANTIAGO PAPASQUIARO,032,EL PORVENIR,1,27,14,13,2
DURANGO,10,SANTIAGO PAPASQUIARO,032,EL SALITRE,2,7,4,3,1
DURANGO,10,SANTIAGO PAPASQUIARO,032,EL SALVADOR,3,28,15,13,4
DURANGO,10,SANTIAGO PAPASQUIARO,032,EL TAMBOR,3,49,24,25,4
DURANGO,10,SANTIAGO PAPASQUIARO,032,EL TORREONCITO,2,5,3,2,2
DURANGO,10,SANTIAGO PAPASQUIARO,032,FRANCISCO JAVIER LEYVA,3,27,15,12,3
DURANGO,10,SANTIAGO PAPASQUIARO,032,GARAME DE ABAJO,3,53,33,20,4
DURANGO,10,SANTIAGO PAPASQUIARO,032,GARAME DE ARRIBA,2,33,16,17,3
DURANGO,10,SANTIAGO PAPASQUIARO,032,JOSÉ MARÍA MORELOS (CHINACATES),4,420,233,187,24
DURANGO,10,SANTIAGO PAPASQUIARO,032,JOSÉ SALOMÉ ACOSTA (EL OLOTE),3,30,13,17,3
DURANGO,10,SANTIAGO PAPASQUIARO,032,JOYA DE MONTOROS,2,5,4,1,2
DURANGO,10,SANTIAGO PAPASQUIARO,032,LA CAMPANA,2,54,34,20,5
DURANGO,10,SANTIAGO PAPASQUIARO,032,LA CAÑADA DE SAN MIGUEL,2,6,4,2,2
DURANGO,10,SANTIAGO PAPASQUIARO,032,LA CIÉNEGA DE SAN JOSÉ,3,33,20,13,3
DURANGO,10,SANTIAGO PAPASQUIARO,032,LA CIÉNEGA DEL CORREO,2,5,2,3,2
DURANGO,10,SANTIAGO PAPASQUIARO,032,LA ESTANCIA,1,18,8,10,1
DURANGO,10,SANTIAGO PAPASQUIARO,032,LA HUERTA,1,18,7,11,1
DURANGO,10,SANTIAGO PAPASQUIARO,032,LA LAGUNITA,3,37,19,18,5
DURANGO,10,SANTIAGO PAPASQUIARO,032,LA LOMA,1,16,5,11,1
DURANGO,10,SANTIAGO PAPASQUIARO,032,LA MOCHA,2,4,1,3,1
DURANGO,10,SANTIAGO PAPASQUIARO,032,LA PALESTINA,3,61,26,35,5
DURANGO,10,SANTIAGO PAPASQUIARO,032,LA SIERRITA,1,8,3,5,1
DURANGO,10,SANTIAGO PAPASQUIARO,032,LA SOLEDAD,1,7,5,2,1
DURANGO,10,SANTIAGO PAPASQUIARO,032,LAGUNA DE LA CHAPARRA (RANAS),3,53,30,23,4
DURANGO,10,SANTIAGO PAPASQUIARO,032,LAS CRUCES,2,21,6,15,2
DURANGO,10,SANTIAGO PAPASQUIARO,032,LAS FLORES,1,12,2,10,1
DURANGO,10,SANTIAGO PAPASQUIARO,032,LAS PALMAS,3,38,22,16,4
DURANGO,10,SANTIAGO PAPASQUIARO,032,LLANO PRIETO,2,7,3,4,1
DURANGO,10,SANTIAGO PAPASQUIARO,032,LOS ALGODONES,1,16,9,7,1
DURANGO,10,SANTIAGO PAPASQUIARO,032,LOS ALTARES,5,183,88,95,12
DURANGO,10,SANTIAGO PAPASQUIARO,032,LOS HERRERA,4,175,85,90,16
DURANGO,10,SANTIAGO PAPASQUIARO,032,LOS OJITOS (EL YAQUI),1,14,10,4,1
DURANGO,10,SANTIAGO PAPASQUIARO,032,LOS PASCUALES,2,5,4,1,1
DURANGO,10,SANTIAGO PAPASQUIARO,032,LOZANO ZAVALA (LA CAMPANA),1,14,5,9,1
DURANGO,10,SANTIAGO PAPASQUIARO,032,LUNA GONZÁLEZ,2,19,12,7,2
DURANGO,10,SANTIAGO PAPASQUIARO,032,MACHADO,1,14,5,9,1
DURANGO,10,SANTIAGO PAPASQUIARO,032,MADROÑO (EL MADROÑO),1,9,6,3,1
DURANGO,10,SANTIAGO PAPASQUIARO,032,MARTÍNEZ DE ABAJO,3,17,9,8,3
DURANGO,10,SANTIAGO PAPASQUIARO,032,MELCHOR OCAMPO,3,37,22,15,3
DURANGO,10,SANTIAGO PAPASQUIARO,032,MELEROS,3,8,5,3,2
DURANGO,10,SANTIAGO PAPASQUIARO,032,METATES,1,5,1,4,1
DURANGO,10,SANTIAGO PAPASQUIARO,032,MONTOROS,3,40,20,20,4
DURANGO,10,SANTIAGO PAPASQUIARO,032,NUEVO SAN DIEGO (EL CABALLO),4,189,93,96,13
DURANGO,10,SANTIAGO PAPASQUIARO,032,PUNTA DEL AGUA,1,4,2,2,1
DURANGO,10,SANTIAGO PAPASQUIARO,032,RANCHITO DE SAUCEDO,1,8,4,4,1
DURANGO,10,SANTIAGO PAPASQUIARO,032,RINCÓN DE HUAJUPA,1,16,9,7,1
DURANGO,10,SANTIAGO PAPASQUIARO,032,ROSA MORADA,1,27,13,14,2
DURANGO,10,SANTIAGO PAPASQUIARO,032,SAN ANTONIO DE LA SIERRA,2,10,6,4,2
DURANGO,10,SANTIAGO PAPASQUIARO,032,SAN ANTONIO DE NEVÁREZ,2,12,8,4,1
DURANGO,10,SANTIAGO PAPASQUIARO,032,SAN DIEGO DE TENZAENS,3,36,19,17,3
DURANGO,10,SANTIAGO PAPASQUIARO,032,SAN GREGORIO DE BOSÓS,2,7,3,4,2
DURANGO,10,SANTIAGO PAPASQUIARO,032,SAN IGNACIO,3,28,12,16,3
DURANGO,10,SANTIAGO PAPASQUIARO,032,SAN JAVIER,1,11,6,5,1
DURANGO,10,SANTIAGO PAPASQUIARO,032,SAN JOSÉ DE CAÑAS,1,9,7,2,1
DURANGO,10,SANTIAGO PAPASQUIARO,032,SAN JOSÉ DE FAVELAS (FAVELAS),2,19,12,7,2
DURANGO,10,SANTIAGO PAPASQUIARO,032,SAN JOSÉ DE LA CHAPARRA,1,4,3,1,1
DURANGO,10,SANTIAGO PAPASQUIARO,032,SAN JOSÉ DEL BONETE (EL BONETE),2,4,3,1,1
DURANGO,10,SANTIAGO PAPASQUIARO,032,SAN JOSÉ DEL PACHÓN,2,17,11,6,2
DURANGO,10,SANTIAGO PAPASQUIARO,032,SAN JULIÁN,2,6,2,4,2
DURANGO,10,SANTIAGO PAPASQUIARO,032,SAN MANUEL DE LA GALERA,1,6,2,4,1
DURANGO,10,SANTIAGO PAPASQUIARO,032,SAN MIGUEL DE LOS PINOS (RANCHO VIEJO),1,11,7,4,1
DURANGO,10,SANTIAGO PAPASQUIARO,032,SAN MIGUEL DE PAPASQUIARO,4,180,88,92,5
DURANGO,10,SANTIAGO PAPASQUIARO,032,SAN MIGUEL DEL ALTO,3,56,29,27,4
DURANGO,10,SANTIAGO PAPASQUIARO,032,SAN MIGUEL DEL CANTIL,2,30,14,16,3
DURANGO,10,SANTIAGO PAPASQUIARO,032,SAN NICOLÁS,3,78,39,39,8
DURANGO,10,SANTIAGO PAPASQUIARO,032,SAN PABLO,2,4,2,2,2
DURANGO,10,SANTIAGO PAPASQUIARO,032,SAN PEDRO DE TENERAPA,3,48,26,22,4
DURANGO,10,SANTIAGO PAPASQUIARO,032,SANDOVALES,1,12,7,5,1
DURANGO,10,SANTIAGO PAPASQUIARO,032,SANTA CRUZ DE LOS OJITOS (LOS OJITOS),2,13,6,7,2
DURANGO,10,SANTIAGO PAPASQUIARO,032,SANTA CRUZ DE MACOS,2,17,9,8,2
DURANGO,10,SANTIAGO PAPASQUIARO,032,SANTA EFIGENIA,1,12,5,7,2
DURANGO,10,SANTIAGO PAPASQUIARO,032,SANTA RITA DEL PACHÓN (SANTA RITA),1,17,9,8,1
DURANGO,10,SANTIAGO PAPASQUIARO,032,SANTA TERESA DEL PACHÓN (SANTA TERESA),1,13,6,7,1
DURANGO,10,SANTIAGO PAPASQUIARO,032,SANTIAGO PAPASQUIARO,45,9568,4849,4719,624
DURANGO,10,SANTIAGO PAPASQUIARO,032,SAUCEDO (LA CUEVA DE SAUCEDO),2,7,5,2,2
DURANGO,10,SANTIAGO PAPASQUIARO,032,SOYUPA,2,26,8,18,2
DURANGO,10,SANTIAGO PAPASQUIARO,032,VASCOGIL,3,50,30,20,4
DURANGO,10,SÚCHIL,033,ALEJANDRO,3,73,34,39,4
DURANGO,10,SÚCHIL,033,ALEMÁN (ALEMÁN VIEJO),1,27,13,14,2
DURANGO,10,SÚCHIL,033,EL ALEMÁN (EL ALEMÁN NUEVO),2,16,9,7,2
DURANGO,10,SÚCHIL,033,EMILIANO ZAPATA (LOS COCONOS),3,29,15,14,3
DURANGO,10,SÚCHIL,033,HACIENDA EL MORTERO,1,2,0,2,1
DURANGO,10,SÚCHIL,033,LA SOLEDAD,3,41,18,23,4
DURANGO,10,SÚCHIL,033,LAS MARGARITAS,2,9,7,2,1
DURANGO,10,SÚCHIL,033,LUIS ECHEVERRÍA (LA QUEMADA),2,24,9,15,2
DURANGO,10,SÚCHIL,033,MESA DE SAN ANTONIO (EL LLANO),1,41,23,18,2
DURANGO,10,SÚCHIL,033,MESA DE TABACOS,4,122,47,75,6
DURANGO,10,SÚCHIL,033,SAN JUAN DE MICHIS,3,79,47,32,5
DURANGO,10,SÚCHIL,033,SAN MIGUEL DE LA MICHILÍA,4,209,117,92,12
DURANGO,10,SÚCHIL,033,SANTA CRUZ,2,5,3,2,1
DURANGO,10,SÚCHIL,033,SÚCHIL,9,1169,580,589,94
DURANGO,10,TAMAZULA,034,ACACHUANE,2,18,7,11,2
DURANGO,10,TAMAZULA,034,ACATITÁN,3,49,21,28,4
DURANGO,10,TAMAZULA,034,AGUA CALIENTE,2,26,10,16,2
DURANGO,10,TAMAZULA,034,AGUAJE GRANDE,1,10,3,7,1
DURANGO,10,TAMAZULA,034,AGUATITA,1,8,4,4,1
DURANGO,10,TAMAZULA,034,AMACUABLE,2,27,14,13,3
DURANGO,10,TAMAZULA,034,AMACULÍ,3,79,39,40,7
DURANGO,10,TAMAZULA,034,ARROYO GRANDE,1,8,7,1,1
DURANGO,10,TAMAZULA,034,BASTANTITAS DE ABAJO,3,69,29,40,5
DURANGO,10,TAMAZULA,034,CARRICITOS,4,18,11,7,3
DURANGO,10,TAMAZULA,034,CHACALA,3,61,34,27,4
DURANGO,10,TAMAZULA,034,CHAPOTÁN,2,46,21,25,3
DURANGO,10,TAMAZULA,034,CIÉNEGA DE LOS BELTRANES,1,14,7,7,1
DURANGO,10,TAMAZULA,034,COACOYOLE,2,12,7,5,2
DURANGO,10,TAMAZULA,034,COLOMA,2,34,14,20,3
DURANGO,10,TAMAZULA,034,COLUTA,3,118,57,61,6
DURANGO,10,TAMAZULA,034,DOS DE ABRIL,3,39,21,18,4
DURANGO,10,TAMAZULA,034,EL AGUAJE,5,50,23,27,6
DURANGO,10,TAMAZULA,034,EL BAJÍO,1,31,17,14,2
DURANGO,10,TAMAZULA,034,EL BARCO,1,16,10,6,2
DURANGO,10,TAMAZULA,034,EL CARRIZAL,2,48,25,23,3
DURANGO,10,TAMAZULA,034,EL CARRIZAL DE COLUTA,1,4,2,2,1
DURANGO,10,TAMAZULA,034,EL CARRIZO DE AMACULÍ,2,5,1,4,2
DURANGO,10,TAMAZULA,034,EL CARRIZO DE LA PETACA,1,17,9,8,2
DURANGO,10,TAMAZULA,034,EL CHICURAL,3,27,15,12,3
DURANGO,10,TAMAZULA,034,EL CONFITAL,1,19,9,10,1
DURANGO,10,TAMAZULA,034,EL DURAZNO,4,545,275,270,38
DURANGO,10,TAMAZULA,034,EL ESPÍRITU,1,6,4,2,1
DURANGO,10,TAMAZULA,034,EL FRIJOLAR,3,58,32,26,4
DURANGO,10,TAMAZULA,034,EL GACHUPÍN,3,52,23,29,4
DURANGO,10,TAMAZULA,034,EL GUAMÚCHIL,1,13,8,5,1
DURANGO,10,TAMAZULA,034,EL GUAYABO,2,24,15,9,2
DURANGO,10,TAMAZULA,034,EL IGUALAMO,3,40,24,16,4
DURANGO,10,TAMAZULA,034,EL JAGÜITAL,3,33,17,16,4
DURANGO,10,TAMAZULA,034,EL JUDÍO,1,20,13,7,2
DURANGO,10,TAMAZULA,034,EL LIMÓN,2,26,10,16,2
DURANGO,10,TAMAZULA,034,EL LIMÓN DE COPALQUÍN,1,29,16,13,2
DURANGO,10,TAMAZULA,034,EL LLANO,1,7,3,4,1
DURANGO,10,TAMAZULA,034,EL LLANO REDONDO,2,18,13,5,2
DURANGO,10,TAMAZULA,034,EL MUERTECITO,2,13,6,7,2
DURANGO,10,TAMAZULA,034,EL MUERTO,1,12,6,6,1
DURANGO,10,TAMAZULA,034,EL OSO,2,4,1,3,1
DURANGO,10,TAMAZULA,034,EL PALMAR,2,19,11,8,2
DURANGO,10,TAMAZULA,034,EL PALMAREJO,2,22,9,13,2
DURANGO,10,TAMAZULA,034,EL PINO,2,24,7,17,3
DURANGO,10,TAMAZULA,034,EL PORTEZUELO (EL LIMONCITO),1,13,6,7,1
DURANGO,10,TAMAZULA,034,EL POTRERO,6,22,10,12,4
DURANGO,10,TAMAZULA,034,EL POTRERO DE ABAJO,2,33,16,17,3
DURANGO,10,TAMAZULA,034,EL POTRERO DE ARRIBA,1,29,14,15,2
DURANGO,10,TAMAZULA,034,EL POTRERO DE LA VENTANA,1,28,15,13,2
DURANGO,10,TAMAZULA,034,EL POTRERO DE MACABRESTO,1,9,5,4,1
DURANGO,10,TAMAZULA,034,EL PUERTO DE LA CIÉNEGA,1,5,2,3,1
DURANGO,10,TAMAZULA,034,EL RANCHITO,1,16,3,13,1
DURANGO,10,TAMAZULA,034,EL REALITO DE LA VENTANA,1,10,6,4,1
DURANGO,10,TAMAZULA,034,EL RINCÓN,1,2,0,2,1
DURANGO,10,TAMAZULA,034,EL RODEO,1,12,4,8,1
DURANGO,10,TAMAZULA,034,EL SALTO DE TABAHUETO,1,15,9,6,1
DURANGO,10,TAMAZULA,034,EL TACHINOLE,1,5,3,2,1
DURANGO,10,TAMAZULA,034,EL TÁPALE,1,4,1,3,1
DURANGO,10,TAMAZULA,034,EL TASTE,1,7,4,3,1
DURANGO,10,TAMAZULA,034,EL TECUÁN,4,124,61,63,10
DURANGO,10,TAMAZULA,034,EL TIGRE,2,14,7,7,2
DURANGO,10,TAMAZULA,034,EL TORO,2,7,2,5,1
DURANGO,10,TAMAZULA,034,EL ZAPATERO,2,22,9,13,2
DURANGO,10,TAMAZULA,034,GUADALUPE DE URREA,2,22,9,13,2
DURANGO,10,TAMAZULA,034,GUAJOLOTES,3,28,13,15,3
DURANGO,10,TAMAZULA,034,HACIENDA DE CAMARONES,1,5,0,5,1
DURANGO,10,TAMAZULA,034,HUIZOLIXTA,2,32,14,18,3
DURANGO,10,TAMAZULA,034,JALA,2,48,22,26,4
DURANGO,10,TAMAZULA,034,LA AGUATECA,3,14,6,8,3
DURANGO,10,TAMAZULA,034,LA ALAMEDA,3,44,23,21,4
DURANGO,10,TAMAZULA,034,LA BOCA DEL ARROYO,1,9,4,5,1
DURANGO,10,TAMAZULA,034,LA CAMPANA,1,22,11,11,2
DURANGO,10,TAMAZULA,034,LA CEBADILLA,5,49,20,29,5
DURANGO,10,TAMAZULA,034,LA CIÉNEGA,1,5,1,4,1
DURANGO,10,TAMAZULA,034,LA CIÉNEGA DE OTATES,1,14,7,7,1
DURANGO,10,TAMAZULA,034,LA CIÉNEGA DEL TULE,3,60,28,32,4
DURANGO,10,TAMAZULA,034,LA CIENEGUITA,3,24,5,19,3
DURANGO,10,TAMAZULA,034,LA COFRADÍA,1,10,5,5,1
DURANGO,10,TAMAZULA,034,LA CRUZ,1,9,6,3,1
DURANGO,10,TAMAZULA,034,LA CUEVA SANTA,1,2,1,1,1
DURANGO,10,TAMAZULA,034,LA CUPÍA,1,13,7,6,1
DURANGO,10,TAMAZULA,034,LA GUACAMAYA,1,4,1,3,1
DURANGO,10,TAMAZULA,034,LA GÜICHI,1,3,3,0,1
DURANGO,10,TAMAZULA,034,LA HIGUERA,1,25,12,13,1
DURANGO,10,TAMAZULA,034,LA HIGUERA HUECA,2,10,4,6,1
DURANGO,10,TAMAZULA,034,LA HIGUERITA,1,5,3,2,1
DURANGO,10,TAMAZULA,034,LA MANTECOSA,1,10,6,4,1
DURANGO,10,TAMAZULA,034,LA MÁQUINA,2,9,4,5,1
DURANGO,10,TAMAZULA,034,LA MESA ANCHA,2,66,29,37,3
DURANGO,10,TAMAZULA,034,LA MESA DE LA PERRA,1,4,1,3,1
DURANGO,10,TAMAZULA,034,LA MESA DEL DURAZNITO,1,5,0,5,1
DURANGO,10,TAMAZULA,034,LA MESA DEL OCOTE (MESA ANCHA),1,32,13,19,2
DURANGO,10,TAMAZULA,034,LA MESA DEL RODEO,2,30,14,16,3
DURANGO,10,TAMAZULA,034,LA NUEVA ROSITA MORADA,2,22,13,9,2
DURANGO,10,TAMAZULA,034,LA PALMA,2,15,8,7,2
DURANGO,10,TAMAZULA,034,LA PANTERA,2,14,7,7,2
DURANGO,10,TAMAZULA,034,LA PRESA,2,35,22,13,3
DURANGO,10,TAMAZULA,034,LA SIERRITA,1,25,13,12,2
DURANGO,10,TAMAZULA,034,LA TABLETA,1,3,1,2,1
DURANGO,10,TAMAZULA,034,LA TRAMPA,2,38,19,19,3
DURANGO,10,TAMAZULA,034,LA VAINILLA,2,6,2,4,1
DURANGO,10,TAMAZULA,034,LAS BANQUETAS,3,17,5,12,3
DURANGO,10,TAMAZULA,034,LAS COLORADITAS,1,9,5,4,1
DURANGO,10,TAMAZULA,034,LAS CUEVAS,3,36,20,16,3
DURANGO,10,TAMAZULA,034,LAS CUEVAS DE ABAJO,2,8,4,4,2
DURANGO,10,TAMAZULA,034,LAS DURAS,1,4,0,4,1
DURANGO,10,TAMAZULA,034,LAS GARROCHAS,2,31,14,17,3
DURANGO,10,TAMAZULA,034,LAS HIGUERAS,1,11,7,4,1
DURANGO,10,TAMAZULA,034,LAS HIGUERITAS,2,31,17,14,2
DURANGO,10,TAMAZULA,034,LAS IGLESIAS,3,17,9,8,3
DURANGO,10,TAMAZULA,034,LAS JOYAS,1,3,0,3,1
DURANGO,10,TAMAZULA,034,LAS LAJAS,2,49,23,26,4
DURANGO,10,TAMAZULA,034,LAS MESAS DE COLUTA,2,4,2,2,1
DURANGO,10,TAMAZULA,034,LAS MILPAS [ASERRADERO],3,80,28,52,5
DURANGO,10,TAMAZULA,034,LAS PALMAS,1,5,1,4,1
DURANGO,10,TAMAZULA,034,LOS AGUAJITOS,1,14,6,8,1
DURANGO,10,TAMAZULA,034,LOS BAJÍOS,3,18,11,7,3
DURANGO,10,TAMAZULA,034,LOS FRAILES,4,106,55,51,9
DURANGO,10,TAMAZULA,034,LOS GIOTES,1,5,2,3,1
DURANGO,10,TAMAZULA,034,LOS JACALES,1,3,1,2,1
DURANGO,10,TAMAZULA,034,LOS LLANITOS,3,39,15,24,3
DURANGO,10,TAMAZULA,034,LOS MEDIOS,2,23,15,8,2
DURANGO,10,TAMAZULA,034,LOS PLÁTANOS,1,5,3,2,1
DURANGO,10,TAMAZULA,034,LOS REMEDIOS,4,327,177,150,16
DURANGO,10,TAMAZULA,034,LOS REYES,1,26,12,14,2
DURANGO,10,TAMAZULA,034,LOS REYES DE COPALQUÍN,2,8,2,6,1
DURANGO,10,TAMAZULA,034,LOS SAUCES,1,4,3,1,1
DURANGO,10,TAMAZULA,034,LOS TEJABANES,3,33,18,15,3
DURANGO,10,TAMAZULA,034,LOS VASITOS,1,17,6,11,1
DURANGO,10,TAMAZULA,034,MARROQUINCILLO,2,15,6,9,2
DURANGO,10,TAMAZULA,034,MESA DE LOS BECERROS,2,11,6,5,2
DURANGO,10,TAMAZULA,034,NOROTAL,2,28,13,15,2
DURANGO,10,TAMAZULA,034,OSOS BRAVOS,2,49,29,20,4
DURANGO,10,TAMAZULA,034,PALMILLAS,3,27,15,12,3
DURANGO,10,TAMAZULA,034,PIE DE LA CUESTA,1,22,10,12,1
DURANGO,10,TAMAZULA,034,PIE DE LA CUESTA DE PALMILLAS,2,24,13,11,2
DURANGO,10,TAMAZULA,034,PITO REAL,1,4,0,4,1
DURANGO,10,TAMAZULA,034,PITORREAL,3,48,22,26,4
DURANGO,10,TAMAZULA,034,POTRERO DE JALA,1,10,4,6,1
DURANGO,10,TAMAZULA,034,QUEBRADA DE LOS DURÁN,1,3,1,2,1
DURANGO,10,TAMAZULA,034,QUEBRADA DE LOS SÁNCHEZ,2,26,13,13,3
DURANGO,10,TAMAZULA,034,QUENIBAS,1,9,4,5,1
DURANGO,10,TAMAZULA,034,RANCHITO QUEMADO,2,12,6,6,2
DURANGO,10,TAMAZULA,034,RANCHO SAN DIEGO,2,44,20,24,3
DURANGO,10,TAMAZULA,034,RINCÓN DE LOS MACEDO,2,51,21,30,3
DURANGO,10,TAMAZULA,034,SAHUATENIPA,3,23,13,10,3
DURANGO,10,TAMAZULA,034,SAN ANTONIO DE LA CUEVA,2,12,3,9,2
DURANGO,10,TAMAZULA,034,SAN CAYETANO DE PERICOS,3,46,21,25,4
DURANGO,10,TAMAZULA,034,SAN DARÍO,1,5,2,3,1
DURANGO,10,TAMAZULA,034,SAN FERNANDO,1,10,2,8,1
DURANGO,10,TAMAZULA,034,SAN IGNACIO,3,22,9,13,3
DURANGO,10,TAMAZULA,034,SAN JORGE,1,12,5,7,1
DURANGO,10,TAMAZULA,034,SAN JOSÉ DE CHIQUERITOS,2,19,12,7,2
DURANGO,10,TAMAZULA,034,SAN JOSÉ DE VIBORILLAS,1,4,2,2,1
DURANGO,10,TAMAZULA,034,SAN JUAN,1,13,6,7,1
DURANGO,10,TAMAZULA,034,SAN JUAN DEL TECUAN,2,30,19,11,3
DURANGO,10,TAMAZULA,034,SAN LUISITO,1,15,8,7,1
DURANGO,10,TAMAZULA,034,SANTA ANA,4,68,37,31,5
DURANGO,10,TAMAZULA,034,SANTA ELENA (LA MONTE),1,8,6,2,1
DURANGO,10,TAMAZULA,034,SANTA GERTRUDIS,4,240,124,116,14
DURANGO,10,TAMAZULA,034,SANTA MARÍA DE LOS REMEDIOS,1,24,13,11,2
DURANGO,10,TAMAZULA,034,TAMAZULA DE VICTORIA,6,1393,696,697,79
DURANGO,10,TAMAZULA,034,TANIBOL,1,2,0,2,1
DURANGO,10,TAMAZULA,034,TODOS SANTOS,3,72,39,33,5
DURANGO,10,TAMAZULA,034,VALLECILLOS,2,21,10,11,2
DURANGO,10,TAMAZULA,034,VETILLAS,1,7,3,4,1
DURANGO,10,TAMAZULA,034,VIBORILLAS,1,9,8,1,1
DURANGO,10,TEPEHUANES,035,ACAPULCO,1,3,3,0,1
DURANGO,10,TEPEHUANES,035,BARAJAS,2,20,9,11,2
DURANGO,10,TEPEHUANES,035,CAPULÍN DE METATES,1,13,9,4,1
DURANGO,10,TEPEHUANES,035,CARRERAS,1,6,4,2,1
DURANGO,10,TEPEHUANES,035,CIÉNEGA DE CABALLOS,2,28,17,11,3
DURANGO,10,TEPEHUANES,035,CIÉNEGA DE ESCOBAR,3,28,14,14,3
DURANGO,10,TEPEHUANES,035,CIÉNEGA DE LOS FRAILES,2,9,4,5,1
DURANGO,10,TEPEHUANES,035,EL CONEJO,3,43,22,21,4
DURANGO,10,TEPEHUANES,035,EL GATO DE ARRIBA,4,84,40,44,7
DURANGO,10,TEPEHUANES,035,EL PEÑOL,1,4,3,1,1
DURANGO,10,TEPEHUANES,035,EL PURGATORIO,1,3,2,1,1
DURANGO,10,TEPEHUANES,035,EL REFUGIO (EL REFUGIO DE LOS LOBOS),1,10,5,5,1
DURANGO,10,TEPEHUANES,035,EL RINCÓN,1,7,5,2,1
DURANGO,10,TEPEHUANES,035,EL TAISTE,1,11,6,5,1
DURANGO,10,TEPEHUANES,035,EL TARAHUMAR,1,11,4,7,1
DURANGO,10,TEPEHUANES,035,EL TULE,1,20,11,9,1
DURANGO,10,TEPEHUANES,035,JOYA DE LAS VIUDAS,1,6,4,2,1
DURANGO,10,TEPEHUANES,035,LA ATASCOSA,1,6,1,5,1
DURANGO,10,TEPEHUANES,035,LA BUFA,1,21,10,11,1
DURANGO,10,TEPEHUANES,035,LA CONCEPCIÓN DE LAS IGLESIAS (EL PEDREGAL),2,4,2,2,1
DURANGO,10,TEPEHUANES,035,LA JOYA DE CHIQUEROS,1,3,1,2,1
DURANGO,10,TEPEHUANES,035,LA JOYA DEL VENADO,1,14,9,5,1
DURANGO,10,TEPEHUANES,035,LA LAGUNITA,1,5,3,2,1
DURANGO,10,TEPEHUANES,035,LA PURÍSIMA,2,22,10,12,2
DURANGO,10,TEPEHUANES,035,LA SOLEDAD DE SAN ISIDRO (LA SOLEDAD),1,12,7,5,1
DURANGO,10,TEPEHUANES,035,LAS CRUCES,3,20,8,12,3
DURANGO,10,TEPEHUANES,035,LAS CRUCES DE BARAJAS,2,11,7,4,2
DURANGO,10,TEPEHUANES,035,LAS FLORES,1,12,5,7,1
DURANGO,10,TEPEHUANES,035,LAS IGLESIAS,1,3,1,2,1
DURANGO,10,TEPEHUANES,035,LOS BAGRES,2,35,19,16,3
DURANGO,10,TEPEHUANES,035,LOS CORRALES,3,26,15,11,3
DURANGO,10,TEPEHUANES,035,MESA DE LOS NÁVAR,3,43,21,22,3
DURANGO,10,TEPEHUANES,035,PIE DE LA CUESTA,2,9,4,5,2
DURANGO,10,TEPEHUANES,035,POTRERILLOS,2,10,5,5,2
DURANGO,10,TEPEHUANES,035,POTRERO DE CHÁIDEZ,3,42,21,21,4
DURANGO,10,TEPEHUANES,035,PRESIDIO DE ABAJO (LA CANDELA),1,12,8,4,1
DURANGO,10,TEPEHUANES,035,SAN GERÓNIMO,2,25,14,11,2
DURANGO,10,TEPEHUANES,035,SAN IGNACIO DE LA SIERRA,2,5,1,4,1
DURANGO,10,TEPEHUANES,035,SAN ISIDRO DE LAS CALABAZAS (LAS CALABAZAS),1,13,3,10,1
DURANGO,10,TEPEHUANES,035,SAN JOSÉ DE LA BOCA,3,184,93,91,12
DURANGO,10,TEPEHUANES,035,SAN JUAN DEL NEGRO (SAN JUAN),2,25,11,14,2
DURANGO,10,TEPEHUANES,035,SAN MIGUEL DE LOBOS,1,14,6,8,1
DURANGO,10,TEPEHUANES,035,SAN NICOLÁS DE PRESIDIO (PRESIDIO DE ARRIBA),1,4,1,3,1
DURANGO,10,TEPEHUANES,035,SAN RAFAEL,2,15,11,4,2
DURANGO,10,TEPEHUANES,035,SANDÍAS (EL VADO DE SANDÍAS),1,10,4,6,1
DURANGO,10,TEPEHUANES,035,SANTA CATARINA DE TEPEHUANES,9,1295,684,611,67
DURANGO,10,TEPEHUANES,035,TORO QUEMADO,3,24,10,14,3
DURANGO,10,TEPEHUANES,035,YERBABUENA,1,13,4,9,1
DURANGO,10,TLAHUALILO,036,AMAPOLAS,1,8,5,3,1
DURANGO,10,TLAHUALILO,036,BALCONES,2,27,13,14,2
DURANGO,10,TLAHUALILO,036,BANCO NACIONAL,3,179,87,92,12
DURANGO,10,TLAHUALILO,036,CECEDA,3,43,22,21,4
DURANGO,10,TLAHUALILO,036,DIVISIÓN DEL NORTE,2,22,10,12,2
DURANGO,10,TLAHUALILO,036,EL CUARENTA (EL BARRO),2,33,16,17,3
DURANGO,10,TLAHUALILO,036,EL LUCERO (ARCINAS),5,921,447,474,69
DURANGO,10,TLAHUALILO,036,EL RENEGADO (LA PERLA),1,8,3,5,1
DURANGO,10,TLAHUALILO,036,JAUJA,3,194,89,105,19
DURANGO,10,TLAHUALILO,036,LA CAMPANA,4,165,89,76,10
DURANGO,10,TLAHUALILO,036,LA SIERRITA,2,28,14,14,2
DURANGO,10,TLAHUALILO,036,MORELOS (LA LOMA YERMO) [GRANJA],4,165,76,89,9
DURANGO,10,TLAHUALILO,036,NOMBRE DE DIOS,2,13,6,7,2
DURANGO,10,TLAHUALILO,036,NUEVO MÉXICO,3,64,31,33,4
DURANGO,10,TLAHUALILO,036,OQUENDO,1,19,5,14,1
DURANGO,10,TLAHUALILO,036,PAMPLONA,3,92,48,44,6
DURANGO,10,TLAHUALILO,036,POMPEYA,2,51,27,24,3
DURANGO,10,TLAHUALILO,036,PROVIDENCIA,2,27,5,22,2
DURANGO,10,TLAHUALILO,036,ROSAS,3,61,26,35,5
DURANGO,10,TLAHUALILO,036,SAN FRANCISCO DE HORIZONTE (HORIZONTE),3,334,173,161,23
DURANGO,10,TLAHUALILO,036,SAN JULIO,2,194,97,97,9
DURANGO,10,TLAHUALILO,036,SAN MIGUEL DEL REAL,2,23,11,12,2
DURANGO,10,TLAHUALILO,036,TLAHUALILO DE ZARAGOZA,14,2327,1142,1185,154
DURANGO,10,TOPIA,037,AGUA BLANCA DE LOS ROCHA,1,7,4,3,1
DURANGO,10,TOPIA,037,AGUA ESCONDIDA,1,9,6,3,1
DURANGO,10,TOPIA,037,EL BARRANCO (SAN JOSÉ DE LOS BARRANCOS),1,3,2,1,1
DURANGO,10,TOPIA,037,EL CARMEN,1,11,6,5,1
DURANGO,10,TOPIA,037,EL COMEDERO,2,12,8,4,2
DURANGO,10,TOPIA,037,EL DESTIERRO,2,28,16,12,2
DURANGO,10,TOPIA,037,EL LAUREL,1,9,2,7,1
DURANGO,10,TOPIA,037,EL NURITO,2,17,9,8,2
DURANGO,10,TOPIA,037,EL PALMAREJITO,3,64,34,30,4
DURANGO,10,TOPIA,037,EL PINO,2,10,5,5,2
DURANGO,10,TOPIA,037,EL PLATANAR DE SIANORI,4,171,94,77,8
DURANGO,10,TOPIA,037,EL PUEBLO NUEVO,1,2,0,2,1
DURANGO,10,TOPIA,037,EL RINCÓN DE GALANCITA (EL RINCÓN DE LOS ALISOS),1,8,5,3,1
DURANGO,10,TOPIA,037,EL VENTOSO,1,2,0,2,1
DURANGO,10,TOPIA,037,GALANCITA,3,123,67,56,8
DURANGO,10,TOPIA,037,HACIENDA DE RUEDA,2,4,3,1,1
DURANGO,10,TOPIA,037,LA CIENEGUITA,2,3,0,3,1
DURANGO,10,TOPIA,037,LA COCHA,2,11,4,7,2
DURANGO,10,TOPIA,037,LA ESTANZUELA,1,5,2,3,1
DURANGO,10,TOPIA,037,LA HUERTA,3,29,14,15,3
DURANGO,10,TOPIA,037,LA JOYA,1,3,2,1,1
DURANGO,10,TOPIA,037,LA JUNTA DE LOS HERNÁNDEZ (LA JUNTA),1,3,0,3,1
DURANGO,10,TOPIA,037,LA MESA ROSADA,2,5,4,1,1
DURANGO,10,TOPIA,037,LA OJEDA,3,59,31,28,4
DURANGO,10,TOPIA,037,LA SIERRITA DE SANTA BÁRBARA,1,13,2,11,1
DURANGO,10,TOPIA,037,LA TINAJA,2,8,4,4,1
DURANGO,10,TOPIA,037,LA VEGA DEL OSO,3,23,8,15,3
DURANGO,10,TOPIA,037,LAS ADJUNTAS,2,59,32,27,4
DURANGO,10,TOPIA,037,LAS PAPAS,3,21,12,9,3
DURANGO,10,TOPIA,037,LAS TRANCAS,2,5,2,3,1
DURANGO,10,TOPIA,037,LOS DE DIARTE,2,37,15,22,3
DURANGO,10,TOPIA,037,LOS LAURELES,2,6,2,4,2
DURANGO,10,TOPIA,037,LOS PINOS,3,57,29,28,4
DURANGO,10,TOPIA,037,MANZANILLA,2,6,4,2,2
DURANGO,10,TOPIA,037,MOLINOS,2,15,7,8,2
DURANGO,10,TOPIA,037,PIE DE LA CUESTA,3,7,4,3,2
DURANGO,10,TOPIA,037,RANCHO DE ABAJO,1,4,2,2,1
DURANGO,10,TOPIA,037,RANCHO DE TÍO JUAN,3,44,22,22,4
DURANGO,10,TOPIA,037,RANCHO VIEJO I,1,4,3,1,1
DURANGO,10,TOPIA,037,RENTERÍA,1,16,8,8,1
DURANGO,10,TOPIA,037,RINCÓN DE CRUCES,1,16,2,14,1
DURANGO,10,TOPIA,037,RINCÓN DE SIANORI (RINCÓN VIEJO),2,27,10,17,2
DURANGO,10,TOPIA,037,SAN ANTONIO,2,26,11,15,2
DURANGO,10,TOPIA,037,SAN BERNABÉ,3,21,9,12,3
DURANGO,10,TOPIA,037,SIANORI,1,18,12,6,1
DURANGO,10,TOPIA,037,TOPIA,4,777,417,360,41
DURANGO,10,TOPIA,037,TORANCE,3,41,20,21,3
DURANGO,10,TOPIA,037,VALLE DE TOPIA,4,188,109,79,11
DURANGO,10,VICENTE GUERRERO,038,ALFREDO V. BONFIL (POMPEYA),3,12,3,9,2
DURANGO,10,VICENTE GUERRERO,038,EL ANCÓN,2,73,37,36,4
DURANGO,10,VICENTE GUERRERO,038,ESTACIÓN VICENTE GUERRERO,3,66,31,35,4
DURANGO,10,VICENTE GUERRERO,038,GRACEROS,3,184,97,87,11
DURANGO,10,VICENTE GUERRERO,038,SAN FRANCISCO JAVIER,4,387,194,193,23
DURANGO,10,VICENTE GUERRERO,038,SAN ISIDRO DE MURILLOS,4,216,113,103,14
DURANGO,10,VICENTE GUERRERO,038,SAN JOSÉ DE LAS CORRIENTES,3,127,66,61,8
DURANGO,10,VICENTE GUERRERO,038,SAN JOSÉ DEL MOLINO,1,10,6,4,1
DURANGO,10,VICENTE GUERRERO,038,SAN PEDRO ALCÁNTARA,3,80,40,40,5
DURANGO,10,VICENTE GUERRERO,038,VICENTE GUERRERO,26,5390,2708,2682,294
DURANGO,10,NUEVO IDEAL,039,ASTILLEROS DE ABAJO,2,18,13,5,2
DURANGO,10,NUEVO IDEAL,039,BENITO JUÁREZ (JUÁREZ DE ABAJO),3,53,27,26,4
DURANGO,10,NUEVO IDEAL,039,BUENA UNIÓN,3,80,39,41,5
DURANGO,10,NUEVO IDEAL,039,CAMPO HERMOSO,2,49,22,27,3
DURANGO,10,NUEVO IDEAL,039,CARTAGENA,1,13,9,4,1
DURANGO,10,NUEVO IDEAL,039,CHAPALA,1,8,7,1,1
DURANGO,10,NUEVO IDEAL,039,DOCTOR CASTILLO DEL VALLE (LAS HUERTAS),4,150,78,72,20
DURANGO,10,NUEVO IDEAL,039,EL MOLINO,2,17,9,8,2
DURANGO,10,NUEVO IDEAL,039,EL NUEVO PORVENIR,3,79,42,37,5
DURANGO,10,NUEVO IDEAL,039,ESFUERZOS UNIDOS,3,225,119,106,13
DURANGO,10,NUEVO IDEAL,039,FUENTE DEL LLANO (SANTIAGUILLO),3,85,43,42,5
DURANGO,10,NUEVO IDEAL,039,GUATIMAPÉ,4,458,222,236,31
DURANGO,10,NUEVO IDEAL,039,GUILLERMO PRIETO,3,78,39,39,5
DURANGO,10,NUEVO IDEAL,039,LA ESCONDIDA,3,48,27,21,4
DURANGO,10,NUEVO IDEAL,039,LIBERTADORES DEL LLANO (SANTA SOFÍA),2,24,13,11,3
DURANGO,10,NUEVO IDEAL,039,MELCHOR OCAMPO (EL TRÉBOL),3,56,24,32,4
DURANGO,10,NUEVO IDEAL,039,MIGUEL NEGRETE (EL TOBOSO),3,182,87,95,11
DURANGO,10,NUEVO IDEAL,039,MODESTO QUEZADA (JUÁREZ DE ARRIBA),1,10,5,5,1
DURANGO,10,NUEVO IDEAL,039,NUEVO IDEAL,18,3795,1910,1885,206
DURANGO,10,NUEVO IDEAL,039,ONCE DE MARZO (TRINCHERAS),3,32,18,14,4
DURANGO,10,NUEVO IDEAL,039,PINOS ALTOS,3,93,49,44,6
DURANGO,10,NUEVO IDEAL,039,RAÚL MADERO,3,68,31,37,5
DURANGO,10,NUEVO IDEAL,039,SAN JOSÉ DE MORILLITOS (LA PERLA),3,123,69,54,9
DURANGO,10,NUEVO IDEAL,039,SAN MIGUEL DE ALLENDE,2,68,26,42,4
DURANGO,10,NUEVO IDEAL,039,TEJAMEN,3,83,41,42,7
DURANGO,10,NUEVO IDEAL,039,VALLE FLORIDO (EL REFUGIO),3,24,12,12,4
DURANGO,10,NUEVO IDEAL,039,VILLA HERMOSA,4,131,62,69,9
GUANAJUATO,11,ABASOLO,001,ABASOLO,40,9314,4718,4596,491
GUANAJUATO,11,ABASOLO,001,ALTO DE ALCOCER,2,105,54,51,4
GUANAJUATO,11,ABASOLO,001,ALTO DE CHAMACUA,2,89,45,44,4
GUANAJUATO,11,ABASOLO,001,ALTO DE SAN JOSÉ DE GONZÁLEZ,2,87,46,41,5
GUANAJUATO,11,ABASOLO,001,BERUMBO,2,40,17,23,3
GUANAJUATO,11,ABASOLO,001,BOQUILLAS,5,565,255,310,24
GUANAJUATO,11,ABASOLO,001,BUENAVISTA DE VEGA (LAS CONEJAS),1,6,1,5,1
GUANAJUATO,11,ABASOLO,001,CERRITOS DE ACEVES,3,109,53,56,6
GUANAJUATO,11,ABASOLO,001,CHAMACUA,4,226,110,116,13
GUANAJUATO,11,ABASOLO,001,COFRADÍA DE GUERRA,2,82,38,44,5
GUANAJUATO,11,ABASOLO,001,COFRADÍA DE PERALTA,2,46,23,23,2
GUANAJUATO,11,ABASOLO,001,COLONIA HERMOSILLO,2,158,82,76,7
GUANAJUATO,11,ABASOLO,001,COLONIA LOS ÁNGELES,1,17,7,10,1
GUANAJUATO,11,ABASOLO,001,EJIDO DE TLANALAPA (COLONIA DE LA ESPERANZA),2,88,45,43,4
GUANAJUATO,11,ABASOLO,001,EL ENCINAL,1,4,1,3,1
GUANAJUATO,11,ABASOLO,001,EL FRESNO,2,17,7,10,2
GUANAJUATO,11,ABASOLO,001,EL GALLITO (EL PITAHAYO),2,91,48,43,4
GUANAJUATO,11,ABASOLO,001,EL REFUGIO DE AYALA (LUZ DE AYALA),1,11,5,6,1
GUANAJUATO,11,ABASOLO,001,EL TEPOCATE,1,21,9,12,1
GUANAJUATO,11,ABASOLO,001,EL TULE,4,389,206,183,17
GUANAJUATO,11,ABASOLO,001,EL VARAL,4,384,186,198,17
GUANAJUATO,11,ABASOLO,001,EMILIANO ZAPATA (LA COLONIA),2,124,57,67,6
GUANAJUATO,11,ABASOLO,001,ESTACIÓN ABASOLO,2,256,113,143,9
GUANAJUATO,11,ABASOLO,001,ESTACIÓN JOAQUÍN,3,916,466,450,50
GUANAJUATO,11,ABASOLO,001,FLORIDA DE GÓMEZ,1,119,60,59,6
GUANAJUATO,11,ABASOLO,001,FRACCIONAMIENTO CENTENARIO,1,479,258,221,10
GUANAJUATO,11,ABASOLO,001,GÓMEZ DE OROZCO,1,22,14,8,1
GUANAJUATO,11,ABASOLO,001,HORTA (SAN ANTONIO DE HORTA),3,149,70,79,7
GUANAJUATO,11,ABASOLO,001,HUITZATARITO,3,379,182,197,14
GUANAJUATO,11,ABASOLO,001,LA BRISA,2,39,19,20,3
GUANAJUATO,11,ABASOLO,001,LA CARROZA,4,312,148,164,14
GUANAJUATO,11,ABASOLO,001,LA CHINCHE,1,13,7,6,1
GUANAJUATO,11,ABASOLO,001,LA FLORIDA DE GONZÁLEZ,2,53,27,26,4
GUANAJUATO,11,ABASOLO,001,LA JOYA DE CALVILLO,4,300,143,157,14
GUANAJUATO,11,ABASOLO,001,LA LUZ DE QUINTANA,4,112,57,55,7
GUANAJUATO,11,ABASOLO,001,LA MINA,1,7,5,2,1
GUANAJUATO,11,ABASOLO,001,LA MORA,2,85,35,50,4
GUANAJUATO,11,ABASOLO,001,LA MURALLA,1,12,4,8,1
GUANAJUATO,11,ABASOLO,001,LA ORDEÑA,2,40,19,21,3
GUANAJUATO,11,ABASOLO,001,LA TINAJA DE NEGRETE,2,170,86,84,8
GUANAJUATO,11,ABASOLO,001,LA TRINIDAD,3,194,97,97,10
GUANAJUATO,11,ABASOLO,001,LABOR DE PERALTA,3,245,123,122,11
GUANAJUATO,11,ABASOLO,001,LAS CRUCES,3,263,129,134,11
GUANAJUATO,11,ABASOLO,001,LAS ESTACAS,1,47,18,29,3
GUANAJUATO,11,ABASOLO,001,LAS MASAS (LA LUZ MASAS),4,416,200,216,15
GUANAJUATO,11,ABASOLO,001,LAS MESAS (BUENA VISTA DE VACA),2,26,12,14,2
GUANAJUATO,11,ABASOLO,001,LAS POMAS NUEVAS,2,49,25,24,4
GUANAJUATO,11,ABASOLO,001,LOMA DE LA ESPERANZA,3,397,191,206,15
GUANAJUATO,11,ABASOLO,001,LOS LEONES,2,48,25,23,3
GUANAJUATO,11,ABASOLO,001,MARFIL,1,49,28,21,2
GUANAJUATO,11,ABASOLO,001,MARITAS,2,78,42,36,4
GUANAJUATO,11,ABASOLO,001,MOGOTES,2,122,56,66,6
GUANAJUATO,11,ABASOLO,001,NOMBRE DE DIOS,2,88,46,42,4
GUANAJUATO,11,ABASOLO,001,OJO DE AGUA DE HUANUMO (EL TORREÓN),2,71,36,35,3
GUANAJUATO,11,ABASOLO,001,OJO DE AGUA DEL ZAPOTE,1,4,1,3,1
GUANAJUATO,11,ABASOLO,001,PASO DE CANOA (ARROYO SECO),1,34,16,18,2
GUANAJUATO,11,ABASOLO,001,PERALTA,3,136,58,78,7
GUANAJUATO,11,ABASOLO,001,PIEDRAS NEGRAS,2,109,57,52,5
GUANAJUATO,11,ABASOLO,001,PINTORES (RAFAEL SAAVEDRA),3,51,24,27,3
GUANAJUATO,11,ABASOLO,001,PUERTO DE LA CRUZ,2,45,29,16,3
GUANAJUATO,11,ABASOLO,001,RANCHO DE GONZÁLEZ,1,3,0,3,1
GUANAJUATO,11,ABASOLO,001,RANCHO NUEVO DE LA CRUZ,5,1673,823,850,87
GUANAJUATO,11,ABASOLO,001,RANCHO SECO,2,26,15,11,3
GUANAJUATO,11,ABASOLO,001,RANCHO SECO DE OROZCO (RANCHO SECO DE CORTEZ),2,22,4,18,2
GUANAJUATO,11,ABASOLO,001,RINCÓN DE MARTÍNEZ,3,116,52,64,7
GUANAJUATO,11,ABASOLO,001,SALITRE DE SAAVEDRA,2,29,18,11,2
GUANAJUATO,11,ABASOLO,001,SAN ANTONIO DE LA RINCONADA (LA MUGRE),1,11,6,5,1
GUANAJUATO,11,ABASOLO,001,SAN ANTONIO DE LAS HUERTAS (EL MANICOMIO),1,8,7,1,1
GUANAJUATO,11,ABASOLO,001,SAN ANTONIO DE PERALTA,1,15,6,9,1
GUANAJUATO,11,ABASOLO,001,SAN APARICIO,2,127,61,66,6
GUANAJUATO,11,ABASOLO,001,SAN CAYETANO,1,3,3,0,1
GUANAJUATO,11,ABASOLO,001,SAN FERNANDO DE AGUIRRE,1,10,3,7,1
GUANAJUATO,11,ABASOLO,001,SAN FRANCISCO DE HORTA (EL ALACRÁN),2,151,77,74,7
GUANAJUATO,11,ABASOLO,001,SAN FRANCISCO DE HORTA (EL GATO),2,143,81,62,7
GUANAJUATO,11,ABASOLO,001,SAN FRANCISCO DE LA SOLEDAD,2,74,38,36,4
GUANAJUATO,11,ABASOLO,001,SAN ISIDRO,4,563,251,312,22
GUANAJUATO,11,ABASOLO,001,SAN JOSÉ DE GONZÁLEZ,4,440,206,234,18
GUANAJUATO,11,ABASOLO,001,SAN NICOLÁS DE LOS ROSALES (LA CABRA),2,97,56,41,5
GUANAJUATO,11,ABASOLO,001,SAN RAFAEL DE HORTA,3,207,106,101,11
GUANAJUATO,11,ABASOLO,001,SAN TELMO DE ROA,1,15,8,7,1
GUANAJUATO,11,ABASOLO,001,SAN VICENTE DEL CAÑO (SAN VICENTE DE HIDALGO),3,220,108,112,10
GUANAJUATO,11,ABASOLO,001,SANTA ROSA DE NEGRETE (LA RATA),1,19,10,9,1
GUANAJUATO,11,ABASOLO,001,SOLEDAD DE NEGRETE,2,68,32,36,4
GUANAJUATO,11,ABASOLO,001,TAMAZULA,3,484,238,246,21
GUANAJUATO,11,ABASOLO,001,TROJES DE MARAÑÓN,5,239,120,119,11
GUANAJUATO,11,ABASOLO,001,ZAPOTE DE LA ESPERANZA,2,61,32,29,4
GUANAJUATO,11,ABASOLO,001,ZAPOTE DE PERALTA,4,392,198,194,14
GUANAJUATO,11,ACÁMBARO,002,ACÁMBARO,83,14533,7565,6968,914
GUANAJUATO,11,ACÁMBARO,002,AGUA CALIENTE,2,96,48,48,4
GUANAJUATO,11,ACÁMBARO,002,ANDOCUTÍN,4,183,91,92,11
GUANAJUATO,11,ACÁMBARO,002,ARROYO COLORADO,2,135,70,65,7
GUANAJUATO,11,ACÁMBARO,002,ARROYO DE LA LUNA,4,230,114,116,14
GUANAJUATO,11,ACÁMBARO,002,BUENAVISTA (LOS MOSCOS),2,16,9,7,2
GUANAJUATO,11,ACÁMBARO,002,CHAMÁCUARO,4,256,140,116,14
GUANAJUATO,11,ACÁMBARO,002,CHUPÍCUARO (NUEVO CHUPÍCUARO),7,732,378,354,38
GUANAJUATO,11,ACÁMBARO,002,CÚTARO,2,18,11,7,2
GUANAJUATO,11,ACÁMBARO,002,EL ESPAÑOL,2,77,32,45,4
GUANAJUATO,11,ACÁMBARO,002,EL MAGUEY,3,56,22,34,4
GUANAJUATO,11,ACÁMBARO,002,EL PILONCILLO,2,22,11,11,2
GUANAJUATO,11,ACÁMBARO,002,EL RODEO,3,141,70,71,8
GUANAJUATO,11,ACÁMBARO,002,EL ROMERO,2,39,22,17,2
GUANAJUATO,11,ACÁMBARO,002,EL SAUZ,2,15,8,7,2
GUANAJUATO,11,ACÁMBARO,002,EL TENORIO,2,18,7,11,2
GUANAJUATO,11,ACÁMBARO,002,GAYTÁN DEL REFUGIO,3,104,58,46,7
GUANAJUATO,11,ACÁMBARO,002,INCHAMÁCUARO (CHAMACUARILLO),3,90,46,44,6
GUANAJUATO,11,ACÁMBARO,002,IRÁMUCO,8,1465,765,700,68
GUANAJUATO,11,ACÁMBARO,002,ISLA CERRO GRANDE (ISLA CHANACO),1,7,5,2,1
GUANAJUATO,11,ACÁMBARO,002,JARAL DEL REFUGIO,2,100,51,49,4
GUANAJUATO,11,ACÁMBARO,002,JESÚS RUIZ RUIZ (SAN MIGUEL),1,941,522,419,109
GUANAJUATO,11,ACÁMBARO,002,LA CAÑADA,1,12,5,7,1
GUANAJUATO,11,ACÁMBARO,002,LA CARPA,2,25,11,14,3
GUANAJUATO,11,ACÁMBARO,002,LA CHICHARRONERA (CAMINO BLANCO),3,29,14,15,3
GUANAJUATO,11,ACÁMBARO,002,LA CONCEPCIÓN,3,89,40,49,6
GUANAJUATO,11,ACÁMBARO,002,LA ENCARNACIÓN,3,188,102,86,9
GUANAJUATO,11,ACÁMBARO,002,LA GRANJA,2,17,11,6,2
GUANAJUATO,11,ACÁMBARO,002,LA MERCED,3,124,62,62,7
GUANAJUATO,11,ACÁMBARO,002,LA MESA DE SAN JOSÉ,2,19,12,7,2
GUANAJUATO,11,ACÁMBARO,002,LA ORTIGA,5,426,185,241,17
GUANAJUATO,11,ACÁMBARO,002,LA PILA DE LOS ÁRBOLES,2,34,14,20,2
GUANAJUATO,11,ACÁMBARO,002,LA PRESA DE SANTA INÉS,2,33,13,20,2
GUANAJUATO,11,ACÁMBARO,002,LA PROVIDENCIA,1,103,51,52,6
GUANAJUATO,11,ACÁMBARO,002,LA PURÍSIMA CONCEPCIÓN,2,41,22,19,3
GUANAJUATO,11,ACÁMBARO,002,LA SOLEDAD,3,18,4,14,3
GUANAJUATO,11,ACÁMBARO,002,LAS CRUCES,2,15,7,8,2
GUANAJUATO,11,ACÁMBARO,002,LAS JÍCAMAS (LA PURÍSIMA),3,145,65,80,7
GUANAJUATO,11,ACÁMBARO,002,LAS PARTIDAS,2,41,23,18,2
GUANAJUATO,11,ACÁMBARO,002,LORETO (TERESA),3,125,72,53,10
GUANAJUATO,11,ACÁMBARO,002,LOS DESMONTES,3,287,141,146,11
GUANAJUATO,11,ACÁMBARO,002,LOS ÓRGANOS (LOS ÓRGANOS DE ABAJO),2,101,49,52,4
GUANAJUATO,11,ACÁMBARO,002,LOS ÓRGANOS DE ARRIBA,1,6,4,2,1
GUANAJUATO,11,ACÁMBARO,002,MONCLOA,2,19,9,10,2
GUANAJUATO,11,ACÁMBARO,002,MONTE PRIETO,4,301,153,148,14
GUANAJUATO,11,ACÁMBARO,002,NINGUNO [ESCUELA TECNOLÓGICA AGROPECUARIA],3,403,206,197,37
GUANAJUATO,11,ACÁMBARO,002,OBRAJUELO,3,126,66,60,6
GUANAJUATO,11,ACÁMBARO,002,PALO BLANCO DEL REFUGIO,2,31,16,15,2
GUANAJUATO,11,ACÁMBARO,002,PANTALEÓN,2,70,40,30,3
GUANAJUATO,11,ACÁMBARO,002,PARÁCUARO,4,432,203,229,18
GUANAJUATO,11,ACÁMBARO,002,PIEDRAS CHINAS,2,10,4,6,2
GUANAJUATO,11,ACÁMBARO,002,PIEDRAS DE AMOLAR,2,19,10,9,2
GUANAJUATO,11,ACÁMBARO,002,PROVIDENCIA,1,52,25,27,2
GUANAJUATO,11,ACÁMBARO,002,PROVIDENCIA DE SAN AGUSTÍN,2,24,12,12,2
GUANAJUATO,11,ACÁMBARO,002,PUERTO DE CABRAS,2,34,16,18,2
GUANAJUATO,11,ACÁMBARO,002,SAN AGUSTÍN,3,102,49,53,6
GUANAJUATO,11,ACÁMBARO,002,SAN ANTONIO,2,59,34,25,3
GUANAJUATO,11,ACÁMBARO,002,SAN CAYETANO,3,92,46,46,6
GUANAJUATO,11,ACÁMBARO,002,SAN DIEGO DE ALCALÁ (HACIENDA DE SAN DIEGO),4,320,154,166,14
GUANAJUATO,11,ACÁMBARO,002,SAN FRANCISCO DE LA PIEDAD (LA CODORNIZ),2,41,24,17,3
GUANAJUATO,11,ACÁMBARO,002,SAN FRANCISCO PARÁCUARO,2,158,81,77,7
GUANAJUATO,11,ACÁMBARO,002,SAN FRANCISCO RANCHO VIEJO,3,111,57,54,6
GUANAJUATO,11,ACÁMBARO,002,SAN JOSÉ DE LA PEÑA,1,4,3,1,1
GUANAJUATO,11,ACÁMBARO,002,SAN JOSÉ DE LAS PILAS,3,54,30,24,3
GUANAJUATO,11,ACÁMBARO,002,SAN JUAN (EL ZAPOTE),2,168,82,86,8
GUANAJUATO,11,ACÁMBARO,002,SAN JUAN JARIPEO,3,224,107,117,11
GUANAJUATO,11,ACÁMBARO,002,SAN JUAN VIEJO,3,110,51,59,5
GUANAJUATO,11,ACÁMBARO,002,SAN LUIS DE LOS AGUSTINOS,3,45,23,22,4
GUANAJUATO,11,ACÁMBARO,002,SAN MATEO TÓCUARO,4,450,231,219,23
GUANAJUATO,11,ACÁMBARO,002,SAN MIGUEL,2,125,58,67,6
GUANAJUATO,11,ACÁMBARO,002,SAN MIGUEL DEL PUERTO,3,419,188,231,53
GUANAJUATO,11,ACÁMBARO,002,SAN NICOLÁS DE TOLENTINO,2,61,30,31,4
GUANAJUATO,11,ACÁMBARO,002,SAN RAMÓN,2,14,7,7,2
GUANAJUATO,11,ACÁMBARO,002,SAN VICENTE MUNGUÍA,2,48,25,23,3
GUANAJUATO,11,ACÁMBARO,002,SANTA CLARA,2,44,21,23,3
GUANAJUATO,11,ACÁMBARO,002,SANTA INÉS,2,55,21,34,3
GUANAJUATO,11,ACÁMBARO,002,SANTA ROSA DE LIMA,2,20,10,10,2
GUANAJUATO,11,ACÁMBARO,002,SANTIAGUILLO,3,136,64,72,7
GUANAJUATO,11,ACÁMBARO,002,SOLÍS,3,148,71,77,7
GUANAJUATO,11,ACÁMBARO,002,TRES MARÍAS,3,34,17,17,3
GUANAJUATO,11,SAN MIGUEL DE ALLENDE,003,AGUA SALADA,2,29,12,17,2
GUANAJUATO,11,SAN MIGUEL DE ALLENDE,003,AGUSTÍN GONZÁLEZ,5,464,256,208,19
GUANAJUATO,11,SAN MIGUEL DE ALLENDE,003,ALCOCER,4,421,226,195,18
GUANAJUATO,11,SAN MIGUEL DE ALLENDE,003,ALONSO YÁÑEZ,3,325,175,150,12
GUANAJUATO,11,SAN MIGUEL DE ALLENDE,003,BANDA,2,250,128,122,8
GUANAJUATO,11,SAN MIGUEL DE ALLENDE,003,BANDITA,1,40,17,23,2
GUANAJUATO,11,SAN MIGUEL DE ALLENDE,003,BEGOÑA DEL PROGRESO,1,7,4,3,1
GUANAJUATO,11,SAN MIGUEL DE ALLENDE,003,BIZNAGA DE CERRO GRANDE,3,74,46,28,5
GUANAJUATO,11,SAN MIGUEL DE ALLENDE,003,BIZNAGA DE JARAL,2,29,14,15,2
GUANAJUATO,11,SAN MIGUEL DE ALLENDE,003,BOCA DE LA CAÑADA,2,58,29,29,4
GUANAJUATO,11,SAN MIGUEL DE ALLENDE,003,BOCAS,2,106,51,55,4
GUANAJUATO,11,SAN MIGUEL DE ALLENDE,003,BORDO COLORADO,1,16,4,12,1
GUANAJUATO,11,SAN MIGUEL DE ALLENDE,003,CABRERA,2,13,8,5,2
GUANAJUATO,11,SAN MIGUEL DE ALLENDE,003,CALDERÓN,4,176,80,96,9
GUANAJUATO,11,SAN MIGUEL DE ALLENDE,003,CAÑADA DE GARCÍA,3,47,21,26,4
GUANAJUATO,11,SAN MIGUEL DE ALLENDE,003,CAÑADA DE LAS FLORES,2,42,21,21,2
GUANAJUATO,11,SAN MIGUEL DE ALLENDE,003,CAÑAJO,2,158,77,81,7
GUANAJUATO,11,SAN MIGUEL DE ALLENDE,003,CAPADERO (SAN ISIDRO CAPADERO),2,35,19,16,2
GUANAJUATO,11,SAN MIGUEL DE ALLENDE,003,CASTAÑO DE ABAJO,2,18,9,9,2
GUANAJUATO,11,SAN MIGUEL DE ALLENDE,003,CERRITOS,4,490,249,241,17
GUANAJUATO,11,SAN MIGUEL DE ALLENDE,003,CHARCO DE SIERRA,4,254,114,140,12
GUANAJUATO,11,SAN MIGUEL DE ALLENDE,003,CIÉNEGA DE JUANA RUIZ,3,140,67,73,7
GUANAJUATO,11,SAN MIGUEL DE ALLENDE,003,CINCO SEÑORES,2,8,5,3,2
GUANAJUATO,11,SAN MIGUEL DE ALLENDE,003,CLAVELLINAS (CLAVELLINAS COYOTES),5,439,226,213,20
GUANAJUATO,11,SAN MIGUEL DE ALLENDE,003,CORRAL DE PIEDRAS DE ABAJO,1,141,74,67,6
GUANAJUATO,11,SAN MIGUEL DE ALLENDE,003,CORRAL DE PIEDRAS DE ARRIBA,4,609,315,294,24
GUANAJUATO,11,SAN MIGUEL DE ALLENDE,003,CORRALEJO DE ABAJO,2,38,13,25,3
GUANAJUATO,11,SAN MIGUEL DE ALLENDE,003,CORRALEJO DE ARRIBA,3,352,177,175,14
GUANAJUATO,11,SAN MIGUEL DE ALLENDE,003,DON FRANCISCO,4,526,266,260,21
GUANAJUATO,11,SAN MIGUEL DE ALLENDE,003,DON JUAN,2,26,8,18,2
GUANAJUATO,11,SAN MIGUEL DE ALLENDE,003,DON JUAN XIDO DE ABAJO (CABRAS DE BEGOÑA),2,72,39,33,3
GUANAJUATO,11,SAN MIGUEL DE ALLENDE,003,DOÑA JUANA,3,123,68,55,7
GUANAJUATO,11,SAN MIGUEL DE ALLENDE,003,EL ÁGUILA,2,35,12,23,2
GUANAJUATO,11,SAN MIGUEL DE ALLENDE,003,EL BATÁN,2,14,7,7,2
GUANAJUATO,11,SAN MIGUEL DE ALLENDE,003,EL CAPADERILLO,2,152,70,82,7
GUANAJUATO,11,SAN MIGUEL DE ALLENDE,003,EL CARMEN,2,41,23,18,2
GUANAJUATO,11,SAN MIGUEL DE ALLENDE,003,EL CERRITO DE LOS CHÁVEZ,2,29,14,15,2
GUANAJUATO,11,SAN MIGUEL DE ALLENDE,003,EL COLORADO,2,10,6,4,2
GUANAJUATO,11,SAN MIGUEL DE ALLENDE,003,EL EMBARGO (EL NUEVO CIMATARIO),1,18,7,11,2
GUANAJUATO,11,SAN MIGUEL DE ALLENDE,003,EL ESPEJO,2,11,4,7,2
GUANAJUATO,11,SAN MIGUEL DE ALLENDE,003,EL FRAILE,2,77,33,44,4
GUANAJUATO,11,SAN MIGUEL DE ALLENDE,003,EL HUIZACHAL,2,92,49,43,4
GUANAJUATO,11,SAN MIGUEL DE ALLENDE,003,EL LINDERO,2,45,23,22,2
GUANAJUATO,11,SAN MIGUEL DE ALLENDE,003,EL PADRE (EDUARDO OBREGÓN),4,215,118,97,17
GUANAJUATO,11,SAN MIGUEL DE ALLENDE,003,EL SALITRE,2,50,22,28,3
GUANAJUATO,11,SAN MIGUEL DE ALLENDE,003,EL SAUCILLO,3,60,38,22,5
GUANAJUATO,11,SAN MIGUEL DE ALLENDE,003,EL TIGRE,2,23,10,13,2
GUANAJUATO,11,SAN MIGUEL DE ALLENDE,003,EL VERGEL DE LOS LAURELES,2,82,48,34,4
GUANAJUATO,11,SAN MIGUEL DE ALLENDE,003,ELVIRA,2,52,26,26,3
GUANAJUATO,11,SAN MIGUEL DE ALLENDE,003,ESTANCIA DE CANAL,2,24,11,13,2
GUANAJUATO,11,SAN MIGUEL DE ALLENDE,003,ESTANCIA DE SAN ANTONIO,2,93,51,42,4
GUANAJUATO,11,SAN MIGUEL DE ALLENDE,003,EX-HACIENDA LA CIENEGUITA,2,218,112,106,8
GUANAJUATO,11,SAN MIGUEL DE ALLENDE,003,FAJARDO DE BOCAS,3,131,65,66,6
GUANAJUATO,11,SAN MIGUEL DE ALLENDE,003,FLORES DE BEGOÑA,2,147,83,64,7
GUANAJUATO,11,SAN MIGUEL DE ALLENDE,003,GUADALUPE DE CANAL,2,64,35,29,3
GUANAJUATO,11,SAN MIGUEL DE ALLENDE,003,GUADALUPE DE TÁMBULA,3,292,155,137,12
GUANAJUATO,11,SAN MIGUEL DE ALLENDE,003,GUADIANILLA,2,13,7,6,2
GUANAJUATO,11,SAN MIGUEL DE ALLENDE,003,GUANAJUATITO,1,29,14,15,1
GUANAJUATO,11,SAN MIGUEL DE ALLENDE,003,GUERRERO,2,75,30,45,3
GUANAJUATO,11,SAN MIGUEL DE ALLENDE,003,JALPA,4,229,124,105,13
GUANAJUATO,11,SAN MIGUEL DE ALLENDE,003,JESÚS MARÍA LA PETACA,2,89,49,40,4
GUANAJUATO,11,SAN MIGUEL DE ALLENDE,003,JUAN GONZÁLEZ,2,41,17,24,2
GUANAJUATO,11,SAN MIGUEL DE ALLENDE,003,LA ANGOSTURA,2,8,4,4,2
GUANAJUATO,11,SAN MIGUEL DE ALLENDE,003,LA CALERA,2,29,17,12,2
GUANAJUATO,11,SAN MIGUEL DE ALLENDE,003,LA CAMPANA,4,308,158,150,14
GUANAJUATO,11,SAN MIGUEL DE ALLENDE,003,LA CRUZ DEL PALMAR,4,481,244,237,18
GUANAJUATO,11,SAN MIGUEL DE ALLENDE,003,LA CUADRILLA,3,302,151,151,13
GUANAJUATO,11,SAN MIGUEL DE ALLENDE,003,LA ESMERALDA,2,160,80,80,8
GUANAJUATO,11,SAN MIGUEL DE ALLENDE,003,LA ESPERANZA,1,28,18,10,1
GUANAJUATO,11,SAN MIGUEL DE ALLENDE,003,LA HUERTA,4,283,143,140,14
GUANAJUATO,11,SAN MIGUEL DE ALLENDE,003,LA MEDINA,3,78,36,42,5
GUANAJUATO,11,SAN MIGUEL DE ALLENDE,003,LA MINITA,2,33,15,18,2
GUANAJUATO,11,SAN MIGUEL DE ALLENDE,003,LA PALMILLA,2,73,38,35,3
GUANAJUATO,11,SAN MIGUEL DE ALLENDE,003,LA PALMITA,2,89,49,40,4
GUANAJUATO,11,SAN MIGUEL DE ALLENDE,003,LA PROVIDENCIA,1,7,3,4,1
GUANAJUATO,11,SAN MIGUEL DE ALLENDE,003,LA TALEGA,3,112,38,74,7
GUANAJUATO,11,SAN MIGUEL DE ALLENDE,003,LA TINAJA DE LOS RODRÍGUEZ,2,105,47,58,4
GUANAJUATO,11,SAN MIGUEL DE ALLENDE,003,LA VIVIENDA DE ARRIBA,2,28,13,15,2
GUANAJUATO,11,SAN MIGUEL DE ALLENDE,003,LAGUNA ESCONDIDA,4,256,113,143,14
GUANAJUATO,11,SAN MIGUEL DE ALLENDE,003,LAGUNILLA,1,11,6,5,1
GUANAJUATO,11,SAN MIGUEL DE ALLENDE,003,LAS CAÑAS,5,348,178,170,18
GUANAJUATO,11,SAN MIGUEL DE ALLENDE,003,LAS CRUCES,1,7,2,5,1
GUANAJUATO,11,SAN MIGUEL DE ALLENDE,003,LAS TROJES DE BELÉN,3,40,30,10,4
GUANAJUATO,11,SAN MIGUEL DE ALLENDE,003,LIRA DE BOCAS,2,41,23,18,2
GUANAJUATO,11,SAN MIGUEL DE ALLENDE,003,LOMA DE CABRAS,2,17,9,8,2
GUANAJUATO,11,SAN MIGUEL DE ALLENDE,003,LOMA DE COCINAS (SAN ANDRÉS),2,102,52,50,4
GUANAJUATO,11,SAN MIGUEL DE ALLENDE,003,LOMA DE LA PURÍSIMA,2,76,49,27,4
GUANAJUATO,11,SAN MIGUEL DE ALLENDE,003,LOMA DEL SALTO DE CANAL (EL SALTITO),2,182,95,87,13
GUANAJUATO,11,SAN MIGUEL DE ALLENDE,003,LOS BARRONES,1,20,8,12,1
GUANAJUATO,11,SAN MIGUEL DE ALLENDE,003,LOS GALVANES,4,526,263,263,24
GUANAJUATO,11,SAN MIGUEL DE ALLENDE,003,LOS GONZÁLEZ,4,179,90,89,10
GUANAJUATO,11,SAN MIGUEL DE ALLENDE,003,LOS GUÍAS,1,10,6,4,1
GUANAJUATO,11,SAN MIGUEL DE ALLENDE,003,LOS JUÁREZ,2,64,34,30,4
GUANAJUATO,11,SAN MIGUEL DE ALLENDE,003,LOS LÓPEZ,4,759,380,379,23
GUANAJUATO,11,SAN MIGUEL DE ALLENDE,003,LOS MARTÍNEZ,2,27,15,12,2
GUANAJUATO,11,SAN MIGUEL DE ALLENDE,003,LOS ÓRGANOS,2,52,21,31,3
GUANAJUATO,11,SAN MIGUEL DE ALLENDE,003,LOS REYES (LA VIVIENDA),2,20,11,9,2
GUANAJUATO,11,SAN MIGUEL DE ALLENDE,003,LOS RICOS DE ABAJO,2,62,26,36,3
GUANAJUATO,11,SAN MIGUEL DE ALLENDE,003,LOS RODRÍGUEZ,6,1092,573,519,54
GUANAJUATO,11,SAN MIGUEL DE ALLENDE,003,LOS TORILES,3,49,21,28,4
GUANAJUATO,11,SAN MIGUEL DE ALLENDE,003,LOS TORRES,2,87,51,36,4
GUANAJUATO,11,SAN MIGUEL DE ALLENDE,003,LOS TOVARES,2,5,3,2,2
GUANAJUATO,11,SAN MIGUEL DE ALLENDE,003,LUZ DE JACALES (GUADALUPE DE LA LUZ),2,29,14,15,2
GUANAJUATO,11,SAN MIGUEL DE ALLENDE,003,MANANTIALES,3,72,29,43,4
GUANAJUATO,11,SAN MIGUEL DE ALLENDE,003,MARAVILLAS,2,23,13,10,2
GUANAJUATO,11,SAN MIGUEL DE ALLENDE,003,MARROQUÍN DE ABAJO,3,89,44,45,5
GUANAJUATO,11,SAN MIGUEL DE ALLENDE,003,MONTECILLO DE GUZMÁN,4,156,72,84,8
GUANAJUATO,11,SAN MIGUEL DE ALLENDE,003,MONTECILLO DE LA MILPA,2,119,61,58,5
GUANAJUATO,11,SAN MIGUEL DE ALLENDE,003,MONTECILLO DE NIETO,2,69,36,33,3
GUANAJUATO,11,SAN MIGUEL DE ALLENDE,003,MORAL DE PUERTO DE NIETO,4,284,128,156,14
GUANAJUATO,11,SAN MIGUEL DE ALLENDE,003,MORAL DE PUERTO DE SOSA,2,29,13,16,2
GUANAJUATO,11,SAN MIGUEL DE ALLENDE,003,NIGROMANTE,2,188,97,91,8
GUANAJUATO,11,SAN MIGUEL DE ALLENDE,003,OAXACA,2,140,79,61,7
GUANAJUATO,11,SAN MIGUEL DE ALLENDE,003,PALMITA DE LANDETA,4,648,327,321,80
GUANAJUATO,11,SAN MIGUEL DE ALLENDE,003,PALO BLANCO,1,4,1,3,1
GUANAJUATO,11,SAN MIGUEL DE ALLENDE,003,PALO COLORADO,5,437,223,214,16
GUANAJUATO,11,SAN MIGUEL DE ALLENDE,003,PANTOJA,4,378,207,171,17
GUANAJUATO,11,SAN MIGUEL DE ALLENDE,003,PEDREGAL DE JERICÓ,2,58,25,33,3
GUANAJUATO,11,SAN MIGUEL DE ALLENDE,003,PEÑA BLANCA,5,431,209,222,23
GUANAJUATO,11,SAN MIGUEL DE ALLENDE,003,PEÑÓN DE LOS BAÑOS,2,91,41,50,4
GUANAJUATO,11,SAN MIGUEL DE ALLENDE,003,PINALILLO,2,7,2,5,2
GUANAJUATO,11,SAN MIGUEL DE ALLENDE,003,POZO DE BALDERAS,4,220,116,104,10
GUANAJUATO,11,SAN MIGUEL DE ALLENDE,003,POZOS DE LICEAS,1,5,3,2,1
GUANAJUATO,11,SAN MIGUEL DE ALLENDE,003,PRESA ALLENDE,1,40,19,21,2
GUANAJUATO,11,SAN MIGUEL DE ALLENDE,003,PRESA DE MANANTIALES,2,4,2,2,2
GUANAJUATO,11,SAN MIGUEL DE ALLENDE,003,PRESITA DE SANTA ROSA,3,37,18,19,3
GUANAJUATO,11,SAN MIGUEL DE ALLENDE,003,PROVIDENCIA DE SOSNABAR (EL BANDOLÓN),2,94,50,44,5
GUANAJUATO,11,SAN MIGUEL DE ALLENDE,003,PUENTE DEL CARMEN,2,110,56,54,5
GUANAJUATO,11,SAN MIGUEL DE ALLENDE,003,PUERTO DE NIETO,4,622,318,304,23
GUANAJUATO,11,SAN MIGUEL DE ALLENDE,003,PUERTO DE SOSA,2,89,40,49,4
GUANAJUATO,11,SAN MIGUEL DE ALLENDE,003,RANCHO NUEVO (RANCHO NUEVO DE BANDA),1,4,1,3,1
GUANAJUATO,11,SAN MIGUEL DE ALLENDE,003,RANCHO NUEVO DE GALVANES,1,8,4,4,1
GUANAJUATO,11,SAN MIGUEL DE ALLENDE,003,RANCHO NUEVO DE LA ROSA,2,34,20,14,2
GUANAJUATO,11,SAN MIGUEL DE ALLENDE,003,RANCHO NUEVO VILLA DE GUADALUPE,2,34,17,17,2
GUANAJUATO,11,SAN MIGUEL DE ALLENDE,003,RANCHO VIEJO,5,727,352,375,25
GUANAJUATO,11,SAN MIGUEL DE ALLENDE,003,RINCÓN DE CANAL,2,11,6,5,2
GUANAJUATO,11,SAN MIGUEL DE ALLENDE,003,SALITRILLO,2,88,53,35,4
GUANAJUATO,11,SAN MIGUEL DE ALLENDE,003,SAN ANTONIO DE CRUCES,2,121,57,64,4
GUANAJUATO,11,SAN MIGUEL DE ALLENDE,003,SAN ANTONIO DE LA JOYA,2,29,12,17,2
GUANAJUATO,11,SAN MIGUEL DE ALLENDE,003,SAN ANTONIO DEL VARAL,3,228,124,104,10
GUANAJUATO,11,SAN MIGUEL DE ALLENDE,003,SAN CRISTÓBAL,2,71,41,30,4
GUANAJUATO,11,SAN MIGUEL DE ALLENDE,003,SAN DAMIÁN,3,117,55,62,6
GUANAJUATO,11,SAN MIGUEL DE ALLENDE,003,SAN FRANCISCO,2,70,35,35,4
GUANAJUATO,11,SAN MIGUEL DE ALLENDE,003,SAN ISIDRO DE BANDITA,1,5,3,2,1
GUANAJUATO,11,SAN MIGUEL DE ALLENDE,003,SAN ISIDRO DE ENSAYE (LA CUEVITA),3,84,46,38,4
GUANAJUATO,11,SAN MIGUEL DE ALLENDE,003,SAN ISIDRO DE LA CAÑADA DE LA VIRGEN,3,35,17,18,3
GUANAJUATO,11,SAN MIGUEL DE ALLENDE,003,SAN JERÓNIMO DE LA PLAYA,2,71,32,39,3
GUANAJUATO,11,SAN MIGUEL DE ALLENDE,003,SAN JOSÉ DE ALLENDE,4,383,187,196,17
GUANAJUATO,11,SAN MIGUEL DE ALLENDE,003,SAN JOSÉ DE GRACIA (PALO DULCE),2,54,32,22,3
GUANAJUATO,11,SAN MIGUEL DE ALLENDE,003,SAN JOSÉ DE LA AMISTAD,1,15,8,7,1
GUANAJUATO,11,SAN MIGUEL DE ALLENDE,003,SAN JOSÉ DE LA PALMA,2,11,4,7,2
GUANAJUATO,11,SAN MIGUEL DE ALLENDE,003,SAN JOSÉ DE VIBORILLAS,2,28,13,15,2
GUANAJUATO,11,SAN MIGUEL DE ALLENDE,003,SAN JOSÉ DEL LLANO,2,10,5,5,2
GUANAJUATO,11,SAN MIGUEL DE ALLENDE,003,SAN JUAN,1,4,3,1,1
GUANAJUATO,11,SAN MIGUEL DE ALLENDE,003,SAN JUAN JUVENAL,3,15,5,10,3
GUANAJUATO,11,SAN MIGUEL DE ALLENDE,003,SAN JULIÁN DE LANDETA,1,16,8,8,1
GUANAJUATO,11,SAN MIGUEL DE ALLENDE,003,SAN LUCAS,1,80,42,38,4
GUANAJUATO,11,SAN MIGUEL DE ALLENDE,003,SAN MARCOS DE BEGOÑA,4,287,149,138,14
GUANAJUATO,11,SAN MIGUEL DE ALLENDE,003,SAN MARTÍN DE LA PETACA,2,77,40,37,3
GUANAJUATO,11,SAN MIGUEL DE ALLENDE,003,SAN MARTÍN DEL PAREDÓN,3,213,107,106,11
GUANAJUATO,11,SAN MIGUEL DE ALLENDE,003,SAN MIGUEL DE ALLENDE,115,24233,12447,11786,1336
GUANAJUATO,11,SAN MIGUEL DE ALLENDE,003,SAN MIGUEL VIEJO,2,120,51,69,5
GUANAJUATO,11,SAN MIGUEL DE ALLENDE,003,SAN MIGUELITO,2,120,60,60,7
GUANAJUATO,11,SAN MIGUEL DE ALLENDE,003,SAN RAFAEL,2,37,17,20,2
GUANAJUATO,11,SAN MIGUEL DE ALLENDE,003,SANTA ELENA DE LA CRUZ (SAN JOSÉ DE LAGUNA),2,56,29,27,2
GUANAJUATO,11,SAN MIGUEL DE ALLENDE,003,SANTA FE,2,30,16,14,2
GUANAJUATO,11,SAN MIGUEL DE ALLENDE,003,SANTA RITA,2,2,2,0,2
GUANAJUATO,11,SAN MIGUEL DE ALLENDE,003,SANTA TERESITA DE DON DIEGO,7,530,304,226,60
GUANAJUATO,11,SAN MIGUEL DE ALLENDE,003,SANTAS MARÍAS,2,156,80,76,8
GUANAJUATO,11,SAN MIGUEL DE ALLENDE,003,SANTUARIO DE ATOTONILCO,4,478,260,218,18
GUANAJUATO,11,SAN MIGUEL DE ALLENDE,003,SORIA,2,84,37,47,4
GUANAJUATO,11,SAN MIGUEL DE ALLENDE,003,SOSNABAR,4,398,212,186,17
GUANAJUATO,11,SAN MIGUEL DE ALLENDE,003,TIERRA BLANCA DE ABAJO,3,173,73,100,9
GUANAJUATO,11,SAN MIGUEL DE ALLENDE,003,TIERRA BLANCA DE ARRIBA,2,91,44,47,4
GUANAJUATO,11,SAN MIGUEL DE ALLENDE,003,TLAXCALILLA,2,28,13,15,2
GUANAJUATO,11,SAN MIGUEL DE ALLENDE,003,TRES PALMAS,3,140,57,83,7
GUANAJUATO,11,SAN MIGUEL DE ALLENDE,003,VIEJO CIMATARIO,4,75,38,37,6
GUANAJUATO,11,SAN MIGUEL DE ALLENDE,003,VIVIENDA DE ABAJO,3,180,90,90,9
GUANAJUATO,11,SAN MIGUEL DE ALLENDE,003,XOTOLAR,2,4,4,0,1
GUANAJUATO,11,APASEO EL ALTO,004,AGUAJE DE ESPEJO,2,127,71,56,6
GUANAJUATO,11,APASEO EL ALTO,004,APASEO EL ALTO,41,7430,3772,3658,455
GUANAJUATO,11,APASEO EL ALTO,004,BARAJAS,2,174,88,86,8
GUANAJUATO,11,APASEO EL ALTO,004,BELÉN,3,173,81,92,8
GUANAJUATO,11,APASEO EL ALTO,004,BENIGNOS (EL CERRITO),1,4,3,1,1
GUANAJUATO,11,APASEO EL ALTO,004,CANOAS DE ARRIBA (LA LAGUNILLA),1,10,3,7,1
GUANAJUATO,11,APASEO EL ALTO,004,CERRO PRIETO,2,38,16,22,3
GUANAJUATO,11,APASEO EL ALTO,004,CONGREGACIÓN DE LA CRUZ (LA CUEVA),4,227,112,115,13
GUANAJUATO,11,APASEO EL ALTO,004,CORRAL DE PIEDRA,2,52,24,28,3
GUANAJUATO,11,APASEO EL ALTO,004,EL ÁRBOL,2,22,15,7,2
GUANAJUATO,11,APASEO EL ALTO,004,EL CABERO,2,38,17,21,2
GUANAJUATO,11,APASEO EL ALTO,004,EL DURAZNO,4,159,97,62,10
GUANAJUATO,11,APASEO EL ALTO,004,EL ESPEJO (EX-HACIENDA DE ESPEJO),4,349,158,191,17
GUANAJUATO,11,APASEO EL ALTO,004,EL MINERAL,1,16,8,8,1
GUANAJUATO,11,APASEO EL ALTO,004,EL POCITO (EL POCITO DE LA VIRGEN),3,82,47,35,5
GUANAJUATO,11,APASEO EL ALTO,004,EL REFUGIO DE GAMBOA,2,31,19,12,2
GUANAJUATO,11,APASEO EL ALTO,004,EL SABINO,3,109,55,54,5
GUANAJUATO,11,APASEO EL ALTO,004,EL SALTO DE ESPEJO,4,322,162,160,14
GUANAJUATO,11,APASEO EL ALTO,004,EL SAUZ DE BELÉN (QUEMADO),2,38,18,20,2
GUANAJUATO,11,APASEO EL ALTO,004,EL SOLDADO,3,56,27,29,4
GUANAJUATO,11,APASEO EL ALTO,004,EL TALAYOTE,3,139,71,68,7
GUANAJUATO,11,APASEO EL ALTO,004,EL TERRERO (TERRERO DE PAREDONES),4,138,73,65,8
GUANAJUATO,11,APASEO EL ALTO,004,ESTANCIA DE PAREDONES,3,21,12,9,3
GUANAJUATO,11,APASEO EL ALTO,004,JIMÉNEZ,2,60,37,23,4
GUANAJUATO,11,APASEO EL ALTO,004,LA CAÑADA,2,27,14,13,2
GUANAJUATO,11,APASEO EL ALTO,004,LA CUEVITA,4,752,404,348,27
GUANAJUATO,11,APASEO EL ALTO,004,LA HUILOTA,2,53,25,28,4
GUANAJUATO,11,APASEO EL ALTO,004,LA LIEBRE (SOLEDAD DE LA LIEBRE),2,36,19,17,2
GUANAJUATO,11,APASEO EL ALTO,004,LA LUISIADA,3,192,103,89,11
GUANAJUATO,11,APASEO EL ALTO,004,LA MESA (LA MESA DE PAREDONES),3,26,11,15,3
GUANAJUATO,11,APASEO EL ALTO,004,LA PRESITA,2,24,12,12,2
GUANAJUATO,11,APASEO EL ALTO,004,LA SOLEDAD DE REALENGO,2,52,29,23,3
GUANAJUATO,11,APASEO EL ALTO,004,LA TIJERA (SAN ANTONIO LA TIJERA),3,122,64,58,6
GUANAJUATO,11,APASEO EL ALTO,004,LA TINAJA DEL REFUGIO,2,36,14,22,2
GUANAJUATO,11,APASEO EL ALTO,004,LA TINAJA SAMARITANA,2,53,31,22,3
GUANAJUATO,11,APASEO EL ALTO,004,LOS CERVANTES (SAN ANTONIO DE LOS CERVANTES),1,4,3,1,1
GUANAJUATO,11,APASEO EL ALTO,004,LOS GALVANES,1,12,7,5,1
GUANAJUATO,11,APASEO EL ALTO,004,MANDUJANO ATEPEHUACÁN,3,154,77,77,8
GUANAJUATO,11,APASEO EL ALTO,004,MANDUJANO HIDALGO,1,121,59,62,6
GUANAJUATO,11,APASEO EL ALTO,004,MARROQUÍN,3,224,99,125,11
GUANAJUATO,11,APASEO EL ALTO,004,MESITA DE CÁPULA (EL CATORCE),2,61,27,34,3
GUANAJUATO,11,APASEO EL ALTO,004,OJO DE AGUA DE ESPEJO (ESTANCIA DE ESPEJO),2,170,97,73,8
GUANAJUATO,11,APASEO EL ALTO,004,OJO DE AGUA DE LA TRINIDAD,4,328,162,166,17
GUANAJUATO,11,APASEO EL ALTO,004,PALO ALTO,2,10,5,5,2
GUANAJUATO,11,APASEO EL ALTO,004,PAREDONES,2,59,24,35,3
GUANAJUATO,11,APASEO EL ALTO,004,SAN ANTONIO CALICHAR,5,602,279,323,25
GUANAJUATO,11,APASEO EL ALTO,004,SAN BARTOLOMÉ AGUAS CALIENTES,5,939,454,485,35
GUANAJUATO,11,APASEO EL ALTO,004,SAN FELIPE CALICHAR,2,75,44,31,5
GUANAJUATO,11,APASEO EL ALTO,004,SAN ISIDRO DE GAMBOA,3,237,117,120,11
GUANAJUATO,11,APASEO EL ALTO,004,SAN JUAN DEL LLANITO,6,1030,510,520,35
GUANAJUATO,11,APASEO EL ALTO,004,SAN NICOLÁS,2,86,41,45,3
GUANAJUATO,11,APASEO EL ALTO,004,SAN RAFAEL,1,265,131,134,14
GUANAJUATO,11,APASEO EL ALTO,004,SAN VICENTE,3,377,178,199,14
GUANAJUATO,11,APASEO EL ALTO,004,SANTA CRUZ DE GAMBOA,4,367,179,188,16
GUANAJUATO,11,APASEO EL ALTO,004,SANTA ISABEL,1,8,6,2,1
GUANAJUATO,11,APASEO EL GRANDE,005,AMEXHE,3,551,289,262,18
GUANAJUATO,11,APASEO EL GRANDE,005,APASEO EL GRANDE,45,9486,4788,4698,514
GUANAJUATO,11,APASEO EL GRANDE,005,CALERAS DE AMEXHE,4,554,273,281,22
GUANAJUATO,11,APASEO EL GRANDE,005,COACHITI,5,676,315,361,27
GUANAJUATO,11,APASEO EL GRANDE,005,COLONIA RANCHO NUEVO,1,60,37,23,2
GUANAJUATO,11,APASEO EL GRANDE,005,DULCES NOMBRES (EL TRISTE),1,19,9,10,1
GUANAJUATO,11,APASEO EL GRANDE,005,EL CASTILLO,3,590,290,300,24
GUANAJUATO,11,APASEO EL GRANDE,005,EL NACIMIENTO,3,367,194,173,13
GUANAJUATO,11,APASEO EL GRANDE,005,EL PEÑÓN (SAN ISIDRO DEL PEÑÓN),4,228,119,109,12
GUANAJUATO,11,APASEO EL GRANDE,005,EL TESORO,1,23,15,8,1
GUANAJUATO,11,APASEO EL GRANDE,005,EL TUNAL (LOS OLIVOS),4,596,315,281,27
GUANAJUATO,11,APASEO EL GRANDE,005,EL VICARIO,4,307,169,138,14
GUANAJUATO,11,APASEO EL GRANDE,005,ESCOBEDO,2,35,19,16,2
GUANAJUATO,11,APASEO EL GRANDE,005,ESTANCIA DEL LLANO (SAN JOSÉ DEL LLANO),4,519,252,267,23
GUANAJUATO,11,APASEO EL GRANDE,005,FUENTES DE BALVANERA,6,2145,1043,1102,77
GUANAJUATO,11,APASEO EL GRANDE,005,GUADALUPE DEL MONTE (EL RANCHITO),3,223,96,127,11
GUANAJUATO,11,APASEO EL GRANDE,005,IXTLA (SAN MIGUEL DE IXTLA),4,303,152,151,14
GUANAJUATO,11,APASEO EL GRANDE,005,JOCOQUI,4,591,327,264,22
GUANAJUATO,11,APASEO EL GRANDE,005,LA LABOR,3,259,135,124,12
GUANAJUATO,11,APASEO EL GRANDE,005,LA NORITA,3,321,154,167,12
GUANAJUATO,11,APASEO EL GRANDE,005,LA PALMA,5,679,352,327,24
GUANAJUATO,11,APASEO EL GRANDE,005,LA PURÍSIMA,3,263,146,117,12
GUANAJUATO,11,APASEO EL GRANDE,005,LOS JULIANES (LOS ÁNGELES),2,44,25,19,2
GUANAJUATO,11,APASEO EL GRANDE,005,OBRAJE DE IXTLA,3,194,91,103,10
GUANAJUATO,11,APASEO EL GRANDE,005,OBRAJUELO,5,817,419,398,29
GUANAJUATO,11,APASEO EL GRANDE,005,OJO DE AGUA DE IXTLA,3,219,102,117,10
GUANAJUATO,11,APASEO EL GRANDE,005,OJO ZARCO,3,95,50,45,5
GUANAJUATO,11,APASEO EL GRANDE,005,PUNTA DE OBRAJUELO,3,242,117,125,12
GUANAJUATO,11,APASEO EL GRANDE,005,RANCHO NUEVO,4,270,126,144,12
GUANAJUATO,11,APASEO EL GRANDE,005,RANCHO NUEVO LA CONCEPCIÓN,1,18,13,5,1
GUANAJUATO,11,APASEO EL GRANDE,005,RANCHO VIEJO,2,59,30,29,3
GUANAJUATO,11,APASEO EL GRANDE,005,SAN CRISTÓBAL,2,137,70,67,7
GUANAJUATO,11,APASEO EL GRANDE,005,SAN IGNACIO,2,53,27,26,3
GUANAJUATO,11,APASEO EL GRANDE,005,SAN JOSÉ AGUA AZUL,6,1047,541,506,42
GUANAJUATO,11,APASEO EL GRANDE,005,SAN JOSÉ VIBORILLAS,2,216,115,101,9
GUANAJUATO,11,APASEO EL GRANDE,005,SAN PEDRO TENANGO,5,1054,526,528,39
GUANAJUATO,11,APASEO EL GRANDE,005,SAN PEDRO TENANGO EL NUEVO,4,494,261,233,20
GUANAJUATO,11,APASEO EL GRANDE,005,SAN RAMÓN,3,212,110,102,10
GUANAJUATO,11,APASEO EL GRANDE,005,TIERRA BLANCA,4,296,150,146,13
GUANAJUATO,11,APASEO EL GRANDE,005,VILLAS DE LA ESTANCIA [FRACCIONAMIENTO],5,1960,1005,955,70
GUANAJUATO,11,ATARJEA,006,ÁLAMOS,4,168,93,75,7
GUANAJUATO,11,ATARJEA,006,ALDAMA (XOCONOXTLE),3,64,33,31,4
GUANAJUATO,11,ATARJEA,006,ATARJEA,3,82,55,27,5
GUANAJUATO,11,ATARJEA,006,CERRO PRIETO,3,35,10,25,3
GUANAJUATO,11,ATARJEA,006,EL APARTADERO,2,21,9,12,2
GUANAJUATO,11,ATARJEA,006,EL BANCO,3,30,16,14,3
GUANAJUATO,11,ATARJEA,006,EL CARRICILLO,4,167,78,89,8
GUANAJUATO,11,ATARJEA,006,EL CHARCO,2,22,6,16,2
GUANAJUATO,11,ATARJEA,006,EL CHILARITO,2,21,10,11,2
GUANAJUATO,11,ATARJEA,006,EL DURAZNO,2,35,17,18,2
GUANAJUATO,11,ATARJEA,006,EL MEZQUITAL,2,24,13,11,2
GUANAJUATO,11,ATARJEA,006,EL TORO,3,24,11,13,3
GUANAJUATO,11,ATARJEA,006,LA JOYA,1,11,7,4,1
GUANAJUATO,11,ATARJEA,006,LA LAGUNITA,2,18,10,8,2
GUANAJUATO,11,ATARJEA,006,LA TAPONA,4,177,85,92,8
GUANAJUATO,11,ATARJEA,006,LLANITOS A (EL REPASADERO),3,64,32,32,4
GUANAJUATO,11,ATARJEA,006,LOS LLANITOS,1,3,2,1,1
GUANAJUATO,11,ATARJEA,006,MANGAS CUATAS,4,156,90,66,12
GUANAJUATO,11,ATARJEA,006,PIEDRA GORDA,1,22,14,8,2
GUANAJUATO,11,ATARJEA,006,SAN ANTÓN,2,21,15,6,2
GUANAJUATO,11,ATARJEA,006,SAN JUAN DE DIOS,4,106,59,47,7
GUANAJUATO,11,CELAYA,007,CANOAS (CONGREGACIÓN DE CANOAS),1,9,4,5,1
GUANAJUATO,11,CELAYA,007,CELAYA,527,108698,55510,53188,8124
GUANAJUATO,11,CELAYA,007,COLONIA FRACCIONAMIENTO EL PUENTE,2,283,160,123,9
GUANAJUATO,11,CELAYA,007,COLONIA LOS PIRULES DE TROJES,1,9,7,2,1
GUANAJUATO,11,CELAYA,007,COLONIA LUIS DONALDO COLOSIO,1,69,31,38,5
GUANAJUATO,11,CELAYA,007,COLONIA NUEVO MÉXICO,1,11,8,3,1
GUANAJUATO,11,CELAYA,007,COLONIA PATRIA NUEVA,1,312,155,157,12
GUANAJUATO,11,CELAYA,007,EL MEZQUITE GORDO,1,716,351,365,38
GUANAJUATO,11,CELAYA,007,EL PUESTO,4,613,316,297,21
GUANAJUATO,11,CELAYA,007,EL SAUZ (EL SAUZ DE VILLASEÑOR),4,396,212,184,14
GUANAJUATO,11,CELAYA,007,ESTRADA,3,443,189,254,16
GUANAJUATO,11,CELAYA,007,EX-HACIENDA DE TROJES,3,276,140,136,10
GUANAJUATO,11,CELAYA,007,FRACCIONAMIENTO EL ÁLAMO,2,111,49,62,9
GUANAJUATO,11,CELAYA,007,GASCA,4,482,253,229,20
GUANAJUATO,11,CELAYA,007,JÁUREGUI,3,276,130,146,11
GUANAJUATO,11,CELAYA,007,JOFRE,2,109,54,55,5
GUANAJUATO,11,CELAYA,007,JUAN MARTÍN,5,769,352,417,26
GUANAJUATO,11,CELAYA,007,LA CONCEPCIÓN,2,92,42,50,4
GUANAJUATO,11,CELAYA,007,LA CRUZ,2,151,79,72,8
GUANAJUATO,11,CELAYA,007,LA ESPERANZA DE YUSTIS (LOS MARTÍNEZ),1,13,2,11,1
GUANAJUATO,11,CELAYA,007,LA LAJA,3,510,261,249,22
GUANAJUATO,11,CELAYA,007,LA LUZ,3,291,148,143,12
GUANAJUATO,11,CELAYA,007,LA MACHUCA,2,35,14,21,3
GUANAJUATO,11,CELAYA,007,LA PALMITA (LA PALMITA DE SAN GABRIEL),2,142,67,75,7
GUANAJUATO,11,CELAYA,007,LA TRINIDAD,2,239,124,115,9
GUANAJUATO,11,CELAYA,007,LAS MORENAS (FRANCISCO RUBIO),1,182,92,90,7
GUANAJUATO,11,CELAYA,007,LOS AGUIRRE,2,85,49,36,4
GUANAJUATO,11,CELAYA,007,LOS ARREGUINES (LA RECIBIDORA) [GRANJA],1,447,260,187,22
GUANAJUATO,11,CELAYA,007,LOS CAPULINES,3,101,59,42,5
GUANAJUATO,11,CELAYA,007,LOS GALVANES,4,208,115,93,13
GUANAJUATO,11,CELAYA,007,LOS HUESOS,2,22,12,10,3
GUANAJUATO,11,CELAYA,007,LOS MANCERA,2,260,137,123,9
GUANAJUATO,11,CELAYA,007,LOS TRES PUENTES,1,13,7,6,1
GUANAJUATO,11,CELAYA,007,MICHINELAS,2,63,35,28,3
GUANAJUATO,11,CELAYA,007,NUEVO PORVENIR (EL PUJIDO),2,19,9,10,2
GUANAJUATO,11,CELAYA,007,OJO SECO,4,393,198,195,14
GUANAJUATO,11,CELAYA,007,PLANCARTE,3,591,289,302,34
GUANAJUATO,11,CELAYA,007,PRESA BLANCA,5,561,278,283,23
GUANAJUATO,11,CELAYA,007,PRIMERA FRACCIÓN DE CRESPO (EL MOLINO),5,951,468,483,31
GUANAJUATO,11,CELAYA,007,PRIMERA FRACCIÓN DE CRESPO (EL TANQUE),1,251,129,122,9
GUANAJUATO,11,CELAYA,007,PUERTA DEL MONTE (ELGUERA),2,225,116,109,9
GUANAJUATO,11,CELAYA,007,RINCÓN DE TAMAYO,13,3350,1751,1599,168
GUANAJUATO,11,CELAYA,007,ROQUE (ITA),7,3672,1767,1905,130
GUANAJUATO,11,CELAYA,007,SAN ANTONIO ESPINOZA,2,118,67,51,6
GUANAJUATO,11,CELAYA,007,SAN CAYETANO,3,275,147,128,11
GUANAJUATO,11,CELAYA,007,SAN ELÍAS,5,616,309,307,26
GUANAJUATO,11,CELAYA,007,SAN ISIDRO CRESPO,4,667,336,331,25
GUANAJUATO,11,CELAYA,007,SAN ISIDRO DE ELGUERA,2,187,100,87,8
GUANAJUATO,11,CELAYA,007,SAN ISIDRO DE LA CONCEPCIÓN,3,508,239,269,21
GUANAJUATO,11,CELAYA,007,SAN ISIDRO DE TROJES,1,42,24,18,2
GUANAJUATO,11,CELAYA,007,SAN ISIDRO DEL PALMAR,2,13,7,6,2
GUANAJUATO,11,CELAYA,007,SAN ISIDRO DEL REFUGIO (EL TAJO),1,16,10,6,1
GUANAJUATO,11,CELAYA,007,SAN JOSÉ DE GUANAJUATO,9,1153,552,601,74
GUANAJUATO,11,CELAYA,007,SAN JOSÉ DE LA PRESA,1,28,8,20,1
GUANAJUATO,11,CELAYA,007,SAN JOSÉ DE MENDOZA,2,73,37,36,4
GUANAJUATO,11,CELAYA,007,SAN JOSÉ EL NUEVO,2,184,80,104,8
GUANAJUATO,11,CELAYA,007,SAN JUAN DE LA VEGA,18,4859,2421,2438,196
GUANAJUATO,11,CELAYA,007,SAN LORENZO,3,172,90,82,9
GUANAJUATO,11,CELAYA,007,SAN LUIS REY,2,177,85,92,8
GUANAJUATO,11,CELAYA,007,SAN MIGUEL OCTOPAN,16,4126,2033,2093,190
GUANAJUATO,11,CELAYA,007,SAN NICOLÁS ESQUIROS,3,251,137,114,11
GUANAJUATO,11,CELAYA,007,SAN RAFAEL DE YUSTIS (LORETÍO),1,8,2,6,1
GUANAJUATO,11,CELAYA,007,SANTA ANITA,2,189,87,102,8
GUANAJUATO,11,CELAYA,007,SANTA MARÍA DEL REFUGIO,8,809,382,427,44
GUANAJUATO,11,CELAYA,007,SANTA ROSA DE LIMA,1,3,1,2,1
GUANAJUATO,11,CELAYA,007,SANTA TERESA,5,587,297,290,25
GUANAJUATO,11,CELAYA,007,TENERÍA DE VALDEZ,1,208,115,93,61
GUANAJUATO,11,CELAYA,007,TENERÍA DEL SANTUARIO,4,866,434,432,33
GUANAJUATO,11,CELAYA,007,UNIVERSIDAD TECNOLÓGICA LAJA BAJÍO,1,329,148,181,34
GUANAJUATO,11,CELAYA,007,YUSTIS (SAN JOSÉ DE YUSTIS),3,509,252,257,22
GUANAJUATO,11,MANUEL DOBLADO,008,CALZADA DEL TEPOZÁN,4,333,178,155,25
GUANAJUATO,11,MANUEL DOBLADO,008,CERRITO DE SANTIAGO,2,22,9,13,2
GUANAJUATO,11,MANUEL DOBLADO,008,CIUDAD MANUEL DOBLADO,17,4070,2153,1917,172
GUANAJUATO,11,MANUEL DOBLADO,008,CONCEPCIÓN VIEJA (LA CONCHA VIEJA),3,84,34,50,5
GUANAJUATO,11,MANUEL DOBLADO,008,EL CHARCÓN,3,176,80,96,9
GUANAJUATO,11,MANUEL DOBLADO,008,EL GUAYABO DE ASCENCIO,1,26,9,17,1
GUANAJUATO,11,MANUEL DOBLADO,008,EL GUAYABO DE MUÑOZ,2,19,7,12,2
GUANAJUATO,11,MANUEL DOBLADO,008,EL NOPAL,1,3,3,0,1
GUANAJUATO,11,MANUEL DOBLADO,008,EL PIRUL,1,14,9,5,1
GUANAJUATO,11,MANUEL DOBLADO,008,EL TECUÁN,3,220,100,120,9
GUANAJUATO,11,MANUEL DOBLADO,008,EL VENADO,2,32,15,17,2
GUANAJUATO,11,MANUEL DOBLADO,008,EX-HACIENDA DE ATOTONILQUILLO,2,26,8,18,2
GUANAJUATO,11,MANUEL DOBLADO,008,FRACCIÓN BORDO VIEJO,2,29,17,12,2
GUANAJUATO,11,MANUEL DOBLADO,008,FRÍAS,4,357,176,181,15
GUANAJUATO,11,MANUEL DOBLADO,008,GUAYABO DE SANTA RITA,3,239,119,120,10
GUANAJUATO,11,MANUEL DOBLADO,008,HUIZACHE DE SERRANOS,3,95,50,45,4
GUANAJUATO,11,MANUEL DOBLADO,008,JAGÜEY DE SERRANOS,2,24,11,13,2
GUANAJUATO,11,MANUEL DOBLADO,008,LA CALZADA DE LA MERCED,4,212,101,111,13
GUANAJUATO,11,MANUEL DOBLADO,008,LA CHARCA,1,15,8,7,1
GUANAJUATO,11,MANUEL DOBLADO,008,LA LADERA,3,110,59,51,6
GUANAJUATO,11,MANUEL DOBLADO,008,LA MORA,2,25,13,12,2
GUANAJUATO,11,MANUEL DOBLADO,008,LA PLAYA,2,45,27,18,3
GUANAJUATO,11,MANUEL DOBLADO,008,LA PROVIDENCIA,2,9,5,4,2
GUANAJUATO,11,MANUEL DOBLADO,008,LA TORRECILLA,2,34,21,13,2
GUANAJUATO,11,MANUEL DOBLADO,008,LAS ADJUNTAS,2,67,25,42,4
GUANAJUATO,11,MANUEL DOBLADO,008,LAS COLORADAS,2,26,16,10,2
GUANAJUATO,11,MANUEL DOBLADO,008,LAS CUEVAS,2,7,4,3,2
GUANAJUATO,11,MANUEL DOBLADO,008,LOS OJOS DE AGUA,2,14,9,5,2
GUANAJUATO,11,MANUEL DOBLADO,008,LOS ÓRGANOS,1,10,7,3,1
GUANAJUATO,11,MANUEL DOBLADO,008,MARAVILLAS,3,233,115,118,11
GUANAJUATO,11,MANUEL DOBLADO,008,PASO HONDO,1,15,8,7,1
GUANAJUATO,11,MANUEL DOBLADO,008,PIEDRA PARADA (LA MANGA),2,57,32,25,3
GUANAJUATO,11,MANUEL DOBLADO,008,PIEDRAS NEGRAS,4,172,84,88,9
GUANAJUATO,11,MANUEL DOBLADO,008,PUERTA DE LLAVE,4,183,102,81,10
GUANAJUATO,11,MANUEL DOBLADO,008,PUERTO DEL LAUREL DOS ALTO,2,35,18,17,2
GUANAJUATO,11,MANUEL DOBLADO,008,RANCHO NUEVO DE ATOTONILQUILLO,4,302,153,149,16
GUANAJUATO,11,MANUEL DOBLADO,008,RANCHO NUEVO DE CERRITOS,3,26,12,14,4
GUANAJUATO,11,MANUEL DOBLADO,008,RANCHO NUEVO DEL VENADO,1,13,7,6,1
GUANAJUATO,11,MANUEL DOBLADO,008,RANCHO VIEJO DEL SAUZ,2,50,22,28,3
GUANAJUATO,11,MANUEL DOBLADO,008,RÍO VERDE,1,9,7,2,1
GUANAJUATO,11,MANUEL DOBLADO,008,SAN ANTONIO DE LA PRESA,2,61,34,27,3
GUANAJUATO,11,MANUEL DOBLADO,008,SAN JOSÉ DE BELLAVISTA,2,93,51,42,5
GUANAJUATO,11,MANUEL DOBLADO,008,SAN JOSÉ DE MOGOTES,2,54,25,29,3
GUANAJUATO,11,MANUEL DOBLADO,008,SAN JOSÉ DE ORNELAS,2,17,12,5,2
GUANAJUATO,11,MANUEL DOBLADO,008,SAN JOSÉ DE OTATES,4,214,106,108,10
GUANAJUATO,11,MANUEL DOBLADO,008,SAN JOSÉ DE SOLÍS,2,27,16,11,2
GUANAJUATO,11,MANUEL DOBLADO,008,SAN JOSÉ DE TANCO,2,22,10,12,2
GUANAJUATO,11,MANUEL DOBLADO,008,SAN JOSÉ DEL PASO,2,75,36,39,3
GUANAJUATO,11,MANUEL DOBLADO,008,SAN JUAN DE LA PUERTA,4,360,178,182,12
GUANAJUATO,11,MANUEL DOBLADO,008,SAN JUAN DEL FRESNO (EL CAÑÓN),1,5,2,3,1
GUANAJUATO,11,MANUEL DOBLADO,008,SAN LUISITO,1,20,6,14,1
GUANAJUATO,11,MANUEL DOBLADO,008,SAN MATÍAS,2,14,11,3,2
GUANAJUATO,11,MANUEL DOBLADO,008,SAN PABLO,3,118,59,59,5
GUANAJUATO,11,MANUEL DOBLADO,008,SANTA ANITA,2,50,25,25,3
GUANAJUATO,11,MANUEL DOBLADO,008,SANTA MARÍA DE BOLAÑOS,3,217,121,96,10
GUANAJUATO,11,MANUEL DOBLADO,008,SITIO DE MARAVILLAS,2,58,26,32,3
GUANAJUATO,11,MANUEL DOBLADO,008,TANGAMANGA,1,3,1,2,1
GUANAJUATO,11,MANUEL DOBLADO,008,TINAJA DE COLORADAS,2,9,5,4,2
GUANAJUATO,11,MANUEL DOBLADO,008,TUTITLÁN,2,11,7,4,2
GUANAJUATO,11,MANUEL DOBLADO,008,VADO DE ZAPIÉN,1,12,8,4,1
GUANAJUATO,11,MANUEL DOBLADO,008,ZAPOTE DE ADJUNTAS,4,125,60,65,9
GUANAJUATO,11,COMONFORT,009,AGUA BLANCA,2,82,44,38,3
GUANAJUATO,11,COMONFORT,009,ARIAS,1,12,4,8,1
GUANAJUATO,11,COMONFORT,009,BOCATOMA,1,7,5,2,1
GUANAJUATO,11,COMONFORT,009,CAÑADA DEL AGUA,3,147,71,76,7
GUANAJUATO,11,COMONFORT,009,COMONFORT,36,7022,3546,3476,434
GUANAJUATO,11,COMONFORT,009,DELGADO DE ABAJO,2,268,132,136,8
GUANAJUATO,11,COMONFORT,009,DELGADO DE ARRIBA,5,765,405,360,28
GUANAJUATO,11,COMONFORT,009,DON DIEGO,4,271,134,137,13
GUANAJUATO,11,COMONFORT,009,EJIDO CINCO DE FEBRERO,1,23,9,14,1
GUANAJUATO,11,COMONFORT,009,EL CORALILLO,2,10,4,6,2
GUANAJUATO,11,COMONFORT,009,EL GARAMBULLO,1,51,25,26,15
GUANAJUATO,11,COMONFORT,009,EL LINDERO,2,23,12,11,3
GUANAJUATO,11,COMONFORT,009,EL MANANTIAL DE LA CRUZ,2,6,4,2,1
GUANAJUATO,11,COMONFORT,009,EL PUERTECITO,3,18,9,9,3
GUANAJUATO,11,COMONFORT,009,EL TRIÁNGULO (LA LOMA DE LA LAGUNA),2,25,9,16,3
GUANAJUATO,11,COMONFORT,009,EMPALME ESCOBEDO,15,3738,1875,1863,166
GUANAJUATO,11,COMONFORT,009,GUADALUPE (SAN ANTONIO DE GUADALUPE),2,37,18,19,2
GUANAJUATO,11,COMONFORT,009,GUANI (SANTA MARÍA DE GUADALUPE),1,17,9,8,2
GUANAJUATO,11,COMONFORT,009,JALPILLA,6,590,315,275,25
GUANAJUATO,11,COMONFORT,009,LA ASUNCIÓN,3,76,38,38,4
GUANAJUATO,11,COMONFORT,009,LA BORUNDA,4,252,129,123,13
GUANAJUATO,11,COMONFORT,009,LA CANTERA,2,96,47,49,5
GUANAJUATO,11,COMONFORT,009,LA LAGUNA,3,202,89,113,8
GUANAJUATO,11,COMONFORT,009,LA PRESA (RANCHO DE LA PRESA DE LOS OLALDES),2,85,47,38,5
GUANAJUATO,11,COMONFORT,009,LANDÍN,5,600,313,287,25
GUANAJUATO,11,COMONFORT,009,LAS GALLINAS,2,73,34,39,4
GUANAJUATO,11,COMONFORT,009,LAS POMAS,2,8,6,2,1
GUANAJUATO,11,COMONFORT,009,LAS TROJAS,2,212,108,104,8
GUANAJUATO,11,COMONFORT,009,MARABIS COMONFORT [PARQUE INDUSTRIAL],1,158,93,65,18
GUANAJUATO,11,COMONFORT,009,MIRAFLORES,3,103,49,54,5
GUANAJUATO,11,COMONFORT,009,MORALES,4,436,225,211,18
GUANAJUATO,11,COMONFORT,009,NEUTLA,7,1306,666,640,79
GUANAJUATO,11,COMONFORT,009,NOPALERA,2,24,11,13,2
GUANAJUATO,11,COMONFORT,009,OJO DE AGUA DE GARCÍA,4,269,151,118,13
GUANAJUATO,11,COMONFORT,009,OJO DE AGUA DEL POTRERO,4,287,145,142,14
GUANAJUATO,11,COMONFORT,009,ORDUÑA DE ABAJO,4,547,274,273,20
GUANAJUATO,11,COMONFORT,009,ORDUÑA DE ARRIBA,2,174,84,90,8
GUANAJUATO,11,COMONFORT,009,PALMILLAS DE SAN JUAN,4,429,236,193,16
GUANAJUATO,11,COMONFORT,009,PALMILLAS DEL PICACHO,2,62,28,34,4
GUANAJUATO,11,COMONFORT,009,PEÑA COLORADA,2,22,13,9,2
GUANAJUATO,11,COMONFORT,009,PICACHO,3,258,145,113,11
GUANAJUATO,11,COMONFORT,009,POCITOS DE CORRALES,4,275,130,145,14
GUANAJUATO,11,COMONFORT,009,POTRERO,3,327,162,165,15
GUANAJUATO,11,COMONFORT,009,RANCHITO DE SORIA (JOSÉ RUBIO VÁZQUEZ),1,6,3,3,1
GUANAJUATO,11,COMONFORT,009,RANCHO EL POZO,1,5,2,3,1
GUANAJUATO,11,COMONFORT,009,REFUGIO DE ABAJO,2,151,88,63,7
GUANAJUATO,11,COMONFORT,009,REFUGIO DE ARRIBA,1,6,3,3,1
GUANAJUATO,11,COMONFORT,009,RINCÓN DEL PURGATORIO,3,118,62,56,6
GUANAJUATO,11,COMONFORT,009,RINCONCILLO (RINCONCILLO DE LOS REMEDIOS),2,111,54,57,5
GUANAJUATO,11,COMONFORT,009,ROSALES,2,139,71,68,6
GUANAJUATO,11,COMONFORT,009,SAN ANTONIO DE CORRALES,4,345,162,183,14
GUANAJUATO,11,COMONFORT,009,SAN ISIDRO (LA LOMA),2,126,65,61,6
GUANAJUATO,11,COMONFORT,009,SAN ISIDRO DE SAN JERÓNIMO,2,64,34,30,4
GUANAJUATO,11,COMONFORT,009,SAN JERÓNIMO,1,34,18,16,2
GUANAJUATO,11,COMONFORT,009,SAN PABLO,2,140,75,65,7
GUANAJUATO,11,COMONFORT,009,SAN PEDRO NORTE,1,133,64,69,6
GUANAJUATO,11,COMONFORT,009,SAN PEDRO SUR,2,105,53,52,5
GUANAJUATO,11,COMONFORT,009,XOCONOXTLE,3,119,66,53,4
GUANAJUATO,11,CORONEO,010,ACATLÁN,4,237,111,126,13
GUANAJUATO,11,CORONEO,010,CEBOLLETAS,4,189,101,88,10
GUANAJUATO,11,CORONEO,010,CERRO COLORADO,3,102,46,56,6
GUANAJUATO,11,CORONEO,010,CERRO PRIETO ORIENTE,2,38,22,16,3
GUANAJUATO,11,CORONEO,010,CERRO PRIETO PONIENTE,2,18,9,9,2
GUANAJUATO,11,CORONEO,010,CORONEO,11,1529,771,758,72
GUANAJUATO,11,CORONEO,010,CRUZ DEL PASTOR,2,19,7,12,2
GUANAJUATO,11,CORONEO,010,EL CAPULÍN,2,61,32,29,3
GUANAJUATO,11,CORONEO,010,EL ESPINAZO (LOMA BONITA),1,8,6,2,1
GUANAJUATO,11,CORONEO,010,EL PUERTECITO,1,11,7,4,1
GUANAJUATO,11,CORONEO,010,EL SAUZ DE CEBOLLETAS,2,71,35,36,4
GUANAJUATO,11,CORONEO,010,LA HUERTA,2,47,25,22,3
GUANAJUATO,11,CORONEO,010,LA PRESA,1,7,3,4,1
GUANAJUATO,11,CORONEO,010,LA VENTA NORTE,1,480,258,222,28
GUANAJUATO,11,CORONEO,010,LA VIBORILLA,2,40,24,16,2
GUANAJUATO,11,CORONEO,010,PIEDRA LARGA,4,174,78,96,11
GUANAJUATO,11,CORONEO,010,SALTO DE LEÓN,3,97,51,46,5
GUANAJUATO,11,CORONEO,010,SANTA CRUZ,1,8,3,5,1
GUANAJUATO,11,CORTAZAR,011,ARREGUÍN DE ARRIBA,4,200,95,105,11
GUANAJUATO,11,CORTAZAR,011,BELLAVISTA,4,328,168,160,14
GUANAJUATO,11,CORTAZAR,011,CAÑADA DE CARACHEO,4,433,214,219,16
GUANAJUATO,11,CORTAZAR,011,CARACHEO,4,363,171,192,17
GUANAJUATO,11,CORTAZAR,011,COLONIA DE FUENTES (LAS COLONIAS),3,82,34,48,5
GUANAJUATO,11,CORTAZAR,011,COLONIA LA FORTALEZA,3,247,120,127,11
GUANAJUATO,11,CORTAZAR,011,CORTAZAR,67,17124,8477,8647,1076
GUANAJUATO,11,CORTAZAR,011,EL DIEZMO,2,66,35,31,5
GUANAJUATO,11,CORTAZAR,011,EL HUIZACHE,4,586,304,282,25
GUANAJUATO,11,CORTAZAR,011,EL JILOTE,2,42,21,21,2
GUANAJUATO,11,CORTAZAR,011,EL SALITRE,2,54,25,29,3
GUANAJUATO,11,CORTAZAR,011,EL ZAPOTE,3,150,71,79,7
GUANAJUATO,11,CORTAZAR,011,GALERAS,2,68,27,41,4
GUANAJUATO,11,CORTAZAR,011,JUAN ALONSO,1,4267,1753,2514,220
GUANAJUATO,11,CORTAZAR,011,LA CONCEPCIÓN,2,25,11,14,2
GUANAJUATO,11,CORTAZAR,011,LA GAVIA,4,363,176,187,18
GUANAJUATO,11,CORTAZAR,011,LA HUERTA (SAN JOSÉ DE AMOLES),2,75,36,39,4
GUANAJUATO,11,CORTAZAR,011,LA MINILLA,2,46,21,25,3
GUANAJUATO,11,CORTAZAR,011,LA MOCHA,4,220,105,115,12
GUANAJUATO,11,CORTAZAR,011,LOMA LINDA (SAN JOSÉ DE PARRA),1,14,7,7,1
GUANAJUATO,11,CORTAZAR,011,MANDINGA,2,14,6,8,2
GUANAJUATO,11,CORTAZAR,011,MERINO,2,221,104,117,9
GUANAJUATO,11,CORTAZAR,011,NUEVO EJIDO DE MERINO,3,281,206,75,41
GUANAJUATO,11,CORTAZAR,011,PARRA,4,319,167,152,15
GUANAJUATO,11,CORTAZAR,011,SAN AGUSTÍN CULIACÁN,2,19,9,10,2
GUANAJUATO,11,CORTAZAR,011,SAN FRANCISCO DE LOS LEÓN,2,38,17,21,2
GUANAJUATO,11,CORTAZAR,011,SAN ISIDRO CULIACÁN,3,217,119,98,11
GUANAJUATO,11,CORTAZAR,011,SAN JOSÉ DE PARRA (COLA DE PATO),1,39,23,16,1
GUANAJUATO,11,CORTAZAR,011,SAN NICOLÁS DE MANANTIALES,2,97,54,43,4
GUANAJUATO,11,CORTAZAR,011,SANTA FE DE LA PURÍSIMA,3,256,133,123,13
GUANAJUATO,11,CORTAZAR,011,SAUZ DE FUENTES,2,33,15,18,2
GUANAJUATO,11,CORTAZAR,011,SAUZ DE MERINO,2,29,15,14,2
GUANAJUATO,11,CORTAZAR,011,TIERRA FRÍA,5,975,511,464,37
GUANAJUATO,11,CORTAZAR,011,VALENCIA DE FUENTES,2,100,54,46,4
GUANAJUATO,11,CORTAZAR,011,VISTA HERMOSA,1,15,9,6,1
GUANAJUATO,11,CUERÁMARO,012,18 DE MARZO (EL TOPE),2,32,14,18,2
GUANAJUATO,11,CUERÁMARO,012,BUENAVISTA (LA LECHUZA),2,48,19,29,3
GUANAJUATO,11,CUERÁMARO,012,CERRITO DE AGUA CALIENTE,4,236,110,126,14
GUANAJUATO,11,CUERÁMARO,012,COLONIA LINDA VISTA,1,26,7,19,1
GUANAJUATO,11,CUERÁMARO,012,COLONIA SAN MIGUEL,1,70,33,37,3
GUANAJUATO,11,CUERÁMARO,012,CUERÁMARO,16,4247,2117,2130,202
GUANAJUATO,11,CUERÁMARO,012,EJIDO LUZ MAZAS,2,77,37,40,4
GUANAJUATO,11,CUERÁMARO,012,EL NOVILLERO,2,18,11,7,2
GUANAJUATO,11,CUERÁMARO,012,EL NUEVO EDÉN,1,17,10,7,1
GUANAJUATO,11,CUERÁMARO,012,EL SAUCILLO,4,178,96,82,11
GUANAJUATO,11,CUERÁMARO,012,GALERA DE LA GRULLA,4,225,116,109,10
GUANAJUATO,11,CUERÁMARO,012,LA NUEVA ESPERANZA,2,42,24,18,3
GUANAJUATO,11,CUERÁMARO,012,LA PALMA,1,6,4,2,1
GUANAJUATO,11,CUERÁMARO,012,LA PRESA DE URIBE,3,212,108,104,10
GUANAJUATO,11,CUERÁMARO,012,LA REGALADA,2,115,59,56,6
GUANAJUATO,11,CUERÁMARO,012,LA SARTENEJA,3,118,58,60,6
GUANAJUATO,11,CUERÁMARO,012,LA SOLEDAD (LA PALANCA),2,36,18,18,3
GUANAJUATO,11,CUERÁMARO,012,LOS HORNOS,2,24,10,14,2
GUANAJUATO,11,CUERÁMARO,012,OJO DE AGUA,2,95,42,53,5
GUANAJUATO,11,CUERÁMARO,012,PLAN SEXENAL,2,39,21,18,2
GUANAJUATO,11,CUERÁMARO,012,PLATANAR,4,193,89,104,10
GUANAJUATO,11,CUERÁMARO,012,PUERTA DE LA RESERVA,3,278,123,155,11
GUANAJUATO,11,CUERÁMARO,012,SAN GREGORIO,5,272,138,134,14
GUANAJUATO,11,CUERÁMARO,012,SAN JOSÉ DE RAMALES,2,41,18,23,3
GUANAJUATO,11,CUERÁMARO,012,SANTA RITA (EJIDO REFUGIO DE AYALA),1,33,10,23,2
GUANAJUATO,11,CUERÁMARO,012,TRES VILLAS,3,75,39,36,4
GUANAJUATO,11,CUERÁMARO,012,TUPÁTARO,4,757,390,367,35
GUANAJUATO,11,DOCTOR MORA,013,ARROYO DE LA PLATA (SAN MIGUEL),2,30,14,16,2
GUANAJUATO,11,DOCTOR MORA,013,BEGOÑA,3,332,160,172,13
GUANAJUATO,11,DOCTOR MORA,013,CARBONERA DE GUADALUPE,2,78,46,32,3
GUANAJUATO,11,DOCTOR MORA,013,CERRITO DE LA ESTANCIA (CERRITO VERDE),3,149,79,70,6
GUANAJUATO,11,DOCTOR MORA,013,CERRO CHATO,2,105,47,58,5
GUANAJUATO,11,DOCTOR MORA,013,CUARTO BLANCO,1,73,33,40,4
GUANAJUATO,11,DOCTOR MORA,013,DERRAMADERO DE CHARCAS,2,138,61,77,7
GUANAJUATO,11,DOCTOR MORA,013,DERRAMADERO DE EN MEDIO,2,110,65,45,6
GUANAJUATO,11,DOCTOR MORA,013,DERRAMADERO DEL SAUZ,3,222,95,127,10
GUANAJUATO,11,DOCTOR MORA,013,DOCTOR MORA,8,2131,1073,1058,100
GUANAJUATO,11,DOCTOR MORA,013,EJIDO BEGOÑA,1,263,136,127,8
GUANAJUATO,11,DOCTOR MORA,013,EJIDO VAGUI,2,71,41,30,4
GUANAJUATO,11,DOCTOR MORA,013,EL BAÑO,1,21,9,12,1
GUANAJUATO,11,DOCTOR MORA,013,EL CARMEN,1,12,8,4,1
GUANAJUATO,11,DOCTOR MORA,013,EL LINDERO,3,323,171,152,12
GUANAJUATO,11,DOCTOR MORA,013,EL MEZQUITE,1,7,3,4,1
GUANAJUATO,11,DOCTOR MORA,013,ESCALANTE,3,145,62,83,5
GUANAJUATO,11,DOCTOR MORA,013,FLORENCIA,4,349,163,186,15
GUANAJUATO,11,DOCTOR MORA,013,LA BARRANCA,2,63,36,27,4
GUANAJUATO,11,DOCTOR MORA,013,LA DONCELLA,3,162,70,92,7
GUANAJUATO,11,DOCTOR MORA,013,LA ESTANCIA (EL CERRITO),2,44,27,17,3
GUANAJUATO,11,DOCTOR MORA,013,LA FORTUNA,1,9,3,6,1
GUANAJUATO,11,DOCTOR MORA,013,LA PRESA DEL GATO,2,147,69,78,7
GUANAJUATO,11,DOCTOR MORA,013,LA PURÍSIMA,2,112,56,56,5
GUANAJUATO,11,DOCTOR MORA,013,LA REDONDA,4,432,224,208,17
GUANAJUATO,11,DOCTOR MORA,013,LAS FLORES,3,160,85,75,9
GUANAJUATO,11,DOCTOR MORA,013,LAS PALMITAS,3,144,79,65,8
GUANAJUATO,11,DOCTOR MORA,013,LOMA DE BUENAVISTA,4,436,228,208,17
GUANAJUATO,11,DOCTOR MORA,013,LOMA DEL ZAPOTE,2,51,24,27,3
GUANAJUATO,11,DOCTOR MORA,013,LOS AMOLES,3,158,91,67,8
GUANAJUATO,11,DOCTOR MORA,013,LOS DURAZNOS,1,12,5,7,1
GUANAJUATO,11,DOCTOR MORA,013,MAJADA VERDE,1,31,17,14,2
GUANAJUATO,11,DOCTOR MORA,013,MORISQUILLAS,3,218,109,109,10
GUANAJUATO,11,DOCTOR MORA,013,NEGRITAS,2,53,30,23,3
GUANAJUATO,11,DOCTOR MORA,013,OBRAJITOS DE ABAJO,3,165,83,82,9
GUANAJUATO,11,DOCTOR MORA,013,OBRAJITOS DE ARRIBA,2,222,110,112,8
GUANAJUATO,11,DOCTOR MORA,013,PEÑA RODADA,4,227,118,109,12
GUANAJUATO,11,DOCTOR MORA,013,PUERTO DE TROJES (LA TROJA),2,50,24,26,3
GUANAJUATO,11,DOCTOR MORA,013,RANCHITO DE SAN JOSÉ,2,67,39,28,4
GUANAJUATO,11,DOCTOR MORA,013,RANCHO NUEVO DE GUADALUPE (EL HURÓN),2,66,30,36,4
GUANAJUATO,11,DOCTOR MORA,013,SACROMONTE,3,128,60,68,8
GUANAJUATO,11,DOCTOR MORA,013,SAN AGUSTÍN,1,24,14,10,1
GUANAJUATO,11,DOCTOR MORA,013,SAN ANTONIO TERCERO,1,17,12,5,1
GUANAJUATO,11,DOCTOR MORA,013,SAN JERÓNIMO DEL MEZQUITAL,1,11,4,7,1
GUANAJUATO,11,DOCTOR MORA,013,SAN RAFAEL,2,209,101,108,7
GUANAJUATO,11,DOCTOR MORA,013,TIERRA PRIETA,2,84,42,42,5
GUANAJUATO,11,DOCTOR MORA,013,VAGUI,3,141,72,69,8
GUANAJUATO,11,DOLORES HIDALGO CUNA DE LA INDEPENDENCIA NACIONAL,014,ADJUNTAS DEL MONTE,4,260,140,120,11
GUANAJUATO,11,DOLORES HIDALGO CUNA DE LA INDEPENDENCIA NACIONAL,014,ADJUNTAS DEL RÍO,6,693,358,335,27
GUANAJUATO,11,DOLORES HIDALGO CUNA DE LA INDEPENDENCIA NACIONAL,014,BORDO DE GUADALUPE,1,8,3,5,1
GUANAJUATO,11,DOLORES HIDALGO CUNA DE LA INDEPENDENCIA NACIONAL,014,BORDO DE SAN PEDRO,2,43,21,22,2
GUANAJUATO,11,DOLORES HIDALGO CUNA DE LA INDEPENDENCIA NACIONAL,014,CANCINO,2,40,16,24,2
GUANAJUATO,11,DOLORES HIDALGO CUNA DE LA INDEPENDENCIA NACIONAL,014,CAÑADA DE GONZÁLEZ,2,19,11,8,2
GUANAJUATO,11,DOLORES HIDALGO CUNA DE LA INDEPENDENCIA NACIONAL,014,CASAS VIEJAS,2,12,4,8,2
GUANAJUATO,11,DOLORES HIDALGO CUNA DE LA INDEPENDENCIA NACIONAL,014,CEJA DE SAN AGUSTÍN,2,57,37,20,3
GUANAJUATO,11,DOLORES HIDALGO CUNA DE LA INDEPENDENCIA NACIONAL,014,CERRITO DE GUADALUPE,1,6,5,1,1
GUANAJUATO,11,DOLORES HIDALGO CUNA DE LA INDEPENDENCIA NACIONAL,014,CERRITO DE LA PAZ,1,16,8,8,1
GUANAJUATO,11,DOLORES HIDALGO CUNA DE LA INDEPENDENCIA NACIONAL,014,CERRITO DE SAN PABLO,2,102,59,43,4
GUANAJUATO,11,DOLORES HIDALGO CUNA DE LA INDEPENDENCIA NACIONAL,014,CERRITO DE SANTA CECILIA,1,30,16,14,1
GUANAJUATO,11,DOLORES HIDALGO CUNA DE LA INDEPENDENCIA NACIONAL,014,CERRO BLANCO,3,115,63,52,6
GUANAJUATO,11,DOLORES HIDALGO CUNA DE LA INDEPENDENCIA NACIONAL,014,CIENEGUILLA,2,100,55,45,4
GUANAJUATO,11,DOLORES HIDALGO CUNA DE LA INDEPENDENCIA NACIONAL,014,CINCO LLAGAS,1,7,3,4,1
GUANAJUATO,11,DOLORES HIDALGO CUNA DE LA INDEPENDENCIA NACIONAL,014,COECILLO,2,86,45,41,5
GUANAJUATO,11,DOLORES HIDALGO CUNA DE LA INDEPENDENCIA NACIONAL,014,COLONIA FRANCISCO I. MADERO,1,273,116,157,63
GUANAJUATO,11,DOLORES HIDALGO CUNA DE LA INDEPENDENCIA NACIONAL,014,COLONIA VILLAS DEL SOL,2,14,8,6,2
GUANAJUATO,11,DOLORES HIDALGO CUNA DE LA INDEPENDENCIA NACIONAL,014,CRUZ DE PIEDRA,2,8,7,1,2
GUANAJUATO,11,DOLORES HIDALGO CUNA DE LA INDEPENDENCIA NACIONAL,014,DELGADILLO,3,108,54,54,5
GUANAJUATO,11,DOLORES HIDALGO CUNA DE LA INDEPENDENCIA NACIONAL,014,DOLORES HIDALGO CUNA DE LA INDEPENDENCIA NACIONAL,98,24807,12726,12081,1344
GUANAJUATO,11,DOLORES HIDALGO CUNA DE LA INDEPENDENCIA NACIONAL,014,DON PEDRO,2,33,20,13,3
GUANAJUATO,11,DOLORES HIDALGO CUNA DE LA INDEPENDENCIA NACIONAL,014,DON SEBASTIÁN,1,84,46,38,3
GUANAJUATO,11,DOLORES HIDALGO CUNA DE LA INDEPENDENCIA NACIONAL,014,EJIDO DE CIENEGUILLA,2,111,57,54,4
GUANAJUATO,11,DOLORES HIDALGO CUNA DE LA INDEPENDENCIA NACIONAL,014,EJIDO JESÚS MARÍA (ARTURO AGUILAR GARCÍA),2,184,95,89,9
GUANAJUATO,11,DOLORES HIDALGO CUNA DE LA INDEPENDENCIA NACIONAL,014,EL ÁLAMO,2,240,117,123,10
GUANAJUATO,11,DOLORES HIDALGO CUNA DE LA INDEPENDENCIA NACIONAL,014,EL APARTADERO,1,7,5,2,1
GUANAJUATO,11,DOLORES HIDALGO CUNA DE LA INDEPENDENCIA NACIONAL,014,EL BANCO (SAN VICENTE DE LA PROVIDENCIA),1,11,5,6,1
GUANAJUATO,11,DOLORES HIDALGO CUNA DE LA INDEPENDENCIA NACIONAL,014,EL CAPULÍN,4,186,105,81,9
GUANAJUATO,11,DOLORES HIDALGO CUNA DE LA INDEPENDENCIA NACIONAL,014,EL CARMEN DE LA CUESTA,1,15,8,7,1
GUANAJUATO,11,DOLORES HIDALGO CUNA DE LA INDEPENDENCIA NACIONAL,014,EL CARPINTERO,1,6,3,3,1
GUANAJUATO,11,DOLORES HIDALGO CUNA DE LA INDEPENDENCIA NACIONAL,014,EL COLORADO,2,42,23,19,3
GUANAJUATO,11,DOLORES HIDALGO CUNA DE LA INDEPENDENCIA NACIONAL,014,EL CONTADOR,2,62,31,31,4
GUANAJUATO,11,DOLORES HIDALGO CUNA DE LA INDEPENDENCIA NACIONAL,014,EL CORONEL,2,13,9,4,2
GUANAJUATO,11,DOLORES HIDALGO CUNA DE LA INDEPENDENCIA NACIONAL,014,EL DERRAMADERO,2,56,30,26,2
GUANAJUATO,11,DOLORES HIDALGO CUNA DE LA INDEPENDENCIA NACIONAL,014,EL DURAZNO,3,79,41,38,5
GUANAJUATO,11,DOLORES HIDALGO CUNA DE LA INDEPENDENCIA NACIONAL,014,EL GALLINERO,4,329,162,167,14
GUANAJUATO,11,DOLORES HIDALGO CUNA DE LA INDEPENDENCIA NACIONAL,014,EL GATO,2,25,9,16,2
GUANAJUATO,11,DOLORES HIDALGO CUNA DE LA INDEPENDENCIA NACIONAL,014,EL GUSANO,2,58,25,33,3
GUANAJUATO,11,DOLORES HIDALGO CUNA DE LA INDEPENDENCIA NACIONAL,014,EL JALTOMATE,2,127,69,58,6
GUANAJUATO,11,DOLORES HIDALGO CUNA DE LA INDEPENDENCIA NACIONAL,014,EL LLANITO,3,536,261,275,21
GUANAJUATO,11,DOLORES HIDALGO CUNA DE LA INDEPENDENCIA NACIONAL,014,EL LLANO DE ARRIBA (EL LLANO REDONDO),2,103,48,55,5
GUANAJUATO,11,DOLORES HIDALGO CUNA DE LA INDEPENDENCIA NACIONAL,014,EL MASTRANTO,2,18,6,12,2
GUANAJUATO,11,DOLORES HIDALGO CUNA DE LA INDEPENDENCIA NACIONAL,014,EL MEZQUITAL,2,63,30,33,4
GUANAJUATO,11,DOLORES HIDALGO CUNA DE LA INDEPENDENCIA NACIONAL,014,EL MOLINO,3,114,58,56,7
GUANAJUATO,11,DOLORES HIDALGO CUNA DE LA INDEPENDENCIA NACIONAL,014,EL MONTAÑÉS,1,4,1,3,1
GUANAJUATO,11,DOLORES HIDALGO CUNA DE LA INDEPENDENCIA NACIONAL,014,EL PÁJARO BOBO,2,122,63,59,6
GUANAJUATO,11,DOLORES HIDALGO CUNA DE LA INDEPENDENCIA NACIONAL,014,EL PARAÍSO,1,12,5,7,1
GUANAJUATO,11,DOLORES HIDALGO CUNA DE LA INDEPENDENCIA NACIONAL,014,EL PEDREGAL,1,15,8,7,1
GUANAJUATO,11,DOLORES HIDALGO CUNA DE LA INDEPENDENCIA NACIONAL,014,EL PRIETO,2,62,25,37,4
GUANAJUATO,11,DOLORES HIDALGO CUNA DE LA INDEPENDENCIA NACIONAL,014,EL RAMILLETE,4,95,42,53,4
GUANAJUATO,11,DOLORES HIDALGO CUNA DE LA INDEPENDENCIA NACIONAL,014,EL REFUGIO DE TRANCAS,3,153,69,84,6
GUANAJUATO,11,DOLORES HIDALGO CUNA DE LA INDEPENDENCIA NACIONAL,014,EL RINCÓN (RINCÓN DEL ESTAÑO),3,94,48,46,6
GUANAJUATO,11,DOLORES HIDALGO CUNA DE LA INDEPENDENCIA NACIONAL,014,EL ROSILLO (EL ROSILLO DE ARRIBA),1,9,4,5,1
GUANAJUATO,11,DOLORES HIDALGO CUNA DE LA INDEPENDENCIA NACIONAL,014,EL SAUCILLO,4,213,107,106,11
GUANAJUATO,11,DOLORES HIDALGO CUNA DE LA INDEPENDENCIA NACIONAL,014,EL SAUCITO,2,38,16,22,2
GUANAJUATO,11,DOLORES HIDALGO CUNA DE LA INDEPENDENCIA NACIONAL,014,EL TECOLOTE,3,57,29,28,3
GUANAJUATO,11,DOLORES HIDALGO CUNA DE LA INDEPENDENCIA NACIONAL,014,EL TEPOZÁN,2,32,16,16,2
GUANAJUATO,11,DOLORES HIDALGO CUNA DE LA INDEPENDENCIA NACIONAL,014,EL TOBOSO,2,8,5,3,2
GUANAJUATO,11,DOLORES HIDALGO CUNA DE LA INDEPENDENCIA NACIONAL,014,ESTANCIA DE ZAMARRIPA,3,135,76,59,6
GUANAJUATO,11,DOLORES HIDALGO CUNA DE LA INDEPENDENCIA NACIONAL,014,GALANCILLO,2,29,14,15,2
GUANAJUATO,11,DOLORES HIDALGO CUNA DE LA INDEPENDENCIA NACIONAL,014,GARABATILLO,2,111,66,45,6
GUANAJUATO,11,DOLORES HIDALGO CUNA DE LA INDEPENDENCIA NACIONAL,014,GUANAJUATITO,1,11,7,4,1
GUANAJUATO,11,DOLORES HIDALGO CUNA DE LA INDEPENDENCIA NACIONAL,014,HACIENDA DE ABAJO,1,8,8,0,1
GUANAJUATO,11,DOLORES HIDALGO CUNA DE LA INDEPENDENCIA NACIONAL,014,JAMAICA (SAN MIGUEL DE JAMAICA),8,643,314,329,29
GUANAJUATO,11,DOLORES HIDALGO CUNA DE LA INDEPENDENCIA NACIONAL,014,JERICÓ DE MARÍA (LA COLONIA),2,19,8,11,2
GUANAJUATO,11,DOLORES HIDALGO CUNA DE LA INDEPENDENCIA NACIONAL,014,JERICÓ DE TRANCAS,2,24,9,15,2
GUANAJUATO,11,DOLORES HIDALGO CUNA DE LA INDEPENDENCIA NACIONAL,014,JOYA DE JESÚS MARÍA (LA JOYA),1,13,6,7,1
GUANAJUATO,11,DOLORES HIDALGO CUNA DE LA INDEPENDENCIA NACIONAL,014,LA CABAÑA,2,29,12,17,2
GUANAJUATO,11,DOLORES HIDALGO CUNA DE LA INDEPENDENCIA NACIONAL,014,LA CABRA,2,80,51,29,4
GUANAJUATO,11,DOLORES HIDALGO CUNA DE LA INDEPENDENCIA NACIONAL,014,LA CALIFORNIA,4,318,163,155,14
GUANAJUATO,11,DOLORES HIDALGO CUNA DE LA INDEPENDENCIA NACIONAL,014,LA CANDELARIA,2,9,4,5,1
GUANAJUATO,11,DOLORES HIDALGO CUNA DE LA INDEPENDENCIA NACIONAL,014,LA CANTERA,7,555,263,292,25
GUANAJUATO,11,DOLORES HIDALGO CUNA DE LA INDEPENDENCIA NACIONAL,014,LA CAZUELA,2,39,12,27,2
GUANAJUATO,11,DOLORES HIDALGO CUNA DE LA INDEPENDENCIA NACIONAL,014,LA COLMENA,2,22,15,7,2
GUANAJUATO,11,DOLORES HIDALGO CUNA DE LA INDEPENDENCIA NACIONAL,014,LA COLORADA,3,234,119,115,12
GUANAJUATO,11,DOLORES HIDALGO CUNA DE LA INDEPENDENCIA NACIONAL,014,LA CRUZ DEL PADRE RAZO (LAS CRUCITAS),2,220,110,110,9
GUANAJUATO,11,DOLORES HIDALGO CUNA DE LA INDEPENDENCIA NACIONAL,014,LA CRUZ DEL PASTOR,2,10,4,6,2
GUANAJUATO,11,DOLORES HIDALGO CUNA DE LA INDEPENDENCIA NACIONAL,014,LA CUESTA DE TANDEROS,2,9,3,6,2
GUANAJUATO,11,DOLORES HIDALGO CUNA DE LA INDEPENDENCIA NACIONAL,014,LA ERRE,3,245,121,124,11
GUANAJUATO,11,DOLORES HIDALGO CUNA DE LA INDEPENDENCIA NACIONAL,014,LA ESPERANZA,4,127,65,62,7
GUANAJUATO,11,DOLORES HIDALGO CUNA DE LA INDEPENDENCIA NACIONAL,014,LA GRULLA DE ABAJO,4,223,102,121,12
GUANAJUATO,11,DOLORES HIDALGO CUNA DE LA INDEPENDENCIA NACIONAL,014,LA HACIENDITA,4,177,87,90,10
GUANAJUATO,11,DOLORES HIDALGO CUNA DE LA INDEPENDENCIA NACIONAL,014,LA JARILLA (LAS LOMITAS),2,39,20,19,2
GUANAJUATO,11,DOLORES HIDALGO CUNA DE LA INDEPENDENCIA NACIONAL,014,LA JOYA,2,34,18,16,2
GUANAJUATO,11,DOLORES HIDALGO CUNA DE LA INDEPENDENCIA NACIONAL,014,LA LAGUNA,2,39,12,27,2
GUANAJUATO,11,DOLORES HIDALGO CUNA DE LA INDEPENDENCIA NACIONAL,014,LA LUZ,3,64,35,29,3
GUANAJUATO,11,DOLORES HIDALGO CUNA DE LA INDEPENDENCIA NACIONAL,014,LA LUZ DE TRANCAS,2,9,0,9,2
GUANAJUATO,11,DOLORES HIDALGO CUNA DE LA INDEPENDENCIA NACIONAL,014,LA NUEVA LUZ,2,9,6,3,2
GUANAJUATO,11,DOLORES HIDALGO CUNA DE LA INDEPENDENCIA NACIONAL,014,LA PALMILLA,2,103,48,55,6
GUANAJUATO,11,DOLORES HIDALGO CUNA DE LA INDEPENDENCIA NACIONAL,014,LA PIEDRA,2,112,66,46,6
GUANAJUATO,11,DOLORES HIDALGO CUNA DE LA INDEPENDENCIA NACIONAL,014,LA PRESA DEL GALLINERO,2,199,88,111,8
GUANAJUATO,11,DOLORES HIDALGO CUNA DE LA INDEPENDENCIA NACIONAL,014,LA PROVIDENCIA (VADILLO DE GUADALUPE),4,84,45,39,5
GUANAJUATO,11,DOLORES HIDALGO CUNA DE LA INDEPENDENCIA NACIONAL,014,LA PUERTA DE SAN FRANCISCO,2,125,73,52,6
GUANAJUATO,11,DOLORES HIDALGO CUNA DE LA INDEPENDENCIA NACIONAL,014,LA PURÍSIMA,2,32,21,11,2
GUANAJUATO,11,DOLORES HIDALGO CUNA DE LA INDEPENDENCIA NACIONAL,014,LA QUEMADITA,4,461,242,219,18
GUANAJUATO,11,DOLORES HIDALGO CUNA DE LA INDEPENDENCIA NACIONAL,014,LA REGALADA (REGALADA DE ABAJO),2,51,26,25,3
GUANAJUATO,11,DOLORES HIDALGO CUNA DE LA INDEPENDENCIA NACIONAL,014,LA SABANA,3,351,185,166,15
GUANAJUATO,11,DOLORES HIDALGO CUNA DE LA INDEPENDENCIA NACIONAL,014,LA TRINIDAD,3,85,42,43,5
GUANAJUATO,11,DOLORES HIDALGO CUNA DE LA INDEPENDENCIA NACIONAL,014,LA VENTA,4,478,241,237,20
GUANAJUATO,11,DOLORES HIDALGO CUNA DE LA INDEPENDENCIA NACIONAL,014,LA VENTILLA,3,184,106,78,10
GUANAJUATO,11,DOLORES HIDALGO CUNA DE LA INDEPENDENCIA NACIONAL,014,LADY MARY,3,104,56,48,3
GUANAJUATO,11,DOLORES HIDALGO CUNA DE LA INDEPENDENCIA NACIONAL,014,LAS ESCOBAS,2,42,23,19,2
GUANAJUATO,11,DOLORES HIDALGO CUNA DE LA INDEPENDENCIA NACIONAL,014,LAS FUENTES,3,33,16,17,4
GUANAJUATO,11,DOLORES HIDALGO CUNA DE LA INDEPENDENCIA NACIONAL,014,LAS LIEBRES,3,25,9,16,3
GUANAJUATO,11,DOLORES HIDALGO CUNA DE LA INDEPENDENCIA NACIONAL,014,LAS LOZAS,2,26,12,14,2
GUANAJUATO,11,DOLORES HIDALGO CUNA DE LA INDEPENDENCIA NACIONAL,014,LAS MILPITAS,2,69,38,31,3
GUANAJUATO,11,DOLORES HIDALGO CUNA DE LA INDEPENDENCIA NACIONAL,014,LAS NEGRITAS,2,65,34,31,3
GUANAJUATO,11,DOLORES HIDALGO CUNA DE LA INDEPENDENCIA NACIONAL,014,LAS TROJES DEL RINCÓN,1,4,1,3,1
GUANAJUATO,11,DOLORES HIDALGO CUNA DE LA INDEPENDENCIA NACIONAL,014,LAS YERBAS,4,279,140,139,15
GUANAJUATO,11,DOLORES HIDALGO CUNA DE LA INDEPENDENCIA NACIONAL,014,LÓPEZ DE ABAJO,2,16,11,5,2
GUANAJUATO,11,DOLORES HIDALGO CUNA DE LA INDEPENDENCIA NACIONAL,014,LOS ARCOS,2,54,42,12,3
GUANAJUATO,11,DOLORES HIDALGO CUNA DE LA INDEPENDENCIA NACIONAL,014,LOS ARRIEROS DE TRANCAS,2,7,2,5,2
GUANAJUATO,11,DOLORES HIDALGO CUNA DE LA INDEPENDENCIA NACIONAL,014,LOS AVILÉS,3,35,17,18,3
GUANAJUATO,11,DOLORES HIDALGO CUNA DE LA INDEPENDENCIA NACIONAL,014,LOS CARRILLO,2,147,94,53,21
GUANAJUATO,11,DOLORES HIDALGO CUNA DE LA INDEPENDENCIA NACIONAL,014,LOS CLAVELES,1,8,4,4,1
GUANAJUATO,11,DOLORES HIDALGO CUNA DE LA INDEPENDENCIA NACIONAL,014,LOS GARCÍA,2,10,2,8,1
GUANAJUATO,11,DOLORES HIDALGO CUNA DE LA INDEPENDENCIA NACIONAL,014,LOS HERNÁNDEZ,2,50,16,34,3
GUANAJUATO,11,DOLORES HIDALGO CUNA DE LA INDEPENDENCIA NACIONAL,014,LOS HERREROS,2,57,25,32,3
GUANAJUATO,11,DOLORES HIDALGO CUNA DE LA INDEPENDENCIA NACIONAL,014,LOS LÓPEZ DE ARRIBA,2,17,8,9,2
GUANAJUATO,11,DOLORES HIDALGO CUNA DE LA INDEPENDENCIA NACIONAL,014,LOS LUGO,1,20,8,12,1
GUANAJUATO,11,DOLORES HIDALGO CUNA DE LA INDEPENDENCIA NACIONAL,014,LOS MONCADA,1,12,6,6,1
GUANAJUATO,11,DOLORES HIDALGO CUNA DE LA INDEPENDENCIA NACIONAL,014,LOS QUIOTES,3,48,20,28,3
GUANAJUATO,11,DOLORES HIDALGO CUNA DE LA INDEPENDENCIA NACIONAL,014,LOS RODRÍGUEZ,1,14,9,5,1
GUANAJUATO,11,DOLORES HIDALGO CUNA DE LA INDEPENDENCIA NACIONAL,014,LOS SERNA,2,46,28,18,2
GUANAJUATO,11,DOLORES HIDALGO CUNA DE LA INDEPENDENCIA NACIONAL,014,MANZANOS,2,26,10,16,2
GUANAJUATO,11,DOLORES HIDALGO CUNA DE LA INDEPENDENCIA NACIONAL,014,MESA DE LÓPEZ,2,100,53,47,4
GUANAJUATO,11,DOLORES HIDALGO CUNA DE LA INDEPENDENCIA NACIONAL,014,MOJONERAS,3,60,27,33,3
GUANAJUATO,11,DOLORES HIDALGO CUNA DE LA INDEPENDENCIA NACIONAL,014,MONTELONGO (SAN FRANCISCO),4,407,198,209,18
GUANAJUATO,11,DOLORES HIDALGO CUNA DE LA INDEPENDENCIA NACIONAL,014,MORILLOS,2,15,7,8,2
GUANAJUATO,11,DOLORES HIDALGO CUNA DE LA INDEPENDENCIA NACIONAL,014,NORIA LIBRE,2,7,1,6,2
GUANAJUATO,11,DOLORES HIDALGO CUNA DE LA INDEPENDENCIA NACIONAL,014,NORIA NUEVA,2,44,22,22,3
GUANAJUATO,11,DOLORES HIDALGO CUNA DE LA INDEPENDENCIA NACIONAL,014,OJO DE AGUA DE CERVANTES,4,131,76,55,8
GUANAJUATO,11,DOLORES HIDALGO CUNA DE LA INDEPENDENCIA NACIONAL,014,OJO DE AGUA DE TEPEXTLE,2,31,18,13,2
GUANAJUATO,11,DOLORES HIDALGO CUNA DE LA INDEPENDENCIA NACIONAL,014,OJO DE AGUA DE TRANCAS (EL PENAL DE TRANCAS),2,30,19,11,3
GUANAJUATO,11,DOLORES HIDALGO CUNA DE LA INDEPENDENCIA NACIONAL,014,OJO ZARCO,3,82,32,50,4
GUANAJUATO,11,DOLORES HIDALGO CUNA DE LA INDEPENDENCIA NACIONAL,014,PALACIO DE ABAJO,3,103,46,57,5
GUANAJUATO,11,DOLORES HIDALGO CUNA DE LA INDEPENDENCIA NACIONAL,014,PALMA PRIETA,2,186,87,99,8
GUANAJUATO,11,DOLORES HIDALGO CUNA DE LA INDEPENDENCIA NACIONAL,014,PALMITAS,4,84,41,43,8
GUANAJUATO,11,DOLORES HIDALGO CUNA DE LA INDEPENDENCIA NACIONAL,014,PAREDONES,3,51,22,29,3
GUANAJUATO,11,DOLORES HIDALGO CUNA DE LA INDEPENDENCIA NACIONAL,014,PASO DE ALEJO,1,8,5,3,1
GUANAJUATO,11,DOLORES HIDALGO CUNA DE LA INDEPENDENCIA NACIONAL,014,PEÑA COLORADA,2,19,12,7,2
GUANAJUATO,11,DOLORES HIDALGO CUNA DE LA INDEPENDENCIA NACIONAL,014,PEÑA PRIETA,2,78,45,33,4
GUANAJUATO,11,DOLORES HIDALGO CUNA DE LA INDEPENDENCIA NACIONAL,014,POTRERO DE GUADALUPE,2,26,10,16,3
GUANAJUATO,11,DOLORES HIDALGO CUNA DE LA INDEPENDENCIA NACIONAL,014,POTRERO DE JESÚS,2,10,6,4,2
GUANAJUATO,11,DOLORES HIDALGO CUNA DE LA INDEPENDENCIA NACIONAL,014,POZO NUEVO,3,44,21,23,4
GUANAJUATO,11,DOLORES HIDALGO CUNA DE LA INDEPENDENCIA NACIONAL,014,PUERTA DEL CERROTE,2,25,15,10,2
GUANAJUATO,11,DOLORES HIDALGO CUNA DE LA INDEPENDENCIA NACIONAL,014,PURÍSIMA DE CEBOLLETAS,2,32,16,16,2
GUANAJUATO,11,DOLORES HIDALGO CUNA DE LA INDEPENDENCIA NACIONAL,014,RANCHITO DE LOS HERNÁNDEZ,1,17,8,9,1
GUANAJUATO,11,DOLORES HIDALGO CUNA DE LA INDEPENDENCIA NACIONAL,014,RANCHO DE EN MEDIO DE LOS LUGO,1,11,5,6,1
GUANAJUATO,11,DOLORES HIDALGO CUNA DE LA INDEPENDENCIA NACIONAL,014,RANCHO DE GUADALUPE,4,287,132,155,13
GUANAJUATO,11,DOLORES HIDALGO CUNA DE LA INDEPENDENCIA NACIONAL,014,RANCHO EL CALVARITO,2,117,51,66,5
GUANAJUATO,11,DOLORES HIDALGO CUNA DE LA INDEPENDENCIA NACIONAL,014,RANCHO LOS DOLORES,2,25,13,12,2
GUANAJUATO,11,DOLORES HIDALGO CUNA DE LA INDEPENDENCIA NACIONAL,014,RANCHO NUEVO DE SAN JOSÉ DE BADILLO,4,303,147,156,15
GUANAJUATO,11,DOLORES HIDALGO CUNA DE LA INDEPENDENCIA NACIONAL,014,RANCHO OVEJAS,2,55,27,28,3
GUANAJUATO,11,DOLORES HIDALGO CUNA DE LA INDEPENDENCIA NACIONAL,014,REFUGIO DE MONTELONGO,1,16,10,6,1
GUANAJUATO,11,DOLORES HIDALGO CUNA DE LA INDEPENDENCIA NACIONAL,014,RÍO LAJA,5,683,300,383,28
GUANAJUATO,11,DOLORES HIDALGO CUNA DE LA INDEPENDENCIA NACIONAL,014,RIOYOS,2,51,25,26,3
GUANAJUATO,11,DOLORES HIDALGO CUNA DE LA INDEPENDENCIA NACIONAL,014,SAN ANTÓN DE CEBALLOS,2,59,26,33,3
GUANAJUATO,11,DOLORES HIDALGO CUNA DE LA INDEPENDENCIA NACIONAL,014,SAN ANTÓN DE LAS MINAS,3,187,85,102,9
GUANAJUATO,11,DOLORES HIDALGO CUNA DE LA INDEPENDENCIA NACIONAL,014,SAN ANTONIO,1,32,17,15,1
GUANAJUATO,11,DOLORES HIDALGO CUNA DE LA INDEPENDENCIA NACIONAL,014,SAN ANTONIO DE TIERRA BLANCA,2,92,41,51,5
GUANAJUATO,11,DOLORES HIDALGO CUNA DE LA INDEPENDENCIA NACIONAL,014,SAN ANTONIO DEL CARMEN,2,133,65,68,6
GUANAJUATO,11,DOLORES HIDALGO CUNA DE LA INDEPENDENCIA NACIONAL,014,SAN ANTONIO DEL LLANITO,1,19,9,10,1
GUANAJUATO,11,DOLORES HIDALGO CUNA DE LA INDEPENDENCIA NACIONAL,014,SAN ANTONIO DEL TEPOZÁN,3,48,20,28,3
GUANAJUATO,11,DOLORES HIDALGO CUNA DE LA INDEPENDENCIA NACIONAL,014,SAN CRISTÓBAL,3,76,44,32,4
GUANAJUATO,11,DOLORES HIDALGO CUNA DE LA INDEPENDENCIA NACIONAL,014,SAN ELÍAS,3,91,40,51,5
GUANAJUATO,11,DOLORES HIDALGO CUNA DE LA INDEPENDENCIA NACIONAL,014,SAN FRANCISCO,1,16,6,10,2
GUANAJUATO,11,DOLORES HIDALGO CUNA DE LA INDEPENDENCIA NACIONAL,014,SAN FRANCISCO (EL RANCHITO),2,19,9,10,2
GUANAJUATO,11,DOLORES HIDALGO CUNA DE LA INDEPENDENCIA NACIONAL,014,SAN FRANCISCO DE LA ERRE,2,103,47,56,6
GUANAJUATO,11,DOLORES HIDALGO CUNA DE LA INDEPENDENCIA NACIONAL,014,SAN GABRIEL,4,399,213,186,16
GUANAJUATO,11,DOLORES HIDALGO CUNA DE LA INDEPENDENCIA NACIONAL,014,SAN IGNACIO DE LOYOLA,1,24,16,8,1
GUANAJUATO,11,DOLORES HIDALGO CUNA DE LA INDEPENDENCIA NACIONAL,014,SAN ISIDRO DE LA ESTACADA,3,283,133,150,11
GUANAJUATO,11,DOLORES HIDALGO CUNA DE LA INDEPENDENCIA NACIONAL,014,SAN ISIDRO DE LOS CAMACHO,2,23,10,13,3
GUANAJUATO,11,DOLORES HIDALGO CUNA DE LA INDEPENDENCIA NACIONAL,014,SAN ISIDRO DEL CARMEN,1,25,10,15,1
GUANAJUATO,11,DOLORES HIDALGO CUNA DE LA INDEPENDENCIA NACIONAL,014,SAN ISIDRO DEL DURAZNO (LOS AGUILAR),2,45,19,26,2
GUANAJUATO,11,DOLORES HIDALGO CUNA DE LA INDEPENDENCIA NACIONAL,014,SAN ISIDRO DEL SISOTE,3,149,69,80,6
GUANAJUATO,11,DOLORES HIDALGO CUNA DE LA INDEPENDENCIA NACIONAL,014,SAN JOSÉ DE BADILLO,2,77,45,32,4
GUANAJUATO,11,DOLORES HIDALGO CUNA DE LA INDEPENDENCIA NACIONAL,014,SAN JOSÉ DE LA CAJA,2,46,28,18,3
GUANAJUATO,11,DOLORES HIDALGO CUNA DE LA INDEPENDENCIA NACIONAL,014,SAN JOSÉ DE LA CAMPANA (LAS CUEVAS),3,49,24,25,3
GUANAJUATO,11,DOLORES HIDALGO CUNA DE LA INDEPENDENCIA NACIONAL,014,SAN JOSÉ DE LA ESTACADA (FÁTIMA),3,71,34,37,4
GUANAJUATO,11,DOLORES HIDALGO CUNA DE LA INDEPENDENCIA NACIONAL,014,SAN JOSÉ DE LA PALMA,4,480,251,229,23
GUANAJUATO,11,DOLORES HIDALGO CUNA DE LA INDEPENDENCIA NACIONAL,014,SAN JOSÉ DE LAGUNILLAS,3,672,373,299,32
GUANAJUATO,11,DOLORES HIDALGO CUNA DE LA INDEPENDENCIA NACIONAL,014,SAN JUAN DEL ESTAÑO,2,64,32,32,3
GUANAJUATO,11,DOLORES HIDALGO CUNA DE LA INDEPENDENCIA NACIONAL,014,SAN MARCOS DE ABAJO,4,303,166,137,13
GUANAJUATO,11,DOLORES HIDALGO CUNA DE LA INDEPENDENCIA NACIONAL,014,SAN MARCOS DE ARRIBA (HACIENDA DE ARRIBA),2,43,22,21,3
GUANAJUATO,11,DOLORES HIDALGO CUNA DE LA INDEPENDENCIA NACIONAL,014,SAN MARTÍN DE TERREROS,4,284,155,129,15
GUANAJUATO,11,DOLORES HIDALGO CUNA DE LA INDEPENDENCIA NACIONAL,014,SAN NICOLÁS DE ARROYO SECO,2,142,87,55,6
GUANAJUATO,11,DOLORES HIDALGO CUNA DE LA INDEPENDENCIA NACIONAL,014,SAN NICOLÁS DE LA PRESA,1,14,9,5,1
GUANAJUATO,11,DOLORES HIDALGO CUNA DE LA INDEPENDENCIA NACIONAL,014,SAN NICOLÁS DE TRANCAS,1,5,0,5,1
GUANAJUATO,11,DOLORES HIDALGO CUNA DE LA INDEPENDENCIA NACIONAL,014,SAN PABLO,2,165,81,84,8
GUANAJUATO,11,DOLORES HIDALGO CUNA DE LA INDEPENDENCIA NACIONAL,014,SAN PEDRO (PALO MOCHO),2,57,29,28,3
GUANAJUATO,11,DOLORES HIDALGO CUNA DE LA INDEPENDENCIA NACIONAL,014,SAN PEDRO DE LA SIERRA,3,24,11,13,3
GUANAJUATO,11,DOLORES HIDALGO CUNA DE LA INDEPENDENCIA NACIONAL,014,SAN RAFAEL,3,45,27,18,4
GUANAJUATO,11,DOLORES HIDALGO CUNA DE LA INDEPENDENCIA NACIONAL,014,SAN SERGIO,3,28,11,17,3
GUANAJUATO,11,DOLORES HIDALGO CUNA DE LA INDEPENDENCIA NACIONAL,014,SAN SIMEÓN,3,72,37,35,4
GUANAJUATO,11,DOLORES HIDALGO CUNA DE LA INDEPENDENCIA NACIONAL,014,SAN VICENTE,3,113,54,59,6
GUANAJUATO,11,DOLORES HIDALGO CUNA DE LA INDEPENDENCIA NACIONAL,014,SANTA BÁRBARA,3,120,60,60,6
GUANAJUATO,11,DOLORES HIDALGO CUNA DE LA INDEPENDENCIA NACIONAL,014,SANTA CATARINA,2,91,49,42,4
GUANAJUATO,11,DOLORES HIDALGO CUNA DE LA INDEPENDENCIA NACIONAL,014,SANTA CLARA,3,338,181,157,12
GUANAJUATO,11,DOLORES HIDALGO CUNA DE LA INDEPENDENCIA NACIONAL,014,SANTA CRUZ DEL MECO,1,24,8,16,1
GUANAJUATO,11,DOLORES HIDALGO CUNA DE LA INDEPENDENCIA NACIONAL,014,SANTA LUCÍA,2,52,26,26,2
GUANAJUATO,11,DOLORES HIDALGO CUNA DE LA INDEPENDENCIA NACIONAL,014,SANTA RITA,2,24,10,14,3
GUANAJUATO,11,DOLORES HIDALGO CUNA DE LA INDEPENDENCIA NACIONAL,014,SANTA TERESA DE JIRICUICHI,1,36,19,17,2
GUANAJUATO,11,DOLORES HIDALGO CUNA DE LA INDEPENDENCIA NACIONAL,014,SANTIAGUILLO,3,106,61,45,6
GUANAJUATO,11,DOLORES HIDALGO CUNA DE LA INDEPENDENCIA NACIONAL,014,SANTO NIÑO,2,23,12,11,3
GUANAJUATO,11,DOLORES HIDALGO CUNA DE LA INDEPENDENCIA NACIONAL,014,SILLEROS DEL ROSARIO,3,28,14,14,3
GUANAJUATO,11,DOLORES HIDALGO CUNA DE LA INDEPENDENCIA NACIONAL,014,SOLEDAD ANTIGUA (SOLEDAD VIEJA),3,21,11,10,3
GUANAJUATO,11,DOLORES HIDALGO CUNA DE LA INDEPENDENCIA NACIONAL,014,SOLEDAD NUEVA,4,396,202,194,18
GUANAJUATO,11,DOLORES HIDALGO CUNA DE LA INDEPENDENCIA NACIONAL,014,TAMPICO (TAMPIQUILLO),1,4,2,2,1
GUANAJUATO,11,DOLORES HIDALGO CUNA DE LA INDEPENDENCIA NACIONAL,014,TANQUE COLORADO,2,103,45,58,4
GUANAJUATO,11,DOLORES HIDALGO CUNA DE LA INDEPENDENCIA NACIONAL,014,TEQUISQUIAPAN,4,525,291,234,23
GUANAJUATO,11,DOLORES HIDALGO CUNA DE LA INDEPENDENCIA NACIONAL,014,TERRERO DE TRANCAS,2,34,19,15,2
GUANAJUATO,11,DOLORES HIDALGO CUNA DE LA INDEPENDENCIA NACIONAL,014,TERREROS,1,20,11,9,1
GUANAJUATO,11,DOLORES HIDALGO CUNA DE LA INDEPENDENCIA NACIONAL,014,TERREROS DE LA SABANA,4,311,144,167,13
GUANAJUATO,11,DOLORES HIDALGO CUNA DE LA INDEPENDENCIA NACIONAL,014,TRANCAS,4,293,161,132,13
GUANAJUATO,11,DOLORES HIDALGO CUNA DE LA INDEPENDENCIA NACIONAL,014,TRANCAS VIEJAS,2,12,9,3,2
GUANAJUATO,11,DOLORES HIDALGO CUNA DE LA INDEPENDENCIA NACIONAL,014,XOCONOXTLE DE REMÁTALO,4,142,83,59,8
GUANAJUATO,11,DOLORES HIDALGO CUNA DE LA INDEPENDENCIA NACIONAL,014,XOCONOXTLE EL GRANDE,4,287,156,131,15
GUANAJUATO,11,DOLORES HIDALGO CUNA DE LA INDEPENDENCIA NACIONAL,014,XOCONOXTLITO DEL LLANITO,3,132,65,67,7
GUANAJUATO,11,GUANAJUATO,015,AGUA COLORADA,2,46,26,20,2
GUANAJUATO,11,GUANAJUATO,015,AGUA ZARCA,1,5,2,3,1
GUANAJUATO,11,GUANAJUATO,015,ARPEROS,4,243,110,133,14
GUANAJUATO,11,GUANAJUATO,015,CAJONES,2,81,38,43,4
GUANAJUATO,11,GUANAJUATO,015,CALDERONES,3,207,98,109,11
GUANAJUATO,11,GUANAJUATO,015,CAMPUZANO,4,361,183,178,14
GUANAJUATO,11,GUANAJUATO,015,CAÑADA DE BUSTOS,4,1205,616,589,41
GUANAJUATO,11,GUANAJUATO,015,CAÑADA DE LA VIRGEN,2,15,9,6,2
GUANAJUATO,11,GUANAJUATO,015,CAPULÍN DE BUSTOS,4,810,394,416,27
GUANAJUATO,11,GUANAJUATO,015,CARBONERA,2,25,13,12,2
GUANAJUATO,11,GUANAJUATO,015,CIÉNEGA DE NEGROS,2,21,12,9,2
GUANAJUATO,11,GUANAJUATO,015,CIÉNEGA DEL PEDREGAL,2,91,51,40,4
GUANAJUATO,11,GUANAJUATO,015,CIENEGUITA DE SAN BARTOLO,2,40,13,27,2
GUANAJUATO,11,GUANAJUATO,015,CUESTECITA DE SAN JUAN,2,33,18,15,2
GUANAJUATO,11,GUANAJUATO,015,EL CASTILLO,3,23,13,10,3
GUANAJUATO,11,GUANAJUATO,015,EL CEDRO (MINERAL DEL CEDRO),2,76,40,36,3
GUANAJUATO,11,GUANAJUATO,015,EL COYOTE,3,288,126,162,11
GUANAJUATO,11,GUANAJUATO,015,EL CUERVITO (EL CUERVO),3,26,19,7,3
GUANAJUATO,11,GUANAJUATO,015,EL LAUREL,2,17,9,8,2
GUANAJUATO,11,GUANAJUATO,015,EL MALUCO,2,211,118,93,8
GUANAJUATO,11,GUANAJUATO,015,EL TABLÓN,3,55,31,24,4
GUANAJUATO,11,GUANAJUATO,015,EL TEJABÁN,4,310,157,153,14
GUANAJUATO,11,GUANAJUATO,015,EL TERRERO,3,92,42,50,4
GUANAJUATO,11,GUANAJUATO,015,EL VARAL,3,28,15,13,3
GUANAJUATO,11,GUANAJUATO,015,EX-HACIENDA EL SAUZ,2,28,10,18,2
GUANAJUATO,11,GUANAJUATO,015,GRANJA LA PAZ,3,146,75,71,7
GUANAJUATO,11,GUANAJUATO,015,GUANAJUATO,109,46261,23938,22323,2633
GUANAJUATO,11,GUANAJUATO,015,HACIENDA GUADALUPE,4,514,262,252,22
GUANAJUATO,11,GUANAJUATO,015,ITESG (TECNOLÓGICO),2,2392,997,1395,98
GUANAJUATO,11,GUANAJUATO,015,LA CONCEPCIÓN,4,277,137,140,14
GUANAJUATO,11,GUANAJUATO,015,LA ESTANCIA DE COMANJILLA,3,104,51,53,4
GUANAJUATO,11,GUANAJUATO,015,LA HUERTA,2,13,4,9,2
GUANAJUATO,11,GUANAJUATO,015,LA PALMA,3,88,47,41,5
GUANAJUATO,11,GUANAJUATO,015,LA POZA (OJO DE AGUA),2,62,30,32,3
GUANAJUATO,11,GUANAJUATO,015,LA PRESITA,1,35,15,20,1
GUANAJUATO,11,GUANAJUATO,015,LA SAUCEDA (SANTA FE DE GUADALUPE),7,1499,762,737,50
GUANAJUATO,11,GUANAJUATO,015,LA TRINIDAD,4,520,256,264,22
GUANAJUATO,11,GUANAJUATO,015,LAGUNILLAS DE LA FRATERNIDAD,1,4,3,1,1
GUANAJUATO,11,GUANAJUATO,015,LAS MAGDALENAS,2,24,10,14,2
GUANAJUATO,11,GUANAJUATO,015,LLANOS DE LA FRAGUA,3,105,55,50,6
GUANAJUATO,11,GUANAJUATO,015,LLANOS DE SANTA ANA,2,163,87,76,7
GUANAJUATO,11,GUANAJUATO,015,LOMAS DE CERVERA,2,913,445,468,68
GUANAJUATO,11,GUANAJUATO,015,LOS LORENZOS,4,538,284,254,26
GUANAJUATO,11,GUANAJUATO,015,LOS NICOLASES,3,498,243,255,19
GUANAJUATO,11,GUANAJUATO,015,MARFIL,22,4924,2515,2409,310
GUANAJUATO,11,GUANAJUATO,015,MESA CUATA,3,164,83,81,6
GUANAJUATO,11,GUANAJUATO,015,MINERAL DE LA LUZ,4,627,327,300,26
GUANAJUATO,11,GUANAJUATO,015,MINERAL DE MEXIAMORA,3,86,40,46,4
GUANAJUATO,11,GUANAJUATO,015,MINERAL DEL CUBO,4,187,89,98,9
GUANAJUATO,11,GUANAJUATO,015,MOLINEROS,2,73,40,33,4
GUANAJUATO,11,GUANAJUATO,015,MONTE DE SAN NICOLÁS,2,55,26,29,3
GUANAJUATO,11,GUANAJUATO,015,OJO DE AGUA DE MEDINA,2,23,9,14,2
GUANAJUATO,11,GUANAJUATO,015,PASO DE PIRULES,5,964,468,496,30
GUANAJUATO,11,GUANAJUATO,015,PICONES,1,7,3,4,1
GUANAJUATO,11,GUANAJUATO,015,POTRERO (LA CIÉNEGA DEL POTRERO),3,34,17,17,3
GUANAJUATO,11,GUANAJUATO,015,PUENTECILLAS,7,1816,913,903,55
GUANAJUATO,11,GUANAJUATO,015,PUERTO DE SANTA ROSA,2,52,30,22,2
GUANAJUATO,11,GUANAJUATO,015,RANCHO DE EN MEDIO,2,13,10,3,2
GUANAJUATO,11,GUANAJUATO,015,RANCHO LOS MARTÍNEZ,1,5,4,1,1
GUANAJUATO,11,GUANAJUATO,015,ROSA DE CASTILLA,2,96,53,43,4
GUANAJUATO,11,GUANAJUATO,015,SAN ISIDRO,2,110,52,58,5
GUANAJUATO,11,GUANAJUATO,015,SAN JOSÉ DE CERVERA,9,1798,895,903,92
GUANAJUATO,11,GUANAJUATO,015,SAN JOSÉ DE GRACIA,1,7,4,3,1
GUANAJUATO,11,GUANAJUATO,015,SAN JOSÉ DE LLANOS,5,1354,660,694,39
GUANAJUATO,11,GUANAJUATO,015,SAN JOSÉ DE PINOS,3,95,36,59,4
GUANAJUATO,11,GUANAJUATO,015,SAN JOSÉ DE TRÁNSITO,4,378,183,195,15
GUANAJUATO,11,GUANAJUATO,015,SAN JOSÉ DEL CHAPÍN,2,50,25,25,3
GUANAJUATO,11,GUANAJUATO,015,SAN JOSÉ DEL GACHO,1,10,5,5,1
GUANAJUATO,11,GUANAJUATO,015,SAN JOSÉ DEL RODEO,3,348,176,172,12
GUANAJUATO,11,GUANAJUATO,015,SAN NICOLÁS (SAN NICOLÁS DEL CHAPÍN),2,35,21,14,3
GUANAJUATO,11,GUANAJUATO,015,SAN PEDRO,1,9,6,3,1
GUANAJUATO,11,GUANAJUATO,015,SAN VICENTE DE LA CRUZ,1,11,6,5,1
GUANAJUATO,11,GUANAJUATO,015,SANGRE DE CRISTO,1,22,9,13,1
GUANAJUATO,11,GUANAJUATO,015,SANTA ANA (SANTANA),2,56,32,24,3
GUANAJUATO,11,GUANAJUATO,015,SANTA CATARINA DE CUEVAS (EL TINACO),6,575,292,283,25
GUANAJUATO,11,GUANAJUATO,015,SANTA ROSA DE LIMA,4,428,205,223,18
GUANAJUATO,11,GUANAJUATO,015,SANTA TERESA,6,1259,627,632,59
GUANAJUATO,11,GUANAJUATO,015,SANTIAGUILLO,1,7,4,3,1
GUANAJUATO,11,GUANAJUATO,015,SANTO DOMINGO,1,5,2,3,1
GUANAJUATO,11,GUANAJUATO,015,SOLANO,1,85,46,39,3
GUANAJUATO,11,GUANAJUATO,015,TENERÍAS,2,9,2,7,2
GUANAJUATO,11,GUANAJUATO,015,UCEA CAMPUS MARFIL,3,5842,3319,2523,606
GUANAJUATO,11,GUANAJUATO,015,YERBABUENA,13,2342,1162,1180,99
GUANAJUATO,11,GUANAJUATO,015,ZANGARRO (ZANGARRO NUEVO),5,520,263,257,19
GUANAJUATO,11,HUANÍMARO,016,CERRITO ALTO NUEVO,3,110,60,50,5
GUANAJUATO,11,HUANÍMARO,016,CERRITO DE AGUIRRE,1,6,2,4,1
GUANAJUATO,11,HUANÍMARO,016,COLONIA RAFAEL GARCÍA,2,53,23,30,3
GUANAJUATO,11,HUANÍMARO,016,COPALES,2,26,9,17,2
GUANAJUATO,11,HUANÍMARO,016,CORA,2,72,35,37,4
GUANAJUATO,11,HUANÍMARO,016,EL DURAZNO (EL DURAZNITO),2,61,25,36,4
GUANAJUATO,11,HUANÍMARO,016,HUANÍMARO,8,1902,977,925,73
GUANAJUATO,11,HUANÍMARO,016,JARRILLAS,2,18,10,8,2
GUANAJUATO,11,HUANÍMARO,016,JOROCHES (JOROCHES NUEVO),3,171,96,75,9
GUANAJUATO,11,HUANÍMARO,016,LA CANTERA,2,25,10,15,2
GUANAJUATO,11,HUANÍMARO,016,LA GRANJA (LA GATA),2,48,24,24,3
GUANAJUATO,11,HUANÍMARO,016,LA LOBERA (EL RIÑÓN),3,425,219,206,18
GUANAJUATO,11,HUANÍMARO,016,LA TINAJA,2,64,34,30,4
GUANAJUATO,11,HUANÍMARO,016,LOS OTATES,4,295,150,145,15
GUANAJUATO,11,HUANÍMARO,016,MONTE BLANCO,3,228,114,114,12
GUANAJUATO,11,HUANÍMARO,016,OJOS DE AGUA,4,288,123,165,14
GUANAJUATO,11,HUANÍMARO,016,PASO DE CARRETAS,1,19,14,5,1
GUANAJUATO,11,HUANÍMARO,016,PASO DE COBOS,2,36,17,19,2
GUANAJUATO,11,HUANÍMARO,016,RANCHO DE GUADALUPE (EL GATO),4,241,125,116,10
GUANAJUATO,11,HUANÍMARO,016,SAN ANTONIO DE EGUÍA (EL RANCHITO),2,22,9,13,2
GUANAJUATO,11,HUANÍMARO,016,SAN CRISTÓBAL DE AYALA,4,160,92,68,9
GUANAJUATO,11,HUANÍMARO,016,SAN ISIDRO DE AYALA,2,59,33,26,3
GUANAJUATO,11,HUANÍMARO,016,SAN JOSÉ DE AYALA,3,360,184,176,15
GUANAJUATO,11,HUANÍMARO,016,SAN JUAN GRANDE,4,321,156,165,14
GUANAJUATO,11,HUANÍMARO,016,SAN RAMÓN,2,62,31,31,4
GUANAJUATO,11,HUANÍMARO,016,ZAPOTE DE AGUIRRE,2,32,15,17,2
GUANAJUATO,11,IRAPUATO,017,ADJUNTAS,2,96,54,42,5
GUANAJUATO,11,IRAPUATO,017,ALDAMA,6,1452,754,698,63
GUANAJUATO,11,IRAPUATO,017,CAÑADA DE LA MUERTE,2,75,35,40,4
GUANAJUATO,11,IRAPUATO,017,CASTRO DEL RÍO [PARQUE INDUSTRIAL CASTRO DEL RÍO],1,806,364,442,98
GUANAJUATO,11,IRAPUATO,017,CINVESTAV,1,141,68,73,26
GUANAJUATO,11,IRAPUATO,017,COLONIA LA SOLEDAD,1,36,22,14,2
GUANAJUATO,11,IRAPUATO,017,COLONIA MORELOS DE GUADALUPE DE RIVERA,3,331,158,173,12
GUANAJUATO,11,IRAPUATO,017,COMEDERITO,2,32,18,14,2
GUANAJUATO,11,IRAPUATO,017,COMEDERO GRANDE,2,130,71,59,5
GUANAJUATO,11,IRAPUATO,017,CUARTA BRIGADA,4,865,447,418,30
GUANAJUATO,11,IRAPUATO,017,CUCHICUATO,5,984,477,507,39
GUANAJUATO,11,IRAPUATO,017,EJIDO DE MALVAS (LA ARGOLLA),5,911,457,454,30
GUANAJUATO,11,IRAPUATO,017,EJIDO DEL REFUGIO (LOS LÓPEZ),1,10,5,5,1
GUANAJUATO,11,IRAPUATO,017,EL CARMEN,3,623,279,344,22
GUANAJUATO,11,IRAPUATO,017,EL CARRIZAL GRANDE,6,1223,632,591,40
GUANAJUATO,11,IRAPUATO,017,EL CARRIZALITO,4,503,235,268,17
GUANAJUATO,11,IRAPUATO,017,EL COECILLO,2,154,84,70,6
GUANAJUATO,11,IRAPUATO,017,EL CONEJO,2,82,38,44,4
GUANAJUATO,11,IRAPUATO,017,EL ENCINO DEL COPAL,2,32,14,18,2
GUANAJUATO,11,IRAPUATO,017,EL GARBANZO,3,18,8,10,3
GUANAJUATO,11,IRAPUATO,017,EL ROMERAL,2,174,88,86,7
GUANAJUATO,11,IRAPUATO,017,EL SAUZ BENDITO,5,329,172,157,58
GUANAJUATO,11,IRAPUATO,017,EL VENADO DE YÓSTIRO,3,413,196,217,17
GUANAJUATO,11,IRAPUATO,017,ESTANCIA DEL COPAL,2,27,14,13,2
GUANAJUATO,11,IRAPUATO,017,EX-HACIENDA DE BUENAVISTA (EL GABAZO),1,7,3,4,1
GUANAJUATO,11,IRAPUATO,017,EX-HACIENDA DEL COPAL,9,4025,2308,1717,477
GUANAJUATO,11,IRAPUATO,017,GABINO VÁZQUEZ (LAS VÍBORAS),2,48,23,25,3
GUANAJUATO,11,IRAPUATO,017,GRANJA LA ZARCA,1,9,3,6,1
GUANAJUATO,11,IRAPUATO,017,GUADALUPE DE PASO BLANCO (EL RANCHITO),2,218,100,118,9
GUANAJUATO,11,IRAPUATO,017,GUADALUPE DE RIVERA,4,512,240,272,20
GUANAJUATO,11,IRAPUATO,017,GUADALUPE VILLA CÁRDENAS,2,190,98,92,8
GUANAJUATO,11,IRAPUATO,017,HACIENDA DE MÁRQUEZ,4,600,293,307,22
GUANAJUATO,11,IRAPUATO,017,IRAPUATO,485,115646,58710,56936,6794
GUANAJUATO,11,IRAPUATO,017,LA CAJA,5,425,219,206,21
GUANAJUATO,11,IRAPUATO,017,LA CALERA,7,1867,934,933,66
GUANAJUATO,11,IRAPUATO,017,LA CAPILLA,1,14,6,8,1
GUANAJUATO,11,IRAPUATO,017,LA GARRIDA,3,290,147,143,11
GUANAJUATO,11,IRAPUATO,017,LA LUZ DEL DÍA (EJIDO DE LA SONAJA),1,15,9,6,1
GUANAJUATO,11,IRAPUATO,017,LA PILA DE LOS HERNÁNDEZ,2,9,4,5,2
GUANAJUATO,11,IRAPUATO,017,LA SANABRIA,2,99,44,55,4
GUANAJUATO,11,IRAPUATO,017,LA SOLEDAD,5,998,479,519,30
GUANAJUATO,11,IRAPUATO,017,LA TRINIDAD DE TEMASCATÍO,3,357,186,171,14
GUANAJUATO,11,IRAPUATO,017,LAGUNA LARGA,4,332,154,178,14
GUANAJUATO,11,IRAPUATO,017,LAS PEÑITAS,2,62,33,29,3
GUANAJUATO,11,IRAPUATO,017,LO DE JUÁREZ,8,1733,884,849,81
GUANAJUATO,11,IRAPUATO,017,LO DE SIERRA,2,90,50,40,4
GUANAJUATO,11,IRAPUATO,017,MOLINO DE SANTA ANA,2,273,139,134,9
GUANAJUATO,11,IRAPUATO,017,MUNGUÍA,4,273,136,137,13
GUANAJUATO,11,IRAPUATO,017,NORIA DE CAMARENA,4,206,101,105,12
GUANAJUATO,11,IRAPUATO,017,NORIA DE MUNGUÍA,2,42,23,19,2
GUANAJUATO,11,IRAPUATO,017,NUEVA COLONIA COPALILLO (EL ATORÓN),2,145,69,76,8
GUANAJUATO,11,IRAPUATO,017,NUEVO EJIDO DE SAN LORENZO,2,90,46,44,5
GUANAJUATO,11,IRAPUATO,017,OJO DE AGUA DE BERMÚDEZ,2,76,34,42,4
GUANAJUATO,11,IRAPUATO,017,PASO BLANCO,4,342,179,163,17
GUANAJUATO,11,IRAPUATO,017,PEÑUELAS,2,271,128,143,9
GUANAJUATO,11,IRAPUATO,017,POTRERO DE LA NORIA DE CAMARENA,2,38,16,22,3
GUANAJUATO,11,IRAPUATO,017,PROVIDENCIA DE PÉREZ (EL GUANTÓN),3,272,136,136,11
GUANAJUATO,11,IRAPUATO,017,PURÍSIMA DE COVARRUBIAS,2,222,107,115,8
GUANAJUATO,11,IRAPUATO,017,PURÍSIMA DE TEMASCATÍO DE ABAJO,1,23,12,11,1
GUANAJUATO,11,IRAPUATO,017,PURÍSIMA DE TEMASCATÍO DE ARRIBA,2,198,88,110,8
GUANAJUATO,11,IRAPUATO,017,PURÍSIMA DEL PROGRESO,1,182,81,101,6
GUANAJUATO,11,IRAPUATO,017,RANCHO DE LOS RODRÍGUEZ,3,34,13,21,4
GUANAJUATO,11,IRAPUATO,017,RANCHO NUEVO DE DOLORES (EL CUERO),2,121,67,54,6
GUANAJUATO,11,IRAPUATO,017,RANCHO NUEVO DE YÓSTIRO,2,294,146,148,11
GUANAJUATO,11,IRAPUATO,017,RANCHO NUEVO DEL LLANITO,2,466,235,231,18
GUANAJUATO,11,IRAPUATO,017,RIVERA DE GUADALUPE,2,208,107,101,8
GUANAJUATO,11,IRAPUATO,017,ROSARIO DE COVARRUBIAS,3,117,63,54,7
GUANAJUATO,11,IRAPUATO,017,SAN AGUSTÍN DE LOS TORDOS,4,699,339,360,51
GUANAJUATO,11,IRAPUATO,017,SAN AGUSTÍN EL ALTO (LA ARAÑA),1,91,42,49,3
GUANAJUATO,11,IRAPUATO,017,SAN ANTONIO DE CHICO,2,224,119,105,9
GUANAJUATO,11,IRAPUATO,017,SAN ANTONIO EL RICO,3,539,278,261,18
GUANAJUATO,11,IRAPUATO,017,SAN ANTONIO TEXAS,2,64,29,35,4
GUANAJUATO,11,IRAPUATO,017,SAN CRISTÓBAL,5,1510,766,744,50
GUANAJUATO,11,IRAPUATO,017,SAN DIEGO DEL ROSAL (EL ZORRILLO),3,57,29,28,4
GUANAJUATO,11,IRAPUATO,017,SAN IGNACIO DE RIVERA (OJO DE AGUA),3,199,100,99,9
GUANAJUATO,11,IRAPUATO,017,SAN JAVIER,2,498,240,258,18
GUANAJUATO,11,IRAPUATO,017,SAN JOSÉ DE BERNALEJO (EL GUAYABO),3,424,196,228,15
GUANAJUATO,11,IRAPUATO,017,SAN JOSÉ DE CRUCES,2,113,54,59,4
GUANAJUATO,11,IRAPUATO,017,SAN JOSÉ DE LA LAGUNA (LOS RANCHITOS),2,27,11,16,2
GUANAJUATO,11,IRAPUATO,017,SAN JOSÉ DE MARAÑÓN (LA MOCHA),2,116,58,58,5
GUANAJUATO,11,IRAPUATO,017,SAN JOSÉ DE VÍBORAS,2,7,4,3,2
GUANAJUATO,11,IRAPUATO,017,SAN JUAN TEMASCATÍO,2,46,21,25,3
GUANAJUATO,11,IRAPUATO,017,SAN LUIS DEL JÁNAMO (EL MORADO),2,199,105,94,8
GUANAJUATO,11,IRAPUATO,017,SAN MIGUEL DE VILLALOBOS,2,67,27,40,3
GUANAJUATO,11,IRAPUATO,017,SAN MIGUEL DEL BRETE,2,142,57,85,6
GUANAJUATO,11,IRAPUATO,017,SAN NICOLÁS TEMASCATÍO,4,697,340,357,27
GUANAJUATO,11,IRAPUATO,017,SAN ROQUE,7,1820,930,890,58
GUANAJUATO,11,IRAPUATO,017,SAN VICENTE,3,638,310,328,24
GUANAJUATO,11,IRAPUATO,017,SAN VICENTE DE MALVAS (LA OREJA),2,49,24,25,3
GUANAJUATO,11,IRAPUATO,017,SANTA BÁRBARA,2,236,103,133,9
GUANAJUATO,11,IRAPUATO,017,SANTA ELENA DE LA CRUZ,3,531,253,278,16
GUANAJUATO,11,IRAPUATO,017,SANTA ROSA TEMASCATÍO (SANTA ROSA DE LA CRUZ),4,286,144,142,13
GUANAJUATO,11,IRAPUATO,017,SERRANO,4,622,295,327,23
GUANAJUATO,11,IRAPUATO,017,TAMAHULA,3,55,29,26,4
GUANAJUATO,11,IRAPUATO,017,TARETÁN,3,328,140,188,12
GUANAJUATO,11,IRAPUATO,017,TEJAMANIL,1,98,47,51,4
GUANAJUATO,11,IRAPUATO,017,TIERRAS NEGRAS,1,146,77,69,6
GUANAJUATO,11,IRAPUATO,017,TINAJA DE BERNALES,4,359,170,189,14
GUANAJUATO,11,IRAPUATO,017,TINAJITA DE CRUCITAS,1,11,6,5,1
GUANAJUATO,11,IRAPUATO,017,TOMELÓPEZ,5,1084,554,530,34
GUANAJUATO,11,IRAPUATO,017,TOMELOPITOS,2,508,249,259,17
GUANAJUATO,11,IRAPUATO,017,UNIDAD DEPORTIVA EL COPAL,2,6708,2605,4103,259
GUANAJUATO,11,IRAPUATO,017,VALENCIANA DE YÓSTIRO,2,137,70,67,7
GUANAJUATO,11,IRAPUATO,017,VALENCIANITA,5,1013,483,530,33
GUANAJUATO,11,IRAPUATO,017,VENADO DE SAN LORENZO,4,185,89,96,9
GUANAJUATO,11,IRAPUATO,017,VISTA HERMOSA,3,320,160,160,11
GUANAJUATO,11,JARAL DEL PROGRESO,018,EL ARMADILLO,3,66,31,35,4
GUANAJUATO,11,JARAL DEL PROGRESO,018,EL COLORADO,2,31,16,15,3
GUANAJUATO,11,JARAL DEL PROGRESO,018,EL MOLINITO,4,247,115,132,14
GUANAJUATO,11,JARAL DEL PROGRESO,018,EL TECOLOTE,1,13,3,10,2
GUANAJUATO,11,JARAL DEL PROGRESO,018,HACIENDA DE LA BOLSA,3,248,111,137,12
GUANAJUATO,11,JARAL DEL PROGRESO,018,JARAL DEL PROGRESO,20,4822,2443,2379,256
GUANAJUATO,11,JARAL DEL PROGRESO,018,LAS ISLAS,2,35,20,15,2
GUANAJUATO,11,JARAL DEL PROGRESO,018,LOS LLANITOS (EL RANCHITO),2,78,30,48,4
GUANAJUATO,11,JARAL DEL PROGRESO,018,PROVIDENCIA,3,207,94,113,11
GUANAJUATO,11,JARAL DEL PROGRESO,018,SAN JOSÉ DE OJO ZARCO,3,167,71,96,10
GUANAJUATO,11,JARAL DEL PROGRESO,018,SAN JOSÉ DEL CERRITO DE CAMARGO,4,450,218,232,26
GUANAJUATO,11,JARAL DEL PROGRESO,018,SAN RAMÓN,2,22,7,15,2
GUANAJUATO,11,JARAL DEL PROGRESO,018,SANTIAGO CAPITIRO,4,494,234,260,24
GUANAJUATO,11,JARAL DEL PROGRESO,018,VICTORIA DE CORTAZAR,4,846,423,423,34
GUANAJUATO,11,JARAL DEL PROGRESO,018,ZEMPOALA,3,150,78,72,9
GUANAJUATO,11,JARAL DEL PROGRESO,018,ZOROMUTA,1,460,218,242,26
GUANAJUATO,11,JERÉCUARO,019,ARROYO HONDO DE PURUAGUA,2,22,14,8,2
GUANAJUATO,11,JERÉCUARO,019,ARROYO HONDO DEL FRESNO,2,90,45,45,4
GUANAJUATO,11,JERÉCUARO,019,CANDELAS,4,310,149,161,14
GUANAJUATO,11,JERÉCUARO,019,CANOAS,4,116,54,62,8
GUANAJUATO,11,JERÉCUARO,019,CERRITO DE LA CRUZ,2,14,7,7,2
GUANAJUATO,11,JERÉCUARO,019,CERRO PRIETO CENTRO (TIERRA FRÍA),2,23,11,12,2
GUANAJUATO,11,JERÉCUARO,019,CHILARILLO,3,86,46,40,5
GUANAJUATO,11,JERÉCUARO,019,CIENEGUILLA DE ALZATI,3,102,48,54,5
GUANAJUATO,11,JERÉCUARO,019,CORRALES DE LA ORDEÑA,2,42,27,15,3
GUANAJUATO,11,JERÉCUARO,019,EL ATORÓN,1,10,6,4,1
GUANAJUATO,11,JERÉCUARO,019,EL BANCO,2,33,19,14,2
GUANAJUATO,11,JERÉCUARO,019,EL CARRIZO,3,48,29,19,4
GUANAJUATO,11,JERÉCUARO,019,EL CERRITO (LAS PALMAS),2,15,8,7,2
GUANAJUATO,11,JERÉCUARO,019,EL CLARÍN,3,78,30,48,5
GUANAJUATO,11,JERÉCUARO,019,EL CUCURUCHO,2,52,23,29,3
GUANAJUATO,11,JERÉCUARO,019,EL FRESNO,4,386,209,177,17
GUANAJUATO,11,JERÉCUARO,019,EL GATAL,1,7,3,4,1
GUANAJUATO,11,JERÉCUARO,019,EL HUIZACHE,2,35,12,23,2
GUANAJUATO,11,JERÉCUARO,019,EL JUGUETE (LA PRESA DEL ÁNGEL),2,25,12,13,2
GUANAJUATO,11,JERÉCUARO,019,EL NOVILLO,2,27,12,15,2
GUANAJUATO,11,JERÉCUARO,019,EL PUERTECITO,2,25,13,12,2
GUANAJUATO,11,JERÉCUARO,019,EL PUERTO DE SABANILLA,2,86,44,42,4
GUANAJUATO,11,JERÉCUARO,019,EL REFUGIO (EL BORDO COLORADO),2,12,4,8,2
GUANAJUATO,11,JERÉCUARO,019,EL RODEO,2,57,20,37,3
GUANAJUATO,11,JERÉCUARO,019,EL ROSARIO,4,52,23,29,6
GUANAJUATO,11,JERÉCUARO,019,EL SAUCITO,2,19,11,8,2
GUANAJUATO,11,JERÉCUARO,019,EL TEJOCOTE DE PURUAGUA,1,16,9,7,1
GUANAJUATO,11,JERÉCUARO,019,EL TEPOZÁN,4,194,106,88,10
GUANAJUATO,11,JERÉCUARO,019,EL TERRERO,5,190,98,92,12
GUANAJUATO,11,JERÉCUARO,019,ESTANZUELA DE RAZO,3,168,89,79,8
GUANAJUATO,11,JERÉCUARO,019,ESTANZUELA DE ROMERO,3,555,287,268,22
GUANAJUATO,11,JERÉCUARO,019,HACIENDITA DE LA ORDEÑA,2,48,22,26,3
GUANAJUATO,11,JERÉCUARO,019,JERÉCUARO,9,2309,1201,1108,130
GUANAJUATO,11,JERÉCUARO,019,JIMÉNEZ,2,95,51,44,5
GUANAJUATO,11,JERÉCUARO,019,LA CAJETA,2,5,3,2,2
GUANAJUATO,11,JERÉCUARO,019,LA CEJA,2,23,12,11,2
GUANAJUATO,11,JERÉCUARO,019,LA CUCHILLA,1,9,4,5,1
GUANAJUATO,11,JERÉCUARO,019,LA CUEVA,1,6,2,4,1
GUANAJUATO,11,JERÉCUARO,019,LA CUEVA (LA CUEVA DE PURUAGUA),2,19,10,9,2
GUANAJUATO,11,JERÉCUARO,019,LA CUEVA DE SAN ISIDRO,1,10,5,5,1
GUANAJUATO,11,JERÉCUARO,019,LA ENREDADORA (EL JITOMATAL),2,48,20,28,3
GUANAJUATO,11,JERÉCUARO,019,LA ESQUINA,2,30,19,11,2
GUANAJUATO,11,JERÉCUARO,019,LA ESTANCIA (LA PRESA),2,101,52,49,5
GUANAJUATO,11,JERÉCUARO,019,LA JOYA DE SÁNCHEZ,2,45,20,25,4
GUANAJUATO,11,JERÉCUARO,019,LA LOMA,1,9,5,4,1
GUANAJUATO,11,JERÉCUARO,019,LA LUZ DE JUÁREZ,2,21,14,7,2
GUANAJUATO,11,JERÉCUARO,019,LA LUZ DE PEÑA,1,17,6,11,1
GUANAJUATO,11,JERÉCUARO,019,LA MESA DEL TEPOZÁN (LOS SÁNCHEZ),2,31,16,15,2
GUANAJUATO,11,JERÉCUARO,019,LA MINA,4,161,85,76,9
GUANAJUATO,11,JERÉCUARO,019,LA MORA DE RUICES,2,59,28,31,3
GUANAJUATO,11,JERÉCUARO,019,LA MORA DEL CAPULÍN,2,22,10,12,2
GUANAJUATO,11,JERÉCUARO,019,LA SABANILLA (SAN JOSÉ DE LA SABANILLA),4,507,255,252,21
GUANAJUATO,11,JERÉCUARO,019,LA SALITRERA,3,110,55,55,5
GUANAJUATO,11,JERÉCUARO,019,LA SOLEDAD,2,10,4,6,2
GUANAJUATO,11,JERÉCUARO,019,LA TOMASA,2,16,6,10,2
GUANAJUATO,11,JERÉCUARO,019,LA VIRGEN,1,11,7,4,1
GUANAJUATO,11,JERÉCUARO,019,LA YERBABUENA,2,24,9,15,2
GUANAJUATO,11,JERÉCUARO,019,LAGUNILLA DE AGUSTINOS,2,43,20,23,3
GUANAJUATO,11,JERÉCUARO,019,LAGUNILLA DE PURUAGUA,1,34,18,16,2
GUANAJUATO,11,JERÉCUARO,019,LAS CRUCITAS,1,4,2,2,1
GUANAJUATO,11,JERÉCUARO,019,LAS MORAS DE TACAMBARILLO,2,46,19,27,3
GUANAJUATO,11,JERÉCUARO,019,LAS PALMAS (SAN MIGUEL DE LAS PALMAS),2,23,11,12,2
GUANAJUATO,11,JERÉCUARO,019,LAS PILAS DE LA SALITRERA,2,54,20,34,3
GUANAJUATO,11,JERÉCUARO,019,LAS PILAS DE PURUAGUA,4,174,85,89,10
GUANAJUATO,11,JERÉCUARO,019,LAS PILAS DEL SAUZ DE PEÑA,3,28,11,17,3
GUANAJUATO,11,JERÉCUARO,019,LLANOS DE SAN FRANCISCO,3,58,27,31,4
GUANAJUATO,11,JERÉCUARO,019,LOMA BLANCA,2,53,26,27,3
GUANAJUATO,11,JERÉCUARO,019,LOS RUICES,2,48,28,20,3
GUANAJUATO,11,JERÉCUARO,019,MANZANARES DEL FRESNO,2,72,32,40,4
GUANAJUATO,11,JERÉCUARO,019,OJO DE AGUA DE LA ORDEÑA,2,25,10,15,2
GUANAJUATO,11,JERÉCUARO,019,OJO DE AGUA DE MENDOZA,3,218,112,106,11
GUANAJUATO,11,JERÉCUARO,019,PALOS COLORADOS,3,39,21,18,3
GUANAJUATO,11,JERÉCUARO,019,PETEMORO,1,8,5,3,1
GUANAJUATO,11,JERÉCUARO,019,PIEDRAS DE LUMBRE,4,258,130,128,13
GUANAJUATO,11,JERÉCUARO,019,PUERTA DEL SAUZ DE PURUAGUA,2,31,19,12,2
GUANAJUATO,11,JERÉCUARO,019,PURIANTZÍCUARO,2,32,11,21,2
GUANAJUATO,11,JERÉCUARO,019,PURÍSIMA DE LA BARRANCA (RANCHO NUEVO),3,182,82,100,10
GUANAJUATO,11,JERÉCUARO,019,PURÍSIMA DEL ZAPOTE,2,100,49,51,5
GUANAJUATO,11,JERÉCUARO,019,PURUAGUA,6,794,402,392,36
GUANAJUATO,11,JERÉCUARO,019,PURUAGÜITA,2,73,42,31,3
GUANAJUATO,11,JERÉCUARO,019,RANCHO NUEVO (LOS RUICES),2,85,36,49,5
GUANAJUATO,11,JERÉCUARO,019,SALTO DE PEÑA,5,375,201,174,18
GUANAJUATO,11,JERÉCUARO,019,SAN ANTONIO CORRALES,2,44,24,20,3
GUANAJUATO,11,JERÉCUARO,019,SAN ANTONIO DE LA PRESA (EL FRESNO),2,24,11,13,2
GUANAJUATO,11,JERÉCUARO,019,SAN FRANCISCO JAVIER DE LA BARRANCA,3,124,55,69,7
GUANAJUATO,11,JERÉCUARO,019,SAN IGNACIO (SAN IGNACIO MÁRTIR),3,183,103,80,9
GUANAJUATO,11,JERÉCUARO,019,SAN JOSÉ DE PEÑA,2,43,24,19,3
GUANAJUATO,11,JERÉCUARO,019,SAN LORENZO,4,178,87,91,13
GUANAJUATO,11,JERÉCUARO,019,SAN LUCAS,4,249,123,126,23
GUANAJUATO,11,JERÉCUARO,019,SAN MIGUEL DEL SALTO,2,50,18,32,3
GUANAJUATO,11,JERÉCUARO,019,SAN PABLO,3,132,65,67,7
GUANAJUATO,11,JERÉCUARO,019,SAN PEDRO DE LOS AGUSTINOS,4,141,71,70,11
GUANAJUATO,11,JERÉCUARO,019,SANTA ISABEL,2,23,9,14,2
GUANAJUATO,11,JERÉCUARO,019,SANTA MARÍA (LA SANGUIJUELA),2,18,7,11,2
GUANAJUATO,11,JERÉCUARO,019,SANTA ROSA,1,4,3,1,1
GUANAJUATO,11,JERÉCUARO,019,SANTA TERESA DE TACAMBARILLO,3,35,15,20,3
GUANAJUATO,11,JERÉCUARO,019,SANTA TERESA DEL FRESNO,2,30,8,22,2
GUANAJUATO,11,JERÉCUARO,019,TACAMBARILLO,3,120,57,63,6
GUANAJUATO,11,JERÉCUARO,019,TIERRAS COLORADAS,2,32,14,18,2
GUANAJUATO,11,JERÉCUARO,019,VALLECILLO,2,44,19,25,3
GUANAJUATO,11,JERÉCUARO,019,ZATEMAYE,3,100,45,55,5
GUANAJUATO,11,JERÉCUARO,019,ZOMAYO (LA TRONERA),2,82,34,48,4
GUANAJUATO,11,LEÓN,020,ADVANCE PUERTO INTERIOR,1,67,41,26,3
GUANAJUATO,11,LEÓN,020,ALBARRADONES,4,476,235,241,17
GUANAJUATO,11,LEÓN,020,ALFARO,6,1199,614,585,43
GUANAJUATO,11,LEÓN,020,ÁLVARO OBREGÓN (SANTA ANA DEL CONDE),6,1175,580,595,51
GUANAJUATO,11,LEÓN,020,ARBOLEDAS DE LOS LÓPEZ PRIMERA SECCIÓN,2,223,116,107,6
GUANAJUATO,11,LEÓN,020,BARBOSA UNO (HACIENDA DE BARBOSA),1,4,3,1,1
GUANAJUATO,11,LEÓN,020,BARRANCA DE VENADEROS,3,379,177,202,15
GUANAJUATO,11,LEÓN,020,BARRETOS,4,498,252,246,25
GUANAJUATO,11,LEÓN,020,BUENOS AIRES,1,8,3,5,1
GUANAJUATO,11,LEÓN,020,CAMPO VERDE,3,42,21,21,3
GUANAJUATO,11,LEÓN,020,CANELAS,2,37,15,22,2
GUANAJUATO,11,LEÓN,020,CAPELLANÍA DE LOERA,4,458,225,233,15
GUANAJUATO,11,LEÓN,020,CERRO ALTO,3,44,21,23,3
GUANAJUATO,11,LEÓN,020,COLONIA DE LOS SAUCES,1,87,49,38,3
GUANAJUATO,11,LEÓN,020,COLONIA LATINOAMERICANA,4,722,346,376,24
GUANAJUATO,11,LEÓN,020,CORRAL DE PIEDRA,2,33,19,14,3
GUANAJUATO,11,LEÓN,020,DUARTE,9,1889,957,932,62
GUANAJUATO,11,LEÓN,020,EL CAPULÍN,3,31,12,19,4
GUANAJUATO,11,LEÓN,020,EL CERRITO,1,28,14,14,2
GUANAJUATO,11,LEÓN,020,EL CHARCO (EL ROMERAL),2,9,2,7,2
GUANAJUATO,11,LEÓN,020,EL DERRAMADERO,1,8,6,2,1
GUANAJUATO,11,LEÓN,020,EL GIGANTE,2,39,17,22,2
GUANAJUATO,11,LEÓN,020,EL HUIZACHE,3,58,27,31,3
GUANAJUATO,11,LEÓN,020,EL NACIMIENTO,1,14,6,8,1
GUANAJUATO,11,LEÓN,020,EL PUENTE,2,306,157,149,12
GUANAJUATO,11,LEÓN,020,EL RAMILLETE,4,424,198,226,17
GUANAJUATO,11,LEÓN,020,EL RESPLANDOR (EL CHORRO),4,361,176,185,14
GUANAJUATO,11,LEÓN,020,EL SAUCO,2,9,4,5,2
GUANAJUATO,11,LEÓN,020,EL TERRERO,2,69,31,38,3
GUANAJUATO,11,LEÓN,020,EL TUSCO,2,562,274,288,48
GUANAJUATO,11,LEÓN,020,ESTANCIA DE LOS SAPOS,2,168,80,88,8
GUANAJUATO,11,LEÓN,020,ESTANCIA DE OTATES,1,9,6,3,1
GUANAJUATO,11,LEÓN,020,FRACCIONAMIENTO BUENAVENTURA,1,58,18,40,2
GUANAJUATO,11,LEÓN,020,FUELLECITOS (LOS NEGRETE),1,2,0,2,1
GUANAJUATO,11,LEÓN,020,GRANJA LA ESPERANZA,1,53,29,24,2
GUANAJUATO,11,LEÓN,020,GUADALUPE VICTORIA,3,214,112,102,8
GUANAJUATO,11,LEÓN,020,HACIENDA ARRIBA (SAN JOSÉ DE LA CONCEPCIÓN),5,657,330,327,24
GUANAJUATO,11,LEÓN,020,IBARRILLA,6,1552,754,798,47
GUANAJUATO,11,LEÓN,020,IGNACIO ZARAGOZA,2,113,49,64,5
GUANAJUATO,11,LEÓN,020,LA ANGOSTURA,2,20,11,9,2
GUANAJUATO,11,LEÓN,020,LA ARCINA,2,181,91,90,8
GUANAJUATO,11,LEÓN,020,LA CINTA,2,60,29,31,4
GUANAJUATO,11,LEÓN,020,LA ESTANCIA DE LA SANDÍA,2,49,25,24,3
GUANAJUATO,11,LEÓN,020,LA JOYA (CERRO GIGANTE),1,18,12,6,1
GUANAJUATO,11,LEÓN,020,LA LABORCITA,4,495,244,251,18
GUANAJUATO,11,LEÓN,020,LA LUZ (EL COPETE),2,90,45,45,4
GUANAJUATO,11,LEÓN,020,LA MANZANILLA,1,5,3,2,1
GUANAJUATO,11,LEÓN,020,LA MORA,2,175,79,96,7
GUANAJUATO,11,LEÓN,020,LA PATIÑA,2,190,99,91,8
GUANAJUATO,11,LEÓN,020,LA PROVIDENCIA UNO,2,223,107,116,9
GUANAJUATO,11,LEÓN,020,LA RESERVA,4,206,100,106,9
GUANAJUATO,11,LEÓN,020,LADRILLERAS DEL REFUGIO,4,579,286,293,20
GUANAJUATO,11,LEÓN,020,LAGUNILLAS,3,505,260,245,15
GUANAJUATO,11,LEÓN,020,LAS COLORADAS,3,192,104,88,9
GUANAJUATO,11,LEÓN,020,LEÓN DE LOS ALDAMA,1631,416349,211995,204354,22806
GUANAJUATO,11,LEÓN,020,LLANO GRANDE,2,33,17,16,3
GUANAJUATO,11,LEÓN,020,LOMAS DEL SUSPIRO,2,187,89,98,8
GUANAJUATO,11,LEÓN,020,LOS ALISOS,2,9,6,3,2
GUANAJUATO,11,LEÓN,020,LOS ARCOS,3,671,323,348,23
GUANAJUATO,11,LEÓN,020,LOS BANCOS,2,5,1,4,2
GUANAJUATO,11,LEÓN,020,LOS CERRITOS,1,13,5,8,1
GUANAJUATO,11,LEÓN,020,LOS JACALES (LA LOMA),2,130,75,55,5
GUANAJUATO,11,LEÓN,020,LOS NARANJOS,3,510,237,273,16
GUANAJUATO,11,LEÓN,020,LOS RAMÍREZ,7,947,498,449,35
GUANAJUATO,11,LEÓN,020,LOS SAUCES,5,1108,563,545,36
GUANAJUATO,11,LEÓN,020,LOZA DE LOS PADRES,6,1047,522,525,33
GUANAJUATO,11,LEÓN,020,LUCIO BLANCO (LOS GAVILANES),2,253,141,112,8
GUANAJUATO,11,LEÓN,020,MALAGANA (SAN ANTONIO DEL MONTE),2,195,87,108,8
GUANAJUATO,11,LEÓN,020,MEDIA LUNA,2,6,2,4,2
GUANAJUATO,11,LEÓN,020,MESA DE IBARRILLA,3,113,62,51,6
GUANAJUATO,11,LEÓN,020,MESA DE MEDINA,1,3,3,0,1
GUANAJUATO,11,LEÓN,020,NUEVA COLONIA SAN CARLOS,1,94,54,40,3
GUANAJUATO,11,LEÓN,020,NUEVO LINDERO,4,417,225,192,17
GUANAJUATO,11,LEÓN,020,NUEVO VALLE DE MORENO,4,283,157,126,13
GUANAJUATO,11,LEÓN,020,OJO DE AGUA DE LOS REYES,4,326,166,160,13
GUANAJUATO,11,LEÓN,020,PLAN DE AYALA (SANTA ROSA),9,1292,639,653,73
GUANAJUATO,11,LEÓN,020,PLAN GUANAJUATO (LA SANDÍA),4,728,360,368,25
GUANAJUATO,11,LEÓN,020,PUERTA DE SAN GERMÁN (MORELOS),2,189,105,84,8
GUANAJUATO,11,LEÓN,020,PUERTA DEL CERRO,2,75,42,33,4
GUANAJUATO,11,LEÓN,020,PUERTO BLANCO,1,5,1,4,1
GUANAJUATO,11,LEÓN,020,RANCHO NUEVO DE LA LUZ,2,191,90,101,8
GUANAJUATO,11,LEÓN,020,RANCHO NUEVO DE LA VENTA,5,299,151,148,14
GUANAJUATO,11,LEÓN,020,RANCHO SAN JOSÉ DE LOS SAPOS,4,444,229,215,18
GUANAJUATO,11,LEÓN,020,REFUGIO DE ROSAS,1,10,5,5,1
GUANAJUATO,11,LEÓN,020,RINCÓN GRANDE,3,55,22,33,3
GUANAJUATO,11,LEÓN,020,RIVERA DEL CARMEN (DIVINA INFANTITA),2,128,57,71,4
GUANAJUATO,11,LEÓN,020,SAN ANTONIO DE LOS TEPETATES,3,1332,824,508,448
GUANAJUATO,11,LEÓN,020,SAN ANTONIO DE PADUA,2,29,10,19,3
GUANAJUATO,11,LEÓN,020,SAN ANTONIO DEL GIGANTE,2,17,10,7,2
GUANAJUATO,11,LEÓN,020,SAN FERNANDO,2,15,10,5,2
GUANAJUATO,11,LEÓN,020,SAN FRANCISCO DE DURÁN (SAN AGUSTÍN DEL MIRASOL),5,808,417,391,27
GUANAJUATO,11,LEÓN,020,SAN ISIDRO DE LAS COLONIAS,1,40,17,23,2
GUANAJUATO,11,LEÓN,020,SAN JOAQUÍN,2,187,92,95,6
GUANAJUATO,11,LEÓN,020,SAN JOSÉ DE LOS ROMEROS,2,92,50,42,4
GUANAJUATO,11,LEÓN,020,SAN JOSÉ DE OTATES SUR (PIEDRAS DE COCHE),3,62,35,27,4
GUANAJUATO,11,LEÓN,020,SAN JOSÉ DEL AGUADAL,1,23,12,11,1
GUANAJUATO,11,LEÓN,020,SAN JOSÉ DEL CONSUELO (LA ENVIDIA),3,126,61,65,5
GUANAJUATO,11,LEÓN,020,SAN JOSÉ DEL POTRERO,4,1591,757,834,47
GUANAJUATO,11,LEÓN,020,SAN JOSÉ DEL RESPLANDOR (EL CAPRICHO),4,350,184,166,14
GUANAJUATO,11,LEÓN,020,SAN JUAN DE ABAJO,7,1573,820,753,61
GUANAJUATO,11,LEÓN,020,SAN JUAN DE OTATES,6,1267,622,645,45
GUANAJUATO,11,LEÓN,020,SAN JUDAS,5,586,291,295,23
GUANAJUATO,11,LEÓN,020,SAN NICOLÁS DE LOS GONZÁLEZ,6,2035,1038,997,60
GUANAJUATO,11,LEÓN,020,SAN PEDRO DEL MONTE (LA HUIZACHERA),3,637,346,291,21
GUANAJUATO,11,LEÓN,020,SAN RAFAEL CERRO VERDE,1,5,5,0,1
GUANAJUATO,11,LEÓN,020,SAN RAFAEL DE LOS RAMÍREZ,1,13,5,8,1
GUANAJUATO,11,LEÓN,020,SAUCILLO DE ÁVALOS,2,39,21,18,2
GUANAJUATO,11,LEÓN,020,SAUZ SECO,4,149,73,76,6
GUANAJUATO,11,LEÓN,020,SEMINARIO CONCILIAR DE LEÓN,1,27,0,27,17
GUANAJUATO,11,LEÓN,020,VAQUERÍAS,4,348,182,166,14
GUANAJUATO,11,MOROLEÓN,021,AMOLES,4,73,32,41,6
GUANAJUATO,11,MOROLEÓN,021,CARICHEO,2,11,3,8,2
GUANAJUATO,11,MOROLEÓN,021,CEPIO,2,29,16,13,2
GUANAJUATO,11,MOROLEÓN,021,CUANAMUCO,2,73,33,40,6
GUANAJUATO,11,MOROLEÓN,021,EL SALTO,3,161,85,76,9
GUANAJUATO,11,MOROLEÓN,021,LA BARRANCA,2,26,12,14,2
GUANAJUATO,11,MOROLEÓN,021,LA LOMA,3,66,32,34,5
GUANAJUATO,11,MOROLEÓN,021,LA ORDEÑA,4,173,99,74,11
GUANAJUATO,11,MOROLEÓN,021,LA SOLEDAD,3,262,131,131,9
GUANAJUATO,11,MOROLEÓN,021,MOROLEÓN,62,11698,6169,5529,889
GUANAJUATO,11,MOROLEÓN,021,OJO DE AGUA DE EN MEDIO,3,60,29,31,4
GUANAJUATO,11,MOROLEÓN,021,PIÑÍCUARO,2,128,71,57,7
GUANAJUATO,11,MOROLEÓN,021,QUIAHUYO,2,20,7,13,2
GUANAJUATO,11,MOROLEÓN,021,RANCHO NUEVO,2,22,10,12,2
GUANAJUATO,11,MOROLEÓN,021,SANTA GERTRUDIS,2,16,8,8,2
GUANAJUATO,11,OCAMPO,022,20 DE NOVIEMBRE (EL VEINTE),3,129,61,68,7
GUANAJUATO,11,OCAMPO,022,ARRONA,2,4,3,1,2
GUANAJUATO,11,OCAMPO,022,CABRAS DE GUADALUPE,3,52,32,20,4
GUANAJUATO,11,OCAMPO,022,CALLEJÓN DEL CONEJO,1,5,3,2,1
GUANAJUATO,11,OCAMPO,022,EL CERRITO DE LA CRUZ,3,46,29,17,4
GUANAJUATO,11,OCAMPO,022,EL COLORADO,1,4,3,1,1
GUANAJUATO,11,OCAMPO,022,EL MEZQUITE,3,66,34,32,4
GUANAJUATO,11,OCAMPO,022,EL PÁJARO,2,34,20,14,2
GUANAJUATO,11,OCAMPO,022,EL POTRERO,4,165,87,78,9
GUANAJUATO,11,OCAMPO,022,EL PUERQUITO,2,34,13,21,2
GUANAJUATO,11,OCAMPO,022,EL TROPEZÓN,2,8,0,8,1
GUANAJUATO,11,OCAMPO,022,GACHUPINES,4,217,103,114,13
GUANAJUATO,11,OCAMPO,022,JESÚS MARÍA,3,90,50,40,5
GUANAJUATO,11,OCAMPO,022,LA CALAVERA,1,21,9,12,1
GUANAJUATO,11,OCAMPO,022,LA ESCONDIDA,4,520,266,254,27
GUANAJUATO,11,OCAMPO,022,LA HACIENDITA,3,118,57,61,7
GUANAJUATO,11,OCAMPO,022,LA LAGUNA CERCADA,2,65,35,30,3
GUANAJUATO,11,OCAMPO,022,LA TINAJA,3,203,114,89,11
GUANAJUATO,11,OCAMPO,022,LAS TROJES,3,182,82,100,10
GUANAJUATO,11,OCAMPO,022,LOMA ALTA,2,14,9,5,2
GUANAJUATO,11,OCAMPO,022,OCAMPO,18,2455,1252,1203,116
GUANAJUATO,11,OCAMPO,022,PUERTA DE LA AGUILILLA,2,51,21,30,3
GUANAJUATO,11,OCAMPO,022,PUERTA DE LOS GUZMÁN (LOS GUZMANES),1,9,5,4,1
GUANAJUATO,11,OCAMPO,022,PUERTA DEL TIGRE,2,8,3,5,2
GUANAJUATO,11,OCAMPO,022,PUERTO DE PLATA,1,8,4,4,1
GUANAJUATO,11,OCAMPO,022,RANCHO NUEVO,2,12,6,6,2
GUANAJUATO,11,OCAMPO,022,SAN FRANCISCO,3,43,20,23,4
GUANAJUATO,11,OCAMPO,022,SAN ISIDRO,3,118,56,62,5
GUANAJUATO,11,OCAMPO,022,SAN JOSÉ DEL TORREÓN,4,423,213,210,19
GUANAJUATO,11,OCAMPO,022,SAN PEDRO DE IBARRA,4,385,190,195,17
GUANAJUATO,11,OCAMPO,022,SANTA BÁRBARA,6,614,281,333,26
GUANAJUATO,11,OCAMPO,022,SANTA REGINA,3,120,61,59,5
GUANAJUATO,11,OCAMPO,022,VISTA HERMOSA,2,48,17,31,3
GUANAJUATO,11,PÉNJAMO,023,AGUA TIBIA DE AYALA,1,13,7,6,1
GUANAJUATO,11,PÉNJAMO,023,ARAMÚTARO DE LUQUE,2,36,14,22,2
GUANAJUATO,11,PÉNJAMO,023,ARATZIPU,3,381,204,177,12
GUANAJUATO,11,PÉNJAMO,023,BARAJAS VIEJO,2,81,46,35,4
GUANAJUATO,11,PÉNJAMO,023,BUENAVISTA DE CORTÉS,4,254,129,125,15
GUANAJUATO,11,PÉNJAMO,023,BUENOS AIRES,2,55,20,35,3
GUANAJUATO,11,PÉNJAMO,023,CAÑADA DE CORRALEJO,3,58,28,30,4
GUANAJUATO,11,PÉNJAMO,023,CAPILLA DE MÁRQUEZ,4,180,95,85,11
GUANAJUATO,11,PÉNJAMO,023,CAPILLA DE MORALES,1,39,18,21,2
GUANAJUATO,11,PÉNJAMO,023,CARRIZO DEL CERRO,2,12,5,7,2
GUANAJUATO,11,PÉNJAMO,023,CASAS BLANCAS,1,12,8,4,1
GUANAJUATO,11,PÉNJAMO,023,CASTILLO DE VILLASEÑOR,2,114,55,59,6
GUANAJUATO,11,PÉNJAMO,023,CERRITOS BLANCOS,4,466,219,247,17
GUANAJUATO,11,PÉNJAMO,023,CERRO BLANCO,2,48,30,18,2
GUANAJUATO,11,PÉNJAMO,023,CERRO BLANCO DE CAMARILLO,3,23,11,12,3
GUANAJUATO,11,PÉNJAMO,023,CERRO PRIETO,1,8,3,5,1
GUANAJUATO,11,PÉNJAMO,023,CHARCOS DE PAÚL,2,14,6,8,2
GUANAJUATO,11,PÉNJAMO,023,CHURINCILLO,2,55,26,29,4
GUANAJUATO,11,PÉNJAMO,023,CHURIPITZEO,4,467,231,236,22
GUANAJUATO,11,PÉNJAMO,023,COLONIA DE PALO VERDE,1,6,6,0,1
GUANAJUATO,11,PÉNJAMO,023,COLONIA EMILIANO ZAPATA,2,41,15,26,2
GUANAJUATO,11,PÉNJAMO,023,COLONIA MORELOS,3,225,123,102,11
GUANAJUATO,11,PÉNJAMO,023,COLORADO DE HERRERA,2,70,30,40,4
GUANAJUATO,11,PÉNJAMO,023,COLORADO DE SAAVEDRA,4,218,99,119,10
GUANAJUATO,11,PÉNJAMO,023,CONCEPCIÓN DE RUIZ,3,136,69,67,8
GUANAJUATO,11,PÉNJAMO,023,COPORITOS,2,100,46,54,4
GUANAJUATO,11,PÉNJAMO,023,CORRAL DE PARTIDA,1,8,5,3,1
GUANAJUATO,11,PÉNJAMO,023,CORRAL DE RAMAS,2,33,18,15,2
GUANAJUATO,11,PÉNJAMO,023,CORRAL DE SANTIAGO,3,195,87,108,10
GUANAJUATO,11,PÉNJAMO,023,CORRALEJO DE HIDALGO,4,335,186,149,17
GUANAJUATO,11,PÉNJAMO,023,CORRALES DE RÁBAGO,2,76,44,32,4
GUANAJUATO,11,PÉNJAMO,023,CRUCES DE ROJAS,2,86,44,42,5
GUANAJUATO,11,PÉNJAMO,023,CRUCITAS DE GUTIÉRREZ,2,71,25,46,4
GUANAJUATO,11,PÉNJAMO,023,CUEVAS DE MORALES,4,222,104,118,11
GUANAJUATO,11,PÉNJAMO,023,EJIDO JOYA DE MULAS,2,40,23,17,2
GUANAJUATO,11,PÉNJAMO,023,EL AGUACATE,1,5,3,2,1
GUANAJUATO,11,PÉNJAMO,023,EL AVISPERO,2,34,21,13,2
GUANAJUATO,11,PÉNJAMO,023,EL CAPADERO,2,78,43,35,4
GUANAJUATO,11,PÉNJAMO,023,EL CARRICILLO,1,10,7,3,1
GUANAJUATO,11,PÉNJAMO,023,EL CERRO,2,88,41,47,4
GUANAJUATO,11,PÉNJAMO,023,EL CHUPADERO,2,7,4,3,2
GUANAJUATO,11,PÉNJAMO,023,EL COBRE,3,51,26,25,4
GUANAJUATO,11,PÉNJAMO,023,EL COMALILLO,4,160,83,77,11
GUANAJUATO,11,PÉNJAMO,023,EL CRUCILLAL,2,9,6,3,2
GUANAJUATO,11,PÉNJAMO,023,EL GALLO,1,5,3,2,1
GUANAJUATO,11,PÉNJAMO,023,EL GONZALO DE PAÚL,1,7,2,5,1
GUANAJUATO,11,PÉNJAMO,023,EL GUAYABO DE CAMARENA,2,123,61,62,5
GUANAJUATO,11,PÉNJAMO,023,EL HUIZACHE,2,21,15,6,2
GUANAJUATO,11,PÉNJAMO,023,EL INFIERNILLO,2,115,53,62,7
GUANAJUATO,11,PÉNJAMO,023,EL MAGUEY DE BARAJAS,2,25,18,7,2
GUANAJUATO,11,PÉNJAMO,023,EL MÁRMOL,4,232,113,119,11
GUANAJUATO,11,PÉNJAMO,023,EL MOGOTE DE REYES,2,8,3,5,2
GUANAJUATO,11,PÉNJAMO,023,EL MONTE,1,9,3,6,1
GUANAJUATO,11,PÉNJAMO,023,EL NOPAL DE ARROYO,2,10,3,7,2
GUANAJUATO,11,PÉNJAMO,023,EL PANDITO,3,34,15,19,3
GUANAJUATO,11,PÉNJAMO,023,EL PEDREGAL DE ABAJO,1,16,6,10,1
GUANAJUATO,11,PÉNJAMO,023,EL PEDREGAL DE ARRIBA,2,149,69,80,7
GUANAJUATO,11,PÉNJAMO,023,EL PIRUL,1,5,2,3,1
GUANAJUATO,11,PÉNJAMO,023,EL POCHOTE,2,48,22,26,3
GUANAJUATO,11,PÉNJAMO,023,EL PORVENIR DE AYALA,2,17,8,9,2
GUANAJUATO,11,PÉNJAMO,023,EL RODEO DE AYALA (LA ORDEÑA),2,28,16,12,2
GUANAJUATO,11,PÉNJAMO,023,EL ROMERAL,2,31,15,16,2
GUANAJUATO,11,PÉNJAMO,023,EL SALITRILLO,3,106,42,64,7
GUANAJUATO,11,PÉNJAMO,023,EL SOLOVINO,2,9,3,6,2
GUANAJUATO,11,PÉNJAMO,023,EL TALÓN,1,6,4,2,1
GUANAJUATO,11,PÉNJAMO,023,EL TIGRE,2,70,32,38,3
GUANAJUATO,11,PÉNJAMO,023,EL TLACUACHE,2,111,52,59,5
GUANAJUATO,11,PÉNJAMO,023,EL VOLANTÍN,2,118,60,58,5
GUANAJUATO,11,PÉNJAMO,023,EL XOCONOXTLE,1,5,1,4,1
GUANAJUATO,11,PÉNJAMO,023,EL ZARCO,2,9,6,3,2
GUANAJUATO,11,PÉNJAMO,023,ESTACIÓN CORRALEJO,3,199,85,114,11
GUANAJUATO,11,PÉNJAMO,023,ESTACIÓN LA PIEDAD,2,146,78,68,9
GUANAJUATO,11,PÉNJAMO,023,ESTACIÓN PÉNJAMO,3,705,349,356,28
GUANAJUATO,11,PÉNJAMO,023,FICHAS DE LEÓN,2,57,30,27,3
GUANAJUATO,11,PÉNJAMO,023,FRESNO DOS,1,1316,649,667,81
GUANAJUATO,11,PÉNJAMO,023,GUANGÜITIRO,4,279,137,142,13
GUANAJUATO,11,PÉNJAMO,023,GUAYABITO DE PEDROZA,2,77,34,43,4
GUANAJUATO,11,PÉNJAMO,023,GUAYABO DE ORIGEL,2,49,26,23,3
GUANAJUATO,11,PÉNJAMO,023,GUAYABO DE RUIZ,2,12,7,5,2
GUANAJUATO,11,PÉNJAMO,023,HACIENDA DEL CARMEN,3,148,69,79,8
GUANAJUATO,11,PÉNJAMO,023,HORNITOS,3,66,27,39,4
GUANAJUATO,11,PÉNJAMO,023,HUANDARILLO,2,69,29,40,4
GUANAJUATO,11,PÉNJAMO,023,HUERTA GRANDE,2,19,10,9,2
GUANAJUATO,11,PÉNJAMO,023,LA ACEITUNA,3,52,22,30,4
GUANAJUATO,11,PÉNJAMO,023,LA ATARJEA,4,258,117,141,13
GUANAJUATO,11,PÉNJAMO,023,LA BARRANCA DEL CHILAR,3,35,18,17,3
GUANAJUATO,11,PÉNJAMO,023,LA CAJA DE LA GOLONDRINA,2,18,9,9,2
GUANAJUATO,11,PÉNJAMO,023,LA CAL GRANDE,3,181,88,93,11
GUANAJUATO,11,PÉNJAMO,023,LA CALERITA,1,38,16,22,2
GUANAJUATO,11,PÉNJAMO,023,LA CALLE,3,279,139,140,12
GUANAJUATO,11,PÉNJAMO,023,LA CALLE DE MARTÍNEZ,2,11,4,7,2
GUANAJUATO,11,PÉNJAMO,023,LA CINTA,2,10,3,7,2
GUANAJUATO,11,PÉNJAMO,023,LA CUMBRE DE LA SIERRA,1,9,5,4,1
GUANAJUATO,11,PÉNJAMO,023,LA ERMITA,3,154,77,77,7
GUANAJUATO,11,PÉNJAMO,023,LA ESCONDIDA DE MORALES,3,26,10,16,3
GUANAJUATO,11,PÉNJAMO,023,LA ESTANCIA DEL REFUGIO,3,144,80,64,9
GUANAJUATO,11,PÉNJAMO,023,LA ESTANZUELA,2,16,11,5,2
GUANAJUATO,11,PÉNJAMO,023,LA ESTRELLA,4,816,379,437,88
GUANAJUATO,11,PÉNJAMO,023,LA GAVILANA,2,24,11,13,2
GUANAJUATO,11,PÉNJAMO,023,LA GOLONDRINA,2,17,9,8,2
GUANAJUATO,11,PÉNJAMO,023,LA GRANJENA,2,78,35,43,4
GUANAJUATO,11,PÉNJAMO,023,LA JAMACUA DE CORTÉS,2,82,51,31,4
GUANAJUATO,11,PÉNJAMO,023,LA JOYA DE SAUZ DE MÉNDEZ,1,47,23,24,2
GUANAJUATO,11,PÉNJAMO,023,LA LOBERA,3,126,62,64,7
GUANAJUATO,11,PÉNJAMO,023,LA LUCITA DE LEDEZMA,1,5,2,3,1
GUANAJUATO,11,PÉNJAMO,023,LA MADEJA,4,220,106,114,12
GUANAJUATO,11,PÉNJAMO,023,LA MULA,1,6,0,6,1
GUANAJUATO,11,PÉNJAMO,023,LA MULA DE AGUILAR,2,19,9,10,2
GUANAJUATO,11,PÉNJAMO,023,LA PAZ,3,75,40,35,7
GUANAJUATO,11,PÉNJAMO,023,LA ROSA DE NEGRETE,2,28,19,9,2
GUANAJUATO,11,PÉNJAMO,023,LA SARNA,2,110,52,58,5
GUANAJUATO,11,PÉNJAMO,023,LA SOLEDAD DE MORALES,2,31,15,16,2
GUANAJUATO,11,PÉNJAMO,023,LA TROJA,2,177,86,91,8
GUANAJUATO,11,PÉNJAMO,023,LA VIGUERÍA,2,19,13,6,2
GUANAJUATO,11,PÉNJAMO,023,LABOR DE ARMENTA,2,64,26,38,4
GUANAJUATO,11,PÉNJAMO,023,LABOR DE LÓPEZ,2,34,18,16,3
GUANAJUATO,11,PÉNJAMO,023,LAGUNA LARGA DE CORTÉS,5,1099,533,566,53
GUANAJUATO,11,PÉNJAMO,023,LAGUNILLAS,3,154,92,62,11
GUANAJUATO,11,PÉNJAMO,023,LAS ÁNIMAS,3,275,137,138,14
GUANAJUATO,11,PÉNJAMO,023,LAS PAREDES,3,30,18,12,3
GUANAJUATO,11,PÉNJAMO,023,LAS TABLAS DE CORRALEJO,2,4,2,2,2
GUANAJUATO,11,PÉNJAMO,023,LEYVA DE BARAJAS,2,23,8,15,2
GUANAJUATO,11,PÉNJAMO,023,LIEBRES DE SUÁREZ,4,252,130,122,13
GUANAJUATO,11,PÉNJAMO,023,LLANOS DEL MUERTO,2,6,2,4,1
GUANAJUATO,11,PÉNJAMO,023,LOMA DE ACEVES UNO,4,86,34,52,5
GUANAJUATO,11,PÉNJAMO,023,LOMITA DE NAVARRO,2,24,8,16,2
GUANAJUATO,11,PÉNJAMO,023,LOS AMOLES DE CORTÉS,2,45,26,19,3
GUANAJUATO,11,PÉNJAMO,023,LOS OCOTES,4,510,258,252,22
GUANAJUATO,11,PÉNJAMO,023,MAGALLANES,3,239,95,144,11
GUANAJUATO,11,PÉNJAMO,023,MANGAS DE CORRALEJO,4,79,45,34,7
GUANAJUATO,11,PÉNJAMO,023,MARAVILLAS DE MORALES,2,36,17,19,2
GUANAJUATO,11,PÉNJAMO,023,MESA DE LA TIENDA,1,1,0,1,1
GUANAJUATO,11,PÉNJAMO,023,MESA DE MÉNDEZ,2,71,29,42,3
GUANAJUATO,11,PÉNJAMO,023,MEZQUITE DE LUNA,3,202,94,108,12
GUANAJUATO,11,PÉNJAMO,023,MITAD DE NORIA,2,43,23,20,3
GUANAJUATO,11,PÉNJAMO,023,MONTE BELLO,2,45,23,22,3
GUANAJUATO,11,PÉNJAMO,023,MORO DE BARAJAS,2,22,9,13,3
GUANAJUATO,11,PÉNJAMO,023,NORIA DE BARAJAS,3,147,71,76,7
GUANAJUATO,11,PÉNJAMO,023,NUEVO SANTA ELENA DE ACEVES,1,62,32,30,3
GUANAJUATO,11,PÉNJAMO,023,OJO DE AGUA CALIENTE,2,42,17,25,2
GUANAJUATO,11,PÉNJAMO,023,ORDEÑITA DE BARAJAS,4,483,249,234,55
GUANAJUATO,11,PÉNJAMO,023,PALO ALTO DE ABAJO,4,293,159,134,14
GUANAJUATO,11,PÉNJAMO,023,PALO ALTO DE ARRIBA,1,12,6,6,1
GUANAJUATO,11,PÉNJAMO,023,PALO VERDE,4,252,117,135,13
GUANAJUATO,11,PÉNJAMO,023,PÉNJAMO,46,10771,5369,5402,579
GUANAJUATO,11,PÉNJAMO,023,PERALTA DE JIMÉNEZ,2,10,6,4,2
GUANAJUATO,11,PÉNJAMO,023,PESCADORES,1,8,1,7,1
GUANAJUATO,11,PÉNJAMO,023,PINO SOLO,2,28,15,13,2
GUANAJUATO,11,PÉNJAMO,023,PLAN DEL FRESNO,2,14,8,6,2
GUANAJUATO,11,PÉNJAMO,023,POTRERILLOS DEL CERRO,2,18,9,9,2
GUANAJUATO,11,PÉNJAMO,023,POTRERILLOS DEL RÍO,4,162,77,85,10
GUANAJUATO,11,PÉNJAMO,023,POTREROS,4,460,225,235,20
GUANAJUATO,11,PÉNJAMO,023,PRESA DE JOYA DE MULAS,1,41,19,22,3
GUANAJUATO,11,PÉNJAMO,023,PRESA DEL AGUACATE,2,34,20,14,2
GUANAJUATO,11,PÉNJAMO,023,PRESA DEL COLORADO,2,8,6,2,1
GUANAJUATO,11,PÉNJAMO,023,PRESIDIO DE MORALES,2,34,15,19,2
GUANAJUATO,11,PÉNJAMO,023,PRESITAS DE GÓMEZ,1,10,4,6,1
GUANAJUATO,11,PÉNJAMO,023,PRESITAS DE REGIL,2,19,11,8,2
GUANAJUATO,11,PÉNJAMO,023,PROVIDENCIA DE NEGRETE,1,6,3,3,1
GUANAJUATO,11,PÉNJAMO,023,PUERTA DE AGUA CALIENTE,2,79,33,46,4
GUANAJUATO,11,PÉNJAMO,023,PUERTA DE GÓMEZ CHICA,3,82,40,42,14
GUANAJUATO,11,PÉNJAMO,023,PURÍSIMA DE RAMÍREZ,4,342,191,151,16
GUANAJUATO,11,PÉNJAMO,023,QUESERA DE CORTÉS,4,353,189,164,15
GUANAJUATO,11,PÉNJAMO,023,RANCHO NUEVO DE GUTIÉRREZ,4,85,40,45,7
GUANAJUATO,11,PÉNJAMO,023,RANCHO NUEVO DE POTREROS,2,24,10,14,2
GUANAJUATO,11,PÉNJAMO,023,RANCHO SECO DE BARAJAS,3,210,103,107,11
GUANAJUATO,11,PÉNJAMO,023,RINCÓN DE PITAHAYOS,1,11,3,8,1
GUANAJUATO,11,PÉNJAMO,023,SAN ANTONIO DE ACEVES,4,238,120,118,10
GUANAJUATO,11,PÉNJAMO,023,SAN ANTONIO DE AGUIRRE,2,134,72,62,7
GUANAJUATO,11,PÉNJAMO,023,SAN BERNARDO,3,124,70,54,7
GUANAJUATO,11,PÉNJAMO,023,SAN FELIPE CHILARILLO,4,168,81,87,11
GUANAJUATO,11,PÉNJAMO,023,SAN FERNANDO DE PAÚL,2,32,16,16,2
GUANAJUATO,11,PÉNJAMO,023,SAN FRANCISCO DE RIZO,1,10,3,7,1
GUANAJUATO,11,PÉNJAMO,023,SAN GABRIEL Y SAN IGNACIO,4,412,227,185,18
GUANAJUATO,11,PÉNJAMO,023,SAN IGNACIO DE ÁLVAREZ,2,64,36,28,3
GUANAJUATO,11,PÉNJAMO,023,SAN ISIDRO DE AYALA,1,17,9,8,1
GUANAJUATO,11,PÉNJAMO,023,SAN ISIDRO DE CRUCITAS,2,102,55,47,4
GUANAJUATO,11,PÉNJAMO,023,SAN ISIDRO DEL CARMEN,1,17,10,7,1
GUANAJUATO,11,PÉNJAMO,023,SAN JOSÉ DE LAS MORAS,2,64,27,37,4
GUANAJUATO,11,PÉNJAMO,023,SAN JOSÉ DE LOS SABINOS,3,99,46,53,5
GUANAJUATO,11,PÉNJAMO,023,SAN JOSÉ DE MORALES,2,42,23,19,2
GUANAJUATO,11,PÉNJAMO,023,SAN JUAN EL ALTO PLAZUELAS,3,104,46,58,5
GUANAJUATO,11,PÉNJAMO,023,SAN JUANITO DE ECHEVERRÍA,2,77,39,38,4
GUANAJUATO,11,PÉNJAMO,023,SAN LUIS EL ALTO,2,41,18,23,3
GUANAJUATO,11,PÉNJAMO,023,SAN MARCOS,2,82,42,40,4
GUANAJUATO,11,PÉNJAMO,023,SAN MIGUEL DE CAMARENA,2,18,12,6,2
GUANAJUATO,11,PÉNJAMO,023,SAN PEDRITO,2,69,34,35,4
GUANAJUATO,11,PÉNJAMO,023,SAN RAFAEL DE LA MARAÑA,2,85,37,48,4
GUANAJUATO,11,PÉNJAMO,023,SAN RAFAEL DE VILLASEÑOR,2,329,161,168,10
GUANAJUATO,11,PÉNJAMO,023,SANTA ANA PACUECO,11,1939,984,955,74
GUANAJUATO,11,PÉNJAMO,023,SANTA ELENA DE ACEVES,2,159,77,82,8
GUANAJUATO,11,PÉNJAMO,023,SANTA LUCÍA,3,80,47,33,4
GUANAJUATO,11,PÉNJAMO,023,SAUZ DE MÉNDEZ,2,39,24,15,3
GUANAJUATO,11,PÉNJAMO,023,SAUZ DE VILLASEÑOR,2,50,25,25,3
GUANAJUATO,11,PÉNJAMO,023,TACUBA,2,27,14,13,2
GUANAJUATO,11,PÉNJAMO,023,TACUBAYA,4,392,206,186,16
GUANAJUATO,11,PÉNJAMO,023,TARENGO DE PARRAS,2,29,14,15,2
GUANAJUATO,11,PÉNJAMO,023,TEPETATE DE NEGRETE,2,63,23,40,3
GUANAJUATO,11,PÉNJAMO,023,TEPETATE DE ORIGEL,2,20,13,7,2
GUANAJUATO,11,PÉNJAMO,023,TEPUZA DE VILLALOBOS,2,73,29,44,4
GUANAJUATO,11,PÉNJAMO,023,TIERRAS NEGRAS,4,170,77,93,8
GUANAJUATO,11,PÉNJAMO,023,TRINIDAD DE LOS ÁNGELES,1,8,6,2,1
GUANAJUATO,11,PÉNJAMO,023,TROJES DE PAÚL,2,75,39,36,4
GUANAJUATO,11,PÉNJAMO,023,VARAL DE MORALES,2,45,27,18,3
GUANAJUATO,11,PÉNJAMO,023,VEREDAS,4,138,64,74,8
GUANAJUATO,11,PÉNJAMO,023,VIBORILLAS DE SUÁREZ,4,265,121,144,13
GUANAJUATO,11,PÉNJAMO,023,VISTA HERMOSA DE LA TRINIDAD DE VILLASEÑOR,1,5,3,2,1
GUANAJUATO,11,PÉNJAMO,023,ZAMBRANO,2,30,17,13,2
GUANAJUATO,11,PÉNJAMO,023,ZAPOTE DE BARAJAS,2,222,113,109,9
GUANAJUATO,11,PÉNJAMO,023,ZAPOTE DE CESTAU,4,275,142,133,15
GUANAJUATO,11,PUEBLO NUEVO,024,CASA BLANCA,2,31,19,12,2
GUANAJUATO,11,PUEBLO NUEVO,024,CERRITO DEL CAPULÍN DE YÓSTIRO,2,32,17,15,3
GUANAJUATO,11,PUEBLO NUEVO,024,COLONIA 13 DE JULIO,1,24,17,7,1
GUANAJUATO,11,PUEBLO NUEVO,024,CONGREGACIÓN DE PANALES,3,59,29,30,4
GUANAJUATO,11,PUEBLO NUEVO,024,DOS RÍOS DE SAN ANTONIO,1,12,7,5,1
GUANAJUATO,11,PUEBLO NUEVO,024,DURAZNO DE FONSECA,2,50,26,24,3
GUANAJUATO,11,PUEBLO NUEVO,024,GUADALUPE DEL MONTE (LA LUPITA),2,35,24,11,3
GUANAJUATO,11,PUEBLO NUEVO,024,HACIENDA DE ALONSO,2,75,30,45,4
GUANAJUATO,11,PUEBLO NUEVO,024,LA PURÍSIMA,1,60,35,25,3
GUANAJUATO,11,PUEBLO NUEVO,024,LA SOLEDAD,2,53,26,27,3
GUANAJUATO,11,PUEBLO NUEVO,024,MONTECILLOS,2,52,23,29,3
GUANAJUATO,11,PUEBLO NUEVO,024,PRESA GRANDE,2,97,44,53,6
GUANAJUATO,11,PUEBLO NUEVO,024,PROGRESO DE AFUERA,1,16,8,8,1
GUANAJUATO,11,PUEBLO NUEVO,024,PROGRESO DE LA UNIÓN,4,293,161,132,12
GUANAJUATO,11,PUEBLO NUEVO,024,PUEBLO NUEVO,10,2251,1115,1136,147
GUANAJUATO,11,PUEBLO NUEVO,024,SAN JOSÉ DEL CARMEN,2,39,16,23,2
GUANAJUATO,11,PUEBLO NUEVO,024,VILLA DE GUADALUPE,2,187,99,88,8
GUANAJUATO,11,PUEBLO NUEVO,024,YÓSTIRO (YÓSTIRO DE SAN ANTONIO),4,391,181,210,16
GUANAJUATO,11,PURÍSIMA DEL RINCÓN,025,BUENAVISTA,4,208,109,99,9
GUANAJUATO,11,PURÍSIMA DEL RINCÓN,025,CAÑADA DE NEGROS,5,364,168,196,13
GUANAJUATO,11,PURÍSIMA DEL RINCÓN,025,CAÑADA DE SOTO,2,168,75,93,8
GUANAJUATO,11,PURÍSIMA DEL RINCÓN,025,CARRIZO DE RUBIOS,2,25,9,16,2
GUANAJUATO,11,PURÍSIMA DEL RINCÓN,025,COLINAS DEL REAL,1,171,93,78,6
GUANAJUATO,11,PURÍSIMA DEL RINCÓN,025,DOLORES,4,243,110,133,14
GUANAJUATO,11,PURÍSIMA DEL RINCÓN,025,EL CÓCONO,1,7,1,6,1
GUANAJUATO,11,PURÍSIMA DEL RINCÓN,025,EL PEDERNAL,2,133,65,68,7
GUANAJUATO,11,PURÍSIMA DEL RINCÓN,025,EL REFUGIO,2,148,68,80,7
GUANAJUATO,11,PURÍSIMA DEL RINCÓN,025,EL TECOLOTE,4,379,190,189,14
GUANAJUATO,11,PURÍSIMA DEL RINCÓN,025,EL TORO,4,386,182,204,16
GUANAJUATO,11,PURÍSIMA DEL RINCÓN,025,GUADALUPE DE JALPA,3,192,93,99,10
GUANAJUATO,11,PURÍSIMA DEL RINCÓN,025,JALPA DE CÁNOVAS,3,513,259,254,19
GUANAJUATO,11,PURÍSIMA DEL RINCÓN,025,LA CINTILLA,2,5,3,2,2
GUANAJUATO,11,PURÍSIMA DEL RINCÓN,025,LA DESCUBRIDORA,3,116,48,68,6
GUANAJUATO,11,PURÍSIMA DEL RINCÓN,025,LA PRADERA [FRACCIONAMIENTO],3,359,172,187,16
GUANAJUATO,11,PURÍSIMA DEL RINCÓN,025,LA TRINIDAD,3,63,41,22,6
GUANAJUATO,11,PURÍSIMA DEL RINCÓN,025,LOS TABIQUEROS,2,487,264,223,15
GUANAJUATO,11,PURÍSIMA DEL RINCÓN,025,MIL AZARES [ECOPARQUE],1,291,145,146,44
GUANAJUATO,11,PURÍSIMA DEL RINCÓN,025,POTRERILLOS (GUANAJAL),5,539,263,276,22
GUANAJUATO,11,PURÍSIMA DEL RINCÓN,025,PUERTA DE JALPA,2,47,17,30,3
GUANAJUATO,11,PURÍSIMA DEL RINCÓN,025,PURÍSIMA DE BUSTOS,71,58849,30566,28283,1594
GUANAJUATO,11,PURÍSIMA DEL RINCÓN,025,RANCHO SECO,1,16,6,10,1
GUANAJUATO,11,PURÍSIMA DEL RINCÓN,025,SAN ANDRÉS (SAN ANDRÉS DE JALPA),1,177,88,89,6
GUANAJUATO,11,PURÍSIMA DEL RINCÓN,025,SAN ÁNGEL,3,325,150,175,12
GUANAJUATO,11,PURÍSIMA DEL RINCÓN,025,SAN ANTONIO CASAS BLANCAS,2,67,34,33,3
GUANAJUATO,11,PURÍSIMA DEL RINCÓN,025,SAN BERNARDO,3,155,73,82,7
GUANAJUATO,11,PURÍSIMA DEL RINCÓN,025,SAN JERÓNIMO,3,179,69,110,8
GUANAJUATO,11,PURÍSIMA DEL RINCÓN,025,SAN JOSÉ DEL BARRIAL,1,202,92,110,6
GUANAJUATO,11,PURÍSIMA DEL RINCÓN,025,SAN NICOLÁS DEL PALENQUE,3,320,160,160,12
GUANAJUATO,11,PURÍSIMA DEL RINCÓN,025,TEPETATE DEL GALLO,4,193,91,102,10
GUANAJUATO,11,ROMITA,026,COLONIA RAFAEL CORRALES AYALA,1,288,142,146,12
GUANAJUATO,11,ROMITA,026,EJIDO COLONIA JUÁREZ,1,28,14,14,1
GUANAJUATO,11,ROMITA,026,EL CAMALEÓN,3,128,63,65,7
GUANAJUATO,11,ROMITA,026,EL CARMEN DE SÁNCHEZ (LA PONZOÑA),3,189,87,102,8
GUANAJUATO,11,ROMITA,026,EL ESCOPLO,4,405,206,199,14
GUANAJUATO,11,ROMITA,026,EL JAGÜEY,4,727,357,370,27
GUANAJUATO,11,ROMITA,026,EL MÁRMOL,3,190,104,86,9
GUANAJUATO,11,ROMITA,026,EL PARAÍSO,2,52,24,28,3
GUANAJUATO,11,ROMITA,026,EL TEJAMANIL,2,465,230,235,18
GUANAJUATO,11,ROMITA,026,GAVIA DE RIONDA,3,408,210,198,14
GUANAJUATO,11,ROMITA,026,GAVIA DE RIVAS,2,94,44,50,4
GUANAJUATO,11,ROMITA,026,LA CASETA,2,67,40,27,3
GUANAJUATO,11,ROMITA,026,LA CRUZ DE AGUILAR,3,194,96,98,9
GUANAJUATO,11,ROMITA,026,LA SARDINA,4,439,206,233,19
GUANAJUATO,11,ROMITA,026,LAS LAJAS,2,37,18,19,2
GUANAJUATO,11,ROMITA,026,LAS LIEBRES,3,601,307,294,31
GUANAJUATO,11,ROMITA,026,LAS TABLAS,2,80,44,36,4
GUANAJUATO,11,ROMITA,026,LOS AMOLES,4,340,186,154,15
GUANAJUATO,11,ROMITA,026,LOS ÁNGELES,2,79,35,44,3
GUANAJUATO,11,ROMITA,026,LOS OCOTES,2,33,14,19,2
GUANAJUATO,11,ROMITA,026,LOURDES,4,279,120,159,13
GUANAJUATO,11,ROMITA,026,LUZ DE BUENAVISTA (LAS PULGAS),2,105,51,54,5
GUANAJUATO,11,ROMITA,026,LUZ DE SILVA,2,156,78,78,8
GUANAJUATO,11,ROMITA,026,MARITAS,2,86,41,45,4
GUANAJUATO,11,ROMITA,026,MEZQUITE GORDO,4,589,294,295,25
GUANAJUATO,11,ROMITA,026,MONTE DE HOYOS,4,301,142,159,14
GUANAJUATO,11,ROMITA,026,OJOS DE RANA,2,30,14,16,2
GUANAJUATO,11,ROMITA,026,PEDREGAL DE BARROSO,4,175,83,92,10
GUANAJUATO,11,ROMITA,026,PEDREGAL DE MARTÍNEZ,1,62,28,34,2
GUANAJUATO,11,ROMITA,026,PEDREGAL DE RANGEL,1,9,7,2,1
GUANAJUATO,11,ROMITA,026,REYES DE SAN JOSÉ (EL NIDO),2,46,25,21,2
GUANAJUATO,11,ROMITA,026,ROMITA,29,6655,3377,3278,289
GUANAJUATO,11,ROMITA,026,SAN ANTONIO CERRO PRIETO,3,196,103,93,9
GUANAJUATO,11,ROMITA,026,SAN ANTONIO DEL POCHOTE,2,38,17,21,2
GUANAJUATO,11,ROMITA,026,SAN ANTONIO LOMA DE PORTILLO,3,68,33,35,4
GUANAJUATO,11,ROMITA,026,SAN CLEMENTE,3,239,123,116,11
GUANAJUATO,11,ROMITA,026,SAN FRANCISCO DE GAVIA,2,54,22,32,3
GUANAJUATO,11,ROMITA,026,SAN FRANCISCO DE GAVIA DOS (EL CHOCHO),2,25,13,12,3
GUANAJUATO,11,ROMITA,026,SAN FRANCISCO DE GAVIA UNO,1,4,0,4,1
GUANAJUATO,11,ROMITA,026,SAN GONZALO,4,305,162,143,13
GUANAJUATO,11,ROMITA,026,SAN ISIDRO OJO DE AGUA,4,220,111,109,13
GUANAJUATO,11,ROMITA,026,SAN JORGE DE TUNA AGRIA,2,141,62,79,6
GUANAJUATO,11,ROMITA,026,SAN JOSÉ DE CUBA,2,36,18,18,2
GUANAJUATO,11,ROMITA,026,SAN JOSÉ DE LA ANGOSTURA (EJIDO PASO DE LEÓN),4,191,87,104,10
GUANAJUATO,11,ROMITA,026,SAN JOSÉ DE SOLÍS (LA GARITA),2,36,16,20,2
GUANAJUATO,11,ROMITA,026,SAN JOSÉ DEL JAGÜEY,1,20,9,11,1
GUANAJUATO,11,ROMITA,026,SAN JOSÉ DEL PARAÍSO,2,41,23,18,2
GUANAJUATO,11,ROMITA,026,SAN MIGUEL DEL GUARICHO,3,265,130,135,11
GUANAJUATO,11,ROMITA,026,SAN PEDRITO DE LÓPEZ (EL TENAMASTE),2,65,27,38,4
GUANAJUATO,11,ROMITA,026,SAN RAMÓN NUEVO,2,38,22,16,3
GUANAJUATO,11,ROMITA,026,SANTA EFIGENIA,3,170,79,91,8
GUANAJUATO,11,ROMITA,026,SANTA ELENA DE LA CRUZ (LA OREJA),1,16,11,5,1
GUANAJUATO,11,ROMITA,026,SANTA GERTRUDIS (SANTA TULA),2,117,68,49,4
GUANAJUATO,11,ROMITA,026,SANTA ROSA DE RIVAS,3,264,119,145,12
GUANAJUATO,11,ROMITA,026,SANTA ROSALÍA DE GAVIA,2,80,40,40,4
GUANAJUATO,11,ROMITA,026,SILVA,2,119,58,61,5
GUANAJUATO,11,ROMITA,026,TIERRAS BLANCAS,2,86,45,41,4
GUANAJUATO,11,ROMITA,026,TUNA AGRIA,2,44,22,22,3
GUANAJUATO,11,ROMITA,026,VALENCIANA DE GAVIA,2,77,33,44,3
GUANAJUATO,11,ROMITA,026,VISTA HERMOSA,2,109,53,56,4
GUANAJUATO,11,SALAMANCA,027,ANCÓN (LA HACIENDA DE ANCÓN),2,91,36,55,5
GUANAJUATO,11,SALAMANCA,027,BARRÓN,4,597,301,296,25
GUANAJUATO,11,SALAMANCA,027,BUENAVISTA DE VALTIERRA,1,34,18,16,2
GUANAJUATO,11,SALAMANCA,027,CALLEJONES Y GRANADOS,2,125,58,67,6
GUANAJUATO,11,SALAMANCA,027,CAMPO SARABIA,1,272,139,133,12
GUANAJUATO,11,SALAMANCA,027,CAÑADA DE ORTEGA,1,46,32,14,3
GUANAJUATO,11,SALAMANCA,027,CÁRDENAS,4,767,392,375,26
GUANAJUATO,11,SALAMANCA,027,CERRO BLANCO,2,64,26,38,4
GUANAJUATO,11,SALAMANCA,027,CERRO BLANCO DE MANCERA,3,332,168,164,12
GUANAJUATO,11,SALAMANCA,027,CERRO GORDO (SAN RAFAEL),8,1357,687,670,54
GUANAJUATO,11,SALAMANCA,027,COLONIA MORELOS (EL CHIQUIADOR),2,53,28,25,3
GUANAJUATO,11,SALAMANCA,027,CRUCES,2,28,15,13,2
GUANAJUATO,11,SALAMANCA,027,CUATRO DE ALTAMIRA,4,168,87,81,8
GUANAJUATO,11,SALAMANCA,027,DOÑA ROSA (EL CHICOTE),4,393,195,198,17
GUANAJUATO,11,SALAMANCA,027,EJIDO SAN JUAN DE RAZOS,1,217,115,102,64
GUANAJUATO,11,SALAMANCA,027,EL CALABOZO,2,53,28,25,3
GUANAJUATO,11,SALAMANCA,027,EL CARACOL,2,41,24,17,4
GUANAJUATO,11,SALAMANCA,027,EL CIRCUITO,2,98,50,48,6
GUANAJUATO,11,SALAMANCA,027,EL COECILLO,2,114,57,57,6
GUANAJUATO,11,SALAMANCA,027,EL DIVISADOR,3,339,163,176,15
GUANAJUATO,11,SALAMANCA,027,EL ESTANCO,1,23,11,12,1
GUANAJUATO,11,SALAMANCA,027,EL GUARICHO,2,70,26,44,3
GUANAJUATO,11,SALAMANCA,027,EL NACIMIENTO,2,102,50,52,6
GUANAJUATO,11,SALAMANCA,027,EL PITAHAYO,1,15,8,7,1
GUANAJUATO,11,SALAMANCA,027,EL RECUERDO DE ANCÓN (XOCONOXTLE DE ARRIBA),5,694,346,348,28
GUANAJUATO,11,SALAMANCA,027,EL TEPAMAL,1,8,4,4,1
GUANAJUATO,11,SALAMANCA,027,EL TERRERO,2,95,48,47,4
GUANAJUATO,11,SALAMANCA,027,FIMEE,2,2921,1030,1891,301
GUANAJUATO,11,SALAMANCA,027,FRACCIONAMIENTO VILLA SALAMANCA 400,1,300,145,155,20
GUANAJUATO,11,SALAMANCA,027,GODOY,2,145,68,77,8
GUANAJUATO,11,SALAMANCA,027,GUADALUPE,2,155,84,71,8
GUANAJUATO,11,SALAMANCA,027,JESÚS JIMÉNEZ (GRANJEATELA),1,1999,818,1181,137
GUANAJUATO,11,SALAMANCA,027,JOYA DE CORTÉS (JOYA GRANDE),3,28,10,18,3
GUANAJUATO,11,SALAMANCA,027,LA CAL,2,67,32,35,3
GUANAJUATO,11,SALAMANCA,027,LA CAMPANA,2,142,73,69,7
GUANAJUATO,11,SALAMANCA,027,LA CAPILLA,5,468,265,203,21
GUANAJUATO,11,SALAMANCA,027,LA COMPAÑÍA,2,72,31,41,4
GUANAJUATO,11,SALAMANCA,027,LA HACIENDITA (LA TALONERA),2,86,43,43,4
GUANAJUATO,11,SALAMANCA,027,LA HACIENDITA DE SAN ANDRÉS,1,5,3,2,1
GUANAJUATO,11,SALAMANCA,027,LA JOYITA DE VILLAFAÑA,3,45,26,19,4
GUANAJUATO,11,SALAMANCA,027,LA LUZ (LA CAL),2,235,104,131,9
GUANAJUATO,11,SALAMANCA,027,LA ORDEÑA,5,632,327,305,24
GUANAJUATO,11,SALAMANCA,027,LA PALMA,2,60,34,26,4
GUANAJUATO,11,SALAMANCA,027,LA TINAJA,2,160,77,83,8
GUANAJUATO,11,SALAMANCA,027,LABOR DE VALTIERRA,4,248,124,124,11
GUANAJUATO,11,SALAMANCA,027,LAS LIEBRES,2,77,40,37,4
GUANAJUATO,11,SALAMANCA,027,LO DE RAYAS,2,25,13,12,3
GUANAJUATO,11,SALAMANCA,027,LOCOS DE COVARRUBIAS,2,42,22,20,3
GUANAJUATO,11,SALAMANCA,027,LOCOS DE DOMENZÁIN (LOS LOQUITOS),1,8,3,5,1
GUANAJUATO,11,SALAMANCA,027,LOMA PELADA,5,911,468,443,35
GUANAJUATO,11,SALAMANCA,027,LOS ÁNGELES DE ABAJO,2,58,29,29,4
GUANAJUATO,11,SALAMANCA,027,LOS ÁNGELES DE ARRIBA,1,5,2,3,1
GUANAJUATO,11,SALAMANCA,027,LOS CENIZOS,2,55,25,30,3
GUANAJUATO,11,SALAMANCA,027,LOS CONEJOS (SAN NICOLÁS DE URUÉTARO),2,662,291,371,79
GUANAJUATO,11,SALAMANCA,027,LOS HERNÁNDEZ,2,95,46,49,4
GUANAJUATO,11,SALAMANCA,027,LOS LOBOS,4,241,111,130,14
GUANAJUATO,11,SALAMANCA,027,LOS MIRANDA (EL XOCONOXTLE DE ABAJO),2,130,59,71,7
GUANAJUATO,11,SALAMANCA,027,LOS PRIETOS (EL CAJÓN),5,689,350,339,29
GUANAJUATO,11,SALAMANCA,027,LOS RAZOS DE ANCÓN,2,101,47,54,5
GUANAJUATO,11,SALAMANCA,027,LOS SOTOS,2,19,12,7,2
GUANAJUATO,11,SALAMANCA,027,LOS VÁZQUEZ,1,5,4,1,1
GUANAJUATO,11,SALAMANCA,027,LOS ZAVALA,1,11,7,4,1
GUANAJUATO,11,SALAMANCA,027,MAJADAS DE ANCÓN,2,25,12,13,2
GUANAJUATO,11,SALAMANCA,027,MARÍA GÓMEZ,2,88,34,54,5
GUANAJUATO,11,SALAMANCA,027,MESA DE SAN ISIDRO (MESA DE LOS MOSQUEDA),3,24,13,11,3
GUANAJUATO,11,SALAMANCA,027,OTEROS,5,391,191,200,26
GUANAJUATO,11,SALAMANCA,027,PALO BLANCO,3,149,68,81,8
GUANAJUATO,11,SALAMANCA,027,PERICO DE CORNEJO,2,91,53,38,4
GUANAJUATO,11,SALAMANCA,027,POTRERILLOS,2,26,17,9,2
GUANAJUATO,11,SALAMANCA,027,PUENTE DE GUADALUPE,1,12,4,8,1
GUANAJUATO,11,SALAMANCA,027,PUERTO DE VALLE,4,238,115,123,13
GUANAJUATO,11,SALAMANCA,027,RANCHO LOS RAMÍREZ (FRACCIÓN EL DIVISADOR),1,12,8,4,1
GUANAJUATO,11,SALAMANCA,027,RANCHO NUEVO,1,9,3,6,1
GUANAJUATO,11,SALAMANCA,027,RANCHO ZAPOTE DE NEGRETE,2,77,26,51,3
GUANAJUATO,11,SALAMANCA,027,RIVERA DE GUADALUPE,2,57,35,22,3
GUANAJUATO,11,SALAMANCA,027,SALAMANCA,192,40381,20397,19984,2414
GUANAJUATO,11,SALAMANCA,027,SAN BERNARDO,4,484,224,260,23
GUANAJUATO,11,SALAMANCA,027,SAN FELIPE DE JESÚS,1,9,3,6,1
GUANAJUATO,11,SALAMANCA,027,SAN JOAQUÍN,1,10,4,6,1
GUANAJUATO,11,SALAMANCA,027,SAN JOSÉ DE LA MONTAÑA,2,207,91,116,8
GUANAJUATO,11,SALAMANCA,027,SAN JOSÉ DE LOS DUROS,2,35,13,22,3
GUANAJUATO,11,SALAMANCA,027,SAN JOSÉ DE MENDOZA,5,659,322,337,24
GUANAJUATO,11,SALAMANCA,027,SAN JOSÉ DEL CARMEN,2,38,18,20,2
GUANAJUATO,11,SALAMANCA,027,SAN JOSÉ TEMASCATÍO,6,1646,810,836,51
GUANAJUATO,11,SALAMANCA,027,SAN JUAN,1,8,2,6,1
GUANAJUATO,11,SALAMANCA,027,SAN JUAN DE RAZOS,5,1277,694,583,141
GUANAJUATO,11,SALAMANCA,027,SAN MANUEL DE VALDERRAMA,2,30,16,14,2
GUANAJUATO,11,SALAMANCA,027,SAN RAFAEL DE URUÉTARO,2,35,17,18,2
GUANAJUATO,11,SALAMANCA,027,SAN VICENTE DE FLORES,4,353,192,161,14
GUANAJUATO,11,SALAMANCA,027,SANTA RITA,2,120,60,60,7
GUANAJUATO,11,SALAMANCA,027,SANTIAGUILLO DE GARCÍA,3,67,32,35,4
GUANAJUATO,11,SALAMANCA,027,SANTO DOMINGO,3,195,93,102,9
GUANAJUATO,11,SALAMANCA,027,SAUZ DE CRUCES,2,26,10,16,2
GUANAJUATO,11,SALAMANCA,027,SOTELO,3,292,146,146,14
GUANAJUATO,11,SALAMANCA,027,UNIÓN DE LIEBRES (LAS CONEJAS),1,39,20,19,2
GUANAJUATO,11,SALAMANCA,027,URUÉTARO,3,352,166,186,14
GUANAJUATO,11,SALAMANCA,027,VALENCIA DE CERRO GORDO,4,466,234,232,23
GUANAJUATO,11,SALAMANCA,027,VALTIERRA,3,174,84,90,8
GUANAJUATO,11,SALAMANCA,027,VALTIERRILLA,12,2922,1475,1447,136
GUANAJUATO,11,SALAMANCA,027,ZAPOTE DE COVARRUBIAS,1,62,31,31,3
GUANAJUATO,11,SALAMANCA,027,ZAPOTE DE PALOMAS,2,181,77,104,8
GUANAJUATO,11,SALVATIERRA,028,CUPAREO,3,345,170,175,20
GUANAJUATO,11,SALVATIERRA,028,EL CAPULÍN,3,170,76,94,11
GUANAJUATO,11,SALVATIERRA,028,EL CARACOL,1,3,1,2,1
GUANAJUATO,11,SALVATIERRA,028,EL FÉNIX,2,28,15,13,2
GUANAJUATO,11,SALVATIERRA,028,EL PIRUL,2,15,8,7,2
GUANAJUATO,11,SALVATIERRA,028,EL POTRERO,2,108,51,57,6
GUANAJUATO,11,SALVATIERRA,028,EL REFUGIO (RANCHO NUEVO),1,7,3,4,1
GUANAJUATO,11,SALVATIERRA,028,EL SABINO,6,757,356,401,46
GUANAJUATO,11,SALVATIERRA,028,EL SALVADOR (RANCHITO SAN JOSÉ DEL CARMEN),3,231,117,114,11
GUANAJUATO,11,SALVATIERRA,028,ESTACIÓN GUZMÁN,2,25,14,11,2
GUANAJUATO,11,SALVATIERRA,028,ESTANCIA DEL CARMEN DE MARAVATÍO,4,219,114,105,14
GUANAJUATO,11,SALVATIERRA,028,GERVACIO MENDOZA,2,125,73,52,7
GUANAJUATO,11,SALVATIERRA,028,GUADALUPE,2,95,50,45,4
GUANAJUATO,11,SALVATIERRA,028,JANICHO,4,1726,867,859,63
GUANAJUATO,11,SALVATIERRA,028,LA CALERA,2,215,112,103,10
GUANAJUATO,11,SALVATIERRA,028,LA ESQUINA,2,29,16,13,2
GUANAJUATO,11,SALVATIERRA,028,LA ESTANCIA DE SAN JOSÉ DEL CARMEN,2,152,86,66,8
GUANAJUATO,11,SALVATIERRA,028,LA HUERTA,2,62,29,33,4
GUANAJUATO,11,SALVATIERRA,028,LA LAGUNILLA DEL CARMEN,2,41,19,22,2
GUANAJUATO,11,SALVATIERRA,028,LA LUZ,4,339,176,163,17
GUANAJUATO,11,SALVATIERRA,028,LA MAGDALENA,2,66,37,29,3
GUANAJUATO,11,SALVATIERRA,028,LA PALMA DE EMÉNGUARO,2,106,51,55,5
GUANAJUATO,11,SALVATIERRA,028,LA PALMA DE LA LUZ,2,30,17,13,2
GUANAJUATO,11,SALVATIERRA,028,LA QUEMADA,2,65,35,30,3
GUANAJUATO,11,SALVATIERRA,028,LA VIRGEN,4,195,104,91,11
GUANAJUATO,11,SALVATIERRA,028,LAS CANOAS,2,75,43,32,4
GUANAJUATO,11,SALVATIERRA,028,LAS CAÑAS,1,12,4,8,1
GUANAJUATO,11,SALVATIERRA,028,LAS CRUCES,4,160,90,70,11
GUANAJUATO,11,SALVATIERRA,028,MARAVATÍO DEL ENCINAL,6,660,332,328,35
GUANAJUATO,11,SALVATIERRA,028,OJO DE AGUA DE BALLESTEROS,4,322,162,160,15
GUANAJUATO,11,SALVATIERRA,028,OJUELOS,2,52,35,17,3
GUANAJUATO,11,SALVATIERRA,028,PALO BLANCO,1,12,7,5,1
GUANAJUATO,11,SALVATIERRA,028,PRESA DE SAN JUAN,1,5,4,1,1
GUANAJUATO,11,SALVATIERRA,028,PROVINCIA,1,6,4,2,1
GUANAJUATO,11,SALVATIERRA,028,PUERTA DEL MONTE,2,99,48,51,5
GUANAJUATO,11,SALVATIERRA,028,SALVATIERRA,63,9686,5024,4662,741
GUANAJUATO,11,SALVATIERRA,028,SAN ANTONIO EMÉNGUARO,2,165,81,84,8
GUANAJUATO,11,SALVATIERRA,028,SAN FELIPE DE JESÚS,3,304,147,157,19
GUANAJUATO,11,SALVATIERRA,028,SAN ISIDRO (EL COLORADO),2,77,36,41,4
GUANAJUATO,11,SALVATIERRA,028,SAN JOSÉ DEL CARMEN,3,163,80,83,7
GUANAJUATO,11,SALVATIERRA,028,SAN MIGUEL EMÉNGUARO,4,568,252,316,28
GUANAJUATO,11,SALVATIERRA,028,SAN NICOLÁS DE LOS AGUSTINOS,6,1515,728,787,88
GUANAJUATO,11,SALVATIERRA,028,SAN PABLO PEJO,4,254,133,121,14
GUANAJUATO,11,SALVATIERRA,028,SAN PEDRO DE LOS NARANJOS,5,1663,853,810,93
GUANAJUATO,11,SALVATIERRA,028,SANTA ROSA TEJOCOTE,3,54,26,28,3
GUANAJUATO,11,SALVATIERRA,028,SANTO TOMÁS HUATZINDEO,2,216,115,101,9
GUANAJUATO,11,SALVATIERRA,028,URIREO,9,1967,958,1009,69
GUANAJUATO,11,SAN DIEGO DE LA UNIÓN,029,BARRANCA DE CANO,4,131,73,58,8
GUANAJUATO,11,SAN DIEGO DE LA UNIÓN,029,BORDO DE GUADALUPE,1,11,6,5,1
GUANAJUATO,11,SAN DIEGO DE LA UNIÓN,029,BORDO DEL CARMEN,2,14,6,8,2
GUANAJUATO,11,SAN DIEGO DE LA UNIÓN,029,CABRAS,3,30,14,16,3
GUANAJUATO,11,SAN DIEGO DE LA UNIÓN,029,CATALÁN DEL REFUGIO (CATALANES),4,538,272,266,25
GUANAJUATO,11,SAN DIEGO DE LA UNIÓN,029,CHARCO DE ARAUJO,2,33,10,23,3
GUANAJUATO,11,SAN DIEGO DE LA UNIÓN,029,CHARCO DEL HUIZACHE,4,41,20,21,4
GUANAJUATO,11,SAN DIEGO DE LA UNIÓN,029,CÓPORO,2,46,26,20,3
GUANAJUATO,11,SAN DIEGO DE LA UNIÓN,029,EJIDO EL BARRENO (EL GATO),2,55,33,22,3
GUANAJUATO,11,SAN DIEGO DE LA UNIÓN,029,EJIDO GÓMEZ VILLANUEVA,1,19,11,8,1
GUANAJUATO,11,SAN DIEGO DE LA UNIÓN,029,EJIDO LOS DESMONTES (EL PATOL),2,37,19,18,2
GUANAJUATO,11,SAN DIEGO DE LA UNIÓN,029,EJIDO OJUELOS (EL BARRENO),2,34,16,18,2
GUANAJUATO,11,SAN DIEGO DE LA UNIÓN,029,EJIDO SANTA ANITA,2,25,11,14,2
GUANAJUATO,11,SAN DIEGO DE LA UNIÓN,029,EL ARENAL,2,23,14,9,2
GUANAJUATO,11,SAN DIEGO DE LA UNIÓN,029,EL COLORADO,3,121,54,67,6
GUANAJUATO,11,SAN DIEGO DE LA UNIÓN,029,EL MEZQUITAL,2,31,16,15,2
GUANAJUATO,11,SAN DIEGO DE LA UNIÓN,029,EL MIRADOR,2,7,2,5,2
GUANAJUATO,11,SAN DIEGO DE LA UNIÓN,029,EL NARANJERO,2,12,6,6,2
GUANAJUATO,11,SAN DIEGO DE LA UNIÓN,029,EL PATOLITO DOS,3,41,20,21,4
GUANAJUATO,11,SAN DIEGO DE LA UNIÓN,029,EL PEÑÓN,2,37,19,18,3
GUANAJUATO,11,SAN DIEGO DE LA UNIÓN,029,EL ROSALITO,4,161,86,75,10
GUANAJUATO,11,SAN DIEGO DE LA UNIÓN,029,EL SALITRE,2,8,5,3,1
GUANAJUATO,11,SAN DIEGO DE LA UNIÓN,029,EL SOCORRO,2,38,19,19,3
GUANAJUATO,11,SAN DIEGO DE LA UNIÓN,029,EL TORIL,2,17,7,10,2
GUANAJUATO,11,SAN DIEGO DE LA UNIÓN,029,EL XOCONOXTLE,1,7,1,6,1
GUANAJUATO,11,SAN DIEGO DE LA UNIÓN,029,ESTANCIA DE BANQUITOS,1,4,1,3,1
GUANAJUATO,11,SAN DIEGO DE LA UNIÓN,029,EX-HACIENDA DE JESÚS,4,151,85,66,10
GUANAJUATO,11,SAN DIEGO DE LA UNIÓN,029,EX-HACIENDA DE MONJAS,1,6,1,5,1
GUANAJUATO,11,SAN DIEGO DE LA UNIÓN,029,EX-HACIENDA DE OJUELOS,2,35,17,18,2
GUANAJUATO,11,SAN DIEGO DE LA UNIÓN,029,EX-HACIENDA LA JAULA,4,270,146,124,14
GUANAJUATO,11,SAN DIEGO DE LA UNIÓN,029,EX-HACIENDA NORIA DE ALDAY,3,411,213,198,18
GUANAJUATO,11,SAN DIEGO DE LA UNIÓN,029,GUANAJUATITO,2,68,35,33,4
GUANAJUATO,11,SAN DIEGO DE LA UNIÓN,029,JARILLAS,2,10,4,6,2
GUANAJUATO,11,SAN DIEGO DE LA UNIÓN,029,LA CABAÑA DEL REY,4,358,173,185,17
GUANAJUATO,11,SAN DIEGO DE LA UNIÓN,029,LA GRANJA,2,74,32,42,4
GUANAJUATO,11,SAN DIEGO DE LA UNIÓN,029,LA MISERICORDIA (CHINCHES BRAVAS),2,52,25,27,3
GUANAJUATO,11,SAN DIEGO DE LA UNIÓN,029,LA PALENCIA DEL SAUCITO,2,80,45,35,4
GUANAJUATO,11,SAN DIEGO DE LA UNIÓN,029,LA PRESITA DE LA LUZ,4,582,279,303,24
GUANAJUATO,11,SAN DIEGO DE LA UNIÓN,029,LA SAUCEDA,4,295,155,140,14
GUANAJUATO,11,SAN DIEGO DE LA UNIÓN,029,LA TINAJA,2,43,17,26,2
GUANAJUATO,11,SAN DIEGO DE LA UNIÓN,029,LA VIRGEN,2,24,10,14,2
GUANAJUATO,11,SAN DIEGO DE LA UNIÓN,029,LAGUNA DEL PUERTO,2,5,2,3,1
GUANAJUATO,11,SAN DIEGO DE LA UNIÓN,029,MULATOS,4,165,82,83,10
GUANAJUATO,11,SAN DIEGO DE LA UNIÓN,029,NAINARE,2,12,4,8,2
GUANAJUATO,11,SAN DIEGO DE LA UNIÓN,029,OJO CIEGO (SAN JOSÉ DE LA PURÍSIMA),2,69,34,35,3
GUANAJUATO,11,SAN DIEGO DE LA UNIÓN,029,PALMA GORDA,1,15,12,3,1
GUANAJUATO,11,SAN DIEGO DE LA UNIÓN,029,PALO VERDE,1,21,8,13,1
GUANAJUATO,11,SAN DIEGO DE LA UNIÓN,029,PARRITAS,4,313,168,145,14
GUANAJUATO,11,SAN DIEGO DE LA UNIÓN,029,PEÑUELAS,4,292,144,148,16
GUANAJUATO,11,SAN DIEGO DE LA UNIÓN,029,POZO ADEMADO,4,209,96,113,10
GUANAJUATO,11,SAN DIEGO DE LA UNIÓN,029,PRESA DE MONJAS,4,135,79,56,9
GUANAJUATO,11,SAN DIEGO DE LA UNIÓN,029,PRESA DE SAN FRANCO,2,76,29,47,4
GUANAJUATO,11,SAN DIEGO DE LA UNIÓN,029,PRÍNCIPES,2,33,19,14,2
GUANAJUATO,11,SAN DIEGO DE LA UNIÓN,029,PROVIDENCIA,4,218,109,109,12
GUANAJUATO,11,SAN DIEGO DE LA UNIÓN,029,PUERTA DE CADENAS (EJIDO DE CATALÁN),2,49,24,25,2
GUANAJUATO,11,SAN DIEGO DE LA UNIÓN,029,PUERTA DE MARCIAL (SAN ISIDRO DE LA CRUZ),2,28,17,11,2
GUANAJUATO,11,SAN DIEGO DE LA UNIÓN,029,PURÍSIMA DEL MONTE,1,13,5,8,1
GUANAJUATO,11,SAN DIEGO DE LA UNIÓN,029,RANCHITO DE LOS HERNÁNDEZ,1,6,3,3,1
GUANAJUATO,11,SAN DIEGO DE LA UNIÓN,029,RANCHO DE OVEJAS,3,134,65,69,5
GUANAJUATO,11,SAN DIEGO DE LA UNIÓN,029,ROSA DE CASTILLA,2,71,33,38,4
GUANAJUATO,11,SAN DIEGO DE LA UNIÓN,029,SAN AGUSTÍN,3,87,47,40,4
GUANAJUATO,11,SAN DIEGO DE LA UNIÓN,029,SAN ANTONIO,4,187,106,81,11
GUANAJUATO,11,SAN DIEGO DE LA UNIÓN,029,SAN DIEGO DE LA UNIÓN,15,2406,1154,1252,118
GUANAJUATO,11,SAN DIEGO DE LA UNIÓN,029,SAN ISIDRO,2,27,9,18,2
GUANAJUATO,11,SAN DIEGO DE LA UNIÓN,029,SAN JOSÉ DEL CHARCO,2,23,16,7,2
GUANAJUATO,11,SAN DIEGO DE LA UNIÓN,029,SAN JUAN PAN DE ARRIBA,5,743,362,381,27
GUANAJUATO,11,SAN DIEGO DE LA UNIÓN,029,SAN JUANITA (LA PONDEROSA),1,23,9,14,1
GUANAJUATO,11,SAN DIEGO DE LA UNIÓN,029,SAN PEDRO,2,17,8,9,2
GUANAJUATO,11,SAN DIEGO DE LA UNIÓN,029,SAN ROQUE,3,22,7,15,3
GUANAJUATO,11,SAN DIEGO DE LA UNIÓN,029,SANTA ANITA,4,135,61,74,10
GUANAJUATO,11,SAN DIEGO DE LA UNIÓN,029,SANTA ROSA,2,7,7,0,1
GUANAJUATO,11,SAN DIEGO DE LA UNIÓN,029,TAMPIQUITO,1,6,2,4,1
GUANAJUATO,11,SAN DIEGO DE LA UNIÓN,029,TANQUE NUEVO,1,6,3,3,1
GUANAJUATO,11,SAN DIEGO DE LA UNIÓN,029,TRES ESQUINAS,2,39,21,18,2
GUANAJUATO,11,SAN FELIPE,030,ARANJUEZ,3,297,142,155,13
GUANAJUATO,11,SAN FELIPE,030,ARROYO BLANCO,2,10,2,8,2
GUANAJUATO,11,SAN FELIPE,030,BAJÍO LOS CHILITOS,1,18,11,7,1
GUANAJUATO,11,SAN FELIPE,030,BENITO JUÁREZ,3,18,12,6,3
GUANAJUATO,11,SAN FELIPE,030,BUENAVISTA DEL CUBO,3,82,41,41,6
GUANAJUATO,11,SAN FELIPE,030,CANTERA SUR,4,397,202,195,15
GUANAJUATO,11,SAN FELIPE,030,CANTERITAS,2,20,6,14,2
GUANAJUATO,11,SAN FELIPE,030,CAÑADA DE CHÁVEZ,2,34,15,19,2
GUANAJUATO,11,SAN FELIPE,030,CAPELLANÍA,1,46,21,25,2
GUANAJUATO,11,SAN FELIPE,030,CAPETILLO,1,20,9,11,2
GUANAJUATO,11,SAN FELIPE,030,CAPILLAS,2,24,12,12,2
GUANAJUATO,11,SAN FELIPE,030,CASA BLANCA,1,15,3,12,1
GUANAJUATO,11,SAN FELIPE,030,CERRITO DE LOS HERNÁNDEZ,2,40,21,19,3
GUANAJUATO,11,SAN FELIPE,030,CERRO GORDO (LOS TORTUGOS),3,44,22,22,3
GUANAJUATO,11,SAN FELIPE,030,CHARCO AZUL,2,10,4,6,2
GUANAJUATO,11,SAN FELIPE,030,CHIRIMOYA (ESTACIÓN CHIRIMOYA),3,273,129,144,11
GUANAJUATO,11,SAN FELIPE,030,CHIRIMOYA VIEJA,1,23,8,15,1
GUANAJUATO,11,SAN FELIPE,030,COECILLO,4,282,139,143,14
GUANAJUATO,11,SAN FELIPE,030,CUARTOS DE BRAVO,3,92,41,51,7
GUANAJUATO,11,SAN FELIPE,030,DESEADILLA,3,81,47,34,5
GUANAJUATO,11,SAN FELIPE,030,EL AGUAJE SUR,2,31,16,15,2
GUANAJUATO,11,SAN FELIPE,030,EL ANCÓN,2,37,23,14,2
GUANAJUATO,11,SAN FELIPE,030,EL APOSENTO (LA CONCEPCIÓN),3,158,76,82,7
GUANAJUATO,11,SAN FELIPE,030,EL ARO,2,26,14,12,3
GUANAJUATO,11,SAN FELIPE,030,EL CAPULÍN,2,26,16,10,2
GUANAJUATO,11,SAN FELIPE,030,EL CARRETÓN,4,647,334,313,25
GUANAJUATO,11,SAN FELIPE,030,EL COLORADO,2,13,7,6,2
GUANAJUATO,11,SAN FELIPE,030,EL CONTADERO,1,18,8,10,1
GUANAJUATO,11,SAN FELIPE,030,EL DURAZNO,1,10,7,3,1
GUANAJUATO,11,SAN FELIPE,030,EL ESTAÑO,2,13,9,4,2
GUANAJUATO,11,SAN FELIPE,030,EL FRESNO,1,37,22,15,2
GUANAJUATO,11,SAN FELIPE,030,EL GARBANZO,3,39,19,20,4
GUANAJUATO,11,SAN FELIPE,030,EL HUIZACHE,3,147,67,80,8
GUANAJUATO,11,SAN FELIPE,030,EL JARALILLO,2,42,18,24,3
GUANAJUATO,11,SAN FELIPE,030,EL LINDERO,2,32,19,13,2
GUANAJUATO,11,SAN FELIPE,030,EL LINDERO (ARROYO BLANCO),3,25,11,14,3
GUANAJUATO,11,SAN FELIPE,030,EL MASTRANTO SUR,2,22,13,9,2
GUANAJUATO,11,SAN FELIPE,030,EL MEZQUITE (SAN MARTÍN DEL MEZQUITE),3,37,15,22,4
GUANAJUATO,11,SAN FELIPE,030,EL ORIENTE,1,13,7,6,1
GUANAJUATO,11,SAN FELIPE,030,EL PIRUL,2,89,46,43,5
GUANAJUATO,11,SAN FELIPE,030,EL POTRERO,2,30,15,15,3
GUANAJUATO,11,SAN FELIPE,030,EL ROBLE,2,24,14,10,2
GUANAJUATO,11,SAN FELIPE,030,EL RODEO (EL RODEO DEL LINDERO),2,10,7,3,2
GUANAJUATO,11,SAN FELIPE,030,EL ROSARIO (LA LIEBRE),3,76,34,42,5
GUANAJUATO,11,SAN FELIPE,030,EL SAUCILLO,1,9,4,5,1
GUANAJUATO,11,SAN FELIPE,030,EL SAUZ,2,47,24,23,2
GUANAJUATO,11,SAN FELIPE,030,EL SAUZ (EL SAUCITO),3,42,21,21,3
GUANAJUATO,11,SAN FELIPE,030,EL TEJOCOTE (EL DOMINGO),2,364,177,187,14
GUANAJUATO,11,SAN FELIPE,030,EL TEPOZÁN DE SANTA RITA,2,28,11,17,2
GUANAJUATO,11,SAN FELIPE,030,EL TEPOZÁN DOS,3,132,54,78,6
GUANAJUATO,11,SAN FELIPE,030,EL TULILLO,1,4,3,1,1
GUANAJUATO,11,SAN FELIPE,030,EL VERGEL Y ANEXOS,3,68,35,33,5
GUANAJUATO,11,SAN FELIPE,030,EL ZAPOTE,3,329,155,174,11
GUANAJUATO,11,SAN FELIPE,030,EMILIANO ZAPATA (ZAVALA),3,182,97,85,9
GUANAJUATO,11,SAN FELIPE,030,ESTACIÓN VENTILLA,2,22,9,13,2
GUANAJUATO,11,SAN FELIPE,030,ESTANCIA DE SAN FRANCISCO,4,268,124,144,13
GUANAJUATO,11,SAN FELIPE,030,ESTANCIA DEL CUBITO,2,40,21,19,2
GUANAJUATO,11,SAN FELIPE,030,FÁBRICA DE GUADALUPE,4,108,58,50,9
GUANAJUATO,11,SAN FELIPE,030,FÁBRICA DE MELCHOR,5,778,401,377,28
GUANAJUATO,11,SAN FELIPE,030,FÁTIMA,1,12,6,6,1
GUANAJUATO,11,SAN FELIPE,030,FRESNILLOS DE GALLEGOS (LA MANGA),1,16,10,6,1
GUANAJUATO,11,SAN FELIPE,030,FUENTES,1,3,2,1,1
GUANAJUATO,11,SAN FELIPE,030,FUERTE VIEJO,4,268,137,131,15
GUANAJUATO,11,SAN FELIPE,030,GALEANA,2,11,5,6,2
GUANAJUATO,11,SAN FELIPE,030,GUADALUPE (EX-HACIENDA CASCO DE LEQUEITIO),2,259,130,129,9
GUANAJUATO,11,SAN FELIPE,030,HERRERÍAS,3,92,40,52,6
GUANAJUATO,11,SAN FELIPE,030,HUAPANAL DE LEQUEITIO,3,60,27,33,4
GUANAJUATO,11,SAN FELIPE,030,HUAPIMÍ,1,12,4,8,1
GUANAJUATO,11,SAN FELIPE,030,JARAL DE BERRIOS,7,1122,526,596,46
GUANAJUATO,11,SAN FELIPE,030,JARAL DE BERRIOS (ESTACIÓN JARAL),2,194,95,99,8
GUANAJUATO,11,SAN FELIPE,030,JESÚS MARÍA,4,162,68,94,9
GUANAJUATO,11,SAN FELIPE,030,LA ANGOSTURA,3,52,24,28,4
GUANAJUATO,11,SAN FELIPE,030,LA BALLEZA,3,18,11,7,3
GUANAJUATO,11,SAN FELIPE,030,LA BARRANCA DE LA SANTA CRUZ,2,7,3,4,1
GUANAJUATO,11,SAN FELIPE,030,LA CEJA,3,131,62,69,7
GUANAJUATO,11,SAN FELIPE,030,LA CIÉNEGA,2,70,37,33,4
GUANAJUATO,11,SAN FELIPE,030,LA CIENEGUITA,4,168,76,92,10
GUANAJUATO,11,SAN FELIPE,030,LA ERA DE BRAVO,3,38,24,14,4
GUANAJUATO,11,SAN FELIPE,030,LA ESCONDIDA,2,5,4,1,2
GUANAJUATO,11,SAN FELIPE,030,LA ESPERANZA,2,21,9,12,2
GUANAJUATO,11,SAN FELIPE,030,LA ESTANCIA (LAS AVISPAS),2,57,32,25,3
GUANAJUATO,11,SAN FELIPE,030,LA ESTANCIA DEL CUBO,4,279,145,134,14
GUANAJUATO,11,SAN FELIPE,030,LA ESTANCITA DEL MAGUEY,3,112,55,57,6
GUANAJUATO,11,SAN FELIPE,030,LA ESTANZUELA,2,87,41,46,4
GUANAJUATO,11,SAN FELIPE,030,LA FRONTERA,2,39,18,21,3
GUANAJUATO,11,SAN FELIPE,030,LA GORRIONA,1,4,4,0,1
GUANAJUATO,11,SAN FELIPE,030,LA HERMA (LERMA),1,45,22,23,2
GUANAJUATO,11,SAN FELIPE,030,LA HERRADURA,2,6,3,3,2
GUANAJUATO,11,SAN FELIPE,030,LA HUERTA,3,254,128,126,12
GUANAJUATO,11,SAN FELIPE,030,LA LABOR,3,162,77,85,10
GUANAJUATO,11,SAN FELIPE,030,LA LAGUNITA,4,218,101,117,12
GUANAJUATO,11,SAN FELIPE,030,LA OBRA,2,83,40,43,4
GUANAJUATO,11,SAN FELIPE,030,LA PALMA,2,31,16,15,2
GUANAJUATO,11,SAN FELIPE,030,LA PUERTA DE SAN JUAN,1,8,5,3,1
GUANAJUATO,11,SAN FELIPE,030,LA PURÍSIMA DE ORIENTE (EL MUERTO),3,57,21,36,3
GUANAJUATO,11,SAN FELIPE,030,LA QUEMADA,4,211,103,108,12
GUANAJUATO,11,SAN FELIPE,030,LA ROSA DE CASTILLA,2,17,10,7,2
GUANAJUATO,11,SAN FELIPE,030,LA SAUCEDA DE LA LUZ,4,211,115,96,13
GUANAJUATO,11,SAN FELIPE,030,LA SOLEDAD,1,5,1,4,1
GUANAJUATO,11,SAN FELIPE,030,LA TAPONA,2,60,30,30,3
GUANAJUATO,11,SAN FELIPE,030,LAGUNA DE GUADALUPE,5,1234,610,624,40
GUANAJUATO,11,SAN FELIPE,030,LAS ADELITAS,2,8,3,5,2
GUANAJUATO,11,SAN FELIPE,030,LAS ALAZANAS,1,14,7,7,1
GUANAJUATO,11,SAN FELIPE,030,LAS NEGRITAS,2,12,3,9,3
GUANAJUATO,11,SAN FELIPE,030,LAS PAILITAS (CUERNOS HUECOS),2,18,8,10,2
GUANAJUATO,11,SAN FELIPE,030,LAS PALOMAS DEL CUBO,2,34,8,26,2
GUANAJUATO,11,SAN FELIPE,030,LAS PILAS DEL SUR,2,31,22,9,2
GUANAJUATO,11,SAN FELIPE,030,LAS PILAS NORTE,2,5,2,3,1
GUANAJUATO,11,SAN FELIPE,030,LAS VACAS (CERRITO DE LAS VACAS),2,19,8,11,2
GUANAJUATO,11,SAN FELIPE,030,LEQUEITIO,4,418,196,222,18
GUANAJUATO,11,SAN FELIPE,030,LOMA ALTA (BARRANCA DE LA LOMA),2,23,11,12,2
GUANAJUATO,11,SAN FELIPE,030,LOMAS DE LA ASUNCIÓN (EL PUJIDO),1,11,8,3,1
GUANAJUATO,11,SAN FELIPE,030,LOS ALISOS,2,9,4,5,2
GUANAJUATO,11,SAN FELIPE,030,LOS ALTOS DE IBARRA,3,35,16,19,4
GUANAJUATO,11,SAN FELIPE,030,LOS ARRASTRES,3,81,53,28,4
GUANAJUATO,11,SAN FELIPE,030,LOS CEDROS,2,31,17,14,2
GUANAJUATO,11,SAN FELIPE,030,LOS DÍAZ,2,146,57,89,7
GUANAJUATO,11,SAN FELIPE,030,LOS MARTÍNEZ,4,108,49,59,8
GUANAJUATO,11,SAN FELIPE,030,MAGUEY SUR,2,22,11,11,2
GUANAJUATO,11,SAN FELIPE,030,MAJADAS DE HUAPIMÍ,1,11,6,5,1
GUANAJUATO,11,SAN FELIPE,030,MANZANALES,3,67,35,32,5
GUANAJUATO,11,SAN FELIPE,030,MANZANILLAS,3,83,34,49,5
GUANAJUATO,11,SAN FELIPE,030,MARÍA AUXILIADORA,3,36,18,18,4
GUANAJUATO,11,SAN FELIPE,030,MASTRANTO DEL REFUGIO,4,168,84,84,10
GUANAJUATO,11,SAN FELIPE,030,MIGUEL HIDALGO (CUERITOS),4,193,91,102,12
GUANAJUATO,11,SAN FELIPE,030,MOLINO DE SAN JOSÉ,4,352,185,167,16
GUANAJUATO,11,SAN FELIPE,030,NOPALES,2,23,15,8,2
GUANAJUATO,11,SAN FELIPE,030,OJO DE AGUA DE HERRERÍAS,1,6,4,2,1
GUANAJUATO,11,SAN FELIPE,030,OJO DE AGUA DE LAS VACAS,3,36,14,22,4
GUANAJUATO,11,SAN FELIPE,030,OJO DE AGUA DE SAN MIGUEL (EL COYOTE),3,96,41,55,5
GUANAJUATO,11,SAN FELIPE,030,OJO DE AGUA DEL CARRIZO,2,41,23,18,2
GUANAJUATO,11,SAN FELIPE,030,PALACIO,2,68,27,41,4
GUANAJUATO,11,SAN FELIPE,030,PALMITAS (PALMILLAS),2,18,11,7,2
GUANAJUATO,11,SAN FELIPE,030,PALO COLORADO,4,151,91,60,9
GUANAJUATO,11,SAN FELIPE,030,PEÑA COLORADA,2,17,5,12,2
GUANAJUATO,11,SAN FELIPE,030,PEÑUELAS,2,52,31,21,3
GUANAJUATO,11,SAN FELIPE,030,PIEDRAS NEGRAS,2,6,4,2,2
GUANAJUATO,11,SAN FELIPE,030,POTRERO DE LA CRUZ,2,21,11,10,2
GUANAJUATO,11,SAN FELIPE,030,PROVIDENCIA DE GUADALUPE (ESTANCIA),4,224,116,108,12
GUANAJUATO,11,SAN FELIPE,030,PUERTO ALTO (BUENOS AIRES),2,34,15,19,2
GUANAJUATO,11,SAN FELIPE,030,PUERTO DE LA CARRETA,3,80,45,35,4
GUANAJUATO,11,SAN FELIPE,030,PUERTO DE SANDOVAL,4,164,84,80,11
GUANAJUATO,11,SAN FELIPE,030,RANCHO EL FRAILE (HUERTA EL FRAILE),1,131,60,71,5
GUANAJUATO,11,SAN FELIPE,030,RANCHO NUEVO DE SAN VICENTE,3,132,62,70,7
GUANAJUATO,11,SAN FELIPE,030,RANCHO NUEVO DEL CARRIZO,4,110,52,58,8
GUANAJUATO,11,SAN FELIPE,030,RANCHO NUEVO DEL SALTO,2,42,21,21,3
GUANAJUATO,11,SAN FELIPE,030,RANCHO SECO,3,124,57,67,7
GUANAJUATO,11,SAN FELIPE,030,RINCÓN DE ORTEGA,1,11,3,8,1
GUANAJUATO,11,SAN FELIPE,030,SALTO DEL AHOGADO,4,162,74,88,10
GUANAJUATO,11,SAN FELIPE,030,SAN ANDRÉS DEL CUBO,4,206,108,98,11
GUANAJUATO,11,SAN FELIPE,030,SAN ANTONIO (SAN ANTONIO DE JESÚS MARÍA),2,93,40,53,4
GUANAJUATO,11,SAN FELIPE,030,SAN ANTONIO DE LAS ALAZANAS (BUENOS AIRES),1,6,3,3,1
GUANAJUATO,11,SAN FELIPE,030,SAN ANTONIO DEL MAGUEY,4,116,61,55,9
GUANAJUATO,11,SAN FELIPE,030,SAN BARTOLO DE BERRIOS,7,1954,969,985,63
GUANAJUATO,11,SAN FELIPE,030,SAN FELIPE,41,10530,5405,5125,553
GUANAJUATO,11,SAN FELIPE,030,SAN FELIPE (LA ESTACIÓN),2,14,6,8,2
GUANAJUATO,11,SAN FELIPE,030,SAN FRANCISCO,4,393,187,206,16
GUANAJUATO,11,SAN FELIPE,030,SAN ISIDRO DE CAPELLANÍA,3,84,44,40,7
GUANAJUATO,11,SAN FELIPE,030,SAN ISIDRO Y CAPELLANÍA,3,35,17,18,3
GUANAJUATO,11,SAN FELIPE,030,SAN JOSÉ DE LA LUZ (MAJADAS),2,20,11,9,2
GUANAJUATO,11,SAN FELIPE,030,SAN JOSÉ DE LA PEÑA,2,59,23,36,3
GUANAJUATO,11,SAN FELIPE,030,SAN JOSÉ DE LA VARILLA,4,438,205,233,17
GUANAJUATO,11,SAN FELIPE,030,SAN JOSÉ DE LOS BARCOS,5,440,220,220,20
GUANAJUATO,11,SAN FELIPE,030,SAN JOSÉ DE RANCHO NUEVO (LOS ARRIEROS),5,402,215,187,19
GUANAJUATO,11,SAN FELIPE,030,SAN JOSÉ DEL RAYO,3,90,53,37,5
GUANAJUATO,11,SAN FELIPE,030,SAN JOSÉ DEL TANQUE,4,191,93,98,11
GUANAJUATO,11,SAN FELIPE,030,SAN JUAN DE LLANOS,3,156,80,76,8
GUANAJUATO,11,SAN FELIPE,030,SAN MARTÍN PEDRO PABLO,1,33,16,17,1
GUANAJUATO,11,SAN FELIPE,030,SAN PEDRO (EL FALSO),3,25,13,12,3
GUANAJUATO,11,SAN FELIPE,030,SAN PEDRO DE ALMOLOYÁN,4,597,317,280,25
GUANAJUATO,11,SAN FELIPE,030,SAN PEDRO DE LA PALMA,2,72,36,36,4
GUANAJUATO,11,SAN FELIPE,030,SAN RAMÓN,1,6,2,4,1
GUANAJUATO,11,SAN FELIPE,030,SAN VICENTE,2,16,6,10,2
GUANAJUATO,11,SAN FELIPE,030,SANTA ANITA,1,8,6,2,1
GUANAJUATO,11,SAN FELIPE,030,SANTA CATARINA,4,431,208,223,20
GUANAJUATO,11,SAN FELIPE,030,SANTA FE,2,88,32,56,5
GUANAJUATO,11,SAN FELIPE,030,SANTA MARÍA DE GUADALUPE (LAS TORTUGAS),2,42,19,23,3
GUANAJUATO,11,SAN FELIPE,030,SANTA ROSA,5,697,364,333,26
GUANAJUATO,11,SAN FELIPE,030,SANTIAGUILLO,3,11,6,5,3
GUANAJUATO,11,SAN FELIPE,030,SANTO DOMINGO DE GUZMÁN,3,43,22,21,3
GUANAJUATO,11,SAN FELIPE,030,SIERRA VERDE,1,6,3,3,1
GUANAJUATO,11,SAN FELIPE,030,TEPOZÁN,1,58,34,24,3
GUANAJUATO,11,SAN FELIPE,030,TIERRAS PRIETAS,2,59,31,28,3
GUANAJUATO,11,SAN FELIPE,030,TRES ENCINOS,2,24,10,14,2
GUANAJUATO,11,SAN FELIPE,030,TROJES DE AGUIRRE,2,97,45,52,5
GUANAJUATO,11,SAN FELIPE,030,VARAL DEL NORTE,1,5,1,4,1
GUANAJUATO,11,SAN FELIPE,030,VERGEL DE LA SIERRA,2,30,16,14,2
GUANAJUATO,11,SAN FRANCISCO DEL RINCÓN,031,ARROYO SECO,2,76,42,34,3
GUANAJUATO,11,SAN FRANCISCO DEL RINCÓN,031,BARRIO DE GUADALUPE DEL MEZQUITILLO,4,615,330,285,23
GUANAJUATO,11,SAN FRANCISCO DEL RINCÓN,031,CALIFORNIA,2,54,25,29,3
GUANAJUATO,11,SAN FRANCISCO DEL RINCÓN,031,EL CENTRO,2,73,38,35,5
GUANAJUATO,11,SAN FRANCISCO DEL RINCÓN,031,EL DESAGÜE,2,51,26,25,3
GUANAJUATO,11,SAN FRANCISCO DEL RINCÓN,031,EL GUAJE,2,53,26,27,3
GUANAJUATO,11,SAN FRANCISCO DEL RINCÓN,031,EL JUNCO,3,88,41,47,5
GUANAJUATO,11,SAN FRANCISCO DEL RINCÓN,031,EL LIEBRERO,2,59,29,30,3
GUANAJUATO,11,SAN FRANCISCO DEL RINCÓN,031,EL LINDERO (EL LINDERO VIEJO),2,110,55,55,5
GUANAJUATO,11,SAN FRANCISCO DEL RINCÓN,031,EL MAGUEY,3,466,225,241,17
GUANAJUATO,11,SAN FRANCISCO DEL RINCÓN,031,EL MEZQUITILLO,2,397,198,199,16
GUANAJUATO,11,SAN FRANCISCO DEL RINCÓN,031,EL MOGOTE,2,94,42,52,5
GUANAJUATO,11,SAN FRANCISCO DEL RINCÓN,031,EL MONTE DE LA CRUZ,2,9,5,4,2
GUANAJUATO,11,SAN FRANCISCO DEL RINCÓN,031,EL NACIMIENTO,4,237,126,111,14
GUANAJUATO,11,SAN FRANCISCO DEL RINCÓN,031,EL PANAL,1,84,40,44,4
GUANAJUATO,11,SAN FRANCISCO DEL RINCÓN,031,EL PEDREGOSO,2,49,25,24,3
GUANAJUATO,11,SAN FRANCISCO DEL RINCÓN,031,EL REFUGIO,2,89,45,44,4
GUANAJUATO,11,SAN FRANCISCO DEL RINCÓN,031,EL REPARO,2,36,16,20,3
GUANAJUATO,11,SAN FRANCISCO DEL RINCÓN,031,EL SALTO DE ABAJO,2,67,31,36,4
GUANAJUATO,11,SAN FRANCISCO DEL RINCÓN,031,EL SALTO DE ARRIBA,1,74,34,40,4
GUANAJUATO,11,SAN FRANCISCO DEL RINCÓN,031,EL SAUZ VIEJO,1,5,1,4,1
GUANAJUATO,11,SAN FRANCISCO DEL RINCÓN,031,EL TEJOCOTE,2,49,15,34,3
GUANAJUATO,11,SAN FRANCISCO DEL RINCÓN,031,EL TOMATE,2,80,39,41,4
GUANAJUATO,11,SAN FRANCISCO DEL RINCÓN,031,ESTACIÓN DE SAN FRANCISCO,1,79,37,42,3
GUANAJUATO,11,SAN FRANCISCO DEL RINCÓN,031,FRACCIONAMIENTO EL REFUGIO,1,189,87,102,6
GUANAJUATO,11,SAN FRANCISCO DEL RINCÓN,031,JALAPA,2,30,13,17,2
GUANAJUATO,11,SAN FRANCISCO DEL RINCÓN,031,JARALILLO (EL GALLO),2,122,54,68,5
GUANAJUATO,11,SAN FRANCISCO DEL RINCÓN,031,JESÚS DEL MONTE (EL TALAYOTE),4,502,244,258,19
GUANAJUATO,11,SAN FRANCISCO DEL RINCÓN,031,LA GLORIA,3,191,90,101,11
GUANAJUATO,11,SAN FRANCISCO DEL RINCÓN,031,LA MURALLA DEL CADILLAL,4,168,85,83,10
GUANAJUATO,11,SAN FRANCISCO DEL RINCÓN,031,LOMA DE SAN RAFAEL,3,232,110,122,11
GUANAJUATO,11,SAN FRANCISCO DEL RINCÓN,031,LOMA DEL LIEBRERO,1,18,11,7,1
GUANAJUATO,11,SAN FRANCISCO DEL RINCÓN,031,LOS TANQUES DEL MEZQUITILLO,2,117,42,75,5
GUANAJUATO,11,SAN FRANCISCO DEL RINCÓN,031,MARAVILLAS,2,76,44,32,4
GUANAJUATO,11,SAN FRANCISCO DEL RINCÓN,031,MEXIQUITO,3,259,118,141,12
GUANAJUATO,11,SAN FRANCISCO DEL RINCÓN,031,MONTERREY,1,11,6,5,1
GUANAJUATO,11,SAN FRANCISCO DEL RINCÓN,031,NUEVO JESÚS DEL MONTE (LA GORDA ATORADA),2,96,49,47,5
GUANAJUATO,11,SAN FRANCISCO DEL RINCÓN,031,NUEVO MEXIQUITO (LA LOMA),3,69,40,29,4
GUANAJUATO,11,SAN FRANCISCO DEL RINCÓN,031,PEÑUELAS,3,266,128,138,11
GUANAJUATO,11,SAN FRANCISCO DEL RINCÓN,031,PLAN LIBERTADOR (EL QUEMADO),2,141,72,69,6
GUANAJUATO,11,SAN FRANCISCO DEL RINCÓN,031,RANCHO GRANDE,1,57,29,28,2
GUANAJUATO,11,SAN FRANCISCO DEL RINCÓN,031,SAN ANTONIO DE LA PAZ,1,16,4,12,1
GUANAJUATO,11,SAN FRANCISCO DEL RINCÓN,031,SAN CRISTÓBAL (EL CERRITO),6,1439,754,685,53
GUANAJUATO,11,SAN FRANCISCO DEL RINCÓN,031,SAN FRANCISCO BUENAVISTA (EL CERRITO),2,81,40,41,5
GUANAJUATO,11,SAN FRANCISCO DEL RINCÓN,031,SAN FRANCISCO DEL RINCÓN,109,25031,13471,11560,1597
GUANAJUATO,11,SAN FRANCISCO DEL RINCÓN,031,SAN IGNACIO DE HIDALGO,6,644,311,333,26
GUANAJUATO,11,SAN FRANCISCO DEL RINCÓN,031,SAN ISIDRO DE LOS PALOMINOS,4,218,104,114,13
GUANAJUATO,11,SAN FRANCISCO DEL RINCÓN,031,SAN JOSÉ DE LA BARRANCA (EL RANCHITO),4,152,73,79,9
GUANAJUATO,11,SAN FRANCISCO DEL RINCÓN,031,SAN JOSÉ DE LA CALERA,2,106,53,53,5
GUANAJUATO,11,SAN FRANCISCO DEL RINCÓN,031,SAN RAFAEL,2,99,50,49,4
GUANAJUATO,11,SAN FRANCISCO DEL RINCÓN,031,SAN RAFAEL DE ESTALA,2,59,25,34,3
GUANAJUATO,11,SAN FRANCISCO DEL RINCÓN,031,SAN ROQUE DE MONTES,4,669,362,307,24
GUANAJUATO,11,SAN FRANCISCO DEL RINCÓN,031,SAN ROQUE DE TORRES,3,334,174,160,11
GUANAJUATO,11,SAN FRANCISCO DEL RINCÓN,031,SAUZ DE ARMENTA,4,382,198,184,17
GUANAJUATO,11,SAN FRANCISCO DEL RINCÓN,031,SILVA,3,257,121,136,11
GUANAJUATO,11,SAN FRANCISCO DEL RINCÓN,031,TECOLOTE,2,71,31,40,4
GUANAJUATO,11,SAN FRANCISCO DEL RINCÓN,031,TORTUGAS (LAS CONCHAS),3,238,120,118,11
GUANAJUATO,11,SAN FRANCISCO DEL RINCÓN,031,VISTA HERMOSA (EL TUZO),2,75,32,43,5
GUANAJUATO,11,SAN JOSÉ ITURBIDE,032,BUENAVISTILLA,3,712,350,362,36
GUANAJUATO,11,SAN JOSÉ ITURBIDE,032,CARBAJAL,3,95,42,53,5
GUANAJUATO,11,SAN JOSÉ ITURBIDE,032,CINCO DE MAYO,4,524,229,295,18
GUANAJUATO,11,SAN JOSÉ ITURBIDE,032,CRUZ DE LA MAZA,3,218,123,95,11
GUANAJUATO,11,SAN JOSÉ ITURBIDE,032,EL ARENAL DE ABAJO,1,27,15,12,1
GUANAJUATO,11,SAN JOSÉ ITURBIDE,032,EL ARENAL DE ARRIBA,3,94,41,53,5
GUANAJUATO,11,SAN JOSÉ ITURBIDE,032,EL CAPULÍN,8,1609,828,781,69
GUANAJUATO,11,SAN JOSÉ ITURBIDE,032,EL CARMEN,1,8,3,5,1
GUANAJUATO,11,SAN JOSÉ ITURBIDE,032,EL CERRITO DE GALOMO,2,503,224,279,17
GUANAJUATO,11,SAN JOSÉ ITURBIDE,032,EL CERRITO DEL ARENAL,4,327,152,175,17
GUANAJUATO,11,SAN JOSÉ ITURBIDE,032,EL COLORADO,1,11,5,6,1
GUANAJUATO,11,SAN JOSÉ ITURBIDE,032,EL GALOMO,4,523,249,274,18
GUANAJUATO,11,SAN JOSÉ ITURBIDE,032,EL GUAJOLOTE,2,190,86,104,8
GUANAJUATO,11,SAN JOSÉ ITURBIDE,032,EL HUIZACHAL,1,4,0,4,1
GUANAJUATO,11,SAN JOSÉ ITURBIDE,032,EL HUIZACHE DE GALOMO,2,76,33,43,4
GUANAJUATO,11,SAN JOSÉ ITURBIDE,032,EL JARALILLO,2,40,19,21,2
GUANAJUATO,11,SAN JOSÉ ITURBIDE,032,EL MAGUEYAL (LA ESQUINA),2,39,21,18,2
GUANAJUATO,11,SAN JOSÉ ITURBIDE,032,EL MASTRANTO,2,142,64,78,7
GUANAJUATO,11,SAN JOSÉ ITURBIDE,032,EL PATOLITO,4,386,208,178,15
GUANAJUATO,11,SAN JOSÉ ITURBIDE,032,EL PINITO,1,42,26,16,2
GUANAJUATO,11,SAN JOSÉ ITURBIDE,032,EL POZO BLANCO DE GALOMO,2,33,16,17,2
GUANAJUATO,11,SAN JOSÉ ITURBIDE,032,EL TEPETATE,1,21,9,12,1
GUANAJUATO,11,SAN JOSÉ ITURBIDE,032,EL ZAPOTE,4,276,131,145,14
GUANAJUATO,11,SAN JOSÉ ITURBIDE,032,EL ZORRILLO,1,14,3,11,1
GUANAJUATO,11,SAN JOSÉ ITURBIDE,032,ESPAÑITA,2,168,78,90,8
GUANAJUATO,11,SAN JOSÉ ITURBIDE,032,ESTANCIA DE SAN DIEGO,2,42,23,19,3
GUANAJUATO,11,SAN JOSÉ ITURBIDE,032,GUADALUPE (HACIENDA DE GUADALUPE),1,9,4,5,1
GUANAJUATO,11,SAN JOSÉ ITURBIDE,032,LA ALAMEDA,2,90,46,44,4
GUANAJUATO,11,SAN JOSÉ ITURBIDE,032,LA CANELA,2,61,25,36,4
GUANAJUATO,11,SAN JOSÉ ITURBIDE,032,LA CANTERA,2,61,28,33,4
GUANAJUATO,11,SAN JOSÉ ITURBIDE,032,LA CIÉNEGA,1,23,13,10,1
GUANAJUATO,11,SAN JOSÉ ITURBIDE,032,LA CINTA,2,149,70,79,8
GUANAJUATO,11,SAN JOSÉ ITURBIDE,032,LA CONCEPCIÓN DE ABAJO,3,305,146,159,12
GUANAJUATO,11,SAN JOSÉ ITURBIDE,032,LA ESCONDIDA,4,387,199,188,18
GUANAJUATO,11,SAN JOSÉ ITURBIDE,032,LA ESTANCIA DEL CAPULÍN,2,60,34,26,4
GUANAJUATO,11,SAN JOSÉ ITURBIDE,032,LA FRAGUA,4,348,180,168,14
GUANAJUATO,11,SAN JOSÉ ITURBIDE,032,LA HUERTA,2,215,109,106,8
GUANAJUATO,11,SAN JOSÉ ITURBIDE,032,LA PALMITA,1,25,16,9,2
GUANAJUATO,11,SAN JOSÉ ITURBIDE,032,LA PALMITA DEL CINCO DE MAYO,1,80,40,40,3
GUANAJUATO,11,SAN JOSÉ ITURBIDE,032,LA REFORMA,2,112,61,51,5
GUANAJUATO,11,SAN JOSÉ ITURBIDE,032,LA SOLEDAD DE ARRIBA,2,61,38,23,4
GUANAJUATO,11,SAN JOSÉ ITURBIDE,032,LA TORNA,2,47,26,21,3
GUANAJUATO,11,SAN JOSÉ ITURBIDE,032,LA VENTA,3,262,118,144,11
GUANAJUATO,11,SAN JOSÉ ITURBIDE,032,LA YERBABUENA,3,108,51,57,5
GUANAJUATO,11,SAN JOSÉ ITURBIDE,032,LAS ADJUNTAS,4,355,184,171,15
GUANAJUATO,11,SAN JOSÉ ITURBIDE,032,LAS MEDIAS,2,27,14,13,2
GUANAJUATO,11,SAN JOSÉ ITURBIDE,032,LAS TUZAS,4,264,137,127,11
GUANAJUATO,11,SAN JOSÉ ITURBIDE,032,LOS ENCINOS,2,55,27,28,3
GUANAJUATO,11,SAN JOSÉ ITURBIDE,032,LOS TERREROS,2,89,38,51,5
GUANAJUATO,11,SAN JOSÉ ITURBIDE,032,LOS VEGA DE ABAJO,1,63,26,37,3
GUANAJUATO,11,SAN JOSÉ ITURBIDE,032,LOS VEGA DE ARRIBA,2,93,44,49,4
GUANAJUATO,11,SAN JOSÉ ITURBIDE,032,MEDINA,4,326,160,166,13
GUANAJUATO,11,SAN JOSÉ ITURBIDE,032,MIRANDA,3,216,101,115,11
GUANAJUATO,11,SAN JOSÉ ITURBIDE,032,OJO DE AGUA DEL REFUGIO,4,412,203,209,16
GUANAJUATO,11,SAN JOSÉ ITURBIDE,032,OJO DE DIEGO,3,131,57,74,7
GUANAJUATO,11,SAN JOSÉ ITURBIDE,032,POZO BLANCO DEL CAPULÍN,2,57,26,31,4
GUANAJUATO,11,SAN JOSÉ ITURBIDE,032,PUEBLO NUEVO,2,100,55,45,5
GUANAJUATO,11,SAN JOSÉ ITURBIDE,032,PUERTO DE CARROZA,3,388,179,209,15
GUANAJUATO,11,SAN JOSÉ ITURBIDE,032,RANCHO LARGO (BARRIO DE ALDAMA),2,95,49,46,4
GUANAJUATO,11,SAN JOSÉ ITURBIDE,032,RINCÓN DE SANTA ANITA,2,64,34,30,4
GUANAJUATO,11,SAN JOSÉ ITURBIDE,032,SAN ANTONIO DEL LLANO,1,5,1,4,1
GUANAJUATO,11,SAN JOSÉ ITURBIDE,032,SAN ANTONIO VIBORILLAS,2,227,113,114,8
GUANAJUATO,11,SAN JOSÉ ITURBIDE,032,SAN DIEGO DE LAS TRASQUILAS,3,371,182,189,12
GUANAJUATO,11,SAN JOSÉ ITURBIDE,032,SAN ISIDRO,1,9,6,3,1
GUANAJUATO,11,SAN JOSÉ ITURBIDE,032,SAN JERÓNIMO,2,57,21,36,3
GUANAJUATO,11,SAN JOSÉ ITURBIDE,032,SAN JOSÉ ITURBIDE,50,12930,6725,6205,776
GUANAJUATO,11,SAN JOSÉ ITURBIDE,032,SAN RAFAEL DE LAS POMAS,1,15,2,13,1
GUANAJUATO,11,SAN JOSÉ ITURBIDE,032,SAN SEBASTIÁN DEL SALITRE,5,1019,525,494,37
GUANAJUATO,11,SAN JOSÉ ITURBIDE,032,SANTA ANITA,4,621,308,313,25
GUANAJUATO,11,SAN JOSÉ ITURBIDE,032,TEPOZANES,2,46,21,25,3
GUANAJUATO,11,SAN JOSÉ ITURBIDE,032,TULILLO DE ABAJO,3,243,119,124,9
GUANAJUATO,11,SAN JOSÉ ITURBIDE,032,TULILLO DE ARRIBA,4,515,287,228,24
GUANAJUATO,11,SAN JOSÉ ITURBIDE,032,VIBORILLAS,2,27,16,11,2
GUANAJUATO,11,SAN LUIS DE LA PAZ,033,BERLÍN,1,114,67,47,6
GUANAJUATO,11,SAN LUIS DE LA PAZ,033,BUENAVISTA (EL CUERNITO),2,135,63,72,9
GUANAJUATO,11,SAN LUIS DE LA PAZ,033,CERRO BLANCO,2,5,1,4,2
GUANAJUATO,11,SAN LUIS DE LA PAZ,033,COLONIA BENITO JUÁREZ,1,51,20,31,3
GUANAJUATO,11,SAN LUIS DE LA PAZ,033,COVADONGA,2,131,48,83,7
GUANAJUATO,11,SAN LUIS DE LA PAZ,033,DERRAMADERO SEGUNDO (INFIERNILLO),4,316,154,162,15
GUANAJUATO,11,SAN LUIS DE LA PAZ,033,DOLORES SAN JUAN,2,100,51,49,5
GUANAJUATO,11,SAN LUIS DE LA PAZ,033,EJIDO SANTA ANA Y LOBOS (FRACCIÓN DE LOURDES),5,853,443,410,30
GUANAJUATO,11,SAN LUIS DE LA PAZ,033,EL BOLUDO,1,11,4,7,1
GUANAJUATO,11,SAN LUIS DE LA PAZ,033,EL BOZO,2,24,10,14,2
GUANAJUATO,11,SAN LUIS DE LA PAZ,033,EL CHARCO,2,173,93,80,8
GUANAJUATO,11,SAN LUIS DE LA PAZ,033,EL CHUPADERO,4,112,59,53,9
GUANAJUATO,11,SAN LUIS DE LA PAZ,033,EL MEZOTE (ENTRONQUE DE CHARCAS),1,10,4,6,1
GUANAJUATO,11,SAN LUIS DE LA PAZ,033,EL PAREDÓN,1,10,8,2,1
GUANAJUATO,11,SAN LUIS DE LA PAZ,033,EL PRINGÓN,2,109,51,58,5
GUANAJUATO,11,SAN LUIS DE LA PAZ,033,EL REALITO (MINERAL EL REALITO),2,14,4,10,2
GUANAJUATO,11,SAN LUIS DE LA PAZ,033,EL REFUGIO (RANCHITO EL REFUGIO),2,38,22,16,2
GUANAJUATO,11,SAN LUIS DE LA PAZ,033,EL SAUZ TRES,2,179,92,87,8
GUANAJUATO,11,SAN LUIS DE LA PAZ,033,EL TOREADOR DE ABAJO,2,227,120,107,8
GUANAJUATO,11,SAN LUIS DE LA PAZ,033,EL VARAL (LA MERCED),4,344,173,171,13
GUANAJUATO,11,SAN LUIS DE LA PAZ,033,ESPINAS BLANCAS,2,64,37,27,3
GUANAJUATO,11,SAN LUIS DE LA PAZ,033,EX-HACIENDA DE ORTEGA (EJIDO ORTEGA),4,210,86,124,12
GUANAJUATO,11,SAN LUIS DE LA PAZ,033,EX-HACIENDA DE SANTA ANA (SANTA ANA Y LOBOS),1,218,94,124,8
GUANAJUATO,11,SAN LUIS DE LA PAZ,033,FRACCIONAMIENTO RESIDENCIAL VILLAS DE LA GLORIA,1,50,23,27,12
GUANAJUATO,11,SAN LUIS DE LA PAZ,033,GARIBALDI (EL CERRITO),2,28,13,15,2
GUANAJUATO,11,SAN LUIS DE LA PAZ,033,JOFRE (SAN JOSÉ DE JOFRE),1,8,0,8,1
GUANAJUATO,11,SAN LUIS DE LA PAZ,033,LA ANGELINA (LOS LIEBRILLOS),2,50,28,22,3
GUANAJUATO,11,SAN LUIS DE LA PAZ,033,LA CANTERA,2,92,44,48,5
GUANAJUATO,11,SAN LUIS DE LA PAZ,033,LA CAÑADA DEL PUEBLITO,1,8,4,4,1
GUANAJUATO,11,SAN LUIS DE LA PAZ,033,LA CIÉNEGA,3,417,212,205,19
GUANAJUATO,11,SAN LUIS DE LA PAZ,033,LA CIENEGUILLA DEL REFUGIO,2,55,22,33,4
GUANAJUATO,11,SAN LUIS DE LA PAZ,033,LA CONCEPCIÓN (LA CONCHA),1,8,5,3,1
GUANAJUATO,11,SAN LUIS DE LA PAZ,033,LA CRUZ,1,18,8,10,2
GUANAJUATO,11,SAN LUIS DE LA PAZ,033,LA CRUZ DE GUERRERO,4,194,99,95,10
GUANAJUATO,11,SAN LUIS DE LA PAZ,033,LA ESCOBILLA,2,42,21,21,3
GUANAJUATO,11,SAN LUIS DE LA PAZ,033,LA ESCONDIDA,1,6,4,2,1
GUANAJUATO,11,SAN LUIS DE LA PAZ,033,LA ESCONDIDITA,3,157,75,82,10
GUANAJUATO,11,SAN LUIS DE LA PAZ,033,LA ESQUINA (LA ESQUINA DE LA PURÍSIMA),4,221,125,96,10
GUANAJUATO,11,SAN LUIS DE LA PAZ,033,LA HUERTA,4,1991,1101,890,154
GUANAJUATO,11,SAN LUIS DE LA PAZ,033,LA JARRILLA,2,39,27,12,2
GUANAJUATO,11,SAN LUIS DE LA PAZ,033,LA LAGUNA SECA,2,165,79,86,8
GUANAJUATO,11,SAN LUIS DE LA PAZ,033,LA LEONA,2,62,36,26,3
GUANAJUATO,11,SAN LUIS DE LA PAZ,033,LA LUZ,2,32,16,16,2
GUANAJUATO,11,SAN LUIS DE LA PAZ,033,LA LUZ DE LA ESQUINA,4,408,199,209,17
GUANAJUATO,11,SAN LUIS DE LA PAZ,033,LA MESA DE JESÚS,4,95,48,47,8
GUANAJUATO,11,SAN LUIS DE LA PAZ,033,LA ONZA,2,14,9,5,2
GUANAJUATO,11,SAN LUIS DE LA PAZ,033,LA PEÑITA,1,49,23,26,3
GUANAJUATO,11,SAN LUIS DE LA PAZ,033,LA PROVIDENCIA (LA PROVIDENCIA DEL SALITRE),2,52,30,22,4
GUANAJUATO,11,SAN LUIS DE LA PAZ,033,LA QUINTA DOS,2,33,17,16,2
GUANAJUATO,11,SAN LUIS DE LA PAZ,033,LA SEMITA,4,112,54,58,8
GUANAJUATO,11,SAN LUIS DE LA PAZ,033,LA SOLEDAD,3,206,107,99,11
GUANAJUATO,11,SAN LUIS DE LA PAZ,033,LA SOLEDAD DEL MONTE,3,97,43,54,6
GUANAJUATO,11,SAN LUIS DE LA PAZ,033,LA TINAJA,2,88,41,47,4
GUANAJUATO,11,SAN LUIS DE LA PAZ,033,LA VACIADA,2,31,16,15,2
GUANAJUATO,11,SAN LUIS DE LA PAZ,033,LABOR DE GAMBOA,2,66,37,29,3
GUANAJUATO,11,SAN LUIS DE LA PAZ,033,LAS NEGRITAS,2,44,22,22,2
GUANAJUATO,11,SAN LUIS DE LA PAZ,033,LAS PALOMAS,1,6,3,3,1
GUANAJUATO,11,SAN LUIS DE LA PAZ,033,LOS ÁNGELES,4,371,208,163,15
GUANAJUATO,11,SAN LUIS DE LA PAZ,033,LOS DOLORES (LAS QUINCE LETRAS),6,1149,583,566,38
GUANAJUATO,11,SAN LUIS DE LA PAZ,033,LOS PLÁTANOS,2,41,22,19,3
GUANAJUATO,11,SAN LUIS DE LA PAZ,033,LOS REMEDIOS,2,52,25,27,3
GUANAJUATO,11,SAN LUIS DE LA PAZ,033,LOURDES (ESTACIÓN DE LOURDES),4,500,255,245,20
GUANAJUATO,11,SAN LUIS DE LA PAZ,033,MAGUEY BLANCO,2,175,89,86,7
GUANAJUATO,11,SAN LUIS DE LA PAZ,033,MANZANARES,2,57,26,31,3
GUANAJUATO,11,SAN LUIS DE LA PAZ,033,MARAVILLAL,2,257,129,128,9
GUANAJUATO,11,SAN LUIS DE LA PAZ,033,MATANCILLAS (PUERTO DE MATANCILLAS),2,59,31,28,4
GUANAJUATO,11,SAN LUIS DE LA PAZ,033,MESA DE ESCALANTE,2,26,13,13,2
GUANAJUATO,11,SAN LUIS DE LA PAZ,033,MESA DE LA ESTACADA,2,16,6,10,2
GUANAJUATO,11,SAN LUIS DE LA PAZ,033,MESA DE PALOTES (MESA DEL CARMEN),2,36,23,13,2
GUANAJUATO,11,SAN LUIS DE LA PAZ,033,MISIÓN DE CHICHIMECAS,9,2271,1193,1078,88
GUANAJUATO,11,SAN LUIS DE LA PAZ,033,NORITA DEL REFUGIO,3,129,59,70,7
GUANAJUATO,11,SAN LUIS DE LA PAZ,033,NUEVO PASO DE VAQUEROS,2,61,24,37,4
GUANAJUATO,11,SAN LUIS DE LA PAZ,033,PALMARITO,2,33,12,21,2
GUANAJUATO,11,SAN LUIS DE LA PAZ,033,PALMILLAS,1,6,0,6,1
GUANAJUATO,11,SAN LUIS DE LA PAZ,033,PALOS ALTOS,2,174,94,80,8
GUANAJUATO,11,SAN LUIS DE LA PAZ,033,PAREDES,2,96,43,53,5
GUANAJUATO,11,SAN LUIS DE LA PAZ,033,PASO COLORADO,2,50,24,26,2
GUANAJUATO,11,SAN LUIS DE LA PAZ,033,PIEDRAS DE LUMBRE,2,90,35,55,5
GUANAJUATO,11,SAN LUIS DE LA PAZ,033,POZO BLANCO,3,177,96,81,8
GUANAJUATO,11,SAN LUIS DE LA PAZ,033,POZO BLANCO (ESTACIÓN POZO BLANCO),3,185,99,86,9
GUANAJUATO,11,SAN LUIS DE LA PAZ,033,POZO HONDO (EX-HACIENDA DE POZO HONDO),3,232,124,108,11
GUANAJUATO,11,SAN LUIS DE LA PAZ,033,PROVIDENCIA DE LOS MOLINA,4,181,97,84,10
GUANAJUATO,11,SAN LUIS DE LA PAZ,033,PUERTO BLANCO DOS,3,352,192,160,13
GUANAJUATO,11,SAN LUIS DE LA PAZ,033,PUERTO DEL GATO,2,33,16,17,2
GUANAJUATO,11,SAN LUIS DE LA PAZ,033,PUERTO DEL VARAL,2,8,1,7,2
GUANAJUATO,11,SAN LUIS DE LA PAZ,033,PURÍSIMA DE CERRO GRANDE,2,70,36,34,4
GUANAJUATO,11,SAN LUIS DE LA PAZ,033,RANCHO DE GUADALUPE (CIUDAD DE LOS NIÑOS),2,29,17,12,2
GUANAJUATO,11,SAN LUIS DE LA PAZ,033,RANCHO NUEVO,2,60,26,34,3
GUANAJUATO,11,SAN LUIS DE LA PAZ,033,RANCHO NUEVO DE LAS TROJES,2,14,7,7,2
GUANAJUATO,11,SAN LUIS DE LA PAZ,033,SAN AGUSTÍN,2,93,44,49,5
GUANAJUATO,11,SAN LUIS DE LA PAZ,033,SAN AGUSTÍN SEGUNDO,1,10,7,3,1
GUANAJUATO,11,SAN LUIS DE LA PAZ,033,SAN ANTÓN DE LOS MARTÍNEZ,2,24,10,14,2
GUANAJUATO,11,SAN LUIS DE LA PAZ,033,SAN ANTONIO DE LAS VIEJAS,2,23,12,11,2
GUANAJUATO,11,SAN LUIS DE LA PAZ,033,SAN ANTONIO DE PADUA,1,12,7,5,1
GUANAJUATO,11,SAN LUIS DE LA PAZ,033,SAN ANTONIO PRIMERO,2,177,86,91,8
GUANAJUATO,11,SAN LUIS DE LA PAZ,033,SAN CAYETANO,2,163,89,74,6
GUANAJUATO,11,SAN LUIS DE LA PAZ,033,SAN ERNESTO,2,146,67,79,8
GUANAJUATO,11,SAN LUIS DE LA PAZ,033,SAN FRANCISCO UNO,2,22,7,15,2
GUANAJUATO,11,SAN LUIS DE LA PAZ,033,SAN IGNACIO,1,47,28,19,2
GUANAJUATO,11,SAN LUIS DE LA PAZ,033,SAN ISIDRO,4,436,222,214,17
GUANAJUATO,11,SAN LUIS DE LA PAZ,033,SAN JOSÉ DE VISTA HERMOSA,2,36,17,19,2
GUANAJUATO,11,SAN LUIS DE LA PAZ,033,SAN JOSÉ DEL CARMEN (EL CASCARERO),2,122,59,63,6
GUANAJUATO,11,SAN LUIS DE LA PAZ,033,SAN JUAN DE LA CRUZ,2,49,25,24,3
GUANAJUATO,11,SAN LUIS DE LA PAZ,033,SAN JUAN DE LOS RANGELES,2,41,18,23,2
GUANAJUATO,11,SAN LUIS DE LA PAZ,033,SAN JUAN PRIMERO,2,127,61,66,6
GUANAJUATO,11,SAN LUIS DE LA PAZ,033,SAN JUAN SEGUNDO,2,28,15,13,2
GUANAJUATO,11,SAN LUIS DE LA PAZ,033,SAN LUIS DE LA PAZ,76,16585,8612,7973,917
GUANAJUATO,11,SAN LUIS DE LA PAZ,033,SAN MARTÍN,2,80,39,41,5
GUANAJUATO,11,SAN LUIS DE LA PAZ,033,SAN NICOLÁS DEL CARMEN,6,946,455,491,45
GUANAJUATO,11,SAN LUIS DE LA PAZ,033,SAN PEDRO,2,40,20,20,3
GUANAJUATO,11,SAN LUIS DE LA PAZ,033,SAN PEDRO DE LA CRUZ,2,118,58,60,6
GUANAJUATO,11,SAN LUIS DE LA PAZ,033,SAN PEDRO DE LOS POZOS (MINERAL DE POZOS),6,882,411,471,51
GUANAJUATO,11,SAN LUIS DE LA PAZ,033,SAN PEDRO DEL DERRAMADERO (LOS PIRULES),1,16,11,5,1
GUANAJUATO,11,SAN LUIS DE LA PAZ,033,SAN RAFAEL,1,68,38,30,3
GUANAJUATO,11,SAN LUIS DE LA PAZ,033,SAN RAFAEL DE FÁTIMA,2,48,23,25,3
GUANAJUATO,11,SAN LUIS DE LA PAZ,033,SAN RAFAEL DE LA CURVA,1,27,12,15,1
GUANAJUATO,11,SAN LUIS DE LA PAZ,033,SANTA MARÍA DE GUADALUPE,1,11,5,6,1
GUANAJUATO,11,SAN LUIS DE LA PAZ,033,SANTA ROSA DE OCHOA,1,58,33,25,3
GUANAJUATO,11,SAN LUIS DE LA PAZ,033,SANTA TERESITA,2,50,25,25,3
GUANAJUATO,11,SAN LUIS DE LA PAZ,033,SANTIAGUILLO,1,5,1,4,1
GUANAJUATO,11,SAN LUIS DE LA PAZ,033,TERREROS DE LA CONCEPCIÓN,3,67,26,41,5
GUANAJUATO,11,SAN LUIS DE LA PAZ,033,TOREADOR DE ARRIBA,1,13,7,6,1
GUANAJUATO,11,SAN LUIS DE LA PAZ,033,TOREADOR DE EN MEDIO,3,337,151,186,14
GUANAJUATO,11,SAN LUIS DE LA PAZ,033,VALLE DE GUADALUPE,1,87,40,47,4
GUANAJUATO,11,SAN LUIS DE LA PAZ,033,VERGEL DE GUADALUPE,3,174,89,85,8
GUANAJUATO,11,SAN LUIS DE LA PAZ,033,VISTA HERMOSA,3,114,69,45,8
GUANAJUATO,11,SAN LUIS DE LA PAZ,033,XOCONOXTLE,1,16,9,7,1
GUANAJUATO,11,SAN LUIS DE LA PAZ,033,ZAMARRIPA (SAN JOSÉ DE ZAMARRIPA),2,39,18,21,2
GUANAJUATO,11,SANTA CATARINA,034,CORRAL FALSO,3,38,15,23,3
GUANAJUATO,11,SANTA CATARINA,034,CRUZ DE DIEGO,2,35,24,11,3
GUANAJUATO,11,SANTA CATARINA,034,EL AGUACATE,1,36,17,19,2
GUANAJUATO,11,SANTA CATARINA,034,EL CHAPÍN,1,9,4,5,1
GUANAJUATO,11,SANTA CATARINA,034,EL COPUDO,2,20,7,13,2
GUANAJUATO,11,SANTA CATARINA,034,EL NOGAL,2,31,22,9,2
GUANAJUATO,11,SANTA CATARINA,034,EL TABLÓN,2,65,29,36,2
GUANAJUATO,11,SANTA CATARINA,034,EL ZAPOTE DE CORRAL FALSO,2,17,6,11,2
GUANAJUATO,11,SANTA CATARINA,034,LA FAJA,1,7,3,4,1
GUANAJUATO,11,SANTA CATARINA,034,LA RUSIA,1,16,4,12,1
GUANAJUATO,11,SANTA CATARINA,034,LAS LIMITAS,2,136,63,73,7
GUANAJUATO,11,SANTA CATARINA,034,LOS JUAN DIEGOS,1,9,1,8,1
GUANAJUATO,11,SANTA CATARINA,034,ORTEGA,4,120,51,69,8
GUANAJUATO,11,SANTA CATARINA,034,PAREDES,4,131,66,65,8
GUANAJUATO,11,SANTA CATARINA,034,SANTA CATARINA,5,897,468,429,38
GUANAJUATO,11,SANTA CRUZ DE JUVENTINO ROSAS,035,AGUA ZARCA,3,22,14,8,3
GUANAJUATO,11,SANTA CRUZ DE JUVENTINO ROSAS,035,CASAS BLANCAS,2,14,7,7,2
GUANAJUATO,11,SANTA CRUZ DE JUVENTINO ROSAS,035,CERRITO DE GASCA,3,267,132,135,12
GUANAJUATO,11,SANTA CRUZ DE JUVENTINO ROSAS,035,EL CARMEN DE ARRIBA,2,30,10,20,2
GUANAJUATO,11,SANTA CRUZ DE JUVENTINO ROSAS,035,EL JAGÜEY,2,26,13,13,2
GUANAJUATO,11,SANTA CRUZ DE JUVENTINO ROSAS,035,EL MURCIÉLAGO,3,267,123,144,11
GUANAJUATO,11,SANTA CRUZ DE JUVENTINO ROSAS,035,EL NARANJILLO,5,546,280,266,25
GUANAJUATO,11,SANTA CRUZ DE JUVENTINO ROSAS,035,EL ROCILLITO,2,50,29,21,3
GUANAJUATO,11,SANTA CRUZ DE JUVENTINO ROSAS,035,EL ROSILLO,2,56,36,20,3
GUANAJUATO,11,SANTA CRUZ DE JUVENTINO ROSAS,035,EL ZÚÑIGA (LOS PINOS),2,5,4,1,2
GUANAJUATO,11,SANTA CRUZ DE JUVENTINO ROSAS,035,EMILIANO ZAPATA,3,167,71,96,9
GUANAJUATO,11,SANTA CRUZ DE JUVENTINO ROSAS,035,ENCINAL DE CANOAS,3,19,11,8,3
GUANAJUATO,11,SANTA CRUZ DE JUVENTINO ROSAS,035,FRANCO TAVERA,5,1188,646,542,40
GUANAJUATO,11,SANTA CRUZ DE JUVENTINO ROSAS,035,GALERA PRIETA,1,5,1,4,1
GUANAJUATO,11,SANTA CRUZ DE JUVENTINO ROSAS,035,INSURGENTES PÍPILA,3,20,13,7,3
GUANAJUATO,11,SANTA CRUZ DE JUVENTINO ROSAS,035,JARALILLO,3,315,174,141,12
GUANAJUATO,11,SANTA CRUZ DE JUVENTINO ROSAS,035,JUVENTINO ROSAS,40,11113,5608,5505,526
GUANAJUATO,11,SANTA CRUZ DE JUVENTINO ROSAS,035,LA ESPERANZA,2,145,77,68,7
GUANAJUATO,11,SANTA CRUZ DE JUVENTINO ROSAS,035,LA ESTANCIA,3,12,5,7,3
GUANAJUATO,11,SANTA CRUZ DE JUVENTINO ROSAS,035,LA HUERTA,3,220,106,114,10
GUANAJUATO,11,SANTA CRUZ DE JUVENTINO ROSAS,035,LA PEÑA (PEÑA COLORADA),1,13,8,5,1
GUANAJUATO,11,SANTA CRUZ DE JUVENTINO ROSAS,035,LA PURÍSIMA,2,51,20,31,3
GUANAJUATO,11,SANTA CRUZ DE JUVENTINO ROSAS,035,LA TINAJA,3,97,47,50,7
GUANAJUATO,11,SANTA CRUZ DE JUVENTINO ROSAS,035,LA TRINIDAD,3,186,98,88,10
GUANAJUATO,11,SANTA CRUZ DE JUVENTINO ROSAS,035,LAGUNA SECA DE SAN ISIDRO,2,50,30,20,3
GUANAJUATO,11,SANTA CRUZ DE JUVENTINO ROSAS,035,LAS FUENTES,2,88,39,49,4
GUANAJUATO,11,SANTA CRUZ DE JUVENTINO ROSAS,035,LAS PALOMAS,1,11,5,6,1
GUANAJUATO,11,SANTA CRUZ DE JUVENTINO ROSAS,035,LOS DULCES NOMBRES,3,490,251,239,20
GUANAJUATO,11,SANTA CRUZ DE JUVENTINO ROSAS,035,MANDUJANO,2,39,12,27,2
GUANAJUATO,11,SANTA CRUZ DE JUVENTINO ROSAS,035,MESAS DE ACOSTA,4,162,89,73,10
GUANAJUATO,11,SANTA CRUZ DE JUVENTINO ROSAS,035,MESAS DE ALMANZA,3,35,23,12,3
GUANAJUATO,11,SANTA CRUZ DE JUVENTINO ROSAS,035,OJO DE AGUA DE OTATES,2,68,30,38,4
GUANAJUATO,11,SANTA CRUZ DE JUVENTINO ROSAS,035,OJO DE AGUA DEL CARRIZAL,3,92,49,43,6
GUANAJUATO,11,SANTA CRUZ DE JUVENTINO ROSAS,035,POZOS,4,770,406,364,26
GUANAJUATO,11,SANTA CRUZ DE JUVENTINO ROSAS,035,RINCÓN DE CENTENO,4,676,339,337,26
GUANAJUATO,11,SANTA CRUZ DE JUVENTINO ROSAS,035,ROMERO,2,44,22,22,3
GUANAJUATO,11,SANTA CRUZ DE JUVENTINO ROSAS,035,SAN ANTONIO DE LAS MARAVILLAS,2,59,27,32,4
GUANAJUATO,11,SANTA CRUZ DE JUVENTINO ROSAS,035,SAN ANTONIO DE MORALES,4,467,231,236,24
GUANAJUATO,11,SANTA CRUZ DE JUVENTINO ROSAS,035,SAN ANTONIO DE ROMERILLO,3,225,104,121,11
GUANAJUATO,11,SANTA CRUZ DE JUVENTINO ROSAS,035,SAN ANTONIO NUEVO VALENCIA (LA CHIRIPA),2,39,12,27,2
GUANAJUATO,11,SANTA CRUZ DE JUVENTINO ROSAS,035,SAN DIEGO DE LOS DOLORES,3,242,118,124,11
GUANAJUATO,11,SANTA CRUZ DE JUVENTINO ROSAS,035,SAN JOSÉ DE LAS PILAS,4,334,179,155,16
GUANAJUATO,11,SANTA CRUZ DE JUVENTINO ROSAS,035,SAN JOSÉ DE LOS LLANOS,2,12,2,10,2
GUANAJUATO,11,SANTA CRUZ DE JUVENTINO ROSAS,035,SAN JOSÉ DE MANANTIALES,2,146,85,61,7
GUANAJUATO,11,SANTA CRUZ DE JUVENTINO ROSAS,035,SAN JOSÉ DE MERINO,1,13,9,4,1
GUANAJUATO,11,SANTA CRUZ DE JUVENTINO ROSAS,035,SAN JOSÉ DEL SAUZ,2,95,49,46,4
GUANAJUATO,11,SANTA CRUZ DE JUVENTINO ROSAS,035,SAN JUAN DE LA CRUZ,3,236,114,122,11
GUANAJUATO,11,SANTA CRUZ DE JUVENTINO ROSAS,035,SAN JUAN DE LA PROVEEDORA,1,7,3,4,1
GUANAJUATO,11,SANTA CRUZ DE JUVENTINO ROSAS,035,SAN JULIÁN TIERRA BLANCA,4,253,123,130,13
GUANAJUATO,11,SANTA CRUZ DE JUVENTINO ROSAS,035,SANTA ANA DE AGOSTADERO,1,13,11,2,1
GUANAJUATO,11,SANTA CRUZ DE JUVENTINO ROSAS,035,SANTA MARÍA DE GUADALUPE (EL RANCHITO),1,5,4,1,1
GUANAJUATO,11,SANTA CRUZ DE JUVENTINO ROSAS,035,SANTIAGO DE CUENDA,7,1950,998,952,76
GUANAJUATO,11,SANTA CRUZ DE JUVENTINO ROSAS,035,UNIDEG,1,189,98,91,5
GUANAJUATO,11,SANTA CRUZ DE JUVENTINO ROSAS,035,VALENCIA,3,1288,573,715,114
GUANAJUATO,11,SANTIAGO MARAVATÍO,036,EL DORMIDO,2,31,12,19,2
GUANAJUATO,11,SANTIAGO MARAVATÍO,036,HERMOSILLO,1,10,7,3,1
GUANAJUATO,11,SANTIAGO MARAVATÍO,036,LA JARA,1,8,4,4,1
GUANAJUATO,11,SANTIAGO MARAVATÍO,036,LA JOYITA DE PASTORES,2,25,10,15,2
GUANAJUATO,11,SANTIAGO MARAVATÍO,036,LA LEONA,2,66,26,40,3
GUANAJUATO,11,SANTIAGO MARAVATÍO,036,OJO DE AGUA DE LA YERBABUENA,4,102,52,50,6
GUANAJUATO,11,SANTIAGO MARAVATÍO,036,SANTA RITA DE CASIA,2,50,22,28,3
GUANAJUATO,11,SANTIAGO MARAVATÍO,036,SANTA TERESA (LA MAJADA),3,69,25,44,4
GUANAJUATO,11,SANTIAGO MARAVATÍO,036,SANTIAGO MARAVATÍO,5,763,350,413,46
GUANAJUATO,11,SILAO DE LA VICTORIA,037,AGUAS BUENAS,3,312,157,155,11
GUANAJUATO,11,SILAO DE LA VICTORIA,037,BAJÍO DE BONILLAS,4,1307,658,649,39
GUANAJUATO,11,SILAO DE LA VICTORIA,037,BAJÍO DE GUADALUPE (EL RASCADERO),1,16,8,8,1
GUANAJUATO,11,SILAO DE LA VICTORIA,037,BAÑOS DE AGUAS BUENAS,2,138,77,61,7
GUANAJUATO,11,SILAO DE LA VICTORIA,037,CAMINO REAL,1,12,4,8,1
GUANAJUATO,11,SILAO DE LA VICTORIA,037,CAÑADA DE DAMIÁN (LA HACIENDITA),1,10,3,7,1
GUANAJUATO,11,SILAO DE LA VICTORIA,037,CERRITOS,2,231,113,118,8
GUANAJUATO,11,SILAO DE LA VICTORIA,037,CHICHIMEQUILLAS,4,740,372,368,26
GUANAJUATO,11,SILAO DE LA VICTORIA,037,COECILLO,7,1286,654,632,41
GUANAJUATO,11,SILAO DE LA VICTORIA,037,COLONIA EMILIANO ZAPATA (EL CERRITO),2,283,145,138,10
GUANAJUATO,11,SILAO DE LA VICTORIA,037,COLONIA FRANCISCO JAVIER MINA,2,248,113,135,12
GUANAJUATO,11,SILAO DE LA VICTORIA,037,COLONIAS NUEVO MÉXICO,7,1525,739,786,50
GUANAJUATO,11,SILAO DE LA VICTORIA,037,COMANJILLA,5,1083,513,570,38
GUANAJUATO,11,SILAO DE LA VICTORIA,037,CONDADO LA PILA PRIMERA SECCIÓN,1,804,352,452,28
GUANAJUATO,11,SILAO DE LA VICTORIA,037,CUARTA PARTE,2,89,47,42,3
GUANAJUATO,11,SILAO DE LA VICTORIA,037,EJIDO EL PARAÍSO (EL COYOTE),2,95,46,49,5
GUANAJUATO,11,SILAO DE LA VICTORIA,037,EL CAPULÍN DE LA CUESTA,4,307,141,166,34
GUANAJUATO,11,SILAO DE LA VICTORIA,037,EL CERRITO,2,109,56,53,5
GUANAJUATO,11,SILAO DE LA VICTORIA,037,EL CUBILETE (LA MONTAÑA),1,11,5,6,1
GUANAJUATO,11,SILAO DE LA VICTORIA,037,EL ESPEJO,2,199,103,96,8
GUANAJUATO,11,SILAO DE LA VICTORIA,037,EL JITOMATAL,5,371,209,162,14
GUANAJUATO,11,SILAO DE LA VICTORIA,037,EL NUEVO REFUGIO,2,100,57,43,4
GUANAJUATO,11,SILAO DE LA VICTORIA,037,EL PARAÍSO,3,290,143,147,11
GUANAJUATO,11,SILAO DE LA VICTORIA,037,EL REFUGIO DE LA PILA,1,20,13,7,1
GUANAJUATO,11,SILAO DE LA VICTORIA,037,EL REFUGIO DE LOS SAUCES,3,691,348,343,24
GUANAJUATO,11,SILAO DE LA VICTORIA,037,EL SALITRILLO,5,443,207,236,18
GUANAJUATO,11,SILAO DE LA VICTORIA,037,ETA,3,940,438,502,72
GUANAJUATO,11,SILAO DE LA VICTORIA,037,EX-HACIENDA DE TREJO,4,634,314,320,22
GUANAJUATO,11,SILAO DE LA VICTORIA,037,EX-HACIENDA EL BOSQUE,2,95,40,55,4
GUANAJUATO,11,SILAO DE LA VICTORIA,037,FRANCO,3,516,241,275,15
GUANAJUATO,11,SILAO DE LA VICTORIA,037,GUADALUPE DE RAMALES (EL PESCUEZO),1,70,31,39,3
GUANAJUATO,11,SILAO DE LA VICTORIA,037,LA ALDEA,5,1684,842,842,51
GUANAJUATO,11,SILAO DE LA VICTORIA,037,LA ALDEÍTA (LA COTORRA),1,124,49,75,4
GUANAJUATO,11,SILAO DE LA VICTORIA,037,LA ASUNCIÓN (LAS FINCAS),2,47,25,22,2
GUANAJUATO,11,SILAO DE LA VICTORIA,037,LA CALAVERNA,2,122,61,61,5
GUANAJUATO,11,SILAO DE LA VICTORIA,037,LA ESPERANZA DEL REFUGIO,2,276,129,147,9
GUANAJUATO,11,SILAO DE LA VICTORIA,037,LA NORIA COLORADA,1,52,26,26,2
GUANAJUATO,11,SILAO DE LA VICTORIA,037,LA PROVIDENCIA UNO,1,18,9,9,2
GUANAJUATO,11,SILAO DE LA VICTORIA,037,LA YERBABUENA (CAÑADA DE AMÉZQUITA),2,338,169,169,15
GUANAJUATO,11,SILAO DE LA VICTORIA,037,LAS GRASAS,2,103,52,51,4
GUANAJUATO,11,SILAO DE LA VICTORIA,037,LAS TROJES (TROJAS),2,144,76,68,8
GUANAJUATO,11,SILAO DE LA VICTORIA,037,LOMA DE YERBABUENA,2,177,97,80,9
GUANAJUATO,11,SILAO DE LA VICTORIA,037,LOS ÁLAMOS,1,17,5,12,1
GUANAJUATO,11,SILAO DE LA VICTORIA,037,LOS CHARCOS,2,203,95,108,8
GUANAJUATO,11,SILAO DE LA VICTORIA,037,LOS JACINTOS,2,64,33,31,3
GUANAJUATO,11,SILAO DE LA VICTORIA,037,LOS RODRÍGUEZ,4,863,441,422,27
GUANAJUATO,11,SILAO DE LA VICTORIA,037,LOS ROSALES,1,13,6,7,1
GUANAJUATO,11,SILAO DE LA VICTORIA,037,LOZA DE BARRERA,4,490,257,233,15
GUANAJUATO,11,SILAO DE LA VICTORIA,037,LUCERO DE RAMALES,2,163,68,95,8
GUANAJUATO,11,SILAO DE LA VICTORIA,037,MANGAS DE LA ESTANCIA,3,81,45,36,4
GUANAJUATO,11,SILAO DE LA VICTORIA,037,MARAVILLAS DE LAS VICTORIAS,2,134,63,71,5
GUANAJUATO,11,SILAO DE LA VICTORIA,037,MEDIO SITIO,2,412,211,201,15
GUANAJUATO,11,SILAO DE LA VICTORIA,037,MEDRANOS,4,675,343,332,26
GUANAJUATO,11,SILAO DE LA VICTORIA,037,MENORES,4,533,272,261,19
GUANAJUATO,11,SILAO DE LA VICTORIA,037,MEZQUITE DE SOTELO (PLAN DE SOTELO),6,3080,1207,1873,181
GUANAJUATO,11,SILAO DE LA VICTORIA,037,MONTE DEL COECILLO,2,227,127,100,8
GUANAJUATO,11,SILAO DE LA VICTORIA,037,NÁPOLES,5,844,409,435,29
GUANAJUATO,11,SILAO DE LA VICTORIA,037,PABILEROS,2,179,86,93,7
GUANAJUATO,11,SILAO DE LA VICTORIA,037,PAXTLE,4,379,200,179,14
GUANAJUATO,11,SILAO DE LA VICTORIA,037,POZO DE GALLEGOS,3,72,33,39,4
GUANAJUATO,11,SILAO DE LA VICTORIA,037,PROVIDENCIA DE NÁPOLES,2,265,135,130,8
GUANAJUATO,11,SILAO DE LA VICTORIA,037,RANCHO SECO,2,103,54,49,5
GUANAJUATO,11,SILAO DE LA VICTORIA,037,REFUGIO DE OCAMPO,2,93,40,53,4
GUANAJUATO,11,SILAO DE LA VICTORIA,037,SAN AGUSTÍN DE LAS FLORES,4,397,210,187,17
GUANAJUATO,11,SILAO DE LA VICTORIA,037,SAN ANDRÉS DE LA BARAÑA,4,534,292,242,20
GUANAJUATO,11,SILAO DE LA VICTORIA,037,SAN ANTONIO TEXAS,4,785,403,382,29
GUANAJUATO,11,SILAO DE LA VICTORIA,037,SAN BARTOLO,1,28,14,14,1
GUANAJUATO,11,SILAO DE LA VICTORIA,037,SAN DIEGO EL GRANDE,3,540,259,281,24
GUANAJUATO,11,SILAO DE LA VICTORIA,037,SAN FRANCISCO (BAÑOS DE AGUA CALIENTE),3,404,191,213,15
GUANAJUATO,11,SILAO DE LA VICTORIA,037,SAN FRANCISCO PUERTA GRANDE,3,304,171,133,11
GUANAJUATO,11,SILAO DE LA VICTORIA,037,SAN IGNACIO,2,131,60,71,4
GUANAJUATO,11,SILAO DE LA VICTORIA,037,SAN JOSÉ DE GRACIA,5,865,446,419,31
GUANAJUATO,11,SILAO DE LA VICTORIA,037,SAN JOSÉ DE LAS CRUCES (LAS PULGAS),2,69,30,39,3
GUANAJUATO,11,SILAO DE LA VICTORIA,037,SAN JOSÉ DE RIVERA,2,101,36,65,4
GUANAJUATO,11,SILAO DE LA VICTORIA,037,SAN JUAN DE LOS DURÁN,4,1777,850,927,122
GUANAJUATO,11,SILAO DE LA VICTORIA,037,SAN MARCOS,3,155,73,82,8
GUANAJUATO,11,SILAO DE LA VICTORIA,037,SAN RAMÓN DE GALLEGOS,3,260,136,124,9
GUANAJUATO,11,SILAO DE LA VICTORIA,037,SANTA ANITA,2,85,39,46,4
GUANAJUATO,11,SILAO DE LA VICTORIA,037,SANTA FE DE GUADALUPE,1,25,8,17,1
GUANAJUATO,11,SILAO DE LA VICTORIA,037,SEGUNDA FRACCIÓN DE BUSTAMANTE,1,22,10,12,6
GUANAJUATO,11,SILAO DE LA VICTORIA,037,SILAO DE LA VICTORIA,110,26121,13404,12717,1439
GUANAJUATO,11,SILAO DE LA VICTORIA,037,SOLEDAD DE REYNOSO,2,111,53,58,5
GUANAJUATO,11,SILAO DE LA VICTORIA,037,SOTELO (LAS PLAYAS DE SOTELO),1,39,19,20,2
GUANAJUATO,11,SILAO DE LA VICTORIA,037,TUNA MANSA,2,159,72,87,7
GUANAJUATO,11,SILAO DE LA VICTORIA,037,UNIÓN DE SAN DIEGO (SAN DIEGUILLO),3,183,84,99,9
GUANAJUATO,11,SILAO DE LA VICTORIA,037,UNIÓN DE TRES MEZQUITES (EL GUAJOLOTE),2,73,36,37,3
GUANAJUATO,11,SILAO DE LA VICTORIA,037,VALLEJOS,2,58,25,33,3
GUANAJUATO,11,SILAO DE LA VICTORIA,037,VELARDE,2,117,54,63,4
GUANAJUATO,11,SILAO DE LA VICTORIA,037,VETA DE RAMALES,2,97,49,48,3
GUANAJUATO,11,SILAO DE LA VICTORIA,037,VILLAS DE GUADALUPE,2,212,98,114,8
GUANAJUATO,11,TARANDACUAO,038,BARRIO DE SANTIAGO,2,90,38,52,5
GUANAJUATO,11,TARANDACUAO,038,BUENAVISTA,2,106,52,54,6
GUANAJUATO,11,TARANDACUAO,038,CERRITO BLANCO,3,68,35,33,4
GUANAJUATO,11,TARANDACUAO,038,EL GUAYABO (EL ALACRÁN),2,27,11,16,2
GUANAJUATO,11,TARANDACUAO,038,EL TOCUZ (SAN RAFAEL),2,75,43,32,4
GUANAJUATO,11,TARANDACUAO,038,LA MORA,3,44,23,21,3
GUANAJUATO,11,TARANDACUAO,038,LA PARADA (LA LOMA DEL ENCINAL),3,60,25,35,4
GUANAJUATO,11,TARANDACUAO,038,LA PURÍSIMA,2,62,26,36,4
GUANAJUATO,11,TARANDACUAO,038,LA SOLEDAD,1,9,4,5,1
GUANAJUATO,11,TARANDACUAO,038,LA VIRGEN,3,66,38,28,4
GUANAJUATO,11,TARANDACUAO,038,PASO DE OVEJAS (EL PUENTE),2,15,7,8,2
GUANAJUATO,11,TARANDACUAO,038,SAN ANTONIO,4,103,50,53,8
GUANAJUATO,11,TARANDACUAO,038,SAN FELIPE,2,59,27,32,4
GUANAJUATO,11,TARANDACUAO,038,SAN JOAQUÍN DE PORTO (LA POSTA),2,23,14,9,2
GUANAJUATO,11,TARANDACUAO,038,SAN JOSÉ DE PORTO (SAN JOSÉ DE HIDALGO),3,86,43,43,5
GUANAJUATO,11,TARANDACUAO,038,SAN JUAN DE DIOS,1,24,12,12,1
GUANAJUATO,11,TARANDACUAO,038,TARANDACUAO,9,2001,988,1013,100
GUANAJUATO,11,TARIMORO,039,BUENAVISTA,2,54,27,27,3
GUANAJUATO,11,TARIMORO,039,CAÑADA DE TIRADOS DE ABAJO,1,10,3,7,1
GUANAJUATO,11,TARIMORO,039,CAÑADA DE TIRADOS DE ARRIBA,2,60,33,27,3
GUANAJUATO,11,TARIMORO,039,CERRO PRIETO,3,138,58,80,7
GUANAJUATO,11,TARIMORO,039,CHARCO LARGO,3,416,215,201,30
GUANAJUATO,11,TARIMORO,039,CUADRILLA DE CACALOTE (LA CUADRILLA),2,73,36,37,4
GUANAJUATO,11,TARIMORO,039,EL ACEBUCHE,4,454,238,216,17
GUANAJUATO,11,TARIMORO,039,EL ROJO (EL COLORADO),1,194,110,84,12
GUANAJUATO,11,TARIMORO,039,EL TERRERO,2,22,14,8,2
GUANAJUATO,11,TARIMORO,039,EL TORO,2,30,19,11,2
GUANAJUATO,11,TARIMORO,039,GALERA DE PANALES,3,267,121,146,13
GUANAJUATO,11,TARIMORO,039,GUADALUPE,2,5,2,3,1
GUANAJUATO,11,TARIMORO,039,HUAPANGO,4,196,97,99,10
GUANAJUATO,11,TARIMORO,039,LA BÓVEDA,1,7,6,1,1
GUANAJUATO,11,TARIMORO,039,LA CUESTA,2,32,19,13,2
GUANAJUATO,11,TARIMORO,039,LA ESPERANZA,2,89,43,46,4
GUANAJUATO,11,TARIMORO,039,LA MONCADA,6,570,292,278,27
GUANAJUATO,11,TARIMORO,039,LA NOPALERA,2,33,21,12,2
GUANAJUATO,11,TARIMORO,039,LA NORIA DE GALLEGOS,3,307,143,164,11
GUANAJUATO,11,TARIMORO,039,LLANO GRANDE,3,35,20,15,3
GUANAJUATO,11,TARIMORO,039,LOS FIERROS,4,328,165,163,14
GUANAJUATO,11,TARIMORO,039,MINILLAS,3,80,43,37,5
GUANAJUATO,11,TARIMORO,039,NORIA DE SAN ISIDRO (PROVIDENCIA DE LA NORIA),1,40,12,28,2
GUANAJUATO,11,TARIMORO,039,OJO DE AGUA DE NIETO,2,21,10,11,2
GUANAJUATO,11,TARIMORO,039,PANALES JAMAICA (CAÑONES),4,407,194,213,20
GUANAJUATO,11,TARIMORO,039,SAN JUAN BAUTISTA CACALOTE,4,426,222,204,19
GUANAJUATO,11,TARIMORO,039,SAN NICOLÁS DE LA CONDESA,3,211,99,112,11
GUANAJUATO,11,TARIMORO,039,TARIMORO,16,3062,1572,1490,184
GUANAJUATO,11,TARIMORO,039,TLALIXCOYA,3,15,7,8,3
GUANAJUATO,11,TIERRA BLANCA,040,ARROYO SECO,2,31,14,17,2
GUANAJUATO,11,TIERRA BLANCA,040,CANO DE SAN ISIDRO,4,345,170,175,23
GUANAJUATO,11,TIERRA BLANCA,040,CAÑADA DE JUANICA,1,14,7,7,1
GUANAJUATO,11,TIERRA BLANCA,040,CERRO BLANCO,3,18,7,11,3
GUANAJUATO,11,TIERRA BLANCA,040,CERRO COLORADO,3,224,112,112,11
GUANAJUATO,11,TIERRA BLANCA,040,CIENEGUILLA,3,1061,542,519,43
GUANAJUATO,11,TIERRA BLANCA,040,DON BLAS,1,8,5,3,1
GUANAJUATO,11,TIERRA BLANCA,040,EL APARTADERO,3,78,32,46,7
GUANAJUATO,11,TIERRA BLANCA,040,EL HARTÓN,2,13,6,7,2
GUANAJUATO,11,TIERRA BLANCA,040,EL MEZQUITE,1,9,4,5,1
GUANAJUATO,11,TIERRA BLANCA,040,EL PANALITO,2,25,9,16,2
GUANAJUATO,11,TIERRA BLANCA,040,EL PICACHO,2,145,78,67,7
GUANAJUATO,11,TIERRA BLANCA,040,EL SALTO,2,71,28,43,3
GUANAJUATO,11,TIERRA BLANCA,040,EL SAUZ,4,131,60,71,9
GUANAJUATO,11,TIERRA BLANCA,040,EL TEPETATE,1,13,7,6,1
GUANAJUATO,11,TIERRA BLANCA,040,EL VARAL,3,32,13,19,3
GUANAJUATO,11,TIERRA BLANCA,040,FRACCIÓN DE GUADALUPE,2,135,59,76,7
GUANAJUATO,11,TIERRA BLANCA,040,FRACCIÓN DEL CANO,2,106,53,53,4
GUANAJUATO,11,TIERRA BLANCA,040,GUADALUPE,1,17,3,14,1
GUANAJUATO,11,TIERRA BLANCA,040,LA BARBOSA,2,30,16,14,2
GUANAJUATO,11,TIERRA BLANCA,040,LA CHAMACUERA,2,21,11,10,2
GUANAJUATO,11,TIERRA BLANCA,040,LA CUESTA DE PEÑONES,4,352,179,173,13
GUANAJUATO,11,TIERRA BLANCA,040,LA ESTANCIA,1,8,3,5,1
GUANAJUATO,11,TIERRA BLANCA,040,LA MESITA (LA GRANA),1,10,4,6,1
GUANAJUATO,11,TIERRA BLANCA,040,LA TINAJA,2,19,9,10,2
GUANAJUATO,11,TIERRA BLANCA,040,LAS ADJUNTAS,2,32,15,17,2
GUANAJUATO,11,TIERRA BLANCA,040,LAS MORAS,2,101,53,48,5
GUANAJUATO,11,TIERRA BLANCA,040,MONTE PRIETO,2,73,33,40,4
GUANAJUATO,11,TIERRA BLANCA,040,OCOTILLOS,2,6,2,4,2
GUANAJUATO,11,TIERRA BLANCA,040,PEÑA BLANCA DOS,2,73,38,35,3
GUANAJUATO,11,TIERRA BLANCA,040,PEÑA BLANCA UNO,2,52,21,31,3
GUANAJUATO,11,TIERRA BLANCA,040,RINCÓN DEL CANO,4,388,205,183,14
GUANAJUATO,11,TIERRA BLANCA,040,TEMASCALES,1,4,1,3,1
GUANAJUATO,11,TIERRA BLANCA,040,TIERRA BLANCA,8,1759,893,866,93
GUANAJUATO,11,TIERRA BLANCA,040,TORRECITAS,2,89,46,43,4
GUANAJUATO,11,TIERRA BLANCA,040,VILLA UNIÓN,2,35,21,14,2
GUANAJUATO,11,TIERRA BLANCA,040,XOCONOXTLE,1,6,3,3,1
GUANAJUATO,11,URIANGATO,041,COLONIA JUÁREZ,3,1831,682,1149,77
GUANAJUATO,11,URIANGATO,041,EL AGUACATE,2,51,22,29,3
GUANAJUATO,11,URIANGATO,041,EL CERRO,2,32,18,14,2
GUANAJUATO,11,URIANGATO,041,EL CHARCO,5,132,64,68,8
GUANAJUATO,11,URIANGATO,041,EL COMAL,2,17,7,10,2
GUANAJUATO,11,URIANGATO,041,EL DERRAMADERO,4,223,100,123,13
GUANAJUATO,11,URIANGATO,041,LA CINTA,2,53,25,28,2
GUANAJUATO,11,URIANGATO,041,LA JOYITA,3,344,177,167,31
GUANAJUATO,11,URIANGATO,041,LA PRESA (PRESA DE HUAHUEMBA),4,203,98,105,11
GUANAJUATO,11,URIANGATO,041,LAGUNILLA DEL ENCINAL,3,43,24,19,3
GUANAJUATO,11,URIANGATO,041,LAGUNILLA DEL RICO,3,60,30,30,4
GUANAJUATO,11,URIANGATO,041,LOS PORTALITOS,2,64,34,30,3
GUANAJUATO,11,URIANGATO,041,LOS RODRÍGUEZ,2,36,16,20,2
GUANAJUATO,11,URIANGATO,041,RANCHO NUEVO DE CUPUATO,2,40,20,20,2
GUANAJUATO,11,URIANGATO,041,SAN JOSÉ CUARACURIO,4,302,146,156,14
GUANAJUATO,11,URIANGATO,041,URIANGATO,55,9176,4620,4556,515
GUANAJUATO,11,VALLE DE SANTIAGO,042,ALTO DE ALTAMIRA,2,63,31,32,4
GUANAJUATO,11,VALLE DE SANTIAGO,042,AMPLIACIÓN LAS ESTACAS (FUERTE APACHE),2,68,33,35,4
GUANAJUATO,11,VALLE DE SANTIAGO,042,BELLA VISTA DE SANTA MARÍA,2,163,93,70,8
GUANAJUATO,11,VALLE DE SANTIAGO,042,BOTIJA,3,69,44,25,4
GUANAJUATO,11,VALLE DE SANTIAGO,042,BUENAVISTA DE PARANGUEO,2,65,25,40,4
GUANAJUATO,11,VALLE DE SANTIAGO,042,CAHUAGEO,2,60,23,37,4
GUANAJUATO,11,VALLE DE SANTIAGO,042,CARMELITAS CHICO,2,30,13,17,2
GUANAJUATO,11,VALLE DE SANTIAGO,042,CERRITOS,2,27,15,12,2
GUANAJUATO,11,VALLE DE SANTIAGO,042,CERRO BLANCO,2,76,32,44,4
GUANAJUATO,11,VALLE DE SANTIAGO,042,CERRO COLORADO,2,99,50,49,5
GUANAJUATO,11,VALLE DE SANTIAGO,042,CERRO PRIETO DEL CARMEN,4,179,89,90,11
GUANAJUATO,11,VALLE DE SANTIAGO,042,CHANGUEO,3,46,31,15,3
GUANAJUATO,11,VALLE DE SANTIAGO,042,CHARCO DE PANTOJA,3,332,151,181,22
GUANAJUATO,11,VALLE DE SANTIAGO,042,CHICAMITO,3,87,41,46,6
GUANAJUATO,11,VALLE DE SANTIAGO,042,COALANDA,1,21,11,10,1
GUANAJUATO,11,VALLE DE SANTIAGO,042,COLONIA BENITO JUÁREZ,2,102,55,47,5
GUANAJUATO,11,VALLE DE SANTIAGO,042,COLONIA DE GUADALUPE (GUADALUPE DE COPALES),2,36,18,18,2
GUANAJUATO,11,VALLE DE SANTIAGO,042,COLONIA EL CALVARIO,1,8,4,4,1
GUANAJUATO,11,VALLE DE SANTIAGO,042,COPALES,4,260,120,140,13
GUANAJUATO,11,VALLE DE SANTIAGO,042,CRUCITAS,2,109,52,57,6
GUANAJUATO,11,VALLE DE SANTIAGO,042,CUADRILLA DE ANDARACUA,2,61,26,35,3
GUANAJUATO,11,VALLE DE SANTIAGO,042,DOTACIÓN HOYA DE ÁLVAREZ (LA TORTUGA),1,7,4,3,1
GUANAJUATO,11,VALLE DE SANTIAGO,042,DURANES DE ABAJO,2,18,10,8,2
GUANAJUATO,11,VALLE DE SANTIAGO,042,DURANES DE ARRIBA,3,213,95,118,11
GUANAJUATO,11,VALLE DE SANTIAGO,042,EL ARMADILLO,3,103,50,53,6
GUANAJUATO,11,VALLE DE SANTIAGO,042,EL BORREGO,3,127,62,65,7
GUANAJUATO,11,VALLE DE SANTIAGO,042,EL CICUITO,2,36,19,17,2
GUANAJUATO,11,VALLE DE SANTIAGO,042,EL MOTIVO (EL CARRIZAL),2,24,9,15,2
GUANAJUATO,11,VALLE DE SANTIAGO,042,EL PERICO,4,341,166,175,15
GUANAJUATO,11,VALLE DE SANTIAGO,042,EL PITAHAYO,4,320,160,160,14
GUANAJUATO,11,VALLE DE SANTIAGO,042,EL SALITRE DE AGUILARES,4,164,82,82,11
GUANAJUATO,11,VALLE DE SANTIAGO,042,EL TAMBOR,4,196,95,101,10
GUANAJUATO,11,VALLE DE SANTIAGO,042,GERVASIO MENDOZA,4,167,77,90,10
GUANAJUATO,11,VALLE DE SANTIAGO,042,GUARAPO,3,217,121,96,11
GUANAJUATO,11,VALLE DE SANTIAGO,042,HOYA DE ÁLVAREZ,3,26,12,14,4
GUANAJUATO,11,VALLE DE SANTIAGO,042,HOYA DE CINTORA (LA HOYA DE ABAJO),1,42,13,29,3
GUANAJUATO,11,VALLE DE SANTIAGO,042,HOYA DE CINTORA (LA HOYA DE ARRIBA),2,276,142,134,11
GUANAJUATO,11,VALLE DE SANTIAGO,042,HOYA DE ESTRADA,1,3,2,1,1
GUANAJUATO,11,VALLE DE SANTIAGO,042,JAHUIQUES (RANCHO NUEVO DE GUADALUPE),2,38,23,15,3
GUANAJUATO,11,VALLE DE SANTIAGO,042,LA BARQUILLA,2,23,13,10,2
GUANAJUATO,11,VALLE DE SANTIAGO,042,LA COMPAÑÍA,4,414,206,208,18
GUANAJUATO,11,VALLE DE SANTIAGO,042,LA ENMARAÑADA,2,89,42,47,5
GUANAJUATO,11,VALLE DE SANTIAGO,042,LA ISLA,3,152,75,77,8
GUANAJUATO,11,VALLE DE SANTIAGO,042,LA JAULILLA,2,29,15,14,2
GUANAJUATO,11,VALLE DE SANTIAGO,042,LA TEJONERA,1,5,3,2,1
GUANAJUATO,11,VALLE DE SANTIAGO,042,LAGUNILLA DE MOGOTES,3,145,80,65,7
GUANAJUATO,11,VALLE DE SANTIAGO,042,LAS CAÑAS,3,174,97,77,10
GUANAJUATO,11,VALLE DE SANTIAGO,042,LAS DELICIAS,1,4,1,3,1
GUANAJUATO,11,VALLE DE SANTIAGO,042,LAS JÍCAMAS,5,240,112,128,15
GUANAJUATO,11,VALLE DE SANTIAGO,042,LAS LIEBRES,2,53,25,28,4
GUANAJUATO,11,VALLE DE SANTIAGO,042,LAS RAÍCES,4,221,106,115,11
GUANAJUATO,11,VALLE DE SANTIAGO,042,LOMA TENDIDA,3,210,105,105,11
GUANAJUATO,11,VALLE DE SANTIAGO,042,LOS MARTÍNEZ,4,191,101,90,11
GUANAJUATO,11,VALLE DE SANTIAGO,042,LOS PATIOS,2,43,18,25,3
GUANAJUATO,11,VALLE DE SANTIAGO,042,MAGDALENA DE ARACEO,5,357,170,187,14
GUANAJUATO,11,VALLE DE SANTIAGO,042,MANGA DE BUENAVISTA,2,43,24,19,3
GUANAJUATO,11,VALLE DE SANTIAGO,042,MESA DE SAN AGUSTÍN,2,37,16,21,2
GUANAJUATO,11,VALLE DE SANTIAGO,042,MOGOTES DE SAN JOSÉ PARANGUEO,5,398,192,206,21
GUANAJUATO,11,VALLE DE SANTIAGO,042,MONTE VALERIO [RANCHO],1,264,122,142,16
GUANAJUATO,11,VALLE DE SANTIAGO,042,NORIA DE MOSQUEDA,4,428,233,195,16
GUANAJUATO,11,VALLE DE SANTIAGO,042,PASO BLANCO,2,36,15,21,3
GUANAJUATO,11,VALLE DE SANTIAGO,042,PEGUEROS,2,45,23,22,2
GUANAJUATO,11,VALLE DE SANTIAGO,042,PLAZA VIEJA,2,70,33,37,4
GUANAJUATO,11,VALLE DE SANTIAGO,042,POZO DE ARÓSTEGUI (LAS CORREAS),2,79,38,41,4
GUANAJUATO,11,VALLE DE SANTIAGO,042,POZO DE PARANGUEO,2,69,34,35,4
GUANAJUATO,11,VALLE DE SANTIAGO,042,PRESA DE SAN ANDRÉS,3,169,82,87,10
GUANAJUATO,11,VALLE DE SANTIAGO,042,PUERTA DE ANDARACUA,3,49,21,28,5
GUANAJUATO,11,VALLE DE SANTIAGO,042,PUERTA DE SAN ROQUE,2,64,26,38,4
GUANAJUATO,11,VALLE DE SANTIAGO,042,PUERTO DE ARACEO,2,25,13,12,2
GUANAJUATO,11,VALLE DE SANTIAGO,042,QUIRICEO,3,207,102,105,11
GUANAJUATO,11,VALLE DE SANTIAGO,042,RANCHITO DE PAREDONES,1,5,3,2,1
GUANAJUATO,11,VALLE DE SANTIAGO,042,RANCHO CUATRO DE ALTAMIRA,1,69,28,41,4
GUANAJUATO,11,VALLE DE SANTIAGO,042,RANCHO DE GUADALUPE (LA NALGA DE VENTURA),2,34,15,19,3
GUANAJUATO,11,VALLE DE SANTIAGO,042,RANCHO DE GUANTES,2,34,19,15,3
GUANAJUATO,11,VALLE DE SANTIAGO,042,RANCHO DE LOS SOSAS,3,34,21,13,4
GUANAJUATO,11,VALLE DE SANTIAGO,042,RANCHO NUEVO DE LA ISLA,1,15,12,3,2
GUANAJUATO,11,VALLE DE SANTIAGO,042,RANCHO NUEVO DE SAN ANDRÉS,2,83,43,40,5
GUANAJUATO,11,VALLE DE SANTIAGO,042,RANCHO SECO DE GUANTES,3,178,95,83,10
GUANAJUATO,11,VALLE DE SANTIAGO,042,RANCHO VIEJO DE TORRES,2,94,38,56,4
GUANAJUATO,11,VALLE DE SANTIAGO,042,RANCHOS UNIDOS,3,141,78,63,7
GUANAJUATO,11,VALLE DE SANTIAGO,042,RINCÓN DE ALONSO SÁNCHEZ,3,144,66,78,6
GUANAJUATO,11,VALLE DE SANTIAGO,042,RINCÓN DE PARANGUEO,5,559,264,295,25
GUANAJUATO,11,VALLE DE SANTIAGO,042,SABINO DE SANTA ROSA,4,312,151,161,15
GUANAJUATO,11,VALLE DE SANTIAGO,042,SAN ANTONIO DE MOGOTES,3,314,152,162,15
GUANAJUATO,11,VALLE DE SANTIAGO,042,SAN ANTONIO DE PANTOJA,2,27,14,13,3
GUANAJUATO,11,VALLE DE SANTIAGO,042,SAN ANTONIO DE TERÁN,2,41,19,22,3
GUANAJUATO,11,VALLE DE SANTIAGO,042,SAN CRISTÓBAL,4,223,113,110,14
GUANAJUATO,11,VALLE DE SANTIAGO,042,SAN DIEGO QUIRICEO,4,197,101,96,12
GUANAJUATO,11,VALLE DE SANTIAGO,042,SAN FELIPE QUIRICEO,2,173,75,98,8
GUANAJUATO,11,VALLE DE SANTIAGO,042,SAN FRANCISCO CHIHUINDO,2,40,17,23,2
GUANAJUATO,11,VALLE DE SANTIAGO,042,SAN FRANCISCO JAVIER (RANCHO GRANDE),2,23,12,11,2
GUANAJUATO,11,VALLE DE SANTIAGO,042,SAN GUILLERMO,3,97,44,53,5
GUANAJUATO,11,VALLE DE SANTIAGO,042,SAN IGNACIO DE SAN JOSÉ PARANGUEO,1,149,86,63,5
GUANAJUATO,11,VALLE DE SANTIAGO,042,SAN ISIDRO DE MOGOTES,2,157,81,76,8
GUANAJUATO,11,VALLE DE SANTIAGO,042,SAN JERÓNIMO DE ARACEO,5,494,239,255,20
GUANAJUATO,11,VALLE DE SANTIAGO,042,SAN JOAQUÍN,2,63,32,31,4
GUANAJUATO,11,VALLE DE SANTIAGO,042,SAN JOSÉ DE ARACEO,2,31,19,12,2
GUANAJUATO,11,VALLE DE SANTIAGO,042,SAN JOSÉ DE LA MONTAÑA (LOS GATOS),2,43,21,22,3
GUANAJUATO,11,VALLE DE SANTIAGO,042,SAN JOSÉ DE PANTOJA,2,72,28,44,4
GUANAJUATO,11,VALLE DE SANTIAGO,042,SAN JOSÉ DEL BRAZO (LA CORREA),2,51,25,26,4
GUANAJUATO,11,VALLE DE SANTIAGO,042,SAN NICOLÁS PARANGUEO,3,507,266,241,22
GUANAJUATO,11,VALLE DE SANTIAGO,042,SAN NICOLÁS QUIRICEO,2,81,46,35,4
GUANAJUATO,11,VALLE DE SANTIAGO,042,SAN RAMÓN DE LOS PATIOS,2,15,4,11,2
GUANAJUATO,11,VALLE DE SANTIAGO,042,SAN VICENTE DE GARMA (GARMA),4,302,140,162,13
GUANAJUATO,11,VALLE DE SANTIAGO,042,SANABRIA,2,64,31,33,4
GUANAJUATO,11,VALLE DE SANTIAGO,042,SANTA ANA,4,209,110,99,13
GUANAJUATO,11,VALLE DE SANTIAGO,042,SANTA BÁRBARA,1,102,54,48,3
GUANAJUATO,11,VALLE DE SANTIAGO,042,SANTA ROSA (SANTA ROSA DE PARANGUEO),2,53,27,26,3
GUANAJUATO,11,VALLE DE SANTIAGO,042,SAUZ DE PURÍSIMA,2,29,12,17,2
GUANAJUATO,11,VALLE DE SANTIAGO,042,TERÁN,2,94,53,41,5
GUANAJUATO,11,VALLE DE SANTIAGO,042,TINAJA DE GARCÍA,2,42,17,25,3
GUANAJUATO,11,VALLE DE SANTIAGO,042,VALLE DE SANTIAGO,74,18920,9519,9401,1303
GUANAJUATO,11,VALLE DE SANTIAGO,042,ZAPOTE DE SAN VICENTE,3,241,130,111,11
GUANAJUATO,11,VALLE DE SANTIAGO,042,ZAPOTILLO DE MOGOTES,4,481,270,211,24
GUANAJUATO,11,VICTORIA,043,AGUA FRÍA,3,25,9,16,3
GUANAJUATO,11,VICTORIA,043,ÁLAMOS DE MARTÍNEZ,4,72,33,39,6
GUANAJUATO,11,VICTORIA,043,BUENAVISTA DE GUADALUPE,1,14,11,3,1
GUANAJUATO,11,VICTORIA,043,CAÑADA DE HIGUERAS,2,48,20,28,3
GUANAJUATO,11,VICTORIA,043,CAÑADA DE MORENO,2,84,36,48,4
GUANAJUATO,11,VICTORIA,043,CAPILLA BLANCA,1,12,6,6,1
GUANAJUATO,11,VICTORIA,043,CERRITO COLORADO,4,118,62,56,9
GUANAJUATO,11,VICTORIA,043,CIENEGUILLA,4,822,439,383,35
GUANAJUATO,11,VICTORIA,043,CORRAL DE PIEDRA,2,57,26,31,3
GUANAJUATO,11,VICTORIA,043,CORRALILLOS,2,81,38,43,4
GUANAJUATO,11,VICTORIA,043,DERRAMADEROS,4,119,52,67,9
GUANAJUATO,11,VICTORIA,043,EL CARMEN,2,135,69,66,8
GUANAJUATO,11,VICTORIA,043,EL OBISPO (SAN MARTÍN DEL OBISPO),1,4,4,0,1
GUANAJUATO,11,VICTORIA,043,EL OJO DE AGUA,3,51,27,24,4
GUANAJUATO,11,VICTORIA,043,EL PITAHAYO,2,26,11,15,2
GUANAJUATO,11,VICTORIA,043,EL QUELITE,1,16,4,12,1
GUANAJUATO,11,VICTORIA,043,EL REFUGIO,2,54,24,30,4
GUANAJUATO,11,VICTORIA,043,EL SAUZ DE ARRIBA,1,6,3,3,1
GUANAJUATO,11,VICTORIA,043,EL TEPEHUAJE,2,17,12,5,2
GUANAJUATO,11,VICTORIA,043,EL TEPETATE,2,32,19,13,2
GUANAJUATO,11,VICTORIA,043,LA CALERA,2,27,15,12,2
GUANAJUATO,11,VICTORIA,043,LA ESPERANZA,2,53,27,26,3
GUANAJUATO,11,VICTORIA,043,LA ESTANCIA,2,65,28,37,4
GUANAJUATO,11,VICTORIA,043,LA JOYA FRÍA,1,13,8,5,1
GUANAJUATO,11,VICTORIA,043,LA LAGUNITA,1,5,3,2,1
GUANAJUATO,11,VICTORIA,043,LA LUZ,2,38,24,14,2
GUANAJUATO,11,VICTORIA,043,LA SIMONA,2,54,27,27,4
GUANAJUATO,11,VICTORIA,043,LAS CHIVAS,2,35,12,23,3
GUANAJUATO,11,VICTORIA,043,LAS HELADAS,2,38,17,21,2
GUANAJUATO,11,VICTORIA,043,LAS NARANJAS,3,44,17,27,3
GUANAJUATO,11,VICTORIA,043,LOMA DE LOS CHILITOS,3,117,55,62,7
GUANAJUATO,11,VICTORIA,043,LOS LINDEROS,2,119,53,66,6
GUANAJUATO,11,VICTORIA,043,LOS REMEDIOS (CERRO GRANDE),3,252,117,135,12
GUANAJUATO,11,VICTORIA,043,MALINTO,4,159,82,77,10
GUANAJUATO,11,VICTORIA,043,MESA DE LA CANTERA,2,47,19,28,3
GUANAJUATO,11,VICTORIA,043,MESITA DEL TIGRE,2,53,22,31,3
GUANAJUATO,11,VICTORIA,043,MILPILLAS DE SANTIAGO,4,435,234,201,17
GUANAJUATO,11,VICTORIA,043,MILPILLAS DEL PITO,2,35,17,18,2
GUANAJUATO,11,VICTORIA,043,MISIÓN DE ARNEDO,4,403,202,201,18
GUANAJUATO,11,VICTORIA,043,NEGRITAS,1,3,1,2,1
GUANAJUATO,11,VICTORIA,043,PALMILLAS,2,141,70,71,7
GUANAJUATO,11,VICTORIA,043,PANALES,2,124,65,59,6
GUANAJUATO,11,VICTORIA,043,PASO HONDO,1,27,10,17,12
GUANAJUATO,11,VICTORIA,043,PUERTO DE LA TAPONA,2,95,49,46,6
GUANAJUATO,11,VICTORIA,043,PUERTO DE PALMAS,4,127,70,57,8
GUANAJUATO,11,VICTORIA,043,RANCHO VIEJO (ESPÍRITU SANTO),3,53,27,26,3
GUANAJUATO,11,VICTORIA,043,ROMERILLOS,2,13,11,2,2
GUANAJUATO,11,VICTORIA,043,SALITRERA,1,17,7,10,1
GUANAJUATO,11,VICTORIA,043,SAN AGUSTÍN,2,25,13,12,2
GUANAJUATO,11,VICTORIA,043,SAN JERÓNIMO (EL LLANITO),2,58,32,26,3
GUANAJUATO,11,VICTORIA,043,SAN SALVADOR DE AHORCADOS,2,23,8,15,2
GUANAJUATO,11,VICTORIA,043,SOMBRERETE,2,51,25,26,3
GUANAJUATO,11,VICTORIA,043,TASAJILLO,2,73,33,40,5
GUANAJUATO,11,VICTORIA,043,VICTORIA,6,1083,564,519,49
GUANAJUATO,11,VICTORIA,043,XACALÁZUCHITL,2,24,14,10,2
GUANAJUATO,11,VILLAGRÁN,044,CERRITO DE LAS YERBAS,2,37,19,18,2
GUANAJUATO,11,VILLAGRÁN,044,COLONIA 18 DE MARZO,6,462,235,227,21
GUANAJUATO,11,VILLAGRÁN,044,EL CARACOL,3,199,100,99,11
GUANAJUATO,11,VILLAGRÁN,044,EL CHINACO (EL PUJIDO),4,415,198,217,19
GUANAJUATO,11,VILLAGRÁN,044,EL PARRAL,2,41,16,25,2
GUANAJUATO,11,VILLAGRÁN,044,FRACCIONAMIENTO REHILETE,3,827,404,423,38
GUANAJUATO,11,VILLAGRÁN,044,LOS ÁNGELES,4,360,175,185,15
GUANAJUATO,11,VILLAGRÁN,044,MEXICANOS,5,1273,653,620,45
GUANAJUATO,11,VILLAGRÁN,044,SAN ISIDRO CERRO GORDO,2,26,14,12,2
GUANAJUATO,11,VILLAGRÁN,044,SAN PEDRO TOLENTINO,2,26,17,9,2
GUANAJUATO,11,VILLAGRÁN,044,SAN SALVADOR TORRECILLAS,4,391,180,211,14
GUANAJUATO,11,VILLAGRÁN,044,SANTA ROSA,4,597,302,295,23
GUANAJUATO,11,VILLAGRÁN,044,SARABIA,8,1497,747,750,72
GUANAJUATO,11,VILLAGRÁN,044,SUCHITLÁN,3,308,156,152,13
GUANAJUATO,11,VILLAGRÁN,044,VILLAGRÁN,30,8655,4280,4375,354
GUANAJUATO,11,VILLAGRÁN,044,XONOTLI [PARQUE AGROTECNOLÓGICO],1,260,117,143,15
GUANAJUATO,11,XICHÚ,045,ADJUNTAS,2,22,11,11,2
GUANAJUATO,11,XICHÚ,045,AGUA ZARCA DE ROMERILLOS,2,23,11,12,2
GUANAJUATO,11,XICHÚ,045,AGUA ZARCA DEL PINAL,3,39,18,21,3
GUANAJUATO,11,XICHÚ,045,AURORA,1,6,4,2,1
GUANAJUATO,11,XICHÚ,045,BELTRÁN,1,18,6,12,1
GUANAJUATO,11,XICHÚ,045,BERNAL,1,5,3,2,1
GUANAJUATO,11,XICHÚ,045,BUENAVISTA (EL SALVIAR DE BUENAVISTA),4,73,41,32,5
GUANAJUATO,11,XICHÚ,045,BUENAVISTA (PUERTO DE BUENAVISTA),2,17,12,5,2
GUANAJUATO,11,XICHÚ,045,CALABAZAS,3,26,14,12,3
GUANAJUATO,11,XICHÚ,045,CRISTO REY,1,13,7,6,1
GUANAJUATO,11,XICHÚ,045,EL AGUACATE,4,131,77,54,9
GUANAJUATO,11,XICHÚ,045,EL CHARCO DE LUCAS,2,19,10,9,2
GUANAJUATO,11,XICHÚ,045,EL CONTADERO,2,17,8,9,2
GUANAJUATO,11,XICHÚ,045,EL GUAMÚCHIL,4,260,126,134,12
GUANAJUATO,11,XICHÚ,045,EL MEMBRILLO,3,53,31,22,4
GUANAJUATO,11,XICHÚ,045,EL OCOTERO,1,38,17,21,3
GUANAJUATO,11,XICHÚ,045,EL PINALITO DE PALOMAS,1,14,7,7,1
GUANAJUATO,11,XICHÚ,045,EL REVOLCADERO,2,20,10,10,2
GUANAJUATO,11,XICHÚ,045,EL ROBLAR,1,6,1,5,1
GUANAJUATO,11,XICHÚ,045,EL RUCIO,3,40,18,22,3
GUANAJUATO,11,XICHÚ,045,EL TANQUE,2,13,4,9,2
GUANAJUATO,11,XICHÚ,045,EL ZAMORANO,2,9,4,5,2
GUANAJUATO,11,XICHÚ,045,ENRAMADAS (CERRO DEL ÁGUILA),1,17,6,11,1
GUANAJUATO,11,XICHÚ,045,GUADALUPE,3,35,12,23,3
GUANAJUATO,11,XICHÚ,045,LA CIENEGUITA,1,11,7,4,1
GUANAJUATO,11,XICHÚ,045,LA HIGUERITA,2,27,10,17,2
GUANAJUATO,11,XICHÚ,045,LA LAJA,3,83,45,38,5
GUANAJUATO,11,XICHÚ,045,LA PILA,1,3,1,2,1
GUANAJUATO,11,XICHÚ,045,LA SALITRERA,2,23,11,12,2
GUANAJUATO,11,XICHÚ,045,LA ZÁBILA,4,138,72,66,9
GUANAJUATO,11,XICHÚ,045,LABORCILLA,2,25,13,12,2
GUANAJUATO,11,XICHÚ,045,LLANETES,2,30,20,10,2
GUANAJUATO,11,XICHÚ,045,LLANO GRANDE,1,5,1,4,1
GUANAJUATO,11,XICHÚ,045,LOS PABLOS (LOS PABLOS DE ARRIBA),2,18,9,9,2
GUANAJUATO,11,XICHÚ,045,LOS TANQUES,2,7,5,2,2
GUANAJUATO,11,XICHÚ,045,MAJADA ALTA,3,27,15,12,3
GUANAJUATO,11,XICHÚ,045,MESA DE CHALOC,3,41,16,25,3
GUANAJUATO,11,XICHÚ,045,MESA DE SAN DIEGO,2,9,4,5,2
GUANAJUATO,11,XICHÚ,045,MISIÓN DE SANTA ROSA,1,4,2,2,1
GUANAJUATO,11,XICHÚ,045,NORIA DEL MALTRATO,2,12,5,7,2
GUANAJUATO,11,XICHÚ,045,OJO DE AGUA,3,21,12,9,3
GUANAJUATO,11,XICHÚ,045,ORGANITOS,3,54,27,27,4
GUANAJUATO,11,XICHÚ,045,PALOMAS,3,72,35,37,5
GUANAJUATO,11,XICHÚ,045,PASO DE GUILLERMO (SAGRADO CORAZÓN),3,64,32,32,5
GUANAJUATO,11,XICHÚ,045,PIE DE LA CUESTA,2,45,23,22,3
GUANAJUATO,11,XICHÚ,045,PIEDRAS PINTADAS,2,37,21,16,3
GUANAJUATO,11,XICHÚ,045,PINALITO DE LA GLORIA,2,25,17,8,2
GUANAJUATO,11,XICHÚ,045,POTRERILLOS (EL SALTO),2,13,8,5,2
GUANAJUATO,11,XICHÚ,045,PUERTO DE MILAGRO,2,49,25,24,3
GUANAJUATO,11,XICHÚ,045,PUERTO DE TABLAS,2,29,10,19,2
GUANAJUATO,11,XICHÚ,045,PUERTO DEL OCOTE (EL CONFITE),3,43,32,11,4
GUANAJUATO,11,XICHÚ,045,ROMERILLOS,2,18,10,8,2
GUANAJUATO,11,XICHÚ,045,ROSA DE CASTILLA,2,37,20,17,2
GUANAJUATO,11,XICHÚ,045,SAN DIEGO DE LAS PITAHAYAS,3,53,27,26,4
GUANAJUATO,11,XICHÚ,045,SAN MIGUEL DE LAS CASITAS,4,203,111,92,12
GUANAJUATO,11,XICHÚ,045,XICHÚ,4,660,332,328,33
GUANAJUATO,11,YURIRIA,046,AGUA FRÍA,2,20,9,11,2
GUANAJUATO,11,YURIRIA,046,ARAGÓN,2,63,22,41,4
GUANAJUATO,11,YURIRIA,046,BUENAVISTA (BUENA VISTA DE CERANO),1,21,14,7,1
GUANAJUATO,11,YURIRIA,046,BUENAVISTA DE LA LIBERTAD,1,19,8,11,1
GUANAJUATO,11,YURIRIA,046,CERANO (SAN JUAN CERANO),10,1494,760,734,68
GUANAJUATO,11,YURIRIA,046,CERÉCUARO,4,199,105,94,11
GUANAJUATO,11,YURIRIA,046,COLONIA DEL ARMADILLO,2,25,12,13,2
GUANAJUATO,11,YURIRIA,046,COLONIA SAN ANTONIO,2,21,12,9,3
GUANAJUATO,11,YURIRIA,046,CORRALES,1,19,8,11,1
GUANAJUATO,11,YURIRIA,046,CUERUNERO,1,6,1,5,1
GUANAJUATO,11,YURIRIA,046,EL BOSQUE,3,60,31,29,3
GUANAJUATO,11,YURIRIA,046,EL CANARIO,2,187,93,94,8
GUANAJUATO,11,YURIRIA,046,EL CIMENTAL (HACIENDA DEL CIMENTAL),2,39,25,14,2
GUANAJUATO,11,YURIRIA,046,EL GRANJENAL,1,15,9,6,1
GUANAJUATO,11,YURIRIA,046,EL MORAL,4,308,155,153,16
GUANAJUATO,11,YURIRIA,046,EL MORALITO,2,54,24,30,3
GUANAJUATO,11,YURIRIA,046,EL MORO,2,37,16,21,3
GUANAJUATO,11,YURIRIA,046,EL SALTEADOR,3,142,66,76,8
GUANAJUATO,11,YURIRIA,046,EL TIGRE,3,146,64,82,9
GUANAJUATO,11,YURIRIA,046,EL TIMBINAL,4,109,52,57,6
GUANAJUATO,11,YURIRIA,046,EL VELADOR,3,23,8,15,3
GUANAJUATO,11,YURIRIA,046,JUAN LUCAS,4,157,85,72,12
GUANAJUATO,11,YURIRIA,046,LA ANGOSTURA,4,364,192,172,15
GUANAJUATO,11,YURIRIA,046,LA CABAÑA DE LOS TEPAMEZ,1,4,1,3,1
GUANAJUATO,11,YURIRIA,046,LA CALERA,4,344,178,166,17
GUANAJUATO,11,YURIRIA,046,LA FAJA,1,29,14,15,1
GUANAJUATO,11,YURIRIA,046,LA PUNTA (MONTECILLO Y PUNTA),2,15,9,6,2
GUANAJUATO,11,YURIRIA,046,LA PURÍSIMA,1,9,4,5,1
GUANAJUATO,11,YURIRIA,046,LA SOLEDAD DE CUERUNERO,1,7,2,5,1
GUANAJUATO,11,YURIRIA,046,LA TINAJA DEL COYOTE,2,32,9,23,2
GUANAJUATO,11,YURIRIA,046,LAGUNA PRIETA,4,238,115,123,13
GUANAJUATO,11,YURIRIA,046,LAS MESAS,1,5,2,3,1
GUANAJUATO,11,YURIRIA,046,LAS ROSAS (LA MINA),2,8,2,6,1
GUANAJUATO,11,YURIRIA,046,LOMA DE ZEMPOALA,4,450,227,223,18
GUANAJUATO,11,YURIRIA,046,LOS TEPETATES,2,69,36,33,4
GUANAJUATO,11,YURIRIA,046,MONTE DE LOS JUÁREZ,3,78,39,39,4
GUANAJUATO,11,YURIRIA,046,OCHOMITAS,3,100,51,49,4
GUANAJUATO,11,YURIRIA,046,OCURIO,1,5,2,3,1
GUANAJUATO,11,YURIRIA,046,OJOS DE AGUA DE CERANO,2,68,22,46,4
GUANAJUATO,11,YURIRIA,046,OJOS DE AGUA DE CÓRDOBA,1,34,11,23,1
GUANAJUATO,11,YURIRIA,046,ORÚCUARO,3,15,4,11,3
GUANAJUATO,11,YURIRIA,046,PALO ALTO,2,33,10,23,2
GUANAJUATO,11,YURIRIA,046,PARANGARICO,4,1084,558,526,77
GUANAJUATO,11,YURIRIA,046,PORULLO,4,153,72,81,10
GUANAJUATO,11,YURIRIA,046,PROVIDENCIA DE CALERA,2,119,68,51,6
GUANAJUATO,11,YURIRIA,046,PROVIDENCIA DE CUERUNERO,4,104,52,52,8
GUANAJUATO,11,YURIRIA,046,PUERTA DE CERANO,2,25,14,11,2
GUANAJUATO,11,YURIRIA,046,PUERTO DEL ÁGUILA,3,53,36,17,4
GUANAJUATO,11,YURIRIA,046,PUQUICHAPIO,2,47,25,22,3
GUANAJUATO,11,YURIRIA,046,RANCHO VIEJO DE PASTORES,2,30,19,11,2
GUANAJUATO,11,YURIRIA,046,SAN ANDRÉS CALERA,2,153,73,80,8
GUANAJUATO,11,YURIRIA,046,SAN ANDRÉS ENGUARO,4,302,151,151,14
GUANAJUATO,11,YURIRIA,046,SAN FELIPE,2,41,22,19,2
GUANAJUATO,11,YURIRIA,046,SAN FRANCISCO DE LA CRUZ,4,390,208,182,15
GUANAJUATO,11,YURIRIA,046,SAN ISIDRO CALERA,1,15,6,9,1
GUANAJUATO,11,YURIRIA,046,SAN JOSÉ DE GRACIA,1,13,6,7,1
GUANAJUATO,11,YURIRIA,046,SAN JOSÉ OTONGUITIRO,2,53,29,24,4
GUANAJUATO,11,YURIRIA,046,SAN MIGUEL EL ALTO (SAN MIGUELITO),3,140,77,63,9
GUANAJUATO,11,YURIRIA,046,SAN NICOLÁS CUERUNERO,1,41,14,27,2
GUANAJUATO,11,YURIRIA,046,SAN PABLO CASACUARÁN,3,305,153,152,24
GUANAJUATO,11,YURIRIA,046,SAN VICENTE ZAPOTE,2,104,57,47,5
GUANAJUATO,11,YURIRIA,046,SANTA MÓNICA OZUMBILLA,4,290,139,151,15
GUANAJUATO,11,YURIRIA,046,TEJOCOTE DE CALERA,4,492,276,216,18
GUANAJUATO,11,YURIRIA,046,TEJOCOTE DE PASTORES,1,6,0,6,1
GUANAJUATO,11,YURIRIA,046,TIERRA BLANCA,2,18,9,9,2
GUANAJUATO,11,YURIRIA,046,TINAJA DE PASTORES,2,95,42,53,5
GUANAJUATO,11,YURIRIA,046,XOCONOXTLE,4,229,118,111,11
GUANAJUATO,11,YURIRIA,046,YURIRIA,37,5698,2890,2808,392
GUANAJUATO,11,YURIRIA,046,ZAPOTITOS,2,18,10,8,2
GUERRERO,12,ACAPULCO DE JUÁREZ,001,10 DE ABRIL,2,158,80,78,10
GUERRERO,12,ACAPULCO DE JUÁREZ,001,ACAPULCO DE JUÁREZ,974,158377,80775,77602,10441
GUERRERO,12,ACAPULCO DE JUÁREZ,001,AGUA DEL PERRO,3,50,26,24,5
GUERRERO,12,ACAPULCO DE JUÁREZ,001,AGUA ZARCA DE LA PEÑA,4,170,87,83,10
GUERRERO,12,ACAPULCO DE JUÁREZ,001,AGUAS CALIENTES,4,833,407,426,35
GUERRERO,12,ACAPULCO DE JUÁREZ,001,ALTO DEL CAMARÓN,4,170,81,89,19
GUERRERO,12,ACAPULCO DE JUÁREZ,001,AMATEPEC,4,202,95,107,12
GUERRERO,12,ACAPULCO DE JUÁREZ,001,AMATILLO,5,1055,530,525,46
GUERRERO,12,ACAPULCO DE JUÁREZ,001,APALANI,3,395,191,204,19
GUERRERO,12,ACAPULCO DE JUÁREZ,001,APANHUAC (APANGUAQUE),3,205,101,104,12
GUERRERO,12,ACAPULCO DE JUÁREZ,001,ARROYO VERDE,1,4,2,2,1
GUERRERO,12,ACAPULCO DE JUÁREZ,001,BARRA VIEJA,2,266,130,136,9
GUERRERO,12,ACAPULCO DE JUÁREZ,001,BARRIO NUEVO DE LOS MUERTOS,3,332,177,155,17
GUERRERO,12,ACAPULCO DE JUÁREZ,001,BELLA VISTA PAPAGAYO,3,160,83,77,11
GUERRERO,12,ACAPULCO DE JUÁREZ,001,CACAHUATEPEC,4,302,149,153,17
GUERRERO,12,ACAPULCO DE JUÁREZ,001,CAMPANARIO,3,388,192,196,20
GUERRERO,12,ACAPULCO DE JUÁREZ,001,CARABALÍ,3,113,52,61,9
GUERRERO,12,ACAPULCO DE JUÁREZ,001,CERRO DE PIEDRA,4,409,179,230,20
GUERRERO,12,ACAPULCO DE JUÁREZ,001,COLONIA ALBORADA,1,121,64,57,6
GUERRERO,12,ACAPULCO DE JUÁREZ,001,COLONIA GUERRERO (LOS GUAJES),4,204,100,104,15
GUERRERO,12,ACAPULCO DE JUÁREZ,001,COLONIA LOMA LARGA (EL BASURERO),2,45,19,26,4
GUERRERO,12,ACAPULCO DE JUÁREZ,001,COLONIA MANGOS (EL QUEMADO),2,457,217,240,24
GUERRERO,12,ACAPULCO DE JUÁREZ,001,COLONIA NUEVA LUZ,2,33,16,17,5
GUERRERO,12,ACAPULCO DE JUÁREZ,001,COLONIA NUEVA REVOLUCIÓN,1,84,39,45,4
GUERRERO,12,ACAPULCO DE JUÁREZ,001,COLONIA SAN ISIDRO DEL PROGRESO,2,22,8,14,2
GUERRERO,12,ACAPULCO DE JUÁREZ,001,COLONIA SEIS DE AGOSTO,3,56,31,25,4
GUERRERO,12,ACAPULCO DE JUÁREZ,001,DOS ARROYOS,4,352,169,183,22
GUERRERO,12,ACAPULCO DE JUÁREZ,001,EJIDO NUEVO,4,528,255,273,30
GUERRERO,12,ACAPULCO DE JUÁREZ,001,EL ARENAL,3,371,174,197,18
GUERRERO,12,ACAPULCO DE JUÁREZ,001,EL BEJUCO,6,615,291,324,56
GUERRERO,12,ACAPULCO DE JUÁREZ,001,EL CANTÓN,2,176,95,81,10
GUERRERO,12,ACAPULCO DE JUÁREZ,001,EL CARRIZO,2,32,20,12,3
GUERRERO,12,ACAPULCO DE JUÁREZ,001,EL CERRITO (COLONIA EL CERRITO),2,16,9,7,2
GUERRERO,12,ACAPULCO DE JUÁREZ,001,EL METLAPIL,3,324,164,160,18
GUERRERO,12,ACAPULCO DE JUÁREZ,001,EL PELILLO,3,63,33,30,5
GUERRERO,12,ACAPULCO DE JUÁREZ,001,EL PROGRESO DE CACAHUATEPEC,2,71,30,41,5
GUERRERO,12,ACAPULCO DE JUÁREZ,001,EL RANCHITO,2,88,40,48,5
GUERRERO,12,ACAPULCO DE JUÁREZ,001,EL RINCÓN,2,81,36,45,5
GUERRERO,12,ACAPULCO DE JUÁREZ,001,EL SALTO,3,288,126,162,15
GUERRERO,12,ACAPULCO DE JUÁREZ,001,EL VELADERO (VELADERO MORELOS),3,198,108,90,10
GUERRERO,12,ACAPULCO DE JUÁREZ,001,EL ZAPOTE,2,40,21,19,3
GUERRERO,12,ACAPULCO DE JUÁREZ,001,ESPINALILLO,2,45,13,32,2
GUERRERO,12,ACAPULCO DE JUÁREZ,001,GARRAPATAS,3,94,35,59,6
GUERRERO,12,ACAPULCO DE JUÁREZ,001,HUAJINTEPEC,2,55,24,31,5
GUERRERO,12,ACAPULCO DE JUÁREZ,001,HUAMUCHITOS,3,475,256,219,22
GUERRERO,12,ACAPULCO DE JUÁREZ,001,KILÓMETRO 21,2,212,111,101,13
GUERRERO,12,ACAPULCO DE JUÁREZ,001,KILÓMETRO 22,2,62,30,32,4
GUERRERO,12,ACAPULCO DE JUÁREZ,001,KILÓMETRO 30,12,1608,780,828,116
GUERRERO,12,ACAPULCO DE JUÁREZ,001,KILÓMETRO 34,2,22,13,9,3
GUERRERO,12,ACAPULCO DE JUÁREZ,001,KILÓMETRO 39,2,139,59,80,9
GUERRERO,12,ACAPULCO DE JUÁREZ,001,KILÓMETRO 40,3,234,115,119,17
GUERRERO,12,ACAPULCO DE JUÁREZ,001,KILÓMETRO 42 (JUAN N. ÁLVAREZ),2,104,52,52,9
GUERRERO,12,ACAPULCO DE JUÁREZ,001,KILÓMETRO 45,3,162,93,69,12
GUERRERO,12,ACAPULCO DE JUÁREZ,001,KILÓMETRO TREINTA Y DOS (COLONIA LA UNIÓN),2,14,8,6,2
GUERRERO,12,ACAPULCO DE JUÁREZ,001,KILÓMETRO TREINTA Y TRES,2,11,4,7,2
GUERRERO,12,ACAPULCO DE JUÁREZ,001,LA ARENA,3,45,27,18,3
GUERRERO,12,ACAPULCO DE JUÁREZ,001,LA CALERA,3,74,37,37,6
GUERRERO,12,ACAPULCO DE JUÁREZ,001,LA CONCEPCIÓN,3,380,191,189,22
GUERRERO,12,ACAPULCO DE JUÁREZ,001,LA ESTACIÓN,3,333,172,161,17
GUERRERO,12,ACAPULCO DE JUÁREZ,001,LA PROVIDENCIA,5,267,107,160,22
GUERRERO,12,ACAPULCO DE JUÁREZ,001,LA SIERRITA,3,72,35,37,8
GUERRERO,12,ACAPULCO DE JUÁREZ,001,LA TESTARUDA,3,185,88,97,10
GUERRERO,12,ACAPULCO DE JUÁREZ,001,LAGUNA DEL QUEMADO,3,219,109,110,11
GUERRERO,12,ACAPULCO DE JUÁREZ,001,LAS CHANECAS,3,215,113,102,11
GUERRERO,12,ACAPULCO DE JUÁREZ,001,LAS CRUCES DE CACAHUATEPEC,3,213,101,112,14
GUERRERO,12,ACAPULCO DE JUÁREZ,001,LAS JOYAS,3,91,49,42,7
GUERRERO,12,ACAPULCO DE JUÁREZ,001,LAS MARÍAS,4,137,71,66,13
GUERRERO,12,ACAPULCO DE JUÁREZ,001,LAS OLLITAS (LAS JOYITAS),3,45,17,28,5
GUERRERO,12,ACAPULCO DE JUÁREZ,001,LAS PAROTAS,4,216,84,132,14
GUERRERO,12,ACAPULCO DE JUÁREZ,001,LAS PLAZUELAS,4,299,136,163,15
GUERRERO,12,ACAPULCO DE JUÁREZ,001,LAS TORTOLITAS,3,124,67,57,9
GUERRERO,12,ACAPULCO DE JUÁREZ,001,LLANO LARGO UNO,1,725,342,383,24
GUERRERO,12,ACAPULCO DE JUÁREZ,001,LOMAS DE CHAPULTEPEC,5,501,244,257,28
GUERRERO,12,ACAPULCO DE JUÁREZ,001,LOMAS DE SAN JUAN,4,466,237,229,26
GUERRERO,12,ACAPULCO DE JUÁREZ,001,LOMAS DEL AIRE,3,150,77,73,10
GUERRERO,12,ACAPULCO DE JUÁREZ,001,LOS COYOTES,1,45,22,23,3
GUERRERO,12,ACAPULCO DE JUÁREZ,001,LOS ILAMOS,2,24,10,14,3
GUERRERO,12,ACAPULCO DE JUÁREZ,001,LOS ÓRGANOS DE JUAN R. ESCUDERO,4,704,357,347,35
GUERRERO,12,ACAPULCO DE JUÁREZ,001,LOS ÓRGANOS DE SAN AGUSTÍN (EL QUEMADO),4,501,247,254,49
GUERRERO,12,ACAPULCO DE JUÁREZ,001,NICOLÁS BRAVO (ZANJA DEL TENIENTE),1,136,57,79,6
GUERRERO,12,ACAPULCO DE JUÁREZ,001,OAXAQUILLAS,2,230,98,132,9
GUERRERO,12,ACAPULCO DE JUÁREZ,001,PABLO GALEANA (COACOYULAR),4,172,89,83,13
GUERRERO,12,ACAPULCO DE JUÁREZ,001,PARAJE DE LA ZORRA,2,10,4,6,2
GUERRERO,12,ACAPULCO DE JUÁREZ,001,PAROTILLAS,2,77,38,39,5
GUERRERO,12,ACAPULCO DE JUÁREZ,001,PASO TEXCA,1,39,23,16,4
GUERRERO,12,ACAPULCO DE JUÁREZ,001,PIEDRA IMÁN,3,423,218,205,31
GUERRERO,12,ACAPULCO DE JUÁREZ,001,PLAYONES DE SAN ISIDRO,4,153,83,70,9
GUERRERO,12,ACAPULCO DE JUÁREZ,001,PUEBLO MADERO (EL PLAYÓN),3,229,129,100,13
GUERRERO,12,ACAPULCO DE JUÁREZ,001,PUENTE DE FIERRO,2,16,7,9,2
GUERRERO,12,ACAPULCO DE JUÁREZ,001,RANCHO LAS MARÍAS,3,60,28,32,6
GUERRERO,12,ACAPULCO DE JUÁREZ,001,SABANILLAS,4,500,257,243,25
GUERRERO,12,ACAPULCO DE JUÁREZ,001,SALSIPUEDES,2,56,24,32,4
GUERRERO,12,ACAPULCO DE JUÁREZ,001,SAN ANDRÉS PLAYA ENCANTADA (EL PODRIDO),3,300,146,154,15
GUERRERO,12,ACAPULCO DE JUÁREZ,001,SAN ANTONIO,3,243,121,122,14
GUERRERO,12,ACAPULCO DE JUÁREZ,001,SAN ISIDRO GALLINERO (EL GALLINERO),5,727,377,350,40
GUERRERO,12,ACAPULCO DE JUÁREZ,001,SAN JOSÉ,2,88,41,47,7
GUERRERO,12,ACAPULCO DE JUÁREZ,001,SAN JOSÉ CACAHUATEPEC,2,41,20,21,3
GUERRERO,12,ACAPULCO DE JUÁREZ,001,SAN JOSÉ TASAJERAS,3,101,48,53,8
GUERRERO,12,ACAPULCO DE JUÁREZ,001,SAN MARTÍN EL JOVERO,2,71,34,37,4
GUERRERO,12,ACAPULCO DE JUÁREZ,001,SAN PEDRO CACAHUATEPEC (VEREDA DE AMATILLO),3,328,152,176,11
GUERRERO,12,ACAPULCO DE JUÁREZ,001,SAN PEDRO LAS PLAYAS,8,1067,540,527,50
GUERRERO,12,ACAPULCO DE JUÁREZ,001,TASAJERAS,3,211,105,106,12
GUERRERO,12,ACAPULCO DE JUÁREZ,001,TENIENTE JOSÉ AZUETA (RÍO PAPAGAYO),1,20,10,10,2
GUERRERO,12,ACAPULCO DE JUÁREZ,001,TEXCA,5,780,410,370,42
GUERRERO,12,ACAPULCO DE JUÁREZ,001,TRES PALOS,6,1471,730,741,73
GUERRERO,12,ACAPULCO DE JUÁREZ,001,TUNCINGO,4,556,292,264,27
GUERRERO,12,ACAPULCO DE JUÁREZ,001,VENTA VIEJA,3,75,37,38,7
GUERRERO,12,ACAPULCO DE JUÁREZ,001,VISTA HERMOSA,3,92,51,41,5
GUERRERO,12,ACAPULCO DE JUÁREZ,001,XALTIANGUIS,12,1829,905,924,115
GUERRERO,12,ACAPULCO DE JUÁREZ,001,XOLAPA,4,242,117,125,15
GUERRERO,12,AHUACUOTZINGO,002,ACATEYAHUALCO,3,62,31,31,6
GUERRERO,12,AHUACUOTZINGO,002,AGUA ZARCA,5,259,142,117,12
GUERRERO,12,AHUACUOTZINGO,002,AHUACUOTZINGO,6,1172,558,614,54
GUERRERO,12,AHUACUOTZINGO,002,AJUATETLA,3,130,67,63,7
GUERRERO,12,AHUACUOTZINGO,002,ALPUYECANCINGO DE LAS MONTAÑAS,4,574,283,291,24
GUERRERO,12,AHUACUOTZINGO,002,AZAUCLA,2,13,4,9,2
GUERRERO,12,AHUACUOTZINGO,002,BUENA VISTA,1,11,8,3,1
GUERRERO,12,AHUACUOTZINGO,002,CHACHAYACO,1,7,5,2,1
GUERRERO,12,AHUACUOTZINGO,002,EL CARRIZO,2,66,31,35,4
GUERRERO,12,AHUACUOTZINGO,002,EL HUAMÚCHIL,3,48,29,19,3
GUERRERO,12,AHUACUOTZINGO,002,EL ORGANAL,2,12,5,7,1
GUERRERO,12,AHUACUOTZINGO,002,LAGUNILLAS,2,72,34,38,3
GUERRERO,12,AHUACUOTZINGO,002,LAMBEDEROS,1,18,5,13,1
GUERRERO,12,AHUACUOTZINGO,002,LAS JÍCARAS (EL MIRADOR),1,10,4,6,1
GUERRERO,12,AHUACUOTZINGO,002,LOMA BONITA,2,42,18,24,3
GUERRERO,12,AHUACUOTZINGO,002,LOMA HERMOSA,1,14,7,7,1
GUERRERO,12,AHUACUOTZINGO,002,MAZAPA,2,19,10,9,2
GUERRERO,12,AHUACUOTZINGO,002,MAZATLÁN (SAN JOSÉ),1,10,5,5,1
GUERRERO,12,AHUACUOTZINGO,002,MITLANCINGO,3,171,85,86,9
GUERRERO,12,AHUACUOTZINGO,002,MOTUAPA,2,11,6,5,2
GUERRERO,12,AHUACUOTZINGO,002,OCOTEPEC,2,48,21,27,3
GUERRERO,12,AHUACUOTZINGO,002,OXTOTITLÁN,4,499,235,264,27
GUERRERO,12,AHUACUOTZINGO,002,OXTOYAHUALCO,3,187,81,106,11
GUERRERO,12,AHUACUOTZINGO,002,PITECZINTLA,2,86,39,47,5
GUERRERO,12,AHUACUOTZINGO,002,POCHUTLA,4,308,148,160,15
GUERRERO,12,AHUACUOTZINGO,002,RANCHO ESCONDIDO,1,16,6,10,2
GUERRERO,12,AHUACUOTZINGO,002,RINCÓN DE COZAHUAPA,3,178,81,97,10
GUERRERO,12,AHUACUOTZINGO,002,RINCÓN PEÑITAS,3,88,47,41,8
GUERRERO,12,AHUACUOTZINGO,002,SAN ANDRÉS,2,48,25,23,3
GUERRERO,12,AHUACUOTZINGO,002,SAN FRANCISCO,1,10,3,7,1
GUERRERO,12,AHUACUOTZINGO,002,SAN JUAN (LAS JOYAS),3,202,100,102,12
GUERRERO,12,AHUACUOTZINGO,002,SAN MARCOS,1,18,11,7,1
GUERRERO,12,AHUACUOTZINGO,002,SAN MIGUEL AHUELICAN,2,34,19,15,2
GUERRERO,12,AHUACUOTZINGO,002,SANTA CATARINA (SANTA CATARINA LAS JOYAS),4,210,103,107,12
GUERRERO,12,AHUACUOTZINGO,002,SANTA ROSA,2,47,23,24,3
GUERRERO,12,AHUACUOTZINGO,002,TECAXITLA,2,8,4,4,2
GUERRERO,12,AHUACUOTZINGO,002,TECOANAPA,4,287,127,160,16
GUERRERO,12,AHUACUOTZINGO,002,TECOLCUAUTLA,4,375,177,198,20
GUERRERO,12,AHUACUOTZINGO,002,TECOZAJCA (TEPEHUAJE),4,417,215,202,21
GUERRERO,12,AHUACUOTZINGO,002,TENANZINTITLÁN (LA HACIENDA),3,66,31,35,4
GUERRERO,12,AHUACUOTZINGO,002,TEPETLATIPA,3,171,92,79,10
GUERRERO,12,AHUACUOTZINGO,002,TEPOXTLÁN,3,120,57,63,8
GUERRERO,12,AHUACUOTZINGO,002,TLALACONTITLÁN,1,31,12,19,2
GUERRERO,12,AHUACUOTZINGO,002,TLALCHICHILCO,2,27,19,8,2
GUERRERO,12,AHUACUOTZINGO,002,TLALCOMULCO,3,179,84,95,12
GUERRERO,12,AHUACUOTZINGO,002,TLALIXTAC,1,22,11,11,2
GUERRERO,12,AHUACUOTZINGO,002,TLALXOCOTITLÁN,1,25,14,11,1
GUERRERO,12,AHUACUOTZINGO,002,TLAQUILCINGO,3,82,42,40,5
GUERRERO,12,AHUACUOTZINGO,002,TOTOLZINTLA,2,39,20,19,3
GUERRERO,12,AHUACUOTZINGO,002,TRAPICHE VIEJO,3,137,73,64,9
GUERRERO,12,AHUACUOTZINGO,002,TSONTECONCUICUILCO,1,20,7,13,1
GUERRERO,12,AHUACUOTZINGO,002,XITOPONTLA,4,363,179,184,16
GUERRERO,12,AHUACUOTZINGO,002,XOCOYOLZINTLA,4,426,197,229,23
GUERRERO,12,AHUACUOTZINGO,002,XUMILTEPEC,2,145,82,63,7
GUERRERO,12,AHUACUOTZINGO,002,YERBABUENA,1,17,10,7,1
GUERRERO,12,AHUACUOTZINGO,002,YUPITEPEC,1,16,8,8,1
GUERRERO,12,AHUACUOTZINGO,002,ZACUALPA,2,116,64,52,4
GUERRERO,12,AHUACUOTZINGO,002,ZOMPAZOLCO,2,45,29,16,3
GUERRERO,12,AJUCHITLÁN DEL PROGRESO,003,AGUA ESCONDIDA,1,5,2,3,1
GUERRERO,12,AJUCHITLÁN DEL PROGRESO,003,AJUCHITLÁN DEL PROGRESO,13,2215,1073,1142,109
GUERRERO,12,AJUCHITLÁN DEL PROGRESO,003,AYAVITLE,3,111,47,64,9
GUERRERO,12,AJUCHITLÁN DEL PROGRESO,003,BARRIO NUEVO,2,12,4,8,2
GUERRERO,12,AJUCHITLÁN DEL PROGRESO,003,CABALLOS,2,12,6,6,1
GUERRERO,12,AJUCHITLÁN DEL PROGRESO,003,CANTÓN DE GUERRERO,3,164,79,85,10
GUERRERO,12,AJUCHITLÁN DEL PROGRESO,003,CHANGATA,5,647,324,323,36
GUERRERO,12,AJUCHITLÁN DEL PROGRESO,003,CHARCO DE LA VACA,2,5,2,3,2
GUERRERO,12,AJUCHITLÁN DEL PROGRESO,003,CHILACAYOTE,2,21,15,6,2
GUERRERO,12,AJUCHITLÁN DEL PROGRESO,003,COLONIA FRANCISCO VILLA (CUADRILLA SECA),2,26,12,14,3
GUERRERO,12,AJUCHITLÁN DEL PROGRESO,003,COLONIA HIDALGO (LLANO GRANDE),2,31,15,16,3
GUERRERO,12,AJUCHITLÁN DEL PROGRESO,003,CORRAL FALSO,5,893,438,455,72
GUERRERO,12,AJUCHITLÁN DEL PROGRESO,003,CUATRO CRUCES (PALO MARCADO),2,20,13,7,3
GUERRERO,12,AJUCHITLÁN DEL PROGRESO,003,EL AGUAJE,4,181,85,96,16
GUERRERO,12,AJUCHITLÁN DEL PROGRESO,003,EL CARRIZAL,2,28,8,20,4
GUERRERO,12,AJUCHITLÁN DEL PROGRESO,003,EL COCO,2,25,12,13,2
GUERRERO,12,AJUCHITLÁN DEL PROGRESO,003,EL COYOL,4,26,9,17,5
GUERRERO,12,AJUCHITLÁN DEL PROGRESO,003,EL CUAJILOTE,3,20,11,9,4
GUERRERO,12,AJUCHITLÁN DEL PROGRESO,003,EL ESPÍRITU SANTO,2,13,4,9,1
GUERRERO,12,AJUCHITLÁN DEL PROGRESO,003,EL GACHUPÍN,1,6,1,5,2
GUERRERO,12,AJUCHITLÁN DEL PROGRESO,003,EL JONDEÓN,2,28,11,17,3
GUERRERO,12,AJUCHITLÁN DEL PROGRESO,003,EL LLANO GRANDE,3,26,15,11,3
GUERRERO,12,AJUCHITLÁN DEL PROGRESO,003,EL NARANJO,1,8,3,5,1
GUERRERO,12,AJUCHITLÁN DEL PROGRESO,003,EL REPARO,3,119,47,72,11
GUERRERO,12,AJUCHITLÁN DEL PROGRESO,003,EL SALTO,1,2,1,1,1
GUERRERO,12,AJUCHITLÁN DEL PROGRESO,003,EL TEPEHUAJE,3,32,14,18,4
GUERRERO,12,AJUCHITLÁN DEL PROGRESO,003,EL TULE,3,33,13,20,4
GUERRERO,12,AJUCHITLÁN DEL PROGRESO,003,EL ZAPOTAL,1,26,15,11,2
GUERRERO,12,AJUCHITLÁN DEL PROGRESO,003,GÓMEZ FARÍAS (EL LIMÓN),2,31,15,16,3
GUERRERO,12,AJUCHITLÁN DEL PROGRESO,003,GUAYATENCO,2,30,12,18,2
GUERRERO,12,AJUCHITLÁN DEL PROGRESO,003,IXCAPUZALCO,2,22,11,11,2
GUERRERO,12,AJUCHITLÁN DEL PROGRESO,003,LA CAÑA SANTA FE,4,81,39,42,6
GUERRERO,12,AJUCHITLÁN DEL PROGRESO,003,LA COMUNIDAD,3,76,46,30,7
GUERRERO,12,AJUCHITLÁN DEL PROGRESO,003,LA HACIENDA SANTA FE,3,92,47,45,7
GUERRERO,12,AJUCHITLÁN DEL PROGRESO,003,LA LAJA,3,157,71,86,16
GUERRERO,12,AJUCHITLÁN DEL PROGRESO,003,LA TRINIDAD,3,27,12,15,3
GUERRERO,12,AJUCHITLÁN DEL PROGRESO,003,LAS ANONITAS,3,195,102,93,12
GUERRERO,12,AJUCHITLÁN DEL PROGRESO,003,LAS CRUCES,1,6,1,5,1
GUERRERO,12,AJUCHITLÁN DEL PROGRESO,003,LAS JUNTAS (LAS JUNTAS DEL RÍO CHIQUITO),3,181,87,94,11
GUERRERO,12,AJUCHITLÁN DEL PROGRESO,003,LAS MESAS,2,6,2,4,2
GUERRERO,12,AJUCHITLÁN DEL PROGRESO,003,LAS MESAS DEL GUAYABO (LAS MESAS),1,20,10,10,2
GUERRERO,12,AJUCHITLÁN DEL PROGRESO,003,LAS PALMITAS,2,14,3,11,2
GUERRERO,12,AJUCHITLÁN DEL PROGRESO,003,LOS FRESNOS DE PUERTO RICO,3,67,35,32,5
GUERRERO,12,AJUCHITLÁN DEL PROGRESO,003,MESA VERDE,2,5,3,2,1
GUERRERO,12,AJUCHITLÁN DEL PROGRESO,003,NANCHE COLORADO (EL NANCHE),2,37,20,17,3
GUERRERO,12,AJUCHITLÁN DEL PROGRESO,003,PASO ANCHO,1,5,1,4,1
GUERRERO,12,AJUCHITLÁN DEL PROGRESO,003,PINZÁN MORADO,3,28,13,15,5
GUERRERO,12,AJUCHITLÁN DEL PROGRESO,003,PIZOTLA,1,8,4,4,1
GUERRERO,12,AJUCHITLÁN DEL PROGRESO,003,POCITOS DEL BALCÓN,3,103,60,43,9
GUERRERO,12,AJUCHITLÁN DEL PROGRESO,003,PUERTO DEL COCO,3,107,56,51,8
GUERRERO,12,AJUCHITLÁN DEL PROGRESO,003,PUERTO GRANDE,3,94,44,50,6
GUERRERO,12,AJUCHITLÁN DEL PROGRESO,003,SAN ANTONIO DE LOS LIBRES,3,66,35,31,7
GUERRERO,12,AJUCHITLÁN DEL PROGRESO,003,SAN BARTOLO,3,71,36,35,8
GUERRERO,12,AJUCHITLÁN DEL PROGRESO,003,SAN CRISTÓBAL,4,229,112,117,17
GUERRERO,12,AJUCHITLÁN DEL PROGRESO,003,SAN GABRIEL,1,4,2,2,1
GUERRERO,12,AJUCHITLÁN DEL PROGRESO,003,SAN JERÓNIMO EL GRANDE,3,274,145,129,14
GUERRERO,12,AJUCHITLÁN DEL PROGRESO,003,SAN JERÓNIMO SANTA FE,3,55,28,27,4
GUERRERO,12,AJUCHITLÁN DEL PROGRESO,003,SAN LORENZO,3,183,80,103,12
GUERRERO,12,AJUCHITLÁN DEL PROGRESO,003,SAN MARCOS,3,81,35,46,7
GUERRERO,12,AJUCHITLÁN DEL PROGRESO,003,SAN MATEO,3,236,125,111,14
GUERRERO,12,AJUCHITLÁN DEL PROGRESO,003,SAN PABLO ORIENTE,3,92,51,41,8
GUERRERO,12,AJUCHITLÁN DEL PROGRESO,003,SAN PABLO SUR,3,53,24,29,5
GUERRERO,12,AJUCHITLÁN DEL PROGRESO,003,SAN PEDRO Y LAS GARZAS,3,156,84,72,10
GUERRERO,12,AJUCHITLÁN DEL PROGRESO,003,SAN SEBASTIÁN (LAS LOMAS),2,29,13,16,2
GUERRERO,12,AJUCHITLÁN DEL PROGRESO,003,SANTA ANA DEL ÁGUILA,4,213,101,112,20
GUERRERO,12,AJUCHITLÁN DEL PROGRESO,003,SANTA ROSA DE LIMA,4,209,114,95,14
GUERRERO,12,AJUCHITLÁN DEL PROGRESO,003,SANTA ROSA PRIMERA (SANTA ROSA ORIENTE),1,6,3,3,1
GUERRERO,12,AJUCHITLÁN DEL PROGRESO,003,VILLA NICOLÁS BRAVO,6,768,387,381,47
GUERRERO,12,AJUCHITLÁN DEL PROGRESO,003,ZACAHUAJE,4,249,129,120,15
GUERRERO,12,ALCOZAUCA DE GUERRERO,004,ACAMETLA DE BRAVO,2,114,64,50,6
GUERRERO,12,ALCOZAUCA DE GUERRERO,004,AHUEJUTLA,2,133,63,70,5
GUERRERO,12,ALCOZAUCA DE GUERRERO,004,ALCOZAUCA DE GUERRERO,9,1352,687,665,54
GUERRERO,12,ALCOZAUCA DE GUERRERO,004,ALMOLONGA DE OCAMPO (ALMOLONGA),8,376,204,172,16
GUERRERO,12,ALCOZAUCA DE GUERRERO,004,ALTAMIRA,1,12,2,10,1
GUERRERO,12,ALCOZAUCA DE GUERRERO,004,AMAPILCA,2,62,33,29,5
GUERRERO,12,ALCOZAUCA DE GUERRERO,004,BUENA VISTA,2,123,67,56,6
GUERRERO,12,ALCOZAUCA DE GUERRERO,004,CERRO AZUL,2,73,39,34,5
GUERRERO,12,ALCOZAUCA DE GUERRERO,004,CHIMALTEPEC,2,132,65,67,7
GUERRERO,12,ALCOZAUCA DE GUERRERO,004,COLONIA EL ARENAL,2,12,7,5,2
GUERRERO,12,ALCOZAUCA DE GUERRERO,004,COLONIA LOMA BONITA SAN MIGUEL EL GRANDE,2,47,27,20,4
GUERRERO,12,ALCOZAUCA DE GUERRERO,004,COLONIA SAN ANTONIO,2,164,84,80,7
GUERRERO,12,ALCOZAUCA DE GUERRERO,004,CRUZ VERDE,2,40,25,15,2
GUERRERO,12,ALCOZAUCA DE GUERRERO,004,CUYUXTLAHUAC,4,474,233,241,23
GUERRERO,12,ALCOZAUCA DE GUERRERO,004,EL GITANO,2,19,11,8,2
GUERRERO,12,ALCOZAUCA DE GUERRERO,004,IXCUINATOYAC,2,262,122,140,13
GUERRERO,12,ALCOZAUCA DE GUERRERO,004,LOMAZÓYATL (LOMAZOYA),3,332,160,172,12
GUERRERO,12,ALCOZAUCA DE GUERRERO,004,MELCHOR OCAMPO,3,328,175,153,14
GUERRERO,12,ALCOZAUCA DE GUERRERO,004,NUEVO ZARAGOZA,1,25,11,14,2
GUERRERO,12,ALCOZAUCA DE GUERRERO,004,PETLACALANCINGO,2,85,39,46,5
GUERRERO,12,ALCOZAUCA DE GUERRERO,004,PUEBLO DE DIOS,2,81,46,35,4
GUERRERO,12,ALCOZAUCA DE GUERRERO,004,SAN JOSÉ LAGUNAS (CAPULÍN),3,125,62,63,8
GUERRERO,12,ALCOZAUCA DE GUERRERO,004,SAN MARTÍN,2,98,46,52,4
GUERRERO,12,ALCOZAUCA DE GUERRERO,004,SAN MIGUEL EL GRANDE,3,206,119,87,9
GUERRERO,12,ALCOZAUCA DE GUERRERO,004,SAN MIGUELITO,2,29,15,14,3
GUERRERO,12,ALCOZAUCA DE GUERRERO,004,SAN VICENTE ZOYATLÁN,6,653,327,326,29
GUERRERO,12,ALCOZAUCA DE GUERRERO,004,TLAHUAPA,4,597,297,300,25
GUERRERO,12,ALCOZAUCA DE GUERRERO,004,XOCHAPA,8,371,195,176,26
GUERRERO,12,ALCOZAUCA DE GUERRERO,004,XONACATLÁN,3,176,91,85,10
GUERRERO,12,ALCOZAUCA DE GUERRERO,004,ZARAGOZA,1,63,30,33,3
GUERRERO,12,ALPOYECA,005,ALPOYECA,13,1562,803,759,85
GUERRERO,12,ALPOYECA,005,BARRIO DE SAN MARCOS,1,104,45,59,4
GUERRERO,12,ALPOYECA,005,IXCATEOPAN,5,364,162,202,18
GUERRERO,12,ALPOYECA,005,SAN JOSÉ BUENAVISTA,3,218,113,105,14
GUERRERO,12,ALPOYECA,005,TECOYO,3,63,33,30,5
GUERRERO,12,APAXTLA,006,CACALOTEPEC,4,111,54,57,13
GUERRERO,12,APAXTLA,006,CIUDAD APAXTLA DE CASTREJÓN,15,1971,1018,953,138
GUERRERO,12,APAXTLA,006,COLONIA EMILIANO ZAPATA II (CUADRILLA NUEVA),2,14,9,5,2
GUERRERO,12,APAXTLA,006,IGLESIA VIEJA,3,57,33,24,7
GUERRERO,12,APAXTLA,006,LA LAGUNITA,2,8,5,3,3
GUERRERO,12,APAXTLA,006,LIBERALTEPEC,3,64,24,40,5
GUERRERO,12,APAXTLA,006,LOS AMATES,2,20,9,11,2
GUERRERO,12,APAXTLA,006,NEJAPA,1,2,1,1,1
GUERRERO,12,APAXTLA,006,PETLACALA,2,24,9,15,3
GUERRERO,12,APAXTLA,006,PUEBLO NUEVO SANTA MARÍA,2,19,10,9,3
GUERRERO,12,APAXTLA,006,SAN MARCOS,1,7,2,5,1
GUERRERO,12,APAXTLA,006,TEPOXTEPEC (TEPOZTEPEC),4,116,65,51,13
GUERRERO,12,APAXTLA,006,TEXOCOTLA,2,11,6,5,3
GUERRERO,12,APAXTLA,006,TLATZALA,4,102,46,56,12
GUERRERO,12,APAXTLA,006,TRAPICHAL,2,11,6,5,2
GUERRERO,12,APAXTLA,006,XOCHITEPEC,4,134,59,75,8
GUERRERO,12,APAXTLA,006,YETLA DOS,2,54,25,29,4
GUERRERO,12,APAXTLA,006,ZACAPOSTEPEC,4,113,59,54,12
GUERRERO,12,ARCELIA,007,ACHOTLA,3,18,9,9,3
GUERRERO,12,ARCELIA,007,AHUATEPEC (POTRERO),3,56,30,26,6
GUERRERO,12,ARCELIA,007,ALMOLOYA (ALMOLOYA EL GRANDE),4,205,101,104,20
GUERRERO,12,ARCELIA,007,ARCELIA,42,6674,3422,3252,429
GUERRERO,12,ARCELIA,007,AZIZINTLA,2,9,4,5,1
GUERRERO,12,ARCELIA,007,CACAHUANANCHE,3,35,13,22,4
GUERRERO,12,ARCELIA,007,CAMPO MORADO,2,21,8,13,2
GUERRERO,12,ARCELIA,007,CERRO GORDO,2,8,3,5,2
GUERRERO,12,ARCELIA,007,CERRO VERDE,3,63,25,38,5
GUERRERO,12,ARCELIA,007,COLONIA EMPERADOR CUAUHTÉMOC,2,176,83,93,12
GUERRERO,12,ARCELIA,007,COLONIA FILIBERTO GÓMEZ (LA CEIBA),1,9,6,3,1
GUERRERO,12,ARCELIA,007,COLONIA TERRERO BLANCO,1,3,1,2,1
GUERRERO,12,ARCELIA,007,COLONIA VICENTE GUERRERO (COMOL),3,24,12,12,3
GUERRERO,12,ARCELIA,007,COPALTEPEC,2,18,11,7,2
GUERRERO,12,ARCELIA,007,CUADRILLA ASCENCIO,2,14,8,6,2
GUERRERO,12,ARCELIA,007,EL AGUACATE,1,13,6,7,2
GUERRERO,12,ARCELIA,007,EL AMACUÁHUITL,3,60,29,31,7
GUERRERO,12,ARCELIA,007,EL CAZAHUATE,1,3,1,2,1
GUERRERO,12,ARCELIA,007,EL CIRIÁN,2,5,3,2,1
GUERRERO,12,ARCELIA,007,EL CORINDÓN (EL REPARO),2,22,10,12,2
GUERRERO,12,ARCELIA,007,EL ESCONDIDO (VALLE EL ESCONDIDO),3,230,113,117,25
GUERRERO,12,ARCELIA,007,EL GUAYABO,3,99,39,60,8
GUERRERO,12,ARCELIA,007,EL MAL PASO,3,24,11,13,3
GUERRERO,12,ARCELIA,007,EL MIRADOR,2,18,10,8,2
GUERRERO,12,ARCELIA,007,EL NARANJO,2,32,14,18,3
GUERRERO,12,ARCELIA,007,EL PROGRESO (ZAPOTITLÁN),1,3,3,0,1
GUERRERO,12,ARCELIA,007,EL PUERTO DEL TEPEHUAJE,1,6,3,3,1
GUERRERO,12,ARCELIA,007,EL TERRERITO,3,20,9,11,2
GUERRERO,12,ARCELIA,007,EL USHE,2,17,12,5,2
GUERRERO,12,ARCELIA,007,EL VARAL (EL BRINCO),1,22,9,13,1
GUERRERO,12,ARCELIA,007,IXCATEPEC,4,202,102,100,11
GUERRERO,12,ARCELIA,007,LA CONCORDIA,3,48,22,26,6
GUERRERO,12,ARCELIA,007,LA PAROTA DEL OCOTE,2,43,20,23,4
GUERRERO,12,ARCELIA,007,LA SOLEDAD,2,25,14,11,3
GUERRERO,12,ARCELIA,007,LAS PIÑAS,2,21,9,12,3
GUERRERO,12,ARCELIA,007,LOS BRASILES,3,89,45,44,5
GUERRERO,12,ARCELIA,007,NUEVO LEÓN,3,35,13,22,6
GUERRERO,12,ARCELIA,007,OJO DE AGUA,2,30,11,19,3
GUERRERO,12,ARCELIA,007,PALOS ALTOS,4,200,113,87,15
GUERRERO,12,ARCELIA,007,PARAJE NUEVO,1,8,3,5,1
GUERRERO,12,ARCELIA,007,PARAJE SURIANO,2,8,5,3,1
GUERRERO,12,ARCELIA,007,POZO ZARCO,1,6,3,3,1
GUERRERO,12,ARCELIA,007,SAN ANDRÉS,2,12,8,4,2
GUERRERO,12,ARCELIA,007,SAN MIGUELITO,4,102,53,49,9
GUERRERO,12,ARCELIA,007,SANTO TOMÁS,3,88,44,44,8
GUERRERO,12,ARCELIA,007,TEMIXCO,2,38,17,21,3
GUERRERO,12,ARCELIA,007,TLALCHICHILPA,2,41,19,22,4
GUERRERO,12,ARCELIA,007,TULATENGO,2,40,17,23,3
GUERRERO,12,ARCELIA,007,VALLE GALEANA (EL TAMARINDO),4,137,74,63,19
GUERRERO,12,ARCELIA,007,VISTA HERMOSA,1,9,5,4,1
GUERRERO,12,ARCELIA,007,XOCHICALCO,4,83,43,40,7
GUERRERO,12,ARCELIA,007,XOCHITLA,4,94,56,38,8
GUERRERO,12,ARCELIA,007,ZITLALTENGO,3,18,11,7,3
GUERRERO,12,ATENANGO DEL RÍO,008,APANGUITO,3,77,42,35,9
GUERRERO,12,ATENANGO DEL RÍO,008,ATENANGO DEL RÍO,8,908,446,462,58
GUERRERO,12,ATENANGO DEL RÍO,008,ATLAPA DEL RÍO,2,4,1,3,1
GUERRERO,12,ATENANGO DEL RÍO,008,COACÁN (COCÁN),2,28,11,17,4
GUERRERO,12,ATENANGO DEL RÍO,008,COMALA DE GÓMEZ,3,104,47,57,6
GUERRERO,12,ATENANGO DEL RÍO,008,FILADELFIA,3,31,15,16,4
GUERRERO,12,ATENANGO DEL RÍO,008,LA CARBONERA,2,23,10,13,2
GUERRERO,12,ATENANGO DEL RÍO,008,SAN JUAN TEOCALCINGO,4,166,81,85,16
GUERRERO,12,ATENANGO DEL RÍO,008,SANTIAGO ZACANGO,2,52,22,30,4
GUERRERO,12,ATENANGO DEL RÍO,008,TEMALAC,4,193,94,99,14
GUERRERO,12,ATENANGO DEL RÍO,008,TEPETLAPA,3,128,64,64,10
GUERRERO,12,ATENANGO DEL RÍO,008,TEQUICUILCO,4,292,154,138,18
GUERRERO,12,ATENANGO DEL RÍO,008,TUZANTLÁN,2,27,13,14,3
GUERRERO,12,ATLAMAJALCINGO DEL MONTE,009,ATLAMAJALCINGO DEL MONTE,7,315,162,153,28
GUERRERO,12,ATLAMAJALCINGO DEL MONTE,009,BENITO JUÁREZ,2,45,17,28,3
GUERRERO,12,ATLAMAJALCINGO DEL MONTE,009,CHINAMECA,2,81,43,38,3
GUERRERO,12,ATLAMAJALCINGO DEL MONTE,009,COLONIA VICENTE GUERRERO,1,26,12,14,1
GUERRERO,12,ATLAMAJALCINGO DEL MONTE,009,CUAUTIPAN,2,51,24,27,4
GUERRERO,12,ATLAMAJALCINGO DEL MONTE,009,EL ROSARIO,2,85,41,44,4
GUERRERO,12,ATLAMAJALCINGO DEL MONTE,009,HUEHUETEPEC,4,253,110,143,15
GUERRERO,12,ATLAMAJALCINGO DEL MONTE,009,MI PATRIA ES PRIMERO,2,53,18,35,3
GUERRERO,12,ATLAMAJALCINGO DEL MONTE,009,PIEDRA BLANCA,1,16,12,4,1
GUERRERO,12,ATLAMAJALCINGO DEL MONTE,009,PLAN DE GUADALUPE,2,45,17,28,3
GUERRERO,12,ATLAMAJALCINGO DEL MONTE,009,SAN ISIDRO LABRADOR,3,82,35,47,5
GUERRERO,12,ATLAMAJALCINGO DEL MONTE,009,SANTA CRUZ,2,119,54,65,6
GUERRERO,12,ATLAMAJALCINGO DEL MONTE,009,TEPECOCATLÁN,4,204,91,113,12
GUERRERO,12,ATLAMAJALCINGO DEL MONTE,009,ZILACAYOTITLÁN,4,312,176,136,21
GUERRERO,12,ATLIXTAC,010,AGUA ZARCA,3,30,19,11,3
GUERRERO,12,ATLIXTAC,010,AHUACATITLÁN,3,54,29,25,4
GUERRERO,12,ATLIXTAC,010,AHUEXOTITLÁN,2,52,27,25,3
GUERRERO,12,ATLIXTAC,010,AHUIXTLA,2,41,15,26,3
GUERRERO,12,ATLIXTAC,010,ATLIXTAC,10,1364,693,671,64
GUERRERO,12,ATLIXTAC,010,BELÉN,1,18,9,9,2
GUERRERO,12,ATLIXTAC,010,BUENA VISTA,2,35,20,15,3
GUERRERO,12,ATLIXTAC,010,CACALOTEPEC,4,180,89,91,14
GUERRERO,12,ATLIXTAC,010,CAXITEPEC,4,317,168,149,15
GUERRERO,12,ATLIXTAC,010,CHALMA,3,119,54,65,8
GUERRERO,12,ATLIXTAC,010,CHICHIHUATLACO,3,75,33,42,6
GUERRERO,12,ATLIXTAC,010,CHICHILTEPEC,2,114,52,62,7
GUERRERO,12,ATLIXTAC,010,CHILMIXTLA,2,11,4,7,2
GUERRERO,12,ATLIXTAC,010,COATLAMOLOYA,1,8,4,4,1
GUERRERO,12,ATLIXTAC,010,CONTEPEC (SAN JOSÉ CONTEPEC),3,141,58,83,7
GUERRERO,12,ATLIXTAC,010,COPALTEPEC,1,7,3,4,1
GUERRERO,12,ATLIXTAC,010,COXILITEPEC,1,28,14,14,2
GUERRERO,12,ATLIXTAC,010,EL DURAZNAL,4,152,89,63,10
GUERRERO,12,ATLIXTAC,010,EL POTRERO,2,7,4,3,2
GUERRERO,12,ATLIXTAC,010,HUITZACOTLA,3,134,67,67,6
GUERRERO,12,ATLIXTAC,010,HUITZAPULA (SAN PEDRO HUITZAPULA SUR),2,262,113,149,14
GUERRERO,12,ATLIXTAC,010,HUIXOLOTEPEC (HUITZOLOTEPEC),3,156,73,83,9
GUERRERO,12,ATLIXTAC,010,HUIXTLAZALA,4,152,84,68,24
GUERRERO,12,ATLIXTAC,010,IXMATLA,2,20,8,12,2
GUERRERO,12,ATLIXTAC,010,IXTLAHUA ROJA (IXTLAHUA),3,158,77,81,9
GUERRERO,12,ATLIXTAC,010,LA TABERNA,2,66,40,26,3
GUERRERO,12,ATLIXTAC,010,LAGUNALTEPEC,3,41,15,26,3
GUERRERO,12,ATLIXTAC,010,LAS PALMAS,1,27,15,12,1
GUERRERO,12,ATLIXTAC,010,LOMA BONITA,1,11,5,6,1
GUERRERO,12,ATLIXTAC,010,LOS MESONES,2,42,21,21,3
GUERRERO,12,ATLIXTAC,010,LUCERITO,1,18,11,7,2
GUERRERO,12,ATLIXTAC,010,LUIS DONALDO COLOSIO MURRIETA,2,44,25,19,3
GUERRERO,12,ATLIXTAC,010,OCOPEXCO,2,41,19,22,3
GUERRERO,12,ATLIXTAC,010,PETATLÁN,4,337,181,156,15
GUERRERO,12,ATLIXTAC,010,PETLAZOLAPA,3,49,25,24,3
GUERRERO,12,ATLIXTAC,010,SAN JOSÉ,2,20,11,9,3
GUERRERO,12,ATLIXTAC,010,SAN JUAN BAUTISTA COAPALA,4,349,164,185,19
GUERRERO,12,ATLIXTAC,010,SAN LUCAS TEOCUITLAPA (TEOCUITLAPA),4,367,169,198,25
GUERRERO,12,ATLIXTAC,010,SAN MIGUEL TONALAPA,2,14,8,6,1
GUERRERO,12,ATLIXTAC,010,SAN MIGUEL XOCHIMILCO (LAS ESTACAS),1,25,11,14,2
GUERRERO,12,ATLIXTAC,010,SAN PEDRO HUITZAPULA NORTE (HUITZAPULA NORTE),4,503,243,260,22
GUERRERO,12,ATLIXTAC,010,SANTA ISABEL,2,40,19,21,2
GUERRERO,12,ATLIXTAC,010,TECOCOMULAPA,2,40,19,21,4
GUERRERO,12,ATLIXTAC,010,TEJOCOTITLÁN,3,25,10,15,4
GUERRERO,12,ATLIXTAC,010,TEXOCOTITLÁN,2,15,11,4,2
GUERRERO,12,ATLIXTAC,010,TIERRA COLORADA,3,20,10,10,2
GUERRERO,12,ATLIXTAC,010,TLACOTEPEC,2,48,20,28,3
GUERRERO,12,ATLIXTAC,010,TLACOXOCHAPA,3,104,51,53,8
GUERRERO,12,ATLIXTAC,010,TLATLAUQUITEPEC,5,853,442,411,38
GUERRERO,12,ATLIXTAC,010,TONALAPA,3,202,112,90,11
GUERRERO,12,ATLIXTAC,010,TOTOLAPA,1,25,12,13,2
GUERRERO,12,ATLIXTAC,010,TOTOXOCÓYOTL,2,64,33,31,4
GUERRERO,12,ATLIXTAC,010,VICENTE GUERRERO,2,35,20,15,4
GUERRERO,12,ATLIXTAC,010,VISTA HERMOSA,1,14,4,10,1
GUERRERO,12,ATLIXTAC,010,XALPITZÁHUAC,5,395,189,206,20
GUERRERO,12,ATLIXTAC,010,XAXOCOTLA,3,24,6,18,3
GUERRERO,12,ATLIXTAC,010,YETEPETITLÁN,2,12,7,5,2
GUERRERO,12,ATLIXTAC,010,ZOPILOTEPEC,2,33,17,16,3
GUERRERO,12,ATLIXTAC,010,ZOQUITLÁN,4,742,363,379,30
GUERRERO,12,ATLIXTAC,010,ZOYAPEXCO,2,74,37,37,5
GUERRERO,12,ATOYAC DE ÁLVAREZ,011,AGUA FRÍA,3,55,21,34,7
GUERRERO,12,ATOYAC DE ÁLVAREZ,011,ALCHOLOA,4,228,116,112,19
GUERRERO,12,ATOYAC DE ÁLVAREZ,011,ATOYAC DE ÁLVAREZ,51,6499,3194,3305,452
GUERRERO,12,ATOYAC DE ÁLVAREZ,011,BOCA DE ARROYO,2,28,13,15,2
GUERRERO,12,ATOYAC DE ÁLVAREZ,011,CACALUTLA,5,641,327,314,65
GUERRERO,12,ATOYAC DE ÁLVAREZ,011,CAÑA DE AGUA,1,9,4,5,1
GUERRERO,12,ATOYAC DE ÁLVAREZ,011,CERRO PRIETO DE LOS BLANCOS,3,96,46,50,8
GUERRERO,12,ATOYAC DE ÁLVAREZ,011,COLONIA BUENA VISTA,3,104,53,51,6
GUERRERO,12,ATOYAC DE ÁLVAREZ,011,COLONIA BUENOS AIRES,2,73,38,35,6
GUERRERO,12,ATOYAC DE ÁLVAREZ,011,COLONIA CUAUHTÉMOC,3,80,38,42,9
GUERRERO,12,ATOYAC DE ÁLVAREZ,011,COLONIA LA LAJA,1,14,7,7,1
GUERRERO,12,ATOYAC DE ÁLVAREZ,011,COLONIA MIRANDA FONSECA,2,58,28,30,6
GUERRERO,12,ATOYAC DE ÁLVAREZ,011,COLONIA OLÍMPICA,2,67,25,42,5
GUERRERO,12,ATOYAC DE ÁLVAREZ,011,COLONIA VICENTE GUERRERO,1,28,13,15,3
GUERRERO,12,ATOYAC DE ÁLVAREZ,011,CORRAL FALSO,3,356,181,175,22
GUERRERO,12,ATOYAC DE ÁLVAREZ,011,CORRALES DEL RÍO CHIQUITO,3,38,18,20,4
GUERRERO,12,ATOYAC DE ÁLVAREZ,011,CUCUYACHI,3,65,34,31,6
GUERRERO,12,ATOYAC DE ÁLVAREZ,011,EJIDO EL TAMBOR,1,3,2,1,1
GUERRERO,12,ATOYAC DE ÁLVAREZ,011,EL ACHOTAL,1,8,4,4,1
GUERRERO,12,ATOYAC DE ÁLVAREZ,011,EL CACAO,3,51,26,25,4
GUERRERO,12,ATOYAC DE ÁLVAREZ,011,EL CAMARÓN,4,105,58,47,8
GUERRERO,12,ATOYAC DE ÁLVAREZ,011,EL CIRUELAR,2,115,59,56,14
GUERRERO,12,ATOYAC DE ÁLVAREZ,011,EL EDÉN,3,209,101,108,13
GUERRERO,12,ATOYAC DE ÁLVAREZ,011,EL HUICÓN,2,52,17,35,5
GUERRERO,12,ATOYAC DE ÁLVAREZ,011,EL HUMO,3,92,44,48,7
GUERRERO,12,ATOYAC DE ÁLVAREZ,011,EL NANCHAL,2,27,13,14,3
GUERRERO,12,ATOYAC DE ÁLVAREZ,011,EL PARAÍSO,11,1003,533,470,70
GUERRERO,12,ATOYAC DE ÁLVAREZ,011,EL PORVENIR LIMÓN,2,8,1,7,1
GUERRERO,12,ATOYAC DE ÁLVAREZ,011,EL QUEMADO,4,244,124,120,25
GUERRERO,12,ATOYAC DE ÁLVAREZ,011,EL REFUGIO,2,5,2,3,2
GUERRERO,12,ATOYAC DE ÁLVAREZ,011,EL RINCÓN DE LAS PAROTAS,2,43,21,22,4
GUERRERO,12,ATOYAC DE ÁLVAREZ,011,EL SALTO,1,20,9,11,3
GUERRERO,12,ATOYAC DE ÁLVAREZ,011,EL SALTO (EL SALTO GRANDE),3,97,60,37,8
GUERRERO,12,ATOYAC DE ÁLVAREZ,011,EL TICUI,5,666,326,340,40
GUERRERO,12,ATOYAC DE ÁLVAREZ,011,FRACCIONAMIENTO NUEVO HORIZONTE,1,55,28,27,6
GUERRERO,12,ATOYAC DE ÁLVAREZ,011,IXTLA,4,112,54,58,9
GUERRERO,12,ATOYAC DE ÁLVAREZ,011,JUNTA DE LOS RÍOS (LAS JUNTAS),3,42,17,25,3
GUERRERO,12,ATOYAC DE ÁLVAREZ,011,LA CEBADA,2,9,3,6,2
GUERRERO,12,ATOYAC DE ÁLVAREZ,011,LA FINQUITA,2,9,2,7,2
GUERRERO,12,ATOYAC DE ÁLVAREZ,011,LA FLORIDA,2,6,1,5,2
GUERRERO,12,ATOYAC DE ÁLVAREZ,011,LA PINTADA,4,200,106,94,12
GUERRERO,12,ATOYAC DE ÁLVAREZ,011,LA QUEBRADORA,2,66,41,25,4
GUERRERO,12,ATOYAC DE ÁLVAREZ,011,LA REMONTA (LA REMONTA GRANDE),3,23,9,14,3
GUERRERO,12,ATOYAC DE ÁLVAREZ,011,LA SOLEDAD,3,29,10,19,5
GUERRERO,12,ATOYAC DE ÁLVAREZ,011,LA VAINILLA,2,47,27,20,4
GUERRERO,12,ATOYAC DE ÁLVAREZ,011,LA Y GRIEGA,3,230,115,115,21
GUERRERO,12,ATOYAC DE ÁLVAREZ,011,LA ZUZUCA,2,23,15,8,3
GUERRERO,12,ATOYAC DE ÁLVAREZ,011,LAS PALMERAS,2,12,7,5,2
GUERRERO,12,ATOYAC DE ÁLVAREZ,011,LAS SALINAS (LOMA DE SALINAS),2,40,18,22,3
GUERRERO,12,ATOYAC DE ÁLVAREZ,011,LAS SELVAS,2,10,5,5,2
GUERRERO,12,ATOYAC DE ÁLVAREZ,011,LAS TRINCHERAS,3,40,20,20,4
GUERRERO,12,ATOYAC DE ÁLVAREZ,011,LOS ARRAYANES,3,21,7,14,3
GUERRERO,12,ATOYAC DE ÁLVAREZ,011,LOS LLANOS DE SANTIAGO,2,74,45,29,6
GUERRERO,12,ATOYAC DE ÁLVAREZ,011,LOS PILONCILLOS,4,51,28,23,6
GUERRERO,12,ATOYAC DE ÁLVAREZ,011,LOS PLANES,2,24,9,15,2
GUERRERO,12,ATOYAC DE ÁLVAREZ,011,LOS VALLES,3,81,45,36,7
GUERRERO,12,ATOYAC DE ÁLVAREZ,011,MEXCALTEPEC,2,76,38,38,4
GUERRERO,12,ATOYAC DE ÁLVAREZ,011,NUEVA DELHI,3,35,13,22,4
GUERRERO,12,ATOYAC DE ÁLVAREZ,011,PIE DE LA CUESTA,4,235,116,119,11
GUERRERO,12,ATOYAC DE ÁLVAREZ,011,PIEDRAS GRANDES,2,26,14,12,2
GUERRERO,12,ATOYAC DE ÁLVAREZ,011,PLAN DE LAS DELICIAS (DELICIAS DEL PLAN GDE.),3,27,17,10,4
GUERRERO,12,ATOYAC DE ÁLVAREZ,011,PLAN DE LOS MOLINOS,2,18,11,7,2
GUERRERO,12,ATOYAC DE ÁLVAREZ,011,PLAN DEL CARRIZO,3,13,4,9,2
GUERRERO,12,ATOYAC DE ÁLVAREZ,011,POZA HONDA,2,50,22,28,4
GUERRERO,12,ATOYAC DE ÁLVAREZ,011,PUENTE DE LOS LUGARDO,2,15,13,2,2
GUERRERO,12,ATOYAC DE ÁLVAREZ,011,PUENTE DEL REY,3,41,25,16,5
GUERRERO,12,ATOYAC DE ÁLVAREZ,011,QUINTO PATIO,1,15,8,7,2
GUERRERO,12,ATOYAC DE ÁLVAREZ,011,RÍO DEL BÁLSAMO,4,60,24,36,7
GUERRERO,12,ATOYAC DE ÁLVAREZ,011,RÍO SANTIAGO,4,334,167,167,28
GUERRERO,12,ATOYAC DE ÁLVAREZ,011,RÍO VERDE,2,11,6,5,2
GUERRERO,12,ATOYAC DE ÁLVAREZ,011,SAN ANDRÉS DE LA CRUZ,4,200,100,100,14
GUERRERO,12,ATOYAC DE ÁLVAREZ,011,SAN FRANCISCO DEL TIBOR,4,81,45,36,7
GUERRERO,12,ATOYAC DE ÁLVAREZ,011,SAN JUAN DE LAS FLORES,4,184,93,91,17
GUERRERO,12,ATOYAC DE ÁLVAREZ,011,SAN MARTÍN DE LAS FLORES,3,103,53,50,8
GUERRERO,12,ATOYAC DE ÁLVAREZ,011,SAN VICENTE DE BENÍTEZ (SAN VICENTITO),2,43,27,16,3
GUERRERO,12,ATOYAC DE ÁLVAREZ,011,SAN VICENTE DE JESÚS,4,91,39,52,10
GUERRERO,12,ATOYAC DE ÁLVAREZ,011,SANTIAGO DE LA UNIÓN,3,144,79,65,12
GUERRERO,12,ATOYAC DE ÁLVAREZ,011,SANTO DOMINGO,3,77,34,43,6
GUERRERO,12,ATOYAC DE ÁLVAREZ,011,TRES PASOS,3,16,8,8,3
GUERRERO,12,ATOYAC DE ÁLVAREZ,011,ZACUALPAN,5,695,356,339,42
GUERRERO,12,AYUTLA DE LOS LIBRES,012,ACALMANI,3,348,182,166,14
GUERRERO,12,AYUTLA DE LOS LIBRES,012,AMPLIACIÓN VICENTE GUERRERO,1,22,17,5,1
GUERRERO,12,AYUTLA DE LOS LIBRES,012,APANTLA,4,363,181,182,21
GUERRERO,12,AYUTLA DE LOS LIBRES,012,ARROYO DEL ZAPOTE,2,41,22,19,3
GUERRERO,12,AYUTLA DE LOS LIBRES,012,ATOCUTLA,2,96,41,55,6
GUERRERO,12,AYUTLA DE LOS LIBRES,012,AYUTLA DE LOS LIBRES,47,8652,4657,3995,479
GUERRERO,12,AYUTLA DE LOS LIBRES,012,BARRANCA DE GUADALUPE,2,67,34,33,4
GUERRERO,12,AYUTLA DE LOS LIBRES,012,BARRANCA TECOANI,3,99,43,56,6
GUERRERO,12,AYUTLA DE LOS LIBRES,012,CARABALÍ GRANDE,2,40,15,25,3
GUERRERO,12,AYUTLA DE LOS LIBRES,012,CERRO GORDO NUEVO,2,34,13,21,4
GUERRERO,12,AYUTLA DE LOS LIBRES,012,CERRO GORDO VIEJO,3,95,53,42,6
GUERRERO,12,AYUTLA DE LOS LIBRES,012,CHACALINITLA,2,74,32,42,4
GUERRERO,12,AYUTLA DE LOS LIBRES,012,CIÉNEGA DEL SAUCE,2,164,70,94,9
GUERRERO,12,AYUTLA DE LOS LIBRES,012,COLONIA LA ESPERANZA,1,18,8,10,1
GUERRERO,12,AYUTLA DE LOS LIBRES,012,COLONIA MIGUEL HIDALGO,1,51,29,22,3
GUERRERO,12,AYUTLA DE LOS LIBRES,012,COLONIA PROGRESO SIGLO XXI,1,25,16,9,2
GUERRERO,12,AYUTLA DE LOS LIBRES,012,COLONIA YERBA SANTA,3,50,27,23,5
GUERRERO,12,AYUTLA DE LOS LIBRES,012,COLOTEPEC,5,872,432,440,56
GUERRERO,12,AYUTLA DE LOS LIBRES,012,COXCATLÁN CANDELARIA,2,113,48,65,6
GUERRERO,12,AYUTLA DE LOS LIBRES,012,CRUCERO DEL ZAPOTE,2,8,4,4,2
GUERRERO,12,AYUTLA DE LOS LIBRES,012,CUADRILLA NUEVA,4,99,44,55,7
GUERRERO,12,AYUTLA DE LOS LIBRES,012,CUANACAZAPA,2,36,22,14,4
GUERRERO,12,AYUTLA DE LOS LIBRES,012,EL CAMALOTE,3,205,102,103,12
GUERRERO,12,AYUTLA DE LOS LIBRES,012,EL CAPULÍN,2,36,18,18,3
GUERRERO,12,AYUTLA DE LOS LIBRES,012,EL CORTIJO,4,424,183,241,30
GUERRERO,12,AYUTLA DE LOS LIBRES,012,EL CRUCERO DE TONALÁ (HUERTA CAMPO),1,8,4,4,1
GUERRERO,12,AYUTLA DE LOS LIBRES,012,EL GUINEO,3,119,52,67,8
GUERRERO,12,AYUTLA DE LOS LIBRES,012,EL LIMÓN,3,56,24,32,6
GUERRERO,12,AYUTLA DE LOS LIBRES,012,EL MESÓN,4,546,289,257,29
GUERRERO,12,AYUTLA DE LOS LIBRES,012,EL MIRADOR,3,40,21,19,4
GUERRERO,12,AYUTLA DE LOS LIBRES,012,EL PAROTILLO,3,34,17,17,3
GUERRERO,12,AYUTLA DE LOS LIBRES,012,EL PROGRESO,2,96,55,41,5
GUERRERO,12,AYUTLA DE LOS LIBRES,012,EL REFUGIO,4,304,154,150,20
GUERRERO,12,AYUTLA DE LOS LIBRES,012,EL RINCÓN,3,63,30,33,7
GUERRERO,12,AYUTLA DE LOS LIBRES,012,EL ROSARIO,2,76,34,42,5
GUERRERO,12,AYUTLA DE LOS LIBRES,012,EL SALTO,3,228,113,115,12
GUERRERO,12,AYUTLA DE LOS LIBRES,012,EL SAUCE,2,11,4,7,2
GUERRERO,12,AYUTLA DE LOS LIBRES,012,EL TAMARINDO,3,168,89,79,9
GUERRERO,12,AYUTLA DE LOS LIBRES,012,EL TEHUAJE,1,13,7,6,2
GUERRERO,12,AYUTLA DE LOS LIBRES,012,EL TIMBRE,3,142,77,65,9
GUERRERO,12,AYUTLA DE LOS LIBRES,012,EL TORITO,1,8,2,6,1
GUERRERO,12,AYUTLA DE LOS LIBRES,012,EL VANO,2,93,42,51,5
GUERRERO,12,AYUTLA DE LOS LIBRES,012,EL ZAPOTE,3,194,92,102,11
GUERRERO,12,AYUTLA DE LOS LIBRES,012,LA AZOZUCA,6,614,294,320,39
GUERRERO,12,AYUTLA DE LOS LIBRES,012,LA GUADALUPE,2,27,15,12,2
GUERRERO,12,AYUTLA DE LOS LIBRES,012,LA HACIENDITA,2,87,44,43,5
GUERRERO,12,AYUTLA DE LOS LIBRES,012,LA LIMA,2,47,24,23,4
GUERRERO,12,AYUTLA DE LOS LIBRES,012,LA PALMA NUEVO PARAÍSO,2,30,13,17,3
GUERRERO,12,AYUTLA DE LOS LIBRES,012,LA SIDRA,2,44,23,21,3
GUERRERO,12,AYUTLA DE LOS LIBRES,012,LA UNIFICADA,3,40,18,22,3
GUERRERO,12,AYUTLA DE LOS LIBRES,012,LA UNIÓN,3,167,80,87,19
GUERRERO,12,AYUTLA DE LOS LIBRES,012,LOS AMATES,3,12,8,4,3
GUERRERO,12,AYUTLA DE LOS LIBRES,012,LOS TEPETATES,3,571,288,283,24
GUERRERO,12,AYUTLA DE LOS LIBRES,012,MEZÓN CHICO,3,59,27,32,5
GUERRERO,12,AYUTLA DE LOS LIBRES,012,OCOTITLÁN,3,19,9,10,3
GUERRERO,12,AYUTLA DE LOS LIBRES,012,PLAN DE GATICA,3,278,139,139,13
GUERRERO,12,AYUTLA DE LOS LIBRES,012,PLAN DEL BAJÍO,3,53,19,34,5
GUERRERO,12,AYUTLA DE LOS LIBRES,012,POZOLAPA,3,214,111,103,12
GUERRERO,12,AYUTLA DE LOS LIBRES,012,PUMA ROSA,2,81,41,40,3
GUERRERO,12,AYUTLA DE LOS LIBRES,012,RANCHO EL COQUILLO,1,65,29,36,4
GUERRERO,12,AYUTLA DE LOS LIBRES,012,RANCHO NUEVO,1,29,18,11,2
GUERRERO,12,AYUTLA DE LOS LIBRES,012,RÍO VELERO,2,64,33,31,2
GUERRERO,12,AYUTLA DE LOS LIBRES,012,SAN JOSÉ LA HACIENDA,3,367,169,198,41
GUERRERO,12,AYUTLA DE LOS LIBRES,012,SAN MIGUEL,2,61,31,30,5
GUERRERO,12,AYUTLA DE LOS LIBRES,012,SANTIAGO YOLOTEPEC,2,31,15,16,3
GUERRERO,12,AYUTLA DE LOS LIBRES,012,TECOMULAPA (RANCHO VIEJO),2,54,24,30,3
GUERRERO,12,AYUTLA DE LOS LIBRES,012,TECRUZ,4,395,204,191,18
GUERRERO,12,AYUTLA DE LOS LIBRES,012,TEPANGO,3,212,108,104,18
GUERRERO,12,AYUTLA DE LOS LIBRES,012,TIERRA COLORADA,2,9,5,4,1
GUERRERO,12,AYUTLA DE LOS LIBRES,012,TLACHIMALA,3,61,30,31,5
GUERRERO,12,AYUTLA DE LOS LIBRES,012,TLALAPA,2,55,33,22,5
GUERRERO,12,AYUTLA DE LOS LIBRES,012,TONALÁ,4,621,304,317,35
GUERRERO,12,AYUTLA DE LOS LIBRES,012,TUTEPEC,4,341,168,173,19
GUERRERO,12,AYUTLA DE LOS LIBRES,012,UNIDAD HABITACIONAL MAGISTERIAL,1,33,13,20,1
GUERRERO,12,AYUTLA DE LOS LIBRES,012,ZEMPAZULCO,3,162,81,81,11
GUERRERO,12,AZOYÚ,013,ARCELIA DEL PROGRESO,3,240,113,127,20
GUERRERO,12,AZOYÚ,013,AZOYÚ,11,1426,709,717,101
GUERRERO,12,AZOYÚ,013,BANCO DE ORO,2,24,8,16,2
GUERRERO,12,AZOYÚ,013,EL ARENAL (LA PLATAFORMA),3,44,18,26,4
GUERRERO,12,AZOYÚ,013,EL CARRIZO,4,110,44,66,11
GUERRERO,12,AZOYÚ,013,EL MACAHUITE,3,87,47,40,10
GUERRERO,12,AZOYÚ,013,HUEHUETÁN,5,435,205,230,27
GUERRERO,12,AZOYÚ,013,LA BOCANA,2,23,7,16,3
GUERRERO,12,AZOYÚ,013,LA CULEBRA,1,10,5,5,1
GUERRERO,12,AZOYÚ,013,LA PELOTA,2,44,20,24,3
GUERRERO,12,AZOYÚ,013,LOMAS DEL VIDAL (EL VIDAL),1,15,6,9,1
GUERRERO,12,AZOYÚ,013,LOS CHEGÜES,3,31,12,19,3
GUERRERO,12,AZOYÚ,013,LOS METATES,2,21,9,12,2
GUERRERO,12,AZOYÚ,013,LOS QUITERIOS,1,15,7,8,1
GUERRERO,12,AZOYÚ,013,MAXMADI,3,172,86,86,12
GUERRERO,12,AZOYÚ,013,QUETZALAPA,7,495,265,230,38
GUERRERO,12,AZOYÚ,013,SAN ISIDRO EL PUENTE (EL PUENTE),3,183,84,99,12
GUERRERO,12,AZOYÚ,013,TALAPILLA,2,56,31,25,4
GUERRERO,12,AZOYÚ,013,TENANGO,3,86,45,41,8
GUERRERO,12,AZOYÚ,013,ZAPOTITLÁN DE LA FUENTE (EL ZAPOTE),3,113,52,61,11
GUERRERO,12,BENITO JUÁREZ,014,ARENAL DE ÁLVAREZ (ARENAL DE PACO),3,193,104,89,16
GUERRERO,12,BENITO JUÁREZ,014,ARENAL DE GÓMEZ (PRIMER ARENAL),2,95,39,56,8
GUERRERO,12,BENITO JUÁREZ,014,ARENAL DEL CENTRO (LA MÁQUINA),4,183,84,99,16
GUERRERO,12,BENITO JUÁREZ,014,EL TOMATAL,2,22,11,11,2
GUERRERO,12,BENITO JUÁREZ,014,HACIENDA DE CABAÑAS,6,282,141,141,24
GUERRERO,12,BENITO JUÁREZ,014,LAS TUNAS,3,187,86,101,19
GUERRERO,12,BENITO JUÁREZ,014,LLANO DE LA PUERTA,2,31,14,17,3
GUERRERO,12,BENITO JUÁREZ,014,LLANO REAL (EL DORADO),3,89,44,45,7
GUERRERO,12,BENITO JUÁREZ,014,LOS ÓRGANOS,2,15,6,9,2
GUERRERO,12,BENITO JUÁREZ,014,PARAÍSO ESCONDIDO (PLAYA PARAÍSO),1,8,2,6,1
GUERRERO,12,BENITO JUÁREZ,014,SAN JERÓNIMO DE JUÁREZ,15,2332,1238,1094,166
GUERRERO,12,BUENAVISTA DE CUÉLLAR,015,BUENAVISTA DE CUÉLLAR,14,1469,757,712,115
GUERRERO,12,BUENAVISTA DE CUÉLLAR,015,CIENEGUILLAS,2,24,12,12,4
GUERRERO,12,BUENAVISTA DE CUÉLLAR,015,COXCATLÁN,3,160,82,78,13
GUERRERO,12,BUENAVISTA DE CUÉLLAR,015,EL PLATANAL (EL PLATANAR),2,17,8,9,2
GUERRERO,12,BUENAVISTA DE CUÉLLAR,015,LOS AMATES,4,48,25,23,9
GUERRERO,12,BUENAVISTA DE CUÉLLAR,015,LOS EPAZOTES,2,5,2,3,1
GUERRERO,12,BUENAVISTA DE CUÉLLAR,015,LOS LIMONES,2,3,1,2,1
GUERRERO,12,BUENAVISTA DE CUÉLLAR,015,PALMILLAS,4,268,138,130,16
GUERRERO,12,BUENAVISTA DE CUÉLLAR,015,SANTA FE TEPETLAPA,4,262,128,134,17
GUERRERO,12,BUENAVISTA DE CUÉLLAR,015,VENTA DE LA NEGRA,2,22,13,9,2
GUERRERO,12,BUENAVISTA DE CUÉLLAR,015,ZACAPALCO,3,159,82,77,12
GUERRERO,12,COAHUAYUTLA DE JOSÉ MARÍA IZAZAGA,016,AMATEPEC,2,15,7,8,2
GUERRERO,12,COAHUAYUTLA DE JOSÉ MARÍA IZAZAGA,016,ANTONSIMÓN (EL CANAL),1,18,9,9,1
GUERRERO,12,COAHUAYUTLA DE JOSÉ MARÍA IZAZAGA,016,BARRIO DE GUZMÁN (EL LIMÓN),3,81,42,39,5
GUERRERO,12,COAHUAYUTLA DE JOSÉ MARÍA IZAZAGA,016,BARRIO DE LOZANO (EL ROSARIO),3,76,32,44,5
GUERRERO,12,COAHUAYUTLA DE JOSÉ MARÍA IZAZAGA,016,CAMINO REAL,1,18,9,9,1
GUERRERO,12,COAHUAYUTLA DE JOSÉ MARÍA IZAZAGA,016,COAHUAYUTLA DE GUERRERO,6,534,251,283,35
GUERRERO,12,COAHUAYUTLA DE JOSÉ MARÍA IZAZAGA,016,COLMENEROS,3,26,14,12,3
GUERRERO,12,COAHUAYUTLA DE JOSÉ MARÍA IZAZAGA,016,CUAUHTÉMOC,1,35,17,18,2
GUERRERO,12,COAHUAYUTLA DE JOSÉ MARÍA IZAZAGA,016,EL AGUACATE,3,63,40,23,5
GUERRERO,12,COAHUAYUTLA DE JOSÉ MARÍA IZAZAGA,016,EL JAZMÍN,3,98,47,51,7
GUERRERO,12,COAHUAYUTLA DE JOSÉ MARÍA IZAZAGA,016,EL MAGUEY,1,10,3,7,1
GUERRERO,12,COAHUAYUTLA DE JOSÉ MARÍA IZAZAGA,016,EL NARANJO,3,37,13,24,4
GUERRERO,12,COAHUAYUTLA DE JOSÉ MARÍA IZAZAGA,016,EL PANTANO,2,43,27,16,3
GUERRERO,12,COAHUAYUTLA DE JOSÉ MARÍA IZAZAGA,016,EL PLATANILLO,2,54,28,26,3
GUERRERO,12,COAHUAYUTLA DE JOSÉ MARÍA IZAZAGA,016,EL REPARITO,1,7,5,2,1
GUERRERO,12,COAHUAYUTLA DE JOSÉ MARÍA IZAZAGA,016,EL REPARO,1,5,4,1,1
GUERRERO,12,COAHUAYUTLA DE JOSÉ MARÍA IZAZAGA,016,EL ZOPILOTE,2,173,83,90,9
GUERRERO,12,COAHUAYUTLA DE JOSÉ MARÍA IZAZAGA,016,GALEANA DE ABAJO,4,97,40,57,7
GUERRERO,12,COAHUAYUTLA DE JOSÉ MARÍA IZAZAGA,016,HUIZILA,2,22,11,11,3
GUERRERO,12,COAHUAYUTLA DE JOSÉ MARÍA IZAZAGA,016,LA COFRADÍA,1,10,4,6,1
GUERRERO,12,COAHUAYUTLA DE JOSÉ MARÍA IZAZAGA,016,LA HIGUERITA,1,45,23,22,2
GUERRERO,12,COAHUAYUTLA DE JOSÉ MARÍA IZAZAGA,016,LA PAROTITA,2,25,15,10,2
GUERRERO,12,COAHUAYUTLA DE JOSÉ MARÍA IZAZAGA,016,LA PROVIDENCIA (CORONGORO),1,19,11,8,2
GUERRERO,12,COAHUAYUTLA DE JOSÉ MARÍA IZAZAGA,016,LA SOLEDAD (HUARACIO),4,83,46,37,6
GUERRERO,12,COAHUAYUTLA DE JOSÉ MARÍA IZAZAGA,016,LA VAINILLA,3,69,34,35,5
GUERRERO,12,COAHUAYUTLA DE JOSÉ MARÍA IZAZAGA,016,LAS BALSAS,3,78,42,36,6
GUERRERO,12,COAHUAYUTLA DE JOSÉ MARÍA IZAZAGA,016,LAS CARRETAS,2,7,2,5,1
GUERRERO,12,COAHUAYUTLA DE JOSÉ MARÍA IZAZAGA,016,LAS CATARINAS,2,27,12,15,2
GUERRERO,12,COAHUAYUTLA DE JOSÉ MARÍA IZAZAGA,016,LAS HABILLAS,2,9,7,2,1
GUERRERO,12,COAHUAYUTLA DE JOSÉ MARÍA IZAZAGA,016,LAS JUNTAS DE BUSTOS (LAS JUNTAS),1,13,8,5,1
GUERRERO,12,COAHUAYUTLA DE JOSÉ MARÍA IZAZAGA,016,LAS MINITAS,1,7,3,4,1
GUERRERO,12,COAHUAYUTLA DE JOSÉ MARÍA IZAZAGA,016,LOMAS BLANCAS,2,35,16,19,3
GUERRERO,12,COAHUAYUTLA DE JOSÉ MARÍA IZAZAGA,016,MATAMOROS,3,67,27,40,4
GUERRERO,12,COAHUAYUTLA DE JOSÉ MARÍA IZAZAGA,016,MOLINITO,1,6,0,6,1
GUERRERO,12,COAHUAYUTLA DE JOSÉ MARÍA IZAZAGA,016,NUEVA CUADRILLA,3,196,97,99,10
GUERRERO,12,COAHUAYUTLA DE JOSÉ MARÍA IZAZAGA,016,OLIVARES,1,25,16,9,2
GUERRERO,12,COAHUAYUTLA DE JOSÉ MARÍA IZAZAGA,016,PASO DE VACAS,2,43,24,19,2
GUERRERO,12,COAHUAYUTLA DE JOSÉ MARÍA IZAZAGA,016,PLATANILLO,1,31,12,19,2
GUERRERO,12,COAHUAYUTLA DE JOSÉ MARÍA IZAZAGA,016,POTRERITOS,1,13,4,9,1
GUERRERO,12,COAHUAYUTLA DE JOSÉ MARÍA IZAZAGA,016,POTRERO DE OLIVARES (POTRERO DE ARRIBA),1,42,25,17,2
GUERRERO,12,COAHUAYUTLA DE JOSÉ MARÍA IZAZAGA,016,PUERTO DEL CARRIZO (EL PUERTO),3,46,25,21,4
GUERRERO,12,COAHUAYUTLA DE JOSÉ MARÍA IZAZAGA,016,QUIRINGUCUA,2,15,4,11,1
GUERRERO,12,COAHUAYUTLA DE JOSÉ MARÍA IZAZAGA,016,SAN ANTONIO,2,22,14,8,2
GUERRERO,12,COAHUAYUTLA DE JOSÉ MARÍA IZAZAGA,016,SAN CRISTÓBAL,3,49,22,27,5
GUERRERO,12,COAHUAYUTLA DE JOSÉ MARÍA IZAZAGA,016,SAN ISIDRO EL GALLO (EL GALLO),1,8,1,7,1
GUERRERO,12,COAHUAYUTLA DE JOSÉ MARÍA IZAZAGA,016,SAN JOSÉ ANOTA,3,81,39,42,6
GUERRERO,12,COAHUAYUTLA DE JOSÉ MARÍA IZAZAGA,016,SAN RAFAEL (SAN RAFAEL DE LÓPEZ),2,31,13,18,3
GUERRERO,12,COAHUAYUTLA DE JOSÉ MARÍA IZAZAGA,016,SANTA RITA (SANTA RITA DE CASIA),1,16,9,7,1
GUERRERO,12,COAHUAYUTLA DE JOSÉ MARÍA IZAZAGA,016,SANTA ROSA,1,4,2,2,1
GUERRERO,12,COAHUAYUTLA DE JOSÉ MARÍA IZAZAGA,016,TRES PALOS,1,13,6,7,1
GUERRERO,12,COAHUAYUTLA DE JOSÉ MARÍA IZAZAGA,016,VALLE GRANDE,1,15,10,5,1
GUERRERO,12,COAHUAYUTLA DE JOSÉ MARÍA IZAZAGA,016,VALLE NUEVO,2,10,2,8,2
GUERRERO,12,COAHUAYUTLA DE JOSÉ MARÍA IZAZAGA,016,ZOYATÁN,3,60,25,35,5
GUERRERO,12,COCULA,017,ACALMANTLILA,2,60,30,30,5
GUERRERO,12,COCULA,017,APANGO,2,77,45,32,7
GUERRERO,12,COCULA,017,APIPILULCO,2,159,74,85,13
GUERRERO,12,COCULA,017,ATLIXTAC,6,392,191,201,30
GUERRERO,12,COCULA,017,ATZCALA,3,321,152,169,14
GUERRERO,12,COCULA,017,BALSAS NORTE,1,185,94,91,6
GUERRERO,12,COCULA,017,COCULA,14,2038,969,1069,151
GUERRERO,12,COCULA,017,COLONIA TOMÁS GÓMEZ (EL TRIUNFO),1,18,8,10,2
GUERRERO,12,COCULA,017,CUETZALA DE LA REFORMA,2,24,11,13,2
GUERRERO,12,COCULA,017,EL MACHITO DE LAS FLORES,3,34,14,20,3
GUERRERO,12,COCULA,017,EL MUNICIPIO (TIJUANITA),3,87,37,50,10
GUERRERO,12,COCULA,017,EL REAL DEL LIMÓN,2,94,49,45,5
GUERRERO,12,COCULA,017,LA FUNDICIÓN,3,171,81,90,7
GUERRERO,12,COCULA,017,MOHONERA,2,45,20,25,6
GUERRERO,12,COCULA,017,NUEVO BALSAS,4,485,235,250,25
GUERRERO,12,COCULA,017,PUENTE RÍO SAN JUAN,3,72,38,34,7
GUERRERO,12,COCULA,017,SAN NICOLÁS,2,24,13,11,2
GUERRERO,12,COCULA,017,TECOMATLÁN,3,73,32,41,7
GUERRERO,12,COCULA,017,TLANIPATLÁN,4,199,98,101,16
GUERRERO,12,COCULA,017,XONACATLA,3,30,16,14,5
GUERRERO,12,COPALA,018,ATRIXCO,4,300,156,144,16
GUERRERO,12,COPALA,018,CAMPANILLA,1,35,16,19,2
GUERRERO,12,COPALA,018,COLONIA JUAN N. ÁLVAREZ (PLAYA VENTURA),3,135,69,66,8
GUERRERO,12,COPALA,018,COMUNIDAD GENERAL ENRIQUE RODRÍGUEZ [EL CAMPAMENTO],2,47,19,28,4
GUERRERO,12,COPALA,018,COPALA,16,2013,1007,1006,116
GUERRERO,12,COPALA,018,EL CARRIZO,3,172,93,79,11
GUERRERO,12,COPALA,018,EL FOGÓN,1,5,1,4,1
GUERRERO,12,COPALA,018,EL PAPAYO,2,25,15,10,2
GUERRERO,12,COPALA,018,ISLALTEPEC (LAS PAROTAS),2,81,40,41,7
GUERRERO,12,COPALA,018,LA CAÑADA DEL ARROZ,5,91,47,44,8
GUERRERO,12,COPALA,018,LA FORTUNA (LA YEGUADA),2,27,16,11,3
GUERRERO,12,COPALA,018,LAS LAJAS,3,95,46,49,8
GUERRERO,12,COPALA,018,LAS PEÑAS,3,188,94,94,12
GUERRERO,12,COPALA,018,LOS LIRIOS,1,12,7,5,2
GUERRERO,12,COPALA,018,OJO DE AGUA (LAS SALINAS),6,519,281,238,54
GUERRERO,12,COPALA,018,SAN FRANCISCO,2,45,22,23,4
GUERRERO,12,COPALILLO,019,ACINGO,3,120,58,62,7
GUERRERO,12,COPALILLO,019,AHUAXTITLÁN,2,10,4,6,2
GUERRERO,12,COPALILLO,019,CASCALOTERA,3,55,31,24,5
GUERRERO,12,COPALILLO,019,CHIMALACACINGO,3,255,121,134,10
GUERRERO,12,COPALILLO,019,COLONIA ALTA VISTA,2,11,9,2,2
GUERRERO,12,COPALILLO,019,COPALILLO,14,2019,1016,1003,104
GUERRERO,12,COPALILLO,019,EL CASCALOTE,2,95,50,45,5
GUERRERO,12,COPALILLO,019,HUEYATLSALE,2,28,14,14,4
GUERRERO,12,COPALILLO,019,HUEYIATL,3,141,67,74,9
GUERRERO,12,COPALILLO,019,LAS MINAS,1,19,11,8,2
GUERRERO,12,COPALILLO,019,MEZQUITLÁN,3,170,93,77,11
GUERRERO,12,COPALILLO,019,PAPALUTLA,4,153,74,79,11
GUERRERO,12,COPALILLO,019,PEPERUCHES,2,6,2,4,2
GUERRERO,12,COPALILLO,019,SAN FRANCISCO OZTUTLA,8,482,242,240,29
GUERRERO,12,COPALILLO,019,SAN MIGUEL MEZQUITEPEC,2,80,43,37,4
GUERRERO,12,COPALILLO,019,TENANTITLÁN,2,41,18,23,3
GUERRERO,12,COPALILLO,019,TETLAJCO,3,13,8,5,2
GUERRERO,12,COPALILLO,019,TLALCOZOTITLÁN,4,373,198,175,21
GUERRERO,12,COPALILLO,019,TLAYAHUALCO,2,84,44,40,4
GUERRERO,12,COPALILLO,019,ZACUALPA,3,23,9,14,3
GUERRERO,12,COPALILLO,019,ZICAPA,3,107,57,50,9
GUERRERO,12,COPANATOYAC,020,AHUASTEPEC,1,24,10,14,1
GUERRERO,12,COPANATOYAC,020,BUENA VISTA,2,57,33,24,4
GUERRERO,12,COPANATOYAC,020,CACAHUATEPEC,3,299,144,155,12
GUERRERO,12,COPANATOYAC,020,COLONIA LA REFORMA,2,36,16,20,2
GUERRERO,12,COPANATOYAC,020,COLONIA SANTA CRUZ,2,40,18,22,2
GUERRERO,12,COPANATOYAC,020,COLONIA VISTA HERMOSA,1,12,9,3,1
GUERRERO,12,COPANATOYAC,020,COPANATOYAC,9,1104,582,522,55
GUERRERO,12,COPANATOYAC,020,COSTILLA DEL CERRO,2,79,40,39,5
GUERRERO,12,COPANATOYAC,020,COZONDIAPA,2,59,33,26,3
GUERRERO,12,COPANATOYAC,020,CUAUTOLOLO,3,192,98,94,10
GUERRERO,12,COPANATOYAC,020,EL CRUCERO DE OZTOCINGO,2,35,18,17,2
GUERRERO,12,COPANATOYAC,020,EL PLATANAR,2,53,20,33,2
GUERRERO,12,COPANATOYAC,020,GUACAMAYA,2,70,35,35,3
GUERRERO,12,COPANATOYAC,020,LA ASUNCIÓN,1,17,9,8,1
GUERRERO,12,COPANATOYAC,020,LA CONCEPCIÓN,2,46,20,26,3
GUERRERO,12,COPANATOYAC,020,LA TRINCHERA,2,53,28,25,3
GUERRERO,12,COPANATOYAC,020,LAS CRUCES,1,9,4,5,1
GUERRERO,12,COPANATOYAC,020,LOMA BONITA,3,86,42,44,4
GUERRERO,12,COPANATOYAC,020,OCOAPA,5,371,188,183,25
GUERRERO,12,COPANATOYAC,020,OCOTEPEC,3,173,76,97,11
GUERRERO,12,COPANATOYAC,020,OCOTEQUILA,4,442,227,215,23
GUERRERO,12,COPANATOYAC,020,OCOTILLO,1,17,5,12,2
GUERRERO,12,COPANATOYAC,020,OZTOCINGO,4,229,119,110,13
GUERRERO,12,COPANATOYAC,020,PATLICHA,4,193,97,96,10
GUERRERO,12,COPANATOYAC,020,PLAN DE SAN JUAN,2,44,29,15,3
GUERRERO,12,COPANATOYAC,020,PLAN DE SAN MIGUEL,3,97,51,46,6
GUERRERO,12,COPANATOYAC,020,PLAN LAGUNILLA,2,103,49,54,5
GUERRERO,12,COPANATOYAC,020,POTOICHÁN,4,705,361,344,39
GUERRERO,12,COPANATOYAC,020,QUIAHUILTEPEC,2,67,35,32,3
GUERRERO,12,COPANATOYAC,020,RANCHO ESCONDIDO,2,96,59,37,4
GUERRERO,12,COPANATOYAC,020,SAN VICENTE AMOLE,3,244,103,141,11
GUERRERO,12,COPANATOYAC,020,SANTA ANITA,2,285,155,130,12
GUERRERO,12,COPANATOYAC,020,SANTA CRUZ,4,137,68,69,10
GUERRERO,12,COPANATOYAC,020,TEHUISKOJTLA,1,64,35,29,2
GUERRERO,12,COPANATOYAC,020,TENEXCALCINGO,2,70,33,37,4
GUERRERO,12,COPANATOYAC,020,TLACOTEPEC,2,86,43,43,4
GUERRERO,12,COPANATOYAC,020,TLALQUETZALAPA,4,262,143,119,15
GUERRERO,12,COPANATOYAC,020,TOTOHUEHUETLÁN,2,108,50,58,5
GUERRERO,12,COPANATOYAC,020,XITOMATLA,2,51,30,21,3
GUERRERO,12,COPANATOYAC,020,YELOTEPEC,2,39,19,20,3
GUERRERO,12,COPANATOYAC,020,ZACAIXTLAHUACÁN,2,94,50,44,5
GUERRERO,12,COPANATOYAC,020,ZACAZONAPA,2,51,22,29,3
GUERRERO,12,COYUCA DE BENÍTEZ,021,AGUA ZARCA,3,215,101,114,13
GUERRERO,12,COYUCA DE BENÍTEZ,021,AGUAS BLANCAS,6,414,211,203,33
GUERRERO,12,COYUCA DE BENÍTEZ,021,ATOYAQUILLO,4,106,51,55,9
GUERRERO,12,COYUCA DE BENÍTEZ,021,BAJOS DEL EJIDO,8,1253,630,623,70
GUERRERO,12,COYUCA DE BENÍTEZ,021,BARRIO NUEVO,1,18,5,13,2
GUERRERO,12,COYUCA DE BENÍTEZ,021,BARRIO NUEVO DEL PROGRESO,3,217,104,113,12
GUERRERO,12,COYUCA DE BENÍTEZ,021,BARRIO NUEVO LA LAJA,1,1,0,1,1
GUERRERO,12,COYUCA DE BENÍTEZ,021,CAHUATITÁN,2,41,19,22,4
GUERRERO,12,COYUCA DE BENÍTEZ,021,CARRERA LARGA,2,50,22,28,4
GUERRERO,12,COYUCA DE BENÍTEZ,021,CERRITO DE ORO,3,130,67,63,12
GUERRERO,12,COYUCA DE BENÍTEZ,021,COLONIA AURELIO V. GUINTO (EL HUAMUCHITO),2,42,22,20,5
GUERRERO,12,COYUCA DE BENÍTEZ,021,COLONIA BRASILIA,2,53,23,30,4
GUERRERO,12,COYUCA DE BENÍTEZ,021,COLONIA DEL RÍO,3,70,31,39,5
GUERRERO,12,COYUCA DE BENÍTEZ,021,COLONIA LÁZARO CÁRDENAS,2,113,52,61,8
GUERRERO,12,COYUCA DE BENÍTEZ,021,COLONIA LUCES EN EL MAR,2,159,84,75,10
GUERRERO,12,COYUCA DE BENÍTEZ,021,COYUCA DE BENÍTEZ,26,4599,2289,2310,315
GUERRERO,12,COYUCA DE BENÍTEZ,021,CUALOTES (LOS CUAULOTES),1,5,1,4,1
GUERRERO,12,COYUCA DE BENÍTEZ,021,EJIDO VIEJO,3,227,117,110,15
GUERRERO,12,COYUCA DE BENÍTEZ,021,EL AGUACATE,1,11,7,4,1
GUERRERO,12,COYUCA DE BENÍTEZ,021,EL BEJUCO,3,76,32,44,8
GUERRERO,12,COYUCA DE BENÍTEZ,021,EL BORDONAL,3,97,44,53,10
GUERRERO,12,COYUCA DE BENÍTEZ,021,EL CAMALOTE,2,76,40,36,5
GUERRERO,12,COYUCA DE BENÍTEZ,021,EL CARRIZAL,3,107,41,66,9
GUERRERO,12,COYUCA DE BENÍTEZ,021,EL CAYACO,3,201,93,108,14
GUERRERO,12,COYUCA DE BENÍTEZ,021,EL CONCHERO,3,236,117,119,16
GUERRERO,12,COYUCA DE BENÍTEZ,021,EL EMBARCADERO,3,340,160,180,20
GUERRERO,12,COYUCA DE BENÍTEZ,021,EL ESPINALILLO,4,342,170,172,21
GUERRERO,12,COYUCA DE BENÍTEZ,021,EL HUAMÚCHIL,3,73,24,49,5
GUERRERO,12,COYUCA DE BENÍTEZ,021,EL PAPAYO,5,447,218,229,39
GUERRERO,12,COYUCA DE BENÍTEZ,021,EL PORVENIR,4,49,27,22,5
GUERRERO,12,COYUCA DE BENÍTEZ,021,EL TERRERO,4,126,69,57,11
GUERRERO,12,COYUCA DE BENÍTEZ,021,EL ZAPOTE,3,111,54,57,8
GUERRERO,12,COYUCA DE BENÍTEZ,021,ENCINOS PRIETOS,3,36,23,13,5
GUERRERO,12,COYUCA DE BENÍTEZ,021,HUERTECILLAS,3,14,4,10,5
GUERRERO,12,COYUCA DE BENÍTEZ,021,KILÓMETRO DIECISIETE,2,57,30,27,5
GUERRERO,12,COYUCA DE BENÍTEZ,021,LA BARRA (LA BARRA DE COYUCA),2,122,52,70,6
GUERRERO,12,COYUCA DE BENÍTEZ,021,LA FELICIDAD DE ROSALES,3,134,66,68,8
GUERRERO,12,COYUCA DE BENÍTEZ,021,LA LIMA,2,54,31,23,5
GUERRERO,12,COYUCA DE BENÍTEZ,021,LA REMONTITA,3,75,38,37,6
GUERRERO,12,COYUCA DE BENÍTEZ,021,LAS CHIRIPAS,3,10,8,2,3
GUERRERO,12,COYUCA DE BENÍTEZ,021,LAS COMPUERTAS,4,359,177,182,15
GUERRERO,12,COYUCA DE BENÍTEZ,021,LAS HUMEDADES,3,42,25,17,4
GUERRERO,12,COYUCA DE BENÍTEZ,021,LAS LOMAS,2,80,45,35,8
GUERRERO,12,COYUCA DE BENÍTEZ,021,LAS LOMITAS,4,124,54,70,9
GUERRERO,12,COYUCA DE BENÍTEZ,021,LAS PULGAS,3,46,21,25,6
GUERRERO,12,COYUCA DE BENÍTEZ,021,LAS TRANQUITAS,1,20,10,10,2
GUERRERO,12,COYUCA DE BENÍTEZ,021,LOS CIMIENTOS,2,54,30,24,4
GUERRERO,12,COYUCA DE BENÍTEZ,021,LOS MOGOTES,4,416,208,208,30
GUERRERO,12,COYUCA DE BENÍTEZ,021,LOS NOPALES,3,132,69,63,9
GUERRERO,12,COYUCA DE BENÍTEZ,021,OCOTILLO,3,195,107,88,17
GUERRERO,12,COYUCA DE BENÍTEZ,021,PASO REAL,3,49,23,26,6
GUERRERO,12,COYUCA DE BENÍTEZ,021,PÉNJAMO,3,126,64,62,10
GUERRERO,12,COYUCA DE BENÍTEZ,021,PLATANILLO,4,553,264,289,26
GUERRERO,12,COYUCA DE BENÍTEZ,021,PLAYA AZUL,2,134,53,81,5
GUERRERO,12,COYUCA DE BENÍTEZ,021,PUEBLO VIEJO,5,367,189,178,20
GUERRERO,12,COYUCA DE BENÍTEZ,021,RANCHO EL SANTO,2,40,21,19,3
GUERRERO,12,COYUCA DE BENÍTEZ,021,SAN ISIDRO,2,29,19,10,3
GUERRERO,12,COYUCA DE BENÍTEZ,021,SAN JOSÉ MOGOLLÓN,3,77,34,43,7
GUERRERO,12,COYUCA DE BENÍTEZ,021,SAN JUAN DEL RÍO,4,181,94,87,13
GUERRERO,12,COYUCA DE BENÍTEZ,021,SAN NICOLÁS,3,172,87,85,11
GUERRERO,12,COYUCA DE BENÍTEZ,021,SAN NICOLÁS DE LAS PLAYAS,2,157,72,85,9
GUERRERO,12,COYUCA DE BENÍTEZ,021,SAN SALVADOR DE LAS POZAS,4,328,156,172,19
GUERRERO,12,COYUCA DE BENÍTEZ,021,SANTA CRUZ DEL RÍO,2,11,7,4,2
GUERRERO,12,COYUCA DE BENÍTEZ,021,SANTA ROSA DE LIMA,4,137,72,65,11
GUERRERO,12,COYUCA DE BENÍTEZ,021,TECOMAPA,3,49,27,22,4
GUERRERO,12,COYUCA DE BENÍTEZ,021,TEPETIXTLA,8,813,435,378,46
GUERRERO,12,COYUCA DE BENÍTEZ,021,TIXTLANCINGO,6,1012,476,536,54
GUERRERO,12,COYUCA DE BENÍTEZ,021,VALLE DEL RÍO,5,346,198,148,20
GUERRERO,12,COYUCA DE BENÍTEZ,021,YERBASANTITA,4,175,91,84,11
GUERRERO,12,COYUCA DE BENÍTEZ,021,YETLA,3,168,73,95,11
GUERRERO,12,COYUCA DE BENÍTEZ,021,ZAPOTILLO,3,112,56,56,8
GUERRERO,12,COYUCA DE CATALÁN,022,AMUCO DE LA REFORMA,6,537,271,266,32
GUERRERO,12,COYUCA DE CATALÁN,022,ANONAS,2,53,32,21,3
GUERRERO,12,COYUCA DE CATALÁN,022,ARCHIMORO,3,27,14,13,3
GUERRERO,12,COYUCA DE CATALÁN,022,ARROYO EL VIEJO,1,9,7,2,1
GUERRERO,12,COYUCA DE CATALÁN,022,ARROYO GRANDE,2,82,35,47,5
GUERRERO,12,COYUCA DE CATALÁN,022,BARRANCA DE SAN JOSÉ (LA BARRANCA),2,9,5,4,1
GUERRERO,12,COYUCA DE CATALÁN,022,CAÑA (LA CAÑA),2,15,5,10,2
GUERRERO,12,COYUCA DE CATALÁN,022,CIÉNEGA DE ABAJO,3,27,13,14,4
GUERRERO,12,COYUCA DE CATALÁN,022,COYOL (EL COYOL),2,43,17,26,4
GUERRERO,12,COYUCA DE CATALÁN,022,COYUCA DE CATALÁN,14,3099,1745,1354,153
GUERRERO,12,COYUCA DE CATALÁN,022,CRUZ AGUA FRÍA (LA CRUZ),2,23,7,16,2
GUERRERO,12,COYUCA DE CATALÁN,022,CUIRINDAL (EL CUIRINDAL),2,19,9,10,4
GUERRERO,12,COYUCA DE CATALÁN,022,EL ANCÓN,2,21,8,13,2
GUERRERO,12,COYUCA DE CATALÁN,022,EL CARRIZAL,1,13,7,6,1
GUERRERO,12,COYUCA DE CATALÁN,022,EL COCO,3,137,73,64,12
GUERRERO,12,COYUCA DE CATALÁN,022,EL CUIRINDALITO,2,19,11,8,3
GUERRERO,12,COYUCA DE CATALÁN,022,EL CUNDANCITO,2,65,38,27,3
GUERRERO,12,COYUCA DE CATALÁN,022,EL DURAZNO,3,91,53,38,7
GUERRERO,12,COYUCA DE CATALÁN,022,EL EMBARCADERO (EL BARCO),2,23,10,13,2
GUERRERO,12,COYUCA DE CATALÁN,022,EL ÍDOLO,3,55,23,32,6
GUERRERO,12,COYUCA DE CATALÁN,022,EL JABALÍ,3,52,34,18,4
GUERRERO,12,COYUCA DE CATALÁN,022,EL LIMÓN POTRERO (EL LIMÓN),3,21,13,8,3
GUERRERO,12,COYUCA DE CATALÁN,022,EL METATE,1,11,7,4,1
GUERRERO,12,COYUCA DE CATALÁN,022,EL MONO,3,81,43,38,6
GUERRERO,12,COYUCA DE CATALÁN,022,EL NARANJO,3,177,84,93,18
GUERRERO,12,COYUCA DE CATALÁN,022,EL PESCADO,1,28,15,13,1
GUERRERO,12,COYUCA DE CATALÁN,022,EL PUERTO DE LAS OLLAS,3,20,8,12,3
GUERRERO,12,COYUCA DE CATALÁN,022,EL PUERTO DEL ORO,2,30,12,18,2
GUERRERO,12,COYUCA DE CATALÁN,022,EL RATÓN,1,14,5,9,1
GUERRERO,12,COYUCA DE CATALÁN,022,EL TERRERO BLANCO (TERRERO),3,28,12,16,4
GUERRERO,12,COYUCA DE CATALÁN,022,EL ZAPOTE,2,11,7,4,1
GUERRERO,12,COYUCA DE CATALÁN,022,HACIENDA DE DOLORES,2,22,13,9,2
GUERRERO,12,COYUCA DE CATALÁN,022,JARIPO,3,91,47,44,8
GUERRERO,12,COYUCA DE CATALÁN,022,JUNTAS DEL RÍO FRÍO,3,49,25,24,8
GUERRERO,12,COYUCA DE CATALÁN,022,LA BAJADA,3,100,47,53,8
GUERRERO,12,COYUCA DE CATALÁN,022,LA BOLSA,1,16,9,7,1
GUERRERO,12,COYUCA DE CATALÁN,022,LA CAÑITA,1,15,7,8,3
GUERRERO,12,COYUCA DE CATALÁN,022,LA CRUZ DEL RÍO BALSAS,1,10,6,4,1
GUERRERO,12,COYUCA DE CATALÁN,022,LA HIGUERITA,2,10,4,6,1
GUERRERO,12,COYUCA DE CATALÁN,022,LA MAESTRANZA,1,8,4,4,1
GUERRERO,12,COYUCA DE CATALÁN,022,LA PAROTITA,3,34,14,20,5
GUERRERO,12,COYUCA DE CATALÁN,022,LA PUERTA GRANDE (LA PUERTA),2,21,11,10,2
GUERRERO,12,COYUCA DE CATALÁN,022,LA QUESERÍA,2,11,3,8,3
GUERRERO,12,COYUCA DE CATALÁN,022,LA SOLEDAD (LA CHOLE),2,11,6,5,2
GUERRERO,12,COYUCA DE CATALÁN,022,LA ZAPOTERA,3,7,4,3,4
GUERRERO,12,COYUCA DE CATALÁN,022,LAS CRUCES,3,138,63,75,12
GUERRERO,12,COYUCA DE CATALÁN,022,LAS JUNTAS DEL RÍO CHIQUITO (LAS JUNTAS),2,77,41,36,8
GUERRERO,12,COYUCA DE CATALÁN,022,LAS MESAS DE PINEDA,3,97,51,46,9
GUERRERO,12,COYUCA DE CATALÁN,022,LAS PAROTAS,4,24,11,13,4
GUERRERO,12,COYUCA DE CATALÁN,022,LAS TINAJAS,3,140,69,71,10
GUERRERO,12,COYUCA DE CATALÁN,022,LAS TRINCHERAS,3,21,8,13,3
GUERRERO,12,COYUCA DE CATALÁN,022,LOS CIRUELOS,1,16,6,10,1
GUERRERO,12,COYUCA DE CATALÁN,022,LOS DIAMANTES,2,16,8,8,3
GUERRERO,12,COYUCA DE CATALÁN,022,LOS MANGOS,3,10,5,5,2
GUERRERO,12,COYUCA DE CATALÁN,022,LOS PANTANOS,2,5,3,2,1
GUERRERO,12,COYUCA DE CATALÁN,022,LOS POZOS,2,16,6,10,2
GUERRERO,12,COYUCA DE CATALÁN,022,LOS TERRONES,2,61,30,31,6
GUERRERO,12,COYUCA DE CATALÁN,022,MANCHÓN DE AMUCO (LLANO DE GUADALUPE),1,7,4,3,1
GUERRERO,12,COYUCA DE CATALÁN,022,MANCHÓN PAROTAS,4,51,29,22,4
GUERRERO,12,COYUCA DE CATALÁN,022,MESA DE YESQUEROS,2,10,5,5,1
GUERRERO,12,COYUCA DE CATALÁN,022,MONTE GRANDE,3,34,16,18,4
GUERRERO,12,COYUCA DE CATALÁN,022,PALO NUEVO,2,95,49,46,4
GUERRERO,12,COYUCA DE CATALÁN,022,PANCIRA,3,37,16,21,4
GUERRERO,12,COYUCA DE CATALÁN,022,PANTOJA,2,31,18,13,3
GUERRERO,12,COYUCA DE CATALÁN,022,PARANCIO,2,30,20,10,3
GUERRERO,12,COYUCA DE CATALÁN,022,PAROTAS DEL MANCHÓN (LAS PAROTAS),2,15,9,6,1
GUERRERO,12,COYUCA DE CATALÁN,022,PASO DE ARENA,6,668,355,313,70
GUERRERO,12,COYUCA DE CATALÁN,022,PATAMBO,3,186,96,90,14
GUERRERO,12,COYUCA DE CATALÁN,022,PIEDRA PARADA,3,58,28,30,6
GUERRERO,12,COYUCA DE CATALÁN,022,PINEDA,2,67,30,37,5
GUERRERO,12,COYUCA DE CATALÁN,022,PINZÁN DULCE,2,8,6,2,3
GUERRERO,12,COYUCA DE CATALÁN,022,PINZÁN MORADO,3,81,35,46,7
GUERRERO,12,COYUCA DE CATALÁN,022,PLACERES DEL ORO,4,280,135,145,18
GUERRERO,12,COYUCA DE CATALÁN,022,POCITOS DE CATANA,2,22,11,11,3
GUERRERO,12,COYUCA DE CATALÁN,022,PUEBLO NUEVO (EL CIRUELO),3,33,16,17,4
GUERRERO,12,COYUCA DE CATALÁN,022,PUNGARABATITO,2,72,30,42,5
GUERRERO,12,COYUCA DE CATALÁN,022,QUIHUIZÍCARO (QUIHUISHÍCARO),2,13,9,4,1
GUERRERO,12,COYUCA DE CATALÁN,022,RINCÓN DE CHÁMACUA,3,51,21,30,6
GUERRERO,12,COYUCA DE CATALÁN,022,RINCÓN DE LA VIRGEN,1,6,2,4,1
GUERRERO,12,COYUCA DE CATALÁN,022,RÍO FLORIDO (LAS ÁNIMAS),3,136,69,67,9
GUERRERO,12,COYUCA DE CATALÁN,022,RÍO FRÍO DE LOS FRESNOS,1,30,19,11,2
GUERRERO,12,COYUCA DE CATALÁN,022,SAN ANTONIO DE LAS TEXAS (LOS PUERTOS),1,53,25,28,4
GUERRERO,12,COYUCA DE CATALÁN,022,SAN FERNANDO (EL TIMBRE),2,20,10,10,2
GUERRERO,12,COYUCA DE CATALÁN,022,SAN ISIDRO,3,43,19,24,4
GUERRERO,12,COYUCA DE CATALÁN,022,SAN JOSÉ (SAN JOSÉ LA QUESERÍA),3,60,27,33,5
GUERRERO,12,COYUCA DE CATALÁN,022,SAN JUAN CHÁMACUA,3,111,52,59,8
GUERRERO,12,COYUCA DE CATALÁN,022,SAN JUAN DE LA CRUZ,3,129,70,59,8
GUERRERO,12,COYUCA DE CATALÁN,022,SANTA GERTRUDIS,3,25,13,12,3
GUERRERO,12,COYUCA DE CATALÁN,022,SANTA TERESA,4,245,122,123,17
GUERRERO,12,COYUCA DE CATALÁN,022,SANTO DOMINGO,4,285,143,142,15
GUERRERO,12,COYUCA DE CATALÁN,022,TARÉTARO,3,99,48,51,7
GUERRERO,12,COYUCA DE CATALÁN,022,TARIO,1,18,8,10,1
GUERRERO,12,COYUCA DE CATALÁN,022,ZETINA,2,25,16,9,3
GUERRERO,12,COYUCA DE CATALÁN,022,ZIHUAQUIO,2,24,9,15,2
GUERRERO,12,CUAJINICUILAPA,023,BARAJILLAS (BARAJILLA),3,190,86,104,11
GUERRERO,12,CUAJINICUILAPA,023,BUENOS AIRES,2,68,36,32,4
GUERRERO,12,CUAJINICUILAPA,023,CALZADA (LA CALZADA),1,4,1,3,1
GUERRERO,12,CUAJINICUILAPA,023,CERRO DE LAS TABLAS,2,43,21,22,3
GUERRERO,12,CUAJINICUILAPA,023,CERRO DEL INDIO (EL INDIO),3,193,103,90,12
GUERRERO,12,CUAJINICUILAPA,023,COLONIA MIGUEL ALEMÁN VALDEZ,4,345,171,174,22
GUERRERO,12,CUAJINICUILAPA,023,COMALTEPEC (COMAL),3,201,93,108,17
GUERRERO,12,CUAJINICUILAPA,023,CUAJINICUILAPA,18,3766,1794,1972,218
GUERRERO,12,CUAJINICUILAPA,023,EL CUIJI (EL CUIJE),2,50,27,23,4
GUERRERO,12,CUAJINICUILAPA,023,EL QUIZÁ,3,135,81,54,6
GUERRERO,12,CUAJINICUILAPA,023,EL TERRERO,4,187,84,103,12
GUERRERO,12,CUAJINICUILAPA,023,EL VAIVÉN,2,46,24,22,3
GUERRERO,12,CUAJINICUILAPA,023,MALDONADO,5,408,199,209,27
GUERRERO,12,CUAJINICUILAPA,023,MONTECILLOS,4,352,180,172,13
GUERRERO,12,CUAJINICUILAPA,023,TIERRA COLORADA,3,164,76,88,10
GUERRERO,12,CUALÁC,024,AGUAXOTLA (PUEBLO VIEJO),2,73,40,33,3
GUERRERO,12,CUALÁC,024,AHUEXITLÁN,1,14,6,8,1
GUERRERO,12,CUALÁC,024,CHIAUCINGO (CHAPANCINGO),3,442,234,208,20
GUERRERO,12,CUALÁC,024,COATLACO,3,202,95,107,15
GUERRERO,12,CUALÁC,024,CUALÁC,4,726,372,354,41
GUERRERO,12,CUALÁC,024,CUATECONZINGO,1,8,5,3,1
GUERRERO,12,CUALÁC,024,CUESCOMAPA,3,69,30,39,5
GUERRERO,12,CUALÁC,024,EL CUAHULOTE,2,89,36,53,6
GUERRERO,12,CUALÁC,024,EL TEZÓQUIO,2,74,27,47,4
GUERRERO,12,CUALÁC,024,LOS PINOS,1,11,4,7,1
GUERRERO,12,CUALÁC,024,NUEVO PARAÍSO,4,103,53,50,7
GUERRERO,12,CUALÁC,024,SAN MARTÍN JOLALPAN,4,210,119,91,14
GUERRERO,12,CUALÁC,024,TECOJCOYUNCA,2,83,38,45,5
GUERRERO,12,CUALÁC,024,TEPOTZCOCINGO,1,13,5,8,1
GUERRERO,12,CUALÁC,024,TLALAPA,3,114,64,50,6
GUERRERO,12,CUALÁC,024,TLALIXTLÁHUAC,1,15,9,6,1
GUERRERO,12,CUALÁC,024,XALMOLAPA,2,39,17,22,3
GUERRERO,12,CUALÁC,024,ZOOTOLO,1,8,1,7,1
GUERRERO,12,CUAUTEPEC,025,BOCACHAHUE,2,21,9,12,2
GUERRERO,12,CUAUTEPEC,025,COACOYULICHÁN,4,547,280,267,29
GUERRERO,12,CUAUTEPEC,025,CUAUTEPEC,6,1307,645,662,66
GUERRERO,12,CUAUTEPEC,025,EL COQUILLO,4,227,110,117,10
GUERRERO,12,CUAUTEPEC,025,EL LÍBANO,2,58,31,27,4
GUERRERO,12,CUAUTEPEC,025,EL LIMONCITO,2,35,17,18,3
GUERRERO,12,CUAUTEPEC,025,EL LLANO,4,191,104,87,9
GUERRERO,12,CUAUTEPEC,025,EL MAGUEY,3,41,23,18,4
GUERRERO,12,CUAUTEPEC,025,EL PABELLÓN,4,325,152,173,21
GUERRERO,12,CUAUTEPEC,025,EL SALTO,3,178,90,88,11
GUERRERO,12,CUAUTEPEC,025,ESTERO DEL MARQUEZ (CACHUMBO),2,32,17,15,4
GUERRERO,12,CUAUTEPEC,025,HUAMUCHITITÁN (EL HUAMUCHITO),3,168,85,83,12
GUERRERO,12,CUAUTEPEC,025,JALAPA,4,449,231,218,33
GUERRERO,12,CUAUTEPEC,025,LA BOCANA,1,4,3,1,1
GUERRERO,12,CUAUTEPEC,025,LA BOCANITA,3,23,15,8,3
GUERRERO,12,CUAUTEPEC,025,LA DICHA,3,366,184,182,21
GUERRERO,12,CUAUTEPEC,025,LAS PAROTAS,2,33,21,12,3
GUERRERO,12,CUAUTEPEC,025,LIMÓN GRANDE,2,21,9,12,2
GUERRERO,12,CUAUTEPEC,025,PASO SALINAS,3,54,21,33,4
GUERRERO,12,CUAUTEPEC,025,SAN AGUSTÍN CUILUTLA (CUILUTLA),3,276,130,146,20
GUERRERO,12,CUAUTEPEC,025,SAN ANTONIO (EL CRUCERO),2,38,19,19,4
GUERRERO,12,CUAUTEPEC,025,SAN JOSÉ LAS PALMAS (SAN JOSÉ),3,79,42,37,7
GUERRERO,12,CUAUTEPEC,025,SANTA CLARA,2,61,33,28,3
GUERRERO,12,CUAUTEPEC,025,VISTA HERMOSA,2,10,5,5,1
GUERRERO,12,CUAUTEPEC,025,ZIHUAPOLOYA,4,98,49,49,6
GUERRERO,12,CUETZALA DEL PROGRESO,026,AHUAXOTITLA,4,163,87,76,13
GUERRERO,12,CUETZALA DEL PROGRESO,026,APETLANCA,4,197,97,100,16
GUERRERO,12,CUETZALA DEL PROGRESO,026,CHILACACHAPA,5,332,170,162,24
GUERRERO,12,CUETZALA DEL PROGRESO,026,CUAXILOTLA,3,65,30,35,8
GUERRERO,12,CUETZALA DEL PROGRESO,026,CUETZALA DEL PROGRESO,6,550,262,288,39
GUERRERO,12,CUETZALA DEL PROGRESO,026,MICHAPA,1,1,0,1,1
GUERRERO,12,CUETZALA DEL PROGRESO,026,MOLONIAL,1,7,3,4,1
GUERRERO,12,CUETZALA DEL PROGRESO,026,OJO DE AGUA,2,3,1,2,1
GUERRERO,12,CUETZALA DEL PROGRESO,026,SAN FRANCISCO LAGUNITA,3,87,44,43,6
GUERRERO,12,CUETZALA DEL PROGRESO,026,TIANQUIZOLCO,4,206,102,104,19
GUERRERO,12,CUETZALA DEL PROGRESO,026,TLACAQUIPA,4,170,82,88,15
GUERRERO,12,CUETZALA DEL PROGRESO,026,TLAQUILPA,2,48,27,21,3
GUERRERO,12,CUETZALA DEL PROGRESO,026,TOMIXTLAHUACÁN,3,26,9,17,7
GUERRERO,12,CUTZAMALA DE PINZÓN,027,ALBOREJO (EL BOREJO),2,20,9,11,2
GUERRERO,12,CUTZAMALA DE PINZÓN,027,ARROYO GRANDE,3,179,87,92,12
GUERRERO,12,CUTZAMALA DE PINZÓN,027,ATOTONILCO,1,13,2,11,1
GUERRERO,12,CUTZAMALA DE PINZÓN,027,BALDERRAMA (ORILLA DE BALDERRAMA),3,132,58,74,9
GUERRERO,12,CUTZAMALA DE PINZÓN,027,CAMUTLA,2,20,11,9,2
GUERRERO,12,CUTZAMALA DE PINZÓN,027,CHARACO,3,29,18,11,4
GUERRERO,12,CUTZAMALA DE PINZÓN,027,CUADRILLA NUEVA,3,87,42,45,8
GUERRERO,12,CUTZAMALA DE PINZÓN,027,CUATACEO,2,16,8,8,2
GUERRERO,12,CUTZAMALA DE PINZÓN,027,CUIRINDICHAPIO,3,54,29,25,4
GUERRERO,12,CUTZAMALA DE PINZÓN,027,CUTZAMALA DE PINZÓN,11,1542,799,743,111
GUERRERO,12,CUTZAMALA DE PINZÓN,027,EL COYOL,1,2,0,2,1
GUERRERO,12,CUTZAMALA DE PINZÓN,027,EL CUNDÁN,1,17,10,7,1
GUERRERO,12,CUTZAMALA DE PINZÓN,027,EL GUARICHE (EL GUARICHI),3,20,11,9,3
GUERRERO,12,CUTZAMALA DE PINZÓN,027,EL GUAYABO,2,35,18,17,3
GUERRERO,12,CUTZAMALA DE PINZÓN,027,EL OJO DE AGUA,3,28,14,14,3
GUERRERO,12,CUTZAMALA DE PINZÓN,027,EL PINZÁN,3,93,48,45,6
GUERRERO,12,CUTZAMALA DE PINZÓN,027,EL POCHOTE,1,31,15,16,2
GUERRERO,12,CUTZAMALA DE PINZÓN,027,EL REMUDADERO,2,29,15,14,3
GUERRERO,12,CUTZAMALA DE PINZÓN,027,EL SALITRE,1,6,5,1,1
GUERRERO,12,CUTZAMALA DE PINZÓN,027,EL SALITRE (SIRAPITIRO),3,90,52,38,8
GUERRERO,12,CUTZAMALA DE PINZÓN,027,EL TEPEHUAJE (TEPEHUAJE GRANDE),1,6,4,2,1
GUERRERO,12,CUTZAMALA DE PINZÓN,027,EL TIMBINAL,1,18,6,12,1
GUERRERO,12,CUTZAMALA DE PINZÓN,027,EL TULE,1,16,6,10,1
GUERRERO,12,CUTZAMALA DE PINZÓN,027,HUARATZIO,2,35,15,20,3
GUERRERO,12,CUTZAMALA DE PINZÓN,027,IXTAPILLA,4,143,77,66,11
GUERRERO,12,CUTZAMALA DE PINZÓN,027,LA CAÑADA (LA CAÑADA Y EL PINZÁN),2,68,33,35,4
GUERRERO,12,CUTZAMALA DE PINZÓN,027,LA CIÉNEGA,1,6,1,5,1
GUERRERO,12,CUTZAMALA DE PINZÓN,027,LA COMUNIDAD,2,61,37,24,5
GUERRERO,12,CUTZAMALA DE PINZÓN,027,LA FAJILLA,1,13,8,5,1
GUERRERO,12,CUTZAMALA DE PINZÓN,027,LA FLORIDA,2,38,17,21,3
GUERRERO,12,CUTZAMALA DE PINZÓN,027,LA JOYA,3,38,17,21,3
GUERRERO,12,CUTZAMALA DE PINZÓN,027,LA LAJA DEL REAL [LAJITA],2,33,16,17,2
GUERRERO,12,CUTZAMALA DE PINZÓN,027,LA MOHONERA (LA MONERA),3,63,36,27,4
GUERRERO,12,CUTZAMALA DE PINZÓN,027,LA PALMITA (SAN JOSÉ LA PALMITA),2,16,12,4,2
GUERRERO,12,CUTZAMALA DE PINZÓN,027,LA PLAYA Y ANEXOS,2,42,27,15,3
GUERRERO,12,CUTZAMALA DE PINZÓN,027,LA PUCHIMITA (LA RAISUDA),1,1,1,0,1
GUERRERO,12,CUTZAMALA DE PINZÓN,027,LA SOLEDAD,1,9,4,5,1
GUERRERO,12,CUTZAMALA DE PINZÓN,027,LAS JUNTAS DEL ROSARIO,2,10,6,4,2
GUERRERO,12,CUTZAMALA DE PINZÓN,027,LIMÓN GRANDE,2,45,20,25,3
GUERRERO,12,CUTZAMALA DE PINZÓN,027,LOMA BONITA,3,62,34,28,6
GUERRERO,12,CUTZAMALA DE PINZÓN,027,LOS CAPIRES,3,63,33,30,5
GUERRERO,12,CUTZAMALA DE PINZÓN,027,LOS DESPOSADOS,2,27,14,13,3
GUERRERO,12,CUTZAMALA DE PINZÓN,027,LOS TULES,2,22,10,12,2
GUERRERO,12,CUTZAMALA DE PINZÓN,027,NUEVO AMILPILLAS (MILPILLAS),1,10,3,7,1
GUERRERO,12,CUTZAMALA DE PINZÓN,027,NUEVO GALEANA,3,132,68,64,11
GUERRERO,12,CUTZAMALA DE PINZÓN,027,OXTOTITLÁN (TOTITLÁN),3,47,23,24,4
GUERRERO,12,CUTZAMALA DE PINZÓN,027,PÁCUARO,1,13,8,5,1
GUERRERO,12,CUTZAMALA DE PINZÓN,027,PASO REAL,1,9,7,2,1
GUERRERO,12,CUTZAMALA DE PINZÓN,027,PIÑUELA,1,5,3,2,2
GUERRERO,12,CUTZAMALA DE PINZÓN,027,RINCÓN DE TUPATARILLO,2,19,9,10,2
GUERRERO,12,CUTZAMALA DE PINZÓN,027,SAN BLAS,1,7,4,3,1
GUERRERO,12,CUTZAMALA DE PINZÓN,027,SAN JOSÉ,2,34,14,20,3
GUERRERO,12,CUTZAMALA DE PINZÓN,027,TAMÁCUARO,3,138,67,71,14
GUERRERO,12,CUTZAMALA DE PINZÓN,027,TUCURUATO,1,3,1,2,1
GUERRERO,12,CUTZAMALA DE PINZÓN,027,TUPATARILLO (TUPATARIO),2,80,34,46,6
GUERRERO,12,CUTZAMALA DE PINZÓN,027,ZACANGO,2,36,20,16,2
GUERRERO,12,CUTZAMALA DE PINZÓN,027,ZACAPUATO (TEPETATES),4,385,209,176,30
GUERRERO,12,CUTZAMALA DE PINZÓN,027,ZIRANDANGANGUÍO,2,10,4,6,2
GUERRERO,12,CHILAPA DE ÁLVAREZ,028,ACAHUEHUETLÁN,3,105,54,51,7
GUERRERO,12,CHILAPA DE ÁLVAREZ,028,ACALCO,10,635,341,294,37
GUERRERO,12,CHILAPA DE ÁLVAREZ,028,ACATLÁN,8,751,383,368,45
GUERRERO,12,CHILAPA DE ÁLVAREZ,028,ACAZACATLA,2,62,27,35,4
GUERRERO,12,CHILAPA DE ÁLVAREZ,028,ACOJTAPACHTLÁN,3,96,44,52,5
GUERRERO,12,CHILAPA DE ÁLVAREZ,028,ACUENTLA,3,122,63,59,10
GUERRERO,12,CHILAPA DE ÁLVAREZ,028,AGUA FRÍA,2,99,54,45,6
GUERRERO,12,CHILAPA DE ÁLVAREZ,028,AGUA ZARCA,2,35,18,17,3
GUERRERO,12,CHILAPA DE ÁLVAREZ,028,AHUACUOTZINTLA,2,49,29,20,3
GUERRERO,12,CHILAPA DE ÁLVAREZ,028,AHUAZOITIC,1,28,15,13,2
GUERRERO,12,CHILAPA DE ÁLVAREZ,028,AHUEHUEIJTIC,3,203,112,91,12
GUERRERO,12,CHILAPA DE ÁLVAREZ,028,AHUEXOTITLÁN,6,430,227,203,26
GUERRERO,12,CHILAPA DE ÁLVAREZ,028,AHUEXOTITLÁN II,1,33,12,21,2
GUERRERO,12,CHILAPA DE ÁLVAREZ,028,AHUIHUIYUCO,3,280,139,141,17
GUERRERO,12,CHILAPA DE ÁLVAREZ,028,AHUIXTLA,4,160,80,80,10
GUERRERO,12,CHILAPA DE ÁLVAREZ,028,ALCOZACÁN,4,360,200,160,16
GUERRERO,12,CHILAPA DE ÁLVAREZ,028,AMATE AMARILLO,3,179,92,87,12
GUERRERO,12,CHILAPA DE ÁLVAREZ,028,AMILTEPEC,3,187,88,99,8
GUERRERO,12,CHILAPA DE ÁLVAREZ,028,AMILTEPEC COLONIA LA VILLA,3,153,71,82,8
GUERRERO,12,CHILAPA DE ÁLVAREZ,028,ATEMPA,4,245,120,125,14
GUERRERO,12,CHILAPA DE ÁLVAREZ,028,ATENXOXOLA,3,199,98,101,14
GUERRERO,12,CHILAPA DE ÁLVAREZ,028,ATZACOALOYA,7,553,271,282,40
GUERRERO,12,CHILAPA DE ÁLVAREZ,028,AXOPILCO,3,149,86,63,11
GUERRERO,12,CHILAPA DE ÁLVAREZ,028,AYAHUALCO,4,63,33,30,7
GUERRERO,12,CHILAPA DE ÁLVAREZ,028,AYAHUALULCO,4,1040,527,513,47
GUERRERO,12,CHILAPA DE ÁLVAREZ,028,BARRANCA HONDA,2,25,17,8,2
GUERRERO,12,CHILAPA DE ÁLVAREZ,028,BUENA VISTA,2,15,5,10,2
GUERRERO,12,CHILAPA DE ÁLVAREZ,028,BUENA VISTA DE LAS PILAS,2,67,31,36,4
GUERRERO,12,CHILAPA DE ÁLVAREZ,028,BUENA VISTA DEL PLAN,2,13,9,4,2
GUERRERO,12,CHILAPA DE ÁLVAREZ,028,BUENA VISTA DEL RÍO,3,83,41,42,4
GUERRERO,12,CHILAPA DE ÁLVAREZ,028,CAJELTITLÁN,4,120,63,57,10
GUERRERO,12,CHILAPA DE ÁLVAREZ,028,CALHUAXTITLÁN,4,149,76,73,8
GUERRERO,12,CHILAPA DE ÁLVAREZ,028,CANTERA ROSA,2,9,6,3,1
GUERRERO,12,CHILAPA DE ÁLVAREZ,028,CERRITO DE SAN MARCOS,1,42,17,25,2
GUERRERO,12,CHILAPA DE ÁLVAREZ,028,CHAUTLA,2,29,17,12,4
GUERRERO,12,CHILAPA DE ÁLVAREZ,028,CHILAPA DE ÁLVAREZ,73,11997,6196,5801,868
GUERRERO,12,CHILAPA DE ÁLVAREZ,028,COAMACINGO (COAMANCIN),3,130,77,53,3
GUERRERO,12,CHILAPA DE ÁLVAREZ,028,COAQUIMIXCO,3,196,93,103,12
GUERRERO,12,CHILAPA DE ÁLVAREZ,028,COATZINGO,2,76,33,43,4
GUERRERO,12,CHILAPA DE ÁLVAREZ,028,COLOTEPEC,3,75,44,31,7
GUERRERO,12,CHILAPA DE ÁLVAREZ,028,CRUCERO ALTO,2,12,8,4,2
GUERRERO,12,CHILAPA DE ÁLVAREZ,028,CUADRILLA NUEVA,3,234,125,109,11
GUERRERO,12,CHILAPA DE ÁLVAREZ,028,CUAMAÑOTEPEC,2,31,13,18,3
GUERRERO,12,CHILAPA DE ÁLVAREZ,028,CUAUHTENANGO,3,284,119,165,22
GUERRERO,12,CHILAPA DE ÁLVAREZ,028,CUONETZINGO,5,491,252,239,29
GUERRERO,12,CHILAPA DE ÁLVAREZ,028,EL CALVARIO,3,119,59,60,5
GUERRERO,12,CHILAPA DE ÁLVAREZ,028,EL EPAZOTE,4,369,186,183,18
GUERRERO,12,CHILAPA DE ÁLVAREZ,028,EL JAGÜEY,5,602,308,294,30
GUERRERO,12,CHILAPA DE ÁLVAREZ,028,EL LIMÓN,2,17,6,11,3
GUERRERO,12,CHILAPA DE ÁLVAREZ,028,EL MEZÓN,2,105,39,66,4
GUERRERO,12,CHILAPA DE ÁLVAREZ,028,EL PARAÍSO,2,43,17,26,4
GUERRERO,12,CHILAPA DE ÁLVAREZ,028,EL PERAL,3,70,33,37,5
GUERRERO,12,CHILAPA DE ÁLVAREZ,028,EL PINORAL,2,169,82,87,9
GUERRERO,12,CHILAPA DE ÁLVAREZ,028,EL REFUGIO,2,66,34,32,4
GUERRERO,12,CHILAPA DE ÁLVAREZ,028,EL TERRERO I,2,41,20,21,3
GUERRERO,12,CHILAPA DE ÁLVAREZ,028,IGNOTEPEC (CRUZ DE LIMÓN),2,22,13,9,2
GUERRERO,12,CHILAPA DE ÁLVAREZ,028,LA CIÉNEGA,2,207,107,100,9
GUERRERO,12,CHILAPA DE ÁLVAREZ,028,LA MOHONERA,5,535,257,278,23
GUERRERO,12,CHILAPA DE ÁLVAREZ,028,LA PROVIDENCIA,2,51,22,29,4
GUERRERO,12,CHILAPA DE ÁLVAREZ,028,LAMAZINTLA,3,87,38,49,7
GUERRERO,12,CHILAPA DE ÁLVAREZ,028,LODO GRANDE,3,232,117,115,12
GUERRERO,12,CHILAPA DE ÁLVAREZ,028,LOS AMATES,3,147,85,62,11
GUERRERO,12,CHILAPA DE ÁLVAREZ,028,LOS MAGUEYES,3,83,44,39,6
GUERRERO,12,CHILAPA DE ÁLVAREZ,028,MACUIXCATLÁN,3,175,100,75,11
GUERRERO,12,CHILAPA DE ÁLVAREZ,028,MATLALA,3,45,23,22,4
GUERRERO,12,CHILAPA DE ÁLVAREZ,028,MEXCALCINGO,4,720,354,366,27
GUERRERO,12,CHILAPA DE ÁLVAREZ,028,MEXCALTEPEC I,5,325,149,176,17
GUERRERO,12,CHILAPA DE ÁLVAREZ,028,MEXCALTEPEC II,1,77,37,40,3
GUERRERO,12,CHILAPA DE ÁLVAREZ,028,MIRAFLOR,2,64,30,34,4
GUERRERO,12,CHILAPA DE ÁLVAREZ,028,NEJAPA,10,1039,535,504,49
GUERRERO,12,CHILAPA DE ÁLVAREZ,028,OCUITUCO,3,221,120,101,12
GUERRERO,12,CHILAPA DE ÁLVAREZ,028,OCUTLA,1,33,17,16,2
GUERRERO,12,CHILAPA DE ÁLVAREZ,028,OLINGACHACATLÁN (CAMPOSANTO VIEJO),1,73,32,41,4
GUERRERO,12,CHILAPA DE ÁLVAREZ,028,PANTITLÁN,7,739,364,375,33
GUERRERO,12,CHILAPA DE ÁLVAREZ,028,PAPAXTLA,3,123,56,67,8
GUERRERO,12,CHILAPA DE ÁLVAREZ,028,POCHUTLA,1,8,5,3,1
GUERRERO,12,CHILAPA DE ÁLVAREZ,028,POPOCATZIN,3,278,142,136,11
GUERRERO,12,CHILAPA DE ÁLVAREZ,028,POPOYATLAJCO,3,231,111,120,12
GUERRERO,12,CHILAPA DE ÁLVAREZ,028,PUEBLO VIEJO,3,18,12,6,3
GUERRERO,12,CHILAPA DE ÁLVAREZ,028,RANCHO COAQUIMIXCO,2,22,11,11,2
GUERRERO,12,CHILAPA DE ÁLVAREZ,028,RINCÓN DE CHAUTLA,3,40,21,19,4
GUERRERO,12,CHILAPA DE ÁLVAREZ,028,SAMACINGO,2,21,11,10,2
GUERRERO,12,CHILAPA DE ÁLVAREZ,028,SAN ÁNGEL,3,259,120,139,15
GUERRERO,12,CHILAPA DE ÁLVAREZ,028,SAN ANTONIO HUEYITEPEC,2,60,32,28,5
GUERRERO,12,CHILAPA DE ÁLVAREZ,028,SAN JERÓNIMO PALANTLA,4,189,103,86,12
GUERRERO,12,CHILAPA DE ÁLVAREZ,028,SAN MARCOS,4,316,158,158,15
GUERRERO,12,CHILAPA DE ÁLVAREZ,028,SAN PEDRO,1,12,6,6,1
GUERRERO,12,CHILAPA DE ÁLVAREZ,028,SANTA ANA,3,194,100,94,13
GUERRERO,12,CHILAPA DE ÁLVAREZ,028,SANTA CATARINA,4,672,329,343,32
GUERRERO,12,CHILAPA DE ÁLVAREZ,028,SANTA CRUZ,2,145,69,76,9
GUERRERO,12,CHILAPA DE ÁLVAREZ,028,SANTA CRUZ (ZACAZONAPA),3,147,71,76,8
GUERRERO,12,CHILAPA DE ÁLVAREZ,028,TECONGO,2,132,62,70,5
GUERRERO,12,CHILAPA DE ÁLVAREZ,028,TECONGO II,1,26,10,16,1
GUERRERO,12,CHILAPA DE ÁLVAREZ,028,TENEXATLAJCO,3,68,31,37,6
GUERRERO,12,CHILAPA DE ÁLVAREZ,028,TEOMATATLÁN,3,106,38,68,5
GUERRERO,12,CHILAPA DE ÁLVAREZ,028,TEPANGO,2,19,8,11,2
GUERRERO,12,CHILAPA DE ÁLVAREZ,028,TEPEHUIXCO,3,241,113,128,11
GUERRERO,12,CHILAPA DE ÁLVAREZ,028,TEPETLACINGO,3,147,65,82,10
GUERRERO,12,CHILAPA DE ÁLVAREZ,028,TEPEXAXOCOTITLÁN,2,22,11,11,2
GUERRERO,12,CHILAPA DE ÁLVAREZ,028,TEPOZCUAUTLA,3,231,126,105,12
GUERRERO,12,CHILAPA DE ÁLVAREZ,028,TEPOZONALCO,3,243,110,133,12
GUERRERO,12,CHILAPA DE ÁLVAREZ,028,TERRERO,1,14,7,7,1
GUERRERO,12,CHILAPA DE ÁLVAREZ,028,TETITLÁN DE LA LIMA,1,12,7,5,2
GUERRERO,12,CHILAPA DE ÁLVAREZ,028,TETITLÁN II,1,9,5,4,1
GUERRERO,12,CHILAPA DE ÁLVAREZ,028,TETLIXTAC,2,64,31,33,3
GUERRERO,12,CHILAPA DE ÁLVAREZ,028,TEYPALCO,3,289,151,138,12
GUERRERO,12,CHILAPA DE ÁLVAREZ,028,TLACOAXTLA,3,329,155,174,14
GUERRERO,12,CHILAPA DE ÁLVAREZ,028,TLALAHUAPA,3,117,55,62,6
GUERRERO,12,CHILAPA DE ÁLVAREZ,028,TLALCORRAL,2,14,8,6,1
GUERRERO,12,CHILAPA DE ÁLVAREZ,028,TLALHUIC (OCOIXTLAHUAC),2,33,13,20,4
GUERRERO,12,CHILAPA DE ÁLVAREZ,028,TLALIXTALTIPAN,2,27,15,12,3
GUERRERO,12,CHILAPA DE ÁLVAREZ,028,TLALIXTLAHUACÁN,3,174,98,76,10
GUERRERO,12,CHILAPA DE ÁLVAREZ,028,TLALPIZACO AJACAYÁN,1,6,1,5,1
GUERRERO,12,CHILAPA DE ÁLVAREZ,028,TLAMIXTLAHUACAN,5,950,458,492,44
GUERRERO,12,CHILAPA DE ÁLVAREZ,028,TLANIPATLA,2,165,81,84,7
GUERRERO,12,CHILAPA DE ÁLVAREZ,028,TLATEMPA,2,46,21,25,4
GUERRERO,12,CHILAPA DE ÁLVAREZ,028,TLAXINGA (CLATZINGA),3,435,190,245,22
GUERRERO,12,CHILAPA DE ÁLVAREZ,028,TLAYELPA,1,50,26,24,3
GUERRERO,12,CHILAPA DE ÁLVAREZ,028,TRES CRUCES,3,123,64,59,5
GUERRERO,12,CHILAPA DE ÁLVAREZ,028,TRIGOMILA,3,135,67,68,10
GUERRERO,12,CHILAPA DE ÁLVAREZ,028,TULA GUERRERO,1,13,6,7,1
GUERRERO,12,CHILAPA DE ÁLVAREZ,028,TZICAIXTLAHUAC,2,179,86,93,7
GUERRERO,12,CHILAPA DE ÁLVAREZ,028,VISTA HERMOSA,2,158,79,79,8
GUERRERO,12,CHILAPA DE ÁLVAREZ,028,XALOKÁN,1,15,5,10,2
GUERRERO,12,CHILAPA DE ÁLVAREZ,028,XICOTLÁN,3,129,59,70,8
GUERRERO,12,CHILAPA DE ÁLVAREZ,028,XILOXUCHICÁN,3,245,123,122,14
GUERRERO,12,CHILAPA DE ÁLVAREZ,028,XOCHICALCO,2,63,25,38,3
GUERRERO,12,CHILAPA DE ÁLVAREZ,028,XOCHIMILCO,2,31,16,15,2
GUERRERO,12,CHILAPA DE ÁLVAREZ,028,XOCHITEMPA,4,247,122,125,17
GUERRERO,12,CHILAPA DE ÁLVAREZ,028,XOLOTEPEC,3,157,76,81,7
GUERRERO,12,CHILAPA DE ÁLVAREZ,028,XULCHUCHUIO,4,171,82,89,13
GUERRERO,12,CHILAPA DE ÁLVAREZ,028,ZACAPEXCO,3,282,144,138,14
GUERRERO,12,CHILAPA DE ÁLVAREZ,028,ZELOCOTITLÁN,4,361,171,190,17
GUERRERO,12,CHILAPA DE ÁLVAREZ,028,ZINANTLA,3,286,147,139,13
GUERRERO,12,CHILAPA DE ÁLVAREZ,028,ZINENEZINTLA,1,8,3,5,1
GUERRERO,12,CHILAPA DE ÁLVAREZ,028,ZINZINTITLÁN,2,161,82,79,9
GUERRERO,12,CHILAPA DE ÁLVAREZ,028,ZIZICAZAPA,3,415,202,213,19
GUERRERO,12,CHILAPA DE ÁLVAREZ,028,ZOMPELTEPEC,3,208,93,115,11
GUERRERO,12,CHILAPA DE ÁLVAREZ,028,ZOQUITIPA,3,220,126,94,11
GUERRERO,12,CHILAPA DE ÁLVAREZ,028,ZOYACOMULCO,1,25,10,15,2
GUERRERO,12,CHILPANCINGO DE LOS BRAVO,029,ACAHUIZOTLA,4,351,165,186,20
GUERRERO,12,CHILPANCINGO DE LOS BRAVO,029,AGUA HERNÁNDEZ,4,98,48,50,8
GUERRERO,12,CHILPANCINGO DE LOS BRAVO,029,AMOJILECA,4,534,265,269,20
GUERRERO,12,CHILPANCINGO DE LOS BRAVO,029,AZINYAHUALCO (CAÑADA DE AZINYAHUALCO),4,129,58,71,8
GUERRERO,12,CHILPANCINGO DE LOS BRAVO,029,BUENA VISTA DE LA SALUD,5,509,258,251,55
GUERRERO,12,CHILPANCINGO DE LOS BRAVO,029,CAJELITOS,4,239,115,124,17
GUERRERO,12,CHILPANCINGO DE LOS BRAVO,029,CARRIZAL DE LA VÍA,3,64,36,28,7
GUERRERO,12,CHILPANCINGO DE LOS BRAVO,029,CARRIZAL DE PINZÓN,3,84,35,49,7
GUERRERO,12,CHILPANCINGO DE LOS BRAVO,029,CHACUALCINGO,2,7,2,5,2
GUERRERO,12,CHILPANCINGO DE LOS BRAVO,029,CHAUTIPAN,3,171,87,84,11
GUERRERO,12,CHILPANCINGO DE LOS BRAVO,029,CHILPANCINGO DE LOS BRAVO,346,82272,42222,40050,5240
GUERRERO,12,CHILPANCINGO DE LOS BRAVO,029,COACOYULILLO,4,338,173,165,15
GUERRERO,12,CHILPANCINGO DE LOS BRAVO,029,COAPANGO,3,43,22,21,4
GUERRERO,12,CHILPANCINGO DE LOS BRAVO,029,COLONIA GENERAL HELIODORO CASTILLO (CHICAHUALES),4,213,107,106,14
GUERRERO,12,CHILPANCINGO DE LOS BRAVO,029,EL AGUAJITO,3,51,25,26,3
GUERRERO,12,CHILPANCINGO DE LOS BRAVO,029,EL CALVARIO,2,12,8,4,2
GUERRERO,12,CHILPANCINGO DE LOS BRAVO,029,EL CIRUELAR,3,32,18,14,5
GUERRERO,12,CHILPANCINGO DE LOS BRAVO,029,EL FRESNO,4,495,261,234,22
GUERRERO,12,CHILPANCINGO DE LOS BRAVO,029,EL TEJOCOTE (IGLESIA VIEJA),3,40,26,14,3
GUERRERO,12,CHILPANCINGO DE LOS BRAVO,029,HUACALAPA,2,7,5,2,2
GUERRERO,12,CHILPANCINGO DE LOS BRAVO,029,HUITECO,1,6,1,5,1
GUERRERO,12,CHILPANCINGO DE LOS BRAVO,029,INSCUINATOYAC (EL PUEBLITO),4,145,76,69,13
GUERRERO,12,CHILPANCINGO DE LOS BRAVO,029,JALEACA DE CATALÁN,5,534,288,246,32
GUERRERO,12,CHILPANCINGO DE LOS BRAVO,029,JULIÁN BLANCO (DOS CAMINOS),4,444,248,196,32
GUERRERO,12,CHILPANCINGO DE LOS BRAVO,029,LA CIÉNEGA,1,14,3,11,1
GUERRERO,12,CHILPANCINGO DE LOS BRAVO,029,LA ESPERANZA,4,194,98,96,12
GUERRERO,12,CHILPANCINGO DE LOS BRAVO,029,LA HACIENDITA,3,136,71,65,8
GUERRERO,12,CHILPANCINGO DE LOS BRAVO,029,LLANOS DE TEPOXTEPEC,3,62,37,25,6
GUERRERO,12,CHILPANCINGO DE LOS BRAVO,029,MAZATLÁN,8,1463,753,710,77
GUERRERO,12,CHILPANCINGO DE LOS BRAVO,029,MOHONERAS,3,287,134,153,13
GUERRERO,12,CHILPANCINGO DE LOS BRAVO,029,OCOTITO,10,2018,1012,1006,130
GUERRERO,12,CHILPANCINGO DE LOS BRAVO,029,OMILTEMI,3,58,24,34,4
GUERRERO,12,CHILPANCINGO DE LOS BRAVO,029,PALO BLANCO,4,560,287,273,34
GUERRERO,12,CHILPANCINGO DE LOS BRAVO,029,PETAQUILLAS,12,2910,1457,1453,139
GUERRERO,12,CHILPANCINGO DE LOS BRAVO,029,RENACIMIENTO AGUA HERNÁNDEZ,2,54,27,27,5
GUERRERO,12,CHILPANCINGO DE LOS BRAVO,029,RINCÓN DE ALCAPARROSA,3,151,71,80,8
GUERRERO,12,CHILPANCINGO DE LOS BRAVO,029,RINCÓN DE LA VÍA,3,123,60,63,12
GUERRERO,12,CHILPANCINGO DE LOS BRAVO,029,RÍO VERDE,3,72,38,34,7
GUERRERO,12,CHILPANCINGO DE LOS BRAVO,029,SAN CRISTÓBAL,4,277,155,122,15
GUERRERO,12,CHILPANCINGO DE LOS BRAVO,029,SAN MIGUEL,3,73,40,33,5
GUERRERO,12,CHILPANCINGO DE LOS BRAVO,029,SAN VICENTE,4,714,345,369,29
GUERRERO,12,CHILPANCINGO DE LOS BRAVO,029,SANTA BÁRBARA,4,155,69,86,11
GUERRERO,12,CHILPANCINGO DE LOS BRAVO,029,SANTA RITA Y TECALCO,3,14,7,7,2
GUERRERO,12,CHILPANCINGO DE LOS BRAVO,029,TEPECHICOTLÁN,4,265,138,127,16
GUERRERO,12,CHILPANCINGO DE LOS BRAVO,029,TLAHUIZAPA,4,157,85,72,11
GUERRERO,12,CHILPANCINGO DE LOS BRAVO,029,XOCOMANATLÁN,2,8,2,6,2
GUERRERO,12,CHILPANCINGO DE LOS BRAVO,029,ZOYATEPEC,4,159,81,78,12
GUERRERO,12,FLORENCIO VILLARREAL,030,ACAPULQUITO,3,89,39,50,6
GUERRERO,12,FLORENCIO VILLARREAL,030,ARROYO SECO,2,31,18,13,2
GUERRERO,12,FLORENCIO VILLARREAL,030,BOCA DEL RÍO,3,114,61,53,7
GUERRERO,12,FLORENCIO VILLARREAL,030,CANTARRANAS,2,29,16,13,3
GUERRERO,12,FLORENCIO VILLARREAL,030,CHARCO DEL POZO,3,60,33,27,5
GUERRERO,12,FLORENCIO VILLARREAL,030,CHAUTENGO,5,194,98,96,18
GUERRERO,12,FLORENCIO VILLARREAL,030,COLONIA EMILIANO ZAPATA (LOS PALMA),2,11,5,6,2
GUERRERO,12,FLORENCIO VILLARREAL,030,CRUZ GRANDE,25,4356,2185,2171,232
GUERRERO,12,FLORENCIO VILLARREAL,030,CUATRO BANCOS,3,234,110,124,11
GUERRERO,12,FLORENCIO VILLARREAL,030,DIOS TE LIBRE,2,37,17,20,3
GUERRERO,12,FLORENCIO VILLARREAL,030,EL CHAMIZAL,2,94,44,50,6
GUERRERO,12,FLORENCIO VILLARREAL,030,EL MÉDANO,2,49,29,20,4
GUERRERO,12,FLORENCIO VILLARREAL,030,EL MESÓN,2,8,4,4,1
GUERRERO,12,FLORENCIO VILLARREAL,030,EL PORVENIR,3,107,47,60,9
GUERRERO,12,FLORENCIO VILLARREAL,030,EL TEJORUCO,2,5,2,3,2
GUERRERO,12,FLORENCIO VILLARREAL,030,LA AGRÍCOLA,2,13,5,8,2
GUERRERO,12,FLORENCIO VILLARREAL,030,LA CUBA,2,9,2,7,2
GUERRERO,12,FLORENCIO VILLARREAL,030,LA MÁQUINA DE NEXPA,2,34,17,17,3
GUERRERO,12,FLORENCIO VILLARREAL,030,LA RUSIA,2,22,6,16,2
GUERRERO,12,FLORENCIO VILLARREAL,030,LAS ÁNIMAS,4,224,98,126,18
GUERRERO,12,FLORENCIO VILLARREAL,030,LAS GARZAS,3,90,46,44,7
GUERRERO,12,FLORENCIO VILLARREAL,030,LAS ISLETAS,2,16,8,8,2
GUERRERO,12,FLORENCIO VILLARREAL,030,LLANO DE LA BARRA,1,8,4,4,1
GUERRERO,12,FLORENCIO VILLARREAL,030,LLANO GRANDE,3,228,98,130,18
GUERRERO,12,FLORENCIO VILLARREAL,030,LOS ACHOTES,1,10,4,6,1
GUERRERO,12,FLORENCIO VILLARREAL,030,LOS CHARQUITOS,2,6,3,3,2
GUERRERO,12,FLORENCIO VILLARREAL,030,LOS TAMARINDOS,3,76,34,42,6
GUERRERO,12,FLORENCIO VILLARREAL,030,PICO DEL MONTE,3,164,82,82,8
GUERRERO,12,FLORENCIO VILLARREAL,030,PLAYA LARGA VIEJA (PLAYA LARGA),1,86,42,44,5
GUERRERO,12,FLORENCIO VILLARREAL,030,SAN JOSÉ DE LAS FLORES,1,25,11,14,2
GUERRERO,12,GENERAL CANUTO A. NERI,031,ACAPETLAHUAYA,5,475,246,229,34
GUERRERO,12,GENERAL CANUTO A. NERI,031,AMATES GRANDES,2,22,10,12,3
GUERRERO,12,GENERAL CANUTO A. NERI,031,ARROYO SECO,3,45,23,22,3
GUERRERO,12,GENERAL CANUTO A. NERI,031,CUADRILLA NUEVA,2,16,7,9,3
GUERRERO,12,GENERAL CANUTO A. NERI,031,CUEVA DEL TIGRE,3,16,7,9,3
GUERRERO,12,GENERAL CANUTO A. NERI,031,EL CANTÓN,2,31,12,19,3
GUERRERO,12,GENERAL CANUTO A. NERI,031,EL CASCALOTE,1,9,3,6,2
GUERRERO,12,GENERAL CANUTO A. NERI,031,EL MIRADOR,3,20,8,12,4
GUERRERO,12,GENERAL CANUTO A. NERI,031,EL OCOTITO,3,16,3,13,3
GUERRERO,12,GENERAL CANUTO A. NERI,031,EL SALTO,1,10,4,6,1
GUERRERO,12,GENERAL CANUTO A. NERI,031,ENCINO SOLO,3,15,6,9,3
GUERRERO,12,GENERAL CANUTO A. NERI,031,HUEYCALLI,2,10,5,5,2
GUERRERO,12,GENERAL CANUTO A. NERI,031,IXTEPEC DE SAN SIMÓN,4,148,80,68,11
GUERRERO,12,GENERAL CANUTO A. NERI,031,LA ESMERALDA,1,18,12,6,2
GUERRERO,12,GENERAL CANUTO A. NERI,031,LA PROVIDENCIA,2,28,13,15,3
GUERRERO,12,GENERAL CANUTO A. NERI,031,LAS CAÑITAS,2,8,6,2,2
GUERRERO,12,GENERAL CANUTO A. NERI,031,LAS CEIBITAS,2,16,12,4,2
GUERRERO,12,GENERAL CANUTO A. NERI,031,LÍDICE,3,166,73,93,12
GUERRERO,12,GENERAL CANUTO A. NERI,031,LOS CUAHULOTES (LOS CUAJILOTES),1,10,7,3,1
GUERRERO,12,GENERAL CANUTO A. NERI,031,LOS ENCINOS,3,55,23,32,6
GUERRERO,12,GENERAL CANUTO A. NERI,031,LOS PEÑA,2,14,11,3,2
GUERRERO,12,GENERAL CANUTO A. NERI,031,MINA DE LA CONCEPCIÓN,2,27,10,17,3
GUERRERO,12,GENERAL CANUTO A. NERI,031,OCOTEPEC,1,9,5,4,1
GUERRERO,12,GENERAL CANUTO A. NERI,031,PAROTA SAN SIMÓN,3,50,24,26,5
GUERRERO,12,GENERAL CANUTO A. NERI,031,PATA DE VENADO,2,11,6,5,2
GUERRERO,12,GENERAL CANUTO A. NERI,031,RÍO CHIQUITO,3,29,13,16,3
GUERRERO,12,GENERAL CANUTO A. NERI,031,TETEYO EL BAJO (TETEYO),1,11,7,4,1
GUERRERO,12,GENERAL CANUTO A. NERI,031,TIANQUIZOLCO,3,78,39,39,7
GUERRERO,12,GENERAL CANUTO A. NERI,031,VUELTA GRANDE,2,23,9,14,2
GUERRERO,12,GENERAL HELIODORO CASTILLO,032,ACATLÁN DEL RÍO,3,128,66,62,8
GUERRERO,12,GENERAL HELIODORO CASTILLO,032,AGUA ZARCA,3,65,33,32,5
GUERRERO,12,GENERAL HELIODORO CASTILLO,032,AMACAHUITE,3,91,40,51,7
GUERRERO,12,GENERAL HELIODORO CASTILLO,032,BARRIO NUEVO,3,50,20,30,4
GUERRERO,12,GENERAL HELIODORO CASTILLO,032,BUENAVISTA,1,9,5,4,1
GUERRERO,12,GENERAL HELIODORO CASTILLO,032,BUENAVISTA DEL SUR (BUENAVISTA),2,7,3,4,1
GUERRERO,12,GENERAL HELIODORO CASTILLO,032,CAMPO MORADO,4,234,116,118,14
GUERRERO,12,GENERAL HELIODORO CASTILLO,032,CHAPULTEPEC,3,145,79,66,9
GUERRERO,12,GENERAL HELIODORO CASTILLO,032,CHICAHUALES,4,138,75,63,9
GUERRERO,12,GENERAL HELIODORO CASTILLO,032,CHICHILTEPEC,4,326,181,145,17
GUERRERO,12,GENERAL HELIODORO CASTILLO,032,CHILPANCINGUITO,3,84,32,52,6
GUERRERO,12,GENERAL HELIODORO CASTILLO,032,CIRUELO AMARILLO,1,61,28,33,3
GUERRERO,12,GENERAL HELIODORO CASTILLO,032,COATEPEC DE LOS NARANJOS,3,16,10,6,2
GUERRERO,12,GENERAL HELIODORO CASTILLO,032,COATEPEC DEL OCOTE,4,36,14,22,5
GUERRERO,12,GENERAL HELIODORO CASTILLO,032,COLONIA BALUARTE,3,22,13,9,3
GUERRERO,12,GENERAL HELIODORO CASTILLO,032,COLONIA GUERRERO (EL RINCÓN),3,12,5,7,3
GUERRERO,12,GENERAL HELIODORO CASTILLO,032,COLONIA SANTA CRUZ,2,15,10,5,2
GUERRERO,12,GENERAL HELIODORO CASTILLO,032,COMUNITLALI (LA LAGUNA),2,8,4,4,1
GUERRERO,12,GENERAL HELIODORO CASTILLO,032,CRUZ NUEVA,3,18,11,7,2
GUERRERO,12,GENERAL HELIODORO CASTILLO,032,CUEVA DE GUERRERO,3,34,15,19,3
GUERRERO,12,GENERAL HELIODORO CASTILLO,032,DERRUMBADO,2,10,3,7,1
GUERRERO,12,GENERAL HELIODORO CASTILLO,032,DURAZNO DEL ROSARIO,4,208,104,104,14
GUERRERO,12,GENERAL HELIODORO CASTILLO,032,DURAZNO ORIENTE,2,23,14,9,3
GUERRERO,12,GENERAL HELIODORO CASTILLO,032,DURAZNO SAN VICENTE (EL DURAZNO),3,72,43,29,5
GUERRERO,12,GENERAL HELIODORO CASTILLO,032,EL AHUEJOTE,3,60,29,31,5
GUERRERO,12,GENERAL HELIODORO CASTILLO,032,EL AMATE,1,13,6,7,1
GUERRERO,12,GENERAL HELIODORO CASTILLO,032,EL ENCANTO,3,53,31,22,4
GUERRERO,12,GENERAL HELIODORO CASTILLO,032,EL FRÍO,3,66,29,37,5
GUERRERO,12,GENERAL HELIODORO CASTILLO,032,EL LIMONCITO,2,70,36,34,6
GUERRERO,12,GENERAL HELIODORO CASTILLO,032,EL MORRO,3,55,26,29,5
GUERRERO,12,GENERAL HELIODORO CASTILLO,032,EL NARANJO,3,47,17,30,4
GUERRERO,12,GENERAL HELIODORO CASTILLO,032,EL PAPAYO,2,15,8,7,2
GUERRERO,12,GENERAL HELIODORO CASTILLO,032,EL PLAN,3,24,14,10,3
GUERRERO,12,GENERAL HELIODORO CASTILLO,032,EL RENACIMIENTO,3,77,41,36,5
GUERRERO,12,GENERAL HELIODORO CASTILLO,032,EL SALITRE,3,29,14,15,3
GUERRERO,12,GENERAL HELIODORO CASTILLO,032,EL TARASCO,2,5,4,1,1
GUERRERO,12,GENERAL HELIODORO CASTILLO,032,EL TIQUIMIL,1,27,17,10,2
GUERRERO,12,GENERAL HELIODORO CASTILLO,032,EL ZOQUIAL,2,20,13,7,2
GUERRERO,12,GENERAL HELIODORO CASTILLO,032,FILO DEL ÁGUILA,3,42,16,26,4
GUERRERO,12,GENERAL HELIODORO CASTILLO,032,HUAUTLA,4,261,128,133,14
GUERRERO,12,GENERAL HELIODORO CASTILLO,032,HUERTA VIEJA,4,159,78,81,15
GUERRERO,12,GENERAL HELIODORO CASTILLO,032,HUEYÁHUATL,2,20,5,15,2
GUERRERO,12,GENERAL HELIODORO CASTILLO,032,HUIXILAC (HUITZILAC),2,12,7,5,2
GUERRERO,12,GENERAL HELIODORO CASTILLO,032,IXTAYOTLA,2,31,10,21,3
GUERRERO,12,GENERAL HELIODORO CASTILLO,032,IXTLAHUACA,2,39,13,26,3
GUERRERO,12,GENERAL HELIODORO CASTILLO,032,IZOTEPEC,4,271,137,134,16
GUERRERO,12,GENERAL HELIODORO CASTILLO,032,LA AURORA,4,188,100,88,14
GUERRERO,12,GENERAL HELIODORO CASTILLO,032,LA CIÉNEGA,6,187,86,101,15
GUERRERO,12,GENERAL HELIODORO CASTILLO,032,LA CIENEGUITA,1,20,10,10,1
GUERRERO,12,GENERAL HELIODORO CASTILLO,032,LA GUITARRA (PUERTO LA GUITARRA),1,7,3,4,1
GUERRERO,12,GENERAL HELIODORO CASTILLO,032,LA JOYA,2,7,3,4,1
GUERRERO,12,GENERAL HELIODORO CASTILLO,032,LA JOYA DEL CIRIÁN,1,8,5,3,1
GUERRERO,12,GENERAL HELIODORO CASTILLO,032,LA PAROTA UNO,1,27,13,14,2
GUERRERO,12,GENERAL HELIODORO CASTILLO,032,LA PRIMAVERA,3,94,50,44,7
GUERRERO,12,GENERAL HELIODORO CASTILLO,032,LA PRIMAVERITA,1,6,2,4,1
GUERRERO,12,GENERAL HELIODORO CASTILLO,032,LA REFORMA,2,61,28,33,4
GUERRERO,12,GENERAL HELIODORO CASTILLO,032,LA VENTA,4,149,65,84,12
GUERRERO,12,GENERAL HELIODORO CASTILLO,032,LA YERBABUENA,3,30,17,13,3
GUERRERO,12,GENERAL HELIODORO CASTILLO,032,LAS CEIBAS,3,62,35,27,5
GUERRERO,12,GENERAL HELIODORO CASTILLO,032,LAS JARILLAS,2,6,4,2,1
GUERRERO,12,GENERAL HELIODORO CASTILLO,032,LAS JUNTAS,3,37,13,24,4
GUERRERO,12,GENERAL HELIODORO CASTILLO,032,LAS MARGARITAS,3,60,33,27,5
GUERRERO,12,GENERAL HELIODORO CASTILLO,032,LAS MESAS (ANONOS),1,8,3,5,1
GUERRERO,12,GENERAL HELIODORO CASTILLO,032,LAS PIÑAS,2,16,10,6,1
GUERRERO,12,GENERAL HELIODORO CASTILLO,032,LAS VINATAS,4,151,75,76,11
GUERRERO,12,GENERAL HELIODORO CASTILLO,032,LIMONCITO,2,122,61,61,5
GUERRERO,12,GENERAL HELIODORO CASTILLO,032,LOS AMATITOS (LOS AMATES),3,27,15,12,3
GUERRERO,12,GENERAL HELIODORO CASTILLO,032,LOS CAPULINES (LOS FRÍOS ANTIGUOS),4,103,47,56,11
GUERRERO,12,GENERAL HELIODORO CASTILLO,032,LOS CIRUELOS (EL CIRUELO),2,94,45,49,6
GUERRERO,12,GENERAL HELIODORO CASTILLO,032,LOS HOYOS,4,279,136,143,16
GUERRERO,12,GENERAL HELIODORO CASTILLO,032,LOS LAVADEROS,3,15,7,8,3
GUERRERO,12,GENERAL HELIODORO CASTILLO,032,LOS OCOTES,3,84,38,46,7
GUERRERO,12,GENERAL HELIODORO CASTILLO,032,LOS RANCHOS,3,42,23,19,6
GUERRERO,12,GENERAL HELIODORO CASTILLO,032,MAXÍUHITL,2,13,5,8,2
GUERRERO,12,GENERAL HELIODORO CASTILLO,032,NARANJITO ZAPOTITLA (NARANJITO),3,20,12,8,2
GUERRERO,12,GENERAL HELIODORO CASTILLO,032,NUEVO POBLADO EL CARACOL,2,133,64,69,9
GUERRERO,12,GENERAL HELIODORO CASTILLO,032,OJO DE AGUA,3,35,20,15,3
GUERRERO,12,GENERAL HELIODORO CASTILLO,032,PAROTA DE SAN PEDRO (LA PAROTA),2,15,6,9,2
GUERRERO,12,GENERAL HELIODORO CASTILLO,032,PARRALES,1,7,4,3,1
GUERRERO,12,GENERAL HELIODORO CASTILLO,032,PINZAMPANTLE,2,11,4,7,2
GUERRERO,12,GENERAL HELIODORO CASTILLO,032,PLAN DE LAS FLORES,2,6,4,2,1
GUERRERO,12,GENERAL HELIODORO CASTILLO,032,PUEBLO VIEJO,4,131,56,75,11
GUERRERO,12,GENERAL HELIODORO CASTILLO,032,PUERTO CASTRO,2,43,18,25,3
GUERRERO,12,GENERAL HELIODORO CASTILLO,032,PUERTO DE LOS ESPINOS,1,2,2,0,1
GUERRERO,12,GENERAL HELIODORO CASTILLO,032,PUERTO DEL VARAL,4,174,76,98,11
GUERRERO,12,GENERAL HELIODORO CASTILLO,032,PUERTO EUCALIPTO,2,8,2,6,2
GUERRERO,12,GENERAL HELIODORO CASTILLO,032,PUERTO GALLO [CAMPAMENTO],3,17,8,9,3
GUERRERO,12,GENERAL HELIODORO CASTILLO,032,PUERTO TEJAS,1,9,4,5,1
GUERRERO,12,GENERAL HELIODORO CASTILLO,032,RANCHO VIEJO,3,54,29,25,5
GUERRERO,12,GENERAL HELIODORO CASTILLO,032,SAN ANTONIO DE LAS PALMAS,2,13,5,8,2
GUERRERO,12,GENERAL HELIODORO CASTILLO,032,TECOLHUISTLE,1,11,5,6,1
GUERRERO,12,GENERAL HELIODORO CASTILLO,032,TECOMAXÚCHITL DEL NORTE,3,88,46,42,5
GUERRERO,12,GENERAL HELIODORO CASTILLO,032,TECOMAZÚCHITL SUR,3,96,47,49,8
GUERRERO,12,GENERAL HELIODORO CASTILLO,032,TEJAMANIL,4,162,80,82,11
GUERRERO,12,GENERAL HELIODORO CASTILLO,032,TEPEHUAJE,3,81,37,44,5
GUERRERO,12,GENERAL HELIODORO CASTILLO,032,TETELA DEL RÍO,4,122,58,64,11
GUERRERO,12,GENERAL HELIODORO CASTILLO,032,TIQUIMIL,1,8,6,2,1
GUERRERO,12,GENERAL HELIODORO CASTILLO,032,TLACOMULITO,3,47,26,21,4
GUERRERO,12,GENERAL HELIODORO CASTILLO,032,TLACOTENCO,4,257,141,116,14
GUERRERO,12,GENERAL HELIODORO CASTILLO,032,TLACOTEPEC,19,3140,1595,1545,175
GUERRERO,12,GENERAL HELIODORO CASTILLO,032,VERDE RICO (HUERTO DE VERDE RICO),3,190,92,98,12
GUERRERO,12,GENERAL HELIODORO CASTILLO,032,VILLAXÓCHITL,3,55,28,27,4
GUERRERO,12,GENERAL HELIODORO CASTILLO,032,XOCHITEPEC,1,4,3,1,1
GUERRERO,12,GENERAL HELIODORO CASTILLO,032,YERBA SANTA,2,9,5,4,2
GUERRERO,12,GENERAL HELIODORO CASTILLO,032,ZOMPANTLE,4,301,151,150,16
GUERRERO,12,GENERAL HELIODORO CASTILLO,032,ZOPILOSTOC,3,264,124,140,13
GUERRERO,12,HUAMUXTITLÁN,033,CONHUAXO,2,64,30,34,5
GUERRERO,12,HUAMUXTITLÁN,033,COYAHUALCO,5,319,155,164,23
GUERRERO,12,HUAMUXTITLÁN,033,HUAMUXTITLÁN,11,2773,1448,1325,156
GUERRERO,12,HUAMUXTITLÁN,033,JILOTEPEC,2,45,19,26,3
GUERRERO,12,HUAMUXTITLÁN,033,SAN MIGUEL TOTOLAPA,6,658,325,333,40
GUERRERO,12,HUAMUXTITLÁN,033,SAN PEDRO AYTEC,3,129,68,61,6
GUERRERO,12,HUAMUXTITLÁN,033,SANTA CRUZ,4,271,139,132,21
GUERRERO,12,HUAMUXTITLÁN,033,TEPETLAPA,3,77,35,42,5
GUERRERO,12,HUAMUXTITLÁN,033,TLALQUETZALA,3,177,94,83,11
GUERRERO,12,HUAMUXTITLÁN,033,TLAQUILTEPEC (SAN BARTOLOMÉ TLAQUILTEPEC),5,357,176,181,25
GUERRERO,12,HUITZUCO DE LOS FIGUEROA,034,ACAQUILA,3,89,44,45,7
GUERRERO,12,HUITZUCO DE LOS FIGUEROA,034,ATETETLA,3,87,39,48,10
GUERRERO,12,HUITZUCO DE LOS FIGUEROA,034,ATOPULA,2,28,13,15,3
GUERRERO,12,HUITZUCO DE LOS FIGUEROA,034,CACAHUANANCHE,3,199,107,92,12
GUERRERO,12,HUITZUCO DE LOS FIGUEROA,034,CHAUCINGO,4,256,132,124,22
GUERRERO,12,HUITZUCO DE LOS FIGUEROA,034,CIUDAD DE HUITZUCO,29,4792,2443,2349,340
GUERRERO,12,HUITZUCO DE LOS FIGUEROA,034,CUAHUILOTLA,3,64,35,29,6
GUERRERO,12,HUITZUCO DE LOS FIGUEROA,034,EL PERILLO,2,6,2,4,2
GUERRERO,12,HUITZUCO DE LOS FIGUEROA,034,ESCUCHAPA,3,86,39,47,9
GUERRERO,12,HUITZUCO DE LOS FIGUEROA,034,LAGUNILLAS,3,129,70,59,11
GUERRERO,12,HUITZUCO DE LOS FIGUEROA,034,NANCHE DULCE,2,64,28,36,5
GUERRERO,12,HUITZUCO DE LOS FIGUEROA,034,PASO MORELOS (CUETLAJUCHI),3,185,88,97,12
GUERRERO,12,HUITZUCO DE LOS FIGUEROA,034,POLOLCINGO,4,326,166,160,31
GUERRERO,12,HUITZUCO DE LOS FIGUEROA,034,QUETZALAPA,3,122,49,73,9
GUERRERO,12,HUITZUCO DE LOS FIGUEROA,034,SAN FRANCISCO OZOMATLÁN,3,415,196,219,22
GUERRERO,12,HUITZUCO DE LOS FIGUEROA,034,SAN MIGUEL DE LAS PALMAS,4,312,140,172,17
GUERRERO,12,HUITZUCO DE LOS FIGUEROA,034,TECOACUILCO,2,33,16,17,3
GUERRERO,12,HUITZUCO DE LOS FIGUEROA,034,TECOLOTLA,3,89,56,33,6
GUERRERO,12,HUITZUCO DE LOS FIGUEROA,034,TEXAHUALCO (TEYAHUALCO),2,38,17,21,3
GUERRERO,12,HUITZUCO DE LOS FIGUEROA,034,TLAPALA,4,172,81,91,14
GUERRERO,12,HUITZUCO DE LOS FIGUEROA,034,TLAXMALAC,8,326,183,143,38
GUERRERO,12,HUITZUCO DE LOS FIGUEROA,034,TULIMÁN,9,1085,534,551,59
GUERRERO,12,HUITZUCO DE LOS FIGUEROA,034,XILOCINTLA,3,158,80,78,12
GUERRERO,12,HUITZUCO DE LOS FIGUEROA,034,XOYACUAUTLA,2,19,9,10,3
GUERRERO,12,IGUALA DE LA INDEPENDENCIA,035,AHUEHUEPAN,3,123,63,60,22
GUERRERO,12,IGUALA DE LA INDEPENDENCIA,035,CEJA BLANCA,4,148,70,78,12
GUERRERO,12,IGUALA DE LA INDEPENDENCIA,035,COACOYULA DE ÁLVAREZ,6,624,288,336,46
GUERRERO,12,IGUALA DE LA INDEPENDENCIA,035,COLONIA ÁLVARO OBREGÓN,2,14,8,6,2
GUERRERO,12,IGUALA DE LA INDEPENDENCIA,035,COLONIA ERNESTO CHE GUEVARA (LA CHE GUEVARA),2,24,12,12,2
GUERRERO,12,IGUALA DE LA INDEPENDENCIA,035,COLONIA LOMA DE LOS COYOTES,2,47,20,27,5
GUERRERO,12,IGUALA DE LA INDEPENDENCIA,035,EL NARANJO,3,167,86,81,12
GUERRERO,12,IGUALA DE LA INDEPENDENCIA,035,FERMÍN RABADÁN CERVANTES,1,123,62,61,7
GUERRERO,12,IGUALA DE LA INDEPENDENCIA,035,IGUALA DE LA INDEPENDENCIA,223,40828,20208,20620,2947
GUERRERO,12,IGUALA DE LA INDEPENDENCIA,035,JOYA DE PANTLA,2,67,32,35,8
GUERRERO,12,IGUALA DE LA INDEPENDENCIA,035,METLAPA,4,406,194,212,23
GUERRERO,12,IGUALA DE LA INDEPENDENCIA,035,OLEA (ESTACIÓN OLEA),2,23,12,11,3
GUERRERO,12,IGUALA DE LA INDEPENDENCIA,035,PANTLA DE ZAPOTAL,3,69,38,31,7
GUERRERO,12,IGUALA DE LA INDEPENDENCIA,035,PLATANILLO,3,39,19,20,6
GUERRERO,12,IGUALA DE LA INDEPENDENCIA,035,PUEBLO VIEJO,1,149,64,85,7
GUERRERO,12,IGUALA DE LA INDEPENDENCIA,035,RANCHO DEL CURA,3,108,55,53,10
GUERRERO,12,IGUALA DE LA INDEPENDENCIA,035,SANTA TERESA,6,606,306,300,47
GUERRERO,12,IGUALA DE LA INDEPENDENCIA,035,TEPOCHICA,4,241,113,128,19
GUERRERO,12,IGUALA DE LA INDEPENDENCIA,035,TONALAPITA DEL NORTE (PUENTE GONZÁLEZ),1,27,12,15,2
GUERRERO,12,IGUALA DE LA INDEPENDENCIA,035,TUXPAN,6,424,212,212,27
GUERRERO,12,IGUALA DE LA INDEPENDENCIA,035,ZACACOYUCA,3,243,120,123,20
GUERRERO,12,IGUALAPA,036,ACALMANI,4,237,127,110,16
GUERRERO,12,IGUALAPA,036,CHACALAPA,3,310,138,172,25
GUERRERO,12,IGUALAPA,036,CHIMALAPA,4,374,192,182,20
GUERRERO,12,IGUALAPA,036,COLONIA ENRIQUE RODRÍGUEZ CRUZ,3,87,43,44,7
GUERRERO,12,IGUALAPA,036,EL CAPULÍN,2,88,41,47,5
GUERRERO,12,IGUALAPA,036,IGUALAPA,10,839,411,428,52
GUERRERO,12,IGUALAPA,036,LA LIBERTAD,3,91,48,43,8
GUERRERO,12,IGUALAPA,036,LA REFORMA,4,176,82,94,13
GUERRERO,12,IGUALAPA,036,LA VICTORIA,3,103,52,51,8
GUERRERO,12,IGUALAPA,036,LLANO GRANDE DE JUÁREZ,5,291,156,135,16
GUERRERO,12,IGUALAPA,036,LLANO GRANDE DE LOS HILARIOS,6,236,113,123,17
GUERRERO,12,IGUALAPA,036,RANCHO EL ARBOLITO (JUAN CRISTÓBAL),1,7,4,3,1
GUERRERO,12,IGUALAPA,036,SAN JOSÉ BUENAVISTA,4,245,107,138,14
GUERRERO,12,IGUALAPA,036,SAN JUAN DE LOS LLANOS,4,524,267,257,31
GUERRERO,12,IGUALAPA,036,TEPATAHUAC,2,26,10,16,3
GUERRERO,12,IXCATEOPAN DE CUAUHTÉMOC,037,AMEALCO,2,11,4,7,2
GUERRERO,12,IXCATEOPAN DE CUAUHTÉMOC,037,EL POTRERO,1,5,3,2,1
GUERRERO,12,IXCATEOPAN DE CUAUHTÉMOC,037,EL PUENTE,2,26,12,14,2
GUERRERO,12,IXCATEOPAN DE CUAUHTÉMOC,037,EL PUENTE (PUENTE DELGADO),1,7,3,4,1
GUERRERO,12,IXCATEOPAN DE CUAUHTÉMOC,037,IXCATEOPAN DE CUAUHTÉMOC,6,602,285,317,39
GUERRERO,12,IXCATEOPAN DE CUAUHTÉMOC,037,LA MONERA TECORRAL,3,24,9,15,3
GUERRERO,12,IXCATEOPAN DE CUAUHTÉMOC,037,PIPINCATLA,3,91,48,43,6
GUERRERO,12,IXCATEOPAN DE CUAUHTÉMOC,037,ROMITA,3,38,21,17,4
GUERRERO,12,IXCATEOPAN DE CUAUHTÉMOC,037,SAN JUAN,2,12,7,5,3
GUERRERO,12,IXCATEOPAN DE CUAUHTÉMOC,037,SAN MARTÍN PACHIVIA (PACHIVIA),5,236,125,111,21
GUERRERO,12,IXCATEOPAN DE CUAUHTÉMOC,037,SAN PEDRO GUADALUPE,3,50,27,23,3
GUERRERO,12,IXCATEOPAN DE CUAUHTÉMOC,037,SIMATEL,4,116,55,61,10
GUERRERO,12,IXCATEOPAN DE CUAUHTÉMOC,037,TECOCIAPA,2,12,4,8,2
GUERRERO,12,IXCATEOPAN DE CUAUHTÉMOC,037,TENANGUILLO DE LAS CAÑAS,3,92,45,47,8
GUERRERO,12,IXCATEOPAN DE CUAUHTÉMOC,037,TEUCIZAPAN,3,80,41,39,4
GUERRERO,12,IXCATEOPAN DE CUAUHTÉMOC,037,XALOSTOC,2,7,3,4,3
GUERRERO,12,ZIHUATANEJO DE AZUETA,038,ARROYO SECO,1,7,5,2,1
GUERRERO,12,ZIHUATANEJO DE AZUETA,038,BARBULILLAS,2,154,75,79,7
GUERRERO,12,ZIHUATANEJO DE AZUETA,038,BARRANCA DE LA BANDERA,1,4,2,2,1
GUERRERO,12,ZIHUATANEJO DE AZUETA,038,BARRANCA DEL MONTOR (MONTOR UNO),1,7,3,4,1
GUERRERO,12,ZIHUATANEJO DE AZUETA,038,BARRIO NUEVO,3,239,115,124,15
GUERRERO,12,ZIHUATANEJO DE AZUETA,038,BUENA VISTA,3,174,81,93,12
GUERRERO,12,ZIHUATANEJO DE AZUETA,038,COLONIA AEROPUERTO,2,137,62,75,7
GUERRERO,12,ZIHUATANEJO DE AZUETA,038,COLONIA BALTAZAR R. LEYVA MANCILLA,2,7,4,3,1
GUERRERO,12,ZIHUATANEJO DE AZUETA,038,COLONIA TRES DE DICIEMBRE,2,30,18,12,3
GUERRERO,12,ZIHUATANEJO DE AZUETA,038,EL ARENOSITO,1,25,16,9,2
GUERRERO,12,ZIHUATANEJO DE AZUETA,038,EL CALABAZAL,1,7,1,6,1
GUERRERO,12,ZIHUATANEJO DE AZUETA,038,EL CALABAZALITO,4,92,53,39,8
GUERRERO,12,ZIHUATANEJO DE AZUETA,038,EL CAMALOTE,1,6,2,4,1
GUERRERO,12,ZIHUATANEJO DE AZUETA,038,EL CAPIRILLO,3,19,11,8,3
GUERRERO,12,ZIHUATANEJO DE AZUETA,038,EL COACOYUL,14,2113,1031,1082,105
GUERRERO,12,ZIHUATANEJO DE AZUETA,038,EL CORRIENTOSO,1,2,1,1,1
GUERRERO,12,ZIHUATANEJO DE AZUETA,038,EL ESPINALILLO,1,103,51,52,6
GUERRERO,12,ZIHUATANEJO DE AZUETA,038,EL GUAYABAL,3,41,22,19,4
GUERRERO,12,ZIHUATANEJO DE AZUETA,038,EL HIGO,1,8,4,4,1
GUERRERO,12,ZIHUATANEJO DE AZUETA,038,EL POSQUELITE,2,92,45,47,7
GUERRERO,12,ZIHUATANEJO DE AZUETA,038,EL TIRADERO,1,53,26,27,4
GUERRERO,12,ZIHUATANEJO DE AZUETA,038,EL ZARCO,3,129,59,70,10
GUERRERO,12,ZIHUATANEJO DE AZUETA,038,FIGUEROA,1,11,3,8,1
GUERRERO,12,ZIHUATANEJO DE AZUETA,038,IXTAPA ZIHUATANEJO,5,125,62,63,24
GUERRERO,12,ZIHUATANEJO DE AZUETA,038,LA CIÉNEGA,1,27,15,12,2
GUERRERO,12,ZIHUATANEJO DE AZUETA,038,LA LAGUNA,3,16,10,6,3
GUERRERO,12,ZIHUATANEJO DE AZUETA,038,LA LAJA (BUENAVISTA),3,85,50,35,7
GUERRERO,12,ZIHUATANEJO DE AZUETA,038,LA MESA DE LOS BRAVOS,2,7,2,5,1
GUERRERO,12,ZIHUATANEJO DE AZUETA,038,LA PAROTA,3,43,21,22,3
GUERRERO,12,ZIHUATANEJO DE AZUETA,038,LA PERICA,1,5,2,3,1
GUERRERO,12,ZIHUATANEJO DE AZUETA,038,LA PUERTA DE IXTAPA,3,674,341,333,18
GUERRERO,12,ZIHUATANEJO DE AZUETA,038,LA SALITRERA,3,254,125,129,11
GUERRERO,12,ZIHUATANEJO DE AZUETA,038,LA SOLEDAD,1,4,1,3,1
GUERRERO,12,ZIHUATANEJO DE AZUETA,038,LAS HIGUERITAS,3,14,7,7,2
GUERRERO,12,ZIHUATANEJO DE AZUETA,038,LAS OLLAS,3,65,38,27,6
GUERRERO,12,ZIHUATANEJO DE AZUETA,038,LAS PIPINAS,2,18,12,6,3
GUERRERO,12,ZIHUATANEJO DE AZUETA,038,LOS ACHOTES,4,232,110,122,14
GUERRERO,12,ZIHUATANEJO DE AZUETA,038,LOS ALMENDROS,3,362,166,196,21
GUERRERO,12,ZIHUATANEJO DE AZUETA,038,LOS LLANITOS,2,31,11,20,2
GUERRERO,12,ZIHUATANEJO DE AZUETA,038,NUEVO AMANECER,1,165,88,77,7
GUERRERO,12,ZIHUATANEJO DE AZUETA,038,PANTLA,7,914,469,445,51
GUERRERO,12,ZIHUATANEJO DE AZUETA,038,PLAYA BLANCA,1,7,1,6,1
GUERRERO,12,ZIHUATANEJO DE AZUETA,038,PLAYA LARGA,2,39,17,22,2
GUERRERO,12,ZIHUATANEJO DE AZUETA,038,PUERTECITO,1,2,0,2,1
GUERRERO,12,ZIHUATANEJO DE AZUETA,038,RABO DE IGUANA,1,13,8,5,1
GUERRERO,12,ZIHUATANEJO DE AZUETA,038,RANCHO LA ESPERANZA,1,558,266,292,19
GUERRERO,12,ZIHUATANEJO DE AZUETA,038,REAL DE GUADALUPE (EL MINERAL DE GUADALUPE),2,22,9,13,2
GUERRERO,12,ZIHUATANEJO DE AZUETA,038,SAN ANTONIO (LA CURVA),1,10,5,5,1
GUERRERO,12,ZIHUATANEJO DE AZUETA,038,SAN IGNACIO,2,17,6,11,2
GUERRERO,12,ZIHUATANEJO DE AZUETA,038,SAN JOSÉ IXTAPA (BARRIO VIEJO),9,1562,751,811,63
GUERRERO,12,ZIHUATANEJO DE AZUETA,038,SAN MIGUELITO,3,145,68,77,12
GUERRERO,12,ZIHUATANEJO DE AZUETA,038,VALLECITOS DE ZARAGOZA,5,298,142,156,21
GUERRERO,12,ZIHUATANEJO DE AZUETA,038,VILLA HERMOSA (LAS POZAS),1,66,29,37,4
GUERRERO,12,ZIHUATANEJO DE AZUETA,038,VISTA HERMOSA,1,5,2,3,1
GUERRERO,12,ZIHUATANEJO DE AZUETA,038,YERBABUENA,2,5,0,5,2
GUERRERO,12,ZIHUATANEJO DE AZUETA,038,ZIHUATANEJO,138,21804,11310,10494,1510
GUERRERO,12,ZIHUATANEJO DE AZUETA,038,ZUMATLÁN,1,11,5,6,1
GUERRERO,12,JUAN R. ESCUDERO,039,CHACALAPA DE BRAVOS,3,169,79,90,11
GUERRERO,12,JUAN R. ESCUDERO,039,EL POTRERO ORIENTAL,3,171,80,91,12
GUERRERO,12,JUAN R. ESCUDERO,039,EL PUENTE (SAN JOSÉ DEL PUENTE),3,147,76,71,9
GUERRERO,12,JUAN R. ESCUDERO,039,EL TABACAL,2,94,40,54,5
GUERRERO,12,JUAN R. ESCUDERO,039,EL TEPEHUAJE,2,21,5,16,2
GUERRERO,12,JUAN R. ESCUDERO,039,EL TEPEHUAJE DOS,2,17,8,9,2
GUERRERO,12,JUAN R. ESCUDERO,039,EL TERRERO,4,212,105,107,20
GUERRERO,12,JUAN R. ESCUDERO,039,EL ZAPOTE,2,41,22,19,3
GUERRERO,12,JUAN R. ESCUDERO,039,GARRAPATAS (GARRAPATA),3,99,45,54,10
GUERRERO,12,JUAN R. ESCUDERO,039,LA PALMA,4,417,206,211,44
GUERRERO,12,JUAN R. ESCUDERO,039,LAS PIÑAS,2,19,6,13,2
GUERRERO,12,JUAN R. ESCUDERO,039,MICHAPA,3,81,39,42,6
GUERRERO,12,JUAN R. ESCUDERO,039,OMITLÁN,3,97,43,54,7
GUERRERO,12,JUAN R. ESCUDERO,039,PALO GORDO,3,235,118,117,12
GUERRERO,12,JUAN R. ESCUDERO,039,PAPAGAYO,2,19,8,11,3
GUERRERO,12,JUAN R. ESCUDERO,039,PLAN DE LIMA,3,65,31,34,6
GUERRERO,12,JUAN R. ESCUDERO,039,SAN JUAN DEL REPARO NORTE (SAN JUAN DEL REPARO),2,171,89,82,21
GUERRERO,12,JUAN R. ESCUDERO,039,SAN JUAN DEL REPARO SUR (SAN JUAN DEL REPARO),4,320,166,154,23
GUERRERO,12,JUAN R. ESCUDERO,039,TIERRA COLORADA,20,3263,1587,1676,216
GUERRERO,12,JUAN R. ESCUDERO,039,TLALCHOCOHUITE,2,16,4,12,2
GUERRERO,12,JUAN R. ESCUDERO,039,TLAYOLAPA,4,267,137,130,15
GUERRERO,12,JUAN R. ESCUDERO,039,VILLA GUERRERO (JOBERO O TAJARITO),3,72,43,29,7
GUERRERO,12,LEONARDO BRAVO,040,AGUA DE PANTEÓN DE CORRALITOS,3,31,18,13,3
GUERRERO,12,LEONARDO BRAVO,040,ATLIXTAC,3,243,127,116,12
GUERRERO,12,LEONARDO BRAVO,040,CAMOTLA LA TORRE,1,21,16,5,2
GUERRERO,12,LEONARDO BRAVO,040,CAMPO DE AVIACIÓN,3,93,43,50,9
GUERRERO,12,LEONARDO BRAVO,040,CARRIZAL DE BRAVO,4,259,126,133,15
GUERRERO,12,LEONARDO BRAVO,040,CHICHIHUALCO,24,2514,1282,1232,158
GUERRERO,12,LEONARDO BRAVO,040,COATEPEC DE LA ESCALERA,3,78,38,40,6
GUERRERO,12,LEONARDO BRAVO,040,CORRAL DE PIEDRA,4,190,94,96,15
GUERRERO,12,LEONARDO BRAVO,040,EL BALZAMAR,3,272,116,156,12
GUERRERO,12,LEONARDO BRAVO,040,EL NARANJO,4,246,116,130,14
GUERRERO,12,LEONARDO BRAVO,040,IYOTLA,4,218,118,100,15
GUERRERO,12,LEONARDO BRAVO,040,LA FELICIDAD DE GARCÍA SUAZO,3,46,18,28,4
GUERRERO,12,LEONARDO BRAVO,040,LA NUEVA SOLEDAD,2,25,11,14,2
GUERRERO,12,LEONARDO BRAVO,040,LA SOLEDAD,1,37,22,15,2
GUERRERO,12,LEONARDO BRAVO,040,LAS JOYITAS,3,65,39,26,5
GUERRERO,12,LEONARDO BRAVO,040,LOS MORROS,3,75,49,26,7
GUERRERO,12,LEONARDO BRAVO,040,POLIXTEPEC,4,98,54,44,9
GUERRERO,12,LEONARDO BRAVO,040,PUENTECILLAS,3,45,16,29,5
GUERRERO,12,LEONARDO BRAVO,040,PUERTO GENERAL NICOLÁS BRAVO (FILO DE CABALLOS),5,270,137,133,32
GUERRERO,12,LEONARDO BRAVO,040,TEPOZONALCO,4,199,108,91,15
GUERRERO,12,LEONARDO BRAVO,040,TIERRA COLORADA,4,335,172,163,15
GUERRERO,12,LEONARDO BRAVO,040,YEXTLA,6,824,413,411,45
GUERRERO,12,MALINALTEPEC,041,AHUEJUYO VIEJO,2,25,12,13,2
GUERRERO,12,MALINALTEPEC,041,ALACATLATZALA,7,253,130,123,19
GUERRERO,12,MALINALTEPEC,041,CERRO DEL GUAYABO,1,9,4,5,1
GUERRERO,12,MALINALTEPEC,041,CERRO ZACATÓN (ZACATÓN),2,33,20,13,2
GUERRERO,12,MALINALTEPEC,041,CHAPULTEPEC,1,13,3,10,1
GUERRERO,12,MALINALTEPEC,041,COLOMBIA DE GUADALUPE,5,467,231,236,29
GUERRERO,12,MALINALTEPEC,041,COLONIA DEL OBISPO (LOMA DEL OBISPO),1,44,14,30,3
GUERRERO,12,MALINALTEPEC,041,COLONIA ENCINO ROBLE,1,10,4,6,1
GUERRERO,12,MALINALTEPEC,041,COLONIA LAGUNA CHALMA,1,16,9,7,1
GUERRERO,12,MALINALTEPEC,041,COLONIA SAN MATEO,2,125,67,58,9
GUERRERO,12,MALINALTEPEC,041,CUATZOQUITENGO,7,537,258,279,27
GUERRERO,12,MALINALTEPEC,041,EL HUAMÚCHIL,2,9,7,2,1
GUERRERO,12,MALINALTEPEC,041,EL MANGO (XABO NIKIL),2,35,18,17,3
GUERRERO,12,MALINALTEPEC,041,EL PORTEZUELO DE SANTA CRUZ (CRUZAMIENTO),2,24,13,11,2
GUERRERO,12,MALINALTEPEC,041,EL SALTO,2,29,12,17,3
GUERRERO,12,MALINALTEPEC,041,EL TEJOCOTE,4,453,218,235,23
GUERRERO,12,MALINALTEPEC,041,EL TEPEYAC,2,40,18,22,4
GUERRERO,12,MALINALTEPEC,041,ESPINO BLANCO,2,69,38,31,4
GUERRERO,12,MALINALTEPEC,041,FILO DE ACATEPEC,2,30,14,16,2
GUERRERO,12,MALINALTEPEC,041,HOMBRO DEL CERRO ARDILLA (CERRO ARDILLA),2,7,4,3,1
GUERRERO,12,MALINALTEPEC,041,HONDURA VERDE,1,21,9,12,2
GUERRERO,12,MALINALTEPEC,041,LA CANOA,1,15,5,10,1
GUERRERO,12,MALINALTEPEC,041,LA CIÉNEGA,3,325,207,118,39
GUERRERO,12,MALINALTEPEC,041,LA LUCERNA,2,74,30,44,9
GUERRERO,12,MALINALTEPEC,041,LA MAGUEYERA,1,8,3,5,1
GUERRERO,12,MALINALTEPEC,041,LA SOLEDAD,2,74,30,44,5
GUERRERO,12,MALINALTEPEC,041,LA TABERNA,1,15,9,6,1
GUERRERO,12,MALINALTEPEC,041,LAGUNA SECA,2,116,63,53,7
GUERRERO,12,MALINALTEPEC,041,LAGUNA TRES MARÍAS,2,56,33,23,3
GUERRERO,12,MALINALTEPEC,041,LINDA VISTA,1,36,19,17,3
GUERRERO,12,MALINALTEPEC,041,LLANO DE HENO,1,11,3,8,1
GUERRERO,12,MALINALTEPEC,041,LLANO DE MANZANO,1,7,3,4,1
GUERRERO,12,MALINALTEPEC,041,LLANO GRANDE,2,73,34,39,6
GUERRERO,12,MALINALTEPEC,041,LLANO MAJAHUA,2,61,35,26,4
GUERRERO,12,MALINALTEPEC,041,LLANO PANTANOSO,2,81,45,36,5
GUERRERO,12,MALINALTEPEC,041,LOMA CONCHA,2,11,6,5,2
GUERRERO,12,MALINALTEPEC,041,LOMA DEL FAISÁN,3,78,41,37,4
GUERRERO,12,MALINALTEPEC,041,LOMA MAMEY,2,26,15,11,3
GUERRERO,12,MALINALTEPEC,041,MALINALTEPEC,8,755,369,386,49
GUERRERO,12,MALINALTEPEC,041,MESÓN DE IXTLÁHUAC,3,325,136,189,16
GUERRERO,12,MALINALTEPEC,041,MONTE ALEGRE,3,142,72,70,9
GUERRERO,12,MALINALTEPEC,041,MONTE DE OLIVO,2,33,15,18,3
GUERRERO,12,MALINALTEPEC,041,MOYOTEPEC (MOYOTEPEC DE JUÁREZ),4,407,197,210,33
GUERRERO,12,MALINALTEPEC,041,OJO DE AGUA DE CUAUHTÉMOC,3,189,83,106,11
GUERRERO,12,MALINALTEPEC,041,PARAJE MONTERO (PARAJE MONTERO DE ZARAGOZA),5,735,386,349,47
GUERRERO,12,MALINALTEPEC,041,RANCHO NUEVO,2,42,19,23,3
GUERRERO,12,MALINALTEPEC,041,RAYO ALTO,2,18,5,13,2
GUERRERO,12,MALINALTEPEC,041,SAN DIEGO VISTA HERMOSA,2,31,16,15,3
GUERRERO,12,MALINALTEPEC,041,SAN JUAN DE LAS NIEVES,2,35,12,23,4
GUERRERO,12,MALINALTEPEC,041,SAN MIGUEL EL PROGRESO,4,308,151,157,20
GUERRERO,12,MALINALTEPEC,041,SAN MIGUEL EL RINCÓN,1,70,39,31,4
GUERRERO,12,MALINALTEPEC,041,SANTA CRUZ,1,12,7,5,1
GUERRERO,12,MALINALTEPEC,041,TAPAYOLTEPEC,4,201,96,105,10
GUERRERO,12,MALINALTEPEC,041,TILAPA,6,599,321,278,38
GUERRERO,12,MALINALTEPEC,041,UNIÓN DE LAS PERAS,2,37,14,23,4
GUERRERO,12,MALINALTEPEC,041,XKUA XTUTI,2,53,29,24,4
GUERRERO,12,MALINALTEPEC,041,XOCHIATENCO,2,79,44,35,5
GUERRERO,12,MALINALTEPEC,041,YAUTEPEC,2,86,45,41,6
GUERRERO,12,MÁRTIR DE CUILAPAN,042,AHUETLIXPA,2,69,30,39,5
GUERRERO,12,MÁRTIR DE CUILAPAN,042,AHUEXOTITLÁN,3,95,48,47,8
GUERRERO,12,MÁRTIR DE CUILAPAN,042,AIXCUALCO,3,134,57,77,9
GUERRERO,12,MÁRTIR DE CUILAPAN,042,ANALCO,3,64,32,32,6
GUERRERO,12,MÁRTIR DE CUILAPAN,042,APANGO,7,1181,606,575,69
GUERRERO,12,MÁRTIR DE CUILAPAN,042,HUEYITLALPAN,3,508,244,264,25
GUERRERO,12,MÁRTIR DE CUILAPAN,042,LA ESPERANZA,5,663,343,320,31
GUERRERO,12,MÁRTIR DE CUILAPAN,042,SAN AGUSTÍN OSTOTIPAN,3,167,86,81,9
GUERRERO,12,MÁRTIR DE CUILAPAN,042,SAN JUAN TOTOLCINTLA,5,671,342,329,28
GUERRERO,12,MÁRTIR DE CUILAPAN,042,SAN MARCOS OACATZINGO,3,218,128,90,12
GUERRERO,12,MÁRTIR DE CUILAPAN,042,TEBERNILLAS,2,56,30,26,5
GUERRERO,12,MÁRTIR DE CUILAPAN,042,TLAIXCUAC,1,12,1,11,1
GUERRERO,12,MÁRTIR DE CUILAPAN,042,TLAMAMACAN,3,228,102,126,13
GUERRERO,12,MÁRTIR DE CUILAPAN,042,TULA DEL RÍO,3,278,137,141,13
GUERRERO,12,MÁRTIR DE CUILAPAN,042,XICOMULCO,3,157,81,76,10
GUERRERO,12,MÁRTIR DE CUILAPAN,042,ZOTOLTITLÁN,6,786,399,387,41
GUERRERO,12,METLATÓNOC,043,BUENA VISTA,2,17,5,12,2
GUERRERO,12,METLATÓNOC,043,CHILIXTLAHUACA,5,522,297,225,27
GUERRERO,12,METLATÓNOC,043,COCUILOTLAZALA (COCUITLAZALA EL VIEJO),3,305,161,144,15
GUERRERO,12,METLATÓNOC,043,COLONIA DE GUADALUPE,3,172,95,77,8
GUERRERO,12,METLATÓNOC,043,COSTA RICA COLORADA,3,87,43,44,5
GUERRERO,12,METLATÓNOC,043,EL CHOKI,1,8,3,5,1
GUERRERO,12,METLATÓNOC,043,EL COYULITO (EL CORAZÓN),2,43,26,17,3
GUERRERO,12,METLATÓNOC,043,EL PARAÍSO,1,8,5,3,1
GUERRERO,12,METLATÓNOC,043,EL ZAPOTE,4,165,81,84,9
GUERRERO,12,METLATÓNOC,043,FRANCISCO I. MADERO,2,138,70,68,7
GUERRERO,12,METLATÓNOC,043,FRANCISCO VILLA (VIRGEN DE LA VILLA),1,15,2,13,1
GUERRERO,12,METLATÓNOC,043,HUEXOAPA (SAN JUAN HUEXOAPA),4,328,171,157,18
GUERRERO,12,METLATÓNOC,043,ITIA NIVEHE XAHAXIQUI,1,23,7,16,1
GUERRERO,12,METLATÓNOC,043,ITIA ZUTI,3,84,41,43,5
GUERRERO,12,METLATÓNOC,043,JUANACATLÁN,4,312,166,146,23
GUERRERO,12,METLATÓNOC,043,LA PRIMAVERA,2,9,1,8,3
GUERRERO,12,METLATÓNOC,043,LAGUNILLA YUCUTUNI,3,126,67,59,6
GUERRERO,12,METLATÓNOC,043,LLANO DE LA PAROTA (EL RANCHO),1,20,8,12,1
GUERRERO,12,METLATÓNOC,043,LLANO DE LA RANA (XAHA CUCHO DIJ),2,56,32,24,3
GUERRERO,12,METLATÓNOC,043,LLANO DE LAS FLORES,2,49,25,24,4
GUERRERO,12,METLATÓNOC,043,LLANO DE LAS FLORES NÚMERO 1,2,46,26,20,2
GUERRERO,12,METLATÓNOC,043,LLANO DE NOPAL,2,46,23,23,3
GUERRERO,12,METLATÓNOC,043,LLANO DE OCOTE (YOSO TUXA),1,11,5,6,1
GUERRERO,12,METLATÓNOC,043,LLANO DE TEPEHUAJE (TEPEHUAJE),2,36,19,17,3
GUERRERO,12,METLATÓNOC,043,LOMA BONITA,1,12,7,5,1
GUERRERO,12,METLATÓNOC,043,LOS LLANOS (YOSO TIAÑU'U),2,64,34,30,3
GUERRERO,12,METLATÓNOC,043,METLATÓNOC,13,1854,949,905,72
GUERRERO,12,METLATÓNOC,043,MINI NUHUMA,2,93,50,43,4
GUERRERO,12,METLATÓNOC,043,NUHU SAVI KANI,1,57,24,33,4
GUERRERO,12,METLATÓNOC,043,OJO DE PESCADO,4,166,86,80,10
GUERRERO,12,METLATÓNOC,043,RÍO SAN MARTÍN,1,4,2,2,1
GUERRERO,12,METLATÓNOC,043,SAN ANTONIO,2,41,24,17,3
GUERRERO,12,METLATÓNOC,043,SAN JUAN PUERTO MONTAÑA,4,324,180,144,22
GUERRERO,12,METLATÓNOC,043,SAN MARCOS,3,94,47,47,5
GUERRERO,12,METLATÓNOC,043,SAN PABLO ATZOMPA,3,279,147,132,14
GUERRERO,12,METLATÓNOC,043,SAN PEDRO ATZOMPA,1,67,25,42,4
GUERRERO,12,METLATÓNOC,043,SANTA CATARINA,2,73,35,38,4
GUERRERO,12,METLATÓNOC,043,SANTA CRUZ CAFETAL,2,47,25,22,3
GUERRERO,12,METLATÓNOC,043,TEHUIXTEPEC,2,136,72,64,7
GUERRERO,12,METLATÓNOC,043,VALLE HERMOSO,3,137,74,63,8
GUERRERO,12,METLATÓNOC,043,VICENTE GUERRERO,3,80,40,40,4
GUERRERO,12,METLATÓNOC,043,VILLA DE GUADALUPE (TRES RÍOS),3,64,30,34,5
GUERRERO,12,METLATÓNOC,043,XACUNDUTIA,2,48,21,27,3
GUERRERO,12,METLATÓNOC,043,YOZO CHUM,2,33,20,13,2
GUERRERO,12,METLATÓNOC,043,YUCUNDUTA,2,85,48,37,3
GUERRERO,12,METLATÓNOC,043,YU'U TIMI,2,46,21,25,4
GUERRERO,12,METLATÓNOC,043,YUVINANI,5,220,100,120,13
GUERRERO,12,METLATÓNOC,043,YUVITIAQUI (BARRANCA SOLTERA),1,15,9,6,1
GUERRERO,12,METLATÓNOC,043,ZITLALTEPEC,4,264,148,116,14
GUERRERO,12,MOCHITLÁN,044,CHACOTLA,3,48,22,26,4
GUERRERO,12,MOCHITLÁN,044,COATOMATITLÁN,3,95,42,53,12
GUERRERO,12,MOCHITLÁN,044,COAXTLAHUACÁN,4,147,77,70,12
GUERRERO,12,MOCHITLÁN,044,EL NARANJO,2,25,10,15,2
GUERRERO,12,MOCHITLÁN,044,EL RINCÓN DE TLAPACHOLAPA (EL RINCÓN),2,30,17,13,2
GUERRERO,12,MOCHITLÁN,044,EL SALADO,3,111,47,64,7
GUERRERO,12,MOCHITLÁN,044,LAGUNA DE SAN ISIDRO,3,27,15,12,3
GUERRERO,12,MOCHITLÁN,044,LAGUNILLA,2,52,25,27,4
GUERRERO,12,MOCHITLÁN,044,LAS PAROTAS,2,8,4,4,1
GUERRERO,12,MOCHITLÁN,044,LOS DIRCIOS,3,22,9,13,3
GUERRERO,12,MOCHITLÁN,044,MOCHITLÁN,10,1744,927,817,83
GUERRERO,12,MOCHITLÁN,044,MONTE ALEGRE,4,143,69,74,14
GUERRERO,12,MOCHITLÁN,044,OJO DE AGUA DE SAN FRANCISCO,1,4,3,1,1
GUERRERO,12,MOCHITLÁN,044,RANCHO VIEJO,1,4,1,3,1
GUERRERO,12,MOCHITLÁN,044,SAN MIGUEL,3,191,92,99,12
GUERRERO,12,MOCHITLÁN,044,SAN ROQUE,3,79,41,38,7
GUERRERO,12,MOCHITLÁN,044,TLACOTEPEC,2,31,13,18,3
GUERRERO,12,MOCHITLÁN,044,TLACOTITLANAPA,4,90,51,39,10
GUERRERO,12,MOCHITLÁN,044,TLAPACHOLAPA,2,9,3,6,2
GUERRERO,12,MOCHITLÁN,044,ZINTLANAPA,3,25,12,13,3
GUERRERO,12,OLINALÁ,045,AHUACATLÁN,4,309,145,164,15
GUERRERO,12,OLINALÁ,045,AMATLICHA,3,182,98,84,11
GUERRERO,12,OLINALÁ,045,CHAUTIPA,3,86,35,51,5
GUERRERO,12,OLINALÁ,045,COLONIA ALTAMIRANO,2,47,19,28,4
GUERRERO,12,OLINALÁ,045,COLONIA SAN PEDRO,1,28,15,13,1
GUERRERO,12,OLINALÁ,045,DURAZNOTITLÁN,2,50,26,24,4
GUERRERO,12,OLINALÁ,045,EL CARRIZO,1,16,8,8,1
GUERRERO,12,OLINALÁ,045,EL PROGRESO (CHUPANDILLO),1,8,4,4,1
GUERRERO,12,OLINALÁ,045,EL REFUGIO,3,60,22,38,3
GUERRERO,12,OLINALÁ,045,IYOCINGO (VENTANAS IYOCINGO),3,42,25,17,3
GUERRERO,12,OLINALÁ,045,LA CIÉNEGA,2,70,36,34,4
GUERRERO,12,OLINALÁ,045,LA LIBERTAD,4,230,135,95,14
GUERRERO,12,OLINALÁ,045,LAS JUNTAS,2,111,49,62,6
GUERRERO,12,OLINALÁ,045,LINDA VISTA,1,13,5,8,1
GUERRERO,12,OLINALÁ,045,LOMA DE MAZATEPEC (MAZATEPEC),2,87,37,50,5
GUERRERO,12,OLINALÁ,045,LOMA LARGA (EL LAMBEDERO),2,7,5,2,1
GUERRERO,12,OLINALÁ,045,LOMAS DE COCOYOC,2,29,13,16,3
GUERRERO,12,OLINALÁ,045,LOMAS DE TECOJCOYUNCA,3,61,28,33,4
GUERRERO,12,OLINALÁ,045,OCOTITLÁN,2,59,30,29,5
GUERRERO,12,OLINALÁ,045,OLINALÁ,15,2293,1222,1071,126
GUERRERO,12,OLINALÁ,045,SAN ANTONIO COYAHUACÁN,5,578,280,298,31
GUERRERO,12,OLINALÁ,045,SAN FELIPE AMATITLÁN (AMATITLÁN),2,30,15,15,2
GUERRERO,12,OLINALÁ,045,SAN JOSÉ AMOLTEPEC (AMOLTEPEC),3,90,44,46,5
GUERRERO,12,OLINALÁ,045,SAN JOSÉ TECOMULCO,1,12,6,6,1
GUERRERO,12,OLINALÁ,045,SAN LÁZARO (TECOJCOSCO),4,184,87,97,9
GUERRERO,12,OLINALÁ,045,SANTA CRUZ LOMALAPA (LOMALAPA),5,142,63,79,9
GUERRERO,12,OLINALÁ,045,TECOLAPA,4,269,134,135,15
GUERRERO,12,OLINALÁ,045,TECORRALES,3,132,69,63,7
GUERRERO,12,OLINALÁ,045,TECORRALES DE LAS MINAS,1,21,10,11,1
GUERRERO,12,OLINALÁ,045,TEHUAXTITLÁN,5,209,117,92,13
GUERRERO,12,OLINALÁ,045,TEHUIXTLA,3,37,23,14,5
GUERRERO,12,OLINALÁ,045,TEMALACATZINGO,8,1458,703,755,70
GUERRERO,12,OLINALÁ,045,TEPETITLÁN,2,65,28,37,4
GUERRERO,12,OLINALÁ,045,TEPETLACINGO,3,176,99,77,11
GUERRERO,12,OLINALÁ,045,TETELCINGO,2,10,8,2,1
GUERRERO,12,OLINALÁ,045,TETICIC,4,212,98,114,13
GUERRERO,12,OLINALÁ,045,TOMATEPEC,2,47,24,23,3
GUERRERO,12,OLINALÁ,045,VISTA HERMOSA,3,30,17,13,3
GUERRERO,12,OLINALÁ,045,XIXILA,2,66,37,29,4
GUERRERO,12,OLINALÁ,045,XOCHIMILCO,2,34,13,21,4
GUERRERO,12,OLINALÁ,045,ZACANGO,2,71,34,37,5
GUERRERO,12,OLINALÁ,045,ZICATLÁN,2,123,70,53,8
GUERRERO,12,OLINALÁ,045,ZOMPEPELCO,2,19,10,9,2
GUERRERO,12,OLINALÁ,045,ZONTECOMATLÁN,4,172,85,87,10
GUERRERO,12,OLINALÁ,045,ZUMPANGO,3,271,119,152,15
GUERRERO,12,OMETEPEC,046,ACATEPEC,8,1157,572,585,65
GUERRERO,12,OMETEPEC,046,ARROYO BARRANCA HONDA,3,314,148,166,18
GUERRERO,12,OMETEPEC,046,ARROYO ZAPOTE,2,10,3,7,2
GUERRERO,12,OMETEPEC,046,CERRO GRANDE,2,82,47,35,5
GUERRERO,12,OMETEPEC,046,CERRO PÁJARO,2,45,25,20,4
GUERRERO,12,OMETEPEC,046,COCHOAPA,10,1483,720,763,88
GUERRERO,12,OMETEPEC,046,CRUZ DE CORAZÓN,3,157,80,77,12
GUERRERO,12,OMETEPEC,046,CRUZ VERDE I,1,96,48,48,7
GUERRERO,12,OMETEPEC,046,CRUZ VERDE II,2,95,45,50,5
GUERRERO,12,OMETEPEC,046,CUADRILLA NUEVA (CHILPANCINGUITO),2,19,4,15,3
GUERRERO,12,OMETEPEC,046,CUMBRE DE BARRANCA HONDA,5,512,259,253,28
GUERRERO,12,OMETEPEC,046,EL CAPRICHO (LA POZA),3,79,39,40,5
GUERRERO,12,OMETEPEC,046,EL CHARCO DE LA PUERTA,3,121,64,57,8
GUERRERO,12,OMETEPEC,046,EL LIMÓN,2,42,25,17,3
GUERRERO,12,OMETEPEC,046,EL MANGO (EL MANGO SOLO SUR),3,17,10,7,3
GUERRERO,12,OMETEPEC,046,EL TAMARINDO,3,76,38,38,7
GUERRERO,12,OMETEPEC,046,HUAJINTEPEC,7,794,409,385,55
GUERRERO,12,OMETEPEC,046,HUIXTEPEC,8,973,474,499,53
GUERRERO,12,OMETEPEC,046,LA CATALINA,2,31,19,12,2
GUERRERO,12,OMETEPEC,046,LA CONCEPCIÓN,3,225,106,119,12
GUERRERO,12,OMETEPEC,046,LA GUADALUPE,5,361,171,190,23
GUERRERO,12,OMETEPEC,046,LA LADRILLERA,3,81,38,43,6
GUERRERO,12,OMETEPEC,046,LA LIBERTAD,2,37,24,13,3
GUERRERO,12,OMETEPEC,046,LA SOLEDAD,3,206,91,115,13
GUERRERO,12,OMETEPEC,046,LAS IGUANAS,4,168,91,77,9
GUERRERO,12,OMETEPEC,046,LAS PALMAS,5,24,10,14,5
GUERRERO,12,OMETEPEC,046,LAS VIGAS,3,188,100,88,11
GUERRERO,12,OMETEPEC,046,MANGO NORTE (EL MANGO SOLO NORTE),1,11,6,5,2
GUERRERO,12,OMETEPEC,046,MAZAPA,1,14,8,6,2
GUERRERO,12,OMETEPEC,046,MILPILLAS,2,95,45,50,8
GUERRERO,12,OMETEPEC,046,OMETEPEC,74,12940,7015,5925,864
GUERRERO,12,OMETEPEC,046,PASO CUAHULOTE,1,21,6,15,1
GUERRERO,12,OMETEPEC,046,PASO CUAHULOTE DOS,1,37,15,22,4
GUERRERO,12,OMETEPEC,046,PASO DEL TABACO,1,13,8,5,1
GUERRERO,12,OMETEPEC,046,PIEDRA ANCHA,4,159,84,75,11
GUERRERO,12,OMETEPEC,046,PIEDRA BOLUDA,3,93,47,46,9
GUERRERO,12,OMETEPEC,046,PIEDRA DEL TIGRE,4,50,28,22,6
GUERRERO,12,OMETEPEC,046,PIEDRA LABRADA,3,44,26,18,4
GUERRERO,12,OMETEPEC,046,PLAN JUSTE,2,99,43,56,8
GUERRERO,12,OMETEPEC,046,RANCHO SAN FRANCISCO,3,22,14,8,3
GUERRERO,12,OMETEPEC,046,SAN ISIDRO,2,50,22,28,4
GUERRERO,12,OMETEPEC,046,SAN JOSÉ EJIDO (SAN JOSÉ),2,103,48,55,9
GUERRERO,12,OMETEPEC,046,SANTA CRUZ TECONTE (EL TECONTE),2,53,23,30,4
GUERRERO,12,OMETEPEC,046,SANTA MARÍA (SANTA MARÍA ASUNCIÓN),6,666,323,343,41
GUERRERO,12,OMETEPEC,046,TIERRA BLANCA,4,239,121,118,15
GUERRERO,12,OMETEPEC,046,TIERRA COLORADA,3,54,21,33,5
GUERRERO,12,OMETEPEC,046,VILLA HIDALGO,3,143,69,74,10
GUERRERO,12,OMETEPEC,046,VISTA HERMOSA,4,161,88,73,12
GUERRERO,12,OMETEPEC,046,ZACOALPAN,10,1840,895,945,86
GUERRERO,12,PEDRO ASCENCIO ALQUISIRAS,047,ACATLA,3,40,20,20,4
GUERRERO,12,PEDRO ASCENCIO ALQUISIRAS,047,AGUA COLORADA,1,5,3,2,1
GUERRERO,12,PEDRO ASCENCIO ALQUISIRAS,047,AGUA DEL MONTE,1,6,2,4,1
GUERRERO,12,PEDRO ASCENCIO ALQUISIRAS,047,AMATE DE LA PIEDRA,2,51,22,29,4
GUERRERO,12,PEDRO ASCENCIO ALQUISIRAS,047,ATOTONGO,3,35,17,18,3
GUERRERO,12,PEDRO ASCENCIO ALQUISIRAS,047,ATOTONILCO,1,8,5,3,1
GUERRERO,12,PEDRO ASCENCIO ALQUISIRAS,047,AYAHUALCO,3,36,19,17,3
GUERRERO,12,PEDRO ASCENCIO ALQUISIRAS,047,AZULÁQUEZ,3,81,41,40,5
GUERRERO,12,PEDRO ASCENCIO ALQUISIRAS,047,CAÑADA DE TEPOXONAL,1,5,3,2,1
GUERRERO,12,PEDRO ASCENCIO ALQUISIRAS,047,CAPULINES,3,41,18,23,3
GUERRERO,12,PEDRO ASCENCIO ALQUISIRAS,047,CERRO DE ZACAHUIXTEPEC,2,23,10,13,3
GUERRERO,12,PEDRO ASCENCIO ALQUISIRAS,047,CERRO GRANDE,2,30,16,14,2
GUERRERO,12,PEDRO ASCENCIO ALQUISIRAS,047,CHICAHUACA,2,29,12,17,4
GUERRERO,12,PEDRO ASCENCIO ALQUISIRAS,047,CIRIÁN GRANDE,2,14,5,9,2
GUERRERO,12,PEDRO ASCENCIO ALQUISIRAS,047,CRUZ ALTA,2,5,2,3,1
GUERRERO,12,PEDRO ASCENCIO ALQUISIRAS,047,CUAHUAZALPA,3,45,26,19,3
GUERRERO,12,PEDRO ASCENCIO ALQUISIRAS,047,EL PUENTE COLORADO,2,5,1,4,2
GUERRERO,12,PEDRO ASCENCIO ALQUISIRAS,047,EL TECOLOTE,2,9,4,5,1
GUERRERO,12,PEDRO ASCENCIO ALQUISIRAS,047,IXCAPANECA,2,21,13,8,2
GUERRERO,12,PEDRO ASCENCIO ALQUISIRAS,047,IXCAPUZALCO,4,293,143,150,30
GUERRERO,12,PEDRO ASCENCIO ALQUISIRAS,047,IXTLAHUACATENGO,4,139,74,65,14
GUERRERO,12,PEDRO ASCENCIO ALQUISIRAS,047,LA GAVIA,2,13,8,5,3
GUERRERO,12,PEDRO ASCENCIO ALQUISIRAS,047,LLANO DE LA MERCED,1,15,8,7,1
GUERRERO,12,PEDRO ASCENCIO ALQUISIRAS,047,LOS SAUCES,1,5,1,4,1
GUERRERO,12,PEDRO ASCENCIO ALQUISIRAS,047,METLIXTAPA,1,24,8,16,3
GUERRERO,12,PEDRO ASCENCIO ALQUISIRAS,047,OTATES,3,27,9,18,3
GUERRERO,12,PEDRO ASCENCIO ALQUISIRAS,047,PERICONES,2,5,3,2,2
GUERRERO,12,PEDRO ASCENCIO ALQUISIRAS,047,PIEDRA COLGADA,1,12,7,5,1
GUERRERO,12,PEDRO ASCENCIO ALQUISIRAS,047,PIEDRA GRANDE,1,5,2,3,1
GUERRERO,12,PEDRO ASCENCIO ALQUISIRAS,047,RANCHO NUEVO,3,36,17,19,5
GUERRERO,12,PEDRO ASCENCIO ALQUISIRAS,047,RANCHO VIEJO,3,34,15,19,3
GUERRERO,12,PEDRO ASCENCIO ALQUISIRAS,047,RINCÓN DE JUMAPA,2,13,6,7,2
GUERRERO,12,PEDRO ASCENCIO ALQUISIRAS,047,SALITRE GRANDE (EL SALITRE),2,28,14,14,2
GUERRERO,12,PEDRO ASCENCIO ALQUISIRAS,047,SAN PABLO,4,94,47,47,9
GUERRERO,12,PEDRO ASCENCIO ALQUISIRAS,047,SANTA LUCÍA,3,50,24,26,3
GUERRERO,12,PEDRO ASCENCIO ALQUISIRAS,047,SANTIAGO SALINAS,2,7,3,4,2
GUERRERO,12,PEDRO ASCENCIO ALQUISIRAS,047,TEJOCOTES,4,84,47,37,8
GUERRERO,12,PEDRO ASCENCIO ALQUISIRAS,047,TEPATULCO,1,7,3,4,1
GUERRERO,12,PEDRO ASCENCIO ALQUISIRAS,047,TLANILPA,4,133,74,59,10
GUERRERO,12,PEDRO ASCENCIO ALQUISIRAS,047,YAHUALTENGO,3,38,20,18,4
GUERRERO,12,PEDRO ASCENCIO ALQUISIRAS,047,ZACATLÁN GRANDE,3,65,32,33,5
GUERRERO,12,PETATLÁN,048,ALPUYEQUE,1,7,4,3,1
GUERRERO,12,PETATLÁN,048,ARROYO SECO,2,69,30,39,3
GUERRERO,12,PETATLÁN,048,ARROYO VERDE,3,81,45,36,5
GUERRERO,12,PETATLÁN,048,BARRA DE POTOSÍ,3,111,63,48,6
GUERRERO,12,PETATLÁN,048,BARRANCA DEL BÁLSAMO (LA BARRANCA),1,8,5,3,1
GUERRERO,12,PETATLÁN,048,BARRANCA DEL SERENO,3,25,15,10,3
GUERRERO,12,PETATLÁN,048,BARRIO NUEVO,1,10,3,7,1
GUERRERO,12,PETATLÁN,048,CHAVETA,4,23,11,12,5
GUERRERO,12,PETATLÁN,048,CIÉNEGA (CIÉNEGA DEL CAYACAL),2,14,7,7,3
GUERRERO,12,PETATLÁN,048,COLONIA JUÁREZ (VENADO),1,30,13,17,2
GUERRERO,12,PETATLÁN,048,CORRALITOS,3,12,5,7,3
GUERRERO,12,PETATLÁN,048,COYUQUILLA NORTE,5,483,230,253,45
GUERRERO,12,PETATLÁN,048,COYUQUILLA SUR (COYUQUILLA VIEJO),3,69,35,34,6
GUERRERO,12,PETATLÁN,048,EL ANONAL,2,6,4,2,2
GUERRERO,12,PETATLÁN,048,EL ANONITO,3,11,6,5,2
GUERRERO,12,PETATLÁN,048,EL ANONO,1,24,16,8,3
GUERRERO,12,PETATLÁN,048,EL BALCÓN DE LA BANDERA,3,16,13,3,2
GUERRERO,12,PETATLÁN,048,EL CACAO,1,2,2,0,1
GUERRERO,12,PETATLÁN,048,EL CAMALOTE,3,22,11,11,4
GUERRERO,12,PETATLÁN,048,EL CAMALOTITO,2,19,8,11,2
GUERRERO,12,PETATLÁN,048,EL CAMOTAL,2,6,3,3,2
GUERRERO,12,PETATLÁN,048,EL CAYACAL,3,52,16,36,4
GUERRERO,12,PETATLÁN,048,EL HIGUERAL,2,12,5,7,2
GUERRERO,12,PETATLÁN,048,EL HUIZACHE,2,4,1,3,1
GUERRERO,12,PETATLÁN,048,EL MAMEYAL,4,87,58,29,10
GUERRERO,12,PETATLÁN,048,EL MAMEYCITO,1,24,8,16,2
GUERRERO,12,PETATLÁN,048,EL NANCHE,1,2,1,1,1
GUERRERO,12,PETATLÁN,048,EL PAROTAL,3,47,25,22,4
GUERRERO,12,PETATLÁN,048,EL PATACUAL,3,27,10,17,4
GUERRERO,12,PETATLÁN,048,EL REGADITO,1,4,3,1,1
GUERRERO,12,PETATLÁN,048,EL SALTO,2,6,2,4,1
GUERRERO,12,PETATLÁN,048,EL VARILLAL,3,10,3,7,2
GUERRERO,12,PETATLÁN,048,EL VENADITO,1,2,0,2,1
GUERRERO,12,PETATLÁN,048,EL ZAPOTILLAL,1,10,3,7,1
GUERRERO,12,PETATLÁN,048,JULUCHUCA,4,199,89,110,10
GUERRERO,12,PETATLÁN,048,LA BARRITA (PLAYA LA BARRITA),2,19,12,7,2
GUERRERO,12,PETATLÁN,048,LA CALERA DE SANTA LUCÍA,3,48,16,32,5
GUERRERO,12,PETATLÁN,048,LA CEIBA (LA CEIBA DE SAN JOSÉ),2,19,14,5,2
GUERRERO,12,PETATLÁN,048,LA CEIBA (LA CEIBA DEL OCOTE DE CADENA),1,10,6,4,1
GUERRERO,12,PETATLÁN,048,LA CRUZ DE OTATE,2,6,4,2,2
GUERRERO,12,PETATLÁN,048,LA ESCONDIDA,2,6,4,2,1
GUERRERO,12,PETATLÁN,048,LA FINCA (LA FINCA DE GILDARDO),1,3,0,3,1
GUERRERO,12,PETATLÁN,048,LA LAJITA,3,57,26,31,4
GUERRERO,12,PETATLÁN,048,LA MOLONGA,1,12,6,6,1
GUERRERO,12,PETATLÁN,048,LA MORENA,1,21,11,10,1
GUERRERO,12,PETATLÁN,048,LA PALMA,1,11,6,5,1
GUERRERO,12,PETATLÁN,048,LA PASIÓN,2,9,5,4,3
GUERRERO,12,PETATLÁN,048,LA SOLEDAD (SOLEDAD DE MACIEL),3,79,41,38,5
GUERRERO,12,PETATLÁN,048,LA SOLEDAD DE LA PALMA (LA CHOLE),2,9,2,7,2
GUERRERO,12,PETATLÁN,048,LA TIGRA,2,9,4,5,2
GUERRERO,12,PETATLÁN,048,LAS CANALEJAS,3,23,15,8,3
GUERRERO,12,PETATLÁN,048,LAS CUBAS (LA CONCHUDA),3,9,6,3,3
GUERRERO,12,PETATLÁN,048,LAS HUERTAS,2,19,11,8,2
GUERRERO,12,PETATLÁN,048,LAS MESAS,4,133,62,71,12
GUERRERO,12,PETATLÁN,048,LAS PLACITAS,1,22,5,17,1
GUERRERO,12,PETATLÁN,048,LAS SALINAS (SALINAS EL CUAJO),1,13,9,4,1
GUERRERO,12,PETATLÁN,048,LLANOS DE LA PUERTA,3,23,9,14,3
GUERRERO,12,PETATLÁN,048,LOMA BONITA,1,16,8,8,1
GUERRERO,12,PETATLÁN,048,LOS ALAMBRADOS,3,16,7,9,3
GUERRERO,12,PETATLÁN,048,LOS CUAHULOTITOS,2,16,5,11,2
GUERRERO,12,PETATLÁN,048,LOS GUAPINOLES,2,11,6,5,2
GUERRERO,12,PETATLÁN,048,LOS MANGOS,1,53,32,21,5
GUERRERO,12,PETATLÁN,048,LOS PLANES,3,58,28,30,4
GUERRERO,12,PETATLÁN,048,LOS ZAPOTES,1,7,3,4,1
GUERRERO,12,PETATLÁN,048,MURGA,3,51,23,28,4
GUERRERO,12,PETATLÁN,048,OCOTE DE PEREGRINO,3,74,40,34,7
GUERRERO,12,PETATLÁN,048,PALOS BLANCOS,2,195,82,113,10
GUERRERO,12,PETATLÁN,048,PARAZAL,2,23,11,12,2
GUERRERO,12,PETATLÁN,048,PETATLÁN,39,6921,3324,3597,473
GUERRERO,12,PETATLÁN,048,PIEDRA DE VELIANO,2,19,10,9,2
GUERRERO,12,PETATLÁN,048,POTRERILLOS,3,19,6,13,3
GUERRERO,12,PETATLÁN,048,PUENTE DEL TUZAL,2,11,4,7,3
GUERRERO,12,PETATLÁN,048,RANCHO NUEVO,4,36,14,22,4
GUERRERO,12,PETATLÁN,048,RÍO CHIQUITO,2,35,19,16,3
GUERRERO,12,PETATLÁN,048,SAN JERONIMITO (SAN JERÓNIMO),8,1028,538,490,61
GUERRERO,12,PETATLÁN,048,SAN VICENTE,3,26,10,16,3
GUERRERO,12,PILCAYA,049,AMATITLÁN,3,30,15,15,4
GUERRERO,12,PILCAYA,049,CACAHUAMILPA,3,162,77,85,9
GUERRERO,12,PILCAYA,049,CHIMALTITLÁN,2,18,11,7,2
GUERRERO,12,PILCAYA,049,CRUCERO DE GRUTAS (GRUTAS DE CACAHUAMILPA),2,45,23,22,4
GUERRERO,12,PILCAYA,049,CUITLAPA,3,34,16,18,4
GUERRERO,12,PILCAYA,049,EL BOSQUE,2,9,5,4,2
GUERRERO,12,PILCAYA,049,EL MOGOTE,4,116,56,60,10
GUERRERO,12,PILCAYA,049,EL PLATANAR,3,54,34,20,5
GUERRERO,12,PILCAYA,049,EL SAUZ,3,59,27,32,5
GUERRERO,12,PILCAYA,049,EL TRANSFORMADOR,1,23,11,12,2
GUERRERO,12,PILCAYA,049,EL UVALAR,2,9,4,5,2
GUERRERO,12,PILCAYA,049,JUCHIMILPA,3,53,23,30,5
GUERRERO,12,PILCAYA,049,LA CONCEPCIÓN (LA CONCHA),2,191,111,80,7
GUERRERO,12,PILCAYA,049,LOS SAUCES,2,23,11,12,3
GUERRERO,12,PILCAYA,049,PIEDRAS NEGRAS,2,50,30,20,4
GUERRERO,12,PILCAYA,049,PILCAYA,7,1453,727,726,61
GUERRERO,12,PILCAYA,049,SANTA MARÍA,2,11,6,5,2
GUERRERO,12,PILCAYA,049,SANTA TERESA,2,90,35,55,6
GUERRERO,12,PUNGARABATO,050,CHACAMERITO,3,144,63,81,15
GUERRERO,12,PUNGARABATO,050,CHACÁMERO GRANDE,2,50,31,19,4
GUERRERO,12,PUNGARABATO,050,CIUDAD ALTAMIRANO,51,10330,5223,5107,700
GUERRERO,12,PUNGARABATO,050,JARIO Y PANTOJA,2,36,19,17,2
GUERRERO,12,PUNGARABATO,050,LA BOLSA,2,103,47,56,6
GUERRERO,12,PUNGARABATO,050,LAS JUNTAS DE CHACÁMERO,4,202,103,99,18
GUERRERO,12,PUNGARABATO,050,LOS LIMONES,2,120,55,65,9
GUERRERO,12,PUNGARABATO,050,PLACERITOS,2,43,28,15,3
GUERRERO,12,PUNGARABATO,050,QUERENDAS,3,432,208,224,23
GUERRERO,12,PUNGARABATO,050,SANTA BÁRBARA,3,180,78,102,13
GUERRERO,12,PUNGARABATO,050,SINAHUA,3,203,87,116,12
GUERRERO,12,PUNGARABATO,050,TANGANHUATO,5,765,362,403,51
GUERRERO,12,PUNGARABATO,050,TIERRA BLANCA,2,110,61,49,7
GUERRERO,12,QUECHULTENANGO,051,ACHIGCA,4,278,150,128,16
GUERRERO,12,QUECHULTENANGO,051,AHUACATEPEC,3,124,68,56,9
GUERRERO,12,QUECHULTENANGO,051,ATLITENGO,2,38,19,19,3
GUERRERO,12,QUECHULTENANGO,051,AZTATEPEC,6,315,146,169,22
GUERRERO,12,QUECHULTENANGO,051,BARRIO NUEVO,3,56,25,31,5
GUERRERO,12,QUECHULTENANGO,051,COACOYUL,1,11,6,5,1
GUERRERO,12,QUECHULTENANGO,051,COLONIA VICENTE GUERRERO,2,18,8,10,2
GUERRERO,12,QUECHULTENANGO,051,COLOTLIPA,9,1020,498,522,63
GUERRERO,12,QUECHULTENANGO,051,COSCAMILA,3,159,85,74,12
GUERRERO,12,QUECHULTENANGO,051,COTLAZINAPA,3,39,25,14,3
GUERRERO,12,QUECHULTENANGO,051,CUADRILLA NUEVA,1,7,3,4,1
GUERRERO,12,QUECHULTENANGO,051,CUANACAMATLA,1,12,3,9,1
GUERRERO,12,QUECHULTENANGO,051,CUATOMATITLÁN,2,29,17,12,2
GUERRERO,12,QUECHULTENANGO,051,EL AGUACATE,3,47,19,28,5
GUERRERO,12,QUECHULTENANGO,051,EL COCOYUL,5,118,71,47,12
GUERRERO,12,QUECHULTENANGO,051,EL NARANJO,3,15,4,11,3
GUERRERO,12,QUECHULTENANGO,051,EL TEJORUCO,4,214,106,108,13
GUERRERO,12,QUECHULTENANGO,051,EL TULE,1,4,0,4,1
GUERRERO,12,QUECHULTENANGO,051,ESTOYAHUALCO,2,7,1,6,1
GUERRERO,12,QUECHULTENANGO,051,HUEHUECOYOTLA,3,165,83,82,10
GUERRERO,12,QUECHULTENANGO,051,HUIZILTEPEC,2,21,11,10,2
GUERRERO,12,QUECHULTENANGO,051,JALAPA,4,122,61,61,13
GUERRERO,12,QUECHULTENANGO,051,JOCUTLA,5,172,95,77,12
GUERRERO,12,QUECHULTENANGO,051,JUXTLAHUACA,3,204,101,103,13
GUERRERO,12,QUECHULTENANGO,051,LA MINA,3,27,15,12,4
GUERRERO,12,QUECHULTENANGO,051,LA PAROTA,2,35,19,16,3
GUERRERO,12,QUECHULTENANGO,051,LAS PALMITAS,3,32,17,15,4
GUERRERO,12,QUECHULTENANGO,051,LOMA LARGA,2,14,4,10,2
GUERRERO,12,QUECHULTENANGO,051,LOS AMATES,2,16,8,8,2
GUERRERO,12,QUECHULTENANGO,051,LOS MANGUITOS,2,6,3,3,1
GUERRERO,12,QUECHULTENANGO,051,LOS RANCHITOS,2,28,15,13,4
GUERRERO,12,QUECHULTENANGO,051,MEXCALTEPEC,3,17,9,8,3
GUERRERO,12,QUECHULTENANGO,051,NACAXTLÁN,4,252,122,130,15
GUERRERO,12,QUECHULTENANGO,051,NANZINTLA,4,145,72,73,13
GUERRERO,12,QUECHULTENANGO,051,NARANJITAS,4,135,64,71,13
GUERRERO,12,QUECHULTENANGO,051,NARANJUELO,3,66,27,39,4
GUERRERO,12,QUECHULTENANGO,051,NIYANTITLÁN,2,26,12,14,3
GUERRERO,12,QUECHULTENANGO,051,OSTOCAPA,3,183,97,86,12
GUERRERO,12,QUECHULTENANGO,051,PINOLAPA,4,62,28,34,8
GUERRERO,12,QUECHULTENANGO,051,PLATANILLO,4,304,155,149,14
GUERRERO,12,QUECHULTENANGO,051,PUEBLO VIEJO,4,125,67,58,10
GUERRERO,12,QUECHULTENANGO,051,QUECHULTENANGO,16,2028,977,1051,155
GUERRERO,12,QUECHULTENANGO,051,SAN ANTONIO ABAD,1,22,10,12,2
GUERRERO,12,QUECHULTENANGO,051,SAN JOSÉ,4,262,126,136,17
GUERRERO,12,QUECHULTENANGO,051,SAN MARTÍN,4,277,142,135,16
GUERRERO,12,QUECHULTENANGO,051,SANTA CRUZ,3,201,104,97,16
GUERRERO,12,QUECHULTENANGO,051,SANTA FE,4,242,120,122,17
GUERRERO,12,QUECHULTENANGO,051,TEMOCONGO (XOCHITLÁN),2,10,6,4,2
GUERRERO,12,QUECHULTENANGO,051,TEOCUITLAPA,3,127,65,62,9
GUERRERO,12,QUECHULTENANGO,051,TEOZINTLA,3,132,56,76,11
GUERRERO,12,QUECHULTENANGO,051,TEPOXTLAHUACA,2,15,5,10,2
GUERRERO,12,QUECHULTENANGO,051,TLANICUILULCO,6,456,224,232,26
GUERRERO,12,QUECHULTENANGO,051,TLANIPATITLÁN,3,56,19,37,5
GUERRERO,12,QUECHULTENANGO,051,TOLIXTLAHUACA,4,138,80,58,11
GUERRERO,12,QUECHULTENANGO,051,TONALAPA,3,292,135,157,15
GUERRERO,12,QUECHULTENANGO,051,XOCHITEPEC,6,430,220,210,22
GUERRERO,12,QUECHULTENANGO,051,XOCHITLÁN,3,83,38,45,8
GUERRERO,12,QUECHULTENANGO,051,ZACUALPAN,2,31,14,17,2
GUERRERO,12,QUECHULTENANGO,051,ZALPIZACO,2,12,8,4,2
GUERRERO,12,QUECHULTENANGO,051,ZINACANTLA,2,16,6,10,3
GUERRERO,12,QUECHULTENANGO,051,ZOYAPEZCO,2,117,52,65,8
GUERRERO,12,SAN LUIS ACATLÁN,052,ALTEPEC,2,82,44,38,3
GUERRERO,12,SAN LUIS ACATLÁN,052,ARROYO CUMIAPA,4,280,131,149,13
GUERRERO,12,SAN LUIS ACATLÁN,052,ARROYO FAISÁN,2,42,27,15,3
GUERRERO,12,SAN LUIS ACATLÁN,052,ARROYO HOJA DE VENADO,2,52,27,25,5
GUERRERO,12,SAN LUIS ACATLÁN,052,ARROYO LIMÓN (ARROYO LIMA),2,12,7,5,1
GUERRERO,12,SAN LUIS ACATLÁN,052,ARROYO MIXTECOLAPA (MIXTECOLAPA),2,74,40,34,3
GUERRERO,12,SAN LUIS ACATLÁN,052,BARRIO DE GUADALUPE,1,64,29,35,3
GUERRERO,12,SAN LUIS ACATLÁN,052,BUENA VISTA,6,1110,594,516,50
GUERRERO,12,SAN LUIS ACATLÁN,052,CAMALOTILLO (EL CAMALOTILLO),5,177,87,90,13
GUERRERO,12,SAN LUIS ACATLÁN,052,CERRO LIMÓN,3,86,31,55,6
GUERRERO,12,SAN LUIS ACATLÁN,052,CERRO ZAPOTE,2,12,5,7,1
GUERRERO,12,SAN LUIS ACATLÁN,052,COLONIA LA GUADALUPE,1,127,59,68,6
GUERRERO,12,SAN LUIS ACATLÁN,052,COYUL (COYUL CHIQUITO),2,50,27,23,2
GUERRERO,12,SAN LUIS ACATLÁN,052,CRUZ ALTA,2,122,58,64,6
GUERRERO,12,SAN LUIS ACATLÁN,052,CUANACAXTITLÁN,9,917,492,425,51
GUERRERO,12,SAN LUIS ACATLÁN,052,CUATRO CAMINOS,3,35,18,17,3
GUERRERO,12,SAN LUIS ACATLÁN,052,EL CARMEN,3,225,110,115,12
GUERRERO,12,SAN LUIS ACATLÁN,052,EL MAMEY (PLAN DEL MAMEY),1,17,8,9,1
GUERRERO,12,SAN LUIS ACATLÁN,052,EL MANGUITO,2,77,35,42,4
GUERRERO,12,SAN LUIS ACATLÁN,052,EL MESÓN,2,15,8,7,2
GUERRERO,12,SAN LUIS ACATLÁN,052,EL MIRASOL,2,69,29,40,4
GUERRERO,12,SAN LUIS ACATLÁN,052,EL PARAÍSO,2,41,18,23,3
GUERRERO,12,SAN LUIS ACATLÁN,052,HONDURA TIGRE,3,105,56,49,5
GUERRERO,12,SAN LUIS ACATLÁN,052,HORCASITAS (ATOTONILCO DE HORCASITAS),4,612,303,309,29
GUERRERO,12,SAN LUIS ACATLÁN,052,JICAMALTEPEC DE LA MONTAÑA,5,241,118,123,15
GUERRERO,12,SAN LUIS ACATLÁN,052,JOLOTICHÁN,5,482,236,246,25
GUERRERO,12,SAN LUIS ACATLÁN,052,LA PAROTA,2,88,48,40,3
GUERRERO,12,SAN LUIS ACATLÁN,052,LLANO DE MAGUEY,3,189,95,94,10
GUERRERO,12,SAN LUIS ACATLÁN,052,LLANO SILLETA,3,164,77,87,9
GUERRERO,12,SAN LUIS ACATLÁN,052,LOMA BONITA,2,59,28,31,4
GUERRERO,12,SAN LUIS ACATLÁN,052,LOS ACHOTES,3,171,81,90,9
GUERRERO,12,SAN LUIS ACATLÁN,052,LOS PINOS,2,37,19,18,3
GUERRERO,12,SAN LUIS ACATLÁN,052,MIAHUICHÁN,4,216,104,112,13
GUERRERO,12,SAN LUIS ACATLÁN,052,MIXTECAPA,4,776,366,410,30
GUERRERO,12,SAN LUIS ACATLÁN,052,NEJAPA,2,32,17,15,3
GUERRERO,12,SAN LUIS ACATLÁN,052,PAJARITO GRANDE (PÁJARO GRANDE),1,24,5,19,1
GUERRERO,12,SAN LUIS ACATLÁN,052,PARAJE OCOTERO SANTA CRUZ (PARAJE SANTA CRUZ),2,10,3,7,2
GUERRERO,12,SAN LUIS ACATLÁN,052,PASCALA DEL ORO,6,483,238,245,36
GUERRERO,12,SAN LUIS ACATLÁN,052,PIE DE TIERRA BLANCA (TIERRA BLANCA),2,218,114,104,9
GUERRERO,12,SAN LUIS ACATLÁN,052,PIEDRA ANCHA,3,98,53,45,8
GUERRERO,12,SAN LUIS ACATLÁN,052,POTRERILLO COAPINOLE,3,214,102,112,12
GUERRERO,12,SAN LUIS ACATLÁN,052,POZA VERDE,3,150,71,79,10
GUERRERO,12,SAN LUIS ACATLÁN,052,PUEBLO HIDALGO,10,1419,661,758,79
GUERRERO,12,SAN LUIS ACATLÁN,052,RENACIMIENTO,2,55,23,32,4
GUERRERO,12,SAN LUIS ACATLÁN,052,RÍO IGUAPA,4,476,229,247,22
GUERRERO,12,SAN LUIS ACATLÁN,052,SAN ANTONIO,1,6,4,2,1
GUERRERO,12,SAN LUIS ACATLÁN,052,SAN LUIS ACATLÁN,20,3320,1650,1670,165
GUERRERO,12,SAN LUIS ACATLÁN,052,SAN MIGUEL,3,17,12,5,3
GUERRERO,12,SAN LUIS ACATLÁN,052,SAN MIGUEL RE'EDÍ,2,16,8,8,2
GUERRERO,12,SAN LUIS ACATLÁN,052,TIERRA COLORADA,2,68,33,35,3
GUERRERO,12,SAN LUIS ACATLÁN,052,TLAXCALIXTLAHUACA,4,594,292,302,30
GUERRERO,12,SAN LUIS ACATLÁN,052,TUXTEPEC (COFRADÍA),5,344,161,183,17
GUERRERO,12,SAN LUIS ACATLÁN,052,XIHUITEPEC,1,13,8,5,1
GUERRERO,12,SAN LUIS ACATLÁN,052,YOLOXÓCHITL,10,1037,498,539,44
GUERRERO,12,SAN LUIS ACATLÁN,052,ZENTIXTLAHUACA,2,54,26,28,3
GUERRERO,12,SAN MARCOS,053,AMATE MORADO,2,8,4,4,1
GUERRERO,12,SAN MARCOS,053,AMAZQUITE,3,34,19,15,3
GUERRERO,12,SAN MARCOS,053,ANÁHUAC,4,196,108,88,12
GUERRERO,12,SAN MARCOS,053,BARRANQUILLA (LA PULGA),2,36,19,17,2
GUERRERO,12,SAN MARCOS,053,BARRIO NUEVO (TORO PANDO),3,13,9,4,3
GUERRERO,12,SAN MARCOS,053,BELLA VISTA,2,42,16,26,2
GUERRERO,12,SAN MARCOS,053,CARIDAD,4,304,146,158,9
GUERRERO,12,SAN MARCOS,053,CHACALAPA DEL PACÍFICO,3,72,35,37,5
GUERRERO,12,SAN MARCOS,053,COLONIA ANÁHUAC,2,58,30,28,5
GUERRERO,12,SAN MARCOS,053,COLONIA EL CUCO,2,26,11,15,3
GUERRERO,12,SAN MARCOS,053,EL CACAO,2,9,4,5,2
GUERRERO,12,SAN MARCOS,053,EL CARMEN,2,13,5,8,2
GUERRERO,12,SAN MARCOS,053,EL CERRO PESQUERÍA,2,19,10,9,2
GUERRERO,12,SAN MARCOS,053,EL CHAMIZAL,3,25,9,16,3
GUERRERO,12,SAN MARCOS,053,EL COCOYULT (COACOYUL),3,138,73,65,7
GUERRERO,12,SAN MARCOS,053,EL CORTÉS,4,381,176,205,38
GUERRERO,12,SAN MARCOS,053,EL CUCO,4,149,74,75,13
GUERRERO,12,SAN MARCOS,053,EL GUAYABO,2,68,29,39,3
GUERRERO,12,SAN MARCOS,053,EL MAGUEY,1,4,4,0,1
GUERRERO,12,SAN MARCOS,053,EL ROBLE,2,26,5,21,2
GUERRERO,12,SAN MARCOS,053,EL TAMARINDO,3,167,80,87,9
GUERRERO,12,SAN MARCOS,053,EL TEJORUCO (LA HORQUETA),3,156,73,83,9
GUERRERO,12,SAN MARCOS,053,JIMÉNEZ,3,78,42,36,5
GUERRERO,12,SAN MARCOS,053,LA BARRERA,1,10,4,6,1
GUERRERO,12,SAN MARCOS,053,LA ESTANCIA,2,32,18,14,3
GUERRERO,12,SAN MARCOS,053,LAGUNILLA,3,39,12,27,4
GUERRERO,12,SAN MARCOS,053,LAS CRUCES,5,543,266,277,41
GUERRERO,12,SAN MARCOS,053,LAS LOMITAS DE PAPAGAYO,1,27,14,13,2
GUERRERO,12,SAN MARCOS,053,LAS MESAS,7,759,390,369,47
GUERRERO,12,SAN MARCOS,053,LAS MINAS,3,217,101,116,12
GUERRERO,12,SAN MARCOS,053,LLANO DE LA PUERTA,3,281,134,147,17
GUERRERO,12,SAN MARCOS,053,LLANO GRANDE,4,479,243,236,31
GUERRERO,12,SAN MARCOS,053,LOS OTATES,2,7,3,4,1
GUERRERO,12,SAN MARCOS,053,MEDANITOS PERROS DE AGUA,3,21,11,10,3
GUERRERO,12,SAN MARCOS,053,MOCTEZUMA,3,48,20,28,5
GUERRERO,12,SAN MARCOS,053,MONTE ALTO,4,206,117,89,14
GUERRERO,12,SAN MARCOS,053,NUEVO SANTO DOMINGO,1,3,0,3,3
GUERRERO,12,SAN MARCOS,053,NUEVO TECOMULAPA,2,91,54,37,6
GUERRERO,12,SAN MARCOS,053,OCOTILLO,3,73,35,38,5
GUERRERO,12,SAN MARCOS,053,PALMITAS DE PAPAGAYO (LAS PALMITAS),1,9,3,6,1
GUERRERO,12,SAN MARCOS,053,PIEDRA BLANCA,3,182,80,102,7
GUERRERO,12,SAN MARCOS,053,PIEDRA PARADA,2,70,28,42,8
GUERRERO,12,SAN MARCOS,053,PLAN GRANDE,2,12,5,7,2
GUERRERO,12,SAN MARCOS,053,RANCHO LOS TAMARINDOS,2,5,1,4,1
GUERRERO,12,SAN MARCOS,053,RANCHO NUEVO,3,212,95,117,11
GUERRERO,12,SAN MARCOS,053,RANCHO VIEJO,4,313,142,171,17
GUERRERO,12,SAN MARCOS,053,SAN JOSÉ GUATEMALA,3,128,63,65,7
GUERRERO,12,SAN MARCOS,053,SAN JUAN CHICO,2,22,12,10,3
GUERRERO,12,SAN MARCOS,053,SAN JUAN GRANDE,3,101,57,44,8
GUERRERO,12,SAN MARCOS,053,SAN MARCOS,21,4123,2187,1936,224
GUERRERO,12,SAN MARCOS,053,SAN MIGUEL,2,31,20,11,3
GUERRERO,12,SAN MARCOS,053,SANTA ELENA DE LA VILLA,4,289,149,140,18
GUERRERO,12,SAN MARCOS,053,SANTA ELENA GUERRERO,3,219,101,118,9
GUERRERO,12,SAN MARCOS,053,SANTO DOMINGO,2,19,11,8,2
GUERRERO,12,SAN MARCOS,053,TAMARINDILLO,2,49,17,32,2
GUERRERO,12,SAN MARCOS,053,TECOMATE NANCHAL,3,137,69,68,8
GUERRERO,12,SAN MARCOS,053,TECOMATE PESQUERÍA,3,72,42,30,9
GUERRERO,12,SAN MARCOS,053,VISTA HERMOSA,2,19,4,15,2
GUERRERO,12,SAN MARCOS,053,YUCATÁN DE LAS FLORES,3,100,49,51,8
GUERRERO,12,SAN MIGUEL TOTOLAPAN,054,AGUA ESCONDIDA (DESCOMBRO),3,47,25,22,5
GUERRERO,12,SAN MIGUEL TOTOLAPAN,054,BARRANCA DE IGUALA,2,37,19,18,3
GUERRERO,12,SAN MIGUEL TOTOLAPAN,054,BUENAVISTA DEL SALTO (EL SALTO),1,14,8,6,1
GUERRERO,12,SAN MIGUEL TOTOLAPAN,054,CAMPAMENTO DE VACAS (EL CAMPAMENTO),3,34,18,16,3
GUERRERO,12,SAN MIGUEL TOTOLAPAN,054,CIÉNEGA DE PUERTO ALEGRE,3,66,36,30,5
GUERRERO,12,SAN MIGUEL TOTOLAPAN,054,COLONIA DEL PEDREGAL,1,6,2,4,1
GUERRERO,12,SAN MIGUEL TOTOLAPAN,054,CORONILLA,4,84,37,47,9
GUERRERO,12,SAN MIGUEL TOTOLAPAN,054,CUCHARILLOS (CUCHARILLO),2,5,2,3,1
GUERRERO,12,SAN MIGUEL TOTOLAPAN,054,DOS CAMINOS,1,13,5,8,1
GUERRERO,12,SAN MIGUEL TOTOLAPAN,054,EL AGUACATE,3,72,37,35,4
GUERRERO,12,SAN MIGUEL TOTOLAPAN,054,EL CUAJILOTE (SAN BARTOLO),2,38,19,19,3
GUERRERO,12,SAN MIGUEL TOTOLAPAN,054,EL DURAZNITO,1,8,4,4,1
GUERRERO,12,SAN MIGUEL TOTOLAPAN,054,EL NARANJO [RANCHO],1,10,3,7,1
GUERRERO,12,SAN MIGUEL TOTOLAPAN,054,EL PINZÁN,2,16,7,9,2
GUERRERO,12,SAN MIGUEL TOTOLAPAN,054,EL QUERENGUE,2,27,14,13,3
GUERRERO,12,SAN MIGUEL TOTOLAPAN,054,EL REMANCE,1,70,36,34,6
GUERRERO,12,SAN MIGUEL TOTOLAPAN,054,EL RINCÓN,1,7,5,2,1
GUERRERO,12,SAN MIGUEL TOTOLAPAN,054,EL TERRERO,3,169,93,76,18
GUERRERO,12,SAN MIGUEL TOTOLAPAN,054,EL TERRERO II,3,173,82,91,11
GUERRERO,12,SAN MIGUEL TOTOLAPAN,054,ENCINO AMARILLO (EL ENCINO),1,9,5,4,1
GUERRERO,12,SAN MIGUEL TOTOLAPAN,054,HACIENDA VIEJA,1,32,17,15,2
GUERRERO,12,SAN MIGUEL TOTOLAPAN,054,HUERTA VIEJA (HUERTA VIEJA CHICA),3,114,61,53,8
GUERRERO,12,SAN MIGUEL TOTOLAPAN,054,HUEYANALCO,2,84,47,37,6
GUERRERO,12,SAN MIGUEL TOTOLAPAN,054,LA COMUNIDAD,1,5,4,1,1
GUERRERO,12,SAN MIGUEL TOTOLAPAN,054,LA GAVIA,3,41,24,17,4
GUERRERO,12,SAN MIGUEL TOTOLAPAN,054,LA MINA,1,3,2,1,1
GUERRERO,12,SAN MIGUEL TOTOLAPAN,054,LA MOZIMBA,1,4,3,1,1
GUERRERO,12,SAN MIGUEL TOTOLAPAN,054,LA TINAJA (SANTA CRUZ TINAJA),3,48,25,23,7
GUERRERO,12,SAN MIGUEL TOTOLAPAN,054,LA TUNA (LA PALMADA),3,42,19,23,5
GUERRERO,12,SAN MIGUEL TOTOLAPAN,054,LAGUNA DE HUEYANALCO,2,59,41,18,6
GUERRERO,12,SAN MIGUEL TOTOLAPAN,054,LAS HEBILLAS (LAS HABILLAS),3,69,39,30,5
GUERRERO,12,SAN MIGUEL TOTOLAPAN,054,LAS JUNTAS,1,114,55,59,9
GUERRERO,12,SAN MIGUEL TOTOLAPAN,054,LAS MESAS I,4,78,45,33,7
GUERRERO,12,SAN MIGUEL TOTOLAPAN,054,LAS TUNAS,3,72,28,44,7
GUERRERO,12,SAN MIGUEL TOTOLAPAN,054,LAS VENTANAS,1,1,0,1,1
GUERRERO,12,SAN MIGUEL TOTOLAPAN,054,LINDA VISTA,4,403,205,198,21
GUERRERO,12,SAN MIGUEL TOTOLAPAN,054,LOMILLOS,2,32,19,13,3
GUERRERO,12,SAN MIGUEL TOTOLAPAN,054,LOS ENCINOS,2,9,5,4,2
GUERRERO,12,SAN MIGUEL TOTOLAPAN,054,LOS GUAJES,3,27,11,16,5
GUERRERO,12,SAN MIGUEL TOTOLAPAN,054,LOS LAURELES,3,56,25,31,5
GUERRERO,12,SAN MIGUEL TOTOLAPAN,054,LUMBRERAS,2,5,4,1,2
GUERRERO,12,SAN MIGUEL TOTOLAPAN,054,NENZINTLA I,1,6,4,2,1
GUERRERO,12,SAN MIGUEL TOTOLAPAN,054,OTATLÁN,3,114,57,57,9
GUERRERO,12,SAN MIGUEL TOTOLAPAN,054,PALOS ALTOS,1,10,10,0,2
GUERRERO,12,SAN MIGUEL TOTOLAPAN,054,PALOS ALTOS (PALOS ALTOS DOS),1,12,6,6,1
GUERRERO,12,SAN MIGUEL TOTOLAPAN,054,PANDOLOMA,4,272,118,154,15
GUERRERO,12,SAN MIGUEL TOTOLAPAN,054,PERICOTEPEC,4,62,30,32,8
GUERRERO,12,SAN MIGUEL TOTOLAPAN,054,PETLACALA,3,50,23,27,4
GUERRERO,12,SAN MIGUEL TOTOLAPAN,054,PIEDRA CONCHA,1,19,7,12,1
GUERRERO,12,SAN MIGUEL TOTOLAPAN,054,PLAN VERDE,3,30,17,13,3
GUERRERO,12,SAN MIGUEL TOTOLAPAN,054,PUERTO ALEGRE,3,37,21,16,4
GUERRERO,12,SAN MIGUEL TOTOLAPAN,054,PUERTO CHICHALACO,3,9,4,5,3
GUERRERO,12,SAN MIGUEL TOTOLAPAN,054,RANCHO ALEGRE,2,4,2,2,2
GUERRERO,12,SAN MIGUEL TOTOLAPAN,054,REAL DE TEPANTITLÁN,1,12,5,7,1
GUERRERO,12,SAN MIGUEL TOTOLAPAN,054,SAN ANTONIO DE LA GAVIA,3,100,44,56,8
GUERRERO,12,SAN MIGUEL TOTOLAPAN,054,SAN FRANCISCO,3,46,20,26,6
GUERRERO,12,SAN MIGUEL TOTOLAPAN,054,SAN JUAN TEHUEHUETLA (CAPULÍN TEHUEHUETLA),3,105,52,53,7
GUERRERO,12,SAN MIGUEL TOTOLAPAN,054,SAN MIGUEL TOTOLAPAN,10,1084,530,554,73
GUERRERO,12,SAN MIGUEL TOTOLAPAN,054,SAN MIGUELITO,3,97,53,44,7
GUERRERO,12,SAN MIGUEL TOTOLAPAN,054,SAN NICOLÁS DEL ORO,3,66,36,30,4
GUERRERO,12,SAN MIGUEL TOTOLAPAN,054,SANTA CATARINA,2,17,10,7,2
GUERRERO,12,SAN MIGUEL TOTOLAPAN,054,SANTA ELENA,3,95,45,50,5
GUERRERO,12,SAN MIGUEL TOTOLAPAN,054,SANTA FE,2,21,11,10,2
GUERRERO,12,SAN MIGUEL TOTOLAPAN,054,SANTA MARÍA DE LAS FLORES (EL MACHERO),1,17,7,10,1
GUERRERO,12,SAN MIGUEL TOTOLAPAN,054,SANTA MARÍA SUR,3,52,27,25,4
GUERRERO,12,SAN MIGUEL TOTOLAPAN,054,TACAMBARITO,2,17,7,10,2
GUERRERO,12,SAN MIGUEL TOTOLAPAN,054,TORO MUERTO,3,51,21,30,4
GUERRERO,12,SAN MIGUEL TOTOLAPAN,054,VALLE LUZ,4,326,164,162,26
GUERRERO,12,SAN MIGUEL TOTOLAPAN,054,VILLA HIDALGO (EL CUBO),2,110,53,57,20
GUERRERO,12,SAN MIGUEL TOTOLAPAN,054,XIMOTLA (JIMOTLA),3,42,17,25,4
GUERRERO,12,SAN MIGUEL TOTOLAPAN,054,YOLOTLA,3,66,33,33,6
GUERRERO,12,TAXCO DE ALARCÓN,055,ACAMIXTLA,5,947,469,478,48
GUERRERO,12,TAXCO DE ALARCÓN,055,ACUITLAPÁN,5,833,429,404,42
GUERRERO,12,TAXCO DE ALARCÓN,055,ATZALA (ATZALA DE LA ASUNCIÓN),4,231,119,112,16
GUERRERO,12,TAXCO DE ALARCÓN,055,AXIXINTLA,4,412,205,207,25
GUERRERO,12,TAXCO DE ALARCÓN,055,CACALOTENANGO,4,280,132,148,20
GUERRERO,12,TAXCO DE ALARCÓN,055,CAJONES,2,12,4,8,3
GUERRERO,12,TAXCO DE ALARCÓN,055,CASINO DE LA UNIÓN (KILÓMETRO 136),2,63,34,29,3
GUERRERO,12,TAXCO DE ALARCÓN,055,CERRO GORDO,2,22,8,14,2
GUERRERO,12,TAXCO DE ALARCÓN,055,CHICHILA,4,187,103,84,14
GUERRERO,12,TAXCO DE ALARCÓN,055,COAMAZAC,2,18,9,9,2
GUERRERO,12,TAXCO DE ALARCÓN,055,CORONILLAS,2,9,4,5,1
GUERRERO,12,TAXCO DE ALARCÓN,055,DOLORES,3,110,50,60,14
GUERRERO,12,TAXCO DE ALARCÓN,055,EL AGUACATE,4,40,23,17,5
GUERRERO,12,TAXCO DE ALARCÓN,055,EL ANCÓN,2,4,2,2,2
GUERRERO,12,TAXCO DE ALARCÓN,055,EL EJIDO (EJIDO GUERRERO),2,87,44,43,4
GUERRERO,12,TAXCO DE ALARCÓN,055,EL FRAILE,3,61,24,37,9
GUERRERO,12,TAXCO DE ALARCÓN,055,EL GAVILÁN,2,71,33,38,6
GUERRERO,12,TAXCO DE ALARCÓN,055,EL HORCONCITO,3,31,16,15,5
GUERRERO,12,TAXCO DE ALARCÓN,055,EL MIRADOR,2,32,13,19,3
GUERRERO,12,TAXCO DE ALARCÓN,055,EL OJO DE AGUA,2,18,10,8,2
GUERRERO,12,TAXCO DE ALARCÓN,055,EL POTRERO,1,61,28,33,5
GUERRERO,12,TAXCO DE ALARCÓN,055,EL VERGEL,2,11,6,5,2
GUERRERO,12,TAXCO DE ALARCÓN,055,EL ZOMPANTLE,2,21,14,7,2
GUERRERO,12,TAXCO DE ALARCÓN,055,HUAHUAXTLA,3,90,46,44,7
GUERRERO,12,TAXCO DE ALARCÓN,055,HUAJOJUTLA (EL AZUL),2,204,105,99,9
GUERRERO,12,TAXCO DE ALARCÓN,055,HUEYMATLA,3,35,17,18,4
GUERRERO,12,TAXCO DE ALARCÓN,055,HUITZOTITLA,3,26,13,13,3
GUERRERO,12,TAXCO DE ALARCÓN,055,HUIXTAC,5,161,88,73,13
GUERRERO,12,TAXCO DE ALARCÓN,055,ICATEPEC,3,57,26,31,4
GUERRERO,12,TAXCO DE ALARCÓN,055,JULIANTLA,3,116,56,60,11
GUERRERO,12,TAXCO DE ALARCÓN,055,LA CASCADA,2,66,32,34,4
GUERRERO,12,TAXCO DE ALARCÓN,055,LA MORA,3,17,6,11,3
GUERRERO,12,TAXCO DE ALARCÓN,055,LA PRESA,2,6,4,2,2
GUERRERO,12,TAXCO DE ALARCÓN,055,LA W,2,10,4,6,2
GUERRERO,12,TAXCO DE ALARCÓN,055,LAS JOYAS,2,37,16,21,3
GUERRERO,12,TAXCO DE ALARCÓN,055,LAS JOYAS DEL PROGRESO,2,38,18,20,4
GUERRERO,12,TAXCO DE ALARCÓN,055,LOS MEMBRILLOS,2,15,7,8,1
GUERRERO,12,TAXCO DE ALARCÓN,055,MEXCALTEPEC,3,65,34,31,10
GUERRERO,12,TAXCO DE ALARCÓN,055,MINAS VIEJAS,2,21,12,9,3
GUERRERO,12,TAXCO DE ALARCÓN,055,PAINTLA,3,307,145,162,14
GUERRERO,12,TAXCO DE ALARCÓN,055,PAPALA,2,20,11,9,2
GUERRERO,12,TAXCO DE ALARCÓN,055,PLAZA DE GALLOS (EL CUCHARILLO),2,15,10,5,2
GUERRERO,12,TAXCO DE ALARCÓN,055,PUENTE CAMPUZANO,4,944,509,435,49
GUERRERO,12,TAXCO DE ALARCÓN,055,RANCHO VIEJO,1,14,6,8,2
GUERRERO,12,TAXCO DE ALARCÓN,055,SAN FELIPE DE JESÚS CHICHILA,2,23,16,7,3
GUERRERO,12,TAXCO DE ALARCÓN,055,SAN JOSÉ EL POTRERO,3,145,55,90,9
GUERRERO,12,TAXCO DE ALARCÓN,055,SAN JUAN DE DIOS (NARANJAS DE DIOS),3,236,100,136,14
GUERRERO,12,TAXCO DE ALARCÓN,055,SAN JUAN DEL MONTE,3,29,11,18,3
GUERRERO,12,TAXCO DE ALARCÓN,055,SAN JUAN TENERÍA,3,72,37,35,7
GUERRERO,12,TAXCO DE ALARCÓN,055,SAN JUAN UNIÓN,3,64,34,30,6
GUERRERO,12,TAXCO DE ALARCÓN,055,SAN MIGUEL GUERRERO (SAN MIGUEL),3,25,15,10,3
GUERRERO,12,TAXCO DE ALARCÓN,055,SAN MIGUEL Y HUERTA,3,22,10,12,4
GUERRERO,12,TAXCO DE ALARCÓN,055,SAN PEDRO CHICHILA,3,40,25,15,5
GUERRERO,12,TAXCO DE ALARCÓN,055,SAN SEBASTIÁN,1,8,5,3,1
GUERRERO,12,TAXCO DE ALARCÓN,055,SANTA ROSA,2,35,17,18,4
GUERRERO,12,TAXCO DE ALARCÓN,055,SANTIAGO TEMIXCO,3,108,54,54,8
GUERRERO,12,TAXCO DE ALARCÓN,055,SANTO DOMINGO,3,49,24,25,5
GUERRERO,12,TAXCO DE ALARCÓN,055,TAXCO DE ALARCÓN,90,13796,7283,6513,944
GUERRERO,12,TAXCO DE ALARCÓN,055,TAXCO EL VIEJO,7,659,308,351,48
GUERRERO,12,TAXCO DE ALARCÓN,055,TEACALCO,3,227,102,125,15
GUERRERO,12,TAXCO DE ALARCÓN,055,TECALPULCO,4,255,130,125,22
GUERRERO,12,TAXCO DE ALARCÓN,055,TECUICIAPA,3,58,28,30,6
GUERRERO,12,TAXCO DE ALARCÓN,055,TEHUILOTEPEC,4,288,144,144,22
GUERRERO,12,TAXCO DE ALARCÓN,055,TEMAXCALAPA,5,190,98,92,14
GUERRERO,12,TAXCO DE ALARCÓN,055,TEXCALTITLA,3,99,48,51,6
GUERRERO,12,TAXCO DE ALARCÓN,055,TLAMACAZAPA,8,1171,616,555,61
GUERRERO,12,TAXCO DE ALARCÓN,055,TOTOAPA,3,40,20,20,5
GUERRERO,12,TAXCO DE ALARCÓN,055,XOCHIPIZCA,2,19,11,8,2
GUERRERO,12,TAXCO DE ALARCÓN,055,ZACATECOLOTLA,3,131,45,86,8
GUERRERO,12,TAXCO DE ALARCÓN,055,ZAPOAPA,2,45,21,24,5
GUERRERO,12,TECOANAPA,056,BARRIO NUEVO,3,103,52,51,8
GUERRERO,12,TECOANAPA,056,BUENAVISTA DE ALLENDE,4,430,208,222,39
GUERRERO,12,TECOANAPA,056,CARABALINCITO,3,29,20,9,4
GUERRERO,12,TECOANAPA,056,CHAUTIPA,5,207,115,92,25
GUERRERO,12,TECOANAPA,056,CRUZ QUEMADA,4,373,177,196,27
GUERRERO,12,TECOANAPA,056,EL AMATAL,3,120,60,60,7
GUERRERO,12,TECOANAPA,056,EL CARRIZO,3,195,81,114,11
GUERRERO,12,TECOANAPA,056,EL CHARCO,3,143,61,82,6
GUERRERO,12,TECOANAPA,056,EL GUAYABO,3,161,75,86,11
GUERRERO,12,TECOANAPA,056,EL LIMÓN,5,473,208,265,25
GUERRERO,12,TECOANAPA,056,EL PERICÓN,5,560,272,288,44
GUERRERO,12,TECOANAPA,056,EL POTRERO,3,64,38,26,4
GUERRERO,12,TECOANAPA,056,EL TECHALE (TLALTECHALE),3,234,114,120,10
GUERRERO,12,TECOANAPA,056,EL TECORRAL,3,230,115,115,10
GUERRERO,12,TECOANAPA,056,EL TEJOLOTE,2,30,6,24,2
GUERRERO,12,TECOANAPA,056,EL TEJORUCO (TEJORUCO),2,72,36,36,3
GUERRERO,12,TECOANAPA,056,EL ZANATE,3,68,28,40,5
GUERRERO,12,TECOANAPA,056,HUAMUCHAPA,5,1001,518,483,59
GUERRERO,12,TECOANAPA,056,HUERTA GRANDE,2,11,5,6,2
GUERRERO,12,TECOANAPA,056,LA COLONIA DE RÍO NEXPA (LA COLONIA),2,36,17,19,3
GUERRERO,12,TECOANAPA,056,LA ESTRELLA,4,123,60,63,8
GUERRERO,12,TECOANAPA,056,LA PERSEVERANCIA,3,71,33,38,6
GUERRERO,12,TECOANAPA,056,LAGUNILLAS,3,316,159,157,24
GUERRERO,12,TECOANAPA,056,LAS ÁNIMAS,4,496,251,245,36
GUERRERO,12,TECOANAPA,056,LAS CRUCITAS,2,52,25,27,4
GUERRERO,12,TECOANAPA,056,LAS PALMITAS,3,50,31,19,4
GUERRERO,12,TECOANAPA,056,LAS PAROTILLAS (LAS PAROTILLITAS),2,76,32,44,5
GUERRERO,12,TECOANAPA,056,LÁZARO CÁRDENAS (COLONIA LÁZARO CÁRDENAS DEL RÍO),3,31,19,12,3
GUERRERO,12,TECOANAPA,056,LOS MAGUEYITOS,4,303,148,155,17
GUERRERO,12,TECOANAPA,056,LOS SAUCES,3,87,39,48,7
GUERRERO,12,TECOANAPA,056,LOS SAUCITOS,3,455,202,253,25
GUERRERO,12,TECOANAPA,056,MECATEPEC,3,168,81,87,12
GUERRERO,12,TECOANAPA,056,OCHOAPA,3,74,35,39,4
GUERRERO,12,TECOANAPA,056,OCOTITLÁN,4,354,179,175,16
GUERRERO,12,TECOANAPA,056,PAROTA SECA,4,445,242,203,29
GUERRERO,12,TECOANAPA,056,POCHOTILLO,4,429,211,218,30
GUERRERO,12,TECOANAPA,056,RANCHO NUEVO,2,88,41,47,5
GUERRERO,12,TECOANAPA,056,RANCHO VIEJO,3,121,63,58,9
GUERRERO,12,TECOANAPA,056,SAN FRANCISCO,3,413,191,222,25
GUERRERO,12,TECOANAPA,056,SAN JUAN LAS PALMAS,3,141,73,68,12
GUERRERO,12,TECOANAPA,056,SAN MARTÍN,3,74,34,40,5
GUERRERO,12,TECOANAPA,056,SANTA ROSA,2,35,17,18,2
GUERRERO,12,TECOANAPA,056,TECOANAPA,10,2079,1057,1022,115
GUERRERO,12,TECOANAPA,056,TECUANTEPEC,2,150,81,69,9
GUERRERO,12,TECOANAPA,056,TEHUITZINGO,2,85,44,41,6
GUERRERO,12,TECOANAPA,056,TEJORUQUITO,3,42,24,18,4
GUERRERO,12,TECOANAPA,056,TEPINTEPEC,2,48,29,19,4
GUERRERO,12,TECOANAPA,056,TLAYOYOTEPEC,2,62,30,32,5
GUERRERO,12,TECOANAPA,056,VILLA HERMOSA,2,293,137,156,14
GUERRERO,12,TECOANAPA,056,XALPATLÁHUAC,6,1051,503,548,64
GUERRERO,12,TÉCPAN DE GALEANA,057,ARROYO DE LA ORDEÑA (LA ORDEÑA),3,38,22,16,3
GUERRERO,12,TÉCPAN DE GALEANA,057,ARROYO FRÍO,1,17,7,10,1
GUERRERO,12,TÉCPAN DE GALEANA,057,BAJITOS DE LA LAGUNA,4,185,91,94,10
GUERRERO,12,TÉCPAN DE GALEANA,057,BAJOS DEL BALZAMAR,5,212,88,124,15
GUERRERO,12,TÉCPAN DE GALEANA,057,BALZAMAR,1,14,8,6,1
GUERRERO,12,TÉCPAN DE GALEANA,057,BUENA VISTA DE JUÁREZ,1,9,3,6,1
GUERRERO,12,TÉCPAN DE GALEANA,057,BUENAVISTA,2,8,2,6,1
GUERRERO,12,TÉCPAN DE GALEANA,057,CAÑADA DE LA REMONTA (LA CAÑADA),2,26,15,11,2
GUERRERO,12,TÉCPAN DE GALEANA,057,CARRIZAL CINTA LARGA,2,16,7,9,2
GUERRERO,12,TÉCPAN DE GALEANA,057,CERRO BUENAVISTA,2,4,4,0,1
GUERRERO,12,TÉCPAN DE GALEANA,057,COATÁN,2,23,9,14,2
GUERRERO,12,TÉCPAN DE GALEANA,057,COLONIA AGUAS BLANCAS,2,38,22,16,3
GUERRERO,12,TÉCPAN DE GALEANA,057,COLONIA VEINTE DE NOVIEMBRE (EL VEINTE),3,144,75,69,9
GUERRERO,12,TÉCPAN DE GALEANA,057,CORALES (CORRALES),3,43,20,23,4
GUERRERO,12,TÉCPAN DE GALEANA,057,EL CERRITO,2,434,222,212,18
GUERRERO,12,TÉCPAN DE GALEANA,057,EL COBANO,2,47,16,31,2
GUERRERO,12,TÉCPAN DE GALEANA,057,EL CONSUELITO,2,44,21,23,3
GUERRERO,12,TÉCPAN DE GALEANA,057,EL CORDÓN GRANDE,4,89,34,55,9
GUERRERO,12,TÉCPAN DE GALEANA,057,EL COYOLITO,2,11,3,8,2
GUERRERO,12,TÉCPAN DE GALEANA,057,EL EDÉN,3,43,19,24,4
GUERRERO,12,TÉCPAN DE GALEANA,057,EL GUAYABAL,3,43,22,21,4
GUERRERO,12,TÉCPAN DE GALEANA,057,EL GUAYABILLO,3,100,48,52,8
GUERRERO,12,TÉCPAN DE GALEANA,057,EL GUAYABITO,2,6,3,3,2
GUERRERO,12,TÉCPAN DE GALEANA,057,EL LIMÓN,1,12,4,8,1
GUERRERO,12,TÉCPAN DE GALEANA,057,EL LIMÓN DEL POCHOTE,3,99,52,47,7
GUERRERO,12,TÉCPAN DE GALEANA,057,EL MANGUITO,3,24,11,13,4
GUERRERO,12,TÉCPAN DE GALEANA,057,EL MORENO (RUBÉN FIGUEROA),3,77,42,35,8
GUERRERO,12,TÉCPAN DE GALEANA,057,EL OCOTAL,2,12,7,5,1
GUERRERO,12,TÉCPAN DE GALEANA,057,EL PANTANO,3,13,8,5,2
GUERRERO,12,TÉCPAN DE GALEANA,057,EL PARA,3,59,27,32,4
GUERRERO,12,TÉCPAN DE GALEANA,057,EL PINITO,2,6,1,5,1
GUERRERO,12,TÉCPAN DE GALEANA,057,EL PITAL,2,13,10,3,2
GUERRERO,12,TÉCPAN DE GALEANA,057,EL PORVENIR,4,184,92,92,10
GUERRERO,12,TÉCPAN DE GALEANA,057,EL SÚCHIL,9,2416,1232,1184,100
GUERRERO,12,TÉCPAN DE GALEANA,057,EL TRAPICHE,2,34,13,21,2
GUERRERO,12,TÉCPAN DE GALEANA,057,EL TULE,2,13,5,8,1
GUERRERO,12,TÉCPAN DE GALEANA,057,EL VALLE,3,16,8,8,3
GUERRERO,12,TÉCPAN DE GALEANA,057,LA CAÑA,3,45,24,21,4
GUERRERO,12,TÉCPAN DE GALEANA,057,LA CAÑITA,2,9,5,4,1
GUERRERO,12,TÉCPAN DE GALEANA,057,LA CIÉNEGA DEL POCHOTE,1,5,4,1,1
GUERRERO,12,TÉCPAN DE GALEANA,057,LA CUESTA,2,14,6,8,2
GUERRERO,12,TÉCPAN DE GALEANA,057,LA LAGUNA,2,16,6,10,2
GUERRERO,12,TÉCPAN DE GALEANA,057,LA LLAVE,2,17,10,7,2
GUERRERO,12,TÉCPAN DE GALEANA,057,LA OLA,2,21,8,13,2
GUERRERO,12,TÉCPAN DE GALEANA,057,LA SIERRITA BAJOS DE BALZAMAR,2,12,5,7,2
GUERRERO,12,TÉCPAN DE GALEANA,057,LA SIERRITA DE LOS TORRES,2,14,6,8,1
GUERRERO,12,TÉCPAN DE GALEANA,057,LA TEJONA,3,16,8,8,3
GUERRERO,12,TÉCPAN DE GALEANA,057,LA ZARZA,1,14,6,8,2
GUERRERO,12,TÉCPAN DE GALEANA,057,LAS BARRANCAS,1,15,10,5,1
GUERRERO,12,TÉCPAN DE GALEANA,057,LAS FINCAS VIEJAS,3,48,24,24,4
GUERRERO,12,TÉCPAN DE GALEANA,057,LAS HUMEDADES,3,6,1,5,2
GUERRERO,12,TÉCPAN DE GALEANA,057,LAS JUNTITAS,1,4,2,2,1
GUERRERO,12,TÉCPAN DE GALEANA,057,LAS MESAS,3,24,12,12,5
GUERRERO,12,TÉCPAN DE GALEANA,057,LAS PAROTAS,3,47,18,29,5
GUERRERO,12,TÉCPAN DE GALEANA,057,LAS TRUCHAS,2,12,7,5,1
GUERRERO,12,TÉCPAN DE GALEANA,057,LAS TUNAS,1,14,6,8,1
GUERRERO,12,TÉCPAN DE GALEANA,057,LLANOS DE LA PUERTA,1,4,3,1,1
GUERRERO,12,TÉCPAN DE GALEANA,057,LOMAS BONITAS (EL CERESO),1,25,12,13,1
GUERRERO,12,TÉCPAN DE GALEANA,057,LOMAS DE SAN ISIDRO,2,4,2,2,1
GUERRERO,12,TÉCPAN DE GALEANA,057,LOS BANCOS,3,43,23,20,4
GUERRERO,12,TÉCPAN DE GALEANA,057,LOS LAURELES,2,36,15,21,3
GUERRERO,12,TÉCPAN DE GALEANA,057,LOS LETRADOS,2,11,6,5,2
GUERRERO,12,TÉCPAN DE GALEANA,057,LOS LLANITOS,2,160,76,84,9
GUERRERO,12,TÉCPAN DE GALEANA,057,LOS PINOS,2,6,3,3,1
GUERRERO,12,TÉCPAN DE GALEANA,057,LOS PITALES,3,28,16,12,3
GUERRERO,12,TÉCPAN DE GALEANA,057,LOS PITOS,2,6,3,3,2
GUERRERO,12,TÉCPAN DE GALEANA,057,MAGUEYES,2,5,4,1,2
GUERRERO,12,TÉCPAN DE GALEANA,057,NUXCO,6,508,251,257,32
GUERRERO,12,TÉCPAN DE GALEANA,057,OJO DE AGUA,2,83,42,41,5
GUERRERO,12,TÉCPAN DE GALEANA,057,PALO SOLO,3,13,6,7,2
GUERRERO,12,TÉCPAN DE GALEANA,057,PAPANOA,6,838,431,407,44
GUERRERO,12,TÉCPAN DE GALEANA,057,PASO DE LOS MAGUEYES (LOS MAGUEYES),2,32,16,16,2
GUERRERO,12,TÉCPAN DE GALEANA,057,PLATANILLO,4,63,39,24,8
GUERRERO,12,TÉCPAN DE GALEANA,057,PLAYA BOCA CHICA,2,25,9,16,2
GUERRERO,12,TÉCPAN DE GALEANA,057,POCHOTE,3,16,9,7,2
GUERRERO,12,TÉCPAN DE GALEANA,057,POTRERO DE CARLOS,3,55,19,36,6
GUERRERO,12,TÉCPAN DE GALEANA,057,PUERTO DE VELA,3,8,4,4,2
GUERRERO,12,TÉCPAN DE GALEANA,057,PUERTO EDÉN,3,37,22,15,5
GUERRERO,12,TÉCPAN DE GALEANA,057,PUERTO ESCONDIDO,2,11,7,4,2
GUERRERO,12,TÉCPAN DE GALEANA,057,PUERTO VICENTE GUERRERO,6,373,182,191,48
GUERRERO,12,TÉCPAN DE GALEANA,057,PUSUMICHE (PASO DE VILLALBA),2,3,2,1,2
GUERRERO,12,TÉCPAN DE GALEANA,057,RANCHO ALEGRE DEL LLANO (EL LLANO),3,339,163,176,17
GUERRERO,12,TÉCPAN DE GALEANA,057,RÍO CHIQUITO,2,11,7,4,2
GUERRERO,12,TÉCPAN DE GALEANA,057,RODECIA,4,204,110,94,14
GUERRERO,12,TÉCPAN DE GALEANA,057,SAN ANTONIO,1,16,3,13,1
GUERRERO,12,TÉCPAN DE GALEANA,057,SAN ISIDRO EL VENADO,2,4,1,3,2
GUERRERO,12,TÉCPAN DE GALEANA,057,SAN LUIS DE LA LOMA,8,1301,666,635,60
GUERRERO,12,TÉCPAN DE GALEANA,057,SAN LUIS SAN PEDRO,9,1258,645,613,87
GUERRERO,12,TÉCPAN DE GALEANA,057,SANTA LUCÍA,4,121,58,63,11
GUERRERO,12,TÉCPAN DE GALEANA,057,SANTA MARÍA,4,151,73,78,12
GUERRERO,12,TÉCPAN DE GALEANA,057,SANTA ROSA DE LIMA (SANTA ROSA),2,185,95,90,9
GUERRERO,12,TÉCPAN DE GALEANA,057,TÉCPAN DE GALEANA,32,4316,2191,2125,326
GUERRERO,12,TÉCPAN DE GALEANA,057,TENEXPA,3,440,197,243,30
GUERRERO,12,TÉCPAN DE GALEANA,057,TETITLÁN,3,214,108,106,22
GUERRERO,12,TÉCPAN DE GALEANA,057,TIERRA BLANCA,3,23,8,15,3
GUERRERO,12,TÉCPAN DE GALEANA,057,VILLA ROTARIA,2,162,74,88,8
GUERRERO,12,TÉCPAN DE GALEANA,057,VUELTA DEL BARCO,2,7,3,4,2
GUERRERO,12,TÉCPAN DE GALEANA,057,ZACATE DE CASTILLA DOS,2,6,5,1,1
GUERRERO,12,TÉCPAN DE GALEANA,057,ZARAGOZA (EL TEJÓN),3,48,24,24,4
GUERRERO,12,TELOLOAPAN,058,ACACHAUTLA,2,9,4,5,2
GUERRERO,12,TELOLOAPAN,058,ACATEMPAN,3,193,102,91,14
GUERRERO,12,TELOLOAPAN,058,ACATLÁN DE LA CRUZ,4,186,91,95,15
GUERRERO,12,TELOLOAPAN,058,AHUACATITLÁN,2,13,6,7,4
GUERRERO,12,TELOLOAPAN,058,AHUEHUETLA,2,89,50,39,7
GUERRERO,12,TELOLOAPAN,058,ALAHUIXTLÁN,4,79,44,35,9
GUERRERO,12,TELOLOAPAN,058,ALCHOLOA,2,34,18,16,4
GUERRERO,12,TELOLOAPAN,058,ALPIXAFIA,2,39,17,22,3
GUERRERO,12,TELOLOAPAN,058,APATZINGÁN,2,16,9,7,2
GUERRERO,12,TELOLOAPAN,058,BUENAVISTA DE CHAPA,1,4,3,1,1
GUERRERO,12,TELOLOAPAN,058,BUENAVISTA DEL AIRE,2,43,21,22,5
GUERRERO,12,TELOLOAPAN,058,BUENAVISTA GUADALUPE,3,98,47,51,7
GUERRERO,12,TELOLOAPAN,058,CACAHUATLÁN,3,51,25,26,6
GUERRERO,12,TELOLOAPAN,058,CERRO ALTO,4,101,56,45,11
GUERRERO,12,TELOLOAPAN,058,CERRO CORTADO,2,7,4,3,1
GUERRERO,12,TELOLOAPAN,058,CHAPA,4,136,63,73,13
GUERRERO,12,TELOLOAPAN,058,CHICHIMECAPA,2,9,4,5,2
GUERRERO,12,TELOLOAPAN,058,CHIPILATENGO,2,5,4,1,2
GUERRERO,12,TELOLOAPAN,058,COATEPEC COSTALES,5,183,82,101,14
GUERRERO,12,TELOLOAPAN,058,COLONIA VICENTE GUERRERO,3,22,8,14,4
GUERRERO,12,TELOLOAPAN,058,COLOTEPEC,2,5,3,2,1
GUERRERO,12,TELOLOAPAN,058,CORRAL ZOCOTE,2,5,1,4,2
GUERRERO,12,TELOLOAPAN,058,CRUZ BLANCA,2,23,11,12,2
GUERRERO,12,TELOLOAPAN,058,CRUZ GRANDE,2,5,1,4,1
GUERRERO,12,TELOLOAPAN,058,CRUZ PRIETA,1,5,3,2,1
GUERRERO,12,TELOLOAPAN,058,DOLORES,2,5,0,5,2
GUERRERO,12,TELOLOAPAN,058,EL AHUACATE ZIMATEPEC,2,41,20,21,4
GUERRERO,12,TELOLOAPAN,058,EL AHUACATITO (EL AGUACATE),1,21,10,11,2
GUERRERO,12,TELOLOAPAN,058,EL CALVARIO,4,163,90,73,14
GUERRERO,12,TELOLOAPAN,058,EL CAPIRE,3,187,93,94,12
GUERRERO,12,TELOLOAPAN,058,EL DURAZNAL,1,3,0,3,1
GUERRERO,12,TELOLOAPAN,058,EL MIRADOR,2,26,12,14,4
GUERRERO,12,TELOLOAPAN,058,EL POCHOTE (POCHOTE),2,11,7,4,2
GUERRERO,12,TELOLOAPAN,058,EL QUITZAL,2,17,7,10,2
GUERRERO,12,TELOLOAPAN,058,EL SABINITO,3,12,9,3,3
GUERRERO,12,TELOLOAPAN,058,EL TANQUE (TANQUE ALTO),1,27,15,12,3
GUERRERO,12,TELOLOAPAN,058,EL TERRERO VISTAHERMOSA,1,5,4,1,1
GUERRERO,12,TELOLOAPAN,058,EL VERDECILLO,2,27,13,14,3
GUERRERO,12,TELOLOAPAN,058,EL ZAPOTE,3,35,20,15,4
GUERRERO,12,TELOLOAPAN,058,HACIENDA DE OCUILIXTLAHUACÁN,3,27,12,15,3
GUERRERO,12,TELOLOAPAN,058,HUERTA GRANDE NORTE,2,52,23,29,5
GUERRERO,12,TELOLOAPAN,058,HUERTA GRANDE SUR,3,34,14,20,6
GUERRERO,12,TELOLOAPAN,058,IXTAZACATLA,3,20,9,11,3
GUERRERO,12,TELOLOAPAN,058,IXTLAHUALTOXTLA (IXTAHUASTOTLA),1,6,3,3,1
GUERRERO,12,TELOLOAPAN,058,LA CONCEPCIÓN PURA (LA PURÍSIMA CONCEPCIÓN),3,39,24,15,4
GUERRERO,12,TELOLOAPAN,058,LA CONCORDIA,3,48,24,24,6
GUERRERO,12,TELOLOAPAN,058,LA GUADALUPE,3,27,16,11,4
GUERRERO,12,TELOLOAPAN,058,LA MAGDALENA,3,61,33,28,9
GUERRERO,12,TELOLOAPAN,058,LA UNIÓN,1,8,3,5,1
GUERRERO,12,TELOLOAPAN,058,LAGUNA SECA,3,45,20,25,7
GUERRERO,12,TELOLOAPAN,058,LAS CEIBAS,2,19,10,9,2
GUERRERO,12,TELOLOAPAN,058,LAS NEBLINAS,1,5,2,3,2
GUERRERO,12,TELOLOAPAN,058,LIBERAL GUERRERO,1,3,1,2,1
GUERRERO,12,TELOLOAPAN,058,LOMA ZOCOTE,2,5,2,3,2
GUERRERO,12,TELOLOAPAN,058,LOS AGUAJES,2,11,3,8,2
GUERRERO,12,TELOLOAPAN,058,LOS COAJIOTES,1,8,6,2,1
GUERRERO,12,TELOLOAPAN,058,LOS CUATLIX,2,12,5,7,2
GUERRERO,12,TELOLOAPAN,058,LOS ESPINOS,1,9,5,4,1
GUERRERO,12,TELOLOAPAN,058,LOS FRESNOS,2,6,5,1,2
GUERRERO,12,TELOLOAPAN,058,LOS LIMONES,2,17,10,7,3
GUERRERO,12,TELOLOAPAN,058,LOS MANGOS,1,8,5,3,1
GUERRERO,12,TELOLOAPAN,058,LOS PERICONES,2,48,28,20,3
GUERRERO,12,TELOLOAPAN,058,LOS SABINOS,3,83,38,45,8
GUERRERO,12,TELOLOAPAN,058,LOS SAUCES,4,245,120,125,18
GUERRERO,12,TELOLOAPAN,058,MIAHUATEPEC,4,112,57,55,9
GUERRERO,12,TELOLOAPAN,058,MONTE SAUCE,1,3,1,2,1
GUERRERO,12,TELOLOAPAN,058,NUEVA ESPERANZA,2,9,4,5,2
GUERRERO,12,TELOLOAPAN,058,OCOTITLÁN (SANTA MARÍA OCOTITLÁN),1,9,8,1,1
GUERRERO,12,TELOLOAPAN,058,OXTOTITLÁN,6,444,216,228,46
GUERRERO,12,TELOLOAPAN,058,OZOLOTEPEC,2,10,5,5,2
GUERRERO,12,TELOLOAPAN,058,PETLAHUAXALE,2,20,9,11,2
GUERRERO,12,TELOLOAPAN,058,PEZUAPILLA Y NARANJO,2,26,14,12,5
GUERRERO,12,TELOLOAPAN,058,PLAN DEL SABINO,3,57,30,27,6
GUERRERO,12,TELOLOAPAN,058,PUERTO DE LAS FLORES,2,49,24,25,4
GUERRERO,12,TELOLOAPAN,058,PUERTO DEL OCOTE,2,14,9,5,2
GUERRERO,12,TELOLOAPAN,058,RANCHOS NUEVOS,1,9,6,3,1
GUERRERO,12,TELOLOAPAN,058,RINCÓN CHIQUITO,2,16,6,10,4
GUERRERO,12,TELOLOAPAN,058,RINCÓN DEL SAUCE,2,24,20,4,4
GUERRERO,12,TELOLOAPAN,058,RÍO DE ZAYULAPA (SAYULAPAN),3,37,23,14,3
GUERRERO,12,TELOLOAPAN,058,SAN ANTONIO ACACHAUTLA,3,44,18,26,4
GUERRERO,12,TELOLOAPAN,058,SAN ANTONIO AHUEHUEPAN,1,3,3,0,1
GUERRERO,12,TELOLOAPAN,058,SAN ANTONIO GUERRERO,2,25,16,9,2
GUERRERO,12,TELOLOAPAN,058,SAN FRANCISCO,3,28,15,13,3
GUERRERO,12,TELOLOAPAN,058,SAN LORENZO,2,19,8,11,2
GUERRERO,12,TELOLOAPAN,058,SAN SALVADOR,1,4,0,4,1
GUERRERO,12,TELOLOAPAN,058,SANTA CRUZ UNIÓN,2,45,19,26,4
GUERRERO,12,TELOLOAPAN,058,TEHUIXTLA,4,386,181,205,26
GUERRERO,12,TELOLOAPAN,058,TELOLOAPAN,55,8098,4146,3952,559
GUERRERO,12,TELOLOAPAN,058,TENANCINGO,2,49,32,17,4
GUERRERO,12,TELOLOAPAN,058,TENANTITLÁN,1,8,3,5,1
GUERRERO,12,TELOLOAPAN,058,TEPESCUAHUIT (TEPOZCUAHUILT),1,7,2,5,1
GUERRERO,12,TELOLOAPAN,058,TEPOZONALQUILLO,4,129,59,70,11
GUERRERO,12,TELOLOAPAN,058,TETZILACATLÁN,3,53,25,28,8
GUERRERO,12,TELOLOAPAN,058,TIANQUIZOLCO IXTICAPAN,2,62,29,33,8
GUERRERO,12,TELOLOAPAN,058,TIERRA BLANCA,2,33,12,21,3
GUERRERO,12,TELOLOAPAN,058,TLACUITLAPA,4,157,78,79,13
GUERRERO,12,TELOLOAPAN,058,TLAJOCOTLA (LA HACIENDA),4,182,94,88,15
GUERRERO,12,TELOLOAPAN,058,TLALPEXCO,5,75,34,41,10
GUERRERO,12,TELOLOAPAN,058,TLANIPATLÁN (DE LAS LIMAS),2,11,3,8,2
GUERRERO,12,TELOLOAPAN,058,TONALAPA DEL RÍO,7,348,177,171,25
GUERRERO,12,TELOLOAPAN,058,TONALATL,1,18,7,11,2
GUERRERO,12,TELOLOAPAN,058,TONALCUAL,3,122,60,62,11
GUERRERO,12,TELOLOAPAN,058,TOTOLTEPEC,4,164,86,78,11
GUERRERO,12,TELOLOAPAN,058,TULE Y ZACUAPA,2,29,11,18,3
GUERRERO,12,TELOLOAPAN,058,TUXTLA CUEVILLAS,3,35,20,15,3
GUERRERO,12,TELOLOAPAN,058,VALLE DE XÓCHIL,2,53,26,27,4
GUERRERO,12,TELOLOAPAN,058,XIXICASTEPEC,1,9,4,5,1
GUERRERO,12,TELOLOAPAN,058,YERBABUENA,2,26,13,13,2
GUERRERO,12,TELOLOAPAN,058,ZACATLÁN DE GUERRERO,2,28,12,16,4
GUERRERO,12,TELOLOAPAN,058,ZACATLANCILLO,2,12,6,6,2
GUERRERO,12,TELOLOAPAN,058,ZOPILOAL,3,34,20,14,4
GUERRERO,12,TEPECOACUILCO DE TRUJANO,059,ACAYAHUALCO,3,167,82,85,12
GUERRERO,12,TEPECOACUILCO DE TRUJANO,059,AHUEHUEPAN,3,216,92,124,12
GUERRERO,12,TEPECOACUILCO DE TRUJANO,059,COLONIA LÁZARO CÁRDENAS (LÁZARO CÁRDENAS),3,52,25,27,7
GUERRERO,12,TEPECOACUILCO DE TRUJANO,059,COLONIA VALERIO TRUJANO (VALERIO TRUJANO),3,112,65,47,8
GUERRERO,12,TEPECOACUILCO DE TRUJANO,059,CUEXCONTLÁN,3,80,49,31,10
GUERRERO,12,TEPECOACUILCO DE TRUJANO,059,EL RINCÓN (RINCÓN CHIQUITO),2,66,32,34,7
GUERRERO,12,TEPECOACUILCO DE TRUJANO,059,LAS TUNAS,3,62,30,32,4
GUERRERO,12,TEPECOACUILCO DE TRUJANO,059,MAXELA,4,209,99,110,15
GUERRERO,12,TEPECOACUILCO DE TRUJANO,059,MAYANALÁN,7,635,309,326,43
GUERRERO,12,TEPECOACUILCO DE TRUJANO,059,PALULA,3,159,82,77,12
GUERRERO,12,TEPECOACUILCO DE TRUJANO,059,RINCÓN DE LA COCINA,3,127,57,70,12
GUERRERO,12,TEPECOACUILCO DE TRUJANO,059,SABANA GRANDE,4,260,123,137,22
GUERRERO,12,TEPECOACUILCO DE TRUJANO,059,SAN AGUSTÍN OAPAN,5,374,181,193,25
GUERRERO,12,TEPECOACUILCO DE TRUJANO,059,SAN GABRIELITO,1,75,27,48,6
GUERRERO,12,TEPECOACUILCO DE TRUJANO,059,SAN JUAN TETELCINGO,3,155,89,66,9
GUERRERO,12,TEPECOACUILCO DE TRUJANO,059,SAN MIGUEL TECUICIAPAN,5,364,184,180,31
GUERRERO,12,TEPECOACUILCO DE TRUJANO,059,SAN VICENTE PALAPA,5,265,128,137,21
GUERRERO,12,TEPECOACUILCO DE TRUJANO,059,SANTA CRUZ,3,116,61,55,9
GUERRERO,12,TEPECOACUILCO DE TRUJANO,059,SASAMULCO,3,132,77,55,10
GUERRERO,12,TEPECOACUILCO DE TRUJANO,059,TECUEXCONTITLÁN (TECOESCONTITLÁN),3,231,109,122,13
GUERRERO,12,TEPECOACUILCO DE TRUJANO,059,TEPECOACUILCO DE TRUJANO,14,1321,644,677,152
GUERRERO,12,TEPECOACUILCO DE TRUJANO,059,TETELILLA,3,130,81,49,11
GUERRERO,12,TEPECOACUILCO DE TRUJANO,059,TIERRA COLORADA,3,181,91,90,15
GUERRERO,12,TEPECOACUILCO DE TRUJANO,059,TONALAPA DEL SUR,5,328,161,167,25
GUERRERO,12,TEPECOACUILCO DE TRUJANO,059,VENTA DE PALULA,2,84,51,33,8
GUERRERO,12,TEPECOACUILCO DE TRUJANO,059,XALITLA,6,572,267,305,33
GUERRERO,12,TEPECOACUILCO DE TRUJANO,059,XOCHIMILCO (SAN IGNACIO XOCHIMILCO),3,70,43,27,9
GUERRERO,12,TETIPAC,060,AHUALULCO,2,38,19,19,3
GUERRERO,12,TETIPAC,060,ATENCAHUITES,2,24,15,9,3
GUERRERO,12,TETIPAC,060,CHONTALCOATLÁN,5,285,149,136,16
GUERRERO,12,TETIPAC,060,CHONTALPÁN,3,32,15,17,3
GUERRERO,12,TETIPAC,060,COAPANGO,3,66,24,42,6
GUERRERO,12,TETIPAC,060,EL SÁMANO,2,9,7,2,1
GUERRERO,12,TETIPAC,060,IXTEPEC,3,27,14,13,3
GUERRERO,12,TETIPAC,060,IXTLAHUACA,2,8,2,6,2
GUERRERO,12,TETIPAC,060,JOCOTITLÁN,4,223,107,116,15
GUERRERO,12,TETIPAC,060,LOS AYLES,3,94,34,60,7
GUERRERO,12,TETIPAC,060,LOS PLANES,2,23,11,12,2
GUERRERO,12,TETIPAC,060,MALHUANTLA,3,56,26,30,4
GUERRERO,12,TETIPAC,060,NOXTEPEC,4,100,46,54,10
GUERRERO,12,TETIPAC,060,PALAFOX,2,23,12,11,2
GUERRERO,12,TETIPAC,060,PALOS VERDES,3,32,13,19,4
GUERRERO,12,TETIPAC,060,PEZUAPA,2,25,12,13,2
GUERRERO,12,TETIPAC,060,PIPICHAHUAZCO,3,26,12,14,4
GUERRERO,12,TETIPAC,060,PODER DE DIOS (SAN MATEO),3,40,22,18,4
GUERRERO,12,TETIPAC,060,PUEBLO NUEVO,2,116,51,65,6
GUERRERO,12,TETIPAC,060,SAN ANDRÉS,3,123,64,59,9
GUERRERO,12,TETIPAC,060,SAN ANTONIO,3,64,35,29,6
GUERRERO,12,TETIPAC,060,SAN FERNANDO,2,12,6,6,2
GUERRERO,12,TETIPAC,060,SAN GABRIELITO,3,55,24,31,3
GUERRERO,12,TETIPAC,060,SAN GREGORIO,4,294,147,147,17
GUERRERO,12,TETIPAC,060,SANTA CRUZ,3,27,11,16,3
GUERRERO,12,TETIPAC,060,SANTIAGO,3,86,50,36,6
GUERRERO,12,TETIPAC,060,TECOANAPA,3,10,4,6,2
GUERRERO,12,TETIPAC,060,TENEXCONTITLÁN (EL RANCHITO),3,155,85,70,8
GUERRERO,12,TETIPAC,060,TEPACOYA,2,36,16,20,4
GUERRERO,12,TETIPAC,060,TETIPAC,7,608,317,291,42
GUERRERO,12,TETIPAC,060,TOTONANCINTLA,2,10,6,4,1
GUERRERO,12,TETIPAC,060,XITINGA [FLETES],3,15,6,9,3
GUERRERO,12,TIXTLA DE GUERRERO,061,ACATEMPA,3,390,202,188,17
GUERRERO,12,TIXTLA DE GUERRERO,061,ALMOLONGA,5,324,164,160,19
GUERRERO,12,TIXTLA DE GUERRERO,061,ATLIACA,14,1956,958,998,109
GUERRERO,12,TIXTLA DE GUERRERO,061,AYOTZINAPA,1,633,0,633,57
GUERRERO,12,TIXTLA DE GUERRERO,061,CHALICO (RANCHO CHALICO),1,151,81,70,6
GUERRERO,12,TIXTLA DE GUERRERO,061,CHILACACHAPA,3,161,86,75,12
GUERRERO,12,TIXTLA DE GUERRERO,061,EL AHUEJOTE,3,135,65,70,12
GUERRERO,12,TIXTLA DE GUERRERO,061,EL DURAZNO,3,280,140,140,18
GUERRERO,12,TIXTLA DE GUERRERO,061,EL POTRERO,5,109,51,58,11
GUERRERO,12,TIXTLA DE GUERRERO,061,EL TRONCÓN,4,133,62,71,13
GUERRERO,12,TIXTLA DE GUERRERO,061,LA ESTACADA,2,41,22,19,3
GUERRERO,12,TIXTLA DE GUERRERO,061,LOS TERREROS (COLONIA GENERAL EUSEBIO GONZÁLEZ S.),1,19,9,10,1
GUERRERO,12,TIXTLA DE GUERRERO,061,MATLALAPA,1,10,7,3,1
GUERRERO,12,TIXTLA DE GUERRERO,061,OJITOS DE AGUA,2,17,10,7,3
GUERRERO,12,TIXTLA DE GUERRERO,061,OMEAPA,3,83,38,45,7
GUERRERO,12,TIXTLA DE GUERRERO,061,PLAN DE GUERRERO,3,89,47,42,11
GUERRERO,12,TIXTLA DE GUERRERO,061,TIXTLA DE GUERRERO,37,6262,3132,3130,375
GUERRERO,12,TIXTLA DE GUERRERO,061,ZACATZONAPA,4,323,158,165,16
GUERRERO,12,TIXTLA DE GUERRERO,061,ZOQUIAPA,4,410,233,177,21
GUERRERO,12,TLACOACHISTLAHUACA,062,BARRANCA ESTACA,2,30,16,14,2
GUERRERO,12,TLACOACHISTLAHUACA,062,CRUZ ALTA,3,59,23,36,4
GUERRERO,12,TLACOACHISTLAHUACA,062,EL CAPULÍN,3,245,131,114,12
GUERRERO,12,TLACOACHISTLAHUACA,062,EL LIMÓN GUADALUPE,3,99,42,57,7
GUERRERO,12,TLACOACHISTLAHUACA,062,GUADALUPE MANO DE LEÓN,2,119,54,65,6
GUERRERO,12,TLACOACHISTLAHUACA,062,HUEHUETÓNOC,5,430,216,214,25
GUERRERO,12,TLACOACHISTLAHUACA,062,JICAYÁN DE TOVAR,3,396,198,198,18
GUERRERO,12,TLACOACHISTLAHUACA,062,JIQUIMILLAS (JIQUILILLA),2,51,27,24,4
GUERRERO,12,TLACOACHISTLAHUACA,062,JUQUILA YUCUCANI,1,29,17,12,1
GUERRERO,12,TLACOACHISTLAHUACA,062,LA GUADALUPE,3,138,66,72,7
GUERRERO,12,TLACOACHISTLAHUACA,062,LA TRINIDAD,3,325,163,162,12
GUERRERO,12,TLACOACHISTLAHUACA,062,LAS MINAS,3,129,64,65,10
GUERRERO,12,TLACOACHISTLAHUACA,062,LLANO DEL TIGRE,2,55,28,27,3
GUERRERO,12,TLACOACHISTLAHUACA,062,LLANO ZAPOTE,2,63,34,29,7
GUERRERO,12,TLACOACHISTLAHUACA,062,PLAN MAMEY,3,70,27,43,3
GUERRERO,12,TLACOACHISTLAHUACA,062,RANCHO CUANANCHINICHA,4,188,94,94,15
GUERRERO,12,TLACOACHISTLAHUACA,062,RANCHO VIEJO (RANCHO NUEVO DE LA DEMOCRACIA),4,480,258,222,23
GUERRERO,12,TLACOACHISTLAHUACA,062,SAN CRISTÓBAL,6,369,192,177,28
GUERRERO,12,TLACOACHISTLAHUACA,062,SAN ISIDRO,3,55,28,27,5
GUERRERO,12,TLACOACHISTLAHUACA,062,SAN JERÓNIMO,3,301,158,143,12
GUERRERO,12,TLACOACHISTLAHUACA,062,SAN JOSÉ,1,46,19,27,3
GUERRERO,12,TLACOACHISTLAHUACA,062,SAN MARTÍN,3,74,36,38,5
GUERRERO,12,TLACOACHISTLAHUACA,062,SAN PEDRO CUITLAPAN,6,529,271,258,27
GUERRERO,12,TLACOACHISTLAHUACA,062,SANTA CRUZ YUCUCANI,3,431,218,213,14
GUERRERO,12,TLACOACHISTLAHUACA,062,TERRERO VENADO,3,277,150,127,10
GUERRERO,12,TLACOACHISTLAHUACA,062,TLACOACHISTLAHUACA,15,1687,832,855,93
GUERRERO,12,TLACOACHISTLAHUACA,062,YOLOXÓCHITL (SANTIAGO YOLOXÓCHITL),3,252,131,121,11
GUERRERO,12,TLACOAPA,063,AHUEHUETE,2,41,21,20,3
GUERRERO,12,TLACOAPA,063,AHUEJUYOS ASALTADOS (EL AHUEJUYO),2,42,21,21,3
GUERRERO,12,TLACOAPA,063,BARRANCA NOPALERA,1,12,7,5,2
GUERRERO,12,TLACOAPA,063,BUENA VISTA,1,34,19,15,2
GUERRERO,12,TLACOAPA,063,CHIRIMOYO,2,38,21,17,3
GUERRERO,12,TLACOAPA,063,CRUZ DE GALLO,2,31,15,16,3
GUERRERO,12,TLACOAPA,063,EL CAMPANARIO,2,20,8,12,4
GUERRERO,12,TLACOAPA,063,EL CAPULÍN,2,13,9,4,3
GUERRERO,12,TLACOAPA,063,EL CARRIZAL,1,31,22,9,2
GUERRERO,12,TLACOAPA,063,EL MIRADOR,2,14,10,4,2
GUERRERO,12,TLACOAPA,063,LA MAGUEYERA,2,22,10,12,3
GUERRERO,12,TLACOAPA,063,LAGUNA SECA,1,47,31,16,2
GUERRERO,12,TLACOAPA,063,LLANO VERDE,2,31,15,16,3
GUERRERO,12,TLACOAPA,063,METLAPILAPA,3,74,36,38,5
GUERRERO,12,TLACOAPA,063,PIEDRA ESCALERA,1,14,9,5,1
GUERRERO,12,TLACOAPA,063,PLAN DE GUADALUPE,2,33,15,18,3
GUERRERO,12,TLACOAPA,063,PLAN JACARANDA,2,22,7,15,3
GUERRERO,12,TLACOAPA,063,SABANA,3,133,63,70,6
GUERRERO,12,TLACOAPA,063,SABINO DE GUADALUPE,2,39,22,17,3
GUERRERO,12,TLACOAPA,063,SAN MARCOS,1,7,2,5,1
GUERRERO,12,TLACOAPA,063,SAN MIGUEL BUENAVISTA,3,46,24,22,4
GUERRERO,12,TLACOAPA,063,SAN MIGUEL TENAMAZAPA (SAN MIGUELITO),2,75,38,37,4
GUERRERO,12,TLACOAPA,063,TECOLUTLA,1,10,5,5,1
GUERRERO,12,TLACOAPA,063,TENAMAZAPA,4,479,238,241,20
GUERRERO,12,TLACOAPA,063,TLACOAPA,6,670,326,344,43
GUERRERO,12,TLACOAPA,063,TLACOTEPEC,2,58,28,30,5
GUERRERO,12,TLACOAPA,063,TOTOMIXTLAHUACA,4,463,242,221,30
GUERRERO,12,TLACOAPA,063,VISTA HERMOSA,2,28,15,13,3
GUERRERO,12,TLACOAPA,063,XOCHISTLAHUACA,2,36,19,17,3
GUERRERO,12,TLACOAPA,063,XOCOAPA,2,71,34,37,6
GUERRERO,12,TLALCHAPA,064,CHAPULTEPEC (EL CHAPUL),4,115,62,53,9
GUERRERO,12,TLALCHAPA,064,COLONIA CUAUHTÉMOC,5,140,71,69,22
GUERRERO,12,TLALCHAPA,064,CUAUHLOTITLÁN,4,174,94,80,21
GUERRERO,12,TLALCHAPA,064,EL AGUACATE,3,58,37,21,6
GUERRERO,12,TLALCHAPA,064,EL CHUCUMPÚN,2,12,6,6,2
GUERRERO,12,TLALCHAPA,064,EL PASO DE AMATITLÁN,1,11,5,6,2
GUERRERO,12,TLALCHAPA,064,EL TAMARINDO DEL RÍO,2,11,9,2,3
GUERRERO,12,TLALCHAPA,064,HUAXQUIAL,2,18,9,9,2
GUERRERO,12,TLALCHAPA,064,LA CACÁNICUA DE ARRIBA,1,9,5,4,1
GUERRERO,12,TLALCHAPA,064,LA MONTAÑA,3,80,37,43,9
GUERRERO,12,TLALCHAPA,064,LOS NOPALES,3,41,16,25,5
GUERRERO,12,TLALCHAPA,064,OTLATEPEC (AGUA DEL PADRE),4,137,56,81,11
GUERRERO,12,TLALCHAPA,064,PUERTO DE ALLENDE (PUERTA DE ARRIBA),2,27,17,10,2
GUERRERO,12,TLALCHAPA,064,SAN JUAN,2,17,8,9,2
GUERRERO,12,TLALCHAPA,064,SAN MIGUEL TECOMATLÁN,6,264,123,141,21
GUERRERO,12,TLALCHAPA,064,SAN VICENTE,1,17,7,10,1
GUERRERO,12,TLALCHAPA,064,TENANCINGO,2,27,11,16,2
GUERRERO,12,TLALCHAPA,064,TLALCHAPA,9,1323,662,661,80
GUERRERO,12,TLALCHAPA,064,TLANEXPA,1,2,0,2,1
GUERRERO,12,TLALCHAPA,064,VILLA MADERO (EL POTRERO),5,263,113,150,19
GUERRERO,12,TLALIXTAQUILLA DE MALDONADO,065,AHUACATITLÁN (AGUACATITLÁN),4,115,50,65,10
GUERRERO,12,TLALIXTAQUILLA DE MALDONADO,065,CANNÁN CIUDAD DE LA LUZ,2,156,73,83,9
GUERRERO,12,TLALIXTAQUILLA DE MALDONADO,065,LA LUZ DE JUÁREZ,6,390,198,192,23
GUERRERO,12,TLALIXTAQUILLA DE MALDONADO,065,LA RIVERA,2,36,18,18,3
GUERRERO,12,TLALIXTAQUILLA DE MALDONADO,065,MEXQUITITLÁN,3,84,42,42,7
GUERRERO,12,TLALIXTAQUILLA DE MALDONADO,065,SANTA CRUZ,4,392,213,179,18
GUERRERO,12,TLALIXTAQUILLA DE MALDONADO,065,TECOYAME DE GUADALUPE,4,197,106,91,13
GUERRERO,12,TLALIXTAQUILLA DE MALDONADO,065,TLALIXTAQUILLA,5,669,354,315,38
GUERRERO,12,TLAPA DE COMONFORT,066,ACATENCO,2,49,23,26,3
GUERRERO,12,TLAPA DE COMONFORT,066,AGUA DULCE,2,24,11,13,2
GUERRERO,12,TLAPA DE COMONFORT,066,AHUATEPEC EJIDO,3,453,244,209,17
GUERRERO,12,TLAPA DE COMONFORT,066,AHUATEPEC PUEBLO,4,514,248,266,33
GUERRERO,12,TLAPA DE COMONFORT,066,ALPOYECANCINGO,2,41,19,22,3
GUERRERO,12,TLAPA DE COMONFORT,066,AMATE AMARILLO,2,41,17,24,3
GUERRERO,12,TLAPA DE COMONFORT,066,AQUILPA,3,218,110,108,12
GUERRERO,12,TLAPA DE COMONFORT,066,ATLAMAJAC,3,678,353,325,30
GUERRERO,12,TLAPA DE COMONFORT,066,ATLAMAJALCINGO DEL RÍO,3,322,160,162,16
GUERRERO,12,TLAPA DE COMONFORT,066,AYOTZINAPA,5,338,183,155,14
GUERRERO,12,TLAPA DE COMONFORT,066,BARRANCA DEL OTATE,2,38,27,11,3
GUERRERO,12,TLAPA DE COMONFORT,066,CHICAHUASTEPEC,1,11,6,5,1
GUERRERO,12,TLAPA DE COMONFORT,066,CHIEPETEPEC,8,728,354,374,54
GUERRERO,12,TLAPA DE COMONFORT,066,CHIEPETLÁN (SAN MIGUEL CHIEPETLÁN),3,234,95,139,16
GUERRERO,12,TLAPA DE COMONFORT,066,COACHIMALCO,3,339,169,170,16
GUERRERO,12,TLAPA DE COMONFORT,066,COLONIA DE GUADALUPE,2,45,20,25,3
GUERRERO,12,TLAPA DE COMONFORT,066,COLONIA EL AGUAJE,2,35,22,13,3
GUERRERO,12,TLAPA DE COMONFORT,066,COLONIA MONTE DE OLIVO,1,29,14,15,2
GUERRERO,12,TLAPA DE COMONFORT,066,COLONIA MONTE SINAÍ,2,78,41,37,4
GUERRERO,12,TLAPA DE COMONFORT,066,COLONIA XOCHIMILCO,1,10,3,7,1
GUERRERO,12,TLAPA DE COMONFORT,066,EL NUEVO AMANECER,1,22,14,8,2
GUERRERO,12,TLAPA DE COMONFORT,066,LA PROVIDENCIA,2,153,73,80,9
GUERRERO,12,TLAPA DE COMONFORT,066,LA SOLEDAD,2,193,91,102,10
GUERRERO,12,TLAPA DE COMONFORT,066,LAS PILAS,2,101,50,51,7
GUERRERO,12,TLAPA DE COMONFORT,066,LINDA VISTA,2,133,76,57,6
GUERRERO,12,TLAPA DE COMONFORT,066,LLANO DE SANTA CRUZ,2,25,14,11,2
GUERRERO,12,TLAPA DE COMONFORT,066,MEXCALA,2,24,10,14,3
GUERRERO,12,TLAPA DE COMONFORT,066,PLAN DE ZACATEPEC,2,39,21,18,3
GUERRERO,12,TLAPA DE COMONFORT,066,RÍO AZUL,1,25,10,15,2
GUERRERO,12,TLAPA DE COMONFORT,066,SAN ISIDRO,2,55,26,29,2
GUERRERO,12,TLAPA DE COMONFORT,066,SAN MARCOS,1,73,32,41,3
GUERRERO,12,TLAPA DE COMONFORT,066,SAN MIGUEL AXOXUCA,3,383,190,193,18
GUERRERO,12,TLAPA DE COMONFORT,066,SAN MIGUEL ZAPOTITLÁN,1,31,16,15,1
GUERRERO,12,TLAPA DE COMONFORT,066,SAN MIGUELITO,2,87,41,46,5
GUERRERO,12,TLAPA DE COMONFORT,066,SAN PEDRO ACATLÁN,2,150,89,61,8
GUERRERO,12,TLAPA DE COMONFORT,066,SAN PEDRO PETLACALA,4,239,105,134,15
GUERRERO,12,TLAPA DE COMONFORT,066,SANTA CRUZ TLALCHICHILCO,2,44,16,28,3
GUERRERO,12,TLAPA DE COMONFORT,066,SANTA MARÍA TONAYA,3,228,116,112,12
GUERRERO,12,TLAPA DE COMONFORT,066,TEHUCHICOLOYA,2,37,16,21,4
GUERRERO,12,TLAPA DE COMONFORT,066,TENANGO TEPEXI,4,233,115,118,14
GUERRERO,12,TLAPA DE COMONFORT,066,TENEXTEYO,2,13,7,6,2
GUERRERO,12,TLAPA DE COMONFORT,066,TEPEYAHUALCO,2,36,19,17,3
GUERRERO,12,TLAPA DE COMONFORT,066,TLACUILOYA,3,139,77,62,8
GUERRERO,12,TLAPA DE COMONFORT,066,TLAPA DE COMONFORT,133,24958,13185,11773,1380
GUERRERO,12,TLAPA DE COMONFORT,066,TLAQUILTZINAPA,5,479,239,240,27
GUERRERO,12,TLAPA DE COMONFORT,066,TLAQUILZINGO,3,210,101,109,12
GUERRERO,12,TLAPA DE COMONFORT,066,TLATZALA,3,327,150,177,16
GUERRERO,12,TLAPA DE COMONFORT,066,TORRENTLÁN,2,48,31,17,3
GUERRERO,12,TLAPA DE COMONFORT,066,TOTOMOCHAPA,2,23,5,18,2
GUERRERO,12,TLAPA DE COMONFORT,066,TOTOTEPEC (YOZONONI),9,842,418,424,42
GUERRERO,12,TLAPA DE COMONFORT,066,TRES CAMINOS,3,133,65,68,8
GUERRERO,12,TLAPA DE COMONFORT,066,VILLA DE GUADALUPE,2,31,13,18,3
GUERRERO,12,TLAPA DE COMONFORT,066,VIRGEN DE JUQUILA,1,21,8,13,1
GUERRERO,12,TLAPA DE COMONFORT,066,XALATZALA,4,700,338,362,35
GUERRERO,12,TLAPA DE COMONFORT,066,XOCOTEPEC (SAN MARCOS DEL RANCHO),3,91,39,52,6
GUERRERO,12,TLAPA DE COMONFORT,066,ZACAPEXCO,2,55,26,29,3
GUERRERO,12,TLAPA DE COMONFORT,066,ZACUALPAN,3,171,91,80,10
GUERRERO,12,TLAPA DE COMONFORT,066,ZITLALA,1,13,7,6,1
GUERRERO,12,TLAPEHUALA,067,COLONIA JUÁREZ (EL JABALÍ),4,222,104,118,18
GUERRERO,12,TLAPEHUALA,067,EL CUACUYUL,2,40,20,20,3
GUERRERO,12,TLAPEHUALA,067,EL LIMÓN DE GUADALUPE,1,8,5,3,2
GUERRERO,12,TLAPEHUALA,067,EL TANQUE,2,70,32,38,6
GUERRERO,12,TLAPEHUALA,067,EL TINOCO,3,67,36,31,6
GUERRERO,12,TLAPEHUALA,067,HACIENDA NUEVA,2,51,26,25,3
GUERRERO,12,TLAPEHUALA,067,LAS FRAGUAS,2,41,24,17,2
GUERRERO,12,TLAPEHUALA,067,MORELITA,4,291,142,149,17
GUERRERO,12,TLAPEHUALA,067,NUEVA FILADELFIA (HUERTA VIEJA),1,4,4,0,1
GUERRERO,12,TLAPEHUALA,067,NUEVO GUERRERO,3,266,110,156,17
GUERRERO,12,TLAPEHUALA,067,RINCÓN DEL GALLO (SAN JOSÉ GUADALUPE),2,137,67,70,8
GUERRERO,12,TLAPEHUALA,067,SAN ANTONIO DE LAS HUERTAS,5,558,288,270,32
GUERRERO,12,TLAPEHUALA,067,SAN JOSÉ POLIUTLA,8,648,301,347,52
GUERRERO,12,TLAPEHUALA,067,SAN JUAN MINA,2,117,52,65,9
GUERRERO,12,TLAPEHUALA,067,SANTO NIÑO (SANTO NIÑO DE ATOCHA),3,162,66,96,11
GUERRERO,12,TLAPEHUALA,067,TIRINGUEO,2,120,52,68,7
GUERRERO,12,TLAPEHUALA,067,TLAPEHUALA,18,3110,1547,1563,183
GUERRERO,12,LA UNIÓN DE ISIDORO MONTES DE OCA,068,AGUA ZARCA,1,5,2,3,1
GUERRERO,12,LA UNIÓN DE ISIDORO MONTES DE OCA,068,ARROYO GRANDE,2,33,18,15,3
GUERRERO,12,LA UNIÓN DE ISIDORO MONTES DE OCA,068,BARRANCA DE MARMOLEJO,3,104,54,50,8
GUERRERO,12,LA UNIÓN DE ISIDORO MONTES DE OCA,068,BENÍTEZ,3,93,50,43,6
GUERRERO,12,LA UNIÓN DE ISIDORO MONTES DE OCA,068,BOCA DE LAGUNILLAS,2,30,14,16,3
GUERRERO,12,LA UNIÓN DE ISIDORO MONTES DE OCA,068,CASAS VIEJAS,3,30,13,17,3
GUERRERO,12,LA UNIÓN DE ISIDORO MONTES DE OCA,068,CHANGUNGAL,3,25,13,12,3
GUERRERO,12,LA UNIÓN DE ISIDORO MONTES DE OCA,068,CHUTLA DE NAVA,2,33,20,13,2
GUERRERO,12,LA UNIÓN DE ISIDORO MONTES DE OCA,068,CORRAL FALSO,1,11,5,6,1
GUERRERO,12,LA UNIÓN DE ISIDORO MONTES DE OCA,068,COYUQUILLA,3,113,55,58,8
GUERRERO,12,LA UNIÓN DE ISIDORO MONTES DE OCA,068,EL ÁGUILA,1,17,6,11,1
GUERRERO,12,LA UNIÓN DE ISIDORO MONTES DE OCA,068,EL CEDRAL,3,38,18,20,3
GUERRERO,12,LA UNIÓN DE ISIDORO MONTES DE OCA,068,EL CHICO,2,37,16,21,3
GUERRERO,12,LA UNIÓN DE ISIDORO MONTES DE OCA,068,EL CIRIÁN,1,6,3,3,1
GUERRERO,12,LA UNIÓN DE ISIDORO MONTES DE OCA,068,EL ENTRONQUE DE LA UNIÓN (DESVIACIÓN DE LA UNIÓN),2,24,13,11,3
GUERRERO,12,LA UNIÓN DE ISIDORO MONTES DE OCA,068,EL FAISANAL,2,5,3,2,2
GUERRERO,12,LA UNIÓN DE ISIDORO MONTES DE OCA,068,EL HUARICHO (CIUDAD INSURGENTES),3,77,37,40,5
GUERRERO,12,LA UNIÓN DE ISIDORO MONTES DE OCA,068,EL HUICUMO,3,30,14,16,3
GUERRERO,12,LA UNIÓN DE ISIDORO MONTES DE OCA,068,EL LIMÓN,2,28,11,17,3
GUERRERO,12,LA UNIÓN DE ISIDORO MONTES DE OCA,068,EL NARANJILLO,3,89,48,41,6
GUERRERO,12,LA UNIÓN DE ISIDORO MONTES DE OCA,068,EL NARANJITO,2,239,117,122,13
GUERRERO,12,LA UNIÓN DE ISIDORO MONTES DE OCA,068,EL ROBLE,1,20,12,8,1
GUERRERO,12,LA UNIÓN DE ISIDORO MONTES DE OCA,068,EL TIBOR,4,165,77,88,10
GUERRERO,12,LA UNIÓN DE ISIDORO MONTES DE OCA,068,EL VELADERO,1,7,3,4,1
GUERRERO,12,LA UNIÓN DE ISIDORO MONTES DE OCA,068,FELICIANO,2,63,29,34,3
GUERRERO,12,LA UNIÓN DE ISIDORO MONTES DE OCA,068,HUERTECILLAS,2,12,8,4,2
GUERRERO,12,LA UNIÓN DE ISIDORO MONTES DE OCA,068,JOLUTA,4,250,111,139,17
GUERRERO,12,LA UNIÓN DE ISIDORO MONTES DE OCA,068,JUNTA DE LOS RÍOS (LAS JUNTAS),3,77,35,42,6
GUERRERO,12,LA UNIÓN DE ISIDORO MONTES DE OCA,068,LA BARRANCA DE SAN MIGUEL,2,9,4,5,1
GUERRERO,12,LA UNIÓN DE ISIDORO MONTES DE OCA,068,LA CALERITA,1,6,6,0,1
GUERRERO,12,LA UNIÓN DE ISIDORO MONTES DE OCA,068,LA CIÉNEGA,1,5,2,3,1
GUERRERO,12,LA UNIÓN DE ISIDORO MONTES DE OCA,068,LA COFRADÍA,1,8,5,3,1
GUERRERO,12,LA UNIÓN DE ISIDORO MONTES DE OCA,068,LA COMPUERTA,3,40,23,17,4
GUERRERO,12,LA UNIÓN DE ISIDORO MONTES DE OCA,068,LA ESTANCIA,3,84,36,48,6
GUERRERO,12,LA UNIÓN DE ISIDORO MONTES DE OCA,068,LA HUERTA DE SANTA MARÍA,1,12,4,8,1
GUERRERO,12,LA UNIÓN DE ISIDORO MONTES DE OCA,068,LA MAJAHUA,2,42,25,17,3
GUERRERO,12,LA UNIÓN DE ISIDORO MONTES DE OCA,068,LA NORIA,3,43,19,24,4
GUERRERO,12,LA UNIÓN DE ISIDORO MONTES DE OCA,068,LA PAZ,1,14,6,8,1
GUERRERO,12,LA UNIÓN DE ISIDORO MONTES DE OCA,068,LA SALADA,1,25,12,13,2
GUERRERO,12,LA UNIÓN DE ISIDORO MONTES DE OCA,068,LA SALADITA,3,28,11,17,4
GUERRERO,12,LA UNIÓN DE ISIDORO MONTES DE OCA,068,LA UNIÓN,8,1173,608,565,89
GUERRERO,12,LA UNIÓN DE ISIDORO MONTES DE OCA,068,LA VILLITA,1,14,5,9,1
GUERRERO,12,LA UNIÓN DE ISIDORO MONTES DE OCA,068,LAGUNILLAS,4,269,127,142,16
GUERRERO,12,LA UNIÓN DE ISIDORO MONTES DE OCA,068,LAS HUERTAS,1,7,5,2,1
GUERRERO,12,LA UNIÓN DE ISIDORO MONTES DE OCA,068,LAS LAGUNAS,2,40,17,23,3
GUERRERO,12,LA UNIÓN DE ISIDORO MONTES DE OCA,068,LAS TINAJAS,2,54,26,28,4
GUERRERO,12,LA UNIÓN DE ISIDORO MONTES DE OCA,068,LOS CAJONES,1,12,2,10,1
GUERRERO,12,LA UNIÓN DE ISIDORO MONTES DE OCA,068,LOS LLANOS DE TEMALHUACÁN (LOS LLANOS),3,184,92,92,9
GUERRERO,12,LA UNIÓN DE ISIDORO MONTES DE OCA,068,MAGUEYES,1,24,12,12,2
GUERRERO,12,LA UNIÓN DE ISIDORO MONTES DE OCA,068,PETACALCO,8,899,439,460,56
GUERRERO,12,LA UNIÓN DE ISIDORO MONTES DE OCA,068,RAMAL DE CHUTLA (PASO DE CHUTLA),2,13,4,9,2
GUERRERO,12,LA UNIÓN DE ISIDORO MONTES DE OCA,068,RANCHO NUEVO,2,8,4,4,2
GUERRERO,12,LA UNIÓN DE ISIDORO MONTES DE OCA,068,RINCÓN DE CUCHARATEPEC,3,162,79,83,9
GUERRERO,12,LA UNIÓN DE ISIDORO MONTES DE OCA,068,SAN DIEGO,1,6,2,4,1
GUERRERO,12,LA UNIÓN DE ISIDORO MONTES DE OCA,068,SAN FRANCISCO,2,92,49,43,6
GUERRERO,12,LA UNIÓN DE ISIDORO MONTES DE OCA,068,SAN JERÓNIMO (LA CALIZA),2,33,18,15,3
GUERRERO,12,LA UNIÓN DE ISIDORO MONTES DE OCA,068,SURCUA,4,198,95,103,12
GUERRERO,12,LA UNIÓN DE ISIDORO MONTES DE OCA,068,TAMACUAS (EL RANCHITO),2,107,47,60,6
GUERRERO,12,LA UNIÓN DE ISIDORO MONTES DE OCA,068,TRONCONES (EMILIANO ZAPATA),3,243,120,123,11
GUERRERO,12,LA UNIÓN DE ISIDORO MONTES DE OCA,068,VALLECITOS DE SAN MIGUEL,1,4,3,1,1
GUERRERO,12,LA UNIÓN DE ISIDORO MONTES DE OCA,068,ZACATULA,4,401,188,213,21
GUERRERO,12,XALPATLÁHUAC,069,CAHUATACHE,9,470,236,234,30
GUERRERO,12,XALPATLÁHUAC,069,COLONIA AXOCHIAPAN,2,38,20,18,3
GUERRERO,12,XALPATLÁHUAC,069,CUBA LIBRE,3,185,97,88,12
GUERRERO,12,XALPATLÁHUAC,069,EL PLATANAR (SANTA MARÍA GUADALUPE EL PLATANAR),3,144,72,72,9
GUERRERO,12,XALPATLÁHUAC,069,IGUALITA,6,310,151,159,24
GUERRERO,12,XALPATLÁHUAC,069,LA VICTORIA (SAN MARTÍN LA VICTORIA),1,3,3,0,1
GUERRERO,12,XALPATLÁHUAC,069,QUIAHUITLATZALA,2,26,14,12,3
GUERRERO,12,XALPATLÁHUAC,069,SAN MARTÍN AMATITLÁN (AMATITLÁN),2,29,18,11,2
GUERRERO,12,XALPATLÁHUAC,069,SAN NICOLÁS ZOYATLÁN (ZOYATLÁN),5,270,131,139,13
GUERRERO,12,XALPATLÁHUAC,069,TLACOTLA,2,53,26,27,3
GUERRERO,12,XALPATLÁHUAC,069,TLAXCO,4,159,80,79,9
GUERRERO,12,XALPATLÁHUAC,069,TLAYAHUALCO,2,32,14,18,2
GUERRERO,12,XALPATLÁHUAC,069,XALPATLÁHUAC,8,1268,616,652,67
GUERRERO,12,XALPATLÁHUAC,069,XILOTEPEC (JILOTEPEC CHIQUITO),7,292,139,153,17
GUERRERO,12,XALPATLÁHUAC,069,YERBA SANTA,3,147,66,81,8
GUERRERO,12,XALPATLÁHUAC,069,ZACATIPA,3,152,67,85,9
GUERRERO,12,XOCHIHUEHUETLÁN,070,CACALUTLA,3,100,43,57,6
GUERRERO,12,XOCHIHUEHUETLÁN,070,HUEHUETECACINGO,2,22,12,10,2
GUERRERO,12,XOCHIHUEHUETLÁN,070,SAN MIGUEL COMITLIPA,4,239,108,131,18
GUERRERO,12,XOCHIHUEHUETLÁN,070,TEHUAXTITLÁN,2,47,32,15,3
GUERRERO,12,XOCHIHUEHUETLÁN,070,XIHUITLIPA,3,91,41,50,5
GUERRERO,12,XOCHIHUEHUETLÁN,070,XOCHIHUEHUETLÁN,9,1318,659,659,69
GUERRERO,12,XOCHIHUEHUETLÁN,070,ZOYATITLANAPA,1,18,12,6,1
GUERRERO,12,XOCHISTLAHUACA,071,ARROYO BLANQUILLO,2,29,10,19,3
GUERRERO,12,XOCHISTLAHUACA,071,ARROYO GENTE,3,188,107,81,11
GUERRERO,12,XOCHISTLAHUACA,071,ARROYO GRANDE,4,152,68,84,11
GUERRERO,12,XOCHISTLAHUACA,071,ARROYO GUACAMAYA UNO,2,52,20,32,3
GUERRERO,12,XOCHISTLAHUACA,071,ARROYO MONTAÑA,2,42,24,18,2
GUERRERO,12,XOCHISTLAHUACA,071,ARROYO PÁJARO,3,117,56,61,7
GUERRERO,12,XOCHISTLAHUACA,071,ARROYO PLATANAR,1,16,8,8,1
GUERRERO,12,XOCHISTLAHUACA,071,ARROYO SECO,2,21,14,7,2
GUERRERO,12,XOCHISTLAHUACA,071,ARROYO TOTOLE,1,11,7,4,1
GUERRERO,12,XOCHISTLAHUACA,071,CABEZA DE ARROYO CABALLO (ARROYO CABALLO),3,106,56,50,6
GUERRERO,12,XOCHISTLAHUACA,071,CABEZA DE ARROYO LAGARTO,2,7,3,4,1
GUERRERO,12,XOCHISTLAHUACA,071,CABEZA DE ARROYO NUEVO,3,137,61,76,10
GUERRERO,12,XOCHISTLAHUACA,071,CERRO BRONCO,3,84,45,39,6
GUERRERO,12,XOCHISTLAHUACA,071,CERRO CAJÓN,2,49,29,20,4
GUERRERO,12,XOCHISTLAHUACA,071,CERRO CENIZAS,1,5,4,1,1
GUERRERO,12,XOCHISTLAHUACA,071,CERRO DE PIEDRA REGADA,3,81,48,33,5
GUERRERO,12,XOCHISTLAHUACA,071,CERRO HENO,2,22,11,11,3
GUERRERO,12,XOCHISTLAHUACA,071,COLONIA CERRO NANCHE,2,31,16,15,2
GUERRERO,12,XOCHISTLAHUACA,071,COLONIA PROGRESO,1,4,4,0,1
GUERRERO,12,XOCHISTLAHUACA,071,COLONIA RENACIMIENTO,2,279,132,147,12
GUERRERO,12,XOCHISTLAHUACA,071,COLONIA SAN FRANCISCO,2,26,11,15,3
GUERRERO,12,XOCHISTLAHUACA,071,COZOYOAPÁN,8,1008,485,523,53
GUERRERO,12,XOCHISTLAHUACA,071,CRUCERO DE CAMINOS,1,11,5,6,1
GUERRERO,12,XOCHISTLAHUACA,071,CRUZ PODRIDA,2,93,46,47,5
GUERRERO,12,XOCHISTLAHUACA,071,CUMBRE DE SAN JOSÉ,3,96,44,52,7
GUERRERO,12,XOCHISTLAHUACA,071,EL CARMEN,4,327,165,162,22
GUERRERO,12,XOCHISTLAHUACA,071,EL SANTIAGO,3,179,104,75,11
GUERRERO,12,XOCHISTLAHUACA,071,GUADALUPE VICTORIA,7,746,381,365,43
GUERRERO,12,XOCHISTLAHUACA,071,JUAN ROCHA REYES,2,50,20,30,4
GUERRERO,12,XOCHISTLAHUACA,071,JUNTA DE ARROYO GRANDE,2,65,33,32,5
GUERRERO,12,XOCHISTLAHUACA,071,LA CIÉNEGA,2,61,30,31,3
GUERRERO,12,XOCHISTLAHUACA,071,LA SOLEDAD,3,389,203,186,16
GUERRERO,12,XOCHISTLAHUACA,071,LINDAVISTA,3,112,58,54,7
GUERRERO,12,XOCHISTLAHUACA,071,LLANO DEL CARMEN,3,134,67,67,8
GUERRERO,12,XOCHISTLAHUACA,071,LOMA DE PIEDRA AZUL,3,45,22,23,4
GUERRERO,12,XOCHISTLAHUACA,071,LOS LIROS,5,304,146,158,20
GUERRERO,12,XOCHISTLAHUACA,071,LUIS DONALDO COLOSIO MURRIETA,2,88,45,43,5
GUERRERO,12,XOCHISTLAHUACA,071,MANANTIAL MOJARRA,2,49,26,23,4
GUERRERO,12,XOCHISTLAHUACA,071,PAROTA QUEMADA,1,9,4,5,1
GUERRERO,12,XOCHISTLAHUACA,071,PIEDRA PESADA,1,10,5,5,1
GUERRERO,12,XOCHISTLAHUACA,071,PLAN DE ARROYO LIMÓN,1,30,17,13,2
GUERRERO,12,XOCHISTLAHUACA,071,PLAN DE GUADALUPE,3,68,38,30,5
GUERRERO,12,XOCHISTLAHUACA,071,PLAN DE LOS MUERTOS,3,195,102,93,11
GUERRERO,12,XOCHISTLAHUACA,071,PLAN DE PIERNA,3,251,122,129,11
GUERRERO,12,XOCHISTLAHUACA,071,PLAN LAGARTO,2,72,34,38,4
GUERRERO,12,XOCHISTLAHUACA,071,PLAN MAGUEY I,3,34,21,13,5
GUERRERO,12,XOCHISTLAHUACA,071,PLAN MAGUEY II,2,69,31,38,5
GUERRERO,12,XOCHISTLAHUACA,071,RANCHO BENIGNO LÓPEZ,1,23,9,14,1
GUERRERO,12,XOCHISTLAHUACA,071,RANCHO DEL CURA EJIDO,3,36,21,15,4
GUERRERO,12,XOCHISTLAHUACA,071,RANCHO DEL CURA TEJERÍA,3,110,57,53,9
GUERRERO,12,XOCHISTLAHUACA,071,SAN MIGUEL TEJALPAN,2,182,96,86,7
GUERRERO,12,XOCHISTLAHUACA,071,TIERRA COLORADA,2,35,20,15,3
GUERRERO,12,XOCHISTLAHUACA,071,XOCHISTLAHUACA,11,1313,708,605,67
GUERRERO,12,ZAPOTITLÁN TABLAS,072,AHUIXOTITLA,3,239,115,124,13
GUERRERO,12,ZAPOTITLÁN TABLAS,072,ALTEOPA,2,21,8,13,3
GUERRERO,12,ZAPOTITLÁN TABLAS,072,AYOTOXTLA,4,534,265,269,37
GUERRERO,12,ZAPOTITLÁN TABLAS,072,BARRANCA XOCO,2,13,6,7,2
GUERRERO,12,ZAPOTITLÁN TABLAS,072,CERRO VERDE,2,57,29,28,4
GUERRERO,12,ZAPOTITLÁN TABLAS,072,ESCALERILLA LAGUNAS,4,322,150,172,15
GUERRERO,12,ZAPOTITLÁN TABLAS,072,HUIZTLATZALA,3,160,75,85,9
GUERRERO,12,ZAPOTITLÁN TABLAS,072,IXTLAHUAZACA,3,104,56,48,5
GUERRERO,12,ZAPOTITLÁN TABLAS,072,LAGUNA MEMBRILLO,2,69,32,37,4
GUERRERO,12,ZAPOTITLÁN TABLAS,072,LLANO PERICÓN,2,66,37,29,3
GUERRERO,12,ZAPOTITLÁN TABLAS,072,PIEDRA ANCHA,2,19,7,12,3
GUERRERO,12,ZAPOTITLÁN TABLAS,072,PIEDRA PINTA,3,49,27,22,5
GUERRERO,12,ZAPOTITLÁN TABLAS,072,PLAN DE INGERTO,2,42,25,17,3
GUERRERO,12,ZAPOTITLÁN TABLAS,072,RÍO SAN MARCOS,2,58,22,36,3
GUERRERO,12,ZAPOTITLÁN TABLAS,072,SAN AGUSTÍN,3,52,29,23,5
GUERRERO,12,ZAPOTITLÁN TABLAS,072,SAN JUAN,1,43,27,16,2
GUERRERO,12,ZAPOTITLÁN TABLAS,072,SAN MIGUEL CUIXAPA CENTRO,2,34,22,12,2
GUERRERO,12,ZAPOTITLÁN TABLAS,072,SAN MIGUEL CUIXAPA NORTE,2,103,55,48,6
GUERRERO,12,ZAPOTITLÁN TABLAS,072,SANTA ROSA DE LIMA,1,24,8,16,1
GUERRERO,12,ZAPOTITLÁN TABLAS,072,TAMALOYA,3,203,97,106,12
GUERRERO,12,ZAPOTITLÁN TABLAS,072,TIERRA COLORADA,1,34,19,15,3
GUERRERO,12,ZAPOTITLÁN TABLAS,072,TRES LAGUNAS,2,37,17,20,3
GUERRERO,12,ZAPOTITLÁN TABLAS,072,VILLA DE GUADALUPE,1,30,18,12,1
GUERRERO,12,ZAPOTITLÁN TABLAS,072,XOCOAPANCINGO,2,24,9,15,2
GUERRERO,12,ZAPOTITLÁN TABLAS,072,ZAPOTITLÁN TABLAS,5,706,343,363,46
GUERRERO,12,ZIRÁNDARO,073,ALITA,1,10,4,6,2
GUERRERO,12,ZIRÁNDARO,073,ARATICHANGUIO,6,471,235,236,26
GUERRERO,12,ZIRÁNDARO,073,CARACHURIO (CARACHURIO EL NUEVO),4,151,73,78,10
GUERRERO,12,ZIRÁNDARO,073,CATZÚNDARO,2,20,12,8,2
GUERRERO,12,ZIRÁNDARO,073,CAYUNCHA,1,11,2,9,1
GUERRERO,12,ZIRÁNDARO,073,CIRIQUICHO,3,47,21,26,5
GUERRERO,12,ZIRÁNDARO,073,CUAHULOTE,1,9,3,6,1
GUERRERO,12,ZIRÁNDARO,073,CUAMBIO,2,24,12,12,3
GUERRERO,12,ZIRÁNDARO,073,CUPUÁN,4,132,70,62,8
GUERRERO,12,ZIRÁNDARO,073,EL AGUACATE,2,11,4,7,1
GUERRERO,12,ZIRÁNDARO,073,EL CHIVO,2,33,18,15,2
GUERRERO,12,ZIRÁNDARO,073,EL COCO,2,32,19,13,3
GUERRERO,12,ZIRÁNDARO,073,EL CUITAZ,3,126,62,64,8
GUERRERO,12,ZIRÁNDARO,073,EL LUVIANO,2,27,12,15,2
GUERRERO,12,ZIRÁNDARO,073,EL NARANJO,2,19,6,13,2
GUERRERO,12,ZIRÁNDARO,073,EL PINO,3,71,35,36,5
GUERRERO,12,ZIRÁNDARO,073,EL RANCHITO,2,7,4,3,1
GUERRERO,12,ZIRÁNDARO,073,EL REPARO,3,32,17,15,4
GUERRERO,12,ZIRÁNDARO,073,ENRAMADAS,1,11,6,5,1
GUERRERO,12,ZIRÁNDARO,073,GUAYAMEO,5,464,228,236,26
GUERRERO,12,ZIRÁNDARO,073,HACIENDA VIEJA,2,95,43,52,6
GUERRERO,12,ZIRÁNDARO,073,HUANUMO,1,7,5,2,1
GUERRERO,12,ZIRÁNDARO,073,HUITZÁTARO,3,32,15,17,5
GUERRERO,12,ZIRÁNDARO,073,LA CALERA,2,73,36,37,5
GUERRERO,12,ZIRÁNDARO,073,LA CALERA (LA CALERA VERTIDOR),1,87,39,48,5
GUERRERO,12,ZIRÁNDARO,073,LA CIÉNEGA,1,5,2,3,1
GUERRERO,12,ZIRÁNDARO,073,LA MESA,1,6,2,4,1
GUERRERO,12,ZIRÁNDARO,073,LA PAROTA,3,119,53,66,8
GUERRERO,12,ZIRÁNDARO,073,LA PAROTA DEL CUARTEL,1,11,6,5,1
GUERRERO,12,ZIRÁNDARO,073,LA PILA HONDA (LA PILA),2,10,4,6,2
GUERRERO,12,ZIRÁNDARO,073,LA QUIRINGUCUA,2,43,22,21,3
GUERRERO,12,ZIRÁNDARO,073,LA TASAJERA,2,68,32,36,5
GUERRERO,12,ZIRÁNDARO,073,LAS COLONIAS,3,40,21,19,4
GUERRERO,12,ZIRÁNDARO,073,LAS GUACAMAYAS,1,24,9,15,1
GUERRERO,12,ZIRÁNDARO,073,LAS HUMEDADES (LA HUMEDAD),2,28,14,14,2
GUERRERO,12,ZIRÁNDARO,073,LAS JUNTAS DE CUJARÁN (LAS JUNTAS),1,27,12,15,2
GUERRERO,12,ZIRÁNDARO,073,LAS PILAS,2,4,2,2,1
GUERRERO,12,ZIRÁNDARO,073,LOS ALACRANES,2,18,9,9,2
GUERRERO,12,ZIRÁNDARO,073,LOS BANCOS,2,10,3,7,1
GUERRERO,12,ZIRÁNDARO,073,LOS CIMIENTOS,3,56,23,33,4
GUERRERO,12,ZIRÁNDARO,073,PALMA SOLA,1,6,4,2,1
GUERRERO,12,ZIRÁNDARO,073,PANDACUAREO,2,21,9,12,3
GUERRERO,12,ZIRÁNDARO,073,PASO SECO,3,20,12,8,3
GUERRERO,12,ZIRÁNDARO,073,PUEBLO VIEJO,2,6,2,4,1
GUERRERO,12,ZIRÁNDARO,073,RINCÓN DE LAS CEIBAS,2,6,3,3,2
GUERRERO,12,ZIRÁNDARO,073,SAN ANTONIO,3,84,47,37,6
GUERRERO,12,ZIRÁNDARO,073,SAN JOSÉ DEL PILÓN,4,79,45,34,8
GUERRERO,12,ZIRÁNDARO,073,SAN RAFAEL,4,124,58,66,11
GUERRERO,12,ZIRÁNDARO,073,TIMÓN (EL TIMÓN CAÍDO),2,13,9,4,1
GUERRERO,12,ZIRÁNDARO,073,ZIRÁNDARO DE LOS CHÁVEZ,6,1064,559,505,52
GUERRERO,12,ZIRÁNDARO,073,ZIRITZÍCUARO,2,51,24,27,3
GUERRERO,12,ZITLALA,074,AYOTZINAPA,2,143,66,77,8
GUERRERO,12,ZITLALA,074,AZOACAPA,2,52,27,25,4
GUERRERO,12,ZITLALA,074,AZTILLERO,2,95,55,40,5
GUERRERO,12,ZITLALA,074,COACOYUL,3,58,24,34,4
GUERRERO,12,ZITLALA,074,COYOACÁN,2,44,17,27,3
GUERRERO,12,ZITLALA,074,CUAPEXCO,2,59,28,31,3
GUERRERO,12,ZITLALA,074,HUIXCOMULCO,2,49,23,26,3
GUERRERO,12,ZITLALA,074,IXCATLA,2,78,34,44,4
GUERRERO,12,ZITLALA,074,LAS TRANCAS,3,198,98,100,12
GUERRERO,12,ZITLALA,074,LLANO GRANDE,2,9,4,5,2
GUERRERO,12,ZITLALA,074,MAZATEPEC,1,32,15,17,2
GUERRERO,12,ZITLALA,074,OCOTITLÁN,4,144,63,81,11
GUERRERO,12,ZITLALA,074,POCHAHUIZCO,10,770,371,399,46
GUERRERO,12,ZITLALA,074,QUETZALCOATLÁN DE LAS PALMAS,1,2,0,2,1
GUERRERO,12,ZITLALA,074,RANCHO DE LAS LOMAS,6,460,215,245,27
GUERRERO,12,ZITLALA,074,SAN MARCOS DE LAS ROSAS,4,110,67,43,11
GUERRERO,12,ZITLALA,074,TETEYITIC (TETEHITIC),1,4,2,2,1
GUERRERO,12,ZITLALA,074,TEYAPAN,2,68,36,32,5
GUERRERO,12,ZITLALA,074,TLALTEMPANAPA,4,183,97,86,12
GUERRERO,12,ZITLALA,074,TLAPEHUALAPA,2,87,47,40,4
GUERRERO,12,ZITLALA,074,TONALAPA,2,40,13,27,4
GUERRERO,12,ZITLALA,074,TOPILTEPEC,8,922,457,465,53
GUERRERO,12,ZITLALA,074,VIRAMONTES,2,77,42,35,6
GUERRERO,12,ZITLALA,074,YETLANCINGO,2,336,164,172,14
GUERRERO,12,ZITLALA,074,ZITLALA,13,1619,806,813,98
GUERRERO,12,EDUARDO NERI,075,AHUELICÁN,3,105,49,56,8
GUERRERO,12,EDUARDO NERI,075,AMATITLÁN,3,300,147,153,13
GUERRERO,12,EDUARDO NERI,075,AMEYALTEPEC,3,208,106,102,12
GUERRERO,12,EDUARDO NERI,075,AXAXACUALCO,4,343,175,168,21
GUERRERO,12,EDUARDO NERI,075,CARRIZALILLO,4,621,310,311,27
GUERRERO,12,EDUARDO NERI,075,EL MIRAVAL,3,93,44,49,7
GUERRERO,12,EDUARDO NERI,075,EL PALMAR,4,234,102,132,14
GUERRERO,12,EDUARDO NERI,075,EL PLATANAL,1,5,1,4,1
GUERRERO,12,EDUARDO NERI,075,HUITZILTEPEC,9,1013,522,491,54
GUERRERO,12,EDUARDO NERI,075,JALAPA,2,59,39,20,5
GUERRERO,12,EDUARDO NERI,075,LA LAGUNA,3,73,34,39,5
GUERRERO,12,EDUARDO NERI,075,LA PRIMAVERA [FRACCIONAMIENTO],2,44,19,25,5
GUERRERO,12,EDUARDO NERI,075,MAZAPA,3,112,52,60,8
GUERRERO,12,EDUARDO NERI,075,MEZCALA,7,1772,854,918,70
GUERRERO,12,EDUARDO NERI,075,NUEVO BALZAMAR,1,60,35,25,3
GUERRERO,12,EDUARDO NERI,075,PAPALOTEPEC,3,113,50,63,7
GUERRERO,12,EDUARDO NERI,075,PLAN DE LAS LIEBRES,2,43,21,22,4
GUERRERO,12,EDUARDO NERI,075,SAN MIGUEL VISTA HERMOSA,3,32,16,16,3
GUERRERO,12,EDUARDO NERI,075,TENANTLA,3,95,44,51,4
GUERRERO,12,EDUARDO NERI,075,TEPEHUAJE,3,95,52,43,5
GUERRERO,12,EDUARDO NERI,075,TLANIPATLA,6,494,236,258,28
GUERRERO,12,EDUARDO NERI,075,VENTA VIEJA,1,9,7,2,1
GUERRERO,12,EDUARDO NERI,075,XOCHIPALA,6,869,420,449,41
GUERRERO,12,EDUARDO NERI,075,ZUMPANGO DEL RÍO,40,7592,3734,3858,405
GUERRERO,12,ACATEPEC,076,ACATEPEC,4,1033,522,511,50
GUERRERO,12,ACATEPEC,076,AGUA FRÍA,2,26,15,11,3
GUERRERO,12,ACATEPEC,076,AGUA TOMAGUA,2,77,42,35,4
GUERRERO,12,ACATEPEC,076,AGUA TORDILLO,4,322,147,175,26
GUERRERO,12,ACATEPEC,076,AGUA XOCO,3,219,94,125,11
GUERRERO,12,ACATEPEC,076,ALCAMANI,3,188,112,76,11
GUERRERO,12,ACATEPEC,076,APETZUCA,4,303,154,149,18
GUERRERO,12,ACATEPEC,076,BARRANCA BEJUCO,3,89,40,49,5
GUERRERO,12,ACATEPEC,076,BARRANCA DULCE,3,278,140,138,12
GUERRERO,12,ACATEPEC,076,BARRANCA MINA,2,100,54,46,8
GUERRERO,12,ACATEPEC,076,BARRANCA PIÑA,3,149,77,72,8
GUERRERO,12,ACATEPEC,076,BARRANCA POBRE,4,598,305,293,26
GUERRERO,12,ACATEPEC,076,BARRANCA XOCO,2,28,17,11,2
GUERRERO,12,ACATEPEC,076,BARRIO NUEVO-LOMA MACHO,2,34,15,19,3
GUERRERO,12,ACATEPEC,076,BUENAVISTA,3,121,63,58,7
GUERRERO,12,ACATEPEC,076,CAXITEPEC,5,514,244,270,23
GUERRERO,12,ACATEPEC,076,CERRO EL MAGUEY,2,55,22,33,3
GUERRERO,12,ACATEPEC,076,CERRO PELÓN,4,235,124,111,15
GUERRERO,12,ACATEPEC,076,CERRO TIGRE (CERRO DEL TIGRE),3,123,65,58,7
GUERRERO,12,ACATEPEC,076,CIÉNEGA DEL SAUCE,1,42,25,17,2
GUERRERO,12,ACATEPEC,076,COLONIA CRUZ ALTA,2,69,34,35,4
GUERRERO,12,ACATEPEC,076,COLONIA LA ANTENA,2,14,6,8,2
GUERRERO,12,ACATEPEC,076,COLONIA LOS PINOS,1,3,2,1,0
GUERRERO,12,ACATEPEC,076,COLONIA OCOTE CAPULÍN,2,42,19,23,3
GUERRERO,12,ACATEPEC,076,COLONIA PLAN DE AYALA,3,112,56,56,6
GUERRERO,12,ACATEPEC,076,COLONIA PROGRESO (CERRO GAVILÁN),2,60,30,30,4
GUERRERO,12,ACATEPEC,076,COLONIA SANTA ROSA,1,37,13,24,2
GUERRERO,12,ACATEPEC,076,COLONIA TEPEHUAJE,3,77,38,39,5
GUERRERO,12,ACATEPEC,076,COLONIA YERBA BUENA,2,60,33,27,4
GUERRERO,12,ACATEPEC,076,CUIXINIPA,4,212,96,116,10
GUERRERO,12,ACATEPEC,076,EL AGUACATE,4,398,207,191,17
GUERRERO,12,ACATEPEC,076,EL CAPULÍN,4,257,127,130,14
GUERRERO,12,ACATEPEC,076,EL CHIRIMOYO,3,183,88,95,11
GUERRERO,12,ACATEPEC,076,EL FUEREÑO,3,70,33,37,4
GUERRERO,12,ACATEPEC,076,EL IZOTE (LAGUNA SECA),2,169,80,89,9
GUERRERO,12,ACATEPEC,076,EL LLANO,4,286,142,144,13
GUERRERO,12,ACATEPEC,076,EL MIRADOR,3,200,103,97,9
GUERRERO,12,ACATEPEC,076,EL NARANJO,2,136,68,68,7
GUERRERO,12,ACATEPEC,076,EL PORTEZUELO,3,63,33,30,7
GUERRERO,12,ACATEPEC,076,EL RINCÓN DE LOS PINOS,2,17,5,12,2
GUERRERO,12,ACATEPEC,076,EL TEJOCOTE,4,275,140,135,17
GUERRERO,12,ACATEPEC,076,ESCALERILLA ZAPATA,4,541,262,279,31
GUERRERO,12,ACATEPEC,076,FLOR DE PASCUA,2,22,12,10,2
GUERRERO,12,ACATEPEC,076,HUIXTLAZALA,2,68,34,34,3
GUERRERO,12,ACATEPEC,076,IXTLAHUATEPEC,2,20,12,8,2
GUERRERO,12,ACATEPEC,076,LAGUNA SECA,1,58,32,26,4
GUERRERO,12,ACATEPEC,076,LÁZARO CÁRDENAS,2,28,10,18,2
GUERRERO,12,ACATEPEC,076,LLANO DE LA PAROTA,3,97,49,48,6
GUERRERO,12,ACATEPEC,076,LLANO DEL LIMÓN,2,22,13,9,3
GUERRERO,12,ACATEPEC,076,LLANO GRANDE,3,174,89,85,9
GUERRERO,12,ACATEPEC,076,LLANO MAIZAL,3,25,16,9,3
GUERRERO,12,ACATEPEC,076,LOMA BONITA (EL CAMPAMENTO),2,59,32,27,4
GUERRERO,12,ACATEPEC,076,LOMA DE LA SILLA,2,79,39,40,5
GUERRERO,12,ACATEPEC,076,LOMA MACHO,2,58,30,28,3
GUERRERO,12,ACATEPEC,076,LOMA MAGUEY,2,111,61,50,7
GUERRERO,12,ACATEPEC,076,LOMA TUZA,3,206,94,112,11
GUERRERO,12,ACATEPEC,076,LOMADAD,3,42,17,25,5
GUERRERO,12,ACATEPEC,076,LOMATEPEC,3,173,83,90,10
GUERRERO,12,ACATEPEC,076,MEXCALAPA,3,155,78,77,7
GUERRERO,12,ACATEPEC,076,MEXCALTEPEC,4,452,220,232,25
GUERRERO,12,ACATEPEC,076,MEXCALTEPEC VIEJO,1,5,4,1,1
GUERRERO,12,ACATEPEC,076,MONTE HOREB,3,85,44,41,8
GUERRERO,12,ACATEPEC,076,OJO DE AGUA,2,31,12,19,2
GUERRERO,12,ACATEPEC,076,PLAN DE SAN MARCOS,3,113,59,54,8
GUERRERO,12,ACATEPEC,076,PLAN OJO DE AGUA,2,48,14,34,3
GUERRERO,12,ACATEPEC,076,PLAN RANCHITO,3,92,35,57,5
GUERRERO,12,ACATEPEC,076,PLAN VERDE,3,33,11,22,3
GUERRERO,12,ACATEPEC,076,POZOLAPA,2,58,28,30,3
GUERRERO,12,ACATEPEC,076,PUERTO BUENAVISTA,2,97,52,45,7
GUERRERO,12,ACATEPEC,076,RÍO AZUL,2,173,92,81,9
GUERRERO,12,ACATEPEC,076,RÍO DE HACIENDA,3,108,48,60,5
GUERRERO,12,ACATEPEC,076,RÍO GRANDE,3,37,17,20,4
GUERRERO,12,ACATEPEC,076,SAN JUAN DE LOS PINOS,2,72,37,35,3
GUERRERO,12,ACATEPEC,076,SAN MARCOS YERBA SANTA,2,110,49,61,6
GUERRERO,12,ACATEPEC,076,SANTA ROSA,1,16,5,11,1
GUERRERO,12,ACATEPEC,076,TIERRA BLANCA,4,494,248,246,21
GUERRERO,12,ACATEPEC,076,TIERRA COLORADA,2,98,53,45,5
GUERRERO,12,ACATEPEC,076,TRES CRUCES,3,312,155,157,18
GUERRERO,12,ACATEPEC,076,VILLA DE LAS FLORES,2,60,30,30,4
GUERRERO,12,ACATEPEC,076,VILLA GUADALUPE,2,42,22,20,3
GUERRERO,12,ACATEPEC,076,VISTA HERMOSA,3,41,20,21,4
GUERRERO,12,ACATEPEC,076,XILOTLANCINGO,4,210,99,111,14
GUERRERO,12,ACATEPEC,076,XOCHITEPEC,4,253,120,133,17
GUERRERO,12,ACATEPEC,076,YERBA SANTA,4,504,257,247,20
GUERRERO,12,ACATEPEC,076,ZILACAYOTA,3,244,133,111,11
GUERRERO,12,ACATEPEC,076,ZONTECOMAPA,4,328,157,171,20
GUERRERO,12,MARQUELIA,077,BARRA DE TECOANAPA,5,932,561,371,55
GUERRERO,12,MARQUELIA,077,CRUZ VERDE,2,24,12,12,3
GUERRERO,12,MARQUELIA,077,EL CAPULÍN CHOCOLATE,3,116,53,63,8
GUERRERO,12,MARQUELIA,077,EL ZAPOTE,2,14,8,6,2
GUERRERO,12,MARQUELIA,077,LA CENIZA (LOMA DE ROMERO),3,101,44,57,7
GUERRERO,12,MARQUELIA,077,LA GUADALUPE,2,78,45,33,6
GUERRERO,12,MARQUELIA,077,MARQUELIA,16,3318,1630,1688,185
GUERRERO,12,MARQUELIA,077,TEPANTITLÁN,3,84,37,47,8
GUERRERO,12,MARQUELIA,077,ZOYATLÁN,4,274,140,134,20
GUERRERO,12,COCHOAPA EL GRANDE,078,ARROYO PRIETO,4,350,178,172,16
GUERRERO,12,COCHOAPA EL GRANDE,078,BARRANCA DE LA PALMA,2,127,61,66,6
GUERRERO,12,COCHOAPA EL GRANDE,078,BARRANCA OCOTERA,1,20,9,11,2
GUERRERO,12,COCHOAPA EL GRANDE,078,BARRIO DEL CARMEN,2,24,8,16,2
GUERRERO,12,COCHOAPA EL GRANDE,078,CAHUAÑAÑA,4,166,87,79,10
GUERRERO,12,COCHOAPA EL GRANDE,078,CALPANAPA VIEJO,3,219,110,109,9
GUERRERO,12,COCHOAPA EL GRANDE,078,CASCADA DEL ZORRO,2,47,21,26,3
GUERRERO,12,COCHOAPA EL GRANDE,078,CIENEGUILLA,1,66,30,36,3
GUERRERO,12,COCHOAPA EL GRANDE,078,COCHOAPA EL GRANDE,9,1617,815,802,59
GUERRERO,12,COCHOAPA EL GRANDE,078,COLONIA BELÉN,1,27,17,10,1
GUERRERO,12,COCHOAPA EL GRANDE,078,COLONIA CHILPANCINGUITO DE LOS LIBRES,1,8,3,5,1
GUERRERO,12,COCHOAPA EL GRANDE,078,COLONIA NATIVIDAD,1,7,3,4,1
GUERRERO,12,COCHOAPA EL GRANDE,078,CUETZALA UNIÓN,2,5,4,1,1
GUERRERO,12,COCHOAPA EL GRANDE,078,DIVINO PASTOR,1,12,6,6,1
GUERRERO,12,COCHOAPA EL GRANDE,078,DOS RÍOS,3,187,83,104,9
GUERRERO,12,COCHOAPA EL GRANDE,078,EL CIRUELO,1,26,12,14,1
GUERRERO,12,COCHOAPA EL GRANDE,078,EL COYUL,3,392,208,184,18
GUERRERO,12,COCHOAPA EL GRANDE,078,EL NARANJO,1,4,1,3,1
GUERRERO,12,COCHOAPA EL GRANDE,078,GUADALUPE LA JOYA,2,63,32,31,3
GUERRERO,12,COCHOAPA EL GRANDE,078,ITIA MINIÑU UN,2,44,22,22,2
GUERRERO,12,COCHOAPA EL GRANDE,078,ITIATIO,1,39,25,14,2
GUERRERO,12,COCHOAPA EL GRANDE,078,JOYA REAL,3,290,142,148,12
GUERRERO,12,COCHOAPA EL GRANDE,078,LA BARCA,3,103,48,55,7
GUERRERO,12,COCHOAPA EL GRANDE,078,LA JOYA DE ORO,1,8,3,5,1
GUERRERO,12,COCHOAPA EL GRANDE,078,LÁZARO CÁRDENAS,1,16,6,10,1
GUERRERO,12,COCHOAPA EL GRANDE,078,LLANO DE LA CHUPARROSA,2,70,37,33,4
GUERRERO,12,COCHOAPA EL GRANDE,078,LLANO DE LA MOSCA,1,13,5,8,2
GUERRERO,12,COCHOAPA EL GRANDE,078,LLANO DE LA YACUA,2,42,16,26,3
GUERRERO,12,COCHOAPA EL GRANDE,078,LLANO DEL CARMEN,1,83,38,45,2
GUERRERO,12,COCHOAPA EL GRANDE,078,LLANO PERDIDO,2,179,91,88,6
GUERRERO,12,COCHOAPA EL GRANDE,078,LLANO ZACATERO,2,32,16,16,2
GUERRERO,12,COCHOAPA EL GRANDE,078,LOMA ARENAL,2,9,5,4,2
GUERRERO,12,COCHOAPA EL GRANDE,078,LOMA CANOA,2,62,31,31,4
GUERRERO,12,COCHOAPA EL GRANDE,078,LOMA GRANDE,2,37,15,22,4
GUERRERO,12,COCHOAPA EL GRANDE,078,LOMA SAN MARCOS,1,39,19,20,2
GUERRERO,12,COCHOAPA EL GRANDE,078,LOS PINOS,2,265,127,138,11
GUERRERO,12,COCHOAPA EL GRANDE,078,OCOTEPEC,2,103,51,52,4
GUERRERO,12,COCHOAPA EL GRANDE,078,PEÑA DE VENADO,2,60,26,34,3
GUERRERO,12,COCHOAPA EL GRANDE,078,PIEDRA NEGRA,1,24,16,8,1
GUERRERO,12,COCHOAPA EL GRANDE,078,PLAN BUENAVISTA,1,15,9,6,1
GUERRERO,12,COCHOAPA EL GRANDE,078,RANCHO DE GUADALUPE (BARRANCA POBRE),1,12,6,6,2
GUERRERO,12,COCHOAPA EL GRANDE,078,RANCHO DE LOS HILARIOS,1,32,17,15,1
GUERRERO,12,COCHOAPA EL GRANDE,078,RANCHO SAN MARTÍN,2,53,26,27,3
GUERRERO,12,COCHOAPA EL GRANDE,078,RÍO CANTADOR CHIQUITO,1,18,10,8,1
GUERRERO,12,COCHOAPA EL GRANDE,078,RÍO CORAZÓN,2,10,5,5,1
GUERRERO,12,COCHOAPA EL GRANDE,078,RÍO ENCAJONADO,3,348,170,178,15
GUERRERO,12,COCHOAPA EL GRANDE,078,RÍO HAMACA,2,52,28,24,3
GUERRERO,12,COCHOAPA EL GRANDE,078,SAN AGUSTÍN EL VIEJO,4,87,46,41,5
GUERRERO,12,COCHOAPA EL GRANDE,078,SAN CRISTOBALITO,2,52,29,23,3
GUERRERO,12,COCHOAPA EL GRANDE,078,SAN LUCAS,2,26,8,18,3
GUERRERO,12,COCHOAPA EL GRANDE,078,SAN MIGUEL AMOLTEPEC NUEVO,2,95,34,61,4
GUERRERO,12,COCHOAPA EL GRANDE,078,SAN MIGUEL AMOLTEPEC VIEJO,3,117,54,63,8
GUERRERO,12,COCHOAPA EL GRANDE,078,SAN PEDRO EL VIEJO,2,62,35,27,4
GUERRERO,12,COCHOAPA EL GRANDE,078,SAN RAFAEL,3,224,111,113,13
GUERRERO,12,COCHOAPA EL GRANDE,078,SAN RAFAEL NUEVO,1,19,11,8,1
GUERRERO,12,COCHOAPA EL GRANDE,078,SANTA CRUZ,2,22,14,8,2
GUERRERO,12,COCHOAPA EL GRANDE,078,SANTA MARÍA CAHUAÑAÑA,1,28,15,13,1
GUERRERO,12,COCHOAPA EL GRANDE,078,TIERRA BLANCA,3,87,42,45,5
GUERRERO,12,COCHOAPA EL GRANDE,078,TIERRA BLANQUITA,2,32,17,15,3
GUERRERO,12,COCHOAPA EL GRANDE,078,TIERRA CAMPESINA,1,21,13,8,2
GUERRERO,12,COCHOAPA EL GRANDE,078,TIERRA DE ALGODÓN,2,9,4,5,2
GUERRERO,12,COCHOAPA EL GRANDE,078,VISTA HERMOSA,2,66,32,34,4
GUERRERO,12,COCHOAPA EL GRANDE,078,XAHA YUCU YAA,1,20,11,9,1
GUERRERO,12,COCHOAPA EL GRANDE,078,XALPA,2,78,43,35,5
GUERRERO,12,COCHOAPA EL GRANDE,078,YOZO CHUN CHIQUITO,1,25,14,11,2
GUERRERO,12,COCHOAPA EL GRANDE,078,YOZONDACUA,3,152,81,71,6
GUERRERO,12,COCHOAPA EL GRANDE,078,YUKU NU KAXIN,2,46,23,23,3
GUERRERO,12,COCHOAPA EL GRANDE,078,YUVI CHONU,1,22,13,9,1
GUERRERO,12,COCHOAPA EL GRANDE,078,YUVICANI,2,87,40,47,4
GUERRERO,12,JOSÉ JOAQUÍN DE HERRERA,079,ACALCO,1,22,12,10,1
GUERRERO,12,JOSÉ JOAQUÍN DE HERRERA,079,AJACAYÁN ORIENTE,3,157,71,86,7
GUERRERO,12,JOSÉ JOAQUÍN DE HERRERA,079,AMATITLÁN,2,12,8,4,3
GUERRERO,12,JOSÉ JOAQUÍN DE HERRERA,079,APANGUITO,3,284,138,146,12
GUERRERO,12,JOSÉ JOAQUÍN DE HERRERA,079,APOZONALCO,3,253,117,136,13
GUERRERO,12,JOSÉ JOAQUÍN DE HERRERA,079,ATEMPA ORIENTE,1,4,1,3,1
GUERRERO,12,JOSÉ JOAQUÍN DE HERRERA,079,AXOLOAPA,2,61,34,27,4
GUERRERO,12,JOSÉ JOAQUÍN DE HERRERA,079,AYAHUALTEMPA,4,238,117,121,14
GUERRERO,12,JOSÉ JOAQUÍN DE HERRERA,079,BUENA VISTA DE LOS AIRES,2,82,43,39,4
GUERRERO,12,JOSÉ JOAQUÍN DE HERRERA,079,CACAHUATEPEC,2,280,119,161,14
GUERRERO,12,JOSÉ JOAQUÍN DE HERRERA,079,CACAHUATLA,2,131,62,69,8
GUERRERO,12,JOSÉ JOAQUÍN DE HERRERA,079,CACALOTEPEC,4,149,86,63,8
GUERRERO,12,JOSÉ JOAQUÍN DE HERRERA,079,CHAHUIXCO,2,24,15,9,3
GUERRERO,12,JOSÉ JOAQUÍN DE HERRERA,079,CUITLANISTEPEC,3,43,25,18,5
GUERRERO,12,JOSÉ JOAQUÍN DE HERRERA,079,DOSPAÑOS,2,16,6,10,2
GUERRERO,12,JOSÉ JOAQUÍN DE HERRERA,079,EL BÁRZAMO,2,24,12,12,2
GUERRERO,12,JOSÉ JOAQUÍN DE HERRERA,079,EL CARACOL,2,32,10,22,3
GUERRERO,12,JOSÉ JOAQUÍN DE HERRERA,079,HUEYCANTENANGO,7,589,286,303,36
GUERRERO,12,JOSÉ JOAQUÍN DE HERRERA,079,IXCATLA,4,504,265,239,23
GUERRERO,12,JOSÉ JOAQUÍN DE HERRERA,079,IXTLÁHUAC,3,51,25,26,4
GUERRERO,12,JOSÉ JOAQUÍN DE HERRERA,079,JUQUILITA,2,38,20,18,3
GUERRERO,12,JOSÉ JOAQUÍN DE HERRERA,079,LA LAGUNA,1,201,106,95,9
GUERRERO,12,JOSÉ JOAQUÍN DE HERRERA,079,MAZAZONTECOMAC,3,190,103,87,8
GUERRERO,12,JOSÉ JOAQUÍN DE HERRERA,079,OCOTITOS LL,2,18,9,9,2
GUERRERO,12,JOSÉ JOAQUÍN DE HERRERA,079,OZTOTITLÁN,2,76,43,33,4
GUERRERO,12,JOSÉ JOAQUÍN DE HERRERA,079,PUENTE IXTLA,2,7,4,3,1
GUERRERO,12,JOSÉ JOAQUÍN DE HERRERA,079,QUETZALAPA,2,93,47,46,4
GUERRERO,12,JOSÉ JOAQUÍN DE HERRERA,079,SAN MARCOS IXTLÁHUAC,2,133,63,70,7
GUERRERO,12,JOSÉ JOAQUÍN DE HERRERA,079,TEMIXCO,2,60,25,35,5
GUERRERO,12,JOSÉ JOAQUÍN DE HERRERA,079,TEOCALIXTLAHUACÁN,2,21,12,9,2
GUERRERO,12,JOSÉ JOAQUÍN DE HERRERA,079,TEPETITLÁN,2,39,16,23,5
GUERRERO,12,JOSÉ JOAQUÍN DE HERRERA,079,TEPOZCOTLALOCA,2,19,11,8,2
GUERRERO,12,JOSÉ JOAQUÍN DE HERRERA,079,TEQUIXCA,2,62,30,32,4
GUERRERO,12,JOSÉ JOAQUÍN DE HERRERA,079,TLACHIMALTEPEC,4,466,256,210,20
GUERRERO,12,JOSÉ JOAQUÍN DE HERRERA,079,TLACOAPA,2,64,32,32,4
GUERRERO,12,JOSÉ JOAQUÍN DE HERRERA,079,TLAIXCOATIPAN,1,6,4,2,1
GUERRERO,12,JOSÉ JOAQUÍN DE HERRERA,079,TLALCHICHILTIPÁN,2,204,99,105,8
GUERRERO,12,JOSÉ JOAQUÍN DE HERRERA,079,TLALCHICHILTIPÁN NUEVO,2,135,64,71,8
GUERRERO,12,JOSÉ JOAQUÍN DE HERRERA,079,TLALOJCAN,2,23,15,8,2
GUERRERO,12,JOSÉ JOAQUÍN DE HERRERA,079,TLATLAJQUITEPEC,2,77,30,47,6
GUERRERO,12,JOSÉ JOAQUÍN DE HERRERA,079,TLAYOLAPA,2,10,7,3,2
GUERRERO,12,JOSÉ JOAQUÍN DE HERRERA,079,TOCTEPEC,2,23,15,8,3
GUERRERO,12,JOSÉ JOAQUÍN DE HERRERA,079,TOMACTILICÁN,4,437,217,220,21
GUERRERO,12,JOSÉ JOAQUÍN DE HERRERA,079,ZACAIXTLAHUACÁN,1,15,6,9,1
GUERRERO,12,JOSÉ JOAQUÍN DE HERRERA,079,ZINTIOTITLÁN,2,28,21,7,2
GUERRERO,12,JOSÉ JOAQUÍN DE HERRERA,079,ZOMPANTITLÁN,2,84,32,52,5
GUERRERO,12,JUCHITÁN,080,AGUA ZARCA,3,216,91,125,12
GUERRERO,12,JUCHITÁN,080,BARRIO NUEVO,2,26,17,9,2
GUERRERO,12,JUCHITÁN,080,CARRIZALILLO,4,145,66,79,14
GUERRERO,12,JUCHITÁN,080,EL AGUACATE,3,66,29,37,5
GUERRERO,12,JUCHITÁN,080,EL COCO,2,27,9,18,2
GUERRERO,12,JUCHITÁN,080,EL RINCÓN,1,11,5,6,1
GUERRERO,12,JUCHITÁN,080,EL ZAPOTITO,2,10,7,3,2
GUERRERO,12,JUCHITÁN,080,JUCHITÁN,10,996,478,518,68
GUERRERO,12,JUCHITÁN,080,LA CUCHILLA,2,15,10,5,2
GUERRERO,12,JUCHITÁN,080,LOS CALLEJONES,2,42,24,18,3
GUERRERO,12,JUCHITÁN,080,LOS PELILLOS,2,23,12,11,3
GUERRERO,12,JUCHITÁN,080,PLAN DE BUENA VISTA,2,10,5,5,2
GUERRERO,12,JUCHITÁN,080,RAYITO DE LUNA,2,21,9,12,2
GUERRERO,12,JUCHITÁN,080,SAN JOSÉ EL CAPULÍN,3,42,24,18,3
GUERRERO,12,JUCHITÁN,080,VISTA HERMOSA,2,33,13,20,3
GUERRERO,12,ILIATENCO,081,ALCHIPAHUAC,2,87,51,36,5
GUERRERO,12,ILIATENCO,081,ARROYO SAN PEDRO,3,150,81,69,10
GUERRERO,12,ILIATENCO,081,AVIACIÓN,2,125,58,67,8
GUERRERO,12,ILIATENCO,081,BARRANCA XALE,1,18,8,10,1
GUERRERO,12,ILIATENCO,081,CERRO ARDILLA,2,38,22,16,3
GUERRERO,12,ILIATENCO,081,CERRO CUATE,2,106,53,53,8
GUERRERO,12,ILIATENCO,081,CERRO GUAYABO,1,16,7,9,1
GUERRERO,12,ILIATENCO,081,CERRO TEJÓN,2,79,38,41,4
GUERRERO,12,ILIATENCO,081,COLONIA UNIVERSIDAD,2,124,60,64,7
GUERRERO,12,ILIATENCO,081,CRUZ VERDE,2,101,43,58,5
GUERRERO,12,ILIATENCO,081,CRUZTOMÁHUAC,3,162,76,86,8
GUERRERO,12,ILIATENCO,081,EL ASERRADERO,3,281,141,140,12
GUERRERO,12,ILIATENCO,081,ILIATENCO,11,1531,772,759,92
GUERRERO,12,ILIATENCO,081,LOMA DE CUAPINOLE,2,72,26,46,4
GUERRERO,12,ILIATENCO,081,LOMA ENCINO,1,19,7,12,1
GUERRERO,12,ILIATENCO,081,OJO DE AGUA,2,69,34,35,5
GUERRERO,12,ILIATENCO,081,PORTEZUELO DEL CLARÍN,2,71,36,35,4
GUERRERO,12,ILIATENCO,081,SAN ISIDRO,2,27,10,17,3
GUERRERO,12,ILIATENCO,081,SAN JOSÉ VISTA HERMOSA,5,271,117,154,19
GUERRERO,12,ILIATENCO,081,SANTA CECILIA,1,12,5,7,1
GUERRERO,12,ILIATENCO,081,SANTA CRUZ HERNÁNDEZ,1,21,12,9,1
GUERRERO,12,ILIATENCO,081,TLAHUITEPEC,3,118,63,55,8
GUERRERO,12,LAS VIGAS,082,ALTAMIRA,2,20,14,6,2
GUERRERO,12,LAS VIGAS,082,ALTO DE VENTURA,2,164,75,89,10
GUERRERO,12,LAS VIGAS,082,ARROYO DE LA UNIÓN,3,27,12,15,3
GUERRERO,12,LAS VIGAS,082,ARROYO DE LIMÓN,3,137,65,72,10
GUERRERO,12,LAS VIGAS,082,BARRANCA PRIETA,3,43,17,26,4
GUERRERO,12,LAS VIGAS,082,BUENA VISTA DEL SUR,2,41,21,20,3
GUERRERO,12,LAS VIGAS,082,EL AGOSTADERO,2,5,1,4,2
GUERRERO,12,LAS VIGAS,082,EL ARENAL DE NEXPA,2,9,5,4,2
GUERRERO,12,LAS VIGAS,082,EL PAPAYO,2,20,10,10,2
GUERRERO,12,LAS VIGAS,082,ESPINALILLO DEL TENANTE,1,7,3,4,1
GUERRERO,12,LAS VIGAS,082,ESTERO VERDE,4,244,120,124,34
GUERRERO,12,LAS VIGAS,082,LAS LECHUGAS,3,81,45,36,8
GUERRERO,12,LAS VIGAS,082,LAS LOMITAS DE NEXPA,4,151,68,83,10
GUERRERO,12,LAS VIGAS,082,LAS POZAS,2,20,11,9,2
GUERRERO,12,LAS VIGAS,082,LAS RAMADITAS,3,48,19,29,5
GUERRERO,12,LAS VIGAS,082,LAS VIGAS,10,1497,736,761,89
GUERRERO,12,LAS VIGAS,082,SAN JOSÉ LA PALA,2,15,3,12,2
GUERRERO,12,LAS VIGAS,082,VISTA ALEGRE,4,180,90,90,11
GUERRERO,12,ÑUU SAVI,083,AHUACACHAHUE,4,409,201,208,21
GUERRERO,12,ÑUU SAVI,083,AHUEXUTLA,1,20,10,10,2
GUERRERO,12,ÑUU SAVI,083,ARROYO OCOTLÁN,1,8,4,4,1
GUERRERO,12,ÑUU SAVI,083,CHACALAPA,3,189,101,88,10
GUERRERO,12,ÑUU SAVI,083,COAPINOLA,3,111,57,54,7
GUERRERO,12,ÑUU SAVI,083,COXCATLÁN SAN PEDRO,2,72,31,41,3
GUERRERO,12,ÑUU SAVI,083,CUMBRES DE COTZALZIN,3,165,79,86,10
GUERRERO,12,ÑUU SAVI,083,CUMBRES DE YOLOTEPEC,1,29,15,14,2
GUERRERO,12,ÑUU SAVI,083,EL CHARCO,3,89,35,54,4
GUERRERO,12,ÑUU SAVI,083,EL CHARQUITO,2,41,20,21,3
GUERRERO,12,ÑUU SAVI,083,EL COQUILLO,2,54,30,24,3
GUERRERO,12,ÑUU SAVI,083,EL COYUL,2,45,19,26,3
GUERRERO,12,ÑUU SAVI,083,EL PARAÍSO,3,225,114,111,12
GUERRERO,12,ÑUU SAVI,083,EL PIÑAL,1,19,4,15,1
GUERRERO,12,ÑUU SAVI,083,EL PLATANAR,2,50,15,35,3
GUERRERO,12,ÑUU SAVI,083,EL POTRERO,1,7,5,2,1
GUERRERO,12,ÑUU SAVI,083,EL TEPUENTE,2,49,19,30,3
GUERRERO,12,ÑUU SAVI,083,JUQUILA,2,11,5,6,2
GUERRERO,12,ÑUU SAVI,083,LA ANGOSTURA,4,330,178,152,21
GUERRERO,12,ÑUU SAVI,083,LA CONCORDIA,4,405,198,207,20
GUERRERO,12,ÑUU SAVI,083,LA CORTINA,2,61,33,28,3
GUERRERO,12,ÑUU SAVI,083,LA FÁTIMA,2,58,29,29,2
GUERRERO,12,ÑUU SAVI,083,LA PALMA,1,18,14,4,1
GUERRERO,12,ÑUU SAVI,083,MEZÓN ZAPOTE,3,170,88,82,11
GUERRERO,12,ÑUU SAVI,083,OCOTE AMARILLO,2,29,14,15,2
GUERRERO,12,ÑUU SAVI,083,OCOTLÁN,3,101,55,46,7
GUERRERO,12,ÑUU SAVI,083,OJO DE AGUA,3,61,25,36,4
GUERRERO,12,ÑUU SAVI,083,QUIAHUITEPEC,2,67,28,39,4
GUERRERO,12,ÑUU SAVI,083,RANCHO OCOAPA,3,61,35,26,5
GUERRERO,12,ÑUU SAVI,083,SAN ANTONIO ABAD,2,131,65,66,7
GUERRERO,12,ÑUU SAVI,083,SAN FELIPE,2,78,43,35,5
GUERRERO,12,ÑUU SAVI,083,VISTA ALEGRE,2,24,10,14,2
GUERRERO,12,ÑUU SAVI,083,VISTA HERMOSA,2,32,16,16,3
GUERRERO,12,SANTA CRUZ DEL RINCÓN,084,COLONIA HIDALGO,1,31,15,16,2
GUERRERO,12,SANTA CRUZ DEL RINCÓN,084,COLONIA SAN MIGUEL,2,131,57,74,7
GUERRERO,12,SANTA CRUZ DEL RINCÓN,084,EL COCOYÚL,3,144,66,78,10
GUERRERO,12,SANTA CRUZ DEL RINCÓN,084,EL POTRERILLO,4,484,243,241,29
GUERRERO,12,SANTA CRUZ DEL RINCÓN,084,LA PAROTA,1,32,10,22,2
GUERRERO,12,SANTA CRUZ DEL RINCÓN,084,PIEDRA PINTA (PIEDRA PINTADA),2,47,20,27,3
GUERRERO,12,SANTA CRUZ DEL RINCÓN,084,RANCHO VIEJO,3,181,90,91,10
GUERRERO,12,SANTA CRUZ DEL RINCÓN,084,SANTA CRUZ DEL RINCÓN,8,1009,576,433,55
GUERRERO,12,SANTA CRUZ DEL RINCÓN,084,TIERRA COLORADA DE LOS BRAVO,5,599,303,296,43
GUERRERO,12,SAN NICOLÁS,085,EL CACALOTE,2,34,16,18,3
GUERRERO,12,SAN NICOLÁS,085,EL CARRIZO,1,7,6,1,1
GUERRERO,12,SAN NICOLÁS,085,EL JÍCARO,3,36,18,18,4
GUERRERO,12,SAN NICOLÁS,085,EL PITAHAYO,1,122,49,73,7
GUERRERO,12,SAN NICOLÁS,085,EL TAMALE,3,78,35,43,5
GUERRERO,12,SAN NICOLÁS,085,HACIENDA LA PETACA,3,142,68,74,7
GUERRERO,12,SAN NICOLÁS,085,PUNTA MALDONADO,4,254,124,130,15
GUERRERO,12,SAN NICOLÁS,085,RANCHO DE SANTIAGO PINEDA,1,17,9,8,1
GUERRERO,12,SAN NICOLÁS,085,SAN NICOLÁS,7,892,419,473,55
GUERRERO,12,SAN NICOLÁS,085,TEJAS CRUDAS,2,61,28,33,4
HIDALGO,13,ACATLÁN,001,28 DE MAYO (SANTA ROSA) [COLONIA],3,562,281,281,24
HIDALGO,13,ACATLÁN,001,AGUSTÍN OLVERA SECCIÓN I [COLONIA],1,9,5,4,1
HIDALGO,13,ACATLÁN,001,AGUSTÍN OLVERA SECCÍON II [COLONIA],1,40,24,16,2
HIDALGO,13,ACATLÁN,001,ALCHOLOYA (EL SALTO DE ALCHOLOYA),4,362,176,186,18
HIDALGO,13,ACATLÁN,001,ALMOLOYA,4,945,487,458,35
HIDALGO,13,ACATLÁN,001,BARRIO EL YOLO,2,49,24,25,3
HIDALGO,13,ACATLÁN,001,BENITO JUÁREZ [COLONIA],2,62,30,32,3
HIDALGO,13,ACATLÁN,001,BUENA VISTA,3,84,40,44,5
HIDALGO,13,ACATLÁN,001,CHAUTÉNCO,1,30,14,16,1
HIDALGO,13,ACATLÁN,001,ECHEVERRÍA [COLONIA],3,29,15,14,3
HIDALGO,13,ACATLÁN,001,EL HUIZACHE Y LA PALOMA,2,35,17,18,3
HIDALGO,13,ACATLÁN,001,EL SABINO (LA BARRANCA),3,92,43,49,6
HIDALGO,13,ACATLÁN,001,EL TRANSFORMADOR,2,67,32,35,3
HIDALGO,13,ACATLÁN,001,EL VELADERO,3,93,45,48,7
HIDALGO,13,ACATLÁN,001,ENCINILLOS,3,129,63,66,7
HIDALGO,13,ACATLÁN,001,HUEYOTLIPA,3,33,17,16,3
HIDALGO,13,ACATLÁN,001,LA CALERA (LOS BAÑOS),1,23,8,15,1
HIDALGO,13,ACATLÁN,001,LA CHAMUSQUINA,3,51,24,27,5
HIDALGO,13,ACATLÁN,001,LA PEÑUELA,1,8,3,5,1
HIDALGO,13,ACATLÁN,001,LA UNIÓN,3,56,30,26,6
HIDALGO,13,ACATLÁN,001,LAGUNICATLÁN,2,60,26,34,4
HIDALGO,13,ACATLÁN,001,LAS PALMAS,1,9,4,5,1
HIDALGO,13,ACATLÁN,001,LOMA CHICA,1,6,1,5,1
HIDALGO,13,ACATLÁN,001,LOMA LARGA,2,24,10,14,2
HIDALGO,13,ACATLÁN,001,LOS ARCOS,3,101,44,57,6
HIDALGO,13,ACATLÁN,001,LOS MIGUELES,1,14,7,7,1
HIDALGO,13,ACATLÁN,001,METEPEC PRIMERO,2,615,294,321,24
HIDALGO,13,ACATLÁN,001,METEPEC SEGUNDO,2,257,149,108,16
HIDALGO,13,ACATLÁN,001,MIXQUIAPAN,3,202,95,107,11
HIDALGO,13,ACATLÁN,001,PIEDRA LARGA,2,20,11,9,2
HIDALGO,13,ACATLÁN,001,SAN ANTONIO LA PALMA,2,33,17,16,2
HIDALGO,13,ACATLÁN,001,SAN BARTOLO (EL LLANO),2,41,22,19,4
HIDALGO,13,ACATLÁN,001,SAN BARTOLO (LA BARRANCA),2,78,32,46,4
HIDALGO,13,ACATLÁN,001,SAN DIONISIO,4,353,198,155,19
HIDALGO,13,ACATLÁN,001,SAN PABLO,2,52,27,25,3
HIDALGO,13,ACATLÁN,001,TOTOAPA EL GRANDE,2,45,24,21,3
HIDALGO,13,ACATLÁN,001,TOTOAPITA CANUTILLO,1,23,12,11,2
HIDALGO,13,ACATLÁN,001,TOTOAPITA LA HERRADURA,1,20,9,11,1
HIDALGO,13,ACATLÁN,001,VICENTE GUERRERO,2,147,87,60,8
HIDALGO,13,ACAXOCHITLÁN,002,ACAXOCHITLÁN,6,1647,795,852,67
HIDALGO,13,ACAXOCHITLÁN,002,ALPINAGUA,1,11,5,6,1
HIDALGO,13,ACAXOCHITLÁN,002,APAPAXTLA EL CHICO,1,6,0,6,1
HIDALGO,13,ACAXOCHITLÁN,002,APAPAXTLA EL GRANDE (ALTAMIRA),3,182,88,94,11
HIDALGO,13,ACAXOCHITLÁN,002,BUENA VISTA,2,47,22,25,4
HIDALGO,13,ACAXOCHITLÁN,002,CANALES,3,87,42,45,7
HIDALGO,13,ACAXOCHITLÁN,002,CHIMALAPA,3,726,371,355,32
HIDALGO,13,ACAXOCHITLÁN,002,COYAMETEPEC,4,224,114,110,13
HIDALGO,13,ACAXOCHITLÁN,002,CUAUNEPANTLA,3,305,158,147,15
HIDALGO,13,ACAXOCHITLÁN,002,EJIDO DE TEPEPA (SANTA FÉLIX),1,5,2,3,1
HIDALGO,13,ACAXOCHITLÁN,002,EJIDO SANTA CATARINA,2,34,15,19,4
HIDALGO,13,ACAXOCHITLÁN,002,EJIDO TECHACHALCO,2,36,14,22,3
HIDALGO,13,ACAXOCHITLÁN,002,EJIDO TLAMIMILOLPA,3,15,8,7,2
HIDALGO,13,ACAXOCHITLÁN,002,EJIDO TLATZINTLA,4,181,91,90,11
HIDALGO,13,ACAXOCHITLÁN,002,EL LINDERO,3,135,77,58,7
HIDALGO,13,ACAXOCHITLÁN,002,EL TEJOCOTAL,3,154,81,73,10
HIDALGO,13,ACAXOCHITLÁN,002,LA BÓVEDA,6,630,312,318,29
HIDALGO,13,ACAXOCHITLÁN,002,LA CUMBRE DE SANTA CATARINA,2,15,9,6,2
HIDALGO,13,ACAXOCHITLÁN,002,LA MESA,4,271,124,147,14
HIDALGO,13,ACAXOCHITLÁN,002,LOMA BONITA,2,17,9,8,2
HIDALGO,13,ACAXOCHITLÁN,002,LOS REYES,11,1029,519,510,56
HIDALGO,13,ACAXOCHITLÁN,002,MEZTOLOTLA,3,33,16,17,4
HIDALGO,13,ACAXOCHITLÁN,002,MONTEMAR,2,45,21,24,3
HIDALGO,13,ACAXOCHITLÁN,002,NUEVO SAN JUAN,1,20,10,10,2
HIDALGO,13,ACAXOCHITLÁN,002,OJO DE AGUA DE LAS PALOMAS,3,60,27,33,5
HIDALGO,13,ACAXOCHITLÁN,002,OTONTEPEC,2,34,19,15,3
HIDALGO,13,ACAXOCHITLÁN,002,PARADA 170,3,36,17,19,4
HIDALGO,13,ACAXOCHITLÁN,002,SAN ANDRÉS,2,11,4,7,2
HIDALGO,13,ACAXOCHITLÁN,002,SAN FERNANDO,3,22,12,10,3
HIDALGO,13,ACAXOCHITLÁN,002,SAN FRANCISCO ATOTONILCO,4,567,314,253,28
HIDALGO,13,ACAXOCHITLÁN,002,SAN JUAN,3,42,22,20,4
HIDALGO,13,ACAXOCHITLÁN,002,SAN MARTÍN,2,24,9,15,2
HIDALGO,13,ACAXOCHITLÁN,002,SAN MATEO,6,701,360,341,30
HIDALGO,13,ACAXOCHITLÁN,002,SAN MIGUEL DEL RESGATE,3,203,110,93,12
HIDALGO,13,ACAXOCHITLÁN,002,SAN PEDRO TLACHICHILCO,9,849,441,408,48
HIDALGO,13,ACAXOCHITLÁN,002,SANTA ANA TZACUALA,8,988,513,475,51
HIDALGO,13,ACAXOCHITLÁN,002,SANTA CATARINA,4,138,76,62,13
HIDALGO,13,ACAXOCHITLÁN,002,TECHACHALCO,2,27,13,14,3
HIDALGO,13,ACAXOCHITLÁN,002,TEPEPA (SANTIAGO TEPEPA),9,1114,581,533,57
HIDALGO,13,ACAXOCHITLÁN,002,TLACPAC,2,171,96,75,8
HIDALGO,13,ACAXOCHITLÁN,002,TLALTEGCO (VENTA QUEMADA),2,57,30,27,4
HIDALGO,13,ACAXOCHITLÁN,002,TLAMIMILOLPA,3,202,106,96,11
HIDALGO,13,ACAXOCHITLÁN,002,TLATZINTLA,1,732,419,313,62
HIDALGO,13,ACAXOCHITLÁN,002,TOXTLA,3,43,23,20,4
HIDALGO,13,ACAXOCHITLÁN,002,YEMILA,2,15,2,13,2
HIDALGO,13,ACAXOCHITLÁN,002,ZACACUAUTLA,6,433,213,220,24
HIDALGO,13,ACAXOCHITLÁN,002,ZOTICTLA,2,45,19,26,3
HIDALGO,13,ACTOPAN,003,ACTOPAN,67,11644,5703,5941,764
HIDALGO,13,ACTOPAN,003,BOTHI BAJI,3,72,44,28,7
HIDALGO,13,ACTOPAN,003,BOXAXNI,3,169,90,79,11
HIDALGO,13,ACTOPAN,003,CAÑADA CHICA ANTIGUA,2,47,20,27,3
HIDALGO,13,ACTOPAN,003,CASA BLANCA,1,33,20,13,3
HIDALGO,13,ACTOPAN,003,CHICAVASCO,7,840,412,428,51
HIDALGO,13,ACTOPAN,003,CUAUHTÉMOC [COLONIA],3,236,123,113,14
HIDALGO,13,ACTOPAN,003,DAJIEDHI,3,190,104,86,11
HIDALGO,13,ACTOPAN,003,EL BOXTHA,3,312,155,157,19
HIDALGO,13,ACTOPAN,003,EL DAXTHA,8,3885,2327,1558,211
HIDALGO,13,ACTOPAN,003,EL HUAXTHO,3,409,201,208,21
HIDALGO,13,ACTOPAN,003,EL PALOMO,2,36,16,20,4
HIDALGO,13,ACTOPAN,003,EL PARAJE,3,20,4,16,2
HIDALGO,13,ACTOPAN,003,EL PORVENIR,1,162,77,85,13
HIDALGO,13,ACTOPAN,003,LA ESTANCIA,3,265,137,128,16
HIDALGO,13,ACTOPAN,003,LA LOMA,3,134,65,69,10
HIDALGO,13,ACTOPAN,003,LA PEÑA,2,179,86,93,10
HIDALGO,13,ACTOPAN,003,LAS MECAS,3,28,11,17,4
HIDALGO,13,ACTOPAN,003,MANZANA DE GOLONDRINAS,1,2,1,1,1
HIDALGO,13,ACTOPAN,003,MESA CHICA,2,7,4,3,1
HIDALGO,13,ACTOPAN,003,PLOMOSAS,1,19,4,15,2
HIDALGO,13,ACTOPAN,003,SAN ANDRÉS TIANGUISTENGO,3,112,56,56,10
HIDALGO,13,ACTOPAN,003,SAN DIEGO CANGUIHUINDO,2,26,12,14,3
HIDALGO,13,ACTOPAN,003,SAN ISIDRO,1,7,3,4,1
HIDALGO,13,ACTOPAN,003,SANTA MARÍA MAGDALENA,6,126,58,68,11
HIDALGO,13,ACTOPAN,003,SAUCILLO,3,35,19,16,4
HIDALGO,13,ACTOPAN,003,SEGUNDA MANZANA CHICAVASCO (EL POZO),1,19,10,9,1
HIDALGO,13,ACTOPAN,003,XIDEJE,2,47,19,28,4
HIDALGO,13,AGUA BLANCA DE ITURBIDE,004,AGUA BLANCA DE ITURBIDE,3,923,477,446,38
HIDALGO,13,AGUA BLANCA DE ITURBIDE,004,CALABAZAS PRIMERA SECCIÓN,2,24,14,10,3
HIDALGO,13,AGUA BLANCA DE ITURBIDE,004,CALABAZAS SEGUNDA SECCIÓN,4,105,51,54,7
HIDALGO,13,AGUA BLANCA DE ITURBIDE,004,CHICHICAXTLE,2,68,45,23,5
HIDALGO,13,AGUA BLANCA DE ITURBIDE,004,EJIDO DE AGUA BLANCA (CERRO ALTO),2,45,20,25,4
HIDALGO,13,AGUA BLANCA DE ITURBIDE,004,EJIDO DE CALABAZAS,3,89,45,44,7
HIDALGO,13,AGUA BLANCA DE ITURBIDE,004,EJIDO DE LOMA ANCHA,1,17,4,13,1
HIDALGO,13,AGUA BLANCA DE ITURBIDE,004,EJIDO DE LOS CUBES,2,65,35,30,4
HIDALGO,13,AGUA BLANCA DE ITURBIDE,004,EJIDO DE PALIZAR,2,27,20,7,3
HIDALGO,13,AGUA BLANCA DE ITURBIDE,004,EJIDO MILPA VIEJA,2,313,148,165,13
HIDALGO,13,AGUA BLANCA DE ITURBIDE,004,EJIDO ROSA DE CASTILLA,3,69,36,33,8
HIDALGO,13,AGUA BLANCA DE ITURBIDE,004,EL PALIZAR,2,19,8,11,2
HIDALGO,13,AGUA BLANCA DE ITURBIDE,004,EL REMUDADERO,2,17,7,10,2
HIDALGO,13,AGUA BLANCA DE ITURBIDE,004,EL XÚCHITL,4,115,65,50,11
HIDALGO,13,AGUA BLANCA DE ITURBIDE,004,LOS CUBES,3,126,61,65,11
HIDALGO,13,AGUA BLANCA DE ITURBIDE,004,PLAN GRANDE,1,64,27,37,3
HIDALGO,13,AGUA BLANCA DE ITURBIDE,004,POTRERO DE MONROY,3,34,17,17,4
HIDALGO,13,AGUA BLANCA DE ITURBIDE,004,ROSA DE CASTILLA,1,9,6,3,1
HIDALGO,13,AGUA BLANCA DE ITURBIDE,004,SABANILLAS,1,296,159,137,16
HIDALGO,13,AGUA BLANCA DE ITURBIDE,004,SAN CORNELIO,3,60,23,37,6
HIDALGO,13,AGUA BLANCA DE ITURBIDE,004,SAN MARTÍN,3,14,7,7,3
HIDALGO,13,AGUA BLANCA DE ITURBIDE,004,SAN PEDRITO,4,81,43,38,8
HIDALGO,13,AGUA BLANCA DE ITURBIDE,004,TETETLA,2,30,9,21,4
HIDALGO,13,AJACUBA,005,AJACUBA,7,1675,839,836,71
HIDALGO,13,AJACUBA,005,BARRIO EL RINCÓN SUR,1,5,2,3,1
HIDALGO,13,AJACUBA,005,EL GORRIÓN,2,28,19,9,3
HIDALGO,13,AJACUBA,005,EMILIANO ZAPATA,1,26,11,15,2
HIDALGO,13,AJACUBA,005,IGNACIO ZARAGOZA,4,125,66,59,10
HIDALGO,13,AJACUBA,005,SAN NICOLÁS TECOMATLÁN,7,582,295,287,33
HIDALGO,13,AJACUBA,005,SANTIAGO TEZONTLALE,7,900,447,453,47
HIDALGO,13,AJACUBA,005,TULANCALCO,2,27,13,14,3
HIDALGO,13,AJACUBA,005,VICENTE GUERRERO,2,225,105,120,13
HIDALGO,13,ALFAJAYUCAN,006,ALFAJAYUCAN,6,1431,699,732,76
HIDALGO,13,ALFAJAYUCAN,006,BAXTHE,1,12,6,6,2
HIDALGO,13,ALFAJAYUCAN,006,BOXTHÓ,2,72,39,33,5
HIDALGO,13,ALFAJAYUCAN,006,CEBOLLETAS,2,33,16,17,2
HIDALGO,13,ALFAJAYUCAN,006,CERRO AZUL,3,59,29,30,7
HIDALGO,13,ALFAJAYUCAN,006,DECA,2,37,17,20,4
HIDALGO,13,ALFAJAYUCAN,006,DONGUIÑYO,1,6,3,3,1
HIDALGO,13,ALFAJAYUCAN,006,EL ESPÍRITU,2,129,53,76,7
HIDALGO,13,ALFAJAYUCAN,006,EL PEÑÓN,1,6,2,4,1
HIDALGO,13,ALFAJAYUCAN,006,LA HUAPILLA,3,86,40,46,9
HIDALGO,13,ALFAJAYUCAN,006,LA NOPALERA,2,65,35,30,8
HIDALGO,13,ALFAJAYUCAN,006,LA PIEDAD,2,21,9,12,2
HIDALGO,13,ALFAJAYUCAN,006,LA SALITRERA,3,35,14,21,5
HIDALGO,13,ALFAJAYUCAN,006,LA VEGA,3,108,59,49,10
HIDALGO,13,ALFAJAYUCAN,006,LOS ÁNGELES,2,43,27,16,3
HIDALGO,13,ALFAJAYUCAN,006,MADHO CORRALES,2,10,7,3,1
HIDALGO,13,ALFAJAYUCAN,006,NAXTHÉY,2,41,26,15,3
HIDALGO,13,ALFAJAYUCAN,006,NEXNI,2,8,3,5,1
HIDALGO,13,ALFAJAYUCAN,006,SAN AGUSTÍN TLALIXTICAPA,2,67,28,39,5
HIDALGO,13,ALFAJAYUCAN,006,SAN ANTONIO CORRALES,2,17,7,10,3
HIDALGO,13,ALFAJAYUCAN,006,SAN ANTONIO TEZOQUIPAN,4,172,93,79,14
HIDALGO,13,ALFAJAYUCAN,006,SAN FRANCISCO SACACHICHILCO,4,139,70,69,13
HIDALGO,13,ALFAJAYUCAN,006,SAN LUCAS,3,69,38,31,6
HIDALGO,13,ALFAJAYUCAN,006,SAN PABLO OXTOTIPAN,4,107,54,53,13
HIDALGO,13,ALFAJAYUCAN,006,SAN PEDRO LA PAZ,2,11,6,5,2
HIDALGO,13,ALFAJAYUCAN,006,SANTA MARÍA LA PALMA,2,37,12,25,4
HIDALGO,13,ALFAJAYUCAN,006,SANTA MARÍA XIGUI,3,220,102,118,14
HIDALGO,13,ALFAJAYUCAN,006,TAXHIÉ,2,80,44,36,6
HIDALGO,13,ALFAJAYUCAN,006,XAMAGÉ,3,160,75,85,11
HIDALGO,13,ALFAJAYUCAN,006,XOTHÉ,2,4,1,3,1
HIDALGO,13,ALFAJAYUCAN,006,YONTHE CHICO,2,104,56,48,7
HIDALGO,13,ALFAJAYUCAN,006,YONTHE GRANDE,1,21,16,5,2
HIDALGO,13,ALFAJAYUCAN,006,ZOZEA,4,1279,639,640,78
HIDALGO,13,ALMOLOYA,007,ALMOLOYA,5,1136,600,536,50
HIDALGO,13,ALMOLOYA,007,COLONIA MARTÍNEZ,1,309,156,153,12
HIDALGO,13,ALMOLOYA,007,CUATLACO,2,25,10,15,3
HIDALGO,13,ALMOLOYA,007,EL TEPOZÁN (SAN GABRIEL),4,230,101,129,12
HIDALGO,13,ALMOLOYA,007,LA CORONILLA,3,7,3,4,2
HIDALGO,13,ALMOLOYA,007,LA ORDEÑA,3,18,7,11,3
HIDALGO,13,ALMOLOYA,007,LA VIOLETA,2,5,1,4,2
HIDALGO,13,ALMOLOYA,007,LOS OJITOS,2,5,3,2,1
HIDALGO,13,ALMOLOYA,007,OCOTEPEC,2,90,46,44,5
HIDALGO,13,ALMOLOYA,007,OCOTEPEC DE MORELOS,2,56,24,32,4
HIDALGO,13,ALMOLOYA,007,RANCHO NUEVO,3,192,94,98,10
HIDALGO,13,ALMOLOYA,007,SAN ISIDRO TETLAPAYAC,1,49,20,29,2
HIDALGO,13,ALMOLOYA,007,SAN LORENZO XICOTÉNCATL,1,5,1,4,1
HIDALGO,13,ALMOLOYA,007,SANTIAGO TETLAPAYAC,3,135,65,70,10
HIDALGO,13,ALMOLOYA,007,TEPEPATLAXCO (EL LLANO),3,266,124,142,13
HIDALGO,13,ALMOLOYA,007,TEPETLAYUCA,2,82,44,38,5
HIDALGO,13,APAN,008,ACOPINALCO,4,161,78,83,13
HIDALGO,13,APAN,008,ALCANTARILLAS,3,77,37,40,7
HIDALGO,13,APAN,008,APAN,27,5198,2628,2570,288
HIDALGO,13,APAN,008,CHIMALPA TLALAYOTE,4,910,446,464,64
HIDALGO,13,APAN,008,COCINILLAS,3,41,18,23,3
HIDALGO,13,APAN,008,EL ALCANFOR,2,7,1,6,1
HIDALGO,13,APAN,008,EL TEZOYO,4,66,36,30,9
HIDALGO,13,APAN,008,EL TIGRE,1,2,2,0,0
HIDALGO,13,APAN,008,EX-HACIENDA SAN JUAN IXTILMACO,1,962,524,438,59
HIDALGO,13,APAN,008,GUADALUPE,1,5,2,3,1
HIDALGO,13,APAN,008,LA LAGUNA,2,176,91,85,8
HIDALGO,13,APAN,008,LA LEONA,3,27,16,11,3
HIDALGO,13,APAN,008,LAS HACIENDAS,3,72,30,42,16
HIDALGO,13,APAN,008,LAS PEÑITAS,3,3367,1617,1750,169
HIDALGO,13,APAN,008,LÁZARO CÁRDENAS,3,477,219,258,22
HIDALGO,13,APAN,008,LOMAS DEL PEDREGAL,3,71,34,37,5
HIDALGO,13,APAN,008,LOS VOLADORES,2,39,18,21,3
HIDALGO,13,APAN,008,MALAYERBA,3,82,30,52,7
HIDALGO,13,APAN,008,SAN DIEGO TLALAYOTE,2,72,27,45,4
HIDALGO,13,APAN,008,SAN JOSÉ EL MIRADOR,1,9,4,5,1
HIDALGO,13,APAN,008,SAN JOSÉ JIQUILPAN,4,129,57,72,10
HIDALGO,13,APAN,008,SAN JUAN IXTILMACO,3,145,66,79,10
HIDALGO,13,APAN,008,SAN LUCAS,1,5,1,4,1
HIDALGO,13,APAN,008,SAN MIGUEL DE LAS TUNAS,2,37,16,21,4
HIDALGO,13,APAN,008,SAN RAFAEL,2,6,2,4,2
HIDALGO,13,APAN,008,SAN SEBASTIÁN,1,10,3,7,1
HIDALGO,13,APAN,008,SANTA CRUZ,4,166,86,80,11
HIDALGO,13,APAN,008,ZOTOLUCA (VELOZ),3,198,99,99,11
HIDALGO,13,EL ARENAL,009,20 DE NOVIEMBRE [COLONIA],2,51,29,22,5
HIDALGO,13,EL ARENAL,009,CHIMILPA,2,70,33,37,6
HIDALGO,13,EL ARENAL,009,EL ARENAL,4,964,477,487,46
HIDALGO,13,EL ARENAL,009,EL BOCJA,2,142,70,72,7
HIDALGO,13,EL ARENAL,009,EL JIADI,3,340,156,184,18
HIDALGO,13,EL ARENAL,009,EL MEJE,3,83,39,44,7
HIDALGO,13,EL ARENAL,009,EL RINCÓN,4,377,172,205,19
HIDALGO,13,EL ARENAL,009,FRAY FRANCISCO,3,60,28,32,7
HIDALGO,13,EL ARENAL,009,LA AZTECA,2,11,6,5,1
HIDALGO,13,EL ARENAL,009,LA MANZANA UNO,2,17,7,10,2
HIDALGO,13,EL ARENAL,009,LA SALA (LA CALIENTE),1,18,11,7,2
HIDALGO,13,EL ARENAL,009,OJO DE AGUA SAN JOSÉ TEPENENE,2,190,86,104,10
HIDALGO,13,EL ARENAL,009,OJO DE AGUA SANTA ROSA,2,76,32,44,4
HIDALGO,13,EL ARENAL,009,SAN JERÓNIMO,6,110,52,58,10
HIDALGO,13,EL ARENAL,009,SAN JOSÉ TEPENENE,7,995,492,503,48
HIDALGO,13,ATITALAQUIA,010,ATITALAQUIA,21,4655,2129,2526,381
HIDALGO,13,ATITALAQUIA,010,CARDONAL,9,981,472,509,53
HIDALGO,13,ATITALAQUIA,010,COLONIA REFINERÍA (COLONIA DE LOS INGENIEROS),2,89,60,29,6
HIDALGO,13,ATITALAQUIA,010,EL OLIMPO [RANCHO],1,880,348,532,32
HIDALGO,13,ATITALAQUIA,010,TEZOQUIPA,2,403,208,195,16
HIDALGO,13,ATITALAQUIA,010,TLALMINULPA,2,222,116,106,10
HIDALGO,13,ATITALAQUIA,010,TLAMACO (SAN GERÓNIMO TLAMACO),4,717,322,395,47
HIDALGO,13,ATITALAQUIA,010,UNIDAD HABITACIONAL ANTONIO OSORIO DE LEÓN (BOJAY),2,153,78,75,8
HIDALGO,13,ATLAPEXCO,011,ACHIQUIHUIXTLA,5,162,77,85,17
HIDALGO,13,ATLAPEXCO,011,ATENCUAPA,3,105,45,60,6
HIDALGO,13,ATLAPEXCO,011,ATLAJCO,2,36,16,20,3
HIDALGO,13,ATLAPEXCO,011,ATLALTIPA HUITZOTLACO,2,35,19,16,3
HIDALGO,13,ATLAPEXCO,011,ATLALTIPA MIRADOR,2,53,24,29,5
HIDALGO,13,ATLAPEXCO,011,ATLALTIPA TECOLOTITLA,2,40,24,16,4
HIDALGO,13,ATLAPEXCO,011,ATLAPEXCO,7,2436,1180,1256,160
HIDALGO,13,ATLAPEXCO,011,ATOTOMOC,3,149,87,62,12
HIDALGO,13,ATLAPEXCO,011,COCHISCUATITLA,3,91,45,46,9
HIDALGO,13,ATLAPEXCO,011,COCHOTLA,5,379,197,182,28
HIDALGO,13,ATLAPEXCO,011,COYOLAPA,2,30,16,14,2
HIDALGO,13,ATLAPEXCO,011,CUATAPA,2,9,2,7,1
HIDALGO,13,ATLAPEXCO,011,EL MIRADOR,2,38,18,20,4
HIDALGO,13,ATLAPEXCO,011,GENERAL EMILIANO ZAPATA,2,5,2,3,1
HIDALGO,13,ATLAPEXCO,011,HUITZOTLACO,2,110,52,58,8
HIDALGO,13,ATLAPEXCO,011,ITZÓCAL,4,195,86,109,13
HIDALGO,13,ATLAPEXCO,011,IXTACUATITLA,1,14,5,9,1
HIDALGO,13,ATLAPEXCO,011,IXTACUAYO,1,12,8,4,2
HIDALGO,13,ATLAPEXCO,011,LEY AGRARIA 6 DE ENERO,2,20,12,8,3
HIDALGO,13,ATLAPEXCO,011,LOS NARANJOS,1,9,3,6,1
HIDALGO,13,ATLAPEXCO,011,OXPANTLA,2,27,12,15,2
HIDALGO,13,ATLAPEXCO,011,PAHACTLA,3,295,134,161,20
HIDALGO,13,ATLAPEXCO,011,PALO GORDO,2,29,15,14,2
HIDALGO,13,ATLAPEXCO,011,PLAN HUASTECA,2,22,7,15,2
HIDALGO,13,ATLAPEXCO,011,SAN ISIDRO,3,125,65,60,11
HIDALGO,13,ATLAPEXCO,011,SANTO TOMÁS,3,111,56,55,10
HIDALGO,13,ATLAPEXCO,011,TECACAHUACO,4,227,121,106,20
HIDALGO,13,ATLAPEXCO,011,TECOLOTITLA,4,266,142,124,18
HIDALGO,13,ATLAPEXCO,011,TENEXCO I,3,135,72,63,10
HIDALGO,13,ATLAPEXCO,011,TENEXCO II,2,71,32,39,7
HIDALGO,13,ATLAPEXCO,011,TIERRA PLAYA,1,24,16,8,1
HIDALGO,13,ATLAPEXCO,011,TLACHAPA,2,58,23,35,5
HIDALGO,13,ATLAPEXCO,011,TLAHICA,1,14,8,6,1
HIDALGO,13,ATLAPEXCO,011,XANCALTITLA,2,42,21,21,3
HIDALGO,13,ATOTONILCO EL GRANDE,012,AGUA LIMPIA,3,152,88,64,10
HIDALGO,13,ATOTONILCO EL GRANDE,012,APIPILHUASCO,4,260,133,127,15
HIDALGO,13,ATOTONILCO EL GRANDE,012,ATOTONILCO EL GRANDE,17,2908,1466,1442,194
HIDALGO,13,ATOTONILCO EL GRANDE,012,CERRO BLANCO,3,47,19,28,5
HIDALGO,13,ATOTONILCO EL GRANDE,012,CERRO COLORADO,4,307,166,141,19
HIDALGO,13,ATOTONILCO EL GRANDE,012,CIENEGUILLAS,2,44,20,24,3
HIDALGO,13,ATOTONILCO EL GRANDE,012,CUMBRE DE POTRERO DE LOS REYES,1,5,1,4,1
HIDALGO,13,ATOTONILCO EL GRANDE,012,CUMBRE DE SANTA CATARINA,2,49,23,26,3
HIDALGO,13,ATOTONILCO EL GRANDE,012,DOÑANA,2,22,11,11,3
HIDALGO,13,ATOTONILCO EL GRANDE,012,EL CONTADERO,3,94,45,49,8
HIDALGO,13,ATOTONILCO EL GRANDE,012,EL PEDREGAL DE SAN JUAN,2,10,6,4,2
HIDALGO,13,ATOTONILCO EL GRANDE,012,EL XITHE (SANTA RITA EL XITHE),2,32,16,16,3
HIDALGO,13,ATOTONILCO EL GRANDE,012,EL ZOQUITAL,2,29,16,13,3
HIDALGO,13,ATOTONILCO EL GRANDE,012,LA CRUZ (BARRIO DE LA CRUZ),2,32,15,17,3
HIDALGO,13,ATOTONILCO EL GRANDE,012,LA CUMBRE DE SAN LUCAS,2,11,5,6,2
HIDALGO,13,ATOTONILCO EL GRANDE,012,LA ESTANCIA,7,985,490,495,70
HIDALGO,13,ATOTONILCO EL GRANDE,012,LA NOGALERA,2,31,20,11,4
HIDALGO,13,ATOTONILCO EL GRANDE,012,LA PUEBLA,2,63,31,32,7
HIDALGO,13,ATOTONILCO EL GRANDE,012,LOS REYES,2,24,9,15,2
HIDALGO,13,ATOTONILCO EL GRANDE,012,LOS SABINOS,3,219,117,102,11
HIDALGO,13,ATOTONILCO EL GRANDE,012,LOS TEPETATES,2,30,12,18,3
HIDALGO,13,ATOTONILCO EL GRANDE,012,MONTECILLOS,4,324,172,152,18
HIDALGO,13,ATOTONILCO EL GRANDE,012,PADRE NUESTRO SAN BARTOLO,2,6,1,5,1
HIDALGO,13,ATOTONILCO EL GRANDE,012,PARAJE DE LOS SAUCES,1,14,7,7,1
HIDALGO,13,ATOTONILCO EL GRANDE,012,PAREDONES,2,25,13,12,2
HIDALGO,13,ATOTONILCO EL GRANDE,012,PASO DE AMAJAC,3,95,50,45,8
HIDALGO,13,ATOTONILCO EL GRANDE,012,POTRERO DE LOS REYES,3,40,17,23,3
HIDALGO,13,ATOTONILCO EL GRANDE,012,SAN FELIPE Y ANEXAS,1,9,4,5,1
HIDALGO,13,ATOTONILCO EL GRANDE,012,SAN JOSÉ ZOQUITAL,2,61,31,30,4
HIDALGO,13,ATOTONILCO EL GRANDE,012,SAN MARTÍN,3,76,29,47,7
HIDALGO,13,ATOTONILCO EL GRANDE,012,SAN NICOLÁS XATHÉ,3,118,59,59,8
HIDALGO,13,ATOTONILCO EL GRANDE,012,SAN PEDRO VAQUERÍAS,2,42,21,21,5
HIDALGO,13,ATOTONILCO EL GRANDE,012,SANCTÓRUM,3,59,30,29,5
HIDALGO,13,ATOTONILCO EL GRANDE,012,SANTA ANA,1,12,7,5,1
HIDALGO,13,ATOTONILCO EL GRANDE,012,SANTA CATARINA,2,23,13,10,2
HIDALGO,13,ATOTONILCO EL GRANDE,012,SANTA CRUZ DE MONTECILLOS,4,76,41,35,10
HIDALGO,13,ATOTONILCO EL GRANDE,012,SANTA MARÍA AMAJAC,3,197,100,97,11
HIDALGO,13,ATOTONILCO EL GRANDE,012,SANTIAGUITO,3,36,20,16,3
HIDALGO,13,ATOTONILCO EL GRANDE,012,SAUZ SABINO,2,26,11,15,3
HIDALGO,13,ATOTONILCO EL GRANDE,012,SAUZ XATHÉ,2,23,7,16,2
HIDALGO,13,ATOTONILCO EL GRANDE,012,TEZAHUAPA,2,46,21,25,5
HIDALGO,13,ATOTONILCO EL GRANDE,012,TILTEPEC,3,38,20,18,4
HIDALGO,13,ATOTONILCO DE TULA,013,ATOTONILCO DE TULA,20,3051,1542,1509,224
HIDALGO,13,ATOTONILCO DE TULA,013,COAYUCA,2,46,22,24,4
HIDALGO,13,ATOTONILCO DE TULA,013,CONEJOS,8,1278,632,646,58
HIDALGO,13,ATOTONILCO DE TULA,013,EL PEDREGAL,4,832,412,420,27
HIDALGO,13,ATOTONILCO DE TULA,013,EL PUERTECITO,1,21,12,9,2
HIDALGO,13,ATOTONILCO DE TULA,013,EL REFUGIO (SALITRERA),2,224,123,101,9
HIDALGO,13,ATOTONILCO DE TULA,013,LA CAÑADA,2,160,79,81,8
HIDALGO,13,ATOTONILCO DE TULA,013,OCAMPO,3,298,138,160,14
HIDALGO,13,ATOTONILCO DE TULA,013,PASEOS DE LA PRADERA,17,4668,2314,2354,191
HIDALGO,13,ATOTONILCO DE TULA,013,PRADERAS DEL POTRERO,6,333,154,179,28
HIDALGO,13,ATOTONILCO DE TULA,013,PROGRESO,6,1383,858,525,78
HIDALGO,13,ATOTONILCO DE TULA,013,REAL CASTILLA,3,580,282,298,19
HIDALGO,13,ATOTONILCO DE TULA,013,SAN ANTONIO,2,126,57,69,8
HIDALGO,13,ATOTONILCO DE TULA,013,SAN JOSÉ ACOCULCO,3,162,73,89,10
HIDALGO,13,ATOTONILCO DE TULA,013,SANTA CRUZ DEL TEZONTLE,2,11,4,7,2
HIDALGO,13,ATOTONILCO DE TULA,013,SENDEROS DEL PEDREGAL,2,408,202,206,15
HIDALGO,13,ATOTONILCO DE TULA,013,TEXAS,2,144,63,81,8
HIDALGO,13,ATOTONILCO DE TULA,013,VITO,8,784,412,372,47
HIDALGO,13,ATOTONILCO DE TULA,013,ZACAMULPA,2,169,81,88,8
HIDALGO,13,CALNALI,014,AHUACATLÁN,4,144,75,69,13
HIDALGO,13,CALNALI,014,AHUAMOLOS,2,9,6,3,1
HIDALGO,13,CALNALI,014,ATEMPA,3,52,25,27,7
HIDALGO,13,CALNALI,014,BUENAVISTA,2,34,19,15,4
HIDALGO,13,CALNALI,014,CALNALI,7,1339,659,680,103
HIDALGO,13,CALNALI,014,CAMOTLA,2,22,7,15,3
HIDALGO,13,CALNALI,014,CHICUAPA,2,5,2,3,1
HIDALGO,13,CALNALI,014,COAMITLA,3,136,63,73,10
HIDALGO,13,CALNALI,014,COYULA,3,112,58,54,10
HIDALGO,13,CALNALI,014,NUEVO CUAPTONAPA,1,17,8,9,2
HIDALGO,13,CALNALI,014,PALZOQUITEMPA,2,10,4,6,2
HIDALGO,13,CALNALI,014,PAPATLATLA,5,631,309,322,34
HIDALGO,13,CALNALI,014,PEZMATLÁN,3,242,112,130,13
HIDALGO,13,CALNALI,014,RANCHO NUEVO,3,117,56,61,7
HIDALGO,13,CALNALI,014,SAN ANDRÉS (SAN ANDRÉS CHICHAYOTLA),4,443,205,238,26
HIDALGO,13,CALNALI,014,SANTA LUCÍA (MESA DE SANTA LUCÍA),3,52,26,26,7
HIDALGO,13,CALNALI,014,TECHICHICO,2,55,27,28,4
HIDALGO,13,CALNALI,014,TECPACO,3,127,67,60,10
HIDALGO,13,CALNALI,014,TECUEYACA,3,44,18,26,5
HIDALGO,13,CALNALI,014,TEXCACO (SAGRADO CORAZÓN DE JESÚS),3,19,9,10,3
HIDALGO,13,CALNALI,014,TLALICA,2,5,4,1,1
HIDALGO,13,CALNALI,014,TLATEXCO,1,5,2,3,1
HIDALGO,13,CALNALI,014,TOCHINTLÁN,2,29,12,17,3
HIDALGO,13,CALNALI,014,TOSTLAMANTLA,3,36,18,18,4
HIDALGO,13,CALNALI,014,TULA,3,54,21,33,5
HIDALGO,13,CARDONAL,015,AGUACATLÁN,1,7,3,4,1
HIDALGO,13,CARDONAL,015,BARRIO DE TIXQUI,2,23,13,10,3
HIDALGO,13,CARDONAL,015,CARDONAL,5,1038,509,529,81
HIDALGO,13,CARDONAL,015,CARDONALITO,2,5,1,4,1
HIDALGO,13,CARDONAL,015,CERRITOS,2,29,15,14,3
HIDALGO,13,CARDONAL,015,CERRO BLANCO (EL FRAILE),2,11,6,5,1
HIDALGO,13,CARDONAL,015,CERRO COLORADO,2,42,23,19,4
HIDALGO,13,CARDONAL,015,CIENEGUILLA,4,199,100,99,14
HIDALGO,13,CARDONAL,015,CIENEGUILLITA,1,13,5,8,1
HIDALGO,13,CARDONAL,015,CUESTA BLANCA,2,27,10,17,3
HIDALGO,13,CARDONAL,015,DURANGO DABOXTHA,2,62,24,38,8
HIDALGO,13,CARDONAL,015,EL ARENALITO (EL ARROYO),1,8,3,5,2
HIDALGO,13,CARDONAL,015,EL BINGÚ,3,147,76,71,11
HIDALGO,13,CARDONAL,015,EL BONDHO,2,27,14,13,3
HIDALGO,13,CARDONAL,015,EL BOTHO,4,188,93,95,14
HIDALGO,13,CARDONAL,015,EL BOXO,2,24,16,8,3
HIDALGO,13,CARDONAL,015,EL BUENA,2,88,44,44,8
HIDALGO,13,CARDONAL,015,EL DECA,3,197,92,105,12
HIDALGO,13,CARDONAL,015,EL MOLINO,2,10,4,6,2
HIDALGO,13,CARDONAL,015,EL POTRERO,4,77,38,39,8
HIDALGO,13,CARDONAL,015,EL SAUZ (JUXMAYE),3,105,53,52,10
HIDALGO,13,CARDONAL,015,EL TIXQUI AGUA FRÍA,3,51,24,27,6
HIDALGO,13,CARDONAL,015,EL VITHE,2,28,14,14,4
HIDALGO,13,CARDONAL,015,JONACAPA,1,6,2,4,1
HIDALGO,13,CARDONAL,015,LA FLORIDA,3,56,26,30,9
HIDALGO,13,CARDONAL,015,LA MESA,2,38,19,19,3
HIDALGO,13,CARDONAL,015,LA UNIÓN,2,9,3,6,1
HIDALGO,13,CARDONAL,015,LA VEGA,2,51,23,28,6
HIDALGO,13,CARDONAL,015,LOS FRESNOS,2,15,11,4,2
HIDALGO,13,CARDONAL,015,LOS REYES,2,40,20,20,4
HIDALGO,13,CARDONAL,015,MOXTHE,1,8,5,3,1
HIDALGO,13,CARDONAL,015,NOGAL,2,18,13,5,2
HIDALGO,13,CARDONAL,015,PALACIOS,2,23,14,9,3
HIDALGO,13,CARDONAL,015,PIEDRA CHICA,1,12,5,7,1
HIDALGO,13,CARDONAL,015,PILAS YONTHÉ,1,14,8,6,2
HIDALGO,13,CARDONAL,015,PINALITO,2,8,3,5,1
HIDALGO,13,CARDONAL,015,POZUELOS,5,257,126,131,19
HIDALGO,13,CARDONAL,015,SAN ANDRÉS DABOXTHA,3,215,111,104,19
HIDALGO,13,CARDONAL,015,SAN ANTONIO SABANILLAS,3,155,82,73,11
HIDALGO,13,CARDONAL,015,SAN CLEMENTE,2,33,18,15,3
HIDALGO,13,CARDONAL,015,SAN CRISTÓBAL,3,171,73,98,11
HIDALGO,13,CARDONAL,015,SAN MIGUEL JIGUI,3,127,62,65,11
HIDALGO,13,CARDONAL,015,SAN MIGUEL TLAZINTLA,3,226,115,111,16
HIDALGO,13,CARDONAL,015,SANTA TERESA DABOXTHA,3,102,55,47,11
HIDALGO,13,CARDONAL,015,SANTUARIO (SANTUARIO MAPETHÉ),3,222,120,102,16
HIDALGO,13,CARDONAL,015,TEPOZÁN,2,8,4,4,1
HIDALGO,13,CUAUTEPEC DE HINOJOSA,016,ALHUAJOYUCAN,3,72,39,33,6
HIDALGO,13,CUAUTEPEC DE HINOJOSA,016,ALMOLOYA,2,344,170,174,16
HIDALGO,13,CUAUTEPEC DE HINOJOSA,016,BUENOS AIRES,2,53,18,35,3
HIDALGO,13,CUAUTEPEC DE HINOJOSA,016,CEBADITAS,2,55,27,28,3
HIDALGO,13,CUAUTEPEC DE HINOJOSA,016,CERRO VERDE,2,142,80,62,7
HIDALGO,13,CUAUTEPEC DE HINOJOSA,016,CHACALAPA,2,37,18,19,3
HIDALGO,13,CUAUTEPEC DE HINOJOSA,016,CHAPULTEPEC LA PALMA,2,9,4,5,2
HIDALGO,13,CUAUTEPEC DE HINOJOSA,016,CIMA DE TOGO,3,79,42,37,6
HIDALGO,13,CUAUTEPEC DE HINOJOSA,016,COATZETZENGO,2,47,24,23,3
HIDALGO,13,CUAUTEPEC DE HINOJOSA,016,CUAUTEPEC,35,6120,3071,3049,318
HIDALGO,13,CUAUTEPEC DE HINOJOSA,016,EL ASERRADERO,3,229,118,111,11
HIDALGO,13,CUAUTEPEC DE HINOJOSA,016,EL ATORÓN,1,5,4,1,1
HIDALGO,13,CUAUTEPEC DE HINOJOSA,016,EL CAPULÍN,2,174,83,91,8
HIDALGO,13,CUAUTEPEC DE HINOJOSA,016,EL COYUCO,3,74,38,36,5
HIDALGO,13,CUAUTEPEC DE HINOJOSA,016,EL DURAZNO,3,149,67,82,11
HIDALGO,13,CUAUTEPEC DE HINOJOSA,016,EL ENCINAL,2,50,24,26,3
HIDALGO,13,CUAUTEPEC DE HINOJOSA,016,EL JARILLAL,3,31,11,20,4
HIDALGO,13,CUAUTEPEC DE HINOJOSA,016,EL NECTARIO,2,19,9,10,2
HIDALGO,13,CUAUTEPEC DE HINOJOSA,016,EL RANCHERO,3,40,24,16,4
HIDALGO,13,CUAUTEPEC DE HINOJOSA,016,EL TEPEYAC,2,285,134,151,14
HIDALGO,13,CUAUTEPEC DE HINOJOSA,016,GUADALUPE VICTORIA,5,507,250,257,26
HIDALGO,13,CUAUTEPEC DE HINOJOSA,016,HUEYAPITA,5,344,168,176,17
HIDALGO,13,CUAUTEPEC DE HINOJOSA,016,HUISTONGO,3,39,15,24,5
HIDALGO,13,CUAUTEPEC DE HINOJOSA,016,LA CAÑADA,2,54,29,25,3
HIDALGO,13,CUAUTEPEC DE HINOJOSA,016,LA PALMA,2,10,5,5,1
HIDALGO,13,CUAUTEPEC DE HINOJOSA,016,LA PUERTA DEL YOLO,3,31,11,20,3
HIDALGO,13,CUAUTEPEC DE HINOJOSA,016,LAS ÁNIMAS,3,79,39,40,6
HIDALGO,13,CUAUTEPEC DE HINOJOSA,016,LAS CANOAS,3,37,19,18,4
HIDALGO,13,CUAUTEPEC DE HINOJOSA,016,LAS CONCHAS,2,9,5,4,1
HIDALGO,13,CUAUTEPEC DE HINOJOSA,016,LAS ERAS DE HUISTONGO,2,36,19,17,3
HIDALGO,13,CUAUTEPEC DE HINOJOSA,016,LAS PALMAS,3,168,75,93,9
HIDALGO,13,CUAUTEPEC DE HINOJOSA,016,LAS PUENTES,2,28,12,16,2
HIDALGO,13,CUAUTEPEC DE HINOJOSA,016,LOMA BONITA,1,24,8,16,2
HIDALGO,13,CUAUTEPEC DE HINOJOSA,016,LOMAS DE LOS PINOS,2,30,14,16,3
HIDALGO,13,CUAUTEPEC DE HINOJOSA,016,LOMAS DE OJUILA,3,50,25,25,5
HIDALGO,13,CUAUTEPEC DE HINOJOSA,016,LOS LAURELES,3,15,8,7,3
HIDALGO,13,CUAUTEPEC DE HINOJOSA,016,NUEVE AGUAS,1,5,3,2,1
HIDALGO,13,CUAUTEPEC DE HINOJOSA,016,RANCHO TREJO,3,29,11,18,4
HIDALGO,13,CUAUTEPEC DE HINOJOSA,016,SAN APARICIO,2,39,18,21,3
HIDALGO,13,CUAUTEPEC DE HINOJOSA,016,SAN JOSÉ VISTA HERMOSA,3,54,24,30,4
HIDALGO,13,CUAUTEPEC DE HINOJOSA,016,SAN JUAN HUEYAPAN,2,161,69,92,8
HIDALGO,13,CUAUTEPEC DE HINOJOSA,016,SAN JUAN TECOCOMULCO,1,22,13,9,2
HIDALGO,13,CUAUTEPEC DE HINOJOSA,016,SAN LORENZO SAYULA,3,470,232,238,23
HIDALGO,13,CUAUTEPEC DE HINOJOSA,016,SAN RAFAEL MAZATEPEC,2,22,10,12,2
HIDALGO,13,CUAUTEPEC DE HINOJOSA,016,SANTA ELENA PALISECA,8,769,370,399,38
HIDALGO,13,CUAUTEPEC DE HINOJOSA,016,SANTA MARÍA NATIVITAS,3,467,241,226,20
HIDALGO,13,CUAUTEPEC DE HINOJOSA,016,TECOCOMULCO DE JUÁREZ,5,576,298,278,40
HIDALGO,13,CUAUTEPEC DE HINOJOSA,016,TEXCALTEPEC,2,179,76,103,9
HIDALGO,13,CUAUTEPEC DE HINOJOSA,016,TEZONCUALPAN,3,238,109,129,11
HIDALGO,13,CUAUTEPEC DE HINOJOSA,016,TEZOQUIPA,3,33,17,16,3
HIDALGO,13,CUAUTEPEC DE HINOJOSA,016,XAYAHUALULCO,2,42,16,26,3
HIDALGO,13,CUAUTEPEC DE HINOJOSA,016,XOCOPA,2,59,27,32,4
HIDALGO,13,CHAPANTONGO,017,BARRIO REMEDIOS,1,8,5,3,1
HIDALGO,13,CHAPANTONGO,017,BATHI,1,11,6,5,2
HIDALGO,13,CHAPANTONGO,017,CHAPANTONGO,7,1015,550,465,59
HIDALGO,13,CHAPANTONGO,017,CHAPULACO,1,8,4,4,1
HIDALGO,13,CHAPANTONGO,017,COLONIA FÉLIX OLVERA,3,70,41,29,6
HIDALGO,13,CHAPANTONGO,017,DEXHA,1,32,10,22,2
HIDALGO,13,CHAPANTONGO,017,EL CAPULÍN,3,47,24,23,3
HIDALGO,13,CHAPANTONGO,017,EL COLORADO (CERRO COLORADO),2,6,3,3,1
HIDALGO,13,CHAPANTONGO,017,EL HUIZACHAL (SAN ISIDRO),1,17,9,8,2
HIDALGO,13,CHAPANTONGO,017,JUCHITLÁN,2,26,17,9,3
HIDALGO,13,CHAPANTONGO,017,NUEVA SANTA LUCÍA,3,64,34,30,5
HIDALGO,13,CHAPANTONGO,017,RANCHO NUEVO,2,6,3,3,1
HIDALGO,13,CHAPANTONGO,017,SAN BARTOLO OZOCALPAN,3,257,120,137,12
HIDALGO,13,CHAPANTONGO,017,SAN JOSÉ EL MARQUÉS (ESCANDÓN),3,42,21,21,5
HIDALGO,13,CHAPANTONGO,017,SAN JUAN EL SABINO,2,88,35,53,7
HIDALGO,13,CHAPANTONGO,017,SANTA MARÍA AMEALCO,3,418,211,207,21
HIDALGO,13,CHAPANTONGO,017,TAXHUE,1,6,3,3,1
HIDALGO,13,CHAPANTONGO,017,TENERÍA,2,6,3,3,1
HIDALGO,13,CHAPANTONGO,017,TLAUNILOLPAN,3,307,136,171,16
HIDALGO,13,CHAPANTONGO,017,TOXTHE,2,19,7,12,2
HIDALGO,13,CHAPANTONGO,017,ZIMAPANTONGO,2,42,20,22,3
HIDALGO,13,CHAPULHUACÁN,018,AHUAYO,4,97,45,52,7
HIDALGO,13,CHAPULHUACÁN,018,AMIXCO,2,7,3,4,1
HIDALGO,13,CHAPULHUACÁN,018,ARROYO BLANCO,3,54,24,30,4
HIDALGO,13,CHAPULHUACÁN,018,BARRIO ARRIBA OJO DE AGUA,3,38,19,19,4
HIDALGO,13,CHAPULHUACÁN,018,BUENOS AIRES,2,26,10,16,3
HIDALGO,13,CHAPULHUACÁN,018,CAHUAZAS (HACIENDA DE CAHUAZAS),4,255,137,118,14
HIDALGO,13,CHAPULHUACÁN,018,CARRIZAL DE TENANGO,2,7,2,5,1
HIDALGO,13,CHAPULHUACÁN,018,CARRIZAL DEL SÓTANO,2,28,10,18,2
HIDALGO,13,CHAPULHUACÁN,018,CHAPULHUACÁN,6,1201,585,616,55
HIDALGO,13,CHAPULHUACÁN,018,EL ÁLAMO,2,16,7,9,2
HIDALGO,13,CHAPULHUACÁN,018,EL AMOLAR,2,30,10,20,2
HIDALGO,13,CHAPULHUACÁN,018,EL BANCO,2,32,13,19,3
HIDALGO,13,CHAPULHUACÁN,018,EL BARRIO (BARRIO DEL CARMEN),4,336,192,144,31
HIDALGO,13,CHAPULHUACÁN,018,EL CAMPANARIO,2,4,2,2,1
HIDALGO,13,CHAPULHUACÁN,018,EL CAPULÍN,2,42,22,20,3
HIDALGO,13,CHAPULHUACÁN,018,EL COYOL,4,199,108,91,12
HIDALGO,13,CHAPULHUACÁN,018,EL HUALUL,1,10,6,4,2
HIDALGO,13,CHAPULHUACÁN,018,EL LIMONCITO,2,14,5,9,2
HIDALGO,13,CHAPULHUACÁN,018,EL OCOTE,2,19,11,8,2
HIDALGO,13,CHAPULHUACÁN,018,EL PESCADO,3,20,13,7,4
HIDALGO,13,CHAPULHUACÁN,018,EL SABINO,2,9,6,3,1
HIDALGO,13,CHAPULHUACÁN,018,EL SÓTANO,3,72,34,38,5
HIDALGO,13,CHAPULHUACÁN,018,EL ZACATAL,3,43,16,27,4
HIDALGO,13,CHAPULHUACÁN,018,HUATEPANGO,3,73,40,33,5
HIDALGO,13,CHAPULHUACÁN,018,IGLESIA VIEJA (IGLESIA NUEVA),3,155,83,72,10
HIDALGO,13,CHAPULHUACÁN,018,LA CEIBA,2,15,10,5,1
HIDALGO,13,CHAPULHUACÁN,018,LA CEIBITA,1,9,3,6,1
HIDALGO,13,CHAPULHUACÁN,018,LA ESCONDIDA,3,45,20,25,4
HIDALGO,13,CHAPULHUACÁN,018,LA ESTANCIA,2,9,4,5,2
HIDALGO,13,CHAPULHUACÁN,018,LA HONDURA,3,48,20,28,5
HIDALGO,13,CHAPULHUACÁN,018,LA LOMA,3,113,49,64,7
HIDALGO,13,CHAPULHUACÁN,018,LA LOMITA,1,1,1,0,1
HIDALGO,13,CHAPULHUACÁN,018,LA MESA,3,134,76,58,8
HIDALGO,13,CHAPULHUACÁN,018,LA PIEDRA,2,41,27,14,3
HIDALGO,13,CHAPULHUACÁN,018,LA REFORMA DE PALO SEMITA,1,22,12,10,2
HIDALGO,13,CHAPULHUACÁN,018,LA SIERRITA,2,12,5,7,2
HIDALGO,13,CHAPULHUACÁN,018,LA VEGA,2,11,7,4,2
HIDALGO,13,CHAPULHUACÁN,018,LAS CIRUELAS,2,30,21,9,4
HIDALGO,13,CHAPULHUACÁN,018,LAS MINAS,3,55,23,32,5
HIDALGO,13,CHAPULHUACÁN,018,MIAHUATLA,3,47,26,21,4
HIDALGO,13,CHAPULHUACÁN,018,NEBLINAS,3,101,45,56,7
HIDALGO,13,CHAPULHUACÁN,018,NUEVO COYOLAR,2,5,4,1,1
HIDALGO,13,CHAPULHUACÁN,018,NUEVO PORVENIR [COLONIA],1,446,249,197,64
HIDALGO,13,CHAPULHUACÁN,018,OJO DE AGUA,2,16,8,8,2
HIDALGO,13,CHAPULHUACÁN,018,PALO SEMITA,3,131,58,73,8
HIDALGO,13,CHAPULHUACÁN,018,PALO VERDE,3,52,25,27,4
HIDALGO,13,CHAPULHUACÁN,018,PALOMAS,3,56,33,23,6
HIDALGO,13,CHAPULHUACÁN,018,PARED GRUESA (NUEVO PARED GRUESA),1,6,3,3,1
HIDALGO,13,CHAPULHUACÁN,018,PIEDRA ANCHA,1,5,4,1,1
HIDALGO,13,CHAPULHUACÁN,018,PLAN DE GUADALUPE,3,38,25,13,5
HIDALGO,13,CHAPULHUACÁN,018,PUERTO DEL AMOLAR,2,11,5,6,3
HIDALGO,13,CHAPULHUACÁN,018,PUERTO OBSCURO,3,118,68,50,7
HIDALGO,13,CHAPULHUACÁN,018,RANCHO NUEVO,3,8,4,4,2
HIDALGO,13,CHAPULHUACÁN,018,RANCHO NUEVO (PUERTO DEL GALLO),2,6,3,3,1
HIDALGO,13,CHAPULHUACÁN,018,SAN RAFAEL,4,181,91,90,13
HIDALGO,13,CHAPULHUACÁN,018,SANTA ANA DE ALLENDE,4,688,333,355,45
HIDALGO,13,CHAPULHUACÁN,018,SANTA MARÍA DE ÁLAMOS,2,68,40,28,4
HIDALGO,13,CHAPULHUACÁN,018,SAUCILLO (SAUCILLO AGUA NUEVA),3,60,27,33,5
HIDALGO,13,CHAPULHUACÁN,018,SOLEDAD DEL COYOL,3,81,37,44,6
HIDALGO,13,CHAPULHUACÁN,018,TENANGO,3,127,43,84,8
HIDALGO,13,CHAPULHUACÁN,018,TETLALPAN,4,155,80,75,10
HIDALGO,13,CHAPULHUACÁN,018,TOCAPA,2,20,7,13,2
HIDALGO,13,CHAPULHUACÁN,018,ZACATE GRANDE,2,78,42,36,4
HIDALGO,13,CHILCUAUTLA,019,BENITO JUÁREZ (LA RINCONADA) [COLONIA],2,75,34,41,6
HIDALGO,13,CHILCUAUTLA,019,BOXAXNI,2,28,15,13,3
HIDALGO,13,CHILCUAUTLA,019,CERRO COLORADO,2,87,44,43,7
HIDALGO,13,CHILCUAUTLA,019,CERRO DEL CORAZÓN (EL MUÍ),2,17,8,9,2
HIDALGO,13,CHILCUAUTLA,019,CHILCUAUTLA,5,877,424,453,64
HIDALGO,13,CHILCUAUTLA,019,EL BETHÍ,4,228,115,113,15
HIDALGO,13,CHILCUAUTLA,019,EL DADHÓ,2,93,40,53,8
HIDALGO,13,CHILCUAUTLA,019,EL DECA,2,24,13,11,4
HIDALGO,13,CHILCUAUTLA,019,EL DONTZHÍ (COLONIA ÁLAMOS),2,58,31,27,5
HIDALGO,13,CHILCUAUTLA,019,EL MEJAY,2,67,35,32,7
HIDALGO,13,CHILCUAUTLA,019,EL TANDHE,1,6,2,4,1
HIDALGO,13,CHILCUAUTLA,019,EL XOTHÍ,5,170,81,89,14
HIDALGO,13,CHILCUAUTLA,019,HUITEXCALCO [COLONIA],2,173,76,97,8
HIDALGO,13,CHILCUAUTLA,019,HUITEXCALCO DE MORELOS,3,218,102,116,12
HIDALGO,13,CHILCUAUTLA,019,LA ESTANCIA,2,150,68,82,9
HIDALGO,13,CHILCUAUTLA,019,LA LOMA,1,4,1,3,1
HIDALGO,13,CHILCUAUTLA,019,LLANO PRIMERO,2,40,19,21,5
HIDALGO,13,CHILCUAUTLA,019,SANTA ANA BATHA,6,735,336,399,40
HIDALGO,13,CHILCUAUTLA,019,TEXCATEPEC,4,293,133,160,14
HIDALGO,13,CHILCUAUTLA,019,TLACOTLAPILCO,2,161,79,82,9
HIDALGO,13,CHILCUAUTLA,019,TUNITITLÁN,5,710,332,378,54
HIDALGO,13,CHILCUAUTLA,019,ZACUALOYA,2,32,22,10,2
HIDALGO,13,ELOXOCHITLÁN,020,ELOXOCHITLÁN,4,113,55,58,10
HIDALGO,13,ELOXOCHITLÁN,020,HUALULA (SAN JUAN HUALULA),4,257,121,136,14
HIDALGO,13,ELOXOCHITLÁN,020,ITZTACAPA,2,6,2,4,1
HIDALGO,13,ELOXOCHITLÁN,020,LA PUNTA DE HUALULA (LA PUNTA DE CERRO),1,3,1,2,1
HIDALGO,13,ELOXOCHITLÁN,020,OTATLA,1,7,3,4,1
HIDALGO,13,ELOXOCHITLÁN,020,SAN JUAN AMAJAQUE,2,37,16,21,2
HIDALGO,13,ELOXOCHITLÁN,020,SAN PEDRO GILO (GILO),3,20,11,9,2
HIDALGO,13,ELOXOCHITLÁN,020,TECOMATE,1,9,3,6,2
HIDALGO,13,ELOXOCHITLÁN,020,TEPEYICA,3,38,21,17,5
HIDALGO,13,EMILIANO ZAPATA,021,EMILIANO ZAPATA,12,2214,1079,1135,127
HIDALGO,13,EMILIANO ZAPATA,021,JOSÉ MARÍA MORELOS (SAN JOSÉ),3,289,124,165,14
HIDALGO,13,EMILIANO ZAPATA,021,SANTA BÁRBARA,2,168,86,82,8
HIDALGO,13,EMILIANO ZAPATA,021,SANTA CLARA,2,184,97,87,8
HIDALGO,13,EPAZOYUCAN,022,EL GUAJOLOTE,2,19,9,10,2
HIDALGO,13,EPAZOYUCAN,022,EL MANZANO,2,28,15,13,4
HIDALGO,13,EPAZOYUCAN,022,EL NOPALILLO,3,146,69,77,9
HIDALGO,13,EPAZOYUCAN,022,EL OCOTE CHICO,2,47,26,21,3
HIDALGO,13,EPAZOYUCAN,022,EL SALTO,1,6,2,4,1
HIDALGO,13,EPAZOYUCAN,022,EPAZOYUCAN,5,860,404,456,39
HIDALGO,13,EPAZOYUCAN,022,ESCOBILLAS,2,58,28,30,3
HIDALGO,13,EPAZOYUCAN,022,LA PALOMA,1,6,2,4,1
HIDALGO,13,EPAZOYUCAN,022,SAN FRANCISCO,1,5,2,3,1
HIDALGO,13,EPAZOYUCAN,022,SAN JUAN TIZAHUAPAN,4,264,126,138,14
HIDALGO,13,EPAZOYUCAN,022,SAN MIGUEL NOPALAPA,2,219,112,107,9
HIDALGO,13,EPAZOYUCAN,022,SAN VICENTE,2,9,6,3,2
HIDALGO,13,EPAZOYUCAN,022,SANTA MÓNICA,4,669,327,342,32
HIDALGO,13,EPAZOYUCAN,022,XOCHIHUACÁN,3,245,117,128,11
HIDALGO,13,EPAZOYUCAN,022,XOCHIHUACÁN [FRACCIONAMIENTO],2,146,72,74,9
HIDALGO,13,EPAZOYUCAN,022,XOLOSTITLA DE MORELOS (XOLOSTITLA),3,166,82,84,11
HIDALGO,13,FRANCISCO I. MADERO,023,ARAMBÓ,2,101,60,41,8
HIDALGO,13,FRANCISCO I. MADERO,023,BARRIO NUEVO MÉXICO,1,12,7,5,1
HIDALGO,13,FRANCISCO I. MADERO,023,BOCAMIÑO,2,124,65,59,7
HIDALGO,13,FRANCISCO I. MADERO,023,DENGANTZHA,6,474,217,257,27
HIDALGO,13,FRANCISCO I. MADERO,023,DOCTOR JOSÉ G. PARRES,2,71,35,36,5
HIDALGO,13,FRANCISCO I. MADERO,023,EL HORNO [COLONIA],2,51,30,21,4
HIDALGO,13,FRANCISCO I. MADERO,023,EL MENDOZA,2,21,8,13,3
HIDALGO,13,FRANCISCO I. MADERO,023,EL ROSARIO,5,476,250,226,36
HIDALGO,13,FRANCISCO I. MADERO,023,EL ROSARIO [COLONIA],2,159,86,73,8
HIDALGO,13,FRANCISCO I. MADERO,023,EL VEINTE [COLONIA],2,34,14,20,4
HIDALGO,13,FRANCISCO I. MADERO,023,LA COMUNIDAD,2,21,9,12,3
HIDALGO,13,FRANCISCO I. MADERO,023,LA CRUZ,2,80,40,40,9
HIDALGO,13,FRANCISCO I. MADERO,023,LA MORA,2,72,41,31,5
HIDALGO,13,FRANCISCO I. MADERO,023,LA PUERTA,2,58,25,33,5
HIDALGO,13,FRANCISCO I. MADERO,023,LAS CORONAS,1,17,6,11,2
HIDALGO,13,FRANCISCO I. MADERO,023,LÁZARO CÁRDENAS (EL MEXE) [COLONIA],6,4060,1903,2157,226
HIDALGO,13,FRANCISCO I. MADERO,023,LOS FILTROS,2,16,8,8,2
HIDALGO,13,FRANCISCO I. MADERO,023,LOS HOYOS,5,1045,506,539,90
HIDALGO,13,FRANCISCO I. MADERO,023,SAN JOSÉ BOXAY,2,107,55,52,7
HIDALGO,13,FRANCISCO I. MADERO,023,SAN JUAN TEPA,8,972,473,499,59
HIDALGO,13,FRANCISCO I. MADERO,023,TEPATEPEC,17,2811,1411,1400,155
HIDALGO,13,HUASCA DE OCAMPO,024,AGUA ZARCA,2,35,20,15,3
HIDALGO,13,HUASCA DE OCAMPO,024,BARRANCA DE TLAXOCOYUCAN,2,12,8,4,2
HIDALGO,13,HUASCA DE OCAMPO,024,BERMÚDEZ,1,12,4,8,2
HIDALGO,13,HUASCA DE OCAMPO,024,CERRITOS,2,44,20,24,4
HIDALGO,13,HUASCA DE OCAMPO,024,CERRO DEL TEZONTLE,1,5,5,0,1
HIDALGO,13,HUASCA DE OCAMPO,024,CUESTA DE OCOTILLOS,2,5,5,0,1
HIDALGO,13,HUASCA DE OCAMPO,024,EL HUARICHE,1,10,4,6,1
HIDALGO,13,HUASCA DE OCAMPO,024,EL JILOTILLO,3,358,209,149,25
HIDALGO,13,HUASCA DE OCAMPO,024,EL PERAL,2,54,24,30,3
HIDALGO,13,HUASCA DE OCAMPO,024,EL VITE,4,48,22,26,5
HIDALGO,13,HUASCA DE OCAMPO,024,HUASCA DE OCAMPO,1,299,157,142,12
HIDALGO,13,HUASCA DE OCAMPO,024,LA CAÑADA,4,96,39,57,10
HIDALGO,13,HUASCA DE OCAMPO,024,LA LOMA,3,248,129,119,21
HIDALGO,13,HUASCA DE OCAMPO,024,LAS MESAS DE TLAXOCOYUCAN,2,34,12,22,3
HIDALGO,13,HUASCA DE OCAMPO,024,LLANO GRANDE,2,39,19,20,4
HIDALGO,13,HUASCA DE OCAMPO,024,LOS REYES TEPEZALA,2,49,22,27,4
HIDALGO,13,HUASCA DE OCAMPO,024,MAGUEYES VERDES,4,132,59,73,9
HIDALGO,13,HUASCA DE OCAMPO,024,OJO DE AGUA,3,105,55,50,7
HIDALGO,13,HUASCA DE OCAMPO,024,PALMA ANTIGUA EL VITE,1,14,7,7,1
HIDALGO,13,HUASCA DE OCAMPO,024,PALMILLAS,3,27,14,13,3
HIDALGO,13,HUASCA DE OCAMPO,024,RÍO SECO PUENTE DE DORIA,3,424,201,223,20
HIDALGO,13,HUASCA DE OCAMPO,024,SAN BARTOLOMÉ (SAN BARTOLO),2,21,11,10,3
HIDALGO,13,HUASCA DE OCAMPO,024,SAN JERÓNIMO,2,94,46,48,5
HIDALGO,13,HUASCA DE OCAMPO,024,SAN JOSÉ CACALOAPAN,2,73,31,42,4
HIDALGO,13,HUASCA DE OCAMPO,024,SAN JOSÉ OCOTILLOS,2,144,64,80,8
HIDALGO,13,HUASCA DE OCAMPO,024,SAN JUAN HUEYAPAN,2,52,30,22,3
HIDALGO,13,HUASCA DE OCAMPO,024,SAN JUAN TLAXOCOYUCAN,1,5,4,1,1
HIDALGO,13,HUASCA DE OCAMPO,024,SAN LORENZO EL ZEMBO,2,37,20,17,3
HIDALGO,13,HUASCA DE OCAMPO,024,SAN MIGUEL CACALOAPAN,2,43,22,21,3
HIDALGO,13,HUASCA DE OCAMPO,024,SAN MIGUEL REGLA,3,924,460,464,41
HIDALGO,13,HUASCA DE OCAMPO,024,SAN PABLO OJO DE AGUA,2,138,73,65,8
HIDALGO,13,HUASCA DE OCAMPO,024,SAN SEBASTIÁN (SAN SEBASTIÁN LA BARRANCA),3,30,16,14,3
HIDALGO,13,HUASCA DE OCAMPO,024,SANTA MARÍA REGLA,1,9,2,7,1
HIDALGO,13,HUASCA DE OCAMPO,024,SANTO DOMINGO AGUA ZARCA,4,148,71,77,11
HIDALGO,13,HUASCA DE OCAMPO,024,SANTO TOMÁS ALLENDE,3,180,87,93,11
HIDALGO,13,HUASCA DE OCAMPO,024,TLAXOCOYUCAN,4,223,109,114,14
HIDALGO,13,HUASCA DE OCAMPO,024,XÚCHIL EL LLANO,2,28,13,15,2
HIDALGO,13,HUAUTLA,025,14 DE MAYO,2,10,5,5,1
HIDALGO,13,HUAUTLA,025,ACATEPEC,4,323,143,180,18
HIDALGO,13,HUAUTLA,025,AHUATITLA,3,89,44,45,7
HIDALGO,13,HUAUTLA,025,AHUEHUETL,2,53,23,30,4
HIDALGO,13,HUAUTLA,025,AQUETZPALCO,2,62,32,30,7
HIDALGO,13,HUAUTLA,025,BANDERAS,2,45,25,20,4
HIDALGO,13,HUAUTLA,025,CHALACUACO,2,4,1,3,1
HIDALGO,13,HUAUTLA,025,CHALINGO,3,69,32,37,7
HIDALGO,13,HUAUTLA,025,CHIATITLA,1,4,2,2,1
HIDALGO,13,HUAUTLA,025,CHILITECO,3,63,35,28,6
HIDALGO,13,HUAUTLA,025,CHIPILA,2,21,6,15,3
HIDALGO,13,HUAUTLA,025,COAMITLA,2,19,11,8,2
HIDALGO,13,HUAUTLA,025,COAPANTLA,2,17,7,10,2
HIDALGO,13,HUAUTLA,025,COATEMPA,1,3,0,3,1
HIDALGO,13,HUAUTLA,025,COATENÁHUATL,2,36,13,23,3
HIDALGO,13,HUAUTLA,025,COATZACOATL,2,41,22,19,4
HIDALGO,13,HUAUTLA,025,COATZONCO,3,96,50,46,7
HIDALGO,13,HUAUTLA,025,EL AGUACATE,2,32,16,16,3
HIDALGO,13,HUAUTLA,025,EL BARBECHO,2,42,24,18,4
HIDALGO,13,HUAUTLA,025,EL COJOLITE,1,5,2,3,1
HIDALGO,13,HUAUTLA,025,EL IXTLE,4,202,95,107,11
HIDALGO,13,HUAUTLA,025,EL LINDERO,3,67,29,38,7
HIDALGO,13,HUAUTLA,025,HERNÁNDEZTLA,2,39,15,24,3
HIDALGO,13,HUAUTLA,025,HUAUTLA,8,1318,626,692,69
HIDALGO,13,HUAUTLA,025,HUAZALINGUILLO,3,112,64,48,10
HIDALGO,13,HUAUTLA,025,HUEMACO,2,31,15,16,3
HIDALGO,13,HUAUTLA,025,HUITZOTLACO,1,10,6,4,1
HIDALGO,13,HUAUTLA,025,IXTLAHUAC,2,35,19,16,3
HIDALGO,13,HUAUTLA,025,LA MESA,3,80,44,36,7
HIDALGO,13,HUAUTLA,025,LA PUERTA,3,603,313,290,70
HIDALGO,13,HUAUTLA,025,LOS CEREZOS,2,50,30,20,5
HIDALGO,13,HUAUTLA,025,LOS PUENTES,2,35,15,20,3
HIDALGO,13,HUAUTLA,025,METLATEPEC,3,64,33,31,7
HIDALGO,13,HUAUTLA,025,MILKAUAL,2,35,23,12,2
HIDALGO,13,HUAUTLA,025,PAHUATITLA,3,61,24,37,4
HIDALGO,13,HUAUTLA,025,PEPEYOCA DE CABRERA,3,53,25,28,5
HIDALGO,13,HUAUTLA,025,PILTEPECO,2,24,13,11,2
HIDALGO,13,HUAUTLA,025,SANTO DOMINGO,3,58,27,31,6
HIDALGO,13,HUAUTLA,025,TAMOYÓN I,4,420,217,203,20
HIDALGO,13,HUAUTLA,025,TAMOYÓN II,1,11,7,4,1
HIDALGO,13,HUAUTLA,025,TECOLUCO CALPAN,1,61,28,33,4
HIDALGO,13,HUAUTLA,025,TEPECO,3,79,35,44,9
HIDALGO,13,HUAUTLA,025,TEPETZINTLA,2,50,29,21,3
HIDALGO,13,HUAUTLA,025,TEPEXQUIMITL,1,17,3,14,2
HIDALGO,13,HUAUTLA,025,TERRERO,2,34,20,14,3
HIDALGO,13,HUAUTLA,025,TLACUAPAN,2,78,40,38,7
HIDALGO,13,HUAUTLA,025,TLALPANE,2,16,13,3,2
HIDALGO,13,HUAUTLA,025,TOHUACO AMATZINTLA (TOHUACO III),2,8,3,5,1
HIDALGO,13,HUAUTLA,025,TOHUACO I,2,36,18,18,3
HIDALGO,13,HUAUTLA,025,TOHUACO II,2,143,57,86,8
HIDALGO,13,HUAUTLA,025,TZACUALA,3,77,41,36,9
HIDALGO,13,HUAUTLA,025,VICENTE GUERRERO,2,51,23,28,4
HIDALGO,13,HUAUTLA,025,VINASCO,1,9,4,5,1
HIDALGO,13,HUAUTLA,025,XÓCHITL,2,34,16,18,3
HIDALGO,13,HUAUTLA,025,ZACATIPA,3,75,30,45,7
HIDALGO,13,HUAZALINGO,026,AHUATITLA,2,56,27,29,4
HIDALGO,13,HUAZALINGO,026,ÁMAXAC,2,29,17,12,3
HIDALGO,13,HUAZALINGO,026,CHIATIPÁN,4,388,182,206,22
HIDALGO,13,HUAZALINGO,026,COMALA,2,18,9,9,2
HIDALGO,13,HUAZALINGO,026,CONGRESO,2,54,31,23,5
HIDALGO,13,HUAZALINGO,026,COPALTITLA,3,79,37,42,6
HIDALGO,13,HUAZALINGO,026,CUAMONTAX,4,265,135,130,15
HIDALGO,13,HUAZALINGO,026,HUAZALINGO,4,495,244,251,28
HIDALGO,13,HUAZALINGO,026,HUILOTITLA I,2,34,15,19,3
HIDALGO,13,HUAZALINGO,026,HUILOTITLA II,2,26,13,13,3
HIDALGO,13,HUAZALINGO,026,IXTLAHUAC,3,78,40,38,7
HIDALGO,13,HUAZALINGO,026,LA CEIBA,2,51,25,26,4
HIDALGO,13,HUAZALINGO,026,MAZAHAPA,1,21,13,8,2
HIDALGO,13,HUAZALINGO,026,OTECOCH,3,33,17,16,4
HIDALGO,13,HUAZALINGO,026,PILCHIATIPA,3,167,95,72,11
HIDALGO,13,HUAZALINGO,026,SAN FRANCISCO,4,458,231,227,31
HIDALGO,13,HUAZALINGO,026,SAN JUAN,2,53,28,25,5
HIDALGO,13,HUAZALINGO,026,SAN PEDRO,3,167,92,75,11
HIDALGO,13,HUAZALINGO,026,SANTA MARÍA,3,55,27,28,5
HIDALGO,13,HUAZALINGO,026,SANTO TOMÁS (CUAXAHUAL),3,250,116,134,14
HIDALGO,13,HUAZALINGO,026,TEPEMAXAC,2,24,8,16,3
HIDALGO,13,HUAZALINGO,026,TETLICUIL,2,12,4,8,2
HIDALGO,13,HUAZALINGO,026,TLAMAMALA,3,107,49,58,11
HIDALGO,13,HUAZALINGO,026,TLATZONCO,3,73,35,38,7
HIDALGO,13,HUAZALINGO,026,TZAPOTITLA,2,27,15,12,3
HIDALGO,13,HUAZALINGO,026,ZOQUICUALOYA,2,21,8,13,3
HIDALGO,13,HUEHUETLA,027,ACUAUTLA,4,104,46,58,12
HIDALGO,13,HUEHUETLA,027,BARRIO AZTLÁN,4,258,125,133,15
HIDALGO,13,HUEHUETLA,027,CANTARRANAS,2,8,5,3,2
HIDALGO,13,HUEHUETLA,027,CERRO DE CHAPINGO,1,10,3,7,1
HIDALGO,13,HUEHUETLA,027,CERRO DEL TOMATE,3,18,10,8,3
HIDALGO,13,HUEHUETLA,027,CHAPINGO,2,29,14,15,3
HIDALGO,13,HUEHUETLA,027,DOS CAMINOS,2,40,23,17,4
HIDALGO,13,HUEHUETLA,027,EL BORBOLLÓN,3,29,14,15,3
HIDALGO,13,HUEHUETLA,027,EL CAJÓN,3,8,3,5,2
HIDALGO,13,HUEHUETLA,027,EL CHAMIZAL,3,13,6,7,2
HIDALGO,13,HUEHUETLA,027,EL CHOTE,2,16,6,10,2
HIDALGO,13,HUEHUETLA,027,EL DENXE,2,8,5,3,1
HIDALGO,13,HUEHUETLA,027,EL DEXTHO,1,20,6,14,3
HIDALGO,13,HUEHUETLA,027,EL ENCINAL,2,21,9,12,3
HIDALGO,13,HUEHUETLA,027,EL OCOTAL,4,229,140,89,15
HIDALGO,13,HUEHUETLA,027,EL PADHÍ,3,53,26,27,5
HIDALGO,13,HUEHUETLA,027,EL PARAÍSO,2,24,11,13,2
HIDALGO,13,HUEHUETLA,027,EL PLAN DEL RECREO,1,21,14,7,1
HIDALGO,13,HUEHUETLA,027,EL TEMPESQUITE,3,35,13,22,5
HIDALGO,13,HUEHUETLA,027,EL XOÑE,3,32,17,15,6
HIDALGO,13,HUEHUETLA,027,HERMANOS GALEANA,2,4,0,4,1
HIDALGO,13,HUEHUETLA,027,HUEHUETLA,4,646,335,311,38
HIDALGO,13,HUEHUETLA,027,JUNTAS CHICAS,5,192,107,85,17
HIDALGO,13,HUEHUETLA,027,LA ESMERALDA,2,12,6,6,1
HIDALGO,13,HUEHUETLA,027,LA ESPERANZA NÚMERO 1,3,58,27,31,7
HIDALGO,13,HUEHUETLA,027,LA ESPERANZA NÚMERO DOS,2,20,11,9,2
HIDALGO,13,HUEHUETLA,027,LA JOYA,1,11,0,11,1
HIDALGO,13,HUEHUETLA,027,LA PAHUA,1,526,272,254,21
HIDALGO,13,HUEHUETLA,027,LA PIMIENTA,2,18,9,9,2
HIDALGO,13,HUEHUETLA,027,LA PIÑA,2,4,1,3,1
HIDALGO,13,HUEHUETLA,027,LA TORTUGA,1,15,6,9,2
HIDALGO,13,HUEHUETLA,027,LAS AULAS,3,177,89,88,13
HIDALGO,13,HUEHUETLA,027,LINDA VISTA I (MIRASOL),3,98,50,48,8
HIDALGO,13,HUEHUETLA,027,LINDA VISTA II,2,26,11,15,2
HIDALGO,13,HUEHUETLA,027,LOMA DE BUENAVISTA,1,9,4,5,1
HIDALGO,13,HUEHUETLA,027,LOS NARANJOS,1,7,4,3,1
HIDALGO,13,HUEHUETLA,027,LOS PLANES,2,41,22,19,3
HIDALGO,13,HUEHUETLA,027,PALO VERDE,4,64,37,27,7
HIDALGO,13,HUEHUETLA,027,POZA GRANDE,3,31,12,19,4
HIDALGO,13,HUEHUETLA,027,RÍO BELTRÁN,4,54,25,29,6
HIDALGO,13,HUEHUETLA,027,RÍO BLANCO,3,37,21,16,4
HIDALGO,13,HUEHUETLA,027,SAN AMBROSIO,5,239,125,114,20
HIDALGO,13,HUEHUETLA,027,SAN ANTONIO EL GRANDE,6,655,335,320,37
HIDALGO,13,HUEHUETLA,027,SAN CLEMENTE,3,256,101,155,14
HIDALGO,13,HUEHUETLA,027,SAN ESTEBAN,5,437,215,222,29
HIDALGO,13,HUEHUETLA,027,SAN GREGORIO,5,288,149,139,18
HIDALGO,13,HUEHUETLA,027,SAN GUILLERMO,1,7,4,3,1
HIDALGO,13,HUEHUETLA,027,SAN LORENZO ACHIOTEPEC,6,461,215,246,30
HIDALGO,13,HUEHUETLA,027,SANTA INÉS,3,117,61,56,12
HIDALGO,13,HUEHUETLA,027,SANTA ÚRSULA,6,352,170,182,25
HIDALGO,13,HUEHUETLA,027,TIERRA AMARILLA,1,3,2,1,1
HIDALGO,13,HUEHUETLA,027,VISTA HERMOSA,3,21,9,12,3
HIDALGO,13,HUEJUTLA DE REYES,028,ACAYAHUAL,2,38,17,21,3
HIDALGO,13,HUEJUTLA DE REYES,028,ACHICHÍPIL,2,19,12,7,3
HIDALGO,13,HUEJUTLA DE REYES,028,ACOYOTIPA,2,16,5,11,2
HIDALGO,13,HUEJUTLA DE REYES,028,ACUAPA,2,168,76,92,10
HIDALGO,13,HUEJUTLA DE REYES,028,ACUATEMPA,3,328,160,168,15
HIDALGO,13,HUEJUTLA DE REYES,028,AGUACATITLA,5,315,160,155,19
HIDALGO,13,HUEJUTLA DE REYES,028,AGUACATITLA IXCATLÁN,1,19,12,7,2
HIDALGO,13,HUEJUTLA DE REYES,028,AHUATEMPA,2,125,59,66,9
HIDALGO,13,HUEJUTLA DE REYES,028,AHUATIPA,1,9,5,4,1
HIDALGO,13,HUEJUTLA DE REYES,028,AHUATITLA I,2,26,12,14,2
HIDALGO,13,HUEJUTLA DE REYES,028,AHUATZINTLA,2,14,6,8,2
HIDALGO,13,HUEJUTLA DE REYES,028,AHUEHUETITLA,2,45,23,22,3
HIDALGO,13,HUEJUTLA DE REYES,028,AMAXAC,2,92,41,51,9
HIDALGO,13,HUEJUTLA DE REYES,028,AMOYAHUAL,2,11,7,4,2
HIDALGO,13,HUEJUTLA DE REYES,028,APETLACO AGUACATITLA,1,11,7,4,1
HIDALGO,13,HUEJUTLA DE REYES,028,APETLACO HUEROTA,3,66,38,28,5
HIDALGO,13,HUEJUTLA DE REYES,028,APÍLOL,2,46,27,19,4
HIDALGO,13,HUEJUTLA DE REYES,028,AQUIXCUATITLA I,5,111,59,52,9
HIDALGO,13,HUEJUTLA DE REYES,028,ATALCO,3,95,45,50,7
HIDALGO,13,HUEJUTLA DE REYES,028,ATAPPA,2,44,26,18,4
HIDALGO,13,HUEJUTLA DE REYES,028,ATEIXCO,3,63,25,38,5
HIDALGO,13,HUEJUTLA DE REYES,028,ATEXALTIPA,3,20,11,9,3
HIDALGO,13,HUEJUTLA DE REYES,028,AXCACO,2,189,81,108,9
HIDALGO,13,HUEJUTLA DE REYES,028,AXIHUIYO,2,33,14,19,3
HIDALGO,13,HUEJUTLA DE REYES,028,BUENA VISTA,3,394,187,207,22
HIDALGO,13,HUEJUTLA DE REYES,028,CACATECO,4,58,24,34,8
HIDALGO,13,HUEJUTLA DE REYES,028,CACATETITLA,2,19,9,10,2
HIDALGO,13,HUEJUTLA DE REYES,028,CALMECATE,2,98,49,49,5
HIDALGO,13,HUEJUTLA DE REYES,028,CANDELARIA,3,238,114,124,16
HIDALGO,13,HUEJUTLA DE REYES,028,CECECAPA,3,77,29,48,5
HIDALGO,13,HUEJUTLA DE REYES,028,CHACHAIXPA,2,17,5,12,3
HIDALGO,13,HUEJUTLA DE REYES,028,CHALAHUITZINTLA,2,37,22,15,3
HIDALGO,13,HUEJUTLA DE REYES,028,CHALAHUIYAPA,4,2354,951,1403,65
HIDALGO,13,HUEJUTLA DE REYES,028,CHILILICO,9,1157,688,469,64
HIDALGO,13,HUEJUTLA DE REYES,028,CHIQUEMECATITLA,3,168,79,89,10
HIDALGO,13,HUEJUTLA DE REYES,028,CHOMAQUICO,2,68,29,39,5
HIDALGO,13,HUEJUTLA DE REYES,028,COACUILCO,8,1532,760,772,108
HIDALGO,13,HUEJUTLA DE REYES,028,COAMILA,2,103,56,47,10
HIDALGO,13,HUEJUTLA DE REYES,028,COAXOCOTITLA,5,304,148,156,21
HIDALGO,13,HUEJUTLA DE REYES,028,COCHISCUATITLA ANEXO IXCATLÁN,2,6,5,1,1
HIDALGO,13,HUEJUTLA DE REYES,028,COCHISCUATITLA LAS CHACAS,2,103,60,43,9
HIDALGO,13,HUEJUTLA DE REYES,028,COCO GRANDE,1,16,9,7,1
HIDALGO,13,HUEJUTLA DE REYES,028,CONGRESO PERMANENTE AGRARIO,3,134,69,65,9
HIDALGO,13,HUEJUTLA DE REYES,028,CONTÉPEC,4,118,55,63,8
HIDALGO,13,HUEJUTLA DE REYES,028,COXHUACO I,1,9,3,6,1
HIDALGO,13,HUEJUTLA DE REYES,028,COXHUACO II,2,90,41,49,6
HIDALGO,13,HUEJUTLA DE REYES,028,COYOLTITLA,2,45,29,16,3
HIDALGO,13,HUEJUTLA DE REYES,028,COYOLTZINTLA,3,56,30,26,5
HIDALGO,13,HUEJUTLA DE REYES,028,COYOTEPEC,2,17,6,11,1
HIDALGO,13,HUEJUTLA DE REYES,028,CRUZTITLA,3,149,63,86,12
HIDALGO,13,HUEJUTLA DE REYES,028,CUACHIQUIAPA,1,10,4,6,1
HIDALGO,13,HUEJUTLA DE REYES,028,CUAPAXTITLA,3,275,136,139,19
HIDALGO,13,HUEJUTLA DE REYES,028,CUATECÓMETL,3,85,47,38,9
HIDALGO,13,HUEJUTLA DE REYES,028,ECUATITLA,2,32,14,18,3
HIDALGO,13,HUEJUTLA DE REYES,028,EL CHOTE,4,134,65,69,11
HIDALGO,13,HUEJUTLA DE REYES,028,EL NARANJAL,2,58,29,29,3
HIDALGO,13,HUEJUTLA DE REYES,028,EL OJITE,2,57,35,22,4
HIDALGO,13,HUEJUTLA DE REYES,028,EL PEMUCHE,2,42,21,21,3
HIDALGO,13,HUEJUTLA DE REYES,028,EL XÚCHITL,2,37,20,17,3
HIDALGO,13,HUEJUTLA DE REYES,028,ESCUATITLA,1,4,2,2,1
HIDALGO,13,HUEJUTLA DE REYES,028,HUACAXTITLA,2,80,43,37,5
HIDALGO,13,HUEJUTLA DE REYES,028,HUEHUETLA,2,104,56,48,7
HIDALGO,13,HUEJUTLA DE REYES,028,HUEJUTLA DE REYES,67,13549,6919,6630,803
HIDALGO,13,HUEJUTLA DE REYES,028,HUITZACHÁHUATL,3,175,77,98,10
HIDALGO,13,HUEJUTLA DE REYES,028,HUITZQUILITITLA,2,65,31,34,4
HIDALGO,13,HUEJUTLA DE REYES,028,HUMOTITLA CANDELARIA,2,103,45,58,8
HIDALGO,13,HUEJUTLA DE REYES,028,ILAMACTLA,2,10,3,7,1
HIDALGO,13,HUEJUTLA DE REYES,028,IXCATÉPEC,3,258,124,134,17
HIDALGO,13,HUEJUTLA DE REYES,028,IXCATLÁN,4,878,404,474,52
HIDALGO,13,HUEJUTLA DE REYES,028,IXCUICUILA,2,37,20,17,3
HIDALGO,13,HUEJUTLA DE REYES,028,IXTLAHUAC,4,62,28,34,5
HIDALGO,13,HUEJUTLA DE REYES,028,LA CORRALA,3,113,54,59,11
HIDALGO,13,HUEJUTLA DE REYES,028,LA CRUZ DE ZOCUITECO,2,76,40,36,4
HIDALGO,13,HUEJUTLA DE REYES,028,LA CURVA TLALTZINTLA,1,19,10,9,1
HIDALGO,13,HUEJUTLA DE REYES,028,LA MESA DE AXCACO,2,23,16,7,3
HIDALGO,13,HUEJUTLA DE REYES,028,LA MESA DE LIMANTITLA,2,93,45,48,8
HIDALGO,13,HUEJUTLA DE REYES,028,LA PASTORA,2,51,26,25,4
HIDALGO,13,HUEJUTLA DE REYES,028,LAS CHACAS,7,215,95,120,20
HIDALGO,13,HUEJUTLA DE REYES,028,LAS NUECES,2,4,1,3,1
HIDALGO,13,HUEJUTLA DE REYES,028,LEMONTITLA,3,79,40,39,5
HIDALGO,13,HUEJUTLA DE REYES,028,LOS HORCONES,2,54,27,27,3
HIDALGO,13,HUEJUTLA DE REYES,028,LOS OTATES,4,626,290,336,40
HIDALGO,13,HUEJUTLA DE REYES,028,LOS PARAJES,3,69,29,40,6
HIDALGO,13,HUEJUTLA DE REYES,028,LOS PARAJES BENITO JUÁREZ,2,36,20,16,3
HIDALGO,13,HUEJUTLA DE REYES,028,MACHETLA,2,116,60,56,8
HIDALGO,13,HUEJUTLA DE REYES,028,MACHETLA II,4,820,425,395,51
HIDALGO,13,HUEJUTLA DE REYES,028,MACUXTEPETLA,6,814,401,413,32
HIDALGO,13,HUEJUTLA DE REYES,028,NEPALAPA,2,14,9,5,1
HIDALGO,13,HUEJUTLA DE REYES,028,OJTLAMEKAYO,2,53,22,31,3
HIDALGO,13,HUEJUTLA DE REYES,028,OXALE,3,41,24,17,4
HIDALGO,13,HUEJUTLA DE REYES,028,OXTOMAL I,2,261,119,142,16
HIDALGO,13,HUEJUTLA DE REYES,028,OXTOMAL II,2,214,101,113,9
HIDALGO,13,HUEJUTLA DE REYES,028,OZULUAMA,2,62,29,33,4
HIDALGO,13,HUEJUTLA DE REYES,028,PAHUATLÁN,2,365,169,196,19
HIDALGO,13,HUEJUTLA DE REYES,028,PAHUATZINTLA,2,37,17,20,3
HIDALGO,13,HUEJUTLA DE REYES,028,PALZOQUIAPA,2,102,47,55,8
HIDALGO,13,HUEJUTLA DE REYES,028,PALZOQUICO,2,32,15,17,3
HIDALGO,13,HUEJUTLA DE REYES,028,PANACAXTLÁN,3,252,125,127,12
HIDALGO,13,HUEJUTLA DE REYES,028,PARQUE DE POBLAMIENTO SOLIDARIDAD,7,5249,2939,2310,276
HIDALGO,13,HUEJUTLA DE REYES,028,PITZONTZINTLA,2,28,16,12,3
HIDALGO,13,HUEJUTLA DE REYES,028,POCHOTITLA,2,61,32,29,4
HIDALGO,13,HUEJUTLA DE REYES,028,POXTLA COACUILCO,2,33,20,13,3
HIDALGO,13,HUEJUTLA DE REYES,028,POXTLA IXCATLÁN,2,61,32,29,5
HIDALGO,13,HUEJUTLA DE REYES,028,RANCHO NUEVO IXCATLÁN,1,16,8,8,1
HIDALGO,13,HUEJUTLA DE REYES,028,RANCHO NUEVO MACUXTEPETLA,2,42,25,17,3
HIDALGO,13,HUEJUTLA DE REYES,028,RANCHO VIEJO,3,150,78,72,11
HIDALGO,13,HUEJUTLA DE REYES,028,SAN ANTONIO,2,43,14,29,3
HIDALGO,13,HUEJUTLA DE REYES,028,SAN JOSÉ,2,14,8,6,2
HIDALGO,13,HUEJUTLA DE REYES,028,SAN JOSÉ ANEXO IXCATLÁN,1,32,18,14,2
HIDALGO,13,HUEJUTLA DE REYES,028,SANTA CATARINA,4,374,197,177,20
HIDALGO,13,HUEJUTLA DE REYES,028,SANTA CRUZ,5,888,454,434,50
HIDALGO,13,HUEJUTLA DE REYES,028,SANTA CRUZ COYUCO,2,13,5,8,2
HIDALGO,13,HUEJUTLA DE REYES,028,SANTA MARÍA,2,24,9,15,3
HIDALGO,13,HUEJUTLA DE REYES,028,SITLÁN,2,85,46,39,6
HIDALGO,13,HUEJUTLA DE REYES,028,TACUATITLA,2,57,26,31,3
HIDALGO,13,HUEJUTLA DE REYES,028,TAMALCUATITLA,3,86,48,38,8
HIDALGO,13,HUEJUTLA DE REYES,028,TAMAYA AHUEHUETITLA,1,5,2,3,1
HIDALGO,13,HUEJUTLA DE REYES,028,TANCHA,2,18,7,11,2
HIDALGO,13,HUEJUTLA DE REYES,028,TEACAL,3,356,187,169,19
HIDALGO,13,HUEJUTLA DE REYES,028,TEHUETLÁN,5,1358,664,694,79
HIDALGO,13,HUEJUTLA DE REYES,028,TEMAXCALTITLA,2,78,32,46,8
HIDALGO,13,HUEJUTLA DE REYES,028,TEPEHICA,3,51,27,24,6
HIDALGO,13,HUEJUTLA DE REYES,028,TEPEMALINTLA,2,30,15,15,3
HIDALGO,13,HUEJUTLA DE REYES,028,TEPEMAXAC,2,87,47,40,6
HIDALGO,13,HUEJUTLA DE REYES,028,TEPEOLOL,2,87,42,45,7
HIDALGO,13,HUEJUTLA DE REYES,028,TEPEXITITLA,3,528,249,279,26
HIDALGO,13,HUEJUTLA DE REYES,028,TEPEYACAPA,2,28,14,14,3
HIDALGO,13,HUEJUTLA DE REYES,028,TERRERO,2,91,45,46,7
HIDALGO,13,HUEJUTLA DE REYES,028,TERRERO ABAJO,2,33,19,14,2
HIDALGO,13,HUEJUTLA DE REYES,028,TETZACUAL,3,96,44,52,8
HIDALGO,13,HUEJUTLA DE REYES,028,TETZAHAPA I,2,9,6,3,1
HIDALGO,13,HUEJUTLA DE REYES,028,TEZÓHUAL,2,36,19,17,3
HIDALGO,13,HUEJUTLA DE REYES,028,TIOCUATITLA,2,31,15,16,3
HIDALGO,13,HUEJUTLA DE REYES,028,TLALNEPANCO,3,148,78,70,9
HIDALGO,13,HUEJUTLA DE REYES,028,TLALTZINTLA,4,126,69,57,9
HIDALGO,13,HUEJUTLA DE REYES,028,TLAMAYA TEPEHICA,2,36,15,21,3
HIDALGO,13,HUEJUTLA DE REYES,028,TODOS POR HIDALGO,5,236,131,105,39
HIDALGO,13,HUEJUTLA DE REYES,028,TULAXTITLA,2,15,5,10,3
HIDALGO,13,HUEJUTLA DE REYES,028,UNIVERSIDAD TECNOLÓGICA DE LA HUASTECA HIDALGUENSE,1,3282,1469,1813,140
HIDALGO,13,HUEJUTLA DE REYES,028,XILOCO,2,47,17,30,4
HIDALGO,13,HUEJUTLA DE REYES,028,XIONAXTLA,3,43,22,21,3
HIDALGO,13,HUEJUTLA DE REYES,028,XIQUILA,5,553,282,271,31
HIDALGO,13,HUEJUTLA DE REYES,028,XOCHIATIPA,1,21,12,9,2
HIDALGO,13,HUEJUTLA DE REYES,028,XOCHITITLA,2,54,23,31,4
HIDALGO,13,HUEJUTLA DE REYES,028,XOCHITZINTLA,2,17,6,11,2
HIDALGO,13,HUEJUTLA DE REYES,028,XOCOTITLA,2,106,48,58,8
HIDALGO,13,HUEJUTLA DE REYES,028,ZACAPETLAYO,2,46,20,26,4
HIDALGO,13,HUEJUTLA DE REYES,028,ZACAYAHUAL,2,43,21,22,4
HIDALGO,13,HUEJUTLA DE REYES,028,ZAPOTITLA,1,16,11,5,1
HIDALGO,13,HUEJUTLA DE REYES,028,ZAPOTITLA ANEXO IXCATLÁN,2,43,27,16,4
HIDALGO,13,HUEJUTLA DE REYES,028,ZOCUITECO BENITO JUÁREZ,2,70,38,32,5
HIDALGO,13,HUEJUTLA DE REYES,028,ZOHUALA,4,109,48,61,12
HIDALGO,13,HUICHAPAN,029,BONDOJITO,5,429,209,220,22
HIDALGO,13,HUICHAPAN,029,BOYE,2,45,18,27,5
HIDALGO,13,HUICHAPAN,029,COMODEJE,2,18,10,8,2
HIDALGO,13,HUICHAPAN,029,DANDHÓ,2,125,67,58,8
HIDALGO,13,HUICHAPAN,029,DANTZIBOJAY,4,307,132,175,16
HIDALGO,13,HUICHAPAN,029,DONGOTEAY,2,54,21,33,4
HIDALGO,13,HUICHAPAN,029,EL APARTADERO,3,115,52,63,11
HIDALGO,13,HUICHAPAN,029,EL CAJÓN,2,46,22,24,3
HIDALGO,13,HUICHAPAN,029,EL CARMEN,3,147,71,76,10
HIDALGO,13,HUICHAPAN,029,EL GAVILLERO DE MINTHO,3,33,17,16,3
HIDALGO,13,HUICHAPAN,029,EL PEDREGAL,1,6,4,2,1
HIDALGO,13,HUICHAPAN,029,EL SAUCILLO,5,2705,1386,1319,75
HIDALGO,13,HUICHAPAN,029,EL TENDIDO,2,27,12,15,2
HIDALGO,13,HUICHAPAN,029,ESTACIÓN HUICHAPAN,2,92,48,44,7
HIDALGO,13,HUICHAPAN,029,GUADALUPE,2,6,4,2,1
HIDALGO,13,HUICHAPAN,029,HUICHAPAN,24,3783,1897,1886,246
HIDALGO,13,HUICHAPAN,029,HUIXCAZDHÁ (LA MANGA),3,70,35,35,7
HIDALGO,13,HUICHAPAN,029,JONACAPA,3,160,80,80,11
HIDALGO,13,HUICHAPAN,029,LA CRUZ,2,70,40,30,4
HIDALGO,13,HUICHAPAN,029,LA ESCONDIDA,2,16,4,12,3
HIDALGO,13,HUICHAPAN,029,LA SABINITA,2,249,119,130,14
HIDALGO,13,HUICHAPAN,029,LLANO LARGO,4,593,294,299,26
HIDALGO,13,HUICHAPAN,029,MAMITHÍ,3,435,193,242,20
HIDALGO,13,HUICHAPAN,029,MANEY,2,131,63,68,8
HIDALGO,13,HUICHAPAN,029,MAXTHÁ,2,72,39,33,5
HIDALGO,13,HUICHAPAN,029,MONTE ALEGRE,1,6,4,2,1
HIDALGO,13,HUICHAPAN,029,PEDREGOSO,2,66,35,31,4
HIDALGO,13,HUICHAPAN,029,SABINA GRANDE,1,10,4,6,1
HIDALGO,13,HUICHAPAN,029,SAN ISIDRO EL ASTILLERO,4,246,124,122,13
HIDALGO,13,HUICHAPAN,029,SAN JOSÉ ATLÁN,3,842,436,406,35
HIDALGO,13,HUICHAPAN,029,SANTA BÁRBARA,1,1192,675,517,95
HIDALGO,13,HUICHAPAN,029,TAGUÍ,3,116,58,58,9
HIDALGO,13,HUICHAPAN,029,TAXQUÍ,2,13,6,7,2
HIDALGO,13,HUICHAPAN,029,TLAXCALILLA,4,814,423,391,33
HIDALGO,13,HUICHAPAN,029,VITEJHÉ,3,117,53,64,7
HIDALGO,13,HUICHAPAN,029,XAJAY,2,42,17,25,3
HIDALGO,13,HUICHAPAN,029,YONTHÉ,2,46,20,26,4
HIDALGO,13,HUICHAPAN,029,ZAMORANO,2,35,24,11,3
HIDALGO,13,HUICHAPAN,029,ZEQUETEJÉ,3,42,20,22,4
HIDALGO,13,HUICHAPAN,029,ZOTHÉ,3,258,130,128,12
HIDALGO,13,IXMIQUILPAN,030,AGUA FLORIDA,2,24,15,9,3
HIDALGO,13,IXMIQUILPAN,030,ÁLAMO,2,6,3,3,1
HIDALGO,13,IXMIQUILPAN,030,ARENALITO,2,72,35,37,8
HIDALGO,13,IXMIQUILPAN,030,BANGANDHÓ,4,318,158,160,25
HIDALGO,13,IXMIQUILPAN,030,BOTENGUEDHO,2,246,114,132,11
HIDALGO,13,IXMIQUILPAN,030,BOXHUADA,2,38,20,18,5
HIDALGO,13,IXMIQUILPAN,030,CANTAMAYE,2,5,3,2,1
HIDALGO,13,IXMIQUILPAN,030,CANTINELA,3,268,123,145,17
HIDALGO,13,IXMIQUILPAN,030,CAÑADA CHICA,3,140,68,72,10
HIDALGO,13,IXMIQUILPAN,030,CAPULA,4,347,158,189,23
HIDALGO,13,IXMIQUILPAN,030,CERRITO CAPULA,2,56,27,29,2
HIDALGO,13,IXMIQUILPAN,030,CERRITOS,3,311,162,149,17
HIDALGO,13,IXMIQUILPAN,030,CERRO BLANCO,2,15,6,9,2
HIDALGO,13,IXMIQUILPAN,030,CHALMITA,2,9,5,4,2
HIDALGO,13,IXMIQUILPAN,030,COLONIA DEL VALLE REMEDIOS,1,20,10,10,1
HIDALGO,13,IXMIQUILPAN,030,CUESTA COLORADA,3,149,80,69,11
HIDALGO,13,IXMIQUILPAN,030,DIOS PADRE,5,774,471,303,106
HIDALGO,13,IXMIQUILPAN,030,EJIDO JAGÜEY DE VÁZQUEZ CAPULA,1,6,3,3,1
HIDALGO,13,IXMIQUILPAN,030,EL ALBERTO,3,114,62,52,11
HIDALGO,13,IXMIQUILPAN,030,EL BANXU,3,39,23,16,7
HIDALGO,13,IXMIQUILPAN,030,EL BARRIDO,2,136,63,73,7
HIDALGO,13,IXMIQUILPAN,030,EL BOYE,2,19,12,7,2
HIDALGO,13,IXMIQUILPAN,030,EL CARRIZAL,2,67,27,40,6
HIDALGO,13,IXMIQUILPAN,030,EL DECA,2,49,25,24,4
HIDALGO,13,IXMIQUILPAN,030,EL DEFAY,3,79,45,34,11
HIDALGO,13,IXMIQUILPAN,030,EL DEXTHI ALBERTO,2,6,2,4,1
HIDALGO,13,IXMIQUILPAN,030,EL DEXTHI SAN JUANICO,3,116,62,54,11
HIDALGO,13,IXMIQUILPAN,030,EL DEXTHO,3,112,50,62,10
HIDALGO,13,IXMIQUILPAN,030,EL DEZHA,2,13,4,9,2
HIDALGO,13,IXMIQUILPAN,030,EL DURAZNO,4,287,142,145,17
HIDALGO,13,IXMIQUILPAN,030,EL ESPINO,4,157,75,82,15
HIDALGO,13,IXMIQUILPAN,030,EL ESPÍRITU,4,150,74,76,12
HIDALGO,13,IXMIQUILPAN,030,EL HUACRI,2,39,20,19,4
HIDALGO,13,IXMIQUILPAN,030,EL MANANTIAL,2,21,9,12,3
HIDALGO,13,IXMIQUILPAN,030,EL MANDHO,5,162,86,76,12
HIDALGO,13,IXMIQUILPAN,030,EL MEJE,2,15,6,9,2
HIDALGO,13,IXMIQUILPAN,030,EL MIRADOR CAPULA,4,552,290,262,36
HIDALGO,13,IXMIQUILPAN,030,EL NANDHO,2,13,5,8,3
HIDALGO,13,IXMIQUILPAN,030,EL NITH,3,516,272,244,27
HIDALGO,13,IXMIQUILPAN,030,EL NOGAL,3,49,27,22,5
HIDALGO,13,IXMIQUILPAN,030,EL OLIVO,2,47,22,25,5
HIDALGO,13,IXMIQUILPAN,030,EL PUERTO DEXTHI,2,62,27,35,8
HIDALGO,13,IXMIQUILPAN,030,EL ROSARIO CAPULA,2,21,12,9,2
HIDALGO,13,IXMIQUILPAN,030,EL TABLÓN,2,80,36,44,8
HIDALGO,13,IXMIQUILPAN,030,EL TEPHÉ,4,2410,1187,1223,79
HIDALGO,13,IXMIQUILPAN,030,EL USTHEJE,3,34,19,15,4
HIDALGO,13,IXMIQUILPAN,030,EL VALANTE,2,36,12,24,3
HIDALGO,13,IXMIQUILPAN,030,EX-HACIENDA DE OCOTZA,2,75,43,32,7
HIDALGO,13,IXMIQUILPAN,030,EX-HACIENDA DEBODHE,2,55,28,27,4
HIDALGO,13,IXMIQUILPAN,030,FELIPE ÁNGELES JULIÁN VILLAGRÁN,2,35,18,17,3
HIDALGO,13,IXMIQUILPAN,030,GENERAL FELIPE ÁNGELES [COLONIA],2,186,90,96,8
HIDALGO,13,IXMIQUILPAN,030,GRANADITAS,2,45,16,29,3
HIDALGO,13,IXMIQUILPAN,030,GUNDHO,3,53,31,22,6
HIDALGO,13,IXMIQUILPAN,030,HUACRI DE LA PAZ,1,6,2,4,1
HIDALGO,13,IXMIQUILPAN,030,HUAPILLA,1,16,8,8,1
HIDALGO,13,IXMIQUILPAN,030,IGNACIO LÓPEZ RAYÓN,3,130,59,71,10
HIDALGO,13,IXMIQUILPAN,030,IXMIQUILPAN,65,11973,6235,5738,740
HIDALGO,13,IXMIQUILPAN,030,JAHUEY CAPULA,3,77,35,42,8
HIDALGO,13,IXMIQUILPAN,030,JULIÁN VILLAGRÁN,4,511,244,267,27
HIDALGO,13,IXMIQUILPAN,030,LA ESTACIÓN,2,148,67,81,8
HIDALGO,13,IXMIQUILPAN,030,LA HEREDAD,3,175,92,83,11
HIDALGO,13,IXMIQUILPAN,030,LA HUERTA CAPULA,2,50,29,21,5
HIDALGO,13,IXMIQUILPAN,030,LA JOYA [COLONIA],2,2365,1206,1159,140
HIDALGO,13,IXMIQUILPAN,030,LA LAGUNITA,3,129,63,66,11
HIDALGO,13,IXMIQUILPAN,030,LA LIBERTAD [COLONIA],1,16,8,8,2
HIDALGO,13,IXMIQUILPAN,030,LA LOMA DE LA CRUZ,2,47,20,27,5
HIDALGO,13,IXMIQUILPAN,030,LA LOMA JULIÁN VILLAGRÁN,4,214,106,108,13
HIDALGO,13,IXMIQUILPAN,030,LA LOMA LÓPEZ RAYÓN,2,62,36,26,6
HIDALGO,13,IXMIQUILPAN,030,LA LOMA PUEBLO NUEVO,2,19,12,7,3
HIDALGO,13,IXMIQUILPAN,030,LA PALMA,4,56,27,29,6
HIDALGO,13,IXMIQUILPAN,030,LA PECHUGA,3,34,22,12,4
HIDALGO,13,IXMIQUILPAN,030,LAS EMES,2,5,1,4,1
HIDALGO,13,IXMIQUILPAN,030,LÁZARO CÁRDENAS (EL INTERNADO) [COLONIA],2,27,14,13,3
HIDALGO,13,IXMIQUILPAN,030,LÓPEZ FLORES,1,9,5,4,1
HIDALGO,13,IXMIQUILPAN,030,LOS PINOS,2,22,8,14,3
HIDALGO,13,IXMIQUILPAN,030,LOS REMEDIOS,2,143,75,68,9
HIDALGO,13,IXMIQUILPAN,030,MAGUEY BLANCO,2,288,131,157,16
HIDALGO,13,IXMIQUILPAN,030,MANZANA CERRITOS,1,51,27,24,3
HIDALGO,13,IXMIQUILPAN,030,NAXTHÉY,2,11,7,4,2
HIDALGO,13,IXMIQUILPAN,030,NEQUETEJE,3,165,80,85,11
HIDALGO,13,IXMIQUILPAN,030,ORIZABITA,5,680,330,350,55
HIDALGO,13,IXMIQUILPAN,030,PANALES,5,810,396,414,37
HIDALGO,13,IXMIQUILPAN,030,POZO EL MIRADOR,2,55,29,26,4
HIDALGO,13,IXMIQUILPAN,030,PUEBLO NUEVO,2,261,135,126,17
HIDALGO,13,IXMIQUILPAN,030,PUERTO BANGANDHÓ,2,78,36,42,6
HIDALGO,13,IXMIQUILPAN,030,QUIXPEDHE,2,74,44,30,8
HIDALGO,13,IXMIQUILPAN,030,SAMAYOA [COLONIA],2,168,65,103,9
HIDALGO,13,IXMIQUILPAN,030,SAN ANDRÉS ORIZABITA,3,58,28,30,8
HIDALGO,13,IXMIQUILPAN,030,SAN JUANICO,3,151,71,80,12
HIDALGO,13,IXMIQUILPAN,030,SAN PEDRO CAPULA,2,157,81,76,9
HIDALGO,13,IXMIQUILPAN,030,TAXADHO,4,401,289,112,38
HIDALGO,13,IXMIQUILPAN,030,TAXTHÓ,2,28,13,15,3
HIDALGO,13,IXMIQUILPAN,030,VÁZQUEZ,2,41,24,17,4
HIDALGO,13,IXMIQUILPAN,030,VILLA DE LA PAZ,2,37,12,25,4
HIDALGO,13,JACALA DE LEDEZMA,031,AGUA FRÍA CHICA,3,51,21,30,5
HIDALGO,13,JACALA DE LEDEZMA,031,AGUA FRÍA GRANDE,1,13,8,5,3
HIDALGO,13,JACALA DE LEDEZMA,031,BARRANCA ARRIBA,2,4,2,2,1
HIDALGO,13,JACALA DE LEDEZMA,031,CARRIZALITO,2,12,5,7,1
HIDALGO,13,JACALA DE LEDEZMA,031,COMATITLÁN,2,7,2,5,1
HIDALGO,13,JACALA DE LEDEZMA,031,COÑECITO,3,85,44,41,6
HIDALGO,13,JACALA DE LEDEZMA,031,CUESTA COLORADA,3,184,93,91,13
HIDALGO,13,JACALA DE LEDEZMA,031,EL AGUAJE,1,10,6,4,1
HIDALGO,13,JACALA DE LEDEZMA,031,EL CARRIZAL,3,31,18,13,5
HIDALGO,13,JACALA DE LEDEZMA,031,EL PINALITO,3,207,86,121,14
HIDALGO,13,JACALA DE LEDEZMA,031,EL REFUGIO,1,4,2,2,1
HIDALGO,13,JACALA DE LEDEZMA,031,JACALA,7,1313,704,609,85
HIDALGO,13,JACALA DE LEDEZMA,031,JOSÉ MARÍA MORELOS,1,17,9,8,1
HIDALGO,13,JACALA DE LEDEZMA,031,LA MORA,1,11,4,7,1
HIDALGO,13,JACALA DE LEDEZMA,031,LA PALMA,4,130,75,55,12
HIDALGO,13,JACALA DE LEDEZMA,031,LAGUNA SECA,3,33,13,20,4
HIDALGO,13,JACALA DE LEDEZMA,031,LOS DURAZNOS,3,82,30,52,7
HIDALGO,13,JACALA DE LEDEZMA,031,LOS HOYOS,1,17,9,8,1
HIDALGO,13,JACALA DE LEDEZMA,031,MESA DE LA CEBADA,2,15,4,11,2
HIDALGO,13,JACALA DE LEDEZMA,031,MINAS VIEJAS,1,6,2,4,1
HIDALGO,13,JACALA DE LEDEZMA,031,OCTUPILLA,3,26,11,15,3
HIDALGO,13,JACALA DE LEDEZMA,031,PALOS PINTADOS,2,5,2,3,1
HIDALGO,13,JACALA DE LEDEZMA,031,PLOMOSAS,3,99,47,52,7
HIDALGO,13,JACALA DE LEDEZMA,031,QUETZALAPA,3,101,50,51,9
HIDALGO,13,JACALA DE LEDEZMA,031,SAN NICOLÁS,4,214,109,105,14
HIDALGO,13,JACALA DE LEDEZMA,031,SANTO DOMINGO,3,37,17,20,5
HIDALGO,13,JACALA DE LEDEZMA,031,VADO HONDO,2,24,11,13,3
HIDALGO,13,JALTOCÁN,032,AHUAYO,2,23,11,12,2
HIDALGO,13,JALTOCÁN,032,AMÁXAC I,3,58,34,24,6
HIDALGO,13,JALTOCÁN,032,AMÁXAC II,3,48,24,24,4
HIDALGO,13,JALTOCÁN,032,ANACLETO RAMOS,1,28,16,12,2
HIDALGO,13,JALTOCÁN,032,CUATECOMACO,2,44,27,17,4
HIDALGO,13,JALTOCÁN,032,CUATZATZAS,2,22,13,9,3
HIDALGO,13,JALTOCÁN,032,EL CHOTE,3,86,43,43,8
HIDALGO,13,JALTOCÁN,032,JALTOCÁN,13,1968,982,986,126
HIDALGO,13,JALTOCÁN,032,LA CAPILLA,2,91,43,48,7
HIDALGO,13,JALTOCÁN,032,LA ILUSIÓN,2,41,23,18,2
HIDALGO,13,JALTOCÁN,032,MATACHILILLO,3,36,14,22,4
HIDALGO,13,JALTOCÁN,032,OCTATITLA,3,83,38,45,6
HIDALGO,13,JALTOCÁN,032,POTRERO ZACTIPÁN,1,15,8,7,1
HIDALGO,13,JALTOCÁN,032,REVOLUCIÓN MEXICANA,2,34,19,15,2
HIDALGO,13,JALTOCÁN,032,TEPEXICUICUIL,2,22,12,10,3
HIDALGO,13,JALTOCÁN,032,TZINANCATITLA,2,35,20,15,3
HIDALGO,13,JUÁREZ HIDALGO,033,JUÁREZ HIDALGO,4,118,66,52,11
HIDALGO,13,JUÁREZ HIDALGO,033,SAN LORENZO ITZTACOYOTLA,4,170,82,88,13
HIDALGO,13,JUÁREZ HIDALGO,033,SAN NICOLÁS COATZONTLA,3,78,41,37,6
HIDALGO,13,JUÁREZ HIDALGO,033,SANTA MARÍA,4,234,115,119,14
HIDALGO,13,LOLOTLA,034,ACATEPEC,3,62,24,38,6
HIDALGO,13,LOLOTLA,034,CHALMA,3,105,51,54,7
HIDALGO,13,LOLOTLA,034,CHANTASCO,5,298,148,150,18
HIDALGO,13,LOLOTLA,034,CHICONCOAC,4,287,155,132,19
HIDALGO,13,LOLOTLA,034,CHIQUITLA,3,34,17,17,6
HIDALGO,13,LOLOTLA,034,COMONTLA,2,15,10,5,2
HIDALGO,13,LOLOTLA,034,CONTEPEC,1,20,10,10,2
HIDALGO,13,LOLOTLA,034,CUATITLANAPA,3,33,16,17,5
HIDALGO,13,LOLOTLA,034,EL BARCO,5,135,66,69,11
HIDALGO,13,LOLOTLA,034,HUITZNOPALA,3,25,11,14,4
HIDALGO,13,LOLOTLA,034,IXTACUATLA,3,27,13,14,4
HIDALGO,13,LOLOTLA,034,IXTLAHUACO,4,429,217,212,27
HIDALGO,13,LOLOTLA,034,LA FLORIDA,2,14,6,8,2
HIDALGO,13,LOLOTLA,034,LA PIMIENTA,2,13,7,6,2
HIDALGO,13,LOLOTLA,034,LA UNIÓN,2,16,8,8,1
HIDALGO,13,LOLOTLA,034,LOLOTLA,3,187,99,88,13
HIDALGO,13,LOLOTLA,034,MAZAHUACÁN,3,12,8,4,3
HIDALGO,13,LOLOTLA,034,TENTLA (CERRO BLANCO),3,69,30,39,4
HIDALGO,13,LOLOTLA,034,TLACOZINTLA,2,12,7,5,2
HIDALGO,13,LOLOTLA,034,TLALTEPINGO,3,71,37,34,7
HIDALGO,13,LOLOTLA,034,TOLAGO,3,73,30,43,5
HIDALGO,13,LOLOTLA,034,XALCUATLA,4,238,124,114,13
HIDALGO,13,LOLOTLA,034,XINTLA,1,68,27,41,5
HIDALGO,13,LOLOTLA,034,XUCHIPANTLA,2,41,26,15,3
HIDALGO,13,LOLOTLA,034,XUCHITLÁN,4,223,124,99,15
HIDALGO,13,METEPEC,035,ACOCUL CEBOLLETAS,2,27,13,14,3
HIDALGO,13,METEPEC,035,ATLIXTACA,2,36,17,19,3
HIDALGO,13,METEPEC,035,CAÑADA DE FLORES,3,70,29,41,6
HIDALGO,13,METEPEC,035,COLONIA NUEVA EX-HACIENDA DE APULCO,1,23,9,14,2
HIDALGO,13,METEPEC,035,EL ACOCUL,3,164,89,75,11
HIDALGO,13,METEPEC,035,EL CASCO,2,156,72,84,8
HIDALGO,13,METEPEC,035,EL SABINO,1,11,2,9,1
HIDALGO,13,METEPEC,035,EL SABINO PARTE ALTA,1,38,25,13,2
HIDALGO,13,METEPEC,035,EL VESUBIO,2,27,11,16,3
HIDALGO,13,METEPEC,035,ESTACIÓN DE APULCO,4,1135,602,533,76
HIDALGO,13,METEPEC,035,FERRERÍA DE APULCO,2,58,37,21,4
HIDALGO,13,METEPEC,035,IGNACIO ZARAGOZA [COLONIA],2,75,31,44,3
HIDALGO,13,METEPEC,035,LA BOMBA,1,17,10,7,2
HIDALGO,13,METEPEC,035,LA LOMA DE METEPEC,1,5,1,4,1
HIDALGO,13,METEPEC,035,LA VICTORIA,3,179,97,82,10
HIDALGO,13,METEPEC,035,MAJADILLAS (LOMA BONITA),4,166,90,76,13
HIDALGO,13,METEPEC,035,METEPEC,5,788,392,396,36
HIDALGO,13,METEPEC,035,NOPALILLO,2,58,30,28,3
HIDALGO,13,METEPEC,035,PALO GACHO,2,123,66,57,8
HIDALGO,13,METEPEC,035,PALO GORDO (EJIDO NOPALILLO),6,222,109,113,13
HIDALGO,13,METEPEC,035,PEÑA COLORADA,1,15,8,7,2
HIDALGO,13,METEPEC,035,TEMAXCALILLOS,2,52,21,31,4
HIDALGO,13,METEPEC,035,TORTUGAS,2,41,21,20,3
HIDALGO,13,SAN AGUSTÍN METZQUITITLÁN,036,AGUA BENDITA,4,86,43,43,9
HIDALGO,13,SAN AGUSTÍN METZQUITITLÁN,036,APARTADERO,1,15,5,10,1
HIDALGO,13,SAN AGUSTÍN METZQUITITLÁN,036,ARROYO HONDO,2,4,3,1,1
HIDALGO,13,SAN AGUSTÍN METZQUITITLÁN,036,ATECOXCO (SAN NICOLÁS ATECOXCO),3,91,40,51,7
HIDALGO,13,SAN AGUSTÍN METZQUITITLÁN,036,CARPINTEROS,4,398,196,202,19
HIDALGO,13,SAN AGUSTÍN METZQUITITLÁN,036,CARRIZAL CHICO,1,17,8,9,1
HIDALGO,13,SAN AGUSTÍN METZQUITITLÁN,036,CIENEGUILLAS,2,25,14,11,2
HIDALGO,13,SAN AGUSTÍN METZQUITITLÁN,036,EL VELADERO,1,11,5,6,1
HIDALGO,13,SAN AGUSTÍN METZQUITITLÁN,036,LOS ÁLAMOS,3,45,23,22,5
HIDALGO,13,SAN AGUSTÍN METZQUITITLÁN,036,MEZQUITITLÁN,6,642,302,340,37
HIDALGO,13,SAN AGUSTÍN METZQUITITLÁN,036,MILPILLAS,2,54,25,29,5
HIDALGO,13,SAN AGUSTÍN METZQUITITLÁN,036,SAN FRANCISCO,1,7,3,4,1
HIDALGO,13,SAN AGUSTÍN METZQUITITLÁN,036,SAN JUAN CUAHUTENGO,2,8,4,4,1
HIDALGO,13,SAN AGUSTÍN METZQUITITLÁN,036,SANTA MARÍA XOXOTECO,2,72,39,33,4
HIDALGO,13,SAN AGUSTÍN METZQUITITLÁN,036,TUZANAPA,4,202,101,101,13
HIDALGO,13,SAN AGUSTÍN METZQUITITLÁN,036,YERBABUENA,4,95,45,50,8
HIDALGO,13,SAN AGUSTÍN METZQUITITLÁN,036,ZAHUASTIPÁN,3,39,16,23,4
HIDALGO,13,METZTITLÁN,037,AGUA HEDEONDA,3,117,57,60,7
HIDALGO,13,METZTITLÁN,037,ALUMBRES,3,528,262,266,23
HIDALGO,13,METZTITLÁN,037,ATZOLCINTLA,3,121,53,68,10
HIDALGO,13,METZTITLÁN,037,AYACATZINTLA,1,9,4,5,1
HIDALGO,13,METZTITLÁN,037,CACALOME (ACALOME),2,34,12,22,3
HIDALGO,13,METZTITLÁN,037,COALQUIZQUE,2,23,17,6,2
HIDALGO,13,METZTITLÁN,037,COYOMETECO,2,32,17,15,2
HIDALGO,13,METZTITLÁN,037,EL CARRIZAL,3,116,63,53,7
HIDALGO,13,METZTITLÁN,037,EL ESCOBAL,2,9,5,4,1
HIDALGO,13,METZTITLÁN,037,EL MAMTHA,1,14,6,8,1
HIDALGO,13,METZTITLÁN,037,EL PALMAR,3,66,31,35,5
HIDALGO,13,METZTITLÁN,037,EL PEDREGAL DE ZARAGOZA (EL PEDREGAL),3,171,81,90,13
HIDALGO,13,METZTITLÁN,037,EL PIRÚ TEPOZOTLÁN (EL PIRÚ),4,64,29,35,9
HIDALGO,13,METZTITLÁN,037,EL TABLÓN,2,13,5,8,2
HIDALGO,13,METZTITLÁN,037,ESTOCUAPA (LA COLMENA),1,8,2,6,1
HIDALGO,13,METZTITLÁN,037,FONTEZUELAS,4,315,167,148,22
HIDALGO,13,METZTITLÁN,037,HACIENDA DE POTRERO,1,3,3,0,1
HIDALGO,13,METZTITLÁN,037,HUAYATENO,3,49,21,28,4
HIDALGO,13,METZTITLÁN,037,HUISTÍCOLA,3,20,11,9,2
HIDALGO,13,METZTITLÁN,037,ITZTAYATLA,3,54,25,29,5
HIDALGO,13,METZTITLÁN,037,ITZTAZACUALA,3,29,10,19,3
HIDALGO,13,METZTITLÁN,037,JILOTLA,1,14,6,8,1
HIDALGO,13,METZTITLÁN,037,JOYA DE ANALCO,2,7,3,4,1
HIDALGO,13,METZTITLÁN,037,LA CUMBRE JAGÜEY SECO (JAGÜEY SECO),2,17,7,10,2
HIDALGO,13,METZTITLÁN,037,LA MESA GRANDE (MESA GRANDE),1,6,3,3,1
HIDALGO,13,METZTITLÁN,037,LA PAILA DE ANÁHUAC,2,34,13,21,3
HIDALGO,13,METZTITLÁN,037,LOS ARCOS,3,48,22,26,5
HIDALGO,13,METZTITLÁN,037,MACUILA,1,12,6,6,1
HIDALGO,13,METZTITLÁN,037,METZTITLÁN,7,1870,929,941,126
HIDALGO,13,METZTITLÁN,037,OLOTLA,3,59,23,36,5
HIDALGO,13,METZTITLÁN,037,PALO BLANCO (CACALOCO),2,8,4,4,1
HIDALGO,13,METZTITLÁN,037,PONTADHÓ,2,53,31,22,4
HIDALGO,13,METZTITLÁN,037,RINCÓN DE COALQUIZQUE,2,26,13,13,3
HIDALGO,13,METZTITLÁN,037,SAN CRISTÓBAL,4,321,147,174,21
HIDALGO,13,METZTITLÁN,037,SAN JUAN TLATEPEXI,1,3,2,1,1
HIDALGO,13,METZTITLÁN,037,SAN PABLO TETLAPAYAC,2,7,2,5,1
HIDALGO,13,METZTITLÁN,037,SAN PEDRO AMAJATLÁN (AMAJATLÁN),2,38,16,22,4
HIDALGO,13,METZTITLÁN,037,SAN PEDRO AYOTOXTLA,2,5,2,3,1
HIDALGO,13,METZTITLÁN,037,SAN PEDRO TLATEMALCO,2,38,15,23,4
HIDALGO,13,METZTITLÁN,037,SANTA MÓNICA AUTEMPA,4,94,36,58,11
HIDALGO,13,METZTITLÁN,037,TABLÓN CHICO,3,31,19,12,4
HIDALGO,13,METZTITLÁN,037,TECRUZ COZAPA,2,45,23,22,4
HIDALGO,13,METZTITLÁN,037,TECRUZ DE ANÁHUAC (TECRUZ DE JIHUICO),2,11,6,5,2
HIDALGO,13,METZTITLÁN,037,TEPATETIPA (SAN AGUSTÍN TEPATETIPA),3,80,41,39,7
HIDALGO,13,METZTITLÁN,037,TEZOCHUCA,2,30,13,17,3
HIDALGO,13,METZTITLÁN,037,TLACOTEPEC (CERRITO DE TLACOTEPEC),2,37,15,22,3
HIDALGO,13,METZTITLÁN,037,TLAMAXA,2,15,6,9,2
HIDALGO,13,METZTITLÁN,037,TLAMAYA,3,47,24,23,4
HIDALGO,13,METZTITLÁN,037,TLATEPEXE,2,135,66,69,7
HIDALGO,13,METZTITLÁN,037,TLAXCO,3,103,54,49,9
HIDALGO,13,METZTITLÁN,037,TOCHINTLA,2,13,9,4,2
HIDALGO,13,METZTITLÁN,037,TRES CRUCES,2,27,12,15,3
HIDALGO,13,METZTITLÁN,037,YERBABUENA,2,6,4,2,2
HIDALGO,13,METZTITLÁN,037,ZOQUITENO,2,7,3,4,1
HIDALGO,13,METZTITLÁN,037,ZOQUIZOQUIPAN,3,95,46,49,6
HIDALGO,13,METZTITLÁN,037,ZOTOLA,2,10,5,5,1
HIDALGO,13,METZTITLÁN,037,ZOTOLTEPEC,2,28,13,15,3
HIDALGO,13,MINERAL DEL CHICO,038,BENITO JUÁREZ,4,1036,492,544,76
HIDALGO,13,MINERAL DEL CHICO,038,CAPULA,3,75,31,44,7
HIDALGO,13,MINERAL DEL CHICO,038,CARBONERAS,4,367,195,172,21
HIDALGO,13,MINERAL DEL CHICO,038,CARBONERAS CUEVA BLANCA,2,16,4,12,1
HIDALGO,13,MINERAL DEL CHICO,038,CARBONERAS LA PALMA,1,16,10,6,2
HIDALGO,13,MINERAL DEL CHICO,038,CEBADAS,2,9,4,5,1
HIDALGO,13,MINERAL DEL CHICO,038,CIMBRONES,1,8,4,4,1
HIDALGO,13,MINERAL DEL CHICO,038,EL PUENTE,2,167,69,98,7
HIDALGO,13,MINERAL DEL CHICO,038,LA ESTANZUELA,4,335,169,166,20
HIDALGO,13,MINERAL DEL CHICO,038,LA PRESA,2,39,16,23,3
HIDALGO,13,MINERAL DEL CHICO,038,LOS NARANJOS,3,36,14,22,3
HIDALGO,13,MINERAL DEL CHICO,038,MINERAL DEL CHICO,3,191,97,94,15
HIDALGO,13,MINERAL DEL CHICO,038,SAN FRANCISCO,2,40,16,24,2
HIDALGO,13,MINERAL DEL CHICO,038,SAN JOSÉ CAPULINES,3,69,37,32,7
HIDALGO,13,MINERAL DEL CHICO,038,SAN SEBASTIÁN CAPULINES,4,80,41,39,9
HIDALGO,13,MINERAL DEL CHICO,038,SAN SIMÓN LO DE ROJAS,2,7,4,3,1
HIDALGO,13,MINERAL DEL CHICO,038,SANTA INÉS,1,7,4,3,1
HIDALGO,13,MINERAL DEL MONTE,039,CIÉNEGA LARGA,3,93,49,44,7
HIDALGO,13,MINERAL DEL MONTE,039,MINERAL DEL MONTE,14,2474,1324,1150,204
HIDALGO,13,MINERAL DEL MONTE,039,PUEBLO NUEVO,3,185,86,99,11
HIDALGO,13,MINERAL DEL MONTE,039,SAN PEDRO HUIXOTITLA,1,8,6,2,1
HIDALGO,13,MINERAL DEL MONTE,039,SANTA ROSALÍA,2,66,29,37,4
HIDALGO,13,MINERAL DEL MONTE,039,TEZOANTLA,2,63,27,36,4
HIDALGO,13,LA MISIÓN,040,AGUAJE DE CERRO PRIETO (LOS PAREDONES),2,14,3,11,2
HIDALGO,13,LA MISIÓN,040,ÁLAMO DE LA MISIÓN,2,9,4,5,1
HIDALGO,13,LA MISIÓN,040,CERRO PRIETO,4,170,88,82,12
HIDALGO,13,LA MISIÓN,040,COÑE VIEJO,2,23,12,11,3
HIDALGO,13,LA MISIÓN,040,CRUCITA DE PILAS,2,10,4,6,2
HIDALGO,13,LA MISIÓN,040,EL ALGODÓN,2,29,14,15,3
HIDALGO,13,LA MISIÓN,040,EL CHAMAL,2,19,8,11,2
HIDALGO,13,LA MISIÓN,040,EL FRESNO,2,22,18,4,3
HIDALGO,13,LA MISIÓN,040,EL NARANJO,4,117,60,57,10
HIDALGO,13,LA MISIÓN,040,EL NOGALITO,2,25,11,14,3
HIDALGO,13,LA MISIÓN,040,EL PARAJE,1,8,4,4,1
HIDALGO,13,LA MISIÓN,040,EL RAYO,1,4,3,1,0
HIDALGO,13,LA MISIÓN,040,EL ROA,2,18,10,8,2
HIDALGO,13,LA MISIÓN,040,JACALILLA,3,80,43,37,8
HIDALGO,13,LA MISIÓN,040,LA CIÉNEGA,2,37,16,21,4
HIDALGO,13,LA MISIÓN,040,LA CULEBRA,2,30,13,17,4
HIDALGO,13,LA MISIÓN,040,LA HONDURA,2,6,2,4,1
HIDALGO,13,LA MISIÓN,040,LA JOYA,3,26,16,10,4
HIDALGO,13,LA MISIÓN,040,LA MESA DEL FRESNO,2,10,3,7,2
HIDALGO,13,LA MISIÓN,040,LA MISIÓN,4,372,197,175,19
HIDALGO,13,LA MISIÓN,040,LA MORA,2,43,25,18,4
HIDALGO,13,LA MISIÓN,040,LA PALIZADA,3,81,38,43,6
HIDALGO,13,LA MISIÓN,040,LA SOLEDAD (EL ENEBRO),3,77,37,40,6
HIDALGO,13,LA MISIÓN,040,LAS CAÑITAS,2,27,13,14,2
HIDALGO,13,LA MISIÓN,040,LAS FUENTES,2,34,12,22,3
HIDALGO,13,LA MISIÓN,040,LAS PALMITAS,3,82,43,39,10
HIDALGO,13,LA MISIÓN,040,LAS PILAS,2,37,20,17,3
HIDALGO,13,LA MISIÓN,040,LOMA DE PERICÓN,2,16,7,9,3
HIDALGO,13,LA MISIÓN,040,LOMA DE PILAS,3,30,16,14,4
HIDALGO,13,LA MISIÓN,040,LOS NARANJOS,2,19,12,7,2
HIDALGO,13,LA MISIÓN,040,MACANGUÍ,3,95,45,50,7
HIDALGO,13,LA MISIÓN,040,MACOJÚ,3,24,11,13,2
HIDALGO,13,LA MISIÓN,040,MESA DE PILAS,1,11,6,5,1
HIDALGO,13,LA MISIÓN,040,MESA DEL HUIZACHE,2,12,8,4,1
HIDALGO,13,LA MISIÓN,040,NUEVO LINARES,3,45,21,24,4
HIDALGO,13,LA MISIÓN,040,PUERTO DE NARANJOS,3,95,55,40,7
HIDALGO,13,LA MISIÓN,040,RANCHO VIEJO,2,9,4,5,1
HIDALGO,13,LA MISIÓN,040,SAN CRISTÓBAL,3,26,14,12,3
HIDALGO,13,LA MISIÓN,040,TEPEHUAJE,2,14,7,7,2
HIDALGO,13,LA MISIÓN,040,TINAJA DE JACALILLA,3,18,7,11,2
HIDALGO,13,LA MISIÓN,040,VEGA DE LA CARRERA,2,10,4,6,2
HIDALGO,13,LA MISIÓN,040,ZIPATLA,4,87,46,41,9
HIDALGO,13,MIXQUIAHUALA DE JUÁREZ,041,3 DE MAYO [COLONIA],2,19,9,10,2
HIDALGO,13,MIXQUIAHUALA DE JUÁREZ,041,ÁRBOL GRANDE,3,105,63,42,7
HIDALGO,13,MIXQUIAHUALA DE JUÁREZ,041,BENITO JUÁREZ,4,300,151,149,14
HIDALGO,13,MIXQUIAHUALA DE JUÁREZ,041,CAÑADA,3,180,94,86,11
HIDALGO,13,MIXQUIAHUALA DE JUÁREZ,041,CINTA LARGA SECCIÓN 22,2,2611,1232,1379,153
HIDALGO,13,MIXQUIAHUALA DE JUÁREZ,041,COLONIA TEÑHE,3,497,237,260,28
HIDALGO,13,MIXQUIAHUALA DE JUÁREZ,041,FELIPE CARRILLO PUERTO,2,43,24,19,5
HIDALGO,13,MIXQUIAHUALA DE JUÁREZ,041,HACIENDA VIEJA,2,30,12,18,3
HIDALGO,13,MIXQUIAHUALA DE JUÁREZ,041,JAGÜEY BLANCO,2,150,71,79,8
HIDALGO,13,MIXQUIAHUALA DE JUÁREZ,041,MIXQUIAHUALA DE JUÁREZ,36,6383,3278,3105,389
HIDALGO,13,MIXQUIAHUALA DE JUÁREZ,041,MORELOS (EL NUEVE) [COLONIA],3,353,161,192,20
HIDALGO,13,MIXQUIAHUALA DE JUÁREZ,041,MOTOBATHA,3,164,77,87,11
HIDALGO,13,MIXQUIAHUALA DE JUÁREZ,041,PALMILLAS [COLONIA],3,224,100,124,11
HIDALGO,13,MIXQUIAHUALA DE JUÁREZ,041,TEPEITIC,4,329,169,160,16
HIDALGO,13,MIXQUIAHUALA DE JUÁREZ,041,VERACRUZ [COLONIA],3,288,136,152,18
HIDALGO,13,MOLANGO DE ESCAMILLA,042,ACAYUCA,3,107,47,60,10
HIDALGO,13,MOLANGO DE ESCAMILLA,042,ATEZCA,3,131,64,67,9
HIDALGO,13,MOLANGO DE ESCAMILLA,042,COACHULA,2,14,5,9,2
HIDALGO,13,MOLANGO DE ESCAMILLA,042,CUXHUACAN,3,88,44,44,8
HIDALGO,13,MOLANGO DE ESCAMILLA,042,IXCATLÁN (SAN PEDRO),3,32,17,15,4
HIDALGO,13,MOLANGO DE ESCAMILLA,042,IXCOTLA (NUEVO IXCOTLA),1,9,7,2,1
HIDALGO,13,MOLANGO DE ESCAMILLA,042,IXCUICUILA,4,110,60,50,10
HIDALGO,13,MOLANGO DE ESCAMILLA,042,IXMOLINTLA,2,21,10,11,3
HIDALGO,13,MOLANGO DE ESCAMILLA,042,MALILA,3,151,67,84,12
HIDALGO,13,MOLANGO DE ESCAMILLA,042,MOLANGO DE ESCAMILLA,8,1424,699,725,116
HIDALGO,13,MOLANGO DE ESCAMILLA,042,MOLOCOTLÁN,1,11,7,4,1
HIDALGO,13,MOLANGO DE ESCAMILLA,042,NAOPA,4,147,69,78,11
HIDALGO,13,MOLANGO DE ESCAMILLA,042,PEMUXTITLA,2,31,16,15,2
HIDALGO,13,MOLANGO DE ESCAMILLA,042,SAN ANTONIO,4,174,93,81,14
HIDALGO,13,MOLANGO DE ESCAMILLA,042,SAN BERNARDO,2,20,6,14,3
HIDALGO,13,MOLANGO DE ESCAMILLA,042,TEMACUIL,3,15,6,9,3
HIDALGO,13,MOLANGO DE ESCAMILLA,042,TENANGO,2,38,25,13,3
HIDALGO,13,MOLANGO DE ESCAMILLA,042,TEPETLAPA,2,10,7,3,1
HIDALGO,13,MOLANGO DE ESCAMILLA,042,TLATZINTLA,3,115,61,54,8
HIDALGO,13,MOLANGO DE ESCAMILLA,042,XICALANGO,2,4,3,1,1
HIDALGO,13,MOLANGO DE ESCAMILLA,042,XUCHITLÁN,1,4,2,2,1
HIDALGO,13,MOLANGO DE ESCAMILLA,042,ZACUALA (HUIXQUILICO),1,5,4,1,1
HIDALGO,13,NICOLÁS FLORES,043,AGUA LIMPIA,3,57,29,28,7
HIDALGO,13,NICOLÁS FLORES,043,BOCUA,4,122,62,60,15
HIDALGO,13,NICOLÁS FLORES,043,CASTADHO,2,25,10,15,3
HIDALGO,13,NICOLÁS FLORES,043,CERRO DE LA CRUZ,1,6,4,2,1
HIDALGO,13,NICOLÁS FLORES,043,CERRO PRIETO,3,32,18,14,3
HIDALGO,13,NICOLÁS FLORES,043,CRUZ DE PIEDRA,2,10,5,5,2
HIDALGO,13,NICOLÁS FLORES,043,EL AGUACATE,3,13,5,8,2
HIDALGO,13,NICOLÁS FLORES,043,EL COBRE,4,67,29,38,11
HIDALGO,13,NICOLÁS FLORES,043,EL DOTHU,2,32,15,17,3
HIDALGO,13,NICOLÁS FLORES,043,IGLESIA VIEJA,2,28,10,18,3
HIDALGO,13,NICOLÁS FLORES,043,ITATLAXCO,2,7,6,1,2
HIDALGO,13,NICOLÁS FLORES,043,JAGÜEY,2,11,7,4,1
HIDALGO,13,NICOLÁS FLORES,043,LA BONANZA,1,5,3,2,1
HIDALGO,13,NICOLÁS FLORES,043,LA CIÉNEGA,2,39,23,16,4
HIDALGO,13,NICOLÁS FLORES,043,LA LAGUNA,3,68,27,41,6
HIDALGO,13,NICOLÁS FLORES,043,LA UNIÓN,2,6,2,4,1
HIDALGO,13,NICOLÁS FLORES,043,LAS MILPAS,2,9,5,4,1
HIDALGO,13,NICOLÁS FLORES,043,LAS PILAS,2,11,6,5,1
HIDALGO,13,NICOLÁS FLORES,043,NICOLÁS FLORES,3,241,111,130,18
HIDALGO,13,NICOLÁS FLORES,043,PAJIADHI,2,22,12,10,4
HIDALGO,13,NICOLÁS FLORES,043,PIJAY,2,12,7,5,2
HIDALGO,13,NICOLÁS FLORES,043,PUERTO DE PIEDRA,3,25,12,13,4
HIDALGO,13,NICOLÁS FLORES,043,SANTA CRUZ,2,40,18,22,5
HIDALGO,13,NICOLÁS FLORES,043,SANTO DOMINGO,2,4,3,1,1
HIDALGO,13,NICOLÁS FLORES,043,SEGUNDO SANTA CRUZ,1,7,3,4,1
HIDALGO,13,NICOLÁS FLORES,043,TAXHAY,3,23,10,13,3
HIDALGO,13,NICOLÁS FLORES,043,TEDRA,2,16,11,5,2
HIDALGO,13,NICOLÁS FLORES,043,TEXCADHO,3,55,27,28,6
HIDALGO,13,NICOLÁS FLORES,043,VILLA HERMOSA,3,52,24,28,6
HIDALGO,13,NICOLÁS FLORES,043,VILLA JUÁREZ,2,7,0,7,1
HIDALGO,13,NICOLÁS FLORES,043,YUDHO,1,125,57,68,7
HIDALGO,13,NICOLÁS FLORES,043,ZOYATAL,3,34,15,19,6
HIDALGO,13,NOPALA DE VILLAGRÁN,044,BATHA Y BARRIOS,4,140,66,74,10
HIDALGO,13,NOPALA DE VILLAGRÁN,044,CUAXITHI,2,62,32,30,4
HIDALGO,13,NOPALA DE VILLAGRÁN,044,DAÑU,4,171,91,80,10
HIDALGO,13,NOPALA DE VILLAGRÁN,044,DENTHÓ,1,13,4,9,1
HIDALGO,13,NOPALA DE VILLAGRÁN,044,EL BORBOLLÓN,3,91,39,52,6
HIDALGO,13,NOPALA DE VILLAGRÁN,044,EL CAPULÍN DE ARAGÓN,2,5,1,4,1
HIDALGO,13,NOPALA DE VILLAGRÁN,044,EL CEDAZO,2,8,5,3,1
HIDALGO,13,NOPALA DE VILLAGRÁN,044,EL FRESNO (CASAS VIEJAS),4,303,118,185,14
HIDALGO,13,NOPALA DE VILLAGRÁN,044,EL JAGÜEY,3,304,156,148,17
HIDALGO,13,NOPALA DE VILLAGRÁN,044,EL MANGUI,2,17,9,8,3
HIDALGO,13,NOPALA DE VILLAGRÁN,044,EL MOGOTE,2,17,10,7,2
HIDALGO,13,NOPALA DE VILLAGRÁN,044,HUMINI,2,8,5,3,1
HIDALGO,13,NOPALA DE VILLAGRÁN,044,LA CAÑADA,1,5,2,3,1
HIDALGO,13,NOPALA DE VILLAGRÁN,044,LA CUCHILLA,2,6,3,3,1
HIDALGO,13,NOPALA DE VILLAGRÁN,044,LA FUENTE (JAGÜEY BLANCO),2,12,7,5,2
HIDALGO,13,NOPALA DE VILLAGRÁN,044,LA PALMA,2,21,11,10,3
HIDALGO,13,NOPALA DE VILLAGRÁN,044,LA SALITA,1,4,2,2,1
HIDALGO,13,NOPALA DE VILLAGRÁN,044,LA SIEMPREVIVA,2,27,13,14,2
HIDALGO,13,NOPALA DE VILLAGRÁN,044,LAS CRUCES,2,7,3,4,1
HIDALGO,13,NOPALA DE VILLAGRÁN,044,LAS VEGAS,2,6,5,1,1
HIDALGO,13,NOPALA DE VILLAGRÁN,044,LOS CERRITOS,1,5,2,3,1
HIDALGO,13,NOPALA DE VILLAGRÁN,044,MARAVILLAS,4,335,167,168,17
HIDALGO,13,NOPALA DE VILLAGRÁN,044,NOPALA DE VILLAGRÁN,8,1364,701,663,97
HIDALGO,13,NOPALA DE VILLAGRÁN,044,SAN LORENZO EL CHICO,3,183,84,99,8
HIDALGO,13,NOPALA DE VILLAGRÁN,044,SAN SEBASTIÁN DE JUÁREZ,3,89,43,46,8
HIDALGO,13,NOPALA DE VILLAGRÁN,044,SAN SEBASTIÁN TENOCHTITLÁN,3,314,156,158,17
HIDALGO,13,NOPALA DE VILLAGRÁN,044,SANTA ROSA EL MARQUÉS,1,8,4,4,1
HIDALGO,13,OMITLÁN DE JUÁREZ,045,CERRO GORDO,2,12,5,7,2
HIDALGO,13,OMITLÁN DE JUÁREZ,045,CRUZ DE MUJER,2,110,59,51,7
HIDALGO,13,OMITLÁN DE JUÁREZ,045,CRUZ DE OMITLÁN,1,6,1,5,1
HIDALGO,13,OMITLÁN DE JUÁREZ,045,EL PERICO,1,1283,636,647,98
HIDALGO,13,OMITLÁN DE JUÁREZ,045,EL TEJOCOTE,2,140,65,75,9
HIDALGO,13,OMITLÁN DE JUÁREZ,045,IGNACIO LÓPEZ RAYÓN,3,111,58,53,9
HIDALGO,13,OMITLÁN DE JUÁREZ,045,MANUEL TENIENTE (EL LLANO),2,27,15,12,2
HIDALGO,13,OMITLÁN DE JUÁREZ,045,OMITLÁN DE JUÁREZ,3,490,275,215,21
HIDALGO,13,OMITLÁN DE JUÁREZ,045,PUENTECILLAS,1,8,5,3,1
HIDALGO,13,OMITLÁN DE JUÁREZ,045,SAN ANTONIO EL PASO,4,288,132,156,16
HIDALGO,13,OMITLÁN DE JUÁREZ,045,VELASCO,3,227,116,111,15
HIDALGO,13,OMITLÁN DE JUÁREZ,045,VENTA DE GUADALUPE,3,216,111,105,11
HIDALGO,13,OMITLÁN DE JUÁREZ,045,VICENTE GUERRERO,2,33,20,13,3
HIDALGO,13,SAN FELIPE ORIZATLÁN,046,AHUAIXPA,3,47,24,23,4
HIDALGO,13,SAN FELIPE ORIZATLÁN,046,AHUATITLA,7,1508,781,727,73
HIDALGO,13,SAN FELIPE ORIZATLÁN,046,AHUEHUETITLA,2,26,12,14,2
HIDALGO,13,SAN FELIPE ORIZATLÁN,046,AHUIMUL,3,33,16,17,4
HIDALGO,13,SAN FELIPE ORIZATLÁN,046,APAXTZINTLA,2,39,20,19,5
HIDALGO,13,SAN FELIPE ORIZATLÁN,046,ARROYO DE CAL,1,13,9,4,1
HIDALGO,13,SAN FELIPE ORIZATLÁN,046,BUENOS AIRES,3,26,15,11,3
HIDALGO,13,SAN FELIPE ORIZATLÁN,046,CECECAMEL,1,15,8,7,2
HIDALGO,13,SAN FELIPE ORIZATLÁN,046,CHACUALA,1,7,3,4,1
HIDALGO,13,SAN FELIPE ORIZATLÁN,046,CHANCUETLÁN,2,17,8,9,2
HIDALGO,13,SAN FELIPE ORIZATLÁN,046,COAXOCOTITLA II,2,28,15,13,3
HIDALGO,13,SAN FELIPE ORIZATLÁN,046,CUAMECACO,3,63,42,21,7
HIDALGO,13,SAN FELIPE ORIZATLÁN,046,EJIDO 3 DE MARZO,2,65,25,40,5
HIDALGO,13,SAN FELIPE ORIZATLÁN,046,EL BRASILAR,2,7,1,6,1
HIDALGO,13,SAN FELIPE ORIZATLÁN,046,EL CARRIZAL,3,123,67,56,9
HIDALGO,13,SAN FELIPE ORIZATLÁN,046,EL CERRO,4,111,37,74,10
HIDALGO,13,SAN FELIPE ORIZATLÁN,046,EL LLANO,2,160,71,89,8
HIDALGO,13,SAN FELIPE ORIZATLÁN,046,EL MANANTIAL,2,23,9,14,3
HIDALGO,13,SAN FELIPE ORIZATLÁN,046,EL NARANJAL,2,38,22,16,4
HIDALGO,13,SAN FELIPE ORIZATLÁN,046,EL OJITE,2,29,16,13,4
HIDALGO,13,SAN FELIPE ORIZATLÁN,046,EL POTRERO,2,24,10,14,2
HIDALGO,13,SAN FELIPE ORIZATLÁN,046,EL RINCÓN,1,5,3,2,1
HIDALGO,13,SAN FELIPE ORIZATLÁN,046,EL ZAPOTAL,2,17,11,6,3
HIDALGO,13,SAN FELIPE ORIZATLÁN,046,HUEXTETITLA,2,36,17,19,3
HIDALGO,13,SAN FELIPE ORIZATLÁN,046,HUEXTETITLA BIENES COMUNALES,2,87,40,47,5
HIDALGO,13,SAN FELIPE ORIZATLÁN,046,HUEYTLALE,4,112,64,48,11
HIDALGO,13,SAN FELIPE ORIZATLÁN,046,HUICHINTLA,3,144,72,72,7
HIDALGO,13,SAN FELIPE ORIZATLÁN,046,HUITZILINGUITO,3,38,18,20,4
HIDALGO,13,SAN FELIPE ORIZATLÁN,046,HUITZITZILINGO,5,691,352,339,35
HIDALGO,13,SAN FELIPE ORIZATLÁN,046,LA CUCHILLA,2,8,3,5,2
HIDALGO,13,SAN FELIPE ORIZATLÁN,046,LA LABOR I,3,145,81,64,9
HIDALGO,13,SAN FELIPE ORIZATLÁN,046,LA LABOR II,1,10,5,5,1
HIDALGO,13,SAN FELIPE ORIZATLÁN,046,LA LAGUNA,3,54,24,30,8
HIDALGO,13,SAN FELIPE ORIZATLÁN,046,LA LAJA,2,31,16,15,3
HIDALGO,13,SAN FELIPE ORIZATLÁN,046,LA MARIANA,1,24,13,11,2
HIDALGO,13,SAN FELIPE ORIZATLÁN,046,LA MESA DE CUATOLOL,2,33,18,15,3
HIDALGO,13,SAN FELIPE ORIZATLÁN,046,LA PITAJAYA,1,16,11,5,1
HIDALGO,13,SAN FELIPE ORIZATLÁN,046,LAS CHACAS,1,9,4,5,1
HIDALGO,13,SAN FELIPE ORIZATLÁN,046,LAS PIEDRAS (MICRÓPOLIS ECOLÓGICA LAS PIEDRAS),6,362,172,190,22
HIDALGO,13,SAN FELIPE ORIZATLÁN,046,LAS VÍBORAS,2,8,6,2,1
HIDALGO,13,SAN FELIPE ORIZATLÁN,046,LOMAS ALTAS,1,14,7,7,1
HIDALGO,13,SAN FELIPE ORIZATLÁN,046,LOS ALTOS DE SAN PEDRO,3,19,8,11,4
HIDALGO,13,SAN FELIPE ORIZATLÁN,046,LOS COYOLES,4,87,44,43,8
HIDALGO,13,SAN FELIPE ORIZATLÁN,046,LOS HUMOS,3,227,114,113,14
HIDALGO,13,SAN FELIPE ORIZATLÁN,046,LOS JOBOS,2,10,4,6,2
HIDALGO,13,SAN FELIPE ORIZATLÁN,046,LOS PANALES,1,11,4,7,1
HIDALGO,13,SAN FELIPE ORIZATLÁN,046,MAXCARILLO,1,15,3,12,1
HIDALGO,13,SAN FELIPE ORIZATLÁN,046,MAZAQUILICO,2,39,23,16,3
HIDALGO,13,SAN FELIPE ORIZATLÁN,046,MELCHOR OCAMPO,2,10,5,5,1
HIDALGO,13,SAN FELIPE ORIZATLÁN,046,MONTE GRANDE,3,56,26,30,7
HIDALGO,13,SAN FELIPE ORIZATLÁN,046,NEXPA,3,73,26,47,7
HIDALGO,13,SAN FELIPE ORIZATLÁN,046,NUEVA TENOCHTITLÁN,2,39,19,20,3
HIDALGO,13,SAN FELIPE ORIZATLÁN,046,PALMA SOLA,2,26,10,16,4
HIDALGO,13,SAN FELIPE ORIZATLÁN,046,PETLÁCATL COMUNAL,4,66,36,30,7
HIDALGO,13,SAN FELIPE ORIZATLÁN,046,PETLÁCATL EJIDO,1,16,9,7,2
HIDALGO,13,SAN FELIPE ORIZATLÁN,046,PIEDRA HINCADA,5,346,155,191,26
HIDALGO,13,SAN FELIPE ORIZATLÁN,046,PILCAPILLA,3,37,17,20,4
HIDALGO,13,SAN FELIPE ORIZATLÁN,046,POCHOTITLA,2,46,25,21,4
HIDALGO,13,SAN FELIPE ORIZATLÁN,046,POTEJÁMEL,4,54,28,26,9
HIDALGO,13,SAN FELIPE ORIZATLÁN,046,RANCHO NUEVO,2,17,10,7,3
HIDALGO,13,SAN FELIPE ORIZATLÁN,046,SAN FELIPE ORIZATLÁN,16,2317,1171,1146,136
HIDALGO,13,SAN FELIPE ORIZATLÁN,046,SANTA ANA,2,106,52,54,7
HIDALGO,13,SAN FELIPE ORIZATLÁN,046,SANTA CLARA,2,24,14,10,3
HIDALGO,13,SAN FELIPE ORIZATLÁN,046,SANTA ROSA TETLAMA,2,44,23,21,3
HIDALGO,13,SAN FELIPE ORIZATLÁN,046,SANTO DOMINGO,2,34,12,22,3
HIDALGO,13,SAN FELIPE ORIZATLÁN,046,TALAPITZ I,2,34,18,16,3
HIDALGO,13,SAN FELIPE ORIZATLÁN,046,TALAPITZ II,2,25,10,15,2
HIDALGO,13,SAN FELIPE ORIZATLÁN,046,TALOL,4,379,163,216,21
HIDALGO,13,SAN FELIPE ORIZATLÁN,046,TAMALCUATITLA,1,34,17,17,4
HIDALGO,13,SAN FELIPE ORIZATLÁN,046,TAMOCALITO II,1,4,2,2,1
HIDALGO,13,SAN FELIPE ORIZATLÁN,046,TATACUATITLA,2,41,21,20,4
HIDALGO,13,SAN FELIPE ORIZATLÁN,046,TAXISCOATITLA,2,43,22,21,5
HIDALGO,13,SAN FELIPE ORIZATLÁN,046,TEOXTITLA,2,72,38,34,7
HIDALGO,13,SAN FELIPE ORIZATLÁN,046,TEPANTITLA,1,19,8,11,2
HIDALGO,13,SAN FELIPE ORIZATLÁN,046,TEPETZINTLA I,3,61,36,25,5
HIDALGO,13,SAN FELIPE ORIZATLÁN,046,TEPETZINTLA II,1,10,4,6,1
HIDALGO,13,SAN FELIPE ORIZATLÁN,046,TEQUEXQUILICO,3,125,66,59,8
HIDALGO,13,SAN FELIPE ORIZATLÁN,046,TETLAMA GRANDE,2,22,14,8,2
HIDALGO,13,SAN FELIPE ORIZATLÁN,046,TETZÁCUAL,2,40,18,22,4
HIDALGO,13,SAN FELIPE ORIZATLÁN,046,TEXCATLA,3,90,45,45,6
HIDALGO,13,SAN FELIPE ORIZATLÁN,046,TOTONICAPA,4,264,117,147,16
HIDALGO,13,SAN FELIPE ORIZATLÁN,046,TULTITLÁN,3,51,23,28,7
HIDALGO,13,SAN FELIPE ORIZATLÁN,046,TZAPOYO I,3,58,26,32,6
HIDALGO,13,SAN FELIPE ORIZATLÁN,046,VALLE VERDE,2,93,41,52,7
HIDALGO,13,SAN FELIPE ORIZATLÁN,046,XALAMAKECHPA,2,43,17,26,4
HIDALGO,13,SAN FELIPE ORIZATLÁN,046,XALAMATITLA,2,18,6,12,2
HIDALGO,13,SAN FELIPE ORIZATLÁN,046,ZACAPILOL,2,30,15,15,2
HIDALGO,13,SAN FELIPE ORIZATLÁN,046,ZAPOTE ABAJO,3,85,43,42,6
HIDALGO,13,SAN FELIPE ORIZATLÁN,046,ZAPOTE ARRIBA,3,62,27,35,8
HIDALGO,13,SAN FELIPE ORIZATLÁN,046,ZAPOTITLA,2,19,10,9,2
HIDALGO,13,PACULA,047,ADJUNTAS,1,18,7,11,1
HIDALGO,13,PACULA,047,CANOAS,1,10,7,3,1
HIDALGO,13,PACULA,047,EL AGUACATITO,3,37,15,22,4
HIDALGO,13,PACULA,047,EL BAILE,3,52,20,32,5
HIDALGO,13,PACULA,047,EL DEVISADERO,2,18,11,7,2
HIDALGO,13,PACULA,047,EL FRAILE,2,17,7,10,2
HIDALGO,13,PACULA,047,JAGÜEY COLORADO,2,5,2,3,1
HIDALGO,13,PACULA,047,JILIAPAN,4,353,183,170,17
HIDALGO,13,PACULA,047,LA MOHONERA,3,70,34,36,6
HIDALGO,13,PACULA,047,MILPAS VIEJAS,3,39,17,22,4
HIDALGO,13,PACULA,047,MIXQUIAHUALES,3,27,17,10,4
HIDALGO,13,PACULA,047,PACULA,4,164,81,83,12
HIDALGO,13,PACULA,047,POTRERILLOS,2,44,23,21,4
HIDALGO,13,PACULA,047,PUERTO GRANDE,2,9,6,3,2
HIDALGO,13,PACULA,047,RANCHO NUEVO,2,28,13,15,3
HIDALGO,13,PACULA,047,SAN FRANCISCO,3,53,28,25,5
HIDALGO,13,PACULA,047,SANTA MARÍA MIRAFLORES,3,57,26,31,5
HIDALGO,13,PACULA,047,SAUCILLO,2,9,5,4,1
HIDALGO,13,PACULA,047,VICENTE GUERRERO (PRESIDIO),2,73,39,34,5
HIDALGO,13,PACHUCA DE SOTO,048,BARRIO DEL JUDÍO,2,50,24,26,12
HIDALGO,13,PACHUCA DE SOTO,048,CAMELIA (BARRIO LA CAMELIA),2,162,91,71,8
HIDALGO,13,PACHUCA DE SOTO,048,CORONAS,1,8,4,4,1
HIDALGO,13,PACHUCA DE SOTO,048,EL HUIXMÍ,3,511,247,264,30
HIDALGO,13,PACHUCA DE SOTO,048,PACHUCA DE SOTO,523,99626,52005,47621,7727
HIDALGO,13,PACHUCA DE SOTO,048,SAN MIGUEL CEREZO (EL CEREZO),3,338,166,172,18
HIDALGO,13,PACHUCA DE SOTO,048,SANTA GERTRUDIS,2,194,95,99,8
HIDALGO,13,PACHUCA DE SOTO,048,SANTIAGO TLAPACOYA,5,743,387,356,35
HIDALGO,13,PISAFLORES,049,CASAS VIEJAS,3,35,19,16,3
HIDALGO,13,PISAFLORES,049,CERRO DE GUADALUPE,2,23,13,10,2
HIDALGO,13,PISAFLORES,049,CERRO DEL CARMEN,2,16,5,11,1
HIDALGO,13,PISAFLORES,049,CERRO GRANDE,3,39,21,18,4
HIDALGO,13,PISAFLORES,049,CHALAHUITE,4,357,176,181,18
HIDALGO,13,PISAFLORES,049,CHALAHUITITO,3,96,47,49,6
HIDALGO,13,PISAFLORES,049,EL ÁLAMO,3,23,16,7,3
HIDALGO,13,PISAFLORES,049,EL AMOLAR,3,238,116,122,11
HIDALGO,13,PISAFLORES,049,EL BONIGU,3,100,48,52,8
HIDALGO,13,PISAFLORES,049,EL CARACOL,3,92,49,43,7
HIDALGO,13,PISAFLORES,049,EL CEDRAL,2,10,5,5,1
HIDALGO,13,PISAFLORES,049,EL COYOL,3,40,24,16,4
HIDALGO,13,PISAFLORES,049,EL CUAMIRRO,2,5,3,2,1
HIDALGO,13,PISAFLORES,049,EL DURAZNO,3,52,28,24,4
HIDALGO,13,PISAFLORES,049,EL GARABATO,3,61,30,31,4
HIDALGO,13,PISAFLORES,049,EL HIGUERÓN,2,85,40,45,6
HIDALGO,13,PISAFLORES,049,EL LIMONCITO,2,23,10,13,3
HIDALGO,13,PISAFLORES,049,EL RAYO,4,362,191,171,14
HIDALGO,13,PISAFLORES,049,EL ZACATAL,2,23,11,12,2
HIDALGO,13,PISAFLORES,049,ESCONDIDA DE SAN RAFAEL,3,160,81,79,11
HIDALGO,13,PISAFLORES,049,GARGANTILLA,4,278,135,143,15
HIDALGO,13,PISAFLORES,049,GUAYABOS,3,84,44,40,7
HIDALGO,13,PISAFLORES,049,LA AMECA,3,285,130,155,13
HIDALGO,13,PISAFLORES,049,LA ARENA,3,146,75,71,12
HIDALGO,13,PISAFLORES,049,LA CRUCITA,2,42,18,24,3
HIDALGO,13,PISAFLORES,049,LA ESCONDIDA DE LO VERDE,3,26,17,9,3
HIDALGO,13,PISAFLORES,049,LA FLORIDA,2,9,1,8,1
HIDALGO,13,PISAFLORES,049,LA HORMIGA,2,22,17,5,2
HIDALGO,13,PISAFLORES,049,LA LAGUNA,3,77,38,39,6
HIDALGO,13,PISAFLORES,049,LA PALMA,1,7,4,3,1
HIDALGO,13,PISAFLORES,049,LA PECHUGA,3,41,16,25,4
HIDALGO,13,PISAFLORES,049,LA PEÑA,3,152,78,74,9
HIDALGO,13,PISAFLORES,049,LA TINAJA,2,7,2,5,1
HIDALGO,13,PISAFLORES,049,LAS MORAS,3,107,43,64,9
HIDALGO,13,PISAFLORES,049,MIRAFLORES,2,25,16,9,3
HIDALGO,13,PISAFLORES,049,OJO DE AGUA,3,24,13,11,3
HIDALGO,13,PISAFLORES,049,PALMITAS,1,7,5,2,1
HIDALGO,13,PISAFLORES,049,PIE DE LA CUESTA,2,14,6,8,2
HIDALGO,13,PISAFLORES,049,PIEDRA ANCHA,1,11,8,3,1
HIDALGO,13,PISAFLORES,049,PISAFLORES,4,799,383,416,37
HIDALGO,13,PISAFLORES,049,PLAN DE AYALA,1,10,5,5,1
HIDALGO,13,PISAFLORES,049,PLAN DE ZAPOTAL,2,44,28,16,4
HIDALGO,13,PISAFLORES,049,POZA AMARILLA,1,8,2,6,1
HIDALGO,13,PISAFLORES,049,PUERTO OBSCURO,3,60,22,38,5
HIDALGO,13,PISAFLORES,049,RANCHO NUEVO,3,72,31,41,5
HIDALGO,13,PISAFLORES,049,SAN PEDRO XOCHICUACO,3,123,55,68,9
HIDALGO,13,PISAFLORES,049,SAN RAFAEL,3,87,40,47,6
HIDALGO,13,PISAFLORES,049,SAN VICENTE,2,23,9,14,3
HIDALGO,13,PISAFLORES,049,TLACUILOLA,3,90,48,42,7
HIDALGO,13,PISAFLORES,049,TRIPUENTE,3,66,31,35,6
HIDALGO,13,PISAFLORES,049,ZAPOTAL DE MORAS,3,89,48,41,5
HIDALGO,13,PROGRESO DE OBREGÓN,050,EL JARDÍN [COLONIA],2,17,10,7,2
HIDALGO,13,PROGRESO DE OBREGÓN,050,EL MORENO,2,159,87,72,8
HIDALGO,13,PROGRESO DE OBREGÓN,050,EL XAMÚ,1,587,472,115,44
HIDALGO,13,PROGRESO DE OBREGÓN,050,LA RANCHERÍA,2,163,87,76,8
HIDALGO,13,PROGRESO DE OBREGÓN,050,LOS OLIVOS,2,478,250,228,26
HIDALGO,13,PROGRESO DE OBREGÓN,050,PROGRESO DE OBREGÓN,33,5317,2801,2516,451
HIDALGO,13,PROGRESO DE OBREGÓN,050,XOCHITLÁN,3,438,205,233,20
HIDALGO,13,MINERAL DE LA REFORMA,051,ABUNDIO MARTÍNEZ,3,269,136,133,38
HIDALGO,13,MINERAL DE LA REFORMA,051,ÁLAMO RUSTICO,4,92,49,43,13
HIDALGO,13,MINERAL DE LA REFORMA,051,AMAQUE,3,56,26,30,5
HIDALGO,13,MINERAL DE LA REFORMA,051,AZOYATLA DE OCAMPO,5,472,218,254,34
HIDALGO,13,MINERAL DE LA REFORMA,051,BOSQUES DEL MINERAL,5,2591,1567,1024,190
HIDALGO,13,MINERAL DE LA REFORMA,051,CAMPESTRE VILLAS DEL ÁLAMO,5,1266,626,640,70
HIDALGO,13,MINERAL DE LA REFORMA,051,CARBONERAS,6,406,186,220,27
HIDALGO,13,MINERAL DE LA REFORMA,051,CIPRESES,2,762,394,368,56
HIDALGO,13,MINERAL DE LA REFORMA,051,COLINAS DE PLATA,4,412,197,215,25
HIDALGO,13,MINERAL DE LA REFORMA,051,COLONIA MILITAR,1,40,16,24,3
HIDALGO,13,MINERAL DE LA REFORMA,051,DOS CARLOS PUEBLO NUEVO,3,597,279,318,25
HIDALGO,13,MINERAL DE LA REFORMA,051,EL ÁLAMO,8,7337,3039,4298,396
HIDALGO,13,MINERAL DE LA REFORMA,051,EL HUIZACHAL,4,278,150,128,41
HIDALGO,13,MINERAL DE LA REFORMA,051,EL PARAÍSO,3,238,114,124,20
HIDALGO,13,MINERAL DE LA REFORMA,051,EL SAUCILLO,4,462,217,245,25
HIDALGO,13,MINERAL DE LA REFORMA,051,EL SAUCILLO FRACCIONAMIENTO,3,828,380,448,28
HIDALGO,13,MINERAL DE LA REFORMA,051,EL VENADO,10,2547,1362,1185,317
HIDALGO,13,MINERAL DE LA REFORMA,051,EX-HACIENDA DE CHAVARRÍA,1,524,273,251,98
HIDALGO,13,MINERAL DE LA REFORMA,051,FORJADORES DE PACHUCA,3,167,78,89,23
HIDALGO,13,MINERAL DE LA REFORMA,051,HACIENDA MARGARITA,2,510,264,246,18
HIDALGO,13,MINERAL DE LA REFORMA,051,JORGE ROJO LUGO (CBTIS 8),3,2227,1221,1006,303
HIDALGO,13,MINERAL DE LA REFORMA,051,LA COLONIA,2,325,166,159,17
HIDALGO,13,MINERAL DE LA REFORMA,051,LA NORIA,1,29,18,11,3
HIDALGO,13,MINERAL DE LA REFORMA,051,LA PROVIDENCIA SIGLO XXI,15,2384,1228,1156,126
HIDALGO,13,MINERAL DE LA REFORMA,051,LA REFORMA,2,217,108,109,9
HIDALGO,13,MINERAL DE LA REFORMA,051,LA REFORMA (CANACINTRA) [PARQUE INDUSTRIAL],2,706,257,449,93
HIDALGO,13,MINERAL DE LA REFORMA,051,LOMAS DEL CHACÓN,6,1002,507,495,62
HIDALGO,13,MINERAL DE LA REFORMA,051,LOS TUZOS,4,440,209,231,32
HIDALGO,13,MINERAL DE LA REFORMA,051,MAGISTERIO DIGNO,3,548,271,277,24
HIDALGO,13,MINERAL DE LA REFORMA,051,MANUEL ÁVILA CAMACHO,2,180,89,91,9
HIDALGO,13,MINERAL DE LA REFORMA,051,NUEVO CENTRO DE POBLACIÓN AGRÍCOLA EL CHACÓN,1,18,9,9,1
HIDALGO,13,MINERAL DE LA REFORMA,051,PACHUQUILLA,10,1684,794,890,77
HIDALGO,13,MINERAL DE LA REFORMA,051,PASEO DE LOS TULIPANES,4,668,324,344,33
HIDALGO,13,MINERAL DE LA REFORMA,051,PASEOS DE CHAVARRÍA,13,5701,2853,2848,263
HIDALGO,13,MINERAL DE LA REFORMA,051,PRADERAS DE VIRREYES,3,710,339,371,25
HIDALGO,13,MINERAL DE LA REFORMA,051,PRI CHACÓN,4,131,65,66,15
HIDALGO,13,MINERAL DE LA REFORMA,051,PRIVADA DE LOS OLIVOS,1,91,43,48,9
HIDALGO,13,MINERAL DE LA REFORMA,051,RINCONADA DE LOS ÁNGELES,2,496,241,255,21
HIDALGO,13,MINERAL DE LA REFORMA,051,RINCONADAS DE SAN FRANCISCO,5,822,401,421,78
HIDALGO,13,MINERAL DE LA REFORMA,051,RINCONADAS DEL VENADO II,3,380,190,190,30
HIDALGO,13,MINERAL DE LA REFORMA,051,RINCONES DEL PARAÍSO,2,143,73,70,18
HIDALGO,13,MINERAL DE LA REFORMA,051,SAHOP CHACÓN,2,585,299,286,29
HIDALGO,13,MINERAL DE LA REFORMA,051,SAN FERNANDO,2,259,129,130,13
HIDALGO,13,MINERAL DE LA REFORMA,051,SAN GUILLERMO LA REFORMA,2,131,74,57,7
HIDALGO,13,MINERAL DE LA REFORMA,051,SAN JOSÉ,4,228,116,112,13
HIDALGO,13,MINERAL DE LA REFORMA,051,SAN JOSÉ PALMA GORDA,3,189,75,114,22
HIDALGO,13,MINERAL DE LA REFORMA,051,SAN MIGUEL LA HIGA,2,59,32,27,5
HIDALGO,13,MINERAL DE LA REFORMA,051,SANTA MARÍA LA CALERA,7,1558,781,777,61
HIDALGO,13,MINERAL DE LA REFORMA,051,UNIDAD MINERA 11 DE JULIO,7,2735,1406,1329,140
HIDALGO,13,MINERAL DE LA REFORMA,051,VILLAS DEL ÁLAMO,5,191,110,81,28
HIDALGO,13,SAN AGUSTÍN TLAXIACA,052,BANÚS,2,89,37,52,7
HIDALGO,13,SAN AGUSTÍN TLAXIACA,052,BARRIO DE ESPAÑITA,2,31,16,15,3
HIDALGO,13,SAN AGUSTÍN TLAXIACA,052,BENITO JUÁREZ,2,54,29,25,3
HIDALGO,13,SAN AGUSTÍN TLAXIACA,052,CASA GRANDE [BARRIO],3,49,20,29,4
HIDALGO,13,SAN AGUSTÍN TLAXIACA,052,CHALMITA,2,39,19,20,3
HIDALGO,13,SAN AGUSTÍN TLAXIACA,052,CHAPULTEPEC DE POZOS,4,97,43,54,9
HIDALGO,13,SAN AGUSTÍN TLAXIACA,052,DAJIE [BARRIO],2,42,15,27,4
HIDALGO,13,SAN AGUSTÍN TLAXIACA,052,EL BOTHO,2,105,48,57,7
HIDALGO,13,SAN AGUSTÍN TLAXIACA,052,EL CAMPANARIO,2,30,9,21,3
HIDALGO,13,SAN AGUSTÍN TLAXIACA,052,EL CANAL (PARADA SANTA MARÍA),1,3,2,1,1
HIDALGO,13,SAN AGUSTÍN TLAXIACA,052,EL CHAMIZAL,2,28,12,16,3
HIDALGO,13,SAN AGUSTÍN TLAXIACA,052,EL DURAZNO,3,172,85,87,11
HIDALGO,13,SAN AGUSTÍN TLAXIACA,052,EL HUIZACHE,1,15,9,6,1
HIDALGO,13,SAN AGUSTÍN TLAXIACA,052,EL TEPOZÁN,2,15,8,7,2
HIDALGO,13,SAN AGUSTÍN TLAXIACA,052,GUADALUPE LOS MANANTIALES [COLONIA],3,93,29,64,7
HIDALGO,13,SAN AGUSTÍN TLAXIACA,052,IXCUINQUITLAPILCO,4,485,253,232,26
HIDALGO,13,SAN AGUSTÍN TLAXIACA,052,JOSÉ MARÍA PINO SUÁREZ,2,29,9,20,3
HIDALGO,13,SAN AGUSTÍN TLAXIACA,052,LA CONCEPCIÓN,22,18119,10818,7301,1120
HIDALGO,13,SAN AGUSTÍN TLAXIACA,052,LA LOMA,5,232,116,116,27
HIDALGO,13,SAN AGUSTÍN TLAXIACA,052,NUEVA TLAXIACA,2,362,172,190,13
HIDALGO,13,SAN AGUSTÍN TLAXIACA,052,ORIENTAL DE ZAPATA,3,386,186,200,18
HIDALGO,13,SAN AGUSTÍN TLAXIACA,052,PALOS BLANCOS,2,20,9,11,2
HIDALGO,13,SAN AGUSTÍN TLAXIACA,052,PASEO DE LOS SOLARES,1,14,9,5,1
HIDALGO,13,SAN AGUSTÍN TLAXIACA,052,PUERTO MÉXICO,4,192,86,106,13
HIDALGO,13,SAN AGUSTÍN TLAXIACA,052,SAN AGUSTÍN TLAXIACA,22,6422,3065,3357,379
HIDALGO,13,SAN AGUSTÍN TLAXIACA,052,SAN FRANCISCO TECAJIQUE,2,37,17,20,4
HIDALGO,13,SAN AGUSTÍN TLAXIACA,052,SAN ISIDRO LLANO LARGO,2,43,16,27,4
HIDALGO,13,SAN AGUSTÍN TLAXIACA,052,SAN JUAN SOLÍS,3,413,202,211,21
HIDALGO,13,SAN AGUSTÍN TLAXIACA,052,SAN JUAN TILCUAUTLA,4,374,167,207,51
HIDALGO,13,SAN AGUSTÍN TLAXIACA,052,SAN MIGUEL TORNACUXTLA,3,478,233,245,24
HIDALGO,13,SAN AGUSTÍN TLAXIACA,052,SANTA CATARINA,2,11,6,5,1
HIDALGO,13,SAN AGUSTÍN TLAXIACA,052,SANTA MARÍA,2,22,9,13,2
HIDALGO,13,SAN AGUSTÍN TLAXIACA,052,VINDHÓ [BARRIO],1,6,4,2,1
HIDALGO,13,SAN BARTOLO TUTOTEPEC,053,AGUA ESCONDIDA,1,6,3,3,1
HIDALGO,13,SAN BARTOLO TUTOTEPEC,053,AGUA GRANDE,2,17,7,10,2
HIDALGO,13,SAN BARTOLO TUTOTEPEC,053,AGUA HEDIONDA,2,7,6,1,1
HIDALGO,13,SAN BARTOLO TUTOTEPEC,053,BARRIO DE LAS MARAVILLAS,2,5,3,2,1
HIDALGO,13,SAN BARTOLO TUTOTEPEC,053,BARRIO DEL CANJOY,2,6,3,3,1
HIDALGO,13,SAN BARTOLO TUTOTEPEC,053,BUENA VISTA,2,28,12,16,3
HIDALGO,13,SAN BARTOLO TUTOTEPEC,053,CALINTLA,2,96,43,53,7
HIDALGO,13,SAN BARTOLO TUTOTEPEC,053,CERRO DE BUENA VISTA,1,10,4,6,1
HIDALGO,13,SAN BARTOLO TUTOTEPEC,053,CERRO MACHO,3,45,25,20,4
HIDALGO,13,SAN BARTOLO TUTOTEPEC,053,CERRO NEGRO,2,29,14,15,3
HIDALGO,13,SAN BARTOLO TUTOTEPEC,053,CERRO VERDE,3,52,23,29,5
HIDALGO,13,SAN BARTOLO TUTOTEPEC,053,CHICAMOLE,3,35,11,24,4
HIDALGO,13,SAN BARTOLO TUTOTEPEC,053,COLONIA INDUSTRIAL,2,69,38,31,3
HIDALGO,13,SAN BARTOLO TUTOTEPEC,053,DIEZ CERROS,2,10,5,5,2
HIDALGO,13,SAN BARTOLO TUTOTEPEC,053,EL BANCO,2,19,8,11,2
HIDALGO,13,SAN BARTOLO TUTOTEPEC,053,EL CANJOY,3,69,37,32,6
HIDALGO,13,SAN BARTOLO TUTOTEPEC,053,EL COPAL,3,51,21,30,6
HIDALGO,13,SAN BARTOLO TUTOTEPEC,053,EL DENXE,3,30,19,11,4
HIDALGO,13,SAN BARTOLO TUTOTEPEC,053,EL DÓNIMO,1,10,7,3,1
HIDALGO,13,SAN BARTOLO TUTOTEPEC,053,EL FRESNO,2,9,5,4,1
HIDALGO,13,SAN BARTOLO TUTOTEPEC,053,EL HONGO,4,11,7,4,2
HIDALGO,13,SAN BARTOLO TUTOTEPEC,053,EL JICOTE,2,9,5,4,1
HIDALGO,13,SAN BARTOLO TUTOTEPEC,053,EL JOVIÓN,1,11,6,5,1
HIDALGO,13,SAN BARTOLO TUTOTEPEC,053,EL LINDERO CHICO,2,4,4,0,1
HIDALGO,13,SAN BARTOLO TUTOTEPEC,053,EL MAHUAQUITE,3,21,7,14,3
HIDALGO,13,SAN BARTOLO TUTOTEPEC,053,EL MAVODO,3,72,30,42,5
HIDALGO,13,SAN BARTOLO TUTOTEPEC,053,EL MUNDHÓ,1,6,3,3,1
HIDALGO,13,SAN BARTOLO TUTOTEPEC,053,EL NANDHO,2,34,21,13,3
HIDALGO,13,SAN BARTOLO TUTOTEPEC,053,EL NANJO,2,21,12,9,3
HIDALGO,13,SAN BARTOLO TUTOTEPEC,053,EL NENJO,2,16,5,11,3
HIDALGO,13,SAN BARTOLO TUTOTEPEC,053,EL PARAÍSO DE TIERRA FUERTE,2,7,3,4,1
HIDALGO,13,SAN BARTOLO TUTOTEPEC,053,EL PEDREGAL,2,25,14,11,3
HIDALGO,13,SAN BARTOLO TUTOTEPEC,053,EL PIÑAL,3,12,7,5,2
HIDALGO,13,SAN BARTOLO TUTOTEPEC,053,EL POPOTILLO GRANDE,1,4,1,3,1
HIDALGO,13,SAN BARTOLO TUTOTEPEC,053,EL PROGRESO,1,13,4,9,1
HIDALGO,13,SAN BARTOLO TUTOTEPEC,053,EL VEINTE,3,47,19,28,5
HIDALGO,13,SAN BARTOLO TUTOTEPEC,053,EL XÚCHITL,3,30,19,11,4
HIDALGO,13,SAN BARTOLO TUTOTEPEC,053,EL ZENTHE,3,12,6,6,3
HIDALGO,13,SAN BARTOLO TUTOTEPEC,053,HUASQUILLA,3,42,14,28,3
HIDALGO,13,SAN BARTOLO TUTOTEPEC,053,LA CUEVA,2,10,3,7,2
HIDALGO,13,SAN BARTOLO TUTOTEPEC,053,LA CUMBRE DE MURIDORES,3,55,28,27,5
HIDALGO,13,SAN BARTOLO TUTOTEPEC,053,LA HUAHUA,2,19,12,7,3
HIDALGO,13,SAN BARTOLO TUTOTEPEC,053,LA JOYA,3,100,42,58,8
HIDALGO,13,SAN BARTOLO TUTOTEPEC,053,LA LOMA DE SAN ANDRÉS,2,7,2,5,1
HIDALGO,13,SAN BARTOLO TUTOTEPEC,053,LA MESA,2,5,1,4,1
HIDALGO,13,SAN BARTOLO TUTOTEPEC,053,LA SABANA,3,19,9,10,3
HIDALGO,13,SAN BARTOLO TUTOTEPEC,053,LA SEGUNDA RANCHERÍA,2,13,6,7,2
HIDALGO,13,SAN BARTOLO TUTOTEPEC,053,LA VENTA,1,18,6,12,2
HIDALGO,13,SAN BARTOLO TUTOTEPEC,053,LA VEREDA,3,64,33,31,6
HIDALGO,13,SAN BARTOLO TUTOTEPEC,053,LOMA LARGA,2,15,8,7,2
HIDALGO,13,SAN BARTOLO TUTOTEPEC,053,LOS MANANTIALES,2,8,2,6,1
HIDALGO,13,SAN BARTOLO TUTOTEPEC,053,MEDIA CUESTA,2,36,14,22,3
HIDALGO,13,SAN BARTOLO TUTOTEPEC,053,MEDIO MONTE,2,17,7,10,2
HIDALGO,13,SAN BARTOLO TUTOTEPEC,053,MILPA LARGA,1,7,4,3,1
HIDALGO,13,SAN BARTOLO TUTOTEPEC,053,PALO GORDO,3,26,11,15,4
HIDALGO,13,SAN BARTOLO TUTOTEPEC,053,PIE DEL CERRO,3,230,109,121,15
HIDALGO,13,SAN BARTOLO TUTOTEPEC,053,PIEDRA ANCHA,2,15,9,6,2
HIDALGO,13,SAN BARTOLO TUTOTEPEC,053,PIEDRA LARGA,1,4,1,3,1
HIDALGO,13,SAN BARTOLO TUTOTEPEC,053,PUEBLO NUEVO,2,17,9,8,2
HIDALGO,13,SAN BARTOLO TUTOTEPEC,053,RANCHO NUEVO,2,27,16,11,3
HIDALGO,13,SAN BARTOLO TUTOTEPEC,053,RÍO CHIQUITO,1,8,4,4,1
HIDALGO,13,SAN BARTOLO TUTOTEPEC,053,SAN ANDRÉS,5,302,150,152,28
HIDALGO,13,SAN BARTOLO TUTOTEPEC,053,SAN ANTONIO,2,7,3,4,1
HIDALGO,13,SAN BARTOLO TUTOTEPEC,053,SAN BARTOLO TUTOTEPEC,7,1027,541,486,78
HIDALGO,13,SAN BARTOLO TUTOTEPEC,053,SAN GABRIEL,3,26,12,14,3
HIDALGO,13,SAN BARTOLO TUTOTEPEC,053,SAN JERÓNIMO,4,110,67,43,10
HIDALGO,13,SAN BARTOLO TUTOTEPEC,053,SAN JUAN DE LAS FLORES,4,139,68,71,9
HIDALGO,13,SAN BARTOLO TUTOTEPEC,053,SAN MATEO,4,114,69,45,11
HIDALGO,13,SAN BARTOLO TUTOTEPEC,053,SAN MIGUEL,4,154,77,77,11
HIDALGO,13,SAN BARTOLO TUTOTEPEC,053,SAN SEBASTIÁN,4,81,44,37,8
HIDALGO,13,SAN BARTOLO TUTOTEPEC,053,SANTA CRUZ,3,35,13,22,4
HIDALGO,13,SAN BARTOLO TUTOTEPEC,053,SANTIAGO,3,181,90,91,13
HIDALGO,13,SAN BARTOLO TUTOTEPEC,053,TENANTITLÁN,2,16,8,8,2
HIDALGO,13,SAN BARTOLO TUTOTEPEC,053,TIERRA FUERTE,1,10,5,5,1
HIDALGO,13,SAN BARTOLO TUTOTEPEC,053,TUTOTEPEC,3,37,22,15,5
HIDALGO,13,SAN BARTOLO TUTOTEPEC,053,VALLE VERDE,2,198,103,95,14
HIDALGO,13,SAN BARTOLO TUTOTEPEC,053,XUCHITLÁN,3,86,46,40,8
HIDALGO,13,SAN SALVADOR,054,BOCAJA,2,76,41,35,7
HIDALGO,13,SAN SALVADOR,054,BOMINTHZA,2,52,28,24,5
HIDALGO,13,SAN SALVADOR,054,BOXAXNI,2,131,61,70,7
HIDALGO,13,SAN SALVADOR,054,BÓXTHA CHICO,2,32,15,17,2
HIDALGO,13,SAN SALVADOR,054,CAÑADA GRANDE,2,115,57,58,7
HIDALGO,13,SAN SALVADOR,054,CASA BLANCA,1,23,15,8,2
HIDALGO,13,SAN SALVADOR,054,CASA GRANDE,2,61,27,34,4
HIDALGO,13,SAN SALVADOR,054,CAXUXI,3,737,364,373,36
HIDALGO,13,SAN SALVADOR,054,CERRO BLANCO,2,29,18,11,4
HIDALGO,13,SAN SALVADOR,054,CHICHIMECAS,3,75,35,40,9
HIDALGO,13,SAN SALVADOR,054,DEMACU,2,97,51,46,8
HIDALGO,13,SAN SALVADOR,054,DENGANDHÓ DE JUÁREZ,2,94,56,38,8
HIDALGO,13,SAN SALVADOR,054,DÉXTHO DE VICTORIA,3,153,82,71,11
HIDALGO,13,SAN SALVADOR,054,EL BONDHO,2,75,31,44,6
HIDALGO,13,SAN SALVADOR,054,EL COLORADO,2,131,57,74,8
HIDALGO,13,SAN SALVADOR,054,EL FRESNO,2,75,34,41,8
HIDALGO,13,SAN SALVADOR,054,EL MEZQUITAL,2,55,28,27,5
HIDALGO,13,SAN SALVADOR,054,EL MOTHÉ,2,118,62,56,8
HIDALGO,13,SAN SALVADOR,054,EL OLVERA,2,92,55,37,7
HIDALGO,13,SAN SALVADOR,054,EL PUERTO LÁZARO CÁRDENAS,2,90,45,45,8
HIDALGO,13,SAN SALVADOR,054,EL RODRIGO,2,77,29,48,6
HIDALGO,13,SAN SALVADOR,054,EL TABLÓN,2,81,42,39,7
HIDALGO,13,SAN SALVADOR,054,FRANCISCO VILLA,2,36,15,21,4
HIDALGO,13,SAN SALVADOR,054,LA FLOR,3,83,43,40,6
HIDALGO,13,SAN SALVADOR,054,LAGUNILLA,4,286,122,164,13
HIDALGO,13,SAN SALVADOR,054,LEANDRO VALLE,2,118,47,71,7
HIDALGO,13,SAN SALVADOR,054,PACHECO DE ALLENDE,2,66,31,35,7
HIDALGO,13,SAN SALVADOR,054,POXINDEJE DE MORELOS,4,1331,841,490,115
HIDALGO,13,SAN SALVADOR,054,QUEMTHA,2,117,62,55,9
HIDALGO,13,SAN SALVADOR,054,RINCÓN SANTA MARÍA,3,25,11,14,3
HIDALGO,13,SAN SALVADOR,054,SAN ANTONIO ABAD,2,21,6,15,3
HIDALGO,13,SAN SALVADOR,054,SAN ANTONIO ZARAGOZA,5,830,423,407,42
HIDALGO,13,SAN SALVADOR,054,SAN MIGUEL ACAMBAY,3,168,81,87,11
HIDALGO,13,SAN SALVADOR,054,SAN SALVADOR,5,547,266,281,34
HIDALGO,13,SAN SALVADOR,054,SANTA MARÍA AMAJAC,7,1193,587,606,59
HIDALGO,13,SAN SALVADOR,054,TEOFANI,2,132,57,75,8
HIDALGO,13,SAN SALVADOR,054,TOTHIE DE ROJO GÓMEZ,2,91,48,43,7
HIDALGO,13,SAN SALVADOR,054,VIXTHA DE MADERO,2,86,42,44,6
HIDALGO,13,SAN SALVADOR,054,XUCHITLÁN,4,574,274,300,32
HIDALGO,13,SANTIAGO DE ANAYA,055,CERRITOS,2,203,101,102,10
HIDALGO,13,SANTIAGO DE ANAYA,055,EJIDO DEL MEZQUITAL,2,35,23,12,3
HIDALGO,13,SANTIAGO DE ANAYA,055,EL AGUACATE,2,10,4,6,2
HIDALGO,13,SANTIAGO DE ANAYA,055,EL ÁGUILA,2,28,13,15,3
HIDALGO,13,SANTIAGO DE ANAYA,055,EL ENCINO,3,52,23,29,6
HIDALGO,13,SANTIAGO DE ANAYA,055,EL MEZQUITAL,3,234,103,131,13
HIDALGO,13,SANTIAGO DE ANAYA,055,EL PALMAR,2,51,25,26,3
HIDALGO,13,SANTIAGO DE ANAYA,055,EL PORVENIR,2,12,9,3,2
HIDALGO,13,SANTIAGO DE ANAYA,055,EL SITIO,2,30,17,13,3
HIDALGO,13,SANTIAGO DE ANAYA,055,GONZÁLEZ GONZÁLEZ,2,63,35,28,4
HIDALGO,13,SANTIAGO DE ANAYA,055,GONZÁLEZ ORTEGA,3,117,67,50,8
HIDALGO,13,SANTIAGO DE ANAYA,055,GUERRERO,3,96,43,53,8
HIDALGO,13,SANTIAGO DE ANAYA,055,HERMOSILLO MONTE NOBLE,4,154,72,82,13
HIDALGO,13,SANTIAGO DE ANAYA,055,JAGÜEY,2,35,16,19,3
HIDALGO,13,SANTIAGO DE ANAYA,055,LA BLANCA (TAXTHO LA BLANCA),2,110,50,60,8
HIDALGO,13,SANTIAGO DE ANAYA,055,LOMAS DE GUILLÉN,1,4,2,2,1
HIDALGO,13,SANTIAGO DE ANAYA,055,PATRIA NUEVA,4,663,324,339,82
HIDALGO,13,SANTIAGO DE ANAYA,055,SANTA MÓNICA,4,144,66,78,11
HIDALGO,13,SANTIAGO DE ANAYA,055,SANTIAGO DE ANAYA,5,990,488,502,45
HIDALGO,13,SANTIAGO DE ANAYA,055,XITZO,2,70,28,42,7
HIDALGO,13,SANTIAGO DE ANAYA,055,YOLOTEPEC,4,515,234,281,30
HIDALGO,13,SANTIAGO DE ANAYA,055,ZARAGOZA,2,58,28,30,4
HIDALGO,13,SANTIAGO TULANTEPEC DE LUGO GUERRERO,056,ALTEPEMILA,2,15,3,12,3
HIDALGO,13,SANTIAGO TULANTEPEC DE LUGO GUERRERO,056,EL PEDREGAL DE SAN JOSÉ,6,690,344,346,34
HIDALGO,13,SANTIAGO TULANTEPEC DE LUGO GUERRERO,056,EMILIANO ZAPATA,9,3097,1891,1206,277
HIDALGO,13,SANTIAGO TULANTEPEC DE LUGO GUERRERO,056,FELIPE ÁNGELES [COLONIA],2,432,206,226,17
HIDALGO,13,SANTIAGO TULANTEPEC DE LUGO GUERRERO,056,LA JOYA,1,5,1,4,1
HIDALGO,13,SANTIAGO TULANTEPEC DE LUGO GUERRERO,056,LAS LAJAS,2,36,18,18,3
HIDALGO,13,SANTIAGO TULANTEPEC DE LUGO GUERRERO,056,LOS ROMEROS,3,449,235,214,21
HIDALGO,13,SANTIAGO TULANTEPEC DE LUGO GUERRERO,056,PAXTEPEC,2,265,120,145,12
HIDALGO,13,SANTIAGO TULANTEPEC DE LUGO GUERRERO,056,SAN MIGUEL HUATENGO,2,65,30,35,3
HIDALGO,13,SANTIAGO TULANTEPEC DE LUGO GUERRERO,056,SAN PEDRO HUATENGO,3,644,313,331,61
HIDALGO,13,SANTIAGO TULANTEPEC DE LUGO GUERRERO,056,SANTIAGO TULANTEPEC,18,4026,2017,2009,204
HIDALGO,13,SANTIAGO TULANTEPEC DE LUGO GUERRERO,056,TILHUACÁN,2,59,36,23,4
HIDALGO,13,SANTIAGO TULANTEPEC DE LUGO GUERRERO,056,UNIDADES HABITACIONALES,4,944,464,480,35
HIDALGO,13,SANTIAGO TULANTEPEC DE LUGO GUERRERO,056,VENTOQUIPA,2,174,83,91,9
HIDALGO,13,SINGUILUCAN,057,AGUAYUTLA,1,6,4,2,1
HIDALGO,13,SINGUILUCAN,057,ALFAJAYUCAN,2,65,31,34,6
HIDALGO,13,SINGUILUCAN,057,AMOLUCAN,1,5,0,5,1
HIDALGO,13,SINGUILUCAN,057,CUATRO PALOS,2,65,32,33,4
HIDALGO,13,SINGUILUCAN,057,EL CEBADAL,2,21,3,18,2
HIDALGO,13,SINGUILUCAN,057,EL SUSTO,3,385,182,203,19
HIDALGO,13,SINGUILUCAN,057,EL VARAL,2,53,27,26,4
HIDALGO,13,SINGUILUCAN,057,FRANCISCO I. MADERO,3,71,31,40,6
HIDALGO,13,SINGUILUCAN,057,JALAPILLA,1,5,3,2,1
HIDALGO,13,SINGUILUCAN,057,LA COMUNIDAD,1,23,14,9,2
HIDALGO,13,SINGUILUCAN,057,LA CONCHITA (LA CANTERA),1,11,5,6,1
HIDALGO,13,SINGUILUCAN,057,LA ESTANCIA,1,3,1,2,1
HIDALGO,13,SINGUILUCAN,057,LA GLORIA,2,21,10,11,3
HIDALGO,13,SINGUILUCAN,057,LA JOYA,2,21,9,12,2
HIDALGO,13,SINGUILUCAN,057,LA LAGUNITA,2,17,7,10,2
HIDALGO,13,SINGUILUCAN,057,LA PEÑA,1,7,4,3,1
HIDALGO,13,SINGUILUCAN,057,LAS PALOMAS,2,45,25,20,3
HIDALGO,13,SINGUILUCAN,057,LOS PATOS [COLONIA],2,18,12,6,2
HIDALGO,13,SINGUILUCAN,057,MATÍAS RODRÍGUEZ,3,308,150,158,15
HIDALGO,13,SINGUILUCAN,057,MIRASOLES,2,14,8,6,2
HIDALGO,13,SINGUILUCAN,057,PLUTARCO ELÍAS CALLES,3,55,23,32,5
HIDALGO,13,SINGUILUCAN,057,RINCÓN DEL AGUA,2,18,8,10,2
HIDALGO,13,SINGUILUCAN,057,RINCÓN DEL PUERTO,2,9,7,2,1
HIDALGO,13,SINGUILUCAN,057,SABANETAS,2,13,7,6,2
HIDALGO,13,SINGUILUCAN,057,SAN MARTÍN EL COYOTE,1,7,3,4,1
HIDALGO,13,SINGUILUCAN,057,SAN RAFAEL AMOLUCAN,3,103,47,56,8
HIDALGO,13,SINGUILUCAN,057,SANTA ANA CHICHICUAUTLA,2,54,26,28,4
HIDALGO,13,SINGUILUCAN,057,SEGUNDAS LAJAS,3,169,76,93,9
HIDALGO,13,SINGUILUCAN,057,SINGUILUCAN,6,1677,875,802,63
HIDALGO,13,SINGUILUCAN,057,SOMORRIEL,2,40,20,20,3
HIDALGO,13,SINGUILUCAN,057,TEXCALTITLA,2,23,8,15,3
HIDALGO,13,TASQUILLO,058,ARBOLADO,2,83,40,43,7
HIDALGO,13,TASQUILLO,058,BONDHÍ,3,329,158,171,18
HIDALGO,13,TASQUILLO,058,CALTIMACÁN,5,389,189,200,28
HIDALGO,13,TASQUILLO,058,CANDELARIA,2,110,54,56,7
HIDALGO,13,TASQUILLO,058,DANGHU,5,237,99,138,15
HIDALGO,13,TASQUILLO,058,EL DURAZNO,3,33,15,18,5
HIDALGO,13,TASQUILLO,058,EL EPAZOTE,2,12,6,6,2
HIDALGO,13,TASQUILLO,058,EL LLANO,1,12,4,8,1
HIDALGO,13,TASQUILLO,058,HUIZACHEZ,2,49,21,28,6
HIDALGO,13,TASQUILLO,058,JUCHITLÁN,2,77,37,40,6
HIDALGO,13,TASQUILLO,058,MOTHO,2,35,17,18,4
HIDALGO,13,TASQUILLO,058,NOXTHEY,4,74,36,38,9
HIDALGO,13,TASQUILLO,058,PORTEZUELO,3,321,161,160,21
HIDALGO,13,TASQUILLO,058,QUITANDEJHE,2,17,11,6,2
HIDALGO,13,TASQUILLO,058,REMEDIOS,2,44,21,23,4
HIDALGO,13,TASQUILLO,058,RINCONADA,2,48,26,22,4
HIDALGO,13,TASQUILLO,058,SAN ANTONIO CALTIMACÁN,2,25,8,17,3
HIDALGO,13,TASQUILLO,058,SAN ISIDRO,2,100,51,49,8
HIDALGO,13,TASQUILLO,058,SAN MIGUEL,2,17,7,10,3
HIDALGO,13,TASQUILLO,058,SAN NICOLÁS (SAN NICOLÁS CALTIMACÁN),2,17,8,9,2
HIDALGO,13,TASQUILLO,058,SAN PEDRO,2,42,20,22,4
HIDALGO,13,TASQUILLO,058,SANTIAGO IXTLAHUACA,4,213,99,114,19
HIDALGO,13,TASQUILLO,058,TASQUILLO,9,1427,716,711,80
HIDALGO,13,TASQUILLO,058,TETZHÚ,2,31,13,18,3
HIDALGO,13,TECOZAUTLA,059,ALJIBES,2,40,16,24,4
HIDALGO,13,TECOZAUTLA,059,ATENGO,3,113,48,65,8
HIDALGO,13,TECOZAUTLA,059,BAJHÍ,4,132,64,68,11
HIDALGO,13,TECOZAUTLA,059,BANZHÁ,3,93,57,36,7
HIDALGO,13,TECOZAUTLA,059,BOMANXOTHA,4,413,212,201,24
HIDALGO,13,TECOZAUTLA,059,BOÑHÉ,1,5,1,4,1
HIDALGO,13,TECOZAUTLA,059,BOTHÉ,3,55,30,25,5
HIDALGO,13,TECOZAUTLA,059,BOXHI,1,23,12,11,3
HIDALGO,13,TECOZAUTLA,059,CUAMXHI,2,35,21,14,3
HIDALGO,13,TECOZAUTLA,059,EL AHORCADO,2,7,3,4,1
HIDALGO,13,TECOZAUTLA,059,EL CARACOL,1,9,3,6,1
HIDALGO,13,TECOZAUTLA,059,EL DEDHÓ,1,7,3,4,1
HIDALGO,13,TECOZAUTLA,059,EL DORANHI,2,10,5,5,1
HIDALGO,13,TECOZAUTLA,059,EL PALMAR,2,37,11,26,4
HIDALGO,13,TECOZAUTLA,059,EL PASO,2,63,27,36,5
HIDALGO,13,TECOZAUTLA,059,EL RIÍTO,2,73,30,43,5
HIDALGO,13,TECOZAUTLA,059,EL SALTO,3,58,25,33,6
HIDALGO,13,TECOZAUTLA,059,GANDHO,4,913,497,416,64
HIDALGO,13,TECOZAUTLA,059,GUADALUPE,3,117,60,57,9
HIDALGO,13,TECOZAUTLA,059,LA CRUZ DE PIEDRA,2,7,1,6,1
HIDALGO,13,TECOZAUTLA,059,LA ESQUINA,2,143,77,66,8
HIDALGO,13,TECOZAUTLA,059,LA JOYA,2,5,1,4,1
HIDALGO,13,TECOZAUTLA,059,LA LOMITA,2,34,15,19,4
HIDALGO,13,TECOZAUTLA,059,LA MESILLA,3,319,168,151,15
HIDALGO,13,TECOZAUTLA,059,LA PAILA,2,43,26,17,4
HIDALGO,13,TECOZAUTLA,059,LA PRESA,2,40,21,19,4
HIDALGO,13,TECOZAUTLA,059,LA SABINA,2,33,19,14,3
HIDALGO,13,TECOZAUTLA,059,LA SALITRERA,2,20,9,11,3
HIDALGO,13,TECOZAUTLA,059,MAGUEY VERDE,3,52,20,32,5
HIDALGO,13,TECOZAUTLA,059,MANGUANÍ,2,26,13,13,3
HIDALGO,13,TECOZAUTLA,059,NINTHÍ,2,20,13,7,2
HIDALGO,13,TECOZAUTLA,059,NUEVO ALJIBES,1,23,11,12,2
HIDALGO,13,TECOZAUTLA,059,PAÑHÉ,7,530,257,273,27
HIDALGO,13,TECOZAUTLA,059,PARED BLANCA,2,29,20,9,3
HIDALGO,13,TECOZAUTLA,059,RANCHO VIEJO,2,38,20,18,4
HIDALGO,13,TECOZAUTLA,059,RANZHÁ,2,30,13,17,3
HIDALGO,13,TECOZAUTLA,059,SAN ANTONIO,3,227,109,118,14
HIDALGO,13,TECOZAUTLA,059,SAN FRANCISCO,4,385,193,192,18
HIDALGO,13,TECOZAUTLA,059,SAN JOAQUÍN,2,151,80,71,8
HIDALGO,13,TECOZAUTLA,059,SAN JOSÉ EL DESIERTO,1,4,2,2,1
HIDALGO,13,TECOZAUTLA,059,SAN MIGUEL CALTEPANTLA,3,142,64,78,10
HIDALGO,13,TECOZAUTLA,059,SAN PEDRO,2,67,32,35,8
HIDALGO,13,TECOZAUTLA,059,TECOZAUTLA,13,2776,1433,1343,163
HIDALGO,13,TECOZAUTLA,059,TENZABHÍ,2,48,27,21,4
HIDALGO,13,TECOZAUTLA,059,TZIDEJHÉ,4,161,74,87,14
HIDALGO,13,TECOZAUTLA,059,UXDEJHÉ,3,154,76,78,8
HIDALGO,13,TECOZAUTLA,059,YETHAY,1,14,7,7,2
HIDALGO,13,TECOZAUTLA,059,YEXTHO CHICO,2,7,3,4,1
HIDALGO,13,TENANGO DE DORIA,060,AGUA ZARCA,3,57,28,29,5
HIDALGO,13,TENANGO DE DORIA,060,CERRO CHIQUITO,3,125,61,64,8
HIDALGO,13,TENANGO DE DORIA,060,COLONIA ERMITA,1,7,1,6,1
HIDALGO,13,TENANGO DE DORIA,060,EJIDO EMILIANO ZAPATA,2,25,11,14,2
HIDALGO,13,TENANGO DE DORIA,060,EJIDO LÓPEZ MATEOS (LA COLONIA),2,73,43,30,6
HIDALGO,13,TENANGO DE DORIA,060,EL AGUACATE,3,87,50,37,7
HIDALGO,13,TENANGO DE DORIA,060,EL BARRIO DE SAN JOSÉ,2,16,5,11,2
HIDALGO,13,TENANGO DE DORIA,060,EL BOPO,3,97,47,50,7
HIDALGO,13,TENANGO DE DORIA,060,EL CASIU,4,93,47,46,7
HIDALGO,13,TENANGO DE DORIA,060,EL DAMO,3,149,63,86,9
HIDALGO,13,TENANGO DE DORIA,060,EL DEQUEÑA,4,137,70,67,9
HIDALGO,13,TENANGO DE DORIA,060,EL DESDAVI,1,611,428,183,58
HIDALGO,13,TENANGO DE DORIA,060,EL DEXHUADÁ,1,9,5,4,1
HIDALGO,13,TENANGO DE DORIA,060,EL GOSCO,3,305,224,81,22
HIDALGO,13,TENANGO DE DORIA,060,EL LINDERO,2,25,13,12,3
HIDALGO,13,TENANGO DE DORIA,060,EL NANTHE,3,130,74,56,11
HIDALGO,13,TENANGO DE DORIA,060,EL PROGRESO,4,48,22,26,5
HIDALGO,13,TENANGO DE DORIA,060,EL TEMAPÁ,2,30,16,14,3
HIDALGO,13,TENANGO DE DORIA,060,EL TEXME,3,49,20,29,7
HIDALGO,13,TENANGO DE DORIA,060,EL XAJA,2,6,2,4,1
HIDALGO,13,TENANGO DE DORIA,060,EL XINDHÓ,2,21,8,13,2
HIDALGO,13,TENANGO DE DORIA,060,EL XUTHI,2,53,26,27,4
HIDALGO,13,TENANGO DE DORIA,060,EL ZETOY,2,11,5,6,2
HIDALGO,13,TENANGO DE DORIA,060,HUASQUILLA,1,10,5,5,1
HIDALGO,13,TENANGO DE DORIA,060,LA CRUZ DE TENANGO,3,98,52,46,7
HIDALGO,13,TENANGO DE DORIA,060,LA LOMA DEL PROGRESO,1,5,1,4,1
HIDALGO,13,TENANGO DE DORIA,060,LA PALIZADA,2,27,14,13,3
HIDALGO,13,TENANGO DE DORIA,060,LA REFORMA,2,22,12,10,2
HIDALGO,13,TENANGO DE DORIA,060,LINDA VISTA,2,21,12,9,2
HIDALGO,13,TENANGO DE DORIA,060,LOS AHILARES,2,30,16,14,2
HIDALGO,13,TENANGO DE DORIA,060,LOS PLANES DE SANTIAGO,2,5,3,2,1
HIDALGO,13,TENANGO DE DORIA,060,PEÑA BLANCA,3,70,31,39,6
HIDALGO,13,TENANGO DE DORIA,060,SAN FRANCISCO IXMIQUILPAN,2,16,3,13,2
HIDALGO,13,TENANGO DE DORIA,060,SAN FRANCISCO LA LAGUNA,4,122,64,58,8
HIDALGO,13,TENANGO DE DORIA,060,SAN ISIDRO LA LAGUNA,3,51,22,29,5
HIDALGO,13,TENANGO DE DORIA,060,SAN JOSÉ [COLONIA],3,359,182,177,21
HIDALGO,13,TENANGO DE DORIA,060,SAN JOSÉ DEL VALLE,3,38,22,16,5
HIDALGO,13,TENANGO DE DORIA,060,SAN NICOLÁS,5,301,151,150,22
HIDALGO,13,TENANGO DE DORIA,060,SAN PABLO EL GRANDE,5,341,171,170,23
HIDALGO,13,TENANGO DE DORIA,060,SANTA MARÍA TEMAXCALAPA,3,78,41,37,8
HIDALGO,13,TENANGO DE DORIA,060,SANTA MÓNICA,4,346,170,176,21
HIDALGO,13,TENANGO DE DORIA,060,TENANGO DE DORIA,6,1118,569,549,67
HIDALGO,13,TEPEAPULCO,061,20 DE NOVIEMBRE [COLONIA],3,177,82,95,11
HIDALGO,13,TEPEAPULCO,061,FRANCISCO SARABIA (CORRALILLOS),2,62,30,32,4
HIDALGO,13,TEPEAPULCO,061,FRAY BERNARDINO DE SAHAGÚN (CIUDAD SAHAGÚN),47,10988,5665,5323,796
HIDALGO,13,TEPEAPULCO,061,IROLO,3,172,84,88,12
HIDALGO,13,TEPEAPULCO,061,JAGÜEY PRIETO,2,10,5,5,2
HIDALGO,13,TEPEAPULCO,061,LA RINCONADA,2,13,6,7,2
HIDALGO,13,TEPEAPULCO,061,LOS CIDES,3,235,123,112,13
HIDALGO,13,TEPEAPULCO,061,LOS COYOTES,2,16,6,10,2
HIDALGO,13,TEPEAPULCO,061,PALMILLAS,1,7,4,3,1
HIDALGO,13,TEPEAPULCO,061,PALO HUECO,3,54,25,29,6
HIDALGO,13,TEPEAPULCO,061,SAN BARTOLOMÉ TEPETATES,2,90,46,44,7
HIDALGO,13,TEPEAPULCO,061,SAN IGNACIO DE LOYOLA,1,5,3,2,1
HIDALGO,13,TEPEAPULCO,061,SAN MIGUEL ALLENDE,3,122,55,67,7
HIDALGO,13,TEPEAPULCO,061,TEPEAPULCO,16,3007,1486,1521,212
HIDALGO,13,TEPEAPULCO,061,TEXCATZONGO,2,43,20,23,3
HIDALGO,13,TEPEAPULCO,061,TLACATEPA,2,5,0,5,1
HIDALGO,13,TEPEAPULCO,061,TULTENGO,3,40,23,17,4
HIDALGO,13,TEPEAPULCO,061,VISTA HERMOSA,2,8,5,3,1
HIDALGO,13,TEPEHUACÁN DE GUERRERO,062,ACATLAJAPA,2,97,46,51,6
HIDALGO,13,TEPEHUACÁN DE GUERRERO,062,ACOXCATLÁN,4,217,112,105,12
HIDALGO,13,TEPEHUACÁN DE GUERRERO,062,ACOYOTLA,6,598,297,301,31
HIDALGO,13,TEPEHUACÁN DE GUERRERO,062,ACUIMANTLA,3,162,84,78,11
HIDALGO,13,TEPEHUACÁN DE GUERRERO,062,AHUATETLA,2,96,44,52,7
HIDALGO,13,TEPEHUACÁN DE GUERRERO,062,ALMOLO (SAN ISIDRO),2,21,11,10,2
HIDALGO,13,TEPEHUACÁN DE GUERRERO,062,AMATITLA,3,62,34,28,4
HIDALGO,13,TEPEHUACÁN DE GUERRERO,062,AMOLA DE OCAMPO,3,165,75,90,11
HIDALGO,13,TEPEHUACÁN DE GUERRERO,062,AQUILASTEC,3,93,44,49,7
HIDALGO,13,TEPEHUACÁN DE GUERRERO,062,CAHUAZAZ DE MORELOS (RANCHO ALEGRE),3,152,71,81,9
HIDALGO,13,TEPEHUACÁN DE GUERRERO,062,CHAHUATITLA,3,146,69,77,8
HIDALGO,13,TEPEHUACÁN DE GUERRERO,062,CHALAHUITE,3,40,22,18,4
HIDALGO,13,TEPEHUACÁN DE GUERRERO,062,CHILIJAPA,3,155,69,86,11
HIDALGO,13,TEPEHUACÁN DE GUERRERO,062,CHOQUINTLA (SAN NICOLÁS CHOQUINTLA),4,134,70,64,10
HIDALGO,13,TEPEHUACÁN DE GUERRERO,062,COYUTLA,3,62,30,32,5
HIDALGO,13,TEPEHUACÁN DE GUERRERO,062,CUATOLOL,4,528,260,268,27
HIDALGO,13,TEPEHUACÁN DE GUERRERO,062,CUAZÁHUATL,3,223,120,103,11
HIDALGO,13,TEPEHUACÁN DE GUERRERO,062,EL BARCO,3,22,8,14,3
HIDALGO,13,TEPEHUACÁN DE GUERRERO,062,EL DURAZNO,3,70,34,36,4
HIDALGO,13,TEPEHUACÁN DE GUERRERO,062,EL NARANJAL,3,125,63,62,7
HIDALGO,13,TEPEHUACÁN DE GUERRERO,062,EL ZACATAL (EL ZACATAL DE LOS ROSALES),3,27,14,13,2
HIDALGO,13,TEPEHUACÁN DE GUERRERO,062,GUADALUPE (OTONGO) [COLONIA],3,127,65,62,16
HIDALGO,13,TEPEHUACÁN DE GUERRERO,062,HUIXQUILICO,2,52,26,26,4
HIDALGO,13,TEPEHUACÁN DE GUERRERO,062,IXTLAPALACO,3,116,65,51,6
HIDALGO,13,TEPEHUACÁN DE GUERRERO,062,LA PALMA,3,76,34,42,5
HIDALGO,13,TEPEHUACÁN DE GUERRERO,062,LA REFORMA,3,489,231,258,22
HIDALGO,13,TEPEHUACÁN DE GUERRERO,062,OLCUATLA,3,26,12,14,3
HIDALGO,13,TEPEHUACÁN DE GUERRERO,062,PETLAPIXCA,4,240,120,120,15
HIDALGO,13,TEPEHUACÁN DE GUERRERO,062,POXTATLA,1,8,4,4,1
HIDALGO,13,TEPEHUACÁN DE GUERRERO,062,PUEBLO NUEVO,3,63,33,30,6
HIDALGO,13,TEPEHUACÁN DE GUERRERO,062,SAN ANDRÉS,3,94,49,45,6
HIDALGO,13,TEPEHUACÁN DE GUERRERO,062,SAN ANTONIO,3,30,13,17,3
HIDALGO,13,TEPEHUACÁN DE GUERRERO,062,SAN JUAN AHUEHUECO,4,548,261,287,28
HIDALGO,13,TEPEHUACÁN DE GUERRERO,062,SAN MIGUEL AYOTEMPA,3,139,86,53,10
HIDALGO,13,TEPEHUACÁN DE GUERRERO,062,SAN SIMÓN,3,76,38,38,5
HIDALGO,13,TEPEHUACÁN DE GUERRERO,062,SOYUCO,3,83,39,44,6
HIDALGO,13,TEPEHUACÁN DE GUERRERO,062,TAMALA,3,153,78,75,10
HIDALGO,13,TEPEHUACÁN DE GUERRERO,062,TENANGO,4,276,152,124,15
HIDALGO,13,TEPEHUACÁN DE GUERRERO,062,TEPEHUACÁN DE GUERRERO,4,892,424,468,101
HIDALGO,13,TEPEHUACÁN DE GUERRERO,062,TEXCAPA,9,777,374,403,38
HIDALGO,13,TEPEHUACÁN DE GUERRERO,062,TEXOPICH,3,35,17,18,4
HIDALGO,13,TEPEHUACÁN DE GUERRERO,062,TEYAHUALA,3,197,83,114,10
HIDALGO,13,TEPEHUACÁN DE GUERRERO,062,TIZAPA,3,49,21,28,4
HIDALGO,13,TEPEHUACÁN DE GUERRERO,062,VILLA DE OCAMPO,3,47,24,23,4
HIDALGO,13,TEPEHUACÁN DE GUERRERO,062,VISTA DE TENANGO,2,6,3,3,1
HIDALGO,13,TEPEHUACÁN DE GUERRERO,062,XILIAPA,3,36,15,21,3
HIDALGO,13,TEPEHUACÁN DE GUERRERO,062,XILITLA,4,227,111,116,14
HIDALGO,13,TEPEHUACÁN DE GUERRERO,062,ZACATAL (SAN MAÍZ),3,22,14,8,3
HIDALGO,13,TEPEHUACÁN DE GUERRERO,062,ZACATLAMAYA,1,77,32,45,6
HIDALGO,13,TEPEHUACÁN DE GUERRERO,062,ZACUALTIPANITO,4,493,259,234,25
HIDALGO,13,TEPEJI DEL RÍO DE OCAMPO,063,BENITO JUÁREZ,2,275,127,148,10
HIDALGO,13,TEPEJI DEL RÍO DE OCAMPO,063,CANTERA DE VILLAGRÁN,4,461,221,240,24
HIDALGO,13,TEPEJI DEL RÍO DE OCAMPO,063,CAÑADA DE MADERO,2,184,89,95,8
HIDALGO,13,TEPEJI DEL RÍO DE OCAMPO,063,EL BANCO (EL BANCO VEGA DE MADERO),2,34,19,15,3
HIDALGO,13,TEPEJI DEL RÍO DE OCAMPO,063,EL CARACOL,1,15,6,9,3
HIDALGO,13,TEPEJI DEL RÍO DE OCAMPO,063,EL ZAPOTE,1,14,6,8,1
HIDALGO,13,TEPEJI DEL RÍO DE OCAMPO,063,LA ESTANCIA 1RA. SECCIÓN SANTA MARÍA MAGDALENA,2,18,5,13,3
HIDALGO,13,TEPEJI DEL RÍO DE OCAMPO,063,LA LOMA,3,286,143,143,13
HIDALGO,13,TEPEJI DEL RÍO DE OCAMPO,063,MELCHOR OCAMPO (EL SALTO),4,1093,549,544,49
HIDALGO,13,TEPEJI DEL RÍO DE OCAMPO,063,MIRAFLORES,1,12,6,6,1
HIDALGO,13,TEPEJI DEL RÍO DE OCAMPO,063,MONTECILLO,3,70,37,33,5
HIDALGO,13,TEPEJI DEL RÍO DE OCAMPO,063,OJO DE AGUA,4,271,111,160,14
HIDALGO,13,TEPEJI DEL RÍO DE OCAMPO,063,PALO GRANDE,2,1745,1011,734,74
HIDALGO,13,TEPEJI DEL RÍO DE OCAMPO,063,SAN BUENAVENTURA,2,384,195,189,18
HIDALGO,13,TEPEJI DEL RÍO DE OCAMPO,063,SAN IGNACIO NOPALA,3,369,184,185,20
HIDALGO,13,TEPEJI DEL RÍO DE OCAMPO,063,SAN ILDEFONSO,5,953,465,488,38
HIDALGO,13,TEPEJI DEL RÍO DE OCAMPO,063,SAN JOSÉ PIEDRA GORDA,3,247,114,133,11
HIDALGO,13,TEPEJI DEL RÍO DE OCAMPO,063,SAN MATEO BUENAVISTA,2,37,15,22,4
HIDALGO,13,TEPEJI DEL RÍO DE OCAMPO,063,SANTA ANA ATZCAPOTZALTONGO,4,214,95,119,14
HIDALGO,13,TEPEJI DEL RÍO DE OCAMPO,063,SANTA MARÍA MAGDALENA,2,340,152,188,16
HIDALGO,13,TEPEJI DEL RÍO DE OCAMPO,063,SANTA MARÍA QUELITES,4,492,255,237,19
HIDALGO,13,TEPEJI DEL RÍO DE OCAMPO,063,SANTIAGO TLALTEPOXCO,2,196,97,99,8
HIDALGO,13,TEPEJI DEL RÍO DE OCAMPO,063,SANTIAGO TLAPANALOYA,3,304,140,164,15
HIDALGO,13,TEPEJI DEL RÍO DE OCAMPO,063,SANTIAGO TLAUTLA,5,1448,677,771,72
HIDALGO,13,TEPEJI DEL RÍO DE OCAMPO,063,TAXHIDO,3,369,189,180,16
HIDALGO,13,TEPEJI DEL RÍO DE OCAMPO,063,TEPEJI DEL RÍO DE OCAMPO,61,9796,4961,4835,671
HIDALGO,13,TEPEJI DEL RÍO DE OCAMPO,063,TIANGUISTENGO (LA ROMERA),6,1441,714,727,93
HIDALGO,13,TEPEJI DEL RÍO DE OCAMPO,063,TINAJAS,2,298,161,137,12
HIDALGO,13,TEPEJI DEL RÍO DE OCAMPO,063,UNIDAD OBRERA HABITACIONAL CTM,1,66,39,27,4
HIDALGO,13,TEPETITLÁN,064,COLONIA AMPLIACIÓN (SEGUNDA MANZANA),1,20,10,10,2
HIDALGO,13,TEPETITLÁN,064,EL RETIRO,1,8,3,5,1
HIDALGO,13,TEPETITLÁN,064,ESTACIÓN SAYULA,2,9,5,4,1
HIDALGO,13,TEPETITLÁN,064,GENERAL PEDRO MARÍA ANAYA,2,189,85,104,9
HIDALGO,13,TEPETITLÁN,064,LA CUARTA MANZANA,1,25,15,10,2
HIDALGO,13,TEPETITLÁN,064,LA JOYA,2,7,4,3,1
HIDALGO,13,TEPETITLÁN,064,LA LOMA,2,86,38,48,5
HIDALGO,13,TEPETITLÁN,064,PALO ALTO,1,5,2,3,1
HIDALGO,13,TEPETITLÁN,064,PINO SUÁREZ,3,208,113,95,11
HIDALGO,13,TEPETITLÁN,064,SAN MATEO LA CURVA,3,35,10,25,2
HIDALGO,13,TEPETITLÁN,064,SAN PEDRO NEXTLALPAN,3,152,70,82,11
HIDALGO,13,TEPETITLÁN,064,SANTA MARÍA DAXTHO,2,31,9,22,3
HIDALGO,13,TEPETITLÁN,064,SAYULA PUEBLO,2,177,87,90,8
HIDALGO,13,TEPETITLÁN,064,TEPETITLÁN,5,1876,1058,818,135
HIDALGO,13,TEPETITLÁN,064,XITHI PRIMERA SECCIÓN,3,30,14,16,4
HIDALGO,13,TETEPANGO,065,JUANDHÓ,2,61,31,30,4
HIDALGO,13,TETEPANGO,065,TETEPANGO,15,3253,1842,1411,205
HIDALGO,13,TETEPANGO,065,ULAPA DE MELCHOR OCAMPO,3,290,145,145,14
HIDALGO,13,VILLA DE TEZONTEPEC,066,BENITO JUÁREZ,2,305,157,148,15
HIDALGO,13,VILLA DE TEZONTEPEC,066,CHAMBERLUCO,2,178,95,83,8
HIDALGO,13,VILLA DE TEZONTEPEC,066,EL CAPULÍN,1,11,5,6,1
HIDALGO,13,VILLA DE TEZONTEPEC,066,EL TEJOCOTE,1,6,2,4,1
HIDALGO,13,VILLA DE TEZONTEPEC,066,GUADALUPE [COLONIA],3,347,167,180,15
HIDALGO,13,VILLA DE TEZONTEPEC,066,LA CANTERA,2,52,24,28,3
HIDALGO,13,VILLA DE TEZONTEPEC,066,MORELOS [COLONIA],1,107,46,61,6
HIDALGO,13,VILLA DE TEZONTEPEC,066,TEZONTEPEC,18,1803,925,878,164
HIDALGO,13,TEZONTEPEC DE ALDAMA,067,5 DE FEBRERO,2,280,137,143,14
HIDALGO,13,TEZONTEPEC DE ALDAMA,067,ATENGO,4,991,480,511,50
HIDALGO,13,TEZONTEPEC DE ALDAMA,067,BINOLA,2,55,29,26,4
HIDALGO,13,TEZONTEPEC DE ALDAMA,067,EL TINACO,2,95,51,44,5
HIDALGO,13,TEZONTEPEC DE ALDAMA,067,HUITEL,6,927,445,482,55
HIDALGO,13,TEZONTEPEC DE ALDAMA,067,LA CHIRIPA [RANCHO],1,290,174,116,20
HIDALGO,13,TEZONTEPEC DE ALDAMA,067,LA CRUZ,2,144,72,72,8
HIDALGO,13,TEZONTEPEC DE ALDAMA,067,LA LOMA,2,150,78,72,7
HIDALGO,13,TEZONTEPEC DE ALDAMA,067,LA PALMA,2,131,57,74,7
HIDALGO,13,TEZONTEPEC DE ALDAMA,067,LOS MANANTIALES,2,1087,483,604,138
HIDALGO,13,TEZONTEPEC DE ALDAMA,067,MANANTIALES DE CERRO COLORADO,2,16,9,7,3
HIDALGO,13,TEZONTEPEC DE ALDAMA,067,MANGAS,11,1260,633,627,81
HIDALGO,13,TEZONTEPEC DE ALDAMA,067,PANUAYA,5,524,243,281,33
HIDALGO,13,TEZONTEPEC DE ALDAMA,067,PRESAS,7,1526,745,781,63
HIDALGO,13,TEZONTEPEC DE ALDAMA,067,SAN GABRIEL,4,580,285,295,29
HIDALGO,13,TEZONTEPEC DE ALDAMA,067,SAN ISIDRO EL TANQUE,2,168,84,84,8
HIDALGO,13,TEZONTEPEC DE ALDAMA,067,SAN ISIDRO PRESAS,2,198,106,92,9
HIDALGO,13,TEZONTEPEC DE ALDAMA,067,SAN JUAN [COLONIA],2,112,54,58,9
HIDALGO,13,TEZONTEPEC DE ALDAMA,067,SAN JUAN ACHICHILCO,3,358,183,175,18
HIDALGO,13,TEZONTEPEC DE ALDAMA,067,SANTA MARÍA BATHA,3,240,127,113,13
HIDALGO,13,TEZONTEPEC DE ALDAMA,067,SANTIAGO ACAYUTLÁN,5,440,192,248,24
HIDALGO,13,TEZONTEPEC DE ALDAMA,067,TENANGO,3,167,70,97,11
HIDALGO,13,TEZONTEPEC DE ALDAMA,067,TEZONTEPEC DE ALDAMA,15,2238,1084,1154,162
HIDALGO,13,TEZONTEPEC DE ALDAMA,067,ZANJA COLORADA,1,794,458,336,55
HIDALGO,13,TIANGUISTENGO,068,ACATENCO,1,4,2,2,1
HIDALGO,13,TIANGUISTENGO,068,ATECOXCO,4,139,61,78,14
HIDALGO,13,TIANGUISTENGO,068,CHAPALTEPEC,2,5,2,3,1
HIDALGO,13,TIANGUISTENGO,068,CHAPULA,3,100,52,48,8
HIDALGO,13,TIANGUISTENGO,068,CHOLULA,3,127,63,64,8
HIDALGO,13,TIANGUISTENGO,068,COAMELCO,3,66,34,32,5
HIDALGO,13,TIANGUISTENGO,068,COATEMPA,2,59,29,30,4
HIDALGO,13,TIANGUISTENGO,068,CONCHINTLÁN,3,42,17,25,3
HIDALGO,13,TIANGUISTENGO,068,IXCOTITLÁN,3,189,81,108,11
HIDALGO,13,TIANGUISTENGO,068,JOQUELA,3,48,21,27,4
HIDALGO,13,TIANGUISTENGO,068,LA ESPERANZA,3,21,13,8,3
HIDALGO,13,TIANGUISTENGO,068,LA MORITA,1,17,9,8,1
HIDALGO,13,TIANGUISTENGO,068,LOS LINDEROS,3,23,10,13,4
HIDALGO,13,TIANGUISTENGO,068,MAZAHUACÁN,3,29,14,15,3
HIDALGO,13,TIANGUISTENGO,068,PAHUATITLA,3,64,39,25,4
HIDALGO,13,TIANGUISTENGO,068,PEMUXCO,3,78,32,46,7
HIDALGO,13,TIANGUISTENGO,068,POLINTOTLA,4,367,181,186,17
HIDALGO,13,TIANGUISTENGO,068,SAN MIGUEL,3,156,79,77,10
HIDALGO,13,TIANGUISTENGO,068,SANTA MÓNICA,3,176,87,89,10
HIDALGO,13,TIANGUISTENGO,068,SOYATLA,3,120,51,69,9
HIDALGO,13,TIANGUISTENGO,068,TECHIMAL,3,62,38,24,7
HIDALGO,13,TIANGUISTENGO,068,TENEXCO,3,30,14,16,4
HIDALGO,13,TIANGUISTENGO,068,TEPANECA,3,13,7,6,2
HIDALGO,13,TIANGUISTENGO,068,TEXACAL,2,12,3,9,2
HIDALGO,13,TIANGUISTENGO,068,TIANGUISTENGO,6,1060,646,414,61
HIDALGO,13,TIANGUISTENGO,068,TLACOHECHAC,3,44,24,20,5
HIDALGO,13,TIANGUISTENGO,068,TLACOLULA,4,91,38,53,9
HIDALGO,13,TIANGUISTENGO,068,TLAHUILTEPA,2,13,7,6,1
HIDALGO,13,TIANGUISTENGO,068,TONCHINTLÁN,3,206,98,108,11
HIDALGO,13,TIANGUISTENGO,068,XALACAHUANTLA,3,164,75,89,11
HIDALGO,13,TIANGUISTENGO,068,XOCHIMILCO,4,299,159,140,15
HIDALGO,13,TIANGUISTENGO,068,XOCOCOATLA,3,16,7,9,2
HIDALGO,13,TIANGUISTENGO,068,YATIPÁN,4,204,92,112,16
HIDALGO,13,TIANGUISTENGO,068,ZACATIPÁN,4,190,94,96,14
HIDALGO,13,TIZAYUCA,069,ANDALUCÍA RESIDENCIAL [FRACCIONAMIENTO],3,695,396,299,48
HIDALGO,13,TIZAYUCA,069,DON ANTONIO,10,2730,1360,1370,149
HIDALGO,13,TIZAYUCA,069,EL CARMEN,4,576,299,277,26
HIDALGO,13,TIZAYUCA,069,EL CID,11,1939,951,988,124
HIDALGO,13,TIZAYUCA,069,EMILIANO ZAPATA,12,1841,923,918,80
HIDALGO,13,TIZAYUCA,069,FUENTES DE TIZAYUCA,9,4383,2294,2089,177
HIDALGO,13,TIZAYUCA,069,HACIENDA DE GUADALUPE,2,460,230,230,32
HIDALGO,13,TIZAYUCA,069,HACIENDAS DE TIZAYUCA,15,5492,2718,2774,238
HIDALGO,13,TIZAYUCA,069,HUITZILA,7,1211,624,587,59
HIDALGO,13,TIZAYUCA,069,IGNACIO ZARAGOZA (MOGOTES),1,35,15,20,3
HIDALGO,13,TIZAYUCA,069,LAS PLAZAS,3,406,182,224,17
HIDALGO,13,TIZAYUCA,069,LOS HÉROES TIZAYUCA,13,6167,3042,3125,237
HIDALGO,13,TIZAYUCA,069,OLMOS,6,522,261,261,34
HIDALGO,13,TIZAYUCA,069,TEPOJACO,11,2237,1049,1188,91
HIDALGO,13,TIZAYUCA,069,TIZAYUCA,93,19288,9677,9611,1129
HIDALGO,13,TLAHUELILPAN,070,CERRO DE LA CRUZ [COLONIA],2,157,76,81,9
HIDALGO,13,TLAHUELILPAN,070,COLONIA CUAUHTÉMOC,4,484,230,254,25
HIDALGO,13,TLAHUELILPAN,070,EL SALITRE,2,79,35,44,21
HIDALGO,13,TLAHUELILPAN,070,MUNITEPEC DE MADERO,4,559,272,287,29
HIDALGO,13,TLAHUELILPAN,070,TLAHUELILPAN,23,5473,3169,2304,337
HIDALGO,13,TLAHUILTEPA,071,ACAPA (SANTIAGO ACAPA),4,174,84,90,13
HIDALGO,13,TLAHUILTEPA,071,AGUA TAPADA,2,16,9,7,2
HIDALGO,13,TLAHUILTEPA,071,BOCA DE LEÓN,3,53,24,29,5
HIDALGO,13,TLAHUILTEPA,071,BUENAVISTA,3,140,60,80,9
HIDALGO,13,TLAHUILTEPA,071,CERRO CHATO,2,9,4,5,1
HIDALGO,13,TLAHUILTEPA,071,CERRO DEL ÁGUILA,2,20,15,5,2
HIDALGO,13,TLAHUILTEPA,071,CHICHICAXTLA,3,37,19,18,4
HIDALGO,13,TLAHUILTEPA,071,COYOCALA,2,56,28,28,7
HIDALGO,13,TLAHUILTEPA,071,DEMAÑI,1,8,1,7,1
HIDALGO,13,TLAHUILTEPA,071,DOMINÍ,3,27,14,13,3
HIDALGO,13,TLAHUILTEPA,071,EL DURAZNITO,3,59,26,33,4
HIDALGO,13,TLAHUILTEPA,071,EL LLANO,1,4,3,1,1
HIDALGO,13,TLAHUILTEPA,071,EL OCOTAL,1,4,3,1,1
HIDALGO,13,TLAHUILTEPA,071,EL PALMAR,2,9,3,6,1
HIDALGO,13,TLAHUILTEPA,071,EL ROBLE,1,9,7,2,1
HIDALGO,13,TLAHUILTEPA,071,EL VENADO,2,23,16,7,2
HIDALGO,13,TLAHUILTEPA,071,ITZTAMICHAPA,3,42,16,26,5
HIDALGO,13,TLAHUILTEPA,071,LA CONCORDIA,1,14,8,6,1
HIDALGO,13,TLAHUILTEPA,071,LA LAGUNA,2,16,9,7,2
HIDALGO,13,TLAHUILTEPA,071,LA MESA,1,4,1,3,1
HIDALGO,13,TLAHUILTEPA,071,LA NUEVA ERA,2,29,19,10,3
HIDALGO,13,TLAHUILTEPA,071,LA UNIÓN,1,12,4,8,1
HIDALGO,13,TLAHUILTEPA,071,LAS CANOAS (VADO HONDO),2,6,4,2,2
HIDALGO,13,TLAHUILTEPA,071,LAS MANZANAS,2,20,11,9,2
HIDALGO,13,TLAHUILTEPA,071,LAS PILAS,2,11,6,5,1
HIDALGO,13,TLAHUILTEPA,071,LÁZARO CÁRDENAS,1,10,5,5,1
HIDALGO,13,TLAHUILTEPA,071,NUEVO MONTERREY,3,36,18,18,4
HIDALGO,13,TLAHUILTEPA,071,NUEVO ZACATLÁN (EL ZACATE),2,7,3,4,1
HIDALGO,13,TLAHUILTEPA,071,PALO PERDIDO,3,48,28,20,4
HIDALGO,13,TLAHUILTEPA,071,RACIEL SALCEDO (EL DURAZNITO),1,9,3,6,1
HIDALGO,13,TLAHUILTEPA,071,SAN ANDRÉS MIRAFLORES,3,70,44,26,6
HIDALGO,13,TLAHUILTEPA,071,SAN FRANCISCO,3,26,15,11,3
HIDALGO,13,TLAHUILTEPA,071,SAN MARCOS,3,41,23,18,4
HIDALGO,13,TLAHUILTEPA,071,SANTIAGO,2,21,10,11,2
HIDALGO,13,TLAHUILTEPA,071,TLAHUILTEPA,4,152,83,69,12
HIDALGO,13,TLAHUILTEPA,071,TLAXCANTITLA,2,26,14,12,3
HIDALGO,13,TLAHUILTEPA,071,TOLANTONGO,1,5,4,1,1
HIDALGO,13,TLAHUILTEPA,071,XILOCUATITLA (EL PUERTO DE XILOCUATITLA),3,78,40,38,6
HIDALGO,13,TLAHUILTEPA,071,XIOPA,2,7,5,2,1
HIDALGO,13,TLAHUILTEPA,071,XUCHIATIPA,3,133,60,73,10
HIDALGO,13,TLAHUILTEPA,071,ZARAGOZA,2,20,15,5,4
HIDALGO,13,TLANALAPA,072,BELLAVISTA,2,46,27,19,3
HIDALGO,13,TLANALAPA,072,BENITO JUÁREZ,1,10,5,5,1
HIDALGO,13,TLANALAPA,072,CHICONCUAC,2,107,51,56,7
HIDALGO,13,TLANALAPA,072,KILÓMETRO 27 [COLONIA],2,5,2,3,1
HIDALGO,13,TLANALAPA,072,SAN ISIDRO [FRACCIONAMIENTO],3,440,252,188,76
HIDALGO,13,TLANALAPA,072,TLANALAPA,9,1127,551,576,63
HIDALGO,13,TLANCHINOL,073,ACAHUASCO,3,359,199,160,22
HIDALGO,13,TLANCHINOL,073,ACATIPA,3,140,69,71,9
HIDALGO,13,TLANCHINOL,073,ACUAPA,2,21,12,9,2
HIDALGO,13,TLANCHINOL,073,AMOXCO,2,43,20,23,3
HIDALGO,13,TLANCHINOL,073,APANTLAZOL,3,152,80,72,11
HIDALGO,13,TLANCHINOL,073,CERRO ALTO,2,28,13,15,4
HIDALGO,13,TLANCHINOL,073,CHACHALA,2,41,20,21,4
HIDALGO,13,TLANCHINOL,073,CHALCHOCOTIPA,2,51,26,25,4
HIDALGO,13,TLANCHINOL,073,CHICHATLA,3,369,171,198,21
HIDALGO,13,TLANCHINOL,073,CHICHILTÉPEC,3,366,173,193,23
HIDALGO,13,TLANCHINOL,073,CHIPOCO,3,207,109,98,11
HIDALGO,13,TLANCHINOL,073,CITLALA,3,79,31,48,7
HIDALGO,13,TLANCHINOL,073,COAMAPIL,4,133,68,65,10
HIDALGO,13,TLANCHINOL,073,COMALA,2,10,7,3,2
HIDALGO,13,TLANCHINOL,073,CUATAHUATLA,1,6,2,4,1
HIDALGO,13,TLANCHINOL,073,CUATATLÁN,2,28,12,16,2
HIDALGO,13,TLANCHINOL,073,CUATLAPECH,3,20,14,6,3
HIDALGO,13,TLANCHINOL,073,CUATLIMAX,4,192,89,103,10
HIDALGO,13,TLANCHINOL,073,EHUATITLA,3,67,45,22,5
HIDALGO,13,TLANCHINOL,073,HUEYAPA,4,465,236,229,21
HIDALGO,13,TLANCHINOL,073,HUITEPEC,4,416,208,208,22
HIDALGO,13,TLANCHINOL,073,IXTLAPALA,3,161,73,88,11
HIDALGO,13,TLANCHINOL,073,JALPA,4,409,202,207,19
HIDALGO,13,TLANCHINOL,073,LA PIMIENTA,3,37,20,17,4
HIDALGO,13,TLANCHINOL,073,LONTLA,3,72,39,33,7
HIDALGO,13,TLANCHINOL,073,OLOTLA,3,290,138,152,18
HIDALGO,13,TLANCHINOL,073,PAHUAYO,4,93,46,47,9
HIDALGO,13,TLANCHINOL,073,PEYULA,2,49,27,22,4
HIDALGO,13,TLANCHINOL,073,PILCUATLA,3,85,48,37,7
HIDALGO,13,TLANCHINOL,073,PITZOTLA,3,68,31,37,5
HIDALGO,13,TLANCHINOL,073,PUEBLO HIDALGO,3,258,112,146,13
HIDALGO,13,TLANCHINOL,073,QUETZALTZONGO,3,75,36,39,7
HIDALGO,13,TLANCHINOL,073,QUIMIXTLA HULA,3,42,13,29,5
HIDALGO,13,TLANCHINOL,073,RANCHO NUEVO,1,12,3,9,1
HIDALGO,13,TLANCHINOL,073,SAN CRISTÓBAL,3,251,125,126,15
HIDALGO,13,TLANCHINOL,073,SAN JOSÉ,3,226,116,110,12
HIDALGO,13,TLANCHINOL,073,SAN MIGUEL,2,6,5,1,1
HIDALGO,13,TLANCHINOL,073,SAN SALVADOR,4,148,76,72,11
HIDALGO,13,TLANCHINOL,073,SANTA LUCÍA,4,117,60,57,12
HIDALGO,13,TLANCHINOL,073,SANTA MARÍA CATZOTIPAN (SANTA MARÍA TEPETZINTLA),5,909,464,445,53
HIDALGO,13,TLANCHINOL,073,SANTA MARTHA ULA,3,66,33,33,4
HIDALGO,13,TLANCHINOL,073,TAMAZOLAPA,2,16,11,5,2
HIDALGO,13,TLANCHINOL,073,TECONTLA,2,20,11,9,2
HIDALGO,13,TLANCHINOL,073,TEMANGO,3,162,80,82,11
HIDALGO,13,TLANCHINOL,073,TENANGO,2,32,16,16,3
HIDALGO,13,TLANCHINOL,073,TENEXCO,3,80,36,44,6
HIDALGO,13,TLANCHINOL,073,TEPEYAC,2,22,12,10,2
HIDALGO,13,TLANCHINOL,073,TIANGUIS,2,53,29,24,4
HIDALGO,13,TLANCHINOL,073,TIERRA COLORADA,3,75,46,29,4
HIDALGO,13,TLANCHINOL,073,TLACOMUL,2,18,9,9,2
HIDALGO,13,TLANCHINOL,073,TLAHUELOMPA,3,33,14,19,4
HIDALGO,13,TLANCHINOL,073,TLAHUELONGO,1,7,4,3,1
HIDALGO,13,TLANCHINOL,073,TLANCHINOL,9,2088,1059,1029,100
HIDALGO,13,TLANCHINOL,073,TOCHINTLA,3,19,13,6,3
HIDALGO,13,TLANCHINOL,073,TOCTITLÁN,4,302,130,172,18
HIDALGO,13,TLANCHINOL,073,TOTONICAPA,3,69,33,36,5
HIDALGO,13,TLANCHINOL,073,XALTIPA,2,30,16,14,3
HIDALGO,13,TLANCHINOL,073,XOCHITITLA,2,11,7,4,1
HIDALGO,13,TLAXCOAPAN,074,DOXEY,10,1502,755,747,70
HIDALGO,13,TLAXCOAPAN,074,TELTIPÁN DE JUÁREZ,6,783,392,391,39
HIDALGO,13,TLAXCOAPAN,074,TEOCALCO,2,138,68,70,7
HIDALGO,13,TLAXCOAPAN,074,TLAXCOAPAN,23,4482,2137,2345,298
HIDALGO,13,TOLCAYUCA,075,BOSQUES DE IBIZA,3,916,456,460,31
HIDALGO,13,TOLCAYUCA,075,GENERAL FELIPE ÁNGELES (LOS ÁNGELES),5,719,343,376,35
HIDALGO,13,TOLCAYUCA,075,LAS PINTAS,1,9,6,3,1
HIDALGO,13,TOLCAYUCA,075,SANTIAGO TLAJOMULCO,3,320,147,173,15
HIDALGO,13,TOLCAYUCA,075,TOLCAYUCA,14,2322,1178,1144,121
HIDALGO,13,TOLCAYUCA,075,VICENTE GUERRERO (SAN JAVIER),3,3506,1724,1782,238
HIDALGO,13,TULA DE ALLENDE,076,ACOCULCO,2,8,4,4,1
HIDALGO,13,TULA DE ALLENDE,076,BENITO JUÁREZ [COLONIA],2,62,36,26,4
HIDALGO,13,TULA DE ALLENDE,076,BOMINTZHA,4,704,337,367,34
HIDALGO,13,TULA DE ALLENDE,076,EL CRESTÓN,2,9,4,5,2
HIDALGO,13,TULA DE ALLENDE,076,EL LLANO,21,2599,1237,1362,167
HIDALGO,13,TULA DE ALLENDE,076,HÉROES CARRANZA,2,27,14,13,3
HIDALGO,13,TULA DE ALLENDE,076,IGNACIO ZARAGOZA,2,369,175,194,16
HIDALGO,13,TULA DE ALLENDE,076,JULIÁN VILLAGRÁN [COLONIA],2,60,35,25,5
HIDALGO,13,TULA DE ALLENDE,076,LA AMISTAD,3,66,30,36,6
HIDALGO,13,TULA DE ALLENDE,076,LA CUARTA MANZANA,2,13,5,8,2
HIDALGO,13,TULA DE ALLENDE,076,MICHIMALOYA (SAN JUAN MICHIMALOYA),4,389,194,195,21
HIDALGO,13,TULA DE ALLENDE,076,MONTE ALEGRE,2,170,87,83,8
HIDALGO,13,TULA DE ALLENDE,076,NANTZHA,5,1509,819,690,229
HIDALGO,13,TULA DE ALLENDE,076,NUEVA SANTA MARÍA [COLONIA],2,62,30,32,5
HIDALGO,13,TULA DE ALLENDE,076,RESIDENCIAL ARBOLEDAS,1,7,4,3,1
HIDALGO,13,TULA DE ALLENDE,076,SAN ANDRÉS (SAN ANDRÉS TULTEPEC),3,151,73,78,10
HIDALGO,13,TULA DE ALLENDE,076,SAN ANTONIO TULA,2,11,5,6,2
HIDALGO,13,TULA DE ALLENDE,076,SAN FRANCISCO BOJAY COLONIA,3,210,110,100,11
HIDALGO,13,TULA DE ALLENDE,076,SAN FRANCISCO BOJAY PUEBLO,2,31,19,12,4
HIDALGO,13,TULA DE ALLENDE,076,SAN LUCAS TEACALCO,2,44,18,26,5
HIDALGO,13,TULA DE ALLENDE,076,SAN MARCOS,17,2621,1286,1335,167
HIDALGO,13,TULA DE ALLENDE,076,SAN MIGUEL DE LAS PIEDRAS PRIMERA SECCIÓN,3,177,88,89,11
HIDALGO,13,TULA DE ALLENDE,076,SAN MIGUEL DE LAS PIEDRAS SEGUNDA SECCIÓN,2,96,45,51,6
HIDALGO,13,TULA DE ALLENDE,076,SAN MIGUEL VINDHO,14,3504,1727,1777,212
HIDALGO,13,TULA DE ALLENDE,076,SAN PEDRITO ALPUYECA,3,138,64,74,9
HIDALGO,13,TULA DE ALLENDE,076,SANTA ANA AHUEHUEPAN,4,721,332,389,32
HIDALGO,13,TULA DE ALLENDE,076,SANTA MARÍA ILUCAN,3,206,104,102,13
HIDALGO,13,TULA DE ALLENDE,076,SANTA MARÍA MACUA,4,615,300,315,26
HIDALGO,13,TULA DE ALLENDE,076,SANTA MARÍA MICHIMALTONGO,2,16,7,9,2
HIDALGO,13,TULA DE ALLENDE,076,SESENTA Y DOS [COLONIA],3,5321,2432,2889,264
HIDALGO,13,TULA DE ALLENDE,076,TEOCALCO,2,48,27,21,2
HIDALGO,13,TULA DE ALLENDE,076,TULA DE ALLENDE,58,10930,5912,5018,734
HIDALGO,13,TULA DE ALLENDE,076,XIJAY DE CUAUHTÉMOC,1,19,12,7,2
HIDALGO,13,TULA DE ALLENDE,076,XITEJE DE LA REFORMA,2,59,27,32,5
HIDALGO,13,TULA DE ALLENDE,076,XITEJE DE ZAPATA,3,140,69,71,9
HIDALGO,13,TULA DE ALLENDE,076,XOCHITLÁN DE LAS FLORES,4,246,125,121,14
HIDALGO,13,TULA DE ALLENDE,076,XONTHE,2,19,14,5,2
HIDALGO,13,TULANCINGO DE BRAVO,077,2 DE AGOSTO [COLONIA],3,179,97,82,11
HIDALGO,13,TULANCINGO DE BRAVO,077,ACOCUL GUADALUPE,3,102,53,49,8
HIDALGO,13,TULANCINGO DE BRAVO,077,ACOCUL LA PALMA,2,46,21,25,3
HIDALGO,13,TULANCINGO DE BRAVO,077,AHUEHUETITLA,2,409,203,206,16
HIDALGO,13,TULANCINGO DE BRAVO,077,AXATEMPA,2,30,19,11,3
HIDALGO,13,TULANCINGO DE BRAVO,077,EJIDO HUAPALCALCO,3,3864,1845,2019,161
HIDALGO,13,TULANCINGO DE BRAVO,077,EJIDO MIMILA,2,77,39,38,4
HIDALGO,13,TULANCINGO DE BRAVO,077,EL ABRA,2,80,41,39,5
HIDALGO,13,TULANCINGO DE BRAVO,077,FRACCIONAMIENTO DEL MAGISTERIO TULANCINGUENSE,1,35,11,24,2
HIDALGO,13,TULANCINGO DE BRAVO,077,GUADALUPE [COLONIA],2,19,5,14,2
HIDALGO,13,TULANCINGO DE BRAVO,077,HUAJOMULCO,3,97,53,44,7
HIDALGO,13,TULANCINGO DE BRAVO,077,HUITITITLA,1,4,1,3,1
HIDALGO,13,TULANCINGO DE BRAVO,077,JALTEPEC,12,2077,976,1101,229
HIDALGO,13,TULANCINGO DE BRAVO,077,JAVIER ROJO GÓMEZ,5,1202,615,587,46
HIDALGO,13,TULANCINGO DE BRAVO,077,LA LAGUNILLA,3,295,144,151,14
HIDALGO,13,TULANCINGO DE BRAVO,077,LA RAYA,2,9,4,5,2
HIDALGO,13,TULANCINGO DE BRAVO,077,LAGUNA DEL CERRITO,1,27,13,14,2
HIDALGO,13,TULANCINGO DE BRAVO,077,LAS COLMENAS,3,32,21,11,4
HIDALGO,13,TULANCINGO DE BRAVO,077,NAPATECO,1,24,11,13,3
HIDALGO,13,TULANCINGO DE BRAVO,077,OJO DE AGUA,2,8,5,3,1
HIDALGO,13,TULANCINGO DE BRAVO,077,PARQUE URBANO NAPATECO,5,1049,537,512,44
HIDALGO,13,TULANCINGO DE BRAVO,077,RANCHO UNIVERSITARIO,1,2996,1773,1223,115
HIDALGO,13,TULANCINGO DE BRAVO,077,RINCONES DE LA HACIENDA,2,330,265,65,24
HIDALGO,13,TULANCINGO DE BRAVO,077,SAN FELIPE [COLONIA],2,107,51,56,8
HIDALGO,13,TULANCINGO DE BRAVO,077,SAN NICOLÁS CEBOLLETAS,2,132,71,61,7
HIDALGO,13,TULANCINGO DE BRAVO,077,SAN NICOLÁS EL CHICO [RANCHO],2,205,98,107,8
HIDALGO,13,TULANCINGO DE BRAVO,077,SAN NICOLÁS EL GRANDE,1,59,33,26,3
HIDALGO,13,TULANCINGO DE BRAVO,077,SAN RAFAEL LOMA BONITA (EJIDO SANTA ANA HUEYTLALPAN),2,43,23,20,3
HIDALGO,13,TULANCINGO DE BRAVO,077,SAN VICENTE,2,38,17,21,3
HIDALGO,13,TULANCINGO DE BRAVO,077,SAN VIDAL,2,42,16,26,3
HIDALGO,13,TULANCINGO DE BRAVO,077,SANTA ANA HUEYTLALPAN,7,1133,558,575,55
HIDALGO,13,TULANCINGO DE BRAVO,077,SANTA MARÍA ASUNCIÓN,7,679,338,341,31
HIDALGO,13,TULANCINGO DE BRAVO,077,SANTA MARÍA EL CHICO,2,195,107,88,8
HIDALGO,13,TULANCINGO DE BRAVO,077,SANTIAGO CALTENGO (BUENOS AIRES),3,629,345,284,20
HIDALGO,13,TULANCINGO DE BRAVO,077,SULTEPEC,2,465,217,248,20
HIDALGO,13,TULANCINGO DE BRAVO,077,TEPALZINGO,3,252,120,132,12
HIDALGO,13,TULANCINGO DE BRAVO,077,TULANCINGO,202,37655,19834,17821,2451
HIDALGO,13,TULANCINGO DE BRAVO,077,VIVEROS DE LA LOMA,2,212,102,110,11
HIDALGO,13,TULANCINGO DE BRAVO,077,ZOTOTLÁN,1,10,2,8,1
HIDALGO,13,XOCHIATIPAN,078,ACANOA,5,345,163,182,20
HIDALGO,13,XOCHIATIPAN,078,ACATIPA,2,57,30,27,5
HIDALGO,13,XOCHIATIPAN,078,ACOMUL,2,43,20,23,3
HIDALGO,13,XOCHIATIPAN,078,AHUATITLA (AGUAYO),1,10,5,5,2
HIDALGO,13,XOCHIATIPAN,078,ATLAJCO,2,46,18,28,3
HIDALGO,13,XOCHIATIPAN,078,ATLALCO,2,49,24,25,5
HIDALGO,13,XOCHIATIPAN,078,CHIAPA,3,209,95,114,14
HIDALGO,13,XOCHIATIPAN,078,COCOTLA,2,40,20,20,3
HIDALGO,13,XOCHIATIPAN,078,CRUZHICA,3,103,54,49,7
HIDALGO,13,XOCHIATIPAN,078,EL ZAPOTE,2,63,35,28,7
HIDALGO,13,XOCHIATIPAN,078,HUEYAJTETL,2,15,6,9,3
HIDALGO,13,XOCHIATIPAN,078,IXTACZOQUICO,4,328,163,165,17
HIDALGO,13,XOCHIATIPAN,078,IXTAKUATITLA,2,37,17,20,3
HIDALGO,13,XOCHIATIPAN,078,LINDA VISTA,2,29,15,14,4
HIDALGO,13,XOCHIATIPAN,078,NANAYATLA,2,60,33,27,6
HIDALGO,13,XOCHIATIPAN,078,NUEVO ACATEPEC (MEZCALAPA),2,25,13,12,3
HIDALGO,13,XOCHIATIPAN,078,NUEVO COYOLAR,2,71,39,32,5
HIDALGO,13,XOCHIATIPAN,078,OHUATIPA,4,628,329,299,38
HIDALGO,13,XOCHIATIPAN,078,PACHIQUITLA,4,287,146,141,17
HIDALGO,13,XOCHIATIPAN,078,PESMAYO,2,94,42,52,6
HIDALGO,13,XOCHIATIPAN,078,POCANTLA,2,80,35,45,7
HIDALGO,13,XOCHIATIPAN,078,POHUANTITLA,2,116,63,53,8
HIDALGO,13,XOCHIATIPAN,078,SAN MIGUEL,2,54,27,27,4
HIDALGO,13,XOCHIATIPAN,078,SANTIAGO I,3,44,23,21,6
HIDALGO,13,XOCHIATIPAN,078,SANTIAGO II,2,92,43,49,8
HIDALGO,13,XOCHIATIPAN,078,TECOPIA,2,53,27,26,5
HIDALGO,13,XOCHIATIPAN,078,TENEXHUEYAC,2,61,33,28,5
HIDALGO,13,XOCHIATIPAN,078,TEXOLOC,3,120,61,59,10
HIDALGO,13,XOCHIATIPAN,078,TLALTECATLA,3,417,211,206,26
HIDALGO,13,XOCHIATIPAN,078,XILICO,2,64,34,30,6
HIDALGO,13,XOCHIATIPAN,078,XOCHIATIPAN,7,921,436,485,67
HIDALGO,13,XOCHIATIPAN,078,XÓCHITL,2,34,13,21,4
HIDALGO,13,XOCHIATIPAN,078,XOCOTITLA,3,214,102,112,15
HIDALGO,13,XOCHIATIPAN,078,ZACATLÁN,3,85,51,34,7
HIDALGO,13,XOCHICOATLÁN,079,ACATEPEC,1,5,2,3,1
HIDALGO,13,XOCHICOATLÁN,079,ACOMULCO,2,17,8,9,2
HIDALGO,13,XOCHICOATLÁN,079,COATENCALCO,3,29,16,13,3
HIDALGO,13,XOCHICOATLÁN,079,COATITLAMIXTLA,1,4,0,4,1
HIDALGO,13,XOCHICOATLÁN,079,CULHUACÁN,1,32,17,15,3
HIDALGO,13,XOCHICOATLÁN,079,HUITZINTLA,2,10,6,4,1
HIDALGO,13,XOCHICOATLÁN,079,JALAMELCO,3,53,18,35,6
HIDALGO,13,XOCHICOATLÁN,079,MAZAHUACÁN,2,21,11,10,2
HIDALGO,13,XOCHICOATLÁN,079,MECAPALA,1,9,4,5,1
HIDALGO,13,XOCHICOATLÁN,079,MICHUMITLA,1,12,6,6,1
HIDALGO,13,XOCHICOATLÁN,079,MOLANGOTZI,1,5,2,3,1
HIDALGO,13,XOCHICOATLÁN,079,NONOALCO,4,234,111,123,14
HIDALGO,13,XOCHICOATLÁN,079,OTONAPA,2,13,8,5,2
HIDALGO,13,XOCHICOATLÁN,079,PAPAXTLA,4,66,38,28,8
HIDALGO,13,XOCHICOATLÁN,079,QUIMIXTLA,3,14,5,9,3
HIDALGO,13,XOCHICOATLÁN,079,TENANGO,3,32,19,13,4
HIDALGO,13,XOCHICOATLÁN,079,TEXCACO,4,234,106,128,16
HIDALGO,13,XOCHICOATLÁN,079,TLAXCOYA,4,127,59,68,12
HIDALGO,13,XOCHICOATLÁN,079,TOTOTLA,2,47,24,23,3
HIDALGO,13,XOCHICOATLÁN,079,TUZANCOAC,4,152,72,80,12
HIDALGO,13,XOCHICOATLÁN,079,XOCHICOATLÁN,4,295,155,140,23
HIDALGO,13,YAHUALICA,080,ACALAMATITLA,2,28,16,12,3
HIDALGO,13,YAHUALICA,080,AGUACATITLA,3,110,62,48,10
HIDALGO,13,YAHUALICA,080,ATLAJCO,2,54,25,29,5
HIDALGO,13,YAHUALICA,080,ATLALCO,4,207,91,116,12
HIDALGO,13,YAHUALICA,080,CHIATITLA,3,156,68,88,11
HIDALGO,13,YAHUALICA,080,CHOMPELETLA,3,87,40,47,7
HIDALGO,13,YAHUALICA,080,CRISOLCO,3,149,67,82,11
HIDALGO,13,YAHUALICA,080,EL ARENAL,2,72,31,41,4
HIDALGO,13,YAHUALICA,080,EL PARAJE,2,26,15,11,3
HIDALGO,13,YAHUALICA,080,HUEXOAPA,2,28,13,15,3
HIDALGO,13,YAHUALICA,080,LOS NARANJOS,2,27,14,13,3
HIDALGO,13,YAHUALICA,080,MANGOCUATITLA,2,59,24,35,4
HIDALGO,13,YAHUALICA,080,MECATLÁN,4,831,385,446,37
HIDALGO,13,YAHUALICA,080,MESA LARGA,2,29,14,15,4
HIDALGO,13,YAHUALICA,080,OLMA,2,15,9,6,2
HIDALGO,13,YAHUALICA,080,OXELOCO,4,558,263,295,28
HIDALGO,13,YAHUALICA,080,PEPEYOCATITLA,3,238,125,113,12
HIDALGO,13,YAHUALICA,080,SANTA TERESA,6,1698,866,832,90
HIDALGO,13,YAHUALICA,080,TAMALCUATITLA,2,47,26,21,4
HIDALGO,13,YAHUALICA,080,TECACALAX,3,30,16,14,4
HIDALGO,13,YAHUALICA,080,TENAMAXTEPEC,3,294,150,144,16
HIDALGO,13,YAHUALICA,080,TEPEHIXPA,2,83,45,38,8
HIDALGO,13,YAHUALICA,080,TEPETITLA,3,222,108,114,12
HIDALGO,13,YAHUALICA,080,TETLA,3,132,67,65,11
HIDALGO,13,YAHUALICA,080,TLALCHIYAHUALICA,4,487,234,253,32
HIDALGO,13,YAHUALICA,080,XÓCHITL,2,38,23,15,3
HIDALGO,13,YAHUALICA,080,XOXOLPA,4,280,144,136,19
HIDALGO,13,YAHUALICA,080,YAHUALICA,4,374,176,198,18
HIDALGO,13,YAHUALICA,080,ZACAYAHUAL,2,54,27,27,6
HIDALGO,13,YAHUALICA,080,ZOQUITIPÁN,4,256,132,124,16
HIDALGO,13,ZACUALTIPÁN DE ÁNGELES,081,AJACAYA,2,8,4,4,1
HIDALGO,13,ZACUALTIPÁN DE ÁNGELES,081,ATOPIXCO,4,341,176,165,15
HIDALGO,13,ZACUALTIPÁN DE ÁNGELES,081,CHINANCÁHUATL,3,52,22,30,4
HIDALGO,13,ZACUALTIPÁN DE ÁNGELES,081,COATLILA,3,168,66,102,11
HIDALGO,13,ZACUALTIPÁN DE ÁNGELES,081,JALAPA,4,154,77,77,11
HIDALGO,13,ZACUALTIPÁN DE ÁNGELES,081,LA MOJONERA,3,364,185,179,16
HIDALGO,13,ZACUALTIPÁN DE ÁNGELES,081,MATLATLÁN,2,19,9,10,2
HIDALGO,13,ZACUALTIPÁN DE ÁNGELES,081,MAXALA,2,22,7,15,2
HIDALGO,13,ZACUALTIPÁN DE ÁNGELES,081,OLONTECO,4,71,27,44,7
HIDALGO,13,ZACUALTIPÁN DE ÁNGELES,081,SAN BERNARDO,3,79,38,41,5
HIDALGO,13,ZACUALTIPÁN DE ÁNGELES,081,SANTO DOMINGO,2,47,21,26,3
HIDALGO,13,ZACUALTIPÁN DE ÁNGELES,081,SIETLA,2,39,14,25,3
HIDALGO,13,ZACUALTIPÁN DE ÁNGELES,081,TEHUITZILA,2,17,7,10,2
HIDALGO,13,ZACUALTIPÁN DE ÁNGELES,081,TETZIMICO (SAN BARTOLO TETZIMICO),2,12,6,6,1
HIDALGO,13,ZACUALTIPÁN DE ÁNGELES,081,TIZAPÁN,3,139,65,74,8
HIDALGO,13,ZACUALTIPÁN DE ÁNGELES,081,TLAHUELOMPA (SAN FRANCISCO TLAHUELOMPA),4,389,186,203,18
HIDALGO,13,ZACUALTIPÁN DE ÁNGELES,081,TZINCOATLÁN,3,139,65,74,7
HIDALGO,13,ZACUALTIPÁN DE ÁNGELES,081,XOLUAPA,1,7,4,3,1
HIDALGO,13,ZACUALTIPÁN DE ÁNGELES,081,ZACUALTIPÁN,32,9293,4951,4342,644
HIDALGO,13,ZAPOTLÁN DE JUÁREZ,082,ACAYUCA,8,2078,1054,1024,97
HIDALGO,13,ZAPOTLÁN DE JUÁREZ,082,SAN PEDRO HUAQUILPAN,14,1453,690,763,110
HIDALGO,13,ZAPOTLÁN DE JUÁREZ,082,ZAPOTLÁN DE JUÁREZ,6,957,472,485,53
HIDALGO,13,ZEMPOALA,083,ACELOTLA DE OCAMPO,2,162,76,86,8
HIDALGO,13,ZEMPOALA,083,BUENAVISTA,2,200,101,99,10
HIDALGO,13,ZEMPOALA,083,EL BARRIO CASAS COLORADAS,2,88,38,50,7
HIDALGO,13,ZEMPOALA,083,EL MIRADOR,2,93,44,49,5
HIDALGO,13,ZEMPOALA,083,FRANCISCO VILLA,2,118,57,61,7
HIDALGO,13,ZEMPOALA,083,GUADALUPE SANTA RITA DE ARRIBA,2,47,28,19,3
HIDALGO,13,ZEMPOALA,083,JAGÜEY DE TÉLLEZ (ESTACIÓN TÉLLEZ),8,1512,729,783,73
HIDALGO,13,ZEMPOALA,083,LA CUCHILLA,2,14,5,9,2
HIDALGO,13,ZEMPOALA,083,LA TRINIDAD,1,29,12,17,3
HIDALGO,13,ZEMPOALA,083,LINDAVISTA,5,727,341,386,26
HIDALGO,13,ZEMPOALA,083,NUEVA ESPERANZA,3,475,245,230,19
HIDALGO,13,ZEMPOALA,083,PRIVADAS SANTA MATILDE,9,2090,1050,1040,94
HIDALGO,13,ZEMPOALA,083,RANCHO LUNA,2,4598,2019,2579,332
HIDALGO,13,ZEMPOALA,083,SAN AGUSTÍN ZAPOTLÁN,3,100,41,59,8
HIDALGO,13,ZEMPOALA,083,SAN ANTONIO OXTOYUCAN,2,132,77,55,8
HIDALGO,13,ZEMPOALA,083,SAN CRISTÓBAL EL GRANDE,1,14,7,7,2
HIDALGO,13,ZEMPOALA,083,SAN GABRIEL AZTECA,3,247,132,115,14
HIDALGO,13,ZEMPOALA,083,SAN MATEO TLAJOMULCO,3,179,100,79,10
HIDALGO,13,ZEMPOALA,083,SAN PEDRO TLAQUILPAN,5,398,184,214,24
HIDALGO,13,ZEMPOALA,083,SANTA CRUZ,2,123,69,54,8
HIDALGO,13,ZEMPOALA,083,SANTA GERTRUDIS,2,35,16,19,4
HIDALGO,13,ZEMPOALA,083,SANTA MARÍA TECAJETE,3,260,117,143,14
HIDALGO,13,ZEMPOALA,083,SANTIAGO TEPEYAHUALCO,4,440,218,222,28
HIDALGO,13,ZEMPOALA,083,SANTO TOMÁS,5,440,215,225,25
HIDALGO,13,ZEMPOALA,083,TEPA EL GRANDE,2,35,12,23,4
HIDALGO,13,ZEMPOALA,083,TEPOZOYUCAN,2,44,18,26,3
HIDALGO,13,ZEMPOALA,083,VENUSTIANO CARRANZA,2,25,7,18,4
HIDALGO,13,ZEMPOALA,083,VILLA MARGARITA,2,141,69,72,7
HIDALGO,13,ZEMPOALA,083,ZEMPOALA,13,2404,1225,1179,126
HIDALGO,13,ZIMAPÁN,084,AGUAS BLANCAS,4,271,141,130,19
HIDALGO,13,ZIMAPÁN,084,ÁLVARO OBREGÓN (TEMUTHE),2,105,56,49,7
HIDALGO,13,ZIMAPÁN,084,APEZCO,1,5,3,2,1
HIDALGO,13,ZIMAPÁN,084,BARRÓN,2,12,8,4,2
HIDALGO,13,ZIMAPÁN,084,BENITO JUÁREZ (DETZANI),2,162,68,94,9
HIDALGO,13,ZIMAPÁN,084,BOTHA,2,7,5,2,1
HIDALGO,13,ZIMAPÁN,084,CAMPOSANTO DEL ORO,4,79,42,37,10
HIDALGO,13,ZIMAPÁN,084,CERRO COLORADO,2,13,6,7,1
HIDALGO,13,ZIMAPÁN,084,COAXITHI,2,22,13,9,3
HIDALGO,13,ZIMAPÁN,084,COBRECITO,2,31,10,21,4
HIDALGO,13,ZIMAPÁN,084,CODORNICES,2,7,6,1,1
HIDALGO,13,ZIMAPÁN,084,CRUZ PINTA,1,10,6,4,1
HIDALGO,13,ZIMAPÁN,084,DOXTHÍ,2,16,8,8,2
HIDALGO,13,ZIMAPÁN,084,DOXTHI LA SABINA (LA SABINA),2,10,4,6,1
HIDALGO,13,ZIMAPÁN,084,DURANGO,4,209,116,93,13
HIDALGO,13,ZIMAPÁN,084,EL AGUACATITO,2,18,12,6,2
HIDALGO,13,ZIMAPÁN,084,EL CARRIZAL,3,26,19,7,3
HIDALGO,13,ZIMAPÁN,084,EL CERROTE,1,10,3,7,2
HIDALGO,13,ZIMAPÁN,084,EL CUARTO,2,20,10,10,3
HIDALGO,13,ZIMAPÁN,084,EL MEZQUITE SEGUNDO,3,16,9,7,2
HIDALGO,13,ZIMAPÁN,084,EL MUHÍ,1,9,6,3,1
HIDALGO,13,ZIMAPÁN,084,EL ORGANAL,2,24,11,13,3
HIDALGO,13,ZIMAPÁN,084,EL RINCÓN,3,34,15,19,4
HIDALGO,13,ZIMAPÁN,084,EL SALITRE,3,118,56,62,8
HIDALGO,13,ZIMAPÁN,084,EL SAUCILLO,2,25,13,12,3
HIDALGO,13,ZIMAPÁN,084,EL SAUZ,1,1,1,0,1
HIDALGO,13,ZIMAPÁN,084,EL TULE,2,13,8,5,2
HIDALGO,13,ZIMAPÁN,084,ENCARNACIÓN,2,44,19,25,4
HIDALGO,13,ZIMAPÁN,084,FRANCISCO I. MADERO (GUADALUPE),4,208,92,116,13
HIDALGO,13,ZIMAPÁN,084,FRANCISCO VILLA (LLANO SEGUNDO),2,52,31,21,4
HIDALGO,13,ZIMAPÁN,084,GARABATOS (GARABATOS LA ESTANCIA),3,37,16,21,4
HIDALGO,13,ZIMAPÁN,084,JAGÜEY COLORADO,2,19,6,13,2
HIDALGO,13,ZIMAPÁN,084,LA CRUZ (EJIDO DE LA CRUZ),1,10,8,2,1
HIDALGO,13,ZIMAPÁN,084,LA ESTANZUELA,2,5,4,1,1
HIDALGO,13,ZIMAPÁN,084,LA MAJADA GRANDE,1,12,4,8,1
HIDALGO,13,ZIMAPÁN,084,LA MANZANA,2,24,16,8,3
HIDALGO,13,ZIMAPÁN,084,LA RUDA,2,6,1,5,1
HIDALGO,13,ZIMAPÁN,084,LA TINAJA,2,56,25,31,4
HIDALGO,13,ZIMAPÁN,084,LA TINAJA DURANGO,1,3,3,0,1
HIDALGO,13,ZIMAPÁN,084,LAS ADJUNTAS,3,55,28,27,5
HIDALGO,13,ZIMAPÁN,084,LAS VEGAS,3,26,15,11,3
HIDALGO,13,ZIMAPÁN,084,LÁZARO CÁRDENAS (REMEDIOS),4,790,363,427,53
HIDALGO,13,ZIMAPÁN,084,LLANITOS,2,16,6,10,2
HIDALGO,13,ZIMAPÁN,084,LLANO BLANCO,1,9,5,4,1
HIDALGO,13,ZIMAPÁN,084,LLANO SEGUNDO,3,47,20,27,6
HIDALGO,13,ZIMAPÁN,084,LOS DURAZNOS,2,44,19,25,3
HIDALGO,13,ZIMAPÁN,084,LOS PILARES,1,5,4,1,1
HIDALGO,13,ZIMAPÁN,084,MAGUEY VERDE,3,37,9,28,6
HIDALGO,13,ZIMAPÁN,084,MEGÜI,2,33,14,19,2
HIDALGO,13,ZIMAPÁN,084,MEZQUITE PRIMERO,1,10,3,7,1
HIDALGO,13,ZIMAPÁN,084,MORELOS (TRANCAS),4,99,47,52,9
HIDALGO,13,ZIMAPÁN,084,PELILLOS,2,19,10,9,2
HIDALGO,13,ZIMAPÁN,084,PLUTARCO ELÍAS CALLES (SANTIAGO),3,795,401,394,43
HIDALGO,13,ZIMAPÁN,084,PONTIHÚ,2,16,7,9,2
HIDALGO,13,ZIMAPÁN,084,POTRERITOS,2,19,10,9,3
HIDALGO,13,ZIMAPÁN,084,PUEBLO NUEVO,1,7,5,2,1
HIDALGO,13,ZIMAPÁN,084,PUERTO DEL ÁNGEL,3,84,36,48,7
HIDALGO,13,ZIMAPÁN,084,PUERTO DEL EFE,2,8,5,3,2
HIDALGO,13,ZIMAPÁN,084,PUERTO JUÁREZ,4,104,54,50,9
HIDALGO,13,ZIMAPÁN,084,SAN ANDRÉS (TOXTHI),3,36,16,20,4
HIDALGO,13,ZIMAPÁN,084,SAN ANTONIO (CUAUHTÉMOC),3,82,39,43,8
HIDALGO,13,ZIMAPÁN,084,SAN FELIPE,2,6,4,2,1
HIDALGO,13,ZIMAPÁN,084,SAN JOSÉ DEL ORO (SAN VICENTE),1,5,2,3,1
HIDALGO,13,ZIMAPÁN,084,SAN MIGUEL TETILLAS,1,15,2,13,3
HIDALGO,13,ZIMAPÁN,084,SANTA RITA,3,45,21,24,6
HIDALGO,13,ZIMAPÁN,084,TENGUEDHÓ,2,5,3,2,1
HIDALGO,13,ZIMAPÁN,084,TIERRAS AMARILLAS,2,5,3,2,1
HIDALGO,13,ZIMAPÁN,084,TINTHÉ,1,11,3,8,2
HIDALGO,13,ZIMAPÁN,084,TLALPAN,2,17,7,10,2
HIDALGO,13,ZIMAPÁN,084,TZIJAY (EMILIANO ZAPATA),2,14,6,8,2
HIDALGO,13,ZIMAPÁN,084,VENUSTIANO CARRANZA (SAN PEDRO),4,329,172,157,18
HIDALGO,13,ZIMAPÁN,084,VICENTE GUERRERO (EL TABLÓN),3,21,9,12,3
HIDALGO,13,ZIMAPÁN,084,VILLA NUEVA,2,13,4,9,2
HIDALGO,13,ZIMAPÁN,084,XAJHÁ,4,223,118,105,14
HIDALGO,13,ZIMAPÁN,084,XHITÁ PRIMERO,4,107,55,52,8
HIDALGO,13,ZIMAPÁN,084,XHITÁ SEGUNDO (SAN ISIDRO),2,23,12,11,2
HIDALGO,13,ZIMAPÁN,084,XINDHÓ PRIMERO,2,110,58,52,7
HIDALGO,13,ZIMAPÁN,084,YETHAY,1,7,3,4,1
HIDALGO,13,ZIMAPÁN,084,ZIMAPÁN,26,6053,3145,2908,378
JALISCO,14,ACATIC,001,ACATIC,23,3567,1832,1735,205
JALISCO,14,ACATIC,001,CHIQUIHUITILLO,2,29,11,18,3
JALISCO,14,ACATIC,001,EL BAJÍO DE LOS HERRERA,2,19,7,12,2
JALISCO,14,ACATIC,001,EL CHIVATERO,3,26,11,15,4
JALISCO,14,ACATIC,001,EL COLOMO,2,27,14,13,3
JALISCO,14,ACATIC,001,EL REFUGIO (PAREDONES),6,801,390,411,41
JALISCO,14,ACATIC,001,EL SAUZ,2,7,3,4,1
JALISCO,14,ACATIC,001,LA CALESA (PLAN DE CALDERÓN),2,7,6,1,2
JALISCO,14,ACATIC,001,LA RESOLANA,2,25,15,10,3
JALISCO,14,ACATIC,001,LA SOLEDAD,1,5,2,3,1
JALISCO,14,ACATIC,001,LAGUNA COLORADA,2,72,34,38,4
JALISCO,14,ACATIC,001,LAS AMAPOLAS,1,26,13,13,1
JALISCO,14,ACATIC,001,LAS MOTAS,2,110,56,54,5
JALISCO,14,ACATIC,001,LOS LLANITOS,3,70,32,38,5
JALISCO,14,ACATIC,001,LOS RANCHITOS,1,32,10,22,3
JALISCO,14,ACATIC,001,MIRAFLORES,1,14,8,6,1
JALISCO,14,ACATIC,001,OJO DE AGUA DE VERDUM,1,15,6,9,1
JALISCO,14,ACATIC,001,PIEDRA AMARILLA,1,8,3,5,1
JALISCO,14,ACATIC,001,RANCHO NUEVO CALDERÓN,3,53,22,31,4
JALISCO,14,ACATIC,001,SALTILLO DE ABAJO,2,38,21,17,3
JALISCO,14,ACATIC,001,SAN ANTONIO DE ROA,1,6,3,3,1
JALISCO,14,ACATIC,001,SANTA RITA,3,155,75,80,8
JALISCO,14,ACATIC,001,TEQUILILLA,3,97,47,50,7
JALISCO,14,ACATIC,001,TIERRAS COLORADAS,3,374,204,170,15
JALISCO,14,ACATLÁN DE JUÁREZ,002,ACATLÁN DE JUÁREZ,20,4278,2123,2155,251
JALISCO,14,ACATLÁN DE JUÁREZ,002,BELLAVISTA,6,1491,744,747,70
JALISCO,14,ACATLÁN DE JUÁREZ,002,SAN JOSÉ DE LOS POZOS,3,216,113,103,11
JALISCO,14,ACATLÁN DE JUÁREZ,002,SAN PEDRO VALENCIA,2,84,43,41,4
JALISCO,14,ACATLÁN DE JUÁREZ,002,VILLA DE LOS NIÑOS,2,1839,0,1839,90
JALISCO,14,AHUALULCO DE MERCADO,003,AHUALULCO DE MERCADO,23,4403,2177,2226,222
JALISCO,14,AHUALULCO DE MERCADO,003,CHAPULIMITA (CHAPULI),3,85,43,42,5
JALISCO,14,AHUALULCO DE MERCADO,003,EL CARMEN (EL CAPULÍN),3,333,149,184,22
JALISCO,14,AHUALULCO DE MERCADO,003,LA MORA (LA MORITA),2,35,16,19,3
JALISCO,14,AHUALULCO DE MERCADO,003,LA PEÑA,1,7,5,2,1
JALISCO,14,AHUALULCO DE MERCADO,003,PORTES GIL (SAN IGNACIO),5,546,275,271,24
JALISCO,14,AHUALULCO DE MERCADO,003,SANTA CRUZ DE BÁRCENAS (SANTA CRUZ),3,331,160,171,15
JALISCO,14,AHUALULCO DE MERCADO,003,TEUCHITECO,2,16,8,8,2
JALISCO,14,AMACUECA,004,AMACUECA,8,912,442,470,65
JALISCO,14,AMACUECA,004,COFRADÍA DEL ROSARIO,2,46,29,17,4
JALISCO,14,AMACUECA,004,TEPEC,5,498,239,259,34
JALISCO,14,AMATITÁN,005,AGUA FRÍA,2,30,15,15,3
JALISCO,14,AMATITÁN,005,AGUA PRIETA,2,14,5,9,2
JALISCO,14,AMATITÁN,005,AMATITÁN,19,3362,1674,1688,198
JALISCO,14,AMATITÁN,005,CHOME (ACHÍO),4,134,65,69,9
JALISCO,14,AMATITÁN,005,EL AMARILLO,2,19,7,12,2
JALISCO,14,AMATITÁN,005,LA MATA,2,39,22,17,3
JALISCO,14,AMATITÁN,005,LA VILLA DE CUERÁMBARO,2,102,49,53,6
JALISCO,14,AMATITÁN,005,SANTIAGUITO,4,426,196,230,19
JALISCO,14,AMATITÁN,005,TEPETATES,2,49,25,24,6
JALISCO,14,AMECA,006,ALTAVISTA DE RAMOS,3,56,25,31,5
JALISCO,14,AMECA,006,AMECA,44,14362,7926,6436,745
JALISCO,14,AMECA,006,ARROYO HONDO,2,15,6,9,2
JALISCO,14,AMECA,006,BUENOS AIRES,2,116,58,58,8
JALISCO,14,AMECA,006,CAIMANERO (EL QUELITE),2,48,24,24,3
JALISCO,14,AMECA,006,DON MARTÍN,2,78,35,43,5
JALISCO,14,AMECA,006,EL ARCO,2,27,13,14,2
JALISCO,14,AMECA,006,EL CABEZÓN (EL LIMÓN),7,596,298,298,47
JALISCO,14,AMECA,006,EL CERRITO DEL CUIS,2,19,7,12,2
JALISCO,14,AMECA,006,EL CUIS (EL TASAJO),2,46,22,24,4
JALISCO,14,AMECA,006,EL MAGISTRAL,1,7,4,3,1
JALISCO,14,AMECA,006,EL PORTEZUELO,3,198,90,108,13
JALISCO,14,AMECA,006,EL REALITO,3,29,16,13,5
JALISCO,14,AMECA,006,EL SABINO,3,88,50,38,6
JALISCO,14,AMECA,006,EL TEXCALAME,3,113,60,53,7
JALISCO,14,AMECA,006,JAYAMITLA (COLMENAR),3,138,80,58,9
JALISCO,14,AMECA,006,LA CALERA DE ARRIBA,2,42,21,21,3
JALISCO,14,AMECA,006,LA CORONILLA,2,28,18,10,3
JALISCO,14,AMECA,006,LA ESTANCITA,2,21,6,15,2
JALISCO,14,AMECA,006,LA HIGUERA,2,44,27,17,3
JALISCO,14,AMECA,006,LA HUERTA DE SAN JAVIER,3,58,31,27,4
JALISCO,14,AMECA,006,LA NUEVA CANTERÍA (EL POCHOTE),2,21,11,10,3
JALISCO,14,AMECA,006,LA PAREJA,3,50,20,30,4
JALISCO,14,AMECA,006,LA VILLITA,4,169,78,91,11
JALISCO,14,AMECA,006,LABOR DE SOLÍS,3,153,77,76,11
JALISCO,14,AMECA,006,LAGUNILLAS,3,55,29,26,4
JALISCO,14,AMECA,006,LAS PAREDES,2,18,8,10,2
JALISCO,14,AMECA,006,LAS PILAS,4,84,43,41,6
JALISCO,14,AMECA,006,LAS RAÍCES,2,10,6,4,2
JALISCO,14,AMECA,006,LOMAS DE SANTIAGO,3,12,6,6,2
JALISCO,14,AMECA,006,LOS AMIALES,3,65,28,37,4
JALISCO,14,AMECA,006,LOS MORILLOS,1,17,10,7,1
JALISCO,14,AMECA,006,LOS PILARES,2,29,17,12,3
JALISCO,14,AMECA,006,LOS POCITOS,3,204,101,103,11
JALISCO,14,AMECA,006,MALPASITO,2,50,17,33,4
JALISCO,14,AMECA,006,MALPASO DE LA PEQUEÑA,1,6,3,3,1
JALISCO,14,AMECA,006,QUEIXPAN,3,78,50,28,6
JALISCO,14,AMECA,006,SAN ANTONIO MATUTE,8,884,466,418,76
JALISCO,14,AMECA,006,SAN ANTONIO PUERTA DE LA VEGA,4,229,117,112,15
JALISCO,14,AMECA,006,SAN IGNACIO,2,23,7,16,3
JALISCO,14,AMECA,006,SAN MIGUEL,3,93,39,54,6
JALISCO,14,AMECA,006,SAN NICOLÁS,3,256,123,133,23
JALISCO,14,AMECA,006,SANTA MARÍA DE LA HUERTA,3,83,43,40,5
JALISCO,14,AMECA,006,VILLA HERMOSA,3,101,49,52,7
JALISCO,14,SAN JUANITO DE ESCOBEDO,007,EL AZAFRÁN,2,60,33,27,4
JALISCO,14,SAN JUANITO DE ESCOBEDO,007,EL TRAPICHE,2,54,25,29,3
JALISCO,14,SAN JUANITO DE ESCOBEDO,007,LA ESTANCIA DE AYONES,2,192,80,112,9
JALISCO,14,SAN JUANITO DE ESCOBEDO,007,LA ESTANCITA,2,63,35,28,6
JALISCO,14,SAN JUANITO DE ESCOBEDO,007,LA PROVIDENCIA (CANTARRANAS),2,67,29,38,3
JALISCO,14,SAN JUANITO DE ESCOBEDO,007,SAN JUANITO DE ESCOBEDO,13,1535,767,768,106
JALISCO,14,SAN JUANITO DE ESCOBEDO,007,SAN PEDRO,6,4321,3168,1153,167
JALISCO,14,SAN JUANITO DE ESCOBEDO,007,SANTIAGUITO,3,78,30,48,6
JALISCO,14,ARANDAS,008,AGUA NUEVA,1,4,3,1,1
JALISCO,14,ARANDAS,008,ARANDAS,77,19702,10302,9400,1279
JALISCO,14,ARANDAS,008,BAJÍO DE RATONES,1,6,3,3,1
JALISCO,14,ARANDAS,008,BAJÍO SECO,2,48,19,29,3
JALISCO,14,ARANDAS,008,BELLAVISTA,1,8,4,4,1
JALISCO,14,ARANDAS,008,BOMBELA,2,16,9,7,2
JALISCO,14,ARANDAS,008,CABRITO,2,55,28,27,4
JALISCO,14,ARANDAS,008,EL ANCÓN,1,14,12,2,1
JALISCO,14,ARANDAS,008,EL BELLOTERO (LA CONCEPCIÓN),2,44,20,24,3
JALISCO,14,ARANDAS,008,EL CARACOL,3,92,47,45,5
JALISCO,14,ARANDAS,008,EL CENTRO,3,55,32,23,4
JALISCO,14,ARANDAS,008,EL GRILLO,2,6,1,5,1
JALISCO,14,ARANDAS,008,EL GUAJOLOTE,1,20,8,12,1
JALISCO,14,ARANDAS,008,EL MOGOTE,1,13,5,8,1
JALISCO,14,ARANDAS,008,EL NACIMIENTO DE ARRIBA,3,155,79,76,8
JALISCO,14,ARANDAS,008,EL NOGAL,3,78,34,44,5
JALISCO,14,ARANDAS,008,EL NOPAL,4,140,64,76,8
JALISCO,14,ARANDAS,008,EL OCOTE DE ENMEDIO,2,10,5,5,1
JALISCO,14,ARANDAS,008,EL POCITO DE ARRIBA,1,32,11,21,2
JALISCO,14,ARANDAS,008,EL REFUGIO,1,14,5,9,1
JALISCO,14,ARANDAS,008,EL SALTILLO,2,28,11,17,3
JALISCO,14,ARANDAS,008,EL SALTO DE NOGALES,1,10,5,5,1
JALISCO,14,ARANDAS,008,EL SAUCILLO,1,22,8,14,1
JALISCO,14,ARANDAS,008,EL SAUZ DE CAJIGAL,2,45,14,31,3
JALISCO,14,ARANDAS,008,EL TULE,2,87,37,50,6
JALISCO,14,ARANDAS,008,EL ZAPOTE,1,18,6,12,2
JALISCO,14,ARANDAS,008,EL ZAPOTE (COLORINES),1,7,5,2,1
JALISCO,14,ARANDAS,008,LA CEJA DE LA CAPILLA,1,13,5,8,2
JALISCO,14,ARANDAS,008,LA CIÉNEGA (CIÉNEGA DE MÉNDEZ),1,15,7,8,1
JALISCO,14,ARANDAS,008,LA CIENEGUITA,3,93,35,58,5
JALISCO,14,ARANDAS,008,LA CORAMBRE,3,86,44,42,5
JALISCO,14,ARANDAS,008,LA GARITA,3,22,12,10,3
JALISCO,14,ARANDAS,008,LA GLORIA,3,148,81,67,9
JALISCO,14,ARANDAS,008,LA GRANJENA,3,191,101,90,11
JALISCO,14,ARANDAS,008,LA LAJA,1,13,5,8,1
JALISCO,14,ARANDAS,008,LA PARADA DE ABAJO,2,32,16,16,3
JALISCO,14,ARANDAS,008,LA PUEBLITA,1,13,8,5,1
JALISCO,14,ARANDAS,008,LA RANA,2,25,14,11,2
JALISCO,14,ARANDAS,008,LA RESOLANA,3,23,10,13,3
JALISCO,14,ARANDAS,008,LA ROSA DE CASTILLA,2,21,11,10,2
JALISCO,14,ARANDAS,008,LA TINAJA,1,9,1,8,1
JALISCO,14,ARANDAS,008,LA TROJA,1,24,10,14,1
JALISCO,14,ARANDAS,008,LA VAQUERA,3,76,36,40,6
JALISCO,14,ARANDAS,008,LAS ALAZANAS,1,12,5,7,1
JALISCO,14,ARANDAS,008,LLANO GRANDE,3,181,91,90,8
JALISCO,14,ARANDAS,008,LOS AGRITOS,1,4,2,2,1
JALISCO,14,ARANDAS,008,LOS AVIONES,1,16,9,7,1
JALISCO,14,ARANDAS,008,LOS FRESNOS,1,15,4,11,1
JALISCO,14,ARANDAS,008,LOS POCITOS,1,14,8,6,2
JALISCO,14,ARANDAS,008,LOS ROBLES,2,22,14,8,2
JALISCO,14,ARANDAS,008,MANUEL MARTÍNEZ VALADEZ (AGUA NEGRA),4,199,87,112,13
JALISCO,14,ARANDAS,008,MESA DE MARTÍNEZ,1,4,2,2,1
JALISCO,14,ARANDAS,008,OJO DE AGUA (RINCÓN DE MOLINO),2,34,19,15,2
JALISCO,14,ARANDAS,008,OJO DE AGUA DE HERNÁNDEZ,1,4,2,2,1
JALISCO,14,ARANDAS,008,PIEDRA AMARILLA,2,34,14,20,3
JALISCO,14,ARANDAS,008,PIEDRAS CHINAS,2,22,12,10,2
JALISCO,14,ARANDAS,008,PRESA DE BARAJAS (EL CRUCERO DE ARANDAS),1,84,47,37,2
JALISCO,14,ARANDAS,008,PRESA DE LÓPEZ,2,21,10,11,2
JALISCO,14,ARANDAS,008,RANCHO SECO,1,21,8,13,1
JALISCO,14,ARANDAS,008,RINCÓN DE OCOTES,2,71,34,37,4
JALISCO,14,ARANDAS,008,RINCONADA DE LOS VÁZQUEZ [FRACCIONAMIENTO],2,208,105,103,8
JALISCO,14,ARANDAS,008,RÍO DE SÁNCHEZ,1,25,8,17,1
JALISCO,14,ARANDAS,008,SAN FRANCISCO,3,90,38,52,6
JALISCO,14,ARANDAS,008,SANTA MARÍA DEL VALLE,8,1109,541,568,67
JALISCO,14,ARANDAS,008,SANTIAGUITO (SANTIAGUITO DE VELÁZQUEZ),3,244,122,122,24
JALISCO,14,ARANDAS,008,YERBABUENA (HUIZACHAL),1,12,6,6,1
JALISCO,14,EL ARENAL,009,EL ARENAL,23,4587,2350,2237,250
JALISCO,14,EL ARENAL,009,EL PANCHOTE,2,23,11,12,2
JALISCO,14,EL ARENAL,009,EMILIANO ZAPATA,3,87,39,48,6
JALISCO,14,EL ARENAL,009,EMPALME DE ORENDAIN (POTRERO LA PRESA),1,26,15,11,2
JALISCO,14,EL ARENAL,009,HUAXTLA,4,515,280,235,37
JALISCO,14,EL ARENAL,009,RANCHO LOS PARAÍSOS,3,19,4,15,2
JALISCO,14,EL ARENAL,009,SANTA CRUZ DEL ASTILLERO,5,581,288,293,31
JALISCO,14,EL ARENAL,009,SANTA SOFÍA,2,442,225,217,65
JALISCO,14,ATEMAJAC DE BRIZUELA,010,ATEMAJAC DE BRIZUELA,14,1949,1006,943,101
JALISCO,14,ATEMAJAC DE BRIZUELA,010,EL JAGÜEY,1,9,3,6,1
JALISCO,14,ATEMAJAC DE BRIZUELA,010,LAGUNILLAS,3,73,41,32,5
JALISCO,14,ATEMAJAC DE BRIZUELA,010,LAS VARILLAS,3,35,17,18,3
JALISCO,14,ATEMAJAC DE BRIZUELA,010,PUEBLO NUEVO,2,13,6,7,1
JALISCO,14,ATEMAJAC DE BRIZUELA,010,TIERRA BLANCA,3,64,31,33,5
JALISCO,14,ATEMAJAC DE BRIZUELA,010,YOLOSTA,3,47,15,32,4
JALISCO,14,ATENGO,011,AGOSTADERO,3,60,26,34,5
JALISCO,14,ATENGO,011,ATENGO,4,435,219,216,30
JALISCO,14,ATENGO,011,COFRADÍA DE LEPE,3,55,30,25,5
JALISCO,14,ATENGO,011,COFRADÍA DE PIMIENTA,1,2,0,2,1
JALISCO,14,ATENGO,011,EL MACUCHI (LA TRINIDAD),2,26,14,12,3
JALISCO,14,ATENGO,011,EL OJO DE AGUA,2,14,7,7,2
JALISCO,14,ATENGO,011,SAN PEDRO LA CHALE,2,13,9,4,2
JALISCO,14,ATENGO,011,SOYATLÁN DEL ORO,5,721,356,365,40
JALISCO,14,ATENGO,011,TACOTA,3,41,23,18,4
JALISCO,14,ATENGO,011,TRIGO DE ALTEÑAS,3,28,13,15,3
JALISCO,14,ATENGO,011,YERBABUENA,2,32,15,17,3
JALISCO,14,ATENGUILLO,012,AHUACATEPEC,2,14,8,6,2
JALISCO,14,ATENGUILLO,012,ATENGUILLO,5,600,338,262,38
JALISCO,14,ATENGUILLO,012,EL RODEO,2,14,8,6,2
JALISCO,14,ATENGUILLO,012,LAS CEBOLLAS,2,26,13,13,2
JALISCO,14,ATENGUILLO,012,LOS VOLCANES,3,212,103,109,19
JALISCO,14,ATENGUILLO,012,SAN ANTONIO DE LOS MACEDO,3,106,55,51,7
JALISCO,14,ATENGUILLO,012,SAN JOSÉ DE LOS ANDRADE,3,44,23,21,3
JALISCO,14,ATOTONILCO EL ALTO,013,ATOTONILCO EL ALTO,47,9045,4778,4267,573
JALISCO,14,ATOTONILCO EL ALTO,013,BARRANCA DEL AGUACATE,2,29,10,19,2
JALISCO,14,ATOTONILCO EL ALTO,013,BUENAVISTA (EL CARMEN),2,73,42,31,4
JALISCO,14,ATOTONILCO EL ALTO,013,CIÉNEGA DEL PASTOR,3,81,45,36,5
JALISCO,14,ATOTONILCO EL ALTO,013,CUCARACHAS,3,118,67,51,8
JALISCO,14,ATOTONILCO EL ALTO,013,EJIDO EL VALLE (LA PAZ DE MILPILLAS),2,24,8,16,2
JALISCO,14,ATOTONILCO EL ALTO,013,EL AGUA CALIENTE,2,76,31,45,4
JALISCO,14,ATOTONILCO EL ALTO,013,EL CASTILLO,2,23,15,8,2
JALISCO,14,ATOTONILCO EL ALTO,013,EL CHAPINGO,2,13,5,8,1
JALISCO,14,ATOTONILCO EL ALTO,013,EL MAGUEY,2,83,41,42,4
JALISCO,14,ATOTONILCO EL ALTO,013,EL NACIMIENTO,3,303,155,148,13
JALISCO,14,ATOTONILCO EL ALTO,013,EL REFUGIO DE LOS ALTOS,2,35,16,19,3
JALISCO,14,ATOTONILCO EL ALTO,013,EL REFUGIO DE LOS BAJOS,3,110,58,52,7
JALISCO,14,ATOTONILCO EL ALTO,013,EL SOPIAL,3,65,39,26,5
JALISCO,14,ATOTONILCO EL ALTO,013,INFONAVIT MILPILLAS,3,365,186,179,17
JALISCO,14,ATOTONILCO EL ALTO,013,LA ANGOSTURA DE LOS ALTOS (LA ANGOSTURA),2,92,40,52,5
JALISCO,14,ATOTONILCO EL ALTO,013,LA PURÍSIMA,4,329,165,164,14
JALISCO,14,ATOTONILCO EL ALTO,013,LA SABINILLA,2,28,12,16,3
JALISCO,14,ATOTONILCO EL ALTO,013,LA SOLEDAD,2,21,13,8,2
JALISCO,14,ATOTONILCO EL ALTO,013,LAS PALMAS,5,647,300,347,124
JALISCO,14,ATOTONILCO EL ALTO,013,LOS CUATES (LA PAREJA),3,126,61,65,7
JALISCO,14,ATOTONILCO EL ALTO,013,LOS LAURELES,2,29,18,11,3
JALISCO,14,ATOTONILCO EL ALTO,013,LOS ZALATES,1,12,6,6,1
JALISCO,14,ATOTONILCO EL ALTO,013,MARGARITAS,4,557,293,264,26
JALISCO,14,ATOTONILCO EL ALTO,013,MESA DEL PINO,2,51,23,28,4
JALISCO,14,ATOTONILCO EL ALTO,013,MILPILLAS,4,473,220,253,18
JALISCO,14,ATOTONILCO EL ALTO,013,MONTE LARGO,3,45,17,28,4
JALISCO,14,ATOTONILCO EL ALTO,013,NUEVO VALLE (EX-HACIENDA DEL VALLE),2,138,59,79,8
JALISCO,14,ATOTONILCO EL ALTO,013,OJO DE AGUA DE MORÁN,2,231,109,122,8
JALISCO,14,ATOTONILCO EL ALTO,013,RINCONADA DE CRISTO REY,3,31,16,15,4
JALISCO,14,ATOTONILCO EL ALTO,013,SAN ÁNGEL,2,23,14,9,3
JALISCO,14,ATOTONILCO EL ALTO,013,SAN ANTONIO DE FERNÁNDEZ,4,390,187,203,19
JALISCO,14,ATOTONILCO EL ALTO,013,SAN FRANCISCO DE ASÍS,9,1898,975,923,81
JALISCO,14,ATOTONILCO EL ALTO,013,SAN GASPAR,2,22,12,10,2
JALISCO,14,ATOTONILCO EL ALTO,013,SAN JOAQUÍN,2,99,55,44,5
JALISCO,14,ATOTONILCO EL ALTO,013,SAN JOSÉ DEL VALLE,3,223,102,121,13
JALISCO,14,ATOTONILCO EL ALTO,013,SAN JUANICO,3,29,19,10,4
JALISCO,14,ATOTONILCO EL ALTO,013,SAN VICENTE,1,8,3,5,1
JALISCO,14,ATOTONILCO EL ALTO,013,SANTA ELENA,2,183,84,99,8
JALISCO,14,ATOTONILCO EL ALTO,013,UNIÓN DE GUADALUPE (RANCHO GUADALUPE),3,51,25,26,4
JALISCO,14,ATOTONILCO EL ALTO,013,VISTAS DEL MAGUEY [FRACCIONAMIENTO],4,854,437,417,31
JALISCO,14,ATOYAC,014,ATOYAC,10,1205,623,582,71
JALISCO,14,ATOYAC,014,CUYACAPAN,3,218,104,114,11
JALISCO,14,ATOYAC,014,EL CARRIZAL (LOS LAURELES DEL NOVENO),2,19,10,9,2
JALISCO,14,ATOYAC,014,EL DESTACAMENTO,2,24,12,12,2
JALISCO,14,ATOYAC,014,LA ESTANCIA,3,7,5,2,2
JALISCO,14,ATOYAC,014,LOS LAURELES,3,30,13,17,3
JALISCO,14,ATOYAC,014,PONCITLÁN,2,29,13,16,2
JALISCO,14,ATOYAC,014,SAN JUAN,3,28,12,16,4
JALISCO,14,ATOYAC,014,TECHAGUE,3,53,24,29,4
JALISCO,14,ATOYAC,014,TULTITÁN,2,21,8,13,2
JALISCO,14,ATOYAC,014,UNIÓN DE GUADALUPE,3,167,90,77,11
JALISCO,14,AUTLÁN DE NAVARRO,015,AGUA HEDIONDA,3,58,29,29,5
JALISCO,14,AUTLÁN DE NAVARRO,015,AHUACAPÁN,5,255,117,138,14
JALISCO,14,AUTLÁN DE NAVARRO,015,AUTLÁN DE NAVARRO,77,16656,8490,8166,1077
JALISCO,14,AUTLÁN DE NAVARRO,015,AYUTITA,3,100,44,56,7
JALISCO,14,AUTLÁN DE NAVARRO,015,BELLAVISTA (EL CASTILLO),2,34,17,17,3
JALISCO,14,AUTLÁN DE NAVARRO,015,CHIQUIHUITLÁN,3,75,38,37,6
JALISCO,14,AUTLÁN DE NAVARRO,015,EL CHACALITO,2,34,14,20,3
JALISCO,14,AUTLÁN DE NAVARRO,015,EL CHANTE,6,454,245,209,33
JALISCO,14,AUTLÁN DE NAVARRO,015,EL CORCOVADO,3,318,167,151,15
JALISCO,14,AUTLÁN DE NAVARRO,015,EL JALOCOTE,2,22,9,13,3
JALISCO,14,AUTLÁN DE NAVARRO,015,EL MENTIDERO,5,395,199,196,19
JALISCO,14,AUTLÁN DE NAVARRO,015,EL RODEO,2,17,7,10,2
JALISCO,14,AUTLÁN DE NAVARRO,015,HACIENDA DE ORIENTE,2,47,15,32,4
JALISCO,14,AUTLÁN DE NAVARRO,015,LA ALDABA,3,73,34,39,6
JALISCO,14,AUTLÁN DE NAVARRO,015,LA LIMA [BALNEARIO],2,28,10,18,2
JALISCO,14,AUTLÁN DE NAVARRO,015,LA NORIA,3,29,10,19,3
JALISCO,14,AUTLÁN DE NAVARRO,015,LA SIDRITA,2,11,5,6,2
JALISCO,14,AUTLÁN DE NAVARRO,015,LAS LAGUNILLAS (LAGUNILLAS),3,169,80,89,11
JALISCO,14,AUTLÁN DE NAVARRO,015,LAS PAREDES,3,171,88,83,11
JALISCO,14,AUTLÁN DE NAVARRO,015,LOS POZOS,2,3,1,2,1
JALISCO,14,AUTLÁN DE NAVARRO,015,LOS SAUCES (LA CAJA),2,83,45,38,3
JALISCO,14,AUTLÁN DE NAVARRO,015,MEZQUITÁN (SAN FRANCISCO DE ABAJO),4,203,107,96,13
JALISCO,14,AUTLÁN DE NAVARRO,015,PUERTA DE LA CAJA,2,92,49,43,5
JALISCO,14,AUTLÁN DE NAVARRO,015,RINCÓN DE LUISA,3,57,26,31,5
JALISCO,14,AUTLÁN DE NAVARRO,015,SAN FRANCISCO DE ARRIBA,1,5,4,1,1
JALISCO,14,AUTLÁN DE NAVARRO,015,TECOPATLÁN,2,10,6,4,2
JALISCO,14,AUTLÁN DE NAVARRO,015,VOLANTÍN,2,5,3,2,1
JALISCO,14,AUTLÁN DE NAVARRO,015,YERBABUENA,3,45,20,25,4
JALISCO,14,AYOTLÁN,016,ACAHUALES (SAN MIGUEL DE ACAHUALES),2,38,23,15,3
JALISCO,14,AYOTLÁN,016,AGUA BLANCA,2,21,10,11,2
JALISCO,14,AYOTLÁN,016,AYOTLÁN,22,3873,1999,1874,151
JALISCO,14,AYOTLÁN,016,BETANIA,7,579,281,298,36
JALISCO,14,AYOTLÁN,016,CAÑADA DE SAN IGNACIO,3,229,116,113,11
JALISCO,14,AYOTLÁN,016,CARRETAS,2,21,12,9,2
JALISCO,14,AYOTLÁN,016,EL CAPULÍN,2,19,10,9,2
JALISCO,14,AYOTLÁN,016,EL CHAVEÑO,2,25,10,15,2
JALISCO,14,AYOTLÁN,016,EL FRAILE,2,26,10,16,3
JALISCO,14,AYOTLÁN,016,EL GUAYABO,2,60,27,33,3
JALISCO,14,AYOTLÁN,016,EL MALUCO,3,226,111,115,11
JALISCO,14,AYOTLÁN,016,EL ROSARIO,2,18,8,10,3
JALISCO,14,AYOTLÁN,016,EL SALITRE (LA BOLSA),2,93,43,50,4
JALISCO,14,AYOTLÁN,016,LA CONCEPCIÓN,4,362,173,189,17
JALISCO,14,AYOTLÁN,016,LA ISLA,3,207,110,97,11
JALISCO,14,AYOTLÁN,016,LA LOMA,2,299,153,146,10
JALISCO,14,AYOTLÁN,016,LA NOPALERA,3,142,76,66,8
JALISCO,14,AYOTLÁN,016,LA NORIA,3,224,107,117,11
JALISCO,14,AYOTLÁN,016,LA PALMA (LA ANGOSTURA),3,301,147,154,11
JALISCO,14,AYOTLÁN,016,LA RIBERA,14,2945,1478,1467,102
JALISCO,14,AYOTLÁN,016,LAS HIGUERAS,3,69,32,37,7
JALISCO,14,AYOTLÁN,016,LOS FRESNOS (LA OFICINA),3,66,24,42,5
JALISCO,14,AYOTLÁN,016,MIRANDILLAS,3,160,79,81,8
JALISCO,14,AYOTLÁN,016,SAN JERÓNIMO,3,138,78,60,7
JALISCO,14,AYOTLÁN,016,SAN RAFAEL DE MONTELARGO,1,17,8,9,1
JALISCO,14,AYOTLÁN,016,SANTA ELENA DE LA CRUZ,2,148,73,75,8
JALISCO,14,AYOTLÁN,016,SANTA RITA,5,517,247,270,25
JALISCO,14,AYUTLA,017,AYUTLA,20,2082,1069,1013,139
JALISCO,14,AYUTLA,017,BUCKINGHAM,3,22,10,12,2
JALISCO,14,AYUTLA,017,CACOMA,2,7,4,3,2
JALISCO,14,AYUTLA,017,CASA BLANCA,2,54,26,28,3
JALISCO,14,AYUTLA,017,EL ARRAYÁN,3,17,6,11,2
JALISCO,14,AYUTLA,017,EL GUAMÚCHIL,1,13,4,9,1
JALISCO,14,AYUTLA,017,EL ROBLE GORDO,2,4,1,3,1
JALISCO,14,AYUTLA,017,EL ROSARIO,3,27,15,12,4
JALISCO,14,AYUTLA,017,EL SALTO (CERRITOS),2,9,3,6,1
JALISCO,14,AYUTLA,017,EL SALTO DE LATILLAS,3,16,10,6,2
JALISCO,14,AYUTLA,017,EL ZAPOTE DE CHÁVEZ,3,40,24,16,5
JALISCO,14,AYUTLA,017,EL ZAPOTILLO,3,80,42,38,5
JALISCO,14,AYUTLA,017,LA CAÑADA DEL CARMEN,2,12,9,3,3
JALISCO,14,AYUTLA,017,LA JOYA SOLEDAD Y TABERNILLAS (LA JOYA),1,7,2,5,1
JALISCO,14,AYUTLA,017,LA MESA DE LOS NUÑO,2,17,12,5,2
JALISCO,14,AYUTLA,017,LOS ARRASTRES,1,5,0,5,1
JALISCO,14,AYUTLA,017,LOS SAUCES,3,23,14,9,3
JALISCO,14,AYUTLA,017,PAREDONES,3,29,18,11,3
JALISCO,14,AYUTLA,017,SAN ANTONIO DE LOS MORÁN,3,6,4,2,2
JALISCO,14,AYUTLA,017,SAN JUAN CACOMA,3,19,8,11,2
JALISCO,14,AYUTLA,017,SAN MIGUEL DE LA SIERRA,3,52,27,25,5
JALISCO,14,AYUTLA,017,SAN PEDRO,3,91,43,48,7
JALISCO,14,AYUTLA,017,SANTA MÓNICA (RUIZ CORTINEZ),3,25,15,10,3
JALISCO,14,AYUTLA,017,SANTA ROSALÍA,3,78,45,33,7
JALISCO,14,AYUTLA,017,SANTO DOMINGO,3,94,39,55,6
JALISCO,14,AYUTLA,017,TEPANTLA,3,138,69,69,9
JALISCO,14,AYUTLA,017,TEPOSPIZALOYA,3,33,12,21,5
JALISCO,14,AYUTLA,017,YERBABUENA DE LAS PALMAS,3,37,16,21,2
JALISCO,14,LA BARCA,018,CARRASQUEÑO,2,28,10,18,2
JALISCO,14,LA BARCA,018,CÓNDIRO,2,124,61,63,8
JALISCO,14,LA BARCA,018,EL CARMEN,2,131,63,68,8
JALISCO,14,LA BARCA,018,EL GOBERNADOR,3,198,89,109,11
JALISCO,14,LA BARCA,018,EL LIMÓN,2,104,52,52,5
JALISCO,14,LA BARCA,018,EL LOPEÑO (GUAJAZO),3,61,25,36,4
JALISCO,14,LA BARCA,018,EL LORETO OCCIDENTAL,2,181,89,92,9
JALISCO,14,LA BARCA,018,EL MIRTO,2,76,45,31,5
JALISCO,14,LA BARCA,018,GENERAL GABRIEL LEYVA,1,35,14,21,2
JALISCO,14,LA BARCA,018,GUADALUPE DEL LERMA,3,240,133,107,12
JALISCO,14,LA BARCA,018,HACIENDA DEL TARENGO,2,25,11,14,2
JALISCO,14,LA BARCA,018,LA BARCA,51,12506,6116,6390,649
JALISCO,14,LA BARCA,018,LA PAZ DE ORDAZ,3,300,130,170,14
JALISCO,14,LA BARCA,018,LA PROVIDENCIA,2,145,79,66,8
JALISCO,14,LA BARCA,018,LA PUERTA DE GUAMÚCHIL,2,91,47,44,6
JALISCO,14,LA BARCA,018,LOS ÁNGELES,1,15,5,10,2
JALISCO,14,LA BARCA,018,LOS CANALES,3,243,118,125,12
JALISCO,14,LA BARCA,018,LOS GUAYABOS,3,158,74,84,9
JALISCO,14,LA BARCA,018,PORTEZUELO,6,852,412,440,59
JALISCO,14,LA BARCA,018,SAN ANTONIO DE RIVAS,5,629,299,330,29
JALISCO,14,LA BARCA,018,SAN FRANCISCO DE RIVAS,4,272,129,143,16
JALISCO,14,LA BARCA,018,SAN JOSÉ CASAS CAÍDAS,4,389,206,183,24
JALISCO,14,LA BARCA,018,SAN JOSÉ DE LAS MORAS,3,230,105,125,11
JALISCO,14,LA BARCA,018,SAN PEDRO DE RUIZ,2,160,79,81,8
JALISCO,14,LA BARCA,018,SAN RAMÓN,3,343,162,181,14
JALISCO,14,LA BARCA,018,SANTA LUCÍA,3,176,83,93,11
JALISCO,14,LA BARCA,018,VILLA DE GARCÍA MÁRQUEZ (EL TARENGO NUEVO),3,351,163,188,16
JALISCO,14,LA BARCA,018,ZALAMEA,3,302,153,149,15
JALISCO,14,BOLAÑOS,019,AGUA MILPA DE ARRIBA,1,3,1,2,1
JALISCO,14,BOLAÑOS,019,AMOLERA,2,36,17,19,2
JALISCO,14,BOLAÑOS,019,BAJÍO DEL TULE,4,99,49,50,8
JALISCO,14,BOLAÑOS,019,BARRANCA DEL TULE,3,65,27,38,4
JALISCO,14,BOLAÑOS,019,BARRANQUILLA,3,124,70,54,11
JALISCO,14,BOLAÑOS,019,BOLAÑOS,5,614,315,299,33
JALISCO,14,BOLAÑOS,019,BORROTES (BARROTES DE ABAJO),2,6,5,1,2
JALISCO,14,BOLAÑOS,019,CAÑÓN DE TLAXCALA,2,36,22,14,2
JALISCO,14,BOLAÑOS,019,COAMOSTITA,3,68,39,29,4
JALISCO,14,BOLAÑOS,019,CRUCERO BANDERITAS,1,4,2,2,1
JALISCO,14,BOLAÑOS,019,CRUCERO DE OCOTA,2,38,19,19,3
JALISCO,14,BOLAÑOS,019,EL BANCO DEL VENADO,2,49,26,23,3
JALISCO,14,BOLAÑOS,019,EL CARRIZO (LOS ARADOS),3,63,31,32,4
JALISCO,14,BOLAÑOS,019,EL CONEJO (AGUA BENDITA),1,22,13,9,1
JALISCO,14,BOLAÑOS,019,EL JOMATE,4,92,43,49,7
JALISCO,14,BOLAÑOS,019,EL MANGUITO,1,7,3,4,1
JALISCO,14,BOLAÑOS,019,EL MIRADOR,1,11,8,3,1
JALISCO,14,BOLAÑOS,019,EL REFUGIO (EL GALLINERO),2,4,4,0,2
JALISCO,14,BOLAÑOS,019,EL SAUCILLO,2,20,6,14,2
JALISCO,14,BOLAÑOS,019,EL TEPEC,2,151,75,76,8
JALISCO,14,BOLAÑOS,019,EL VALLECITO,2,49,25,24,4
JALISCO,14,BOLAÑOS,019,HUILACATITLÁN (HUILA),2,91,41,50,7
JALISCO,14,BOLAÑOS,019,HUIZAISTA,2,39,18,21,4
JALISCO,14,BOLAÑOS,019,LA BERENJENA,3,28,20,8,3
JALISCO,14,BOLAÑOS,019,LA CALERA,1,9,5,4,1
JALISCO,14,BOLAÑOS,019,LA CHICHILA (EL COYOTE),3,41,17,24,3
JALISCO,14,BOLAÑOS,019,LA CIÉNEGA,1,10,5,5,1
JALISCO,14,BOLAÑOS,019,LA MESA,1,32,16,16,2
JALISCO,14,BOLAÑOS,019,LA MESA DEL PINO,3,62,30,32,6
JALISCO,14,BOLAÑOS,019,LA PLAYA,2,47,23,24,3
JALISCO,14,BOLAÑOS,019,LAS PALOMAS,1,14,7,7,1
JALISCO,14,BOLAÑOS,019,LOS CERRITOS,2,23,11,12,2
JALISCO,14,BOLAÑOS,019,LOS CORRALES (MESA DEL TIRADOR),5,581,298,283,29
JALISCO,14,BOLAÑOS,019,MESA DE LOS SABINOS (RANCHO EL PUERTECITO),3,92,48,44,8
JALISCO,14,BOLAÑOS,019,MESA DE PAJARITOS,1,7,4,3,1
JALISCO,14,BOLAÑOS,019,MEZQUITIC,2,6,1,5,2
JALISCO,14,BOLAÑOS,019,TIERRA BLANCA,1,11,7,4,1
JALISCO,14,BOLAÑOS,019,TUXPAN DE BOLAÑOS,5,770,394,376,37
JALISCO,14,CABO CORRIENTES,020,AGUA CALIENTE,2,8,7,1,1
JALISCO,14,CABO CORRIENTES,020,AQUILES SERDÁN,3,40,21,19,4
JALISCO,14,CABO CORRIENTES,020,BIOTO,3,18,11,7,3
JALISCO,14,CABO CORRIENTES,020,CHACALA,3,54,32,22,6
JALISCO,14,CABO CORRIENTES,020,CHIMO,3,45,21,24,4
JALISCO,14,CABO CORRIENTES,020,EL COLUMPIO,2,30,15,15,3
JALISCO,14,CABO CORRIENTES,020,EL REFUGIO SUCHITLÁN (LA CONGREGACIÓN),4,96,47,49,10
JALISCO,14,CABO CORRIENTES,020,EL RINCÓN DE LOS OLOTES (EL RINCÓN),2,7,4,3,1
JALISCO,14,CABO CORRIENTES,020,EL TUITO,9,1531,758,773,74
JALISCO,14,CABO CORRIENTES,020,GRACIANO SÁNCHEZ,3,7,5,2,2
JALISCO,14,CABO CORRIENTES,020,IPALA,2,36,17,19,3
JALISCO,14,CABO CORRIENTES,020,IXTLAHUAHUEY,3,51,24,27,5
JALISCO,14,CABO CORRIENTES,020,LA SAUCEDA,3,21,12,9,3
JALISCO,14,CABO CORRIENTES,020,LAS GUÁSIMAS,2,10,6,4,1
JALISCO,14,CABO CORRIENTES,020,LAS JUNTAS DEL TUITO (PUENTE LA PUCHITECA),1,8,3,5,1
JALISCO,14,CABO CORRIENTES,020,LAS JUNTAS Y LOS VERANOS,3,211,110,101,11
JALISCO,14,CABO CORRIENTES,020,LLANO DE LAS PANOCHAS,3,19,3,16,2
JALISCO,14,CABO CORRIENTES,020,LLANO GRANDE DE IPALA,3,29,14,15,4
JALISCO,14,CABO CORRIENTES,020,LOS CORRALES,2,19,9,10,2
JALISCO,14,CABO CORRIENTES,020,LOS RASTROJOS,3,15,7,8,2
JALISCO,14,CABO CORRIENTES,020,MAITO,2,35,12,23,2
JALISCO,14,CABO CORRIENTES,020,MASCOTITA,2,6,4,2,1
JALISCO,14,CABO CORRIENTES,020,NARANJITOS (ARROYO SECO),3,32,15,17,3
JALISCO,14,CABO CORRIENTES,020,PAULO,3,15,6,9,2
JALISCO,14,CABO CORRIENTES,020,PIZOTA,3,20,10,10,3
JALISCO,14,CABO CORRIENTES,020,POTRERILLOS DEL TUITO,3,9,3,6,2
JALISCO,14,CABO CORRIENTES,020,QUIMIXTO,2,57,23,34,3
JALISCO,14,CABO CORRIENTES,020,TECUANI,3,5,2,3,2
JALISCO,14,CABO CORRIENTES,020,TEHUAMIXTLE (TEHUALMIXTLE),2,10,4,6,3
JALISCO,14,CABO CORRIENTES,020,TLALPUYEQUE,3,6,3,3,2
JALISCO,14,CABO CORRIENTES,020,VILLA DEL MAR,4,178,86,92,10
JALISCO,14,CABO CORRIENTES,020,YELAPA,3,224,104,120,11
JALISCO,14,CASIMIRO CASTILLO,021,CORTE COLORADO,1,22,16,6,2
JALISCO,14,CASIMIRO CASTILLO,021,COYAMEL (EL COYAME),3,89,40,49,7
JALISCO,14,CASIMIRO CASTILLO,021,EJIDO MODELO,1,7,4,3,1
JALISCO,14,CASIMIRO CASTILLO,021,EL CHICO,3,157,75,82,9
JALISCO,14,CASIMIRO CASTILLO,021,EL ZAPOTILLO,4,194,101,93,13
JALISCO,14,CASIMIRO CASTILLO,021,FRANCISCO I. MADERO (EL NARANJAL),1,48,21,27,9
JALISCO,14,CASIMIRO CASTILLO,021,LA RESOLANA,19,2836,1433,1403,186
JALISCO,14,CASIMIRO CASTILLO,021,LAS ABEJAS,1,3,1,2,1
JALISCO,14,CASIMIRO CASTILLO,021,LO ARADO,7,943,439,504,56
JALISCO,14,CASIMIRO CASTILLO,021,NUEVO CENTRO DE POBLACIÓN BENITO JUÁREZ,1,16,8,8,1
JALISCO,14,CASIMIRO CASTILLO,021,NUEVO CENTRO DE POBLACIÓN LAS RAMAS,2,38,15,23,3
JALISCO,14,CASIMIRO CASTILLO,021,NUEVO EJIDO CORRAL DE PIEDRA,4,87,44,43,9
JALISCO,14,CASIMIRO CASTILLO,021,TECOMATES,10,622,312,310,52
JALISCO,14,CIHUATLÁN,022,BARRA DE NAVIDAD,6,837,423,414,52
JALISCO,14,CIHUATLÁN,022,CIHUATLÁN,29,4511,2284,2227,277
JALISCO,14,CIHUATLÁN,022,COLONIA PINAL VILLA,3,62,32,30,6
JALISCO,14,CIHUATLÁN,022,EL AGUACATE,4,245,124,121,12
JALISCO,14,CIHUATLÁN,022,EL BONETE,2,4,0,4,1
JALISCO,14,CIHUATLÁN,022,EL CARRIZAL,1,22,13,9,1
JALISCO,14,CIHUATLÁN,022,EL REBALSE,2,23,10,13,3
JALISCO,14,CIHUATLÁN,022,EMILIANO ZAPATA (EL RANCHITO),4,498,238,260,22
JALISCO,14,CIHUATLÁN,022,JALUCO,7,1300,667,633,108
JALISCO,14,CIHUATLÁN,022,LÁZARO CÁRDENAS,2,26,12,14,2
JALISCO,14,CIHUATLÁN,022,LOS INGENIOS,2,48,21,27,3
JALISCO,14,CIHUATLÁN,022,PEÑITAS Y TRUCHAS,2,27,15,12,2
JALISCO,14,CIHUATLÁN,022,SAN PATRICIO (MELAQUE),15,2175,1130,1045,127
JALISCO,14,ZAPOTLÁN EL GRANDE,023,ATEQUIZAYÁN,3,150,69,81,9
JALISCO,14,ZAPOTLÁN EL GRANDE,023,CIUDAD GUZMÁN,162,38093,20216,17877,2437
JALISCO,14,ZAPOTLÁN EL GRANDE,023,LA MESA (EL FRESNITO),3,246,106,140,11
JALISCO,14,ZAPOTLÁN EL GRANDE,023,LOS DEPÓSITOS,2,9,5,4,1
JALISCO,14,ZAPOTLÁN EL GRANDE,023,RANCHO LOS ARCOS,1,374,164,210,59
JALISCO,14,COCULA,024,AGUA CALIENTE,3,92,41,51,8
JALISCO,14,COCULA,024,CAMAJAPA,3,92,47,45,6
JALISCO,14,COCULA,024,CAMICHINES,4,177,96,81,14
JALISCO,14,COCULA,024,COCULA,33,5759,2820,2939,319
JALISCO,14,COCULA,024,EL CHIVATILLO (SAN ISIDRO),2,27,14,13,3
JALISCO,14,COCULA,024,EL SAUCILLO,3,115,63,52,7
JALISCO,14,COCULA,024,LA COFRADÍA DE LA LUZ,5,643,319,324,34
JALISCO,14,COCULA,024,LA ESTANZUELA,2,89,43,46,7
JALISCO,14,COCULA,024,LA PUERTA DEL BORREGO,3,85,41,44,5
JALISCO,14,COCULA,024,LA SAUCEDA,4,371,198,173,28
JALISCO,14,COCULA,024,LOS PARAJES,2,30,15,15,3
JALISCO,14,COCULA,024,SAN NICOLÁS (SAN NICOLÁS ACUÑA),2,218,111,107,9
JALISCO,14,COCULA,024,SAN PABLO,2,7,4,3,1
JALISCO,14,COCULA,024,SANTA MARÍA,2,78,33,45,4
JALISCO,14,COCULA,024,SANTA TERESA,3,224,131,93,11
JALISCO,14,COCULA,024,TATEPOSCO (SAN JOSÉ TATEPOSCO),3,169,76,93,10
JALISCO,14,COLOTLÁN,025,AGUA GORDA,2,19,9,10,2
JALISCO,14,COLOTLÁN,025,CANOAS DE ARRIBA,2,19,13,6,3
JALISCO,14,COLOTLÁN,025,CASA LLANTA,2,15,11,4,2
JALISCO,14,COLOTLÁN,025,COLOTLÁN,35,4543,2410,2133,357
JALISCO,14,COLOTLÁN,025,DOLORES,3,46,23,23,5
JALISCO,14,COLOTLÁN,025,EL CARRIZAL,3,58,31,27,4
JALISCO,14,COLOTLÁN,025,EL EPAZOTE,3,92,43,49,8
JALISCO,14,COLOTLÁN,025,EL SAUCILLO DE LOS PÉREZ,2,19,14,5,2
JALISCO,14,COLOTLÁN,025,JALISCO DEL REFUGIO (JALISCO),1,24,9,15,3
JALISCO,14,COLOTLÁN,025,LA BOQUILLA DE LOS PÉREZ,2,21,13,8,2
JALISCO,14,COLOTLÁN,025,LA CAPILLA,2,14,6,8,2
JALISCO,14,COLOTLÁN,025,LAS TROJES,1,3646,2293,1353,450
JALISCO,14,COLOTLÁN,025,LOS VÉLIZ,3,100,39,61,5
JALISCO,14,COLOTLÁN,025,MESA DE FLORES,3,37,19,18,4
JALISCO,14,COLOTLÁN,025,MESA DE GUADALUPE,1,5,2,3,1
JALISCO,14,COLOTLÁN,025,SAN ANTONIO DE LAS LAJAS,1,9,4,5,1
JALISCO,14,COLOTLÁN,025,SAN FRANCISCO DEL REFUGIO,1,8,3,5,1
JALISCO,14,COLOTLÁN,025,SAN NICOLÁS,3,26,17,9,3
JALISCO,14,COLOTLÁN,025,SAN RAFAEL,1,17,9,8,1
JALISCO,14,COLOTLÁN,025,SAN RAFAEL DEL REFUGIO,1,19,11,8,2
JALISCO,14,COLOTLÁN,025,SANTIAGO TLATELOLCO (SANTIAGO),2,42,24,18,3
JALISCO,14,COLOTLÁN,025,SAUZ TOSTADO,1,12,3,9,1
JALISCO,14,CONCEPCIÓN DE BUENOS AIRES,026,CONCEPCIÓN DE BUENOS AIRES,9,1441,738,703,63
JALISCO,14,CONCEPCIÓN DE BUENOS AIRES,026,LA MÁQUINA,3,20,10,10,3
JALISCO,14,CONCEPCIÓN DE BUENOS AIRES,026,LOS SAUCES,3,72,35,37,6
JALISCO,14,CONCEPCIÓN DE BUENOS AIRES,026,PASO DE LA YERBABUENA,2,7,4,3,2
JALISCO,14,CONCEPCIÓN DE BUENOS AIRES,026,RANCHO VIEJO,2,11,6,5,2
JALISCO,14,CONCEPCIÓN DE BUENOS AIRES,026,TOLUQUILLA,2,45,16,29,3
JALISCO,14,CUAUTITLÁN DE GARCÍA BARRAGÁN,027,AGUA ZARCA,1,17,8,9,1
JALISCO,14,CUAUTITLÁN DE GARCÍA BARRAGÁN,027,AYOTITLÁN,6,526,241,285,27
JALISCO,14,CUAUTITLÁN DE GARCÍA BARRAGÁN,027,CASA BLANCA (REVOLUCIÓN MEXICANA),3,56,29,27,4
JALISCO,14,CUAUTITLÁN DE GARCÍA BARRAGÁN,027,CERRO PRIETO,3,58,23,35,5
JALISCO,14,CUAUTITLÁN DE GARCÍA BARRAGÁN,027,CHACALA,4,320,172,148,21
JALISCO,14,CUAUTITLÁN DE GARCÍA BARRAGÁN,027,CHAMPULGA,2,30,14,16,3
JALISCO,14,CUAUTITLÁN DE GARCÍA BARRAGÁN,027,CHANCOL,3,53,23,30,4
JALISCO,14,CUAUTITLÁN DE GARCÍA BARRAGÁN,027,CHANGAVILÁN,2,5,4,1,1
JALISCO,14,CUAUTITLÁN DE GARCÍA BARRAGÁN,027,CHANQUEHAHUIL,2,14,5,9,2
JALISCO,14,CUAUTITLÁN DE GARCÍA BARRAGÁN,027,CHARCO AZUL,3,51,26,25,4
JALISCO,14,CUAUTITLÁN DE GARCÍA BARRAGÁN,027,CORTAPICO,1,15,9,6,1
JALISCO,14,CUAUTITLÁN DE GARCÍA BARRAGÁN,027,CRUCECITAS,3,24,7,17,3
JALISCO,14,CUAUTITLÁN DE GARCÍA BARRAGÁN,027,CUAUTITLÁN DE GARCÍA BARRAGÁN,6,781,415,366,42
JALISCO,14,CUAUTITLÁN DE GARCÍA BARRAGÁN,027,CUZALAPA,6,395,193,202,25
JALISCO,14,CUAUTITLÁN DE GARCÍA BARRAGÁN,027,EL ALMOLÓN,3,22,12,10,3
JALISCO,14,CUAUTITLÁN DE GARCÍA BARRAGÁN,027,EL ARRAYÁN,1,2,0,2,1
JALISCO,14,CUAUTITLÁN DE GARCÍA BARRAGÁN,027,EL CHICO,3,163,72,91,9
JALISCO,14,CUAUTITLÁN DE GARCÍA BARRAGÁN,027,EL DURAZNO,2,15,8,7,2
JALISCO,14,CUAUTITLÁN DE GARCÍA BARRAGÁN,027,EL MANGUITO,1,11,7,4,1
JALISCO,14,CUAUTITLÁN DE GARCÍA BARRAGÁN,027,EL NARANJAL,2,8,5,3,1
JALISCO,14,CUAUTITLÁN DE GARCÍA BARRAGÁN,027,EL REFUGIO (EL TEPEHUAJE),2,20,10,10,2
JALISCO,14,CUAUTITLÁN DE GARCÍA BARRAGÁN,027,EL REPARO,3,26,12,14,3
JALISCO,14,CUAUTITLÁN DE GARCÍA BARRAGÁN,027,EL VIGÍA,2,41,13,28,4
JALISCO,14,CUAUTITLÁN DE GARCÍA BARRAGÁN,027,LA ASTILLA,1,8,6,2,1
JALISCO,14,CUAUTITLÁN DE GARCÍA BARRAGÁN,027,LA CUCHILLA,3,12,6,6,3
JALISCO,14,CUAUTITLÁN DE GARCÍA BARRAGÁN,027,LA GUACA,1,4,2,2,1
JALISCO,14,CUAUTITLÁN DE GARCÍA BARRAGÁN,027,LA GUADALUPE,2,11,8,3,2
JALISCO,14,CUAUTITLÁN DE GARCÍA BARRAGÁN,027,LA HACIENDA,2,11,6,5,1
JALISCO,14,CUAUTITLÁN DE GARCÍA BARRAGÁN,027,LA NANCE,2,9,5,4,2
JALISCO,14,CUAUTITLÁN DE GARCÍA BARRAGÁN,027,LA PAREJA,3,33,19,14,3
JALISCO,14,CUAUTITLÁN DE GARCÍA BARRAGÁN,027,LA PIEDRA,2,60,26,34,4
JALISCO,14,CUAUTITLÁN DE GARCÍA BARRAGÁN,027,LA ROSA,2,36,13,23,4
JALISCO,14,CUAUTITLÁN DE GARCÍA BARRAGÁN,027,LA ZORRA,2,13,4,9,2
JALISCO,14,CUAUTITLÁN DE GARCÍA BARRAGÁN,027,LAGUNILLAS DE MACOACA (LAGUNILLAS),3,88,36,52,6
JALISCO,14,CUAUTITLÁN DE GARCÍA BARRAGÁN,027,LAS CANOITAS,2,7,3,4,1
JALISCO,14,CUAUTITLÁN DE GARCÍA BARRAGÁN,027,LAS CAÑADAS,2,17,9,8,2
JALISCO,14,CUAUTITLÁN DE GARCÍA BARRAGÁN,027,LAS GUAYABILLAS,3,68,35,33,5
JALISCO,14,CUAUTITLÁN DE GARCÍA BARRAGÁN,027,LAS LAGUNILLAS DE AYOTITLÁN,3,154,72,82,13
JALISCO,14,CUAUTITLÁN DE GARCÍA BARRAGÁN,027,LAS MADERAS,4,128,58,70,10
JALISCO,14,CUAUTITLÁN DE GARCÍA BARRAGÁN,027,LAS MARÍAS,3,38,17,21,4
JALISCO,14,CUAUTITLÁN DE GARCÍA BARRAGÁN,027,LLANO GRANDE,3,51,18,33,5
JALISCO,14,CUAUTITLÁN DE GARCÍA BARRAGÁN,027,LOMA COLORADA,2,6,1,5,1
JALISCO,14,CUAUTITLÁN DE GARCÍA BARRAGÁN,027,LOS ESPINOS,2,6,1,5,1
JALISCO,14,CUAUTITLÁN DE GARCÍA BARRAGÁN,027,LOS LLANITOS (TEPEJILOTE),3,19,12,7,2
JALISCO,14,CUAUTITLÁN DE GARCÍA BARRAGÁN,027,LOS SAUCES,3,45,19,26,3
JALISCO,14,CUAUTITLÁN DE GARCÍA BARRAGÁN,027,LOS TERREROS,3,33,14,19,3
JALISCO,14,CUAUTITLÁN DE GARCÍA BARRAGÁN,027,LOS TERREROS DE AYOTITLÁN,1,3,0,3,1
JALISCO,14,CUAUTITLÁN DE GARCÍA BARRAGÁN,027,MAMEYITO,2,8,2,6,2
JALISCO,14,CUAUTITLÁN DE GARCÍA BARRAGÁN,027,MOJONERAS,2,32,13,19,3
JALISCO,14,CUAUTITLÁN DE GARCÍA BARRAGÁN,027,OCOTE ARCO (RINCÓN DE AYOTITLÁN),3,98,41,57,6
JALISCO,14,CUAUTITLÁN DE GARCÍA BARRAGÁN,027,PASO REAL,1,8,5,3,1
JALISCO,14,CUAUTITLÁN DE GARCÍA BARRAGÁN,027,PATITAS,2,6,3,3,1
JALISCO,14,CUAUTITLÁN DE GARCÍA BARRAGÁN,027,PEDREGAL,3,43,17,26,5
JALISCO,14,CUAUTITLÁN DE GARCÍA BARRAGÁN,027,PLAN DE MÉNDEZ,2,46,21,25,2
JALISCO,14,CUAUTITLÁN DE GARCÍA BARRAGÁN,027,PLAN DE SAN ANTONIO (SAN ANTONIO),2,30,11,19,3
JALISCO,14,CUAUTITLÁN DE GARCÍA BARRAGÁN,027,QUIROMA,1,9,3,6,1
JALISCO,14,CUAUTITLÁN DE GARCÍA BARRAGÁN,027,RANCHO VIEJO,3,68,35,33,5
JALISCO,14,CUAUTITLÁN DE GARCÍA BARRAGÁN,027,SAN MIGUEL,3,31,18,13,4
JALISCO,14,CUAUTITLÁN DE GARCÍA BARRAGÁN,027,SANTA ROSA,3,21,12,9,3
JALISCO,14,CUAUTITLÁN DE GARCÍA BARRAGÁN,027,SEHUAYA,3,108,51,57,10
JALISCO,14,CUAUTITLÁN DE GARCÍA BARRAGÁN,027,TELCRUCITO,3,19,10,9,3
JALISCO,14,CUAUTITLÁN DE GARCÍA BARRAGÁN,027,TELCRUCITO DE PIEDRA PINTADA (LA CUERILLA),2,26,13,13,3
JALISCO,14,CUAUTITLÁN DE GARCÍA BARRAGÁN,027,TELCRUZ,6,436,207,229,27
JALISCO,14,CUAUTITLÁN DE GARCÍA BARRAGÁN,027,TEQUESQUITLÁN,6,528,245,283,30
JALISCO,14,CUAUTITLÁN DE GARCÍA BARRAGÁN,027,TIERRAS BLANCAS,2,41,16,25,3
JALISCO,14,CUAUTITLÁN DE GARCÍA BARRAGÁN,027,TIERRAS NEGRAS,2,20,9,11,2
JALISCO,14,CUAUTLA,028,CHILACAYOTE,3,57,28,29,5
JALISCO,14,CUAUTLA,028,CUAUTLA,6,621,330,291,55
JALISCO,14,CUAUTLA,028,TIERRAS BLANCAS,2,41,20,21,3
JALISCO,14,CUAUTLA,028,TOTOTLÁN DEL ORO,2,20,8,12,2
JALISCO,14,CUQUÍO,029,AGUA BLANCA,2,12,4,8,2
JALISCO,14,CUQUÍO,029,CAÑADA DE LAS FLORES,3,24,12,12,3
JALISCO,14,CUQUÍO,029,CARRICILLO,2,34,16,18,3
JALISCO,14,CUQUÍO,029,CERRITO DE TIERRA,3,46,21,25,4
JALISCO,14,CUQUÍO,029,CONTLA,1,5,4,1,1
JALISCO,14,CUQUÍO,029,CUACUALA,3,52,25,27,6
JALISCO,14,CUQUÍO,029,CUQUÍO,13,1609,822,787,131
JALISCO,14,CUQUÍO,029,EL AGUACATE,2,44,21,23,3
JALISCO,14,CUQUÍO,029,EL ASTILLERO [LA BODEGA],2,10,6,4,1
JALISCO,14,CUQUÍO,029,EL BAJÍO DE LOS GALLOS,2,16,9,7,2
JALISCO,14,CUQUÍO,029,EL CERRITO DE LOS GUTIÉRREZ,2,16,9,7,2
JALISCO,14,CUQUÍO,029,EL COYOTILLO,2,18,10,8,2
JALISCO,14,CUQUÍO,029,EL CUATRO,2,33,12,21,3
JALISCO,14,CUQUÍO,029,EL DERRAMADERO,3,31,19,12,3
JALISCO,14,CUQUÍO,029,EL LLANO DE BARAJAS,2,37,14,23,3
JALISCO,14,CUQUÍO,029,EL LLANO DE PLASCENCIA,2,18,13,5,3
JALISCO,14,CUQUÍO,029,EL MEZQUITE,2,16,8,8,2
JALISCO,14,CUQUÍO,029,EL RANCHITO,1,9,7,2,1
JALISCO,14,CUQUÍO,029,EL RANCHITO (LOS NARANJITOS),2,17,6,11,2
JALISCO,14,CUQUÍO,029,EL SAUZ,1,12,10,2,1
JALISCO,14,CUQUÍO,029,EL TEPOZÁN,2,21,13,8,2
JALISCO,14,CUQUÍO,029,EL TERRERO,3,86,48,38,7
JALISCO,14,CUQUÍO,029,JALA,2,10,4,6,1
JALISCO,14,CUQUÍO,029,JUCHITLÁN,3,143,73,70,10
JALISCO,14,CUQUÍO,029,LA COFRADÍA,2,7,5,2,1
JALISCO,14,CUQUÍO,029,LA ESPERANZA (EL RANCHITO),4,201,103,98,13
JALISCO,14,CUQUÍO,029,LA GIGANTERA (POTRERO DEL OMBLIGO),2,18,8,10,2
JALISCO,14,CUQUÍO,029,LA LAGUNA GRANDE,2,17,7,10,2
JALISCO,14,CUQUÍO,029,LA MOJARRA (TANQUE COLORADO),2,24,9,15,3
JALISCO,14,CUQUÍO,029,LA PALMA,2,21,12,9,2
JALISCO,14,CUQUÍO,029,LA QUEMADA DE TATEPOSCO,2,14,8,6,2
JALISCO,14,CUQUÍO,029,LA TORTUGA,2,18,10,8,1
JALISCO,14,CUQUÍO,029,LA VILLITA,2,14,5,9,2
JALISCO,14,CUQUÍO,029,LAS COCINAS (EL RANCHITO),3,47,27,20,5
JALISCO,14,CUQUÍO,029,LAS CRUCES,4,324,176,148,22
JALISCO,14,CUQUÍO,029,LÁZARO CÁRDENAS,3,472,241,231,24
JALISCO,14,CUQUÍO,029,LOMA DE ENMEDIO,2,6,2,4,1
JALISCO,14,CUQUÍO,029,LOMAS DEL MIRADOR (LA LOMA),1,6,3,3,1
JALISCO,14,CUQUÍO,029,LOS ARCOS,3,70,36,34,6
JALISCO,14,CUQUÍO,029,LOS CAPULINES,2,25,13,12,2
JALISCO,14,CUQUÍO,029,LOS MEZQUITES,3,52,28,24,4
JALISCO,14,CUQUÍO,029,LOS MUÑOZ,2,18,8,10,2
JALISCO,14,CUQUÍO,029,LOS SAUCES DE MORA,2,8,2,6,1
JALISCO,14,CUQUÍO,029,LOS SAUCES DE PÉREZ,2,28,15,13,2
JALISCO,14,CUQUÍO,029,LOS SAUCES DE PLASCENCIA,1,7,6,1,1
JALISCO,14,CUQUÍO,029,LOS ZAPOTES,3,57,28,29,4
JALISCO,14,CUQUÍO,029,MÁRTIRES DEL 28,1,47,18,29,2
JALISCO,14,CUQUÍO,029,OCOTIC,3,154,75,79,9
JALISCO,14,CUQUÍO,029,OJO DE AGUA COLORADA,3,49,30,19,7
JALISCO,14,CUQUÍO,029,PUERTO DE TATEPOSCO,1,9,4,5,1
JALISCO,14,CUQUÍO,029,SAN GABRIEL,2,8,5,3,1
JALISCO,14,CUQUÍO,029,SAN JOSÉ DE ABAJO,2,5,2,3,1
JALISCO,14,CUQUÍO,029,SAN JOSÉ DE LOS MOLINA,3,60,29,31,6
JALISCO,14,CUQUÍO,029,SAN JUAN DEL MONTE,3,117,66,51,9
JALISCO,14,CUQUÍO,029,SAN NICOLÁS DE LOS ESTEVES,2,29,15,14,2
JALISCO,14,CUQUÍO,029,SANTA CLARA,1,5,3,2,1
JALISCO,14,CUQUÍO,029,TATEPOSCO,2,17,8,9,2
JALISCO,14,CUQUÍO,029,TEPONAHUASCO,3,255,121,134,12
JALISCO,14,CUQUÍO,029,VARAS DULCES,2,29,14,15,2
JALISCO,14,CHAPALA,030,AJIJIC,39,3823,1863,1960,304
JALISCO,14,CHAPALA,030,ATOTONILQUILLO,8,1630,800,830,74
JALISCO,14,CHAPALA,030,CHAPALA,38,7905,3879,4026,466
JALISCO,14,CHAPALA,030,HACIENDA DE LA LABOR,1,34,16,18,2
JALISCO,14,CHAPALA,030,PRESA CORONA,2,85,41,44,4
JALISCO,14,CHAPALA,030,SAN ANTONIO TLAYACAPAN,3,61,34,27,17
JALISCO,14,CHAPALA,030,SAN NICOLÁS DE IBARRA,4,315,169,146,14
JALISCO,14,CHAPALA,030,SANTA CRUZ DE LA SOLEDAD,3,327,150,177,12
JALISCO,14,CHIMALTITÁN,031,AGUA CALIENTE,2,62,30,32,3
JALISCO,14,CHIMALTITÁN,031,CHIMALTITÁN,4,238,132,106,21
JALISCO,14,CHIMALTITÁN,031,CHONACATE,2,43,18,25,3
JALISCO,14,CHIMALTITÁN,031,COCUASCO,3,64,36,28,4
JALISCO,14,CHIMALTITÁN,031,EL DURAZNITO,2,7,3,4,2
JALISCO,14,CHIMALTITÁN,031,HACIENDA DE BORROTES,1,6,3,3,1
JALISCO,14,CHIMALTITÁN,031,LOS CERRITOS,2,32,15,17,3
JALISCO,14,CHIMALTITÁN,031,MESA DEL CAPULÍN,2,17,9,8,2
JALISCO,14,CHIMALTITÁN,031,SAN JUAN DE LOS POTREROS,4,175,92,83,13
JALISCO,14,CHIMALTITÁN,031,TEPIZUAC,3,206,102,104,11
JALISCO,14,CHIQUILISTLÁN,032,AGUA DELGADA,1,26,7,19,2
JALISCO,14,CHIQUILISTLÁN,032,AGUA DELGADA (LOS LLANITOS),2,25,17,8,2
JALISCO,14,CHIQUILISTLÁN,032,AGUA HEDIONDA (SAN JOSÉ DE LA PEÑA),3,97,55,42,6
JALISCO,14,CHIQUILISTLÁN,032,CAPULA,2,15,8,7,2
JALISCO,14,CHIQUILISTLÁN,032,CHIQUILISTLÁN,6,1413,709,704,53
JALISCO,14,CHIQUILISTLÁN,032,CITALA,3,6,3,3,2
JALISCO,14,CHIQUILISTLÁN,032,COMALA Y AGUA PUERCA,3,32,14,18,5
JALISCO,14,CHIQUILISTLÁN,032,EL AGOSTADERO,2,15,9,6,2
JALISCO,14,CHIQUILISTLÁN,032,EL LIMONCITO,2,11,5,6,2
JALISCO,14,CHIQUILISTLÁN,032,EL RANCHITO,2,49,27,22,4
JALISCO,14,CHIQUILISTLÁN,032,JALPA,3,108,54,54,7
JALISCO,14,DEGOLLADO,033,BARBECHITOS (BARBECHOS),1,3,1,2,1
JALISCO,14,DEGOLLADO,033,BUENOS AIRES,3,173,74,99,9
JALISCO,14,DEGOLLADO,033,CHARAPUATO,3,115,59,56,6
JALISCO,14,DEGOLLADO,033,DEGOLLADO,19,3136,1549,1587,182
JALISCO,14,DEGOLLADO,033,EL ARCA,1,24,9,15,1
JALISCO,14,DEGOLLADO,033,EL BAÑADERO,3,33,18,15,4
JALISCO,14,DEGOLLADO,033,EL CASTILLO,3,137,70,67,7
JALISCO,14,DEGOLLADO,033,EL MEZQUITILLO,3,43,21,22,3
JALISCO,14,DEGOLLADO,033,EL REFUGIO DE VÁZQUEZ,1,23,14,9,1
JALISCO,14,DEGOLLADO,033,EL TERRERO DE VILLAREÑO (TERRERO DE CARMEN),3,41,24,17,3
JALISCO,14,DEGOLLADO,033,HUÁSCATO,4,448,218,230,22
JALISCO,14,DEGOLLADO,033,LA ESPADA DE RIZO,1,24,13,11,2
JALISCO,14,DEGOLLADO,033,LA SABINILLA (SABINILLAS),1,6,2,4,1
JALISCO,14,DEGOLLADO,033,LA SANGUIJUELA,1,12,4,8,1
JALISCO,14,DEGOLLADO,033,LA TINAJERA,2,28,16,12,2
JALISCO,14,DEGOLLADO,033,LA VÍBORA (VILLA DEL REFUGIO),3,92,56,36,4
JALISCO,14,DEGOLLADO,033,LAS ADJUNTAS,2,36,18,18,3
JALISCO,14,DEGOLLADO,033,LAS LIMAS,1,13,5,8,1
JALISCO,14,DEGOLLADO,033,LOS ARRAYANES,2,24,12,12,3
JALISCO,14,DEGOLLADO,033,LOS FRESNOS,4,228,109,119,12
JALISCO,14,DEGOLLADO,033,LOS RANCHITOS,2,21,8,13,2
JALISCO,14,DEGOLLADO,033,MEZQUITE GRANDE,4,153,77,76,10
JALISCO,14,DEGOLLADO,033,PUERTO DE CATARINA,2,61,26,35,3
JALISCO,14,DEGOLLADO,033,QUIRINO (LA SIERRITA),3,49,25,24,4
JALISCO,14,DEGOLLADO,033,RANCHO NUEVO,2,39,27,12,3
JALISCO,14,DEGOLLADO,033,SAN HIPÓLITO (ALTAMIRA),3,39,14,25,5
JALISCO,14,DEGOLLADO,033,SAN RAFAEL (LA RESOLANA),2,45,17,28,3
JALISCO,14,DEGOLLADO,033,TARIMORO,3,101,46,55,7
JALISCO,14,DEGOLLADO,033,UNIÓN DE GUADALUPE (LA CHANCLA),2,21,8,13,2
JALISCO,14,EJUTLA,034,EJUTLA,5,361,175,186,23
JALISCO,14,EJUTLA,034,LA LABOR,3,19,12,7,3
JALISCO,14,EJUTLA,034,MESA DE SAN NICOLÁS,1,7,4,3,1
JALISCO,14,EJUTLA,034,SAN LORENZO,2,14,8,6,2
JALISCO,14,ENCARNACIÓN DE DÍAZ,035,BAJÍO DE SAN JOSÉ,9,1336,688,648,81
JALISCO,14,ENCARNACIÓN DE DÍAZ,035,CAQUIXTLE DE ABAJO,1,8,4,4,1
JALISCO,14,ENCARNACIÓN DE DÍAZ,035,CAQUIXTLE DE ARRIBA,3,101,46,55,7
JALISCO,14,ENCARNACIÓN DE DÍAZ,035,CIÉNEGA DE MORA,2,21,10,11,2
JALISCO,14,ENCARNACIÓN DE DÍAZ,035,CORRAL DE PIEDRA,3,145,73,72,9
JALISCO,14,ENCARNACIÓN DE DÍAZ,035,EJIDO CIÉNEGA DE MORA (EL RANCHITO),3,62,32,30,5
JALISCO,14,ENCARNACIÓN DE DÍAZ,035,EL CARMEN,1,13,4,9,2
JALISCO,14,ENCARNACIÓN DE DÍAZ,035,EL ESTABLO (LAS GRANJAS),3,26,12,14,2
JALISCO,14,ENCARNACIÓN DE DÍAZ,035,EL JARALILLO,2,53,23,30,3
JALISCO,14,ENCARNACIÓN DE DÍAZ,035,EL LAUREL,1,13,6,7,1
JALISCO,14,ENCARNACIÓN DE DÍAZ,035,EL MEZQUITE,3,63,27,36,4
JALISCO,14,ENCARNACIÓN DE DÍAZ,035,EL PELÓN,2,7,2,5,1
JALISCO,14,ENCARNACIÓN DE DÍAZ,035,EL ROSARIO,2,144,77,67,7
JALISCO,14,ENCARNACIÓN DE DÍAZ,035,EL SALVADOR,3,165,82,83,10
JALISCO,14,ENCARNACIÓN DE DÍAZ,035,EL TECUÁN,4,666,340,326,43
JALISCO,14,ENCARNACIÓN DE DÍAZ,035,EL TIGRE,1,5,0,5,1
JALISCO,14,ENCARNACIÓN DE DÍAZ,035,EL TROPEZÓN,3,60,30,30,6
JALISCO,14,ENCARNACIÓN DE DÍAZ,035,EL VERGEL,2,61,28,33,3
JALISCO,14,ENCARNACIÓN DE DÍAZ,035,ENCARNACIÓN DE DÍAZ,43,6351,3278,3073,488
JALISCO,14,ENCARNACIÓN DE DÍAZ,035,HUARACHA,3,25,11,14,4
JALISCO,14,ENCARNACIÓN DE DÍAZ,035,LA LOMA,1,11,4,7,1
JALISCO,14,ENCARNACIÓN DE DÍAZ,035,LA LOMITA (EL RANCHITO),2,29,19,10,3
JALISCO,14,ENCARNACIÓN DE DÍAZ,035,LA MAGDALENA,2,4,3,1,1
JALISCO,14,ENCARNACIÓN DE DÍAZ,035,LA MAJADA,2,7,5,2,1
JALISCO,14,ENCARNACIÓN DE DÍAZ,035,LA PALMA,1,8,4,4,1
JALISCO,14,ENCARNACIÓN DE DÍAZ,035,LA TRINIDAD,3,135,61,74,9
JALISCO,14,ENCARNACIÓN DE DÍAZ,035,LA TRINIDAD DE DÍAZ,2,7,3,4,2
JALISCO,14,ENCARNACIÓN DE DÍAZ,035,LAS GÜERAS,3,126,71,55,7
JALISCO,14,ENCARNACIÓN DE DÍAZ,035,LAS JAULAS,2,21,13,8,2
JALISCO,14,ENCARNACIÓN DE DÍAZ,035,LAS PILAS DE ABAJO,2,33,18,15,3
JALISCO,14,ENCARNACIÓN DE DÍAZ,035,LAS PILAS DE ARRIBA,1,39,17,22,2
JALISCO,14,ENCARNACIÓN DE DÍAZ,035,LOS TAJOS,1,6,1,5,1
JALISCO,14,ENCARNACIÓN DE DÍAZ,035,MARIQUITA,2,22,13,9,2
JALISCO,14,ENCARNACIÓN DE DÍAZ,035,MEDIA LUNA,3,19,9,10,2
JALISCO,14,ENCARNACIÓN DE DÍAZ,035,MESÓN DE LOS SAUCES,4,528,271,257,24
JALISCO,14,ENCARNACIÓN DE DÍAZ,035,RINCÓN GRANDE,1,19,11,8,1
JALISCO,14,ENCARNACIÓN DE DÍAZ,035,RÍO DE LOS LOMELINES (LA HACIENDITA),1,17,12,5,2
JALISCO,14,ENCARNACIÓN DE DÍAZ,035,SAN ANTONIO DEL ALTO,1,13,4,9,1
JALISCO,14,ENCARNACIÓN DE DÍAZ,035,SAN IGNACIO,1,4,3,1,1
JALISCO,14,ENCARNACIÓN DE DÍAZ,035,SAN JOSÉ (LA CALERA),3,49,25,24,4
JALISCO,14,ENCARNACIÓN DE DÍAZ,035,SAN JUAN DE LOS LAGOS [ESTACIÓN],2,67,27,40,4
JALISCO,14,ENCARNACIÓN DE DÍAZ,035,SAN MARCOS DE ABAJO (DE LOS DOLORES),1,8,2,6,1
JALISCO,14,ENCARNACIÓN DE DÍAZ,035,SAN MARCOS DE ARRIBA (SAN MARCOS DEL REFUGIO),2,56,26,30,3
JALISCO,14,ENCARNACIÓN DE DÍAZ,035,SAN PEDRO,1,9,4,5,1
JALISCO,14,ENCARNACIÓN DE DÍAZ,035,SAN SEBASTIÁN DEL ÁLAMO,4,637,303,334,27
JALISCO,14,ENCARNACIÓN DE DÍAZ,035,SAN VICENTE,3,32,15,17,2
JALISCO,14,ENCARNACIÓN DE DÍAZ,035,SANTA BÁRBARA (ESTACIÓN CASTRO),3,178,88,90,9
JALISCO,14,ENCARNACIÓN DE DÍAZ,035,SANTA MARÍA DE ENMEDIO,4,184,84,100,13
JALISCO,14,ENCARNACIÓN DE DÍAZ,035,SANTA MARÍA TRANSPONTINA,4,384,196,188,19
JALISCO,14,ENCARNACIÓN DE DÍAZ,035,TEPOZÁN DE MIRANDA,2,27,12,15,3
JALISCO,14,ENCARNACIÓN DE DÍAZ,035,VIBORILLAS,2,24,7,17,3
JALISCO,14,ETZATLÁN,036,EL AMPARO (LA EMBOCADA),2,5,2,3,1
JALISCO,14,ETZATLÁN,036,ETZATLÁN,28,4182,2167,2015,279
JALISCO,14,ETZATLÁN,036,LA MAZATA,1,82,44,38,9
JALISCO,14,ETZATLÁN,036,LA QUEBRADA,3,22,12,10,2
JALISCO,14,ETZATLÁN,036,OCONAHUA,6,587,280,307,37
JALISCO,14,ETZATLÁN,036,PUERTA DE PERICOS (TLACHICHILCO),3,44,24,20,4
JALISCO,14,ETZATLÁN,036,SAN RAFAEL (HACIENDA DE SAN RAFAEL),2,68,30,38,4
JALISCO,14,ETZATLÁN,036,SAN SEBASTIÁN (EX-HACIENDA DE SAN SEBASTIÁN),2,17,6,11,2
JALISCO,14,ETZATLÁN,036,SANTA ROSALÍA,2,187,87,100,9
JALISCO,14,EL GRULLO,037,AYUQUILA,5,432,211,221,33
JALISCO,14,EL GRULLO,037,EL AGUACATE,3,63,33,30,4
JALISCO,14,EL GRULLO,037,EL GRULLO,34,5799,2944,2855,396
JALISCO,14,EL GRULLO,037,LA COFRADÍA,1,242,133,109,8
JALISCO,14,EL GRULLO,037,LA LAJA,3,76,35,41,6
JALISCO,14,EL GRULLO,037,LA PUERTA DEL BARRO,4,360,163,197,50
JALISCO,14,EL GRULLO,037,LAS PILAS,2,52,25,27,4
JALISCO,14,EL GRULLO,037,PALO BLANCO,1,9,2,7,1
JALISCO,14,EL GRULLO,037,RANCHO EL TEMPISQUE,1,4,1,3,1
JALISCO,14,GUACHINANGO,038,AMAJAQUILLO,3,47,27,20,6
JALISCO,14,GUACHINANGO,038,EL ÓRGANO,2,11,4,7,1
JALISCO,14,GUACHINANGO,038,EL RANCHITO,2,46,18,28,3
JALISCO,14,GUACHINANGO,038,EL TABLILLO,2,37,10,27,4
JALISCO,14,GUACHINANGO,038,ESTANZUELA,2,14,8,6,2
JALISCO,14,GUACHINANGO,038,GUACHINANGO,5,478,246,232,33
JALISCO,14,GUACHINANGO,038,LA CIÉNEGA DE LOS AHUMADA,3,37,18,19,4
JALISCO,14,GUACHINANGO,038,LA FUNDICIÓN DEL REBAJE (LA FUNDICIÓN),1,13,8,5,1
JALISCO,14,GUACHINANGO,038,LA TARASCA,2,9,6,3,1
JALISCO,14,GUACHINANGO,038,LLANO GRANDE,3,70,29,41,6
JALISCO,14,GUACHINANGO,038,LOS TORILES,1,25,16,9,1
JALISCO,14,GUACHINANGO,038,PÁNICO,3,24,14,10,3
JALISCO,14,GUACHINANGO,038,SANTA ISABEL DE QUILILLA,2,21,10,11,2
JALISCO,14,GUADALAJARA,039,GUADALAJARA,1910,417462,212156,205306,29908
JALISCO,14,HOSTOTIPAQUILLO,040,CINCO MINAS,3,45,22,23,4
JALISCO,14,HOSTOTIPAQUILLO,040,EL GUAYABO,1,4,1,3,1
JALISCO,14,HOSTOTIPAQUILLO,040,EL LLANO DE LOS VELA,4,124,65,59,10
JALISCO,14,HOSTOTIPAQUILLO,040,EL LLANO DE MICHEL,1,5,3,2,1
JALISCO,14,HOSTOTIPAQUILLO,040,EL MONTE DEL FAVOR,1,7,4,3,1
JALISCO,14,HOSTOTIPAQUILLO,040,EL SAUCILLO,2,18,9,9,2
JALISCO,14,HOSTOTIPAQUILLO,040,EL TEQUESQUITE,3,66,34,32,6
JALISCO,14,HOSTOTIPAQUILLO,040,HOSTOTIPAQUILLO,8,1015,506,509,65
JALISCO,14,HOSTOTIPAQUILLO,040,HUAJACATLÁN,2,16,5,11,2
JALISCO,14,HOSTOTIPAQUILLO,040,LA ESTANZUELA,3,20,9,11,3
JALISCO,14,HOSTOTIPAQUILLO,040,LA MESA DE TECOMATÁN,2,5,4,1,2
JALISCO,14,HOSTOTIPAQUILLO,040,LA MONTAÑA,2,61,31,30,5
JALISCO,14,HOSTOTIPAQUILLO,040,LA VENTA DE MOCHITILTIC,4,212,112,100,15
JALISCO,14,HOSTOTIPAQUILLO,040,LABOR DE GUADALUPE,2,32,17,15,3
JALISCO,14,HOSTOTIPAQUILLO,040,LAS CIÉNEGAS,1,5,3,2,1
JALISCO,14,HOSTOTIPAQUILLO,040,LAS CONOCAS,3,28,18,10,2
JALISCO,14,HOSTOTIPAQUILLO,040,MESA DE FLORES,2,16,8,8,2
JALISCO,14,HOSTOTIPAQUILLO,040,MICHEL,3,59,22,37,5
JALISCO,14,HOSTOTIPAQUILLO,040,MOSELO,1,17,8,9,1
JALISCO,14,HOSTOTIPAQUILLO,040,PLAN DE BARRANCAS,3,65,30,35,5
JALISCO,14,HOSTOTIPAQUILLO,040,SAN ANTONIO,2,41,22,19,3
JALISCO,14,HOSTOTIPAQUILLO,040,SANTO DOMINGO DE GUZMÁN (SANTO DOMINGO),3,46,22,24,4
JALISCO,14,HOSTOTIPAQUILLO,040,SANTO TOMÁS,3,235,115,120,11
JALISCO,14,HOSTOTIPAQUILLO,040,SAYULIMITA,3,41,25,16,4
JALISCO,14,HUEJÚCAR,041,ACHIMEC,3,34,14,20,4
JALISCO,14,HUEJÚCAR,041,CIÉNEGA GRANDE,2,15,6,9,2
JALISCO,14,HUEJÚCAR,041,HUEJÚCAR,13,817,393,424,72
JALISCO,14,HUEJÚCAR,041,LA MESA DE MARÍA DE LEÓN,2,19,11,8,2
JALISCO,14,HUEJÚCAR,041,LAS BOCAS,4,152,81,71,12
JALISCO,14,HUEJÚCAR,041,LAS CAÑAS,1,7,2,5,1
JALISCO,14,HUEJÚCAR,041,NESTORES,1,23,9,14,2
JALISCO,14,HUEJÚCAR,041,SAN JOSÉ DE LOS MÁRQUEZ,2,31,18,13,3
JALISCO,14,HUEJÚCAR,041,SAN RAFAEL DE DÍAZ,2,17,8,9,3
JALISCO,14,HUEJÚCAR,041,TLALCOSAHUA,5,141,69,72,11
JALISCO,14,HUEJUQUILLA EL ALTO,042,ARROYOS DEL AGUA,2,25,11,14,2
JALISCO,14,HUEJUQUILLA EL ALTO,042,COLONIA HATMASIE,3,129,74,55,10
JALISCO,14,HUEJUQUILLA EL ALTO,042,EL SABINO,2,8,5,3,2
JALISCO,14,HUEJUQUILLA EL ALTO,042,HUEJUQUILLA EL ALTO,13,1881,975,906,119
JALISCO,14,HUEJUQUILLA EL ALTO,042,JIMULCO,2,15,5,10,2
JALISCO,14,HUEJUQUILLA EL ALTO,042,LA BOQUILLA,1,5,1,4,1
JALISCO,14,HUEJUQUILLA EL ALTO,042,LA COFRADÍA,3,228,112,116,11
JALISCO,14,HUEJUQUILLA EL ALTO,042,LA ESTANCIA DE ABAJO,1,54,30,24,3
JALISCO,14,HUEJUQUILLA EL ALTO,042,LA ESTANCIA DE ARRIBA,1,3,3,0,1
JALISCO,14,HUEJUQUILLA EL ALTO,042,LA SOLEDAD,3,51,27,24,5
JALISCO,14,HUEJUQUILLA EL ALTO,042,LOS MEZQUITES,1,7,2,5,1
JALISCO,14,HUEJUQUILLA EL ALTO,042,LOS ZAPOTES,2,19,9,10,2
JALISCO,14,HUEJUQUILLA EL ALTO,042,MESA DE CRISTO,1,2,2,0,1
JALISCO,14,HUEJUQUILLA EL ALTO,042,ORTEGA,1,7,2,5,1
JALISCO,14,HUEJUQUILLA EL ALTO,042,RANCHO COLORADO,2,13,3,10,2
JALISCO,14,HUEJUQUILLA EL ALTO,042,SALITRE DE ABAJO,2,15,8,7,2
JALISCO,14,HUEJUQUILLA EL ALTO,042,SAN CAYETANO DE LOS LANDA,1,9,3,6,1
JALISCO,14,HUEJUQUILLA EL ALTO,042,SAN JOSÉ DE MADERAS,2,20,9,11,2
JALISCO,14,HUEJUQUILLA EL ALTO,042,SAN NICOLÁS DE ACUÑA,2,12,5,7,2
JALISCO,14,HUEJUQUILLA EL ALTO,042,TENZOMPA,4,235,104,131,18
JALISCO,14,HUEJUQUILLA EL ALTO,042,VALLECITO,3,9,7,2,3
JALISCO,14,LA HUERTA,043,AGUA CALIENTE NUEVA,1,36,19,17,2
JALISCO,14,LA HUERTA,043,AGUA CALIENTE VIEJA DE APAZULCO,3,370,195,175,19
JALISCO,14,LA HUERTA,043,AGUA ZARQUITA,2,23,10,13,3
JALISCO,14,LA HUERTA,043,APAMILA,2,10,6,4,1
JALISCO,14,LA HUERTA,043,APAZULCO (MIGUEL HIDALGO VIEJO),3,277,141,136,14
JALISCO,14,LA HUERTA,043,ARROYO SECO,3,57,30,27,4
JALISCO,14,LA HUERTA,043,CHAMELA,2,36,18,18,3
JALISCO,14,LA HUERTA,043,COFRADÍA,3,58,27,31,5
JALISCO,14,LA HUERTA,043,COMITANCITO,3,16,8,8,2
JALISCO,14,LA HUERTA,043,CUITZMALA,1,141,69,72,6
JALISCO,14,LA HUERTA,043,EJIDO EL RINCÓN,3,52,26,26,5
JALISCO,14,LA HUERTA,043,EJIDO LA FORTUNA,2,39,13,26,2
JALISCO,14,LA HUERTA,043,EL HIGUERAL,1,5,1,4,1
JALISCO,14,LA HUERTA,043,EL PALMAR (ADOLFO LÓPEZ MATEOS),1,14,4,10,1
JALISCO,14,LA HUERTA,043,EL PROGRAMA,2,35,17,18,3
JALISCO,14,LA HUERTA,043,EL REBALSITO DE APAZULCO,3,108,52,56,6
JALISCO,14,LA HUERTA,043,EMILIANO ZAPATA,5,357,182,175,19
JALISCO,14,LA HUERTA,043,FRANCISCO VILLA,1,16,8,8,1
JALISCO,14,LA HUERTA,043,JUAN GIL PRECIADO,3,71,34,37,5
JALISCO,14,LA HUERTA,043,LA CONCEPCIÓN (LA CONCHA),3,270,119,151,21
JALISCO,14,LA HUERTA,043,LA CONCHITA,2,113,57,56,5
JALISCO,14,LA HUERTA,043,LA HUERTA,18,2631,1386,1245,207
JALISCO,14,LA HUERTA,043,LA MANZANILLA,4,396,185,211,21
JALISCO,14,LA HUERTA,043,LA MESA,3,43,23,20,4
JALISCO,14,LA HUERTA,043,LA ROSA,1,8,4,4,1
JALISCO,14,LA HUERTA,043,LAS PILAS,3,29,11,18,4
JALISCO,14,LA HUERTA,043,LOMA ALTA,2,18,10,8,2
JALISCO,14,LA HUERTA,043,LOS ÁRBOLES,2,36,14,22,3
JALISCO,14,LA HUERTA,043,LOS BAÑOS,3,7,3,4,2
JALISCO,14,LA HUERTA,043,LOS RANCHITOS,2,13,8,5,2
JALISCO,14,LA HUERTA,043,MANUEL ÁVILA CAMACHO,2,8,1,7,1
JALISCO,14,LA HUERTA,043,MAZATÁN,2,19,11,8,3
JALISCO,14,LA HUERTA,043,MORELOS (EL LIMONCITO),1,3,1,2,1
JALISCO,14,LA HUERTA,043,NACASTILLO,3,24,14,10,3
JALISCO,14,LA HUERTA,043,NORBERTO AGUIRRE PALANCARES,3,31,19,12,3
JALISCO,14,LA HUERTA,043,NUEVO MIGUEL HIDALGO,3,402,205,197,27
JALISCO,14,LA HUERTA,043,PÉRULA,4,327,163,164,20
JALISCO,14,LA HUERTA,043,PLAZOLA,2,18,6,12,2
JALISCO,14,LA HUERTA,043,QUÉMARO,1,11,5,6,1
JALISCO,14,LA HUERTA,043,SAN MATEO,3,253,137,116,13
JALISCO,14,LA HUERTA,043,TECUASTITÁN,2,19,10,9,2
JALISCO,14,IXTLAHUACÁN DE LOS MEMBRILLOS,044,ATEQUIZA,7,1837,1017,820,102
JALISCO,14,IXTLAHUACÁN DE LOS MEMBRILLOS,044,BUENAVISTA,3,422,196,226,28
JALISCO,14,IXTLAHUACÁN DE LOS MEMBRILLOS,044,EL RODEO,5,706,347,359,26
JALISCO,14,IXTLAHUACÁN DE LOS MEMBRILLOS,044,EL SACRIFICIO,2,51,26,25,3
JALISCO,14,IXTLAHUACÁN DE LOS MEMBRILLOS,044,HUERTA VIEJA [FRACCIONAMIENTO],4,666,339,327,23
JALISCO,14,IXTLAHUACÁN DE LOS MEMBRILLOS,044,IXTLAHUACÁN DE LOS MEMBRILLOS,13,2896,1494,1402,138
JALISCO,14,IXTLAHUACÁN DE LOS MEMBRILLOS,044,LA CAÑADA,2,67,35,32,4
JALISCO,14,IXTLAHUACÁN DE LOS MEMBRILLOS,044,LA CAPILLA DEL REFUGIO,39,9664,4841,4823,423
JALISCO,14,IXTLAHUACÁN DE LOS MEMBRILLOS,044,LOMAS DE ATEQUIZA,3,930,477,453,36
JALISCO,14,IXTLAHUACÁN DE LOS MEMBRILLOS,044,LOS CEDROS,5,603,326,277,23
JALISCO,14,IXTLAHUACÁN DE LOS MEMBRILLOS,044,LOS OLIVOS,1,110,48,62,6
JALISCO,14,IXTLAHUACÁN DE LOS MEMBRILLOS,044,PUERTA DEL SOL [FRACCIONAMIENTO],2,328,177,151,11
JALISCO,14,IXTLAHUACÁN DE LOS MEMBRILLOS,044,SANTA ROSA (LA HACIENDA DE SANTA ROSA),2,241,109,132,11
JALISCO,14,IXTLAHUACÁN DEL RÍO,045,AGUA COLORADA,2,32,11,21,3
JALISCO,14,IXTLAHUACÁN DEL RÍO,045,AGUA PRIETA,2,14,5,9,2
JALISCO,14,IXTLAHUACÁN DEL RÍO,045,AGUA RICA,2,31,17,14,4
JALISCO,14,IXTLAHUACÁN DEL RÍO,045,ÁNIMAS DE ROMERO,1,23,12,11,2
JALISCO,14,IXTLAHUACÁN DEL RÍO,045,CERRO ALTO,2,4,1,3,2
JALISCO,14,IXTLAHUACÁN DEL RÍO,045,CUYUTÁN DE ARRIBA,1,4,2,2,1
JALISCO,14,IXTLAHUACÁN DEL RÍO,045,EL ANCÓN,2,97,43,54,5
JALISCO,14,IXTLAHUACÁN DEL RÍO,045,EL CHILAR,3,51,29,22,4
JALISCO,14,IXTLAHUACÁN DEL RÍO,045,EL CHIVERO,1,7,2,5,1
JALISCO,14,IXTLAHUACÁN DEL RÍO,045,EL CONSUELO,3,54,20,34,4
JALISCO,14,IXTLAHUACÁN DEL RÍO,045,EL JAGÜEY,2,41,21,20,3
JALISCO,14,IXTLAHUACÁN DEL RÍO,045,EL JAGÜEYCITO,3,52,29,23,5
JALISCO,14,IXTLAHUACÁN DEL RÍO,045,EL PALOMAR,1,10,3,7,1
JALISCO,14,IXTLAHUACÁN DEL RÍO,045,EL PASO DE GUADALUPE,3,144,71,73,8
JALISCO,14,IXTLAHUACÁN DEL RÍO,045,EL PITAYITO,2,20,7,13,2
JALISCO,14,IXTLAHUACÁN DEL RÍO,045,EL RODEO,3,36,21,15,5
JALISCO,14,IXTLAHUACÁN DEL RÍO,045,EL SALVIAL,3,108,52,56,6
JALISCO,14,IXTLAHUACÁN DEL RÍO,045,HACIENDA DE GUADALUPE,2,20,10,10,2
JALISCO,14,IXTLAHUACÁN DEL RÍO,045,IXTLAHUACÁN DEL RÍO,15,2589,1321,1268,177
JALISCO,14,IXTLAHUACÁN DEL RÍO,045,LA CANTERA,2,38,16,22,3
JALISCO,14,IXTLAHUACÁN DEL RÍO,045,LA GARRUÑA,3,59,26,33,5
JALISCO,14,IXTLAHUACÁN DEL RÍO,045,LA HIGUERA,3,54,30,24,4
JALISCO,14,IXTLAHUACÁN DEL RÍO,045,LA LOMA,3,40,25,15,4
JALISCO,14,IXTLAHUACÁN DEL RÍO,045,LA PEÑA (LA PEÑA DE SAN RAFAEL),2,26,14,12,3
JALISCO,14,IXTLAHUACÁN DEL RÍO,045,LA TORTUGA,1,11,7,4,2
JALISCO,14,IXTLAHUACÁN DEL RÍO,045,LAGUNILLAS,2,18,8,10,3
JALISCO,14,IXTLAHUACÁN DEL RÍO,045,LAS TRANCAS,3,60,28,32,5
JALISCO,14,IXTLAHUACÁN DEL RÍO,045,LOS CHILARES,1,3,1,2,1
JALISCO,14,IXTLAHUACÁN DEL RÍO,045,LOS COLOMOS,2,25,13,12,3
JALISCO,14,IXTLAHUACÁN DEL RÍO,045,LOS PUENTES,3,110,53,57,6
JALISCO,14,IXTLAHUACÁN DEL RÍO,045,LOS VENEROS (EL AGUACATE),2,8,3,5,2
JALISCO,14,IXTLAHUACÁN DEL RÍO,045,MASCUALA,3,219,119,100,12
JALISCO,14,IXTLAHUACÁN DEL RÍO,045,MESA DE TORRES,1,3,2,1,1
JALISCO,14,IXTLAHUACÁN DEL RÍO,045,OCOTENGO,2,16,8,8,2
JALISCO,14,IXTLAHUACÁN DEL RÍO,045,PALOS ALTOS,3,240,117,123,11
JALISCO,14,IXTLAHUACÁN DEL RÍO,045,POTRERO DE SAN SEBASTIÁN (POTRERO DE LAS YEGUAS),2,16,7,9,2
JALISCO,14,IXTLAHUACÁN DEL RÍO,045,QUELITÁN,3,55,29,26,5
JALISCO,14,IXTLAHUACÁN DEL RÍO,045,RANCHO EL SALTO,2,7,4,3,1
JALISCO,14,IXTLAHUACÁN DEL RÍO,045,RUELAS,2,34,19,15,4
JALISCO,14,IXTLAHUACÁN DEL RÍO,045,SAN ANTONIO DE LOS VÁZQUEZ,5,497,243,254,30
JALISCO,14,IXTLAHUACÁN DEL RÍO,045,SAN CAYETANO,2,7,1,6,1
JALISCO,14,IXTLAHUACÁN DEL RÍO,045,SAN JOSÉ DE BUENAVISTA,3,63,29,34,5
JALISCO,14,IXTLAHUACÁN DEL RÍO,045,SAN MIGUEL DE ABAJO,3,118,58,60,7
JALISCO,14,IXTLAHUACÁN DEL RÍO,045,SAN NICOLÁS DE LOS ABUNDIS,2,53,27,26,4
JALISCO,14,IXTLAHUACÁN DEL RÍO,045,TACOTLÁN,3,101,56,45,8
JALISCO,14,IXTLAHUACÁN DEL RÍO,045,TEPACA,3,16,12,4,2
JALISCO,14,IXTLAHUACÁN DEL RÍO,045,TESCATITÁN,2,36,19,17,3
JALISCO,14,IXTLAHUACÁN DEL RÍO,045,TREJOS,4,275,144,131,12
JALISCO,14,JALOSTOTITLÁN,046,APOZOLCO,2,17,10,7,3
JALISCO,14,JALOSTOTITLÁN,046,CAPELLANÍA,1,6,4,2,1
JALISCO,14,JALOSTOTITLÁN,046,CERCA BLANCA (LOS CAMACHOS),1,18,7,11,1
JALISCO,14,JALOSTOTITLÁN,046,CERRO BLANCO DE FÁTIMA,1,9,4,5,1
JALISCO,14,JALOSTOTITLÁN,046,COCA (LA ASUNCIÓN),2,7,5,2,1
JALISCO,14,JALOSTOTITLÁN,046,EL ALTO DE SAN JOAQUÍN,3,47,28,19,4
JALISCO,14,JALOSTOTITLÁN,046,EL HUIZACHAL (EL CRUCERO),1,6,3,3,1
JALISCO,14,JALOSTOTITLÁN,046,EL PEDREGAL,2,12,6,6,2
JALISCO,14,JALOSTOTITLÁN,046,EL RIALENGO,2,24,11,13,2
JALISCO,14,JALOSTOTITLÁN,046,JALOSTOTITLÁN,38,6800,3430,3370,428
JALISCO,14,JALOSTOTITLÁN,046,LA ESTANCIA DE ARRIBA,2,8,2,6,1
JALISCO,14,JALOSTOTITLÁN,046,LA LABOR,2,7,2,5,2
JALISCO,14,JALOSTOTITLÁN,046,LA LAGUNA,2,32,12,20,3
JALISCO,14,JALOSTOTITLÁN,046,LA LAJA,1,66,35,31,3
JALISCO,14,JALOSTOTITLÁN,046,LA PARADA,1,7,1,6,1
JALISCO,14,JALOSTOTITLÁN,046,LA SOLEDAD,1,13,7,6,1
JALISCO,14,JALOSTOTITLÁN,046,LABOR DE ABALSA,3,175,77,98,7
JALISCO,14,JALOSTOTITLÁN,046,LAS CAÑADAS (CAÑADAS DE DELGADILLO),3,31,14,17,3
JALISCO,14,JALOSTOTITLÁN,046,LAS PALMAS,1,13,7,6,1
JALISCO,14,JALOSTOTITLÁN,046,LAS TORTUGAS,1,15,9,6,1
JALISCO,14,JALOSTOTITLÁN,046,LOMA DE SAN ANTONIO,1,7,4,3,1
JALISCO,14,JALOSTOTITLÁN,046,LOS PLANES,2,26,15,11,2
JALISCO,14,JALOSTOTITLÁN,046,LOS PORTALES DE ABAJO,2,24,10,14,3
JALISCO,14,JALOSTOTITLÁN,046,LOS PORTALES DE ARRIBA,2,38,21,17,2
JALISCO,14,JALOSTOTITLÁN,046,MESA DE TEOCALTITÁN,1,6,4,2,1
JALISCO,14,JALOSTOTITLÁN,046,MITIC (MITI),2,10,4,6,2
JALISCO,14,JALOSTOTITLÁN,046,MONTE LARGO (LA LAGUNA),1,4,1,3,1
JALISCO,14,JALOSTOTITLÁN,046,POTRERILLOS,3,68,35,33,5
JALISCO,14,JALOSTOTITLÁN,046,RANCHO VIEJO,2,23,14,9,3
JALISCO,14,JALOSTOTITLÁN,046,SAN GASPAR DE LOS REYES (SAN GASPAR),4,218,109,109,15
JALISCO,14,JALOSTOTITLÁN,046,SAN ISIDRO,3,33,18,15,4
JALISCO,14,JALOSTOTITLÁN,046,SAN NICOLÁS DE LAS FLORES,3,65,34,31,6
JALISCO,14,JALOSTOTITLÁN,046,SANTA ANA DE GUADALUPE,3,118,61,57,7
JALISCO,14,JALOSTOTITLÁN,046,SANTA ISABEL,2,25,14,11,2
JALISCO,14,JALOSTOTITLÁN,046,SANTA MARÍA DE LA O,3,36,20,16,4
JALISCO,14,JALOSTOTITLÁN,046,SANTA MARTHA (LOS CAÑOS),3,63,24,39,4
JALISCO,14,JALOSTOTITLÁN,046,TEOCALTITÁN DE GUADALUPE,3,362,171,191,14
JALISCO,14,JALOSTOTITLÁN,046,TIERRAS BLANCAS,1,35,20,15,2
JALISCO,14,JAMAY,047,JAMAY,20,4336,2207,2129,203
JALISCO,14,JAMAY,047,LA MALTARAÑA (LA PALMITA),3,119,54,65,8
JALISCO,14,JAMAY,047,LOS CAPULINES,2,140,77,63,7
JALISCO,14,JAMAY,047,SAN AGUSTÍN,5,555,257,298,26
JALISCO,14,JAMAY,047,SAN MIGUEL DE LA PAZ,5,723,348,375,30
JALISCO,14,JESÚS MARÍA,048,ALLENDE (JOSEFINO DE ALLENDE),5,534,275,259,37
JALISCO,14,JESÚS MARÍA,048,AYO EL GRANDE,3,75,39,36,6
JALISCO,14,JESÚS MARÍA,048,BARRANQUILLA DEL AGUA,2,21,11,10,2
JALISCO,14,JESÚS MARÍA,048,BUENAVISTA DE ROMO,2,23,11,12,2
JALISCO,14,JESÚS MARÍA,048,CIÉNEGA DE GALVANES (CIÉNEGA DE REYES),2,33,13,20,2
JALISCO,14,JESÚS MARÍA,048,EL AMARRADERO,3,43,24,19,4
JALISCO,14,JESÚS MARÍA,048,EL CAPULÍN DE CHÁVEZ,1,5,0,5,1
JALISCO,14,JESÚS MARÍA,048,EL CENTRO,1,9,3,6,1
JALISCO,14,JESÚS MARÍA,048,EL OCOTE,2,35,15,20,3
JALISCO,14,JESÚS MARÍA,048,EL PANTANO,1,4,1,3,1
JALISCO,14,JESÚS MARÍA,048,EL ZAPOTE,1,11,3,8,1
JALISCO,14,JESÚS MARÍA,048,GUANAJUATILLO,1,11,7,4,1
JALISCO,14,JESÚS MARÍA,048,JESÚS MARÍA,15,2318,1227,1091,116
JALISCO,14,JESÚS MARÍA,048,LA ATARJEA,3,107,63,44,7
JALISCO,14,JESÚS MARÍA,048,LA BETULIA,3,37,21,16,3
JALISCO,14,JESÚS MARÍA,048,LA LEONERA,2,53,22,31,4
JALISCO,14,JESÚS MARÍA,048,LA SIERRITA,3,68,33,35,4
JALISCO,14,JESÚS MARÍA,048,LA TIJERA,2,31,16,15,3
JALISCO,14,JESÚS MARÍA,048,LAS CRUCES,1,27,12,15,2
JALISCO,14,JESÚS MARÍA,048,LAS LAGUNAS,3,47,28,19,4
JALISCO,14,JESÚS MARÍA,048,LAS PILAS,1,3,1,2,1
JALISCO,14,JESÚS MARÍA,048,LAS POMAS (LAS PÓMEZ),3,48,29,19,3
JALISCO,14,JESÚS MARÍA,048,LAS RAÍCES,2,27,10,17,3
JALISCO,14,JESÚS MARÍA,048,LOMA DE SAN MIGUEL,1,27,9,18,2
JALISCO,14,JESÚS MARÍA,048,LOS NOGALES,3,38,20,18,3
JALISCO,14,JESÚS MARÍA,048,LOS ROBLES,2,120,63,57,8
JALISCO,14,JESÚS MARÍA,048,NAZARETH,2,37,20,17,3
JALISCO,14,JESÚS MARÍA,048,OJO ZARCO DE FUENTES,3,75,39,36,5
JALISCO,14,JESÚS MARÍA,048,PALO CAÍDO,2,20,11,9,2
JALISCO,14,JESÚS MARÍA,048,PUERTA DE LA CARRETA,2,50,20,30,4
JALISCO,14,JESÚS MARÍA,048,ROSALES,3,66,36,30,5
JALISCO,14,JESÚS MARÍA,048,SAN AGUSTÍN,1,21,14,7,1
JALISCO,14,JESÚS MARÍA,048,SAN JOSÉ DE LA PAZ,4,309,169,140,18
JALISCO,14,JESÚS MARÍA,048,SAN JOSÉ DE LAS PILAS,2,17,4,13,2
JALISCO,14,JESÚS MARÍA,048,SAN MIGUEL DE LA TRINIDAD,1,11,4,7,1
JALISCO,14,JESÚS MARÍA,048,SAN MIGUEL DE LA UNIÓN,2,18,5,13,2
JALISCO,14,JESÚS MARÍA,048,SAN RAFAEL,1,12,10,2,1
JALISCO,14,JESÚS MARÍA,048,SAN RAFAEL DE LAGUNA,1,18,7,11,1
JALISCO,14,JESÚS MARÍA,048,SAN VICENTE,1,8,1,7,1
JALISCO,14,JILOTLÁN DE LOS DOLORES,049,CALDERAS DE VARGAS,1,4,1,3,1
JALISCO,14,JILOTLÁN DE LOS DOLORES,049,CANCHOL,2,15,7,8,2
JALISCO,14,JILOTLÁN DE LOS DOLORES,049,EL ARENAL,1,2,2,0,1
JALISCO,14,JILOTLÁN DE LOS DOLORES,049,EL CERRITO,2,51,33,18,5
JALISCO,14,JILOTLÁN DE LOS DOLORES,049,EL EMPEDRADO,3,8,5,3,2
JALISCO,14,JILOTLÁN DE LOS DOLORES,049,EL LIMONCITO,2,20,12,8,2
JALISCO,14,JILOTLÁN DE LOS DOLORES,049,EL RANCHITO,2,4,2,2,1
JALISCO,14,JILOTLÁN DE LOS DOLORES,049,EL RIÍTO,3,10,5,5,2
JALISCO,14,JILOTLÁN DE LOS DOLORES,049,EL RINCÓN,3,26,15,11,3
JALISCO,14,JILOTLÁN DE LOS DOLORES,049,EL RODEO,3,61,32,29,5
JALISCO,14,JILOTLÁN DE LOS DOLORES,049,EL SOYATAL,3,30,15,15,4
JALISCO,14,JILOTLÁN DE LOS DOLORES,049,EL TERRERO,3,55,34,21,4
JALISCO,14,JILOTLÁN DE LOS DOLORES,049,GALERAS BLANCAS,3,6,1,5,3
JALISCO,14,JILOTLÁN DE LOS DOLORES,049,GALLARDO,1,5,3,2,1
JALISCO,14,JILOTLÁN DE LOS DOLORES,049,HUAPALA,3,33,21,12,3
JALISCO,14,JILOTLÁN DE LOS DOLORES,049,HUICHITILA,3,39,22,17,3
JALISCO,14,JILOTLÁN DE LOS DOLORES,049,JILOTLÁN DE LOS DOLORES,5,618,324,294,35
JALISCO,14,JILOTLÁN DE LOS DOLORES,049,LA MINITA,3,16,4,12,3
JALISCO,14,JILOTLÁN DE LOS DOLORES,049,LA MORA,3,9,3,6,2
JALISCO,14,JILOTLÁN DE LOS DOLORES,049,LA PAROTA,2,10,5,5,2
JALISCO,14,JILOTLÁN DE LOS DOLORES,049,LA TEPEGUAJERA,2,8,4,4,1
JALISCO,14,JILOTLÁN DE LOS DOLORES,049,LAGUNILLA (EL CAPULÍN),1,6,4,2,1
JALISCO,14,JILOTLÁN DE LOS DOLORES,049,LAS HIGUERAS,3,24,12,12,3
JALISCO,14,JILOTLÁN DE LOS DOLORES,049,LAS HIGUERILLAS,3,11,7,4,2
JALISCO,14,JILOTLÁN DE LOS DOLORES,049,LAS NUECES,3,26,10,16,3
JALISCO,14,JILOTLÁN DE LOS DOLORES,049,LIMONCITO DE CASTREJÓN (EL LIMONCITO),2,3,2,1,1
JALISCO,14,JILOTLÁN DE LOS DOLORES,049,LOS ALMÁCIGOS,3,14,7,7,2
JALISCO,14,JILOTLÁN DE LOS DOLORES,049,LOS NOGALES,2,10,2,8,2
JALISCO,14,JILOTLÁN DE LOS DOLORES,049,PLAYA DEL ARROZ,1,9,5,4,1
JALISCO,14,JILOTLÁN DE LOS DOLORES,049,PRESA CONSTITUCIÓN DE APATZINGÁN,3,35,23,12,4
JALISCO,14,JILOTLÁN DE LOS DOLORES,049,RANCHO NUEVO (EL MURCIÉLAGO),3,107,61,46,8
JALISCO,14,JILOTLÁN DE LOS DOLORES,049,RANCHO VIEJO,2,19,11,8,2
JALISCO,14,JILOTLÁN DE LOS DOLORES,049,SAN FRANCISCO,3,56,34,22,5
JALISCO,14,JILOTLÁN DE LOS DOLORES,049,SAYULAPAN (SAYOLAPA),3,10,4,6,2
JALISCO,14,JILOTLÁN DE LOS DOLORES,049,TANDIGUÁN,3,33,16,17,4
JALISCO,14,JILOTLÁN DE LOS DOLORES,049,TAZUMBOS,3,258,135,123,11
JALISCO,14,JILOTLÁN DE LOS DOLORES,049,VILLA DOCTOR GÓMEZ (LAS LOMAS),2,86,42,44,8
JALISCO,14,JOCOTEPEC,050,CHANTEPEC (EL CHANTE),4,530,275,255,21
JALISCO,14,JOCOTEPEC,050,EL MOLINO,3,470,237,233,22
JALISCO,14,JOCOTEPEC,050,EL SALITRE (VILLA LEAL),2,6,3,3,1
JALISCO,14,JOCOTEPEC,050,EL SAUZ,2,41,16,25,3
JALISCO,14,JOCOTEPEC,050,HUEJOTITÁN,3,220,90,130,11
JALISCO,14,JOCOTEPEC,050,JOCOTEPEC,35,6818,3549,3269,421
JALISCO,14,JOCOTEPEC,050,LAS TROJES,3,151,76,75,9
JALISCO,14,JOCOTEPEC,050,POTRERILLOS,3,381,180,201,17
JALISCO,14,JOCOTEPEC,050,SAN CRISTÓBAL ZAPOTITLÁN,3,670,313,357,31
JALISCO,14,JOCOTEPEC,050,SAN JUAN COSALÁ,8,1780,920,860,72
JALISCO,14,JOCOTEPEC,050,SAN LUCIANO,2,48,27,21,3
JALISCO,14,JOCOTEPEC,050,SAN PEDRO TESISTÁN,2,195,101,94,7
JALISCO,14,JOCOTEPEC,050,ZAPOTITÁN DE HIDALGO,4,823,409,414,33
JALISCO,14,JUANACATLÁN,051,CASA DE TEJA,2,62,28,34,3
JALISCO,14,JUANACATLÁN,051,EX-HACIENDA DE ZAPOTLANEJO,3,354,170,184,14
JALISCO,14,JUANACATLÁN,051,JUANACATLÁN,17,3851,1793,2058,333
JALISCO,14,JUANACATLÁN,051,LA AURORA,11,3324,1636,1688,133
JALISCO,14,JUANACATLÁN,051,MIRAFLORES,2,84,48,36,4
JALISCO,14,JUANACATLÁN,051,RANCHO NUEVO (ESTANCIA DE GUADALUPE),2,38,19,19,3
JALISCO,14,JUANACATLÁN,051,SAN ANTONIO JUANACAXTLE,4,316,150,166,22
JALISCO,14,JUANACATLÁN,051,SAN ISIDRO (EL JABALÍ),2,73,25,48,4
JALISCO,14,JUCHITLÁN,052,AGUA ESCONDIDA,2,57,35,22,3
JALISCO,14,JUCHITLÁN,052,JUCHITLÁN,10,1064,544,520,56
JALISCO,14,JUCHITLÁN,052,LA TINAJA,2,20,11,9,2
JALISCO,14,JUCHITLÁN,052,LAS JUNTAS,1,8,5,3,1
JALISCO,14,JUCHITLÁN,052,LOS CORRALES (VILLA DE GUADALUPE),2,50,26,24,4
JALISCO,14,JUCHITLÁN,052,LOS GUAJES,4,303,165,138,20
JALISCO,14,JUCHITLÁN,052,RANCHO VIEJO,2,21,9,12,2
JALISCO,14,JUCHITLÁN,052,SANTA MARÍA,2,47,23,24,3
JALISCO,14,JUCHITLÁN,052,TAMAZULA,3,20,8,12,3
JALISCO,14,LAGOS DE MORENO,053,BAJÍO DE ÁLVAREZ,1,23,13,10,2
JALISCO,14,LAGOS DE MORENO,053,BERNALEJO,2,44,21,23,3
JALISCO,14,LAGOS DE MORENO,053,BERNALEJO (COMANJA),3,28,10,18,3
JALISCO,14,LAGOS DE MORENO,053,BETULIA,6,1145,598,547,65
JALISCO,14,LAGOS DE MORENO,053,BUENAVISTA (SAN MIGUEL),4,458,229,229,20
JALISCO,14,LAGOS DE MORENO,053,CANOAS,3,82,39,43,6
JALISCO,14,LAGOS DE MORENO,053,CHAYOTILLO,3,41,19,22,4
JALISCO,14,LAGOS DE MORENO,053,CHIPINQUE DE ARRIBA,4,667,314,353,28
JALISCO,14,LAGOS DE MORENO,053,CIUDAD MADERAS (LA VENTA),5,75,38,37,7
JALISCO,14,LAGOS DE MORENO,053,COMANJA DE CORONA,5,499,253,246,21
JALISCO,14,LAGOS DE MORENO,053,CUAUTITLÁN,2,123,55,68,7
JALISCO,14,LAGOS DE MORENO,053,DIECIOCHO DE MARZO,3,426,214,212,18
JALISCO,14,LAGOS DE MORENO,053,EL ARENAL,1,42,17,25,2
JALISCO,14,LAGOS DE MORENO,053,EL BAJÍO (LA LAGUNA),3,454,228,226,22
JALISCO,14,LAGOS DE MORENO,053,EL CAJÓN DE ABAJO,2,5,3,2,2
JALISCO,14,LAGOS DE MORENO,053,EL CERRITO (CERRITOS),2,86,46,40,5
JALISCO,14,LAGOS DE MORENO,053,EL CIRCO,2,38,17,21,2
JALISCO,14,LAGOS DE MORENO,053,EL CONEJO,2,67,32,35,3
JALISCO,14,LAGOS DE MORENO,053,EL IXTLE,2,41,23,18,3
JALISCO,14,LAGOS DE MORENO,053,EL JARALITO,3,75,32,43,6
JALISCO,14,LAGOS DE MORENO,053,EL MESONCITO,3,104,37,67,6
JALISCO,14,LAGOS DE MORENO,053,EL MOSCO,2,18,5,13,2
JALISCO,14,LAGOS DE MORENO,053,EL OJUELO,5,385,180,205,19
JALISCO,14,LAGOS DE MORENO,053,EL POSIRÓN,3,26,14,12,2
JALISCO,14,LAGOS DE MORENO,053,EL PUESTO,4,422,184,238,22
JALISCO,14,LAGOS DE MORENO,053,EL RANCHITO,1,26,18,8,2
JALISCO,14,LAGOS DE MORENO,053,EL REFUGIO (EL MAGUEY),3,195,88,107,11
JALISCO,14,LAGOS DE MORENO,053,EL REPARO,2,37,20,17,3
JALISCO,14,LAGOS DE MORENO,053,EL SITIO,2,78,45,33,4
JALISCO,14,LAGOS DE MORENO,053,EL SOYATE,2,16,7,9,2
JALISCO,14,LAGOS DE MORENO,053,EL TERRERO,3,8,4,4,3
JALISCO,14,LAGOS DE MORENO,053,EL TORREÓN,2,70,38,32,4
JALISCO,14,LAGOS DE MORENO,053,FRANCISCO PRIMO DE VERDAD (CIÉNEGA DE MATA),4,263,121,142,14
JALISCO,14,LAGOS DE MORENO,053,GEOVILLAS LAURELES DEL CAMPANARIO,2,559,290,269,16
JALISCO,14,LAGOS DE MORENO,053,GRANADILLAS (LA COLONIA),2,231,120,111,8
JALISCO,14,LAGOS DE MORENO,053,JARAMILLO DE ABAJO,3,29,19,10,3
JALISCO,14,LAGOS DE MORENO,053,JARITAS,3,89,43,46,6
JALISCO,14,LAGOS DE MORENO,053,LA ARRONERA,2,6,6,0,2
JALISCO,14,LAGOS DE MORENO,053,LA ASUNCIÓN,1,13,6,7,1
JALISCO,14,LAGOS DE MORENO,053,LA CANTERA (LA CANTERA DE LOS MORENO),3,150,80,70,9
JALISCO,14,LAGOS DE MORENO,053,LA ERMITA,2,5,2,3,1
JALISCO,14,LAGOS DE MORENO,053,LA ESCONDIDA,3,56,26,30,5
JALISCO,14,LAGOS DE MORENO,053,LA ESTANCIA,3,4,2,2,2
JALISCO,14,LAGOS DE MORENO,053,LA ISLA,2,108,56,52,5
JALISCO,14,LAGOS DE MORENO,053,LA LADERA,3,40,20,20,3
JALISCO,14,LAGOS DE MORENO,053,LA MERCED (LA CHONA),3,130,73,57,9
JALISCO,14,LAGOS DE MORENO,053,LA ORILLA DEL AGUA,3,390,206,184,22
JALISCO,14,LAGOS DE MORENO,053,LA PALMA,2,68,35,33,5
JALISCO,14,LAGOS DE MORENO,053,LA PALMITA,1,45,26,19,2
JALISCO,14,LAGOS DE MORENO,053,LA PUNTA,2,95,46,49,6
JALISCO,14,LAGOS DE MORENO,053,LA SAUCEDA (PEDRO MORENO),2,35,15,20,2
JALISCO,14,LAGOS DE MORENO,053,LA SILLETA,2,6,2,4,1
JALISCO,14,LAGOS DE MORENO,053,LA TROJE (LAS TROJES),1,32,18,14,2
JALISCO,14,LAGOS DE MORENO,053,LA TROJE (LOS NOGALES),2,148,60,88,9
JALISCO,14,LAGOS DE MORENO,053,LA VIRGEN,3,128,54,74,8
JALISCO,14,LAGOS DE MORENO,053,LAGOS DE MORENO,167,33209,17060,16149,2150
JALISCO,14,LAGOS DE MORENO,053,LAS ALFALFAS,1,10,5,5,1
JALISCO,14,LAGOS DE MORENO,053,LAS CRUCES,3,269,133,136,14
JALISCO,14,LAGOS DE MORENO,053,LAS CRUCITAS,2,52,29,23,3
JALISCO,14,LAGOS DE MORENO,053,LAS HUERTAS,3,24,17,7,3
JALISCO,14,LAGOS DE MORENO,053,LAS MANGAS,2,27,12,15,3
JALISCO,14,LAGOS DE MORENO,053,LAS PALOMAS,3,98,56,42,8
JALISCO,14,LAGOS DE MORENO,053,LEDESMA,2,57,31,26,4
JALISCO,14,LAGOS DE MORENO,053,LO DE ÁVALOS,3,18,11,7,2
JALISCO,14,LAGOS DE MORENO,053,LOMA DE AMAPOLA,1,16,9,7,1
JALISCO,14,LAGOS DE MORENO,053,LOMA DE MENA,1,25,11,14,2
JALISCO,14,LAGOS DE MORENO,053,LOMA DE SAN ANTONIO,1,12,3,9,1
JALISCO,14,LAGOS DE MORENO,053,LOMA DE VELOCES,2,62,27,35,4
JALISCO,14,LAGOS DE MORENO,053,LOS ALAMBRES (EJIDO SANTA ELENA),3,55,25,30,4
JALISCO,14,LAGOS DE MORENO,053,LOS AZULITOS,5,754,374,380,30
JALISCO,14,LAGOS DE MORENO,053,LOS CERRITOS,2,11,4,7,1
JALISCO,14,LAGOS DE MORENO,053,MATAMOROS LOS HOYOS,3,149,68,81,9
JALISCO,14,LAGOS DE MORENO,053,MIRANDA DEL REFUGIO,3,40,16,24,4
JALISCO,14,LAGOS DE MORENO,053,PASO DE CUARENTA (SAN MIGUEL DE CUARENTA),7,1135,567,568,61
JALISCO,14,LAGOS DE MORENO,053,PASO DE LA MESA,2,53,25,28,3
JALISCO,14,LAGOS DE MORENO,053,PLAN DE LOS RODRÍGUEZ,2,187,90,97,8
JALISCO,14,LAGOS DE MORENO,053,PORTEZUELOS DE GONZÁLEZ (EL ZAPOTE),2,6,2,4,1
JALISCO,14,LAGOS DE MORENO,053,PRIMERO DE MAYO (CHUPADEROS),4,348,173,175,18
JALISCO,14,LAGOS DE MORENO,053,PUERTA DEL LLANO,1,16,10,6,2
JALISCO,14,LAGOS DE MORENO,053,PUERTA DEL ZAPOTE,2,5,1,4,2
JALISCO,14,LAGOS DE MORENO,053,PUERTA LA CHIRIPA (LA PASCUALA),2,78,39,39,4
JALISCO,14,LAGOS DE MORENO,053,PUERTO DEL CUARENTA,2,5,0,5,1
JALISCO,14,LAGOS DE MORENO,053,QUINTA SAN FRANCISCO,1,66,23,43,3
JALISCO,14,LAGOS DE MORENO,053,RANCHO NUEVO,2,32,14,18,3
JALISCO,14,LAGOS DE MORENO,053,SABINO,3,207,116,91,8
JALISCO,14,LAGOS DE MORENO,053,SALSIPUEDES (EL PUERTO),2,17,9,8,2
JALISCO,14,LAGOS DE MORENO,053,SAN AGUSTÍN (SAN AGUSTÍN DE LOS ROMANES),1,1371,550,821,104
JALISCO,14,LAGOS DE MORENO,053,SAN ANTONIO DE BUENAVISTA,3,163,85,78,8
JALISCO,14,LAGOS DE MORENO,053,SAN CRISTÓBAL,4,329,167,162,15
JALISCO,14,LAGOS DE MORENO,053,SAN ISIDRO DE ABAJO,2,206,106,100,9
JALISCO,14,LAGOS DE MORENO,053,SAN ISIDRO DE ARRIBA,1,198,102,96,6
JALISCO,14,LAGOS DE MORENO,053,SAN ISIDRO EL ALTO,3,7,0,7,2
JALISCO,14,LAGOS DE MORENO,053,SAN JORGE (MACEDONIO AYALA),3,272,138,134,12
JALISCO,14,LAGOS DE MORENO,053,SAN LUIS GONZAGA,1,13,8,5,1
JALISCO,14,LAGOS DE MORENO,053,SAN PABLO DE NAZAS,1,34,11,23,2
JALISCO,14,LAGOS DE MORENO,053,SAN RAFAEL,3,7,3,4,2
JALISCO,14,LAGOS DE MORENO,053,SANFANDILA,2,36,18,18,3
JALISCO,14,LAGOS DE MORENO,053,SANTA INÉS,4,83,35,48,9
JALISCO,14,LAGOS DE MORENO,053,SANTA MARÍA DE GALLARDO,2,15,5,10,2
JALISCO,14,LAGOS DE MORENO,053,SANTA TERESA,1,12,1,11,1
JALISCO,14,LAGOS DE MORENO,053,TACUBAYA,3,246,119,127,12
JALISCO,14,LAGOS DE MORENO,053,TORRECILLAS (EL LINDERO),3,251,125,126,9
JALISCO,14,EL LIMÓN,054,EL LIMÓN,7,738,381,357,67
JALISCO,14,EL LIMÓN,054,EL PALMAR DE SAN ANTONIO,3,27,17,10,3
JALISCO,14,EL LIMÓN,054,LA CIÉNEGA,3,196,101,95,12
JALISCO,14,EL LIMÓN,054,SAN BUENAVENTURA,3,47,26,21,5
JALISCO,14,EL LIMÓN,054,SAN JUAN DE AMULA,4,108,55,53,9
JALISCO,14,EL LIMÓN,054,SAN MIGUEL HIDALGO,3,76,43,33,7
JALISCO,14,MAGDALENA,055,LA JOYA,4,264,128,136,15
JALISCO,14,MAGDALENA,055,LA QUEMADA,4,315,166,149,18
JALISCO,14,MAGDALENA,055,LO DE GUEVARA (LA LOMA),2,72,40,32,3
JALISCO,14,MAGDALENA,055,MAGDALENA,29,5146,2678,2468,269
JALISCO,14,MAGDALENA,055,OJO ZARCO,2,42,28,14,3
JALISCO,14,MAGDALENA,055,SAN ANDRÉS,5,463,210,253,24
JALISCO,14,MAGDALENA,055,SAN SIMÓN,3,134,70,64,6
JALISCO,14,MAGDALENA,055,SANTA MARÍA,2,27,14,13,3
JALISCO,14,SANTA MARÍA DEL ORO,056,EL HUESO,2,6,4,2,1
JALISCO,14,SANTA MARÍA DEL ORO,056,LA AURORA (EL REPARO),2,8,3,5,2
JALISCO,14,SANTA MARÍA DEL ORO,056,LA PLAZA,3,6,3,3,2
JALISCO,14,SANTA MARÍA DEL ORO,056,LA TROJA,3,9,7,2,3
JALISCO,14,SANTA MARÍA DEL ORO,056,LAS JUNTAS,2,7,4,3,1
JALISCO,14,SANTA MARÍA DEL ORO,056,LOS PANALES,1,12,4,8,1
JALISCO,14,SANTA MARÍA DEL ORO,056,LOS PLÁTANOS,1,14,4,10,1
JALISCO,14,SANTA MARÍA DEL ORO,056,PETACALA,1,15,10,5,1
JALISCO,14,SANTA MARÍA DEL ORO,056,PLAYA BONITA,3,5,1,4,2
JALISCO,14,SANTA MARÍA DEL ORO,056,SANTA MARÍA DEL ORO,4,218,126,92,11
JALISCO,14,SANTA MARÍA DEL ORO,056,ZIPOCO,1,2,0,2,1
JALISCO,14,LA MANZANILLA DE LA PAZ,057,EL AGUACATE (LA SABANILLA),3,4,1,3,2
JALISCO,14,LA MANZANILLA DE LA PAZ,057,LA MANZANILLA DE LA PAZ,8,880,441,439,51
JALISCO,14,LA MANZANILLA DE LA PAZ,057,LA TUNA,3,22,12,10,3
JALISCO,14,LA MANZANILLA DE LA PAZ,057,LAS CUEVAS,2,44,22,22,3
JALISCO,14,LA MANZANILLA DE LA PAZ,057,VILLA MORELOS,3,117,66,51,8
JALISCO,14,MASCOTA,058,CHANREY,3,285,158,127,39
JALISCO,14,MASCOTA,058,EL AGOSTADERO,2,10,4,6,2
JALISCO,14,MASCOTA,058,EL CIMARRÓN CHICO,2,18,9,9,2
JALISCO,14,MASCOTA,058,EL EMPEDRADO,1,28,11,17,2
JALISCO,14,MASCOTA,058,EL GALOPE,2,21,10,11,2
JALISCO,14,MASCOTA,058,EL JACAL,1,9,7,2,1
JALISCO,14,MASCOTA,058,EL RANCHITO,1,7,3,4,1
JALISCO,14,MASCOTA,058,GUAYABITOS,2,24,11,13,2
JALISCO,14,MASCOTA,058,JUANACATLÁN GRANDE (JUANACATLÁN),3,62,31,31,4
JALISCO,14,MASCOTA,058,LA CRUZ DE IGNACIO,3,21,11,10,3
JALISCO,14,MASCOTA,058,LA HUERTA DE MIRANDILLA (LA HUERTA),1,9,3,6,1
JALISCO,14,MASCOTA,058,LA MAJADA,1,56,32,24,3
JALISCO,14,MASCOTA,058,LA PALAPA,2,7,1,6,2
JALISCO,14,MASCOTA,058,LA PLATA,2,18,11,7,2
JALISCO,14,MASCOTA,058,LAS ÁNIMAS,1,5,2,3,1
JALISCO,14,MASCOTA,058,LAS MESAS,2,5,2,3,1
JALISCO,14,MASCOTA,058,LAS MORAS,1,7,1,6,1
JALISCO,14,MASCOTA,058,LOS CORRALES (SAN JOSÉ DE LOS CORRALES),2,11,8,3,2
JALISCO,14,MASCOTA,058,MALPASO,2,14,3,11,3
JALISCO,14,MASCOTA,058,MASCOTA,13,2466,1265,1201,184
JALISCO,14,MASCOTA,058,MIRANDILLA,2,26,12,14,2
JALISCO,14,MASCOTA,058,NAVIDAD,2,19,9,10,3
JALISCO,14,MASCOTA,058,PUERTA DE ENMEDIO,1,4,1,3,1
JALISCO,14,MASCOTA,058,RINCÓN DE MIRANDILLA,3,99,44,55,6
JALISCO,14,MASCOTA,058,SAN IGNACIO,2,25,15,10,3
JALISCO,14,MASCOTA,058,SAN JOSÉ DEL MOSCO (EL MOSCO),2,13,7,6,2
JALISCO,14,MASCOTA,058,SAN MIGUEL DE TOVAR,2,48,26,22,4
JALISCO,14,MASCOTA,058,SAN RAFAEL,3,16,9,7,3
JALISCO,14,MASCOTA,058,SANTA BÁRBARA,1,18,12,6,1
JALISCO,14,MASCOTA,058,SANTA ROSA,1,7,2,5,1
JALISCO,14,MASCOTA,058,TECOANY,2,44,24,20,3
JALISCO,14,MASCOTA,058,TIERRAS COLORADAS,2,20,8,12,2
JALISCO,14,MASCOTA,058,YERBABUENA,3,100,45,55,7
JALISCO,14,MASCOTA,058,ZACATONGO,3,64,40,24,6
JALISCO,14,MAZAMITLA,059,CORRAL DE LA MULA,2,8,4,4,1
JALISCO,14,MAZAMITLA,059,CORRAL FALSO,3,63,30,33,5
JALISCO,14,MAZAMITLA,059,DOS AGUAS,3,61,29,32,4
JALISCO,14,MAZAMITLA,059,EL COLORADO,2,10,5,5,1
JALISCO,14,MAZAMITLA,059,EL CORRAL DE MEJÍA,3,5,1,4,2
JALISCO,14,MAZAMITLA,059,EL FRESNAL,3,38,21,17,4
JALISCO,14,MAZAMITLA,059,EL HUMO (EL MARILLO),1,6,3,3,1
JALISCO,14,MAZAMITLA,059,EL LLANO DE LOS TOROS,2,45,26,19,3
JALISCO,14,MAZAMITLA,059,EL MEZCAL,2,7,4,3,1
JALISCO,14,MAZAMITLA,059,EL PAIZTLE,1,12,4,8,1
JALISCO,14,MAZAMITLA,059,EL TERRERO,2,19,11,8,2
JALISCO,14,MAZAMITLA,059,EPENCHE CHICO (PENCHE CHICO),2,153,77,76,8
JALISCO,14,MAZAMITLA,059,EPENCHE GRANDE (PENCHE GRANDE),2,46,28,18,3
JALISCO,14,MAZAMITLA,059,LA CENTRAL,2,36,23,13,3
JALISCO,14,MAZAMITLA,059,LA COFRADÍA,3,368,176,192,17
JALISCO,14,MAZAMITLA,059,LA ESTACADA,2,52,20,32,3
JALISCO,14,MAZAMITLA,059,LA HUEVERA,3,88,47,41,7
JALISCO,14,MAZAMITLA,059,LA LAGUNITA,3,19,11,8,3
JALISCO,14,MAZAMITLA,059,LA MARAVILLA,3,6,2,4,2
JALISCO,14,MAZAMITLA,059,MAZAMITLA,19,2641,1333,1308,147
JALISCO,14,MAZAMITLA,059,PUERTA DEL ZAPATERO,3,241,106,135,12
JALISCO,14,MAZAMITLA,059,PUERTO DE LAS CUEVAS,2,56,30,26,3
JALISCO,14,MEXTICACÁN,060,CAÑADA DE ISLAS,3,97,55,42,6
JALISCO,14,MEXTICACÁN,060,CHIMALAQUÍN DE ABAJO,1,15,6,9,2
JALISCO,14,MEXTICACÁN,060,CHIMALIQUÍN DE ARRIBA,3,119,57,62,7
JALISCO,14,MEXTICACÁN,060,EL SANTUARIO (SANTUARIO DEL SAGRADO CORAZÓN),2,33,16,17,4
JALISCO,14,MEXTICACÁN,060,LA LABOR DE LA CONCEPCIÓN (LA LABOR),1,18,7,11,1
JALISCO,14,MEXTICACÁN,060,LA PRESA,1,35,19,16,3
JALISCO,14,MEXTICACÁN,060,LAS CABAÑAS COUNTRY,1,1,1,0,1
JALISCO,14,MEXTICACÁN,060,LLANO GRANDE,1,12,5,7,1
JALISCO,14,MEXTICACÁN,060,LORETO DE ABAJO,1,5,1,4,1
JALISCO,14,MEXTICACÁN,060,LORETO DE ARRIBA,1,5,3,2,1
JALISCO,14,MEXTICACÁN,060,LOS RINCONES,1,1,0,1,1
JALISCO,14,MEXTICACÁN,060,MEXTICACÁN,8,697,356,341,39
JALISCO,14,MEXTICACÁN,060,OJUELOS (SAN JOSÉ DE OJUELOS),3,15,8,7,3
JALISCO,14,MEXTICACÁN,060,SAN FELIPE,2,39,16,23,3
JALISCO,14,MEXTICACÁN,060,SAN NICOLÁS,3,7,2,5,2
JALISCO,14,MEXTICACÁN,060,TEPELTILTIC,2,18,11,7,2
JALISCO,14,MEZQUITIC,061,ACATITA,1,7,3,4,1
JALISCO,14,MEZQUITIC,061,AGUA ZARCA,2,23,7,16,3
JALISCO,14,MEZQUITIC,061,AMOLTITA,3,125,64,61,9
JALISCO,14,MEZQUITIC,061,BELLA VISTA,1,4,1,3,1
JALISCO,14,MEZQUITIC,061,CABEZA DEL LLANO,1,29,13,16,2
JALISCO,14,MEZQUITIC,061,CALABACILLAS,2,28,17,11,2
JALISCO,14,MEZQUITIC,061,CAMPAMENTO,1,6,2,4,1
JALISCO,14,MEZQUITIC,061,CERRO COLORADO,2,16,3,13,2
JALISCO,14,MEZQUITIC,061,CHINATA (EL CAJÓN),2,139,65,74,7
JALISCO,14,MEZQUITIC,061,CHONACATA,1,13,6,7,1
JALISCO,14,MEZQUITIC,061,CIÉNEGA GRANDE,2,5,2,3,1
JALISCO,14,MEZQUITIC,061,CIRUELILLO,2,12,4,8,2
JALISCO,14,MEZQUITIC,061,CODORNIZ,3,58,24,34,5
JALISCO,14,MEZQUITIC,061,COHAMIATA,2,82,41,41,3
JALISCO,14,MEZQUITIC,061,COLONIA CARLOS RIVERA ACEVES [ASERRADERO],3,42,21,21,3
JALISCO,14,MEZQUITIC,061,EL CAJÓN,1,18,9,9,3
JALISCO,14,MEZQUITIC,061,EL CHALATE (LOS CHALATES),3,170,81,89,10
JALISCO,14,MEZQUITIC,061,EL MORTERO,3,49,20,29,4
JALISCO,14,MEZQUITIC,061,EL PUERTECITO,8,562,282,280,40
JALISCO,14,MEZQUITIC,061,EL RINCÓN,3,16,12,4,2
JALISCO,14,MEZQUITIC,061,EL SAUCITO,2,18,9,9,2
JALISCO,14,MEZQUITIC,061,EL TEMPISQUE,1,14,8,6,1
JALISCO,14,MEZQUITIC,061,EL TESORERO,2,97,56,41,7
JALISCO,14,MEZQUITIC,061,EL VENADO,3,91,46,45,6
JALISCO,14,MEZQUITIC,061,HAKARETSIE (EL CARRIZAL),2,41,17,24,4
JALISCO,14,MEZQUITIC,061,HUIZACHE,2,22,11,11,2
JALISCO,14,MEZQUITIC,061,JALISQUILLO,1,39,13,26,4
JALISCO,14,MEZQUITIC,061,JIMULCO,1,11,3,8,1
JALISCO,14,MEZQUITIC,061,LA CEBOLLETA,3,84,41,43,4
JALISCO,14,MEZQUITIC,061,LA CIÉNEGA DE HUAISTITA (LOS QUESOS),3,128,63,65,8
JALISCO,14,MEZQUITIC,061,LA CURVA DEL BORRACHO,2,23,12,11,3
JALISCO,14,MEZQUITIC,061,LA GUACAMAYA,2,11,6,5,1
JALISCO,14,MEZQUITIC,061,LA HEDIONDA,2,21,10,11,2
JALISCO,14,MEZQUITIC,061,LA LAGUNA,3,157,81,76,9
JALISCO,14,MEZQUITIC,061,LA MANGA,1,7,4,3,1
JALISCO,14,MEZQUITIC,061,LA NARIZ,2,24,11,13,3
JALISCO,14,MEZQUITIC,061,LAS BOCAS,3,41,23,18,4
JALISCO,14,MEZQUITIC,061,LAS GUAYABAS,3,35,20,15,4
JALISCO,14,MEZQUITIC,061,LAS GUITARRAS (LA GUITARRA),2,14,8,6,1
JALISCO,14,MEZQUITIC,061,LAS LATAS,3,72,34,38,5
JALISCO,14,MEZQUITIC,061,LAS LATAS (KWATEMUKAME),1,5,2,3,1
JALISCO,14,MEZQUITIC,061,LAS TAPIAS,2,38,12,26,3
JALISCO,14,MEZQUITIC,061,LOS AMOLES (BAJÍO DE LOS AMOLES),3,59,28,31,5
JALISCO,14,MEZQUITIC,061,LOS ARCOS,2,6,3,3,1
JALISCO,14,MEZQUITIC,061,LOS ARRIEROS,2,17,4,13,2
JALISCO,14,MEZQUITIC,061,LOS BORREGOS,2,15,9,6,1
JALISCO,14,MEZQUITIC,061,LOS LIRIOS,2,6,4,2,1
JALISCO,14,MEZQUITIC,061,LOS LOBOS DE HUASTITA (LOS LOBOS),3,50,27,23,4
JALISCO,14,MEZQUITIC,061,LOS ROBLES,2,44,27,17,5
JALISCO,14,MEZQUITIC,061,MAYEHEKWA PUEBLO NUEVO 2,4,271,129,142,14
JALISCO,14,MEZQUITIC,061,MESA DEL FRAILE (MESA DE GUADALUPE),1,21,9,12,1
JALISCO,14,MEZQUITIC,061,MESA DEL VENADO,2,5,3,2,1
JALISCO,14,MEZQUITIC,061,MEZQUITIC,7,818,426,392,61
JALISCO,14,MEZQUITIC,061,MINILLAS,1,4,0,4,1
JALISCO,14,MEZQUITIC,061,NINGUNO,1,24,12,12,2
JALISCO,14,MEZQUITIC,061,NOSTIC,3,73,33,40,7
JALISCO,14,MEZQUITIC,061,NUEVA COLONIA,4,321,133,188,20
JALISCO,14,MEZQUITIC,061,OCOTA (LA TABERNA),2,5,5,0,2
JALISCO,14,MEZQUITIC,061,OCOTA DE LOS LLANOS,3,95,45,50,6
JALISCO,14,MEZQUITIC,061,PEDERNALES,3,36,19,17,4
JALISCO,14,MEZQUITIC,061,POCHOTITA,2,63,35,28,4
JALISCO,14,MEZQUITIC,061,POPOTITA,2,30,14,16,3
JALISCO,14,MEZQUITIC,061,POTRERO DE NAVARRETE,3,11,5,6,2
JALISCO,14,MEZQUITIC,061,PUEBLO NUEVO,1,32,18,14,2
JALISCO,14,MEZQUITIC,061,RANCHO DE LA RELACIÓN,2,19,11,8,2
JALISCO,14,MEZQUITIC,061,RANCHO NUEVO,2,15,8,7,1
JALISCO,14,MEZQUITIC,061,RANCHO PINAVETE,2,37,22,15,3
JALISCO,14,MEZQUITIC,061,RATONTITA,2,57,27,30,4
JALISCO,14,MEZQUITIC,061,RINCÓN DE SAN VICENTE,2,11,6,5,2
JALISCO,14,MEZQUITIC,061,SAN ANDRÉS COHAMIATA,5,709,374,335,37
JALISCO,14,MEZQUITIC,061,SAN JUAN DE NAVARRETE,3,45,25,20,5
JALISCO,14,MEZQUITIC,061,SAN LUIS,1,8,2,6,1
JALISCO,14,MEZQUITIC,061,SAN LUISITO,4,179,93,86,10
JALISCO,14,MEZQUITIC,061,SAN MIGUEL (SAN MIGUEL HUAIXTITA),5,489,256,233,58
JALISCO,14,MEZQUITIC,061,SAN NICOLÁS,1,28,13,15,2
JALISCO,14,MEZQUITIC,061,SAN SEBASTIÁN TEPONAHUAXTLÁN,5,549,259,290,29
JALISCO,14,MEZQUITIC,061,SANTA CATARINA CUEXCOMATITLÁN,3,125,62,63,7
JALISCO,14,MEZQUITIC,061,SANTA CLARA,2,112,59,53,7
JALISCO,14,MEZQUITIC,061,SANTA GERTRUDIS (SANTA CRUZ),3,103,51,52,8
JALISCO,14,MEZQUITIC,061,SOCONITA,3,56,25,31,4
JALISCO,14,MEZQUITIC,061,TAIMARITA,1,19,8,11,1
JALISCO,14,MEZQUITIC,061,TECHALOTITA,3,56,25,31,4
JALISCO,14,MEZQUITIC,061,TECOLOTE,3,57,25,32,5
JALISCO,14,MEZQUITIC,061,TEMPISQUE,2,36,15,21,2
JALISCO,14,MEZQUITIC,061,TESORERO,3,97,51,46,7
JALISCO,14,MEZQUITIC,061,TIERRA AMARILLA,2,151,76,75,7
JALISCO,14,MEZQUITIC,061,TIERRA AZUL,1,43,21,22,3
JALISCO,14,MEZQUITIC,061,TIERRA BLANCA (LOS ZALATES),1,3,1,2,1
JALISCO,14,MEZQUITIC,061,TIERRA COLORADA,2,7,4,3,2
JALISCO,14,MEZQUITIC,061,TIERRAS AMARILLAS,2,62,28,34,5
JALISCO,14,MEZQUITIC,061,TIERRAS BLANCAS HUAISTITA,2,13,7,6,1
JALISCO,14,MEZQUITIC,061,TLALTENANGO,1,11,6,5,1
JALISCO,14,MEZQUITIC,061,TOTUATE,2,24,12,12,3
JALISCO,14,MEZQUITIC,061,TSIMATEWA (BAJÍO DEL CARRIZAL),2,28,17,11,2
JALISCO,14,MEZQUITIC,061,ZALATITA,9,193,96,97,13
JALISCO,14,MIXTLÁN,062,AGUA ZARCA,2,37,12,25,3
JALISCO,14,MIXTLÁN,062,CUYUTLÁN,2,21,7,14,3
JALISCO,14,MIXTLÁN,062,EL HOLLEJO (TÍO CLETO),3,63,36,27,4
JALISCO,14,MIXTLÁN,062,EMILIANO ZAPATA,3,47,21,26,4
JALISCO,14,MIXTLÁN,062,LA LAJA,4,238,117,121,22
JALISCO,14,MIXTLÁN,062,MIXTLÁN,4,299,151,148,20
JALISCO,14,MIXTLÁN,062,SAN GREGORIO,1,5,3,2,1
JALISCO,14,OCOTLÁN,063,EL PEDREGAL (SANTA CLARA DEL PEDREGAL),3,29,16,13,3
JALISCO,14,OCOTLÁN,063,EL SABINO,2,64,26,38,5
JALISCO,14,OCOTLÁN,063,GENERAL JOAQUÍN AMARO (LOS SAUCES),2,98,52,46,6
JALISCO,14,OCOTLÁN,063,JOCONOXTLE (LA TUNA),3,227,106,121,11
JALISCO,14,OCOTLÁN,063,LA MURALLA (LA MANGA),1,7,3,4,1
JALISCO,14,OCOTLÁN,063,LA PIEDRERA,2,16,7,9,2
JALISCO,14,OCOTLÁN,063,LA PUERTA DE LOS RANCHOS (LOS RANCHOS),3,44,21,23,5
JALISCO,14,OCOTLÁN,063,NUEVO FUERTE (LAS LADRILLERAS),3,889,437,452,29
JALISCO,14,OCOTLÁN,063,OCOTLÁN,120,28831,14785,14046,1905
JALISCO,14,OCOTLÁN,063,PASO DE LA COMUNIDAD,2,38,16,22,3
JALISCO,14,OCOTLÁN,063,RANCHO VIEJO DEL REFUGIO (RANCHO VIEJO),3,123,61,62,8
JALISCO,14,OCOTLÁN,063,SAN ANDRÉS,3,61,26,35,5
JALISCO,14,OCOTLÁN,063,SAN JUAN CHICO,3,25,11,14,3
JALISCO,14,OCOTLÁN,063,SAN MARTÍN DE ZULA,3,586,309,277,24
JALISCO,14,OCOTLÁN,063,SAN VICENTE (LABOR VIEJA),4,340,184,156,14
JALISCO,14,OCOTLÁN,063,SANTA CLARA DE ZULA,2,74,35,39,4
JALISCO,14,OJUELOS DE JALISCO,064,CHINAMPAS,5,523,262,261,30
JALISCO,14,OJUELOS DE JALISCO,064,EL MOLINO,1,34,17,17,2
JALISCO,14,OJUELOS DE JALISCO,064,EL SALITRILLO (SALITRILLO DE GONZÁLEZ),1,5,2,3,1
JALISCO,14,OJUELOS DE JALISCO,064,EMILIANO ZAPATA,3,36,22,14,3
JALISCO,14,OJUELOS DE JALISCO,064,ENCINILLAS,3,83,36,47,6
JALISCO,14,OJUELOS DE JALISCO,064,GUADALUPE VICTORIA,4,356,187,169,27
JALISCO,14,OJUELOS DE JALISCO,064,HIERBA DE MATANCILLAS,3,310,160,150,13
JALISCO,14,OJUELOS DE JALISCO,064,JOSÉ MARÍA MORELOS (EL NOVILLO),3,62,32,30,5
JALISCO,14,OJUELOS DE JALISCO,064,LA GRANJA,3,128,74,54,7
JALISCO,14,OJUELOS DE JALISCO,064,LA PAZ,3,297,145,152,15
JALISCO,14,OJUELOS DE JALISCO,064,LA PRESA,3,236,100,136,12
JALISCO,14,OJUELOS DE JALISCO,064,LAS AMARILLAS,3,72,27,45,5
JALISCO,14,OJUELOS DE JALISCO,064,LOS CAMPOS,1,9,6,3,1
JALISCO,14,OJUELOS DE JALISCO,064,MATANCILLAS (SAN ISIDRO MATANCILLAS),7,1397,739,658,56
JALISCO,14,OJUELOS DE JALISCO,064,MATANZAS,4,291,141,150,15
JALISCO,14,OJUELOS DE JALISCO,064,MORENITOS,3,79,44,35,6
JALISCO,14,OJUELOS DE JALISCO,064,OJUELOS DE JALISCO,19,3742,1923,1819,187
JALISCO,14,OJUELOS DE JALISCO,064,PAPAS DE ABAJO (LAS PAPAS DE ABAJO),1,9,3,6,1
JALISCO,14,OJUELOS DE JALISCO,064,PAPAS DE ENMEDIO,1,21,12,9,2
JALISCO,14,OJUELOS DE JALISCO,064,SAN JOSÉ DE LETRAS (LETRAS),2,41,23,18,3
JALISCO,14,OJUELOS DE JALISCO,064,VAQUERÍAS (LANGUILLO),3,214,102,112,11
JALISCO,14,PIHUAMO,065,BARRERAS,3,81,36,45,6
JALISCO,14,PIHUAMO,065,COLOMOS,1,12,9,3,1
JALISCO,14,PIHUAMO,065,CRUCERO DEL NARANJO,1,5,4,1,1
JALISCO,14,PIHUAMO,065,EL AGOSTADERO,3,29,14,15,4
JALISCO,14,PIHUAMO,065,EL ESPINO,1,5,2,3,1
JALISCO,14,PIHUAMO,065,EL GALÁN,1,15,7,8,1
JALISCO,14,PIHUAMO,065,EL GUAYABO,3,33,21,12,3
JALISCO,14,PIHUAMO,065,EL NARANJO,3,47,25,22,4
JALISCO,14,PIHUAMO,065,EL PLATANAR,1,3,1,2,1
JALISCO,14,PIHUAMO,065,EL POZO SANTO (CRUCERO DEL TULE),2,63,30,33,4
JALISCO,14,PIHUAMO,065,EL QUEMADO,2,17,8,9,2
JALISCO,14,PIHUAMO,065,EL VALLECITO,2,32,16,16,2
JALISCO,14,PIHUAMO,065,EL ZAPOTE,3,5,2,3,2
JALISCO,14,PIHUAMO,065,HUIZACHES,3,48,23,25,4
JALISCO,14,PIHUAMO,065,LA ESTANCIA,2,7,4,3,1
JALISCO,14,PIHUAMO,065,LA ESTRELLA,3,129,65,64,9
JALISCO,14,PIHUAMO,065,LA SIDRA,1,7,3,4,1
JALISCO,14,PIHUAMO,065,LAS NARANJAS,2,18,12,6,2
JALISCO,14,PIHUAMO,065,LÁZARO CÁRDENAS (AGUA ESCONDIDA),1,6,1,5,1
JALISCO,14,PIHUAMO,065,LOS MOJOS DE ABAJO,2,7,4,3,2
JALISCO,14,PIHUAMO,065,PIHUAMO,14,1892,944,948,97
JALISCO,14,PIHUAMO,065,PUENTE DE FÁTIMA,2,17,9,8,2
JALISCO,14,PIHUAMO,065,SAN JOSÉ DEL TULE,3,176,89,87,11
JALISCO,14,PIHUAMO,065,SANTA CRUZ,2,32,17,15,4
JALISCO,14,PIHUAMO,065,SANTA ROSA DE LIMA,3,7,3,4,2
JALISCO,14,PIHUAMO,065,SIDRA DE LOS COLOMOS (LA SIDRA),1,14,7,7,1
JALISCO,14,PONCITLÁN,066,AGUA CALIENTE,4,491,254,237,21
JALISCO,14,PONCITLÁN,066,CASA BLANCA,2,123,57,66,7
JALISCO,14,PONCITLÁN,066,CHALPICOTE,3,224,99,125,10
JALISCO,14,PONCITLÁN,066,CUESTA DE MEZCALA,2,199,98,101,9
JALISCO,14,PONCITLÁN,066,CUITZEO (LA ESTANCIA),6,1073,538,535,56
JALISCO,14,PONCITLÁN,066,EL ZAPOTE,1,6,4,2,1
JALISCO,14,PONCITLÁN,066,LA LADRILLERA,2,15,5,10,2
JALISCO,14,PONCITLÁN,066,LA PEÑA,3,512,256,256,16
JALISCO,14,PONCITLÁN,066,LA ZAPOTERA,3,269,138,131,11
JALISCO,14,PONCITLÁN,066,MEZCALA,9,2081,1066,1015,93
JALISCO,14,PONCITLÁN,066,OJO DE AGUA,2,59,33,26,4
JALISCO,14,PONCITLÁN,066,PONCITLÁN,28,5425,2914,2511,325
JALISCO,14,PONCITLÁN,066,SAN JACINTO,4,447,229,218,21
JALISCO,14,PONCITLÁN,066,SAN JOSÉ DE LAS PILAS,3,73,39,34,4
JALISCO,14,PONCITLÁN,066,SAN JOSÉ DE ORNELAS,1,17,7,10,1
JALISCO,14,PONCITLÁN,066,SAN JUAN TECOMATLÁN,5,511,237,274,40
JALISCO,14,PONCITLÁN,066,SAN LUIS DEL AGUA CALIENTE,3,325,162,163,14
JALISCO,14,PONCITLÁN,066,SAN MIGUEL ZAPOTITLÁN,4,591,289,302,24
JALISCO,14,PONCITLÁN,066,SAN PEDRO ITZICÁN,6,1750,888,862,60
JALISCO,14,PONCITLÁN,066,SAN SEBASTIÁN,3,72,28,44,6
JALISCO,14,PONCITLÁN,066,SANTA CRUZ EL GRANDE,4,627,318,309,26
JALISCO,14,PONCITLÁN,066,SANTA MARÍA DE LA JOYA,1,15,5,10,1
JALISCO,14,PONCITLÁN,066,TLACHICHILCO DEL CARMEN,2,70,33,37,5
JALISCO,14,PUERTO VALLARTA,067,AGUACATERA,3,100,43,57,8
JALISCO,14,PUERTO VALLARTA,067,BOCA DE TOMATLÁN,4,273,140,133,24
JALISCO,14,PUERTO VALLARTA,067,COLINAS DEL VALLE,2,32,17,15,3
JALISCO,14,PUERTO VALLARTA,067,EL CANTÓN,5,667,350,317,20
JALISCO,14,PUERTO VALLARTA,067,EL COLORADO,5,809,408,401,27
JALISCO,14,PUERTO VALLARTA,067,EL RANCHITO (EL COLESIO),5,843,445,398,28
JALISCO,14,PUERTO VALLARTA,067,EL ZANCUDO,2,101,61,40,6
JALISCO,14,PUERTO VALLARTA,067,GETSEMANÍ,2,34,12,22,2
JALISCO,14,PUERTO VALLARTA,067,IXTAPA,35,15853,8254,7599,859
JALISCO,14,PUERTO VALLARTA,067,LA ARBOLEDA (LOMAS DEL VALLE),2,27,9,18,3
JALISCO,14,PUERTO VALLARTA,067,LA PUNTA NEGRA,1,26,7,19,1
JALISCO,14,PUERTO VALLARTA,067,LAS JUNTAS,26,5463,2968,2495,364
JALISCO,14,PUERTO VALLARTA,067,LAS PALMAS DE ARRIBA,4,936,494,442,47
JALISCO,14,PUERTO VALLARTA,067,LOS ÁNGELES,1,11,3,8,1
JALISCO,14,PUERTO VALLARTA,067,LOS LLANITOS,4,92,46,46,6
JALISCO,14,PUERTO VALLARTA,067,MISMALOYA,3,202,79,123,11
JALISCO,14,PUERTO VALLARTA,067,PLAYA GRANDE (SAN PEDRO),3,126,55,71,6
JALISCO,14,PUERTO VALLARTA,067,PUERTO VALLARTA,298,57076,29092,27984,3668
JALISCO,14,PUERTO VALLARTA,067,RANCHO NÁCAR,2,31,16,15,3
JALISCO,14,PUERTO VALLARTA,067,SANTA CRUZ DE QUELITÁN (PALMILLAS),3,40,18,22,4
JALISCO,14,PUERTO VALLARTA,067,TEBELCHIA (EL ROBLE),3,151,76,75,7
JALISCO,14,VILLA PURIFICACIÓN,068,CARREÓN,3,39,16,23,4
JALISCO,14,VILLA PURIFICACIÓN,068,EL ALCÍHUATL,3,25,16,9,2
JALISCO,14,VILLA PURIFICACIÓN,068,EL CARRIZAL,2,7,4,3,1
JALISCO,14,VILLA PURIFICACIÓN,068,EL DIVISADERO,2,14,7,7,2
JALISCO,14,VILLA PURIFICACIÓN,068,EL MANGUITO,3,52,27,25,4
JALISCO,14,VILLA PURIFICACIÓN,068,EL PLAN DE LOS PLÁTANOS,1,4,3,1,1
JALISCO,14,VILLA PURIFICACIÓN,068,EL PLATANAR,1,6,2,4,1
JALISCO,14,VILLA PURIFICACIÓN,068,EL PLATANILLO,1,19,6,13,1
JALISCO,14,VILLA PURIFICACIÓN,068,ESPINOS DE CARREÓN,2,5,1,4,1
JALISCO,14,VILLA PURIFICACIÓN,068,ESPINOS DE JUDÍO,3,50,21,29,5
JALISCO,14,VILLA PURIFICACIÓN,068,ESTANCIA DE AMBORÍN,3,48,21,27,4
JALISCO,14,VILLA PURIFICACIÓN,068,HUISTA,1,6,2,4,1
JALISCO,14,VILLA PURIFICACIÓN,068,JIROSTO,3,52,25,27,5
JALISCO,14,VILLA PURIFICACIÓN,068,JOCOTLÁN,3,24,15,9,3
JALISCO,14,VILLA PURIFICACIÓN,068,LA ANONA,2,5,2,3,1
JALISCO,14,VILLA PURIFICACIÓN,068,LA ATALAYA,2,14,7,7,2
JALISCO,14,VILLA PURIFICACIÓN,068,LA COFRADÍA,3,26,11,15,3
JALISCO,14,VILLA PURIFICACIÓN,068,LA ECA,3,73,39,34,7
JALISCO,14,VILLA PURIFICACIÓN,068,LA NANCITA,1,1,1,0,1
JALISCO,14,VILLA PURIFICACIÓN,068,LAS GUASIMITAS,2,5,2,3,1
JALISCO,14,VILLA PURIFICACIÓN,068,LAS NANCITAS,3,20,8,12,2
JALISCO,14,VILLA PURIFICACIÓN,068,LLANO DEL HIGO,3,39,19,20,4
JALISCO,14,VILLA PURIFICACIÓN,068,LLANO DEL ORO,2,24,11,13,2
JALISCO,14,VILLA PURIFICACIÓN,068,LOS ACHOTES,2,19,13,6,2
JALISCO,14,VILLA PURIFICACIÓN,068,LOS CIMIENTOS,3,23,11,12,3
JALISCO,14,VILLA PURIFICACIÓN,068,LOS CIRUELOS,2,6,3,3,2
JALISCO,14,VILLA PURIFICACIÓN,068,LOS LINDOS,3,34,18,16,4
JALISCO,14,VILLA PURIFICACIÓN,068,LOS OCOTITOS,3,12,5,7,2
JALISCO,14,VILLA PURIFICACIÓN,068,MEZCALES,3,33,19,14,4
JALISCO,14,VILLA PURIFICACIÓN,068,PABELO,3,87,45,42,7
JALISCO,14,VILLA PURIFICACIÓN,068,PASO DEL GUAMÚCHIL,2,4,2,2,1
JALISCO,14,VILLA PURIFICACIÓN,068,PASO REAL,1,8,3,5,1
JALISCO,14,VILLA PURIFICACIÓN,068,PLAZA DE GALLOS,3,8,4,4,2
JALISCO,14,VILLA PURIFICACIÓN,068,RANCHO NUEVO (LOS TECOMATES),3,7,2,5,2
JALISCO,14,VILLA PURIFICACIÓN,068,SAN MIGUEL,4,246,132,114,21
JALISCO,14,VILLA PURIFICACIÓN,068,TELPITITA,2,7,4,3,1
JALISCO,14,VILLA PURIFICACIÓN,068,TEZACUALE (CARRIZALILLO),2,7,3,4,1
JALISCO,14,VILLA PURIFICACIÓN,068,VILLA PURIFICACIÓN,12,1664,805,859,100
JALISCO,14,VILLA PURIFICACIÓN,068,VILLA VIEJA (EX-HACIENDA VILLA VIEJA),3,22,12,10,3
JALISCO,14,VILLA PURIFICACIÓN,068,ZAPOTÁN,4,153,76,77,16
JALISCO,14,QUITUPAN,069,BENITO JUÁREZ (SAN ONOFRE),1,6,3,3,1
JALISCO,14,QUITUPAN,069,CAÑADA SECA (LAS ÁNIMAS),1,9,4,5,1
JALISCO,14,QUITUPAN,069,CARRIZALILLO,2,9,7,2,1
JALISCO,14,QUITUPAN,069,CHAMACUERO,2,12,7,5,2
JALISCO,14,QUITUPAN,069,EL CHORRO,2,6,3,3,2
JALISCO,14,QUITUPAN,069,EL CUERVO,3,82,48,34,6
JALISCO,14,QUITUPAN,069,EL FRESNAL,1,11,7,4,1
JALISCO,14,QUITUPAN,069,EL LIMÓN DE CARRANZA (EL LIMÓN),1,4,2,2,1
JALISCO,14,QUITUPAN,069,EL MONTOSO,2,14,6,8,2
JALISCO,14,QUITUPAN,069,EL QUIRINGUAL,2,13,8,5,2
JALISCO,14,QUITUPAN,069,EL RAICERO,1,22,14,8,2
JALISCO,14,QUITUPAN,069,EL TALAYOTE,1,14,6,8,1
JALISCO,14,QUITUPAN,069,GUADALUPE DEL MONTOSO,3,15,5,10,2
JALISCO,14,QUITUPAN,069,LA JOYA,3,61,36,25,6
JALISCO,14,QUITUPAN,069,LA MORA,1,3,3,0,1
JALISCO,14,QUITUPAN,069,LA PEÑA,1,12,6,6,1
JALISCO,14,QUITUPAN,069,LA TINAJA,2,28,13,15,3
JALISCO,14,QUITUPAN,069,LAS TABLAS,1,6,4,2,1
JALISCO,14,QUITUPAN,069,LAS TECATAS,3,24,8,16,4
JALISCO,14,QUITUPAN,069,LAVADEROS,2,7,5,2,1
JALISCO,14,QUITUPAN,069,LOS CAPULINES,3,19,11,8,3
JALISCO,14,QUITUPAN,069,LOS DESMONTES,3,25,15,10,3
JALISCO,14,QUITUPAN,069,LOS LLANOS,2,30,14,16,3
JALISCO,14,QUITUPAN,069,MARIANO ESCOBEDO (LA GUADALUPE),2,57,25,32,5
JALISCO,14,QUITUPAN,069,PALO VERDE,3,18,8,10,2
JALISCO,14,QUITUPAN,069,PLAN DE CERVANTES,3,29,15,14,4
JALISCO,14,QUITUPAN,069,PUERTO DEL OJO DE AGUA,2,10,3,7,1
JALISCO,14,QUITUPAN,069,QUITUPAN,5,502,249,253,43
JALISCO,14,QUITUPAN,069,RAFAEL PICAZO (SANTA CRUZ),1,32,18,14,3
JALISCO,14,QUITUPAN,069,RAMÓN CORONA (SANTA FE),1,20,7,13,1
JALISCO,14,QUITUPAN,069,RÍO DE HUERTAS,2,13,4,9,2
JALISCO,14,QUITUPAN,069,RODEO,3,28,7,21,3
JALISCO,14,QUITUPAN,069,SAN ANTONIO (CARRILLO PUERTO),3,77,33,44,5
JALISCO,14,QUITUPAN,069,SAN DIEGO (LÁZARO CÁRDENAS),6,520,282,238,45
JALISCO,14,QUITUPAN,069,SAN FRANCISCO (EMILIANO ZAPATA),2,42,26,16,3
JALISCO,14,QUITUPAN,069,SAN JOSÉ DE LA MAJADA,1,3,3,0,1
JALISCO,14,QUITUPAN,069,SANTAS MARÍAS (LAS CANOAS),2,2,1,1,2
JALISCO,14,QUITUPAN,069,SOROMUTA,3,106,54,52,7
JALISCO,14,EL SALTO,070,EL MUEY,4,649,297,352,18
JALISCO,14,EL SALTO,070,EL QUINCE (SAN JOSÉ EL QUINCE),23,4918,2421,2497,204
JALISCO,14,EL SALTO,070,EL SALTO,49,15270,7658,7612,620
JALISCO,14,EL SALTO,070,HACIENDA VIEJA DEL CASTILLO (CASTILLO VIEJO),4,374,165,209,16
JALISCO,14,EL SALTO,070,LAS PINTAS,32,12735,6601,6134,621
JALISCO,14,EL SALTO,070,LAS PINTITAS,25,5609,2742,2867,257
JALISCO,14,EL SALTO,070,LOMAS DEL SALTO,5,1170,584,586,46
JALISCO,14,EL SALTO,070,SAN JOSÉ DEL CASTILLO,35,11204,5498,5706,614
JALISCO,14,EL SALTO,070,SAN JOSÉ EL VERDE (EL VERDE),21,5054,2496,2558,214
JALISCO,14,SAN CRISTÓBAL DE LA BARRANCA,071,CAMOTÁN,2,7,2,5,1
JALISCO,14,SAN CRISTÓBAL DE LA BARRANCA,071,CUYUTLÁN,4,75,44,31,8
JALISCO,14,SAN CRISTÓBAL DE LA BARRANCA,071,EL COLOMO,2,7,1,6,1
JALISCO,14,SAN CRISTÓBAL DE LA BARRANCA,071,EL ESCALÓN,2,19,12,7,2
JALISCO,14,SAN CRISTÓBAL DE LA BARRANCA,071,EL MALACATE,1,6,5,1,1
JALISCO,14,SAN CRISTÓBAL DE LA BARRANCA,071,EL TEPOZÁN,2,61,29,32,4
JALISCO,14,SAN CRISTÓBAL DE LA BARRANCA,071,EXCAMILPA,3,79,42,37,5
JALISCO,14,SAN CRISTÓBAL DE LA BARRANCA,071,HUILOTÁN,2,7,3,4,1
JALISCO,14,SAN CRISTÓBAL DE LA BARRANCA,071,LA LOBERA,3,79,42,37,5
JALISCO,14,SAN CRISTÓBAL DE LA BARRANCA,071,LAS CHORRERAS,2,8,5,3,2
JALISCO,14,SAN CRISTÓBAL DE LA BARRANCA,071,LOS PUEBLITOS,3,51,24,27,4
JALISCO,14,SAN CRISTÓBAL DE LA BARRANCA,071,MESA DE SAN JUAN,3,30,14,16,4
JALISCO,14,SAN CRISTÓBAL DE LA BARRANCA,071,RANCHO EL RODEO,2,13,6,7,3
JALISCO,14,SAN CRISTÓBAL DE LA BARRANCA,071,SAN CRISTÓBAL DE LA BARRANCA,4,353,167,186,20
JALISCO,14,SAN CRISTÓBAL DE LA BARRANCA,071,SAN FRANCISCO,2,18,9,9,3
JALISCO,14,SAN CRISTÓBAL DE LA BARRANCA,071,SANTA CRUZ DE LAS FLORES,2,19,9,10,2
JALISCO,14,SAN CRISTÓBAL DE LA BARRANCA,071,SOSOCOLA,1,7,3,4,1
JALISCO,14,SAN CRISTÓBAL DE LA BARRANCA,071,TEPEACA,3,27,14,13,3
JALISCO,14,SAN DIEGO DE ALEJANDRÍA,072,CASAS BLANCAS (SAN FELIPE DE JESÚS),3,60,24,36,5
JALISCO,14,SAN DIEGO DE ALEJANDRÍA,072,EL MASTRANZO,2,6,2,4,1
JALISCO,14,SAN DIEGO DE ALEJANDRÍA,072,EL OCOTE,2,39,19,20,3
JALISCO,14,SAN DIEGO DE ALEJANDRÍA,072,EL RANCHITO,1,6,2,4,1
JALISCO,14,SAN DIEGO DE ALEJANDRÍA,072,LA ANGOSTURA,1,10,7,3,1
JALISCO,14,SAN DIEGO DE ALEJANDRÍA,072,LA CAMPAÑA DE MORELOS,2,105,56,49,5
JALISCO,14,SAN DIEGO DE ALEJANDRÍA,072,LAS AZULES,2,60,29,31,4
JALISCO,14,SAN DIEGO DE ALEJANDRÍA,072,PUERTA DE LOS SAUCES,1,8,5,3,1
JALISCO,14,SAN DIEGO DE ALEJANDRÍA,072,SAN DIEGO DE ALEJANDRÍA,10,1502,785,717,73
JALISCO,14,SAN DIEGO DE ALEJANDRÍA,072,SAN PABLO,1,11,6,5,1
JALISCO,14,SAN DIEGO DE ALEJANDRÍA,072,VISTA HERMOSA,1,8,6,2,1
JALISCO,14,SAN JUAN DE LOS LAGOS,073,AGUA DE OBISPO,3,99,39,60,6
JALISCO,14,SAN JUAN DE LOS LAGOS,073,CABALLERÍAS,3,21,13,8,3
JALISCO,14,SAN JUAN DE LOS LAGOS,073,CAÑADA DE PÉREZ,1,50,28,22,2
JALISCO,14,SAN JUAN DE LOS LAGOS,073,CAÑADA DEL DINERO,1,6,1,5,1
JALISCO,14,SAN JUAN DE LOS LAGOS,073,CARRIZO DE ABAJO,2,15,7,8,2
JALISCO,14,SAN JUAN DE LOS LAGOS,073,CARRIZO NORTE,2,28,12,16,2
JALISCO,14,SAN JUAN DE LOS LAGOS,073,CASAS VIEJAS (AGUA BLANCA),3,91,49,42,6
JALISCO,14,SAN JUAN DE LOS LAGOS,073,COLONIA SANTA CECILIA (LA SAUCEDA),2,485,220,265,27
JALISCO,14,SAN JUAN DE LOS LAGOS,073,CORRAL DE PIEDRA,2,19,8,11,2
JALISCO,14,SAN JUAN DE LOS LAGOS,073,CUATRO ESQUINAS,1,9,2,7,1
JALISCO,14,SAN JUAN DE LOS LAGOS,073,EL AGOSTADERO,2,88,46,42,5
JALISCO,14,SAN JUAN DE LOS LAGOS,073,EL ALTO DE BARAJAS,1,6,5,1,1
JALISCO,14,SAN JUAN DE LOS LAGOS,073,EL ASOLEADERO,2,30,13,17,2
JALISCO,14,SAN JUAN DE LOS LAGOS,073,EL ATRAVESAÑO,1,23,8,15,2
JALISCO,14,SAN JUAN DE LOS LAGOS,073,EL CARRIZO DE ARRIBA,3,23,10,13,3
JALISCO,14,SAN JUAN DE LOS LAGOS,073,EL CHAMACUERO,1,28,15,13,1
JALISCO,14,SAN JUAN DE LOS LAGOS,073,EL DESPERDICIO (EL SALVADOR),3,181,85,96,10
JALISCO,14,SAN JUAN DE LOS LAGOS,073,EL HÚMEDO,2,36,17,19,2
JALISCO,14,SAN JUAN DE LOS LAGOS,073,EL LLANO DE MÁRQUEZ (LLANO DE CABALLERÍAS),1,11,4,7,1
JALISCO,14,SAN JUAN DE LOS LAGOS,073,EL PADRE JUAN,1,20,8,12,2
JALISCO,14,SAN JUAN DE LOS LAGOS,073,EL SAUZ DE LOS IBARRA,3,118,44,74,7
JALISCO,14,SAN JUAN DE LOS LAGOS,073,EL TECOLOTE,2,33,12,21,3
JALISCO,14,SAN JUAN DE LOS LAGOS,073,EL TEPOZÁN,2,25,11,14,3
JALISCO,14,SAN JUAN DE LOS LAGOS,073,EL TORO CHICO (LA PALMITA),2,15,7,8,2
JALISCO,14,SAN JUAN DE LOS LAGOS,073,EL TORQUE (EL AGOSTADERO),1,16,5,11,1
JALISCO,14,SAN JUAN DE LOS LAGOS,073,ESTANCIA VIEJA DE ABAJO,1,14,6,8,1
JALISCO,14,SAN JUAN DE LOS LAGOS,073,ESTANCIA VIEJA DE ARRIBA,2,50,26,24,3
JALISCO,14,SAN JUAN DE LOS LAGOS,073,HALCONERO DE ABAJO,3,54,29,25,5
JALISCO,14,SAN JUAN DE LOS LAGOS,073,HALCONERO DE ARRIBA,2,30,14,16,3
JALISCO,14,SAN JUAN DE LOS LAGOS,073,JARA DE JIMÉNEZ (LA JARA),2,18,12,6,2
JALISCO,14,SAN JUAN DE LOS LAGOS,073,LA CARMENTA,2,17,7,10,2
JALISCO,14,SAN JUAN DE LOS LAGOS,073,LA CONCHA,1,114,49,65,6
JALISCO,14,SAN JUAN DE LOS LAGOS,073,LA ESPERANZA,1,4,2,2,1
JALISCO,14,SAN JUAN DE LOS LAGOS,073,LA LABOR DE LOS ALBA,3,30,16,14,2
JALISCO,14,SAN JUAN DE LOS LAGOS,073,LA LAJA,2,20,6,14,2
JALISCO,14,SAN JUAN DE LOS LAGOS,073,LA LOMA,6,77,31,46,7
JALISCO,14,SAN JUAN DE LOS LAGOS,073,LA MATILLA,2,7,4,3,1
JALISCO,14,SAN JUAN DE LOS LAGOS,073,LABOR DE MONTOYA,1,3,1,2,1
JALISCO,14,SAN JUAN DE LOS LAGOS,073,LAS PIEDRAS DE AMOLAR,2,22,14,8,2
JALISCO,14,SAN JUAN DE LOS LAGOS,073,LAS VERDOLAGAS,3,47,22,25,5
JALISCO,14,SAN JUAN DE LOS LAGOS,073,LOS AGUIRRES DE ABAJO (LOS AGUIRRES),1,19,6,13,1
JALISCO,14,SAN JUAN DE LOS LAGOS,073,LOS AGUIRRES DE ARRIBA,2,59,34,25,3
JALISCO,14,SAN JUAN DE LOS LAGOS,073,LOS CHARCOS,1,9,5,4,1
JALISCO,14,SAN JUAN DE LOS LAGOS,073,LOS CUARTOS,2,50,18,32,3
JALISCO,14,SAN JUAN DE LOS LAGOS,073,MATA GORDA,3,54,26,28,5
JALISCO,14,SAN JUAN DE LOS LAGOS,073,MEZQUITIC DE LA MAGDALENA,3,464,231,233,20
JALISCO,14,SAN JUAN DE LOS LAGOS,073,OJO DE AGUA,1,5,2,3,1
JALISCO,14,SAN JUAN DE LOS LAGOS,073,PASO DE TRUJILLOS,2,29,14,15,2
JALISCO,14,SAN JUAN DE LOS LAGOS,073,PASO HONDO,2,29,12,17,2
JALISCO,14,SAN JUAN DE LOS LAGOS,073,POTRERO DE LA TUNA (EJIDO LA JARA),1,11,6,5,1
JALISCO,14,SAN JUAN DE LOS LAGOS,073,PURÍSIMA,2,33,15,18,4
JALISCO,14,SAN JUAN DE LOS LAGOS,073,SAN ANTONIO CASAS NUEVAS (EL OJO DE AGUA),1,17,11,6,2
JALISCO,14,SAN JUAN DE LOS LAGOS,073,SAN ANTONIO DE LOS BARRERA,2,35,18,17,3
JALISCO,14,SAN JUAN DE LOS LAGOS,073,SAN JOSÉ DE OLIVARES,2,7,2,5,1
JALISCO,14,SAN JUAN DE LOS LAGOS,073,SAN JUAN DE LOS LAGOS,64,16454,8435,8019,846
JALISCO,14,SAN JUAN DE LOS LAGOS,073,SAN PEDRO DE LAS FLORES,2,42,27,15,3
JALISCO,14,SAN JUAN DE LOS LAGOS,073,SANTA ROSA,3,19,9,10,3
JALISCO,14,SAN JUAN DE LOS LAGOS,073,SANTA TERESA [GRANJA],2,23,14,9,2
JALISCO,14,SAN JUAN DE LOS LAGOS,073,SARDINAS DE ARRIBA,1,2,1,1,1
JALISCO,14,SAN JUAN DE LOS LAGOS,073,TIERRA BLANCA,2,27,13,14,2
JALISCO,14,SAN JUAN DE LOS LAGOS,073,TRUJILLOS DE ABAJO,1,11,7,4,1
JALISCO,14,SAN JULIÁN,074,CARRICILLO,2,12,5,7,2
JALISCO,14,SAN JULIÁN,074,LA MANGA (POTRERO GRANDE),3,36,14,22,3
JALISCO,14,SAN JULIÁN,074,LAS MESITAS,1,32,14,18,2
JALISCO,14,SAN JULIÁN,074,PUERTA DE AMOLERO (PUERTA DEL AIRE),4,306,163,143,12
JALISCO,14,SAN JULIÁN,074,SAN JULIÁN,19,3781,1938,1843,177
JALISCO,14,SAN JULIÁN,074,TAMARA,3,26,13,13,2
JALISCO,14,SAN MARCOS,075,LA PUERTA DEL COCHE,1,5,2,3,1
JALISCO,14,SAN MARCOS,075,SAN MARCOS,7,870,440,430,47
JALISCO,14,SAN MARTÍN DE BOLAÑOS,076,EL PLATANAR,1,11,5,6,1
JALISCO,14,SAN MARTÍN DE BOLAÑOS,076,LA JOYA,1,3,3,0,1
JALISCO,14,SAN MARTÍN DE BOLAÑOS,076,LA PRESA,1,13,10,3,1
JALISCO,14,SAN MARTÍN DE BOLAÑOS,076,MAMATLA,3,23,13,10,4
JALISCO,14,SAN MARTÍN DE BOLAÑOS,076,RANCHO VIEJO,3,9,3,6,2
JALISCO,14,SAN MARTÍN DE BOLAÑOS,076,SAN MARTÍN DE BOLAÑOS,6,609,318,291,35
JALISCO,14,SAN MARTÍN HIDALGO,077,BUENAVISTA,6,679,344,335,68
JALISCO,14,SAN MARTÍN HIDALGO,077,CAMAJAPITA,3,66,41,25,6
JALISCO,14,SAN MARTÍN HIDALGO,077,EL CRUCERO DE SANTA MARÍA,7,752,376,376,47
JALISCO,14,SAN MARTÍN HIDALGO,077,EL SALITRE,5,613,305,308,35
JALISCO,14,SAN MARTÍN HIDALGO,077,EL TEPEHUAJE DE MORELOS,3,339,169,170,22
JALISCO,14,SAN MARTÍN HIDALGO,077,IPAZOLTIC,3,115,64,51,9
JALISCO,14,SAN MARTÍN HIDALGO,077,JESÚS MARÍA (EL ZAPOTE),2,34,15,19,3
JALISCO,14,SAN MARTÍN HIDALGO,077,LABOR DE MEDINA,3,139,62,77,10
JALISCO,14,SAN MARTÍN HIDALGO,077,LAGUNILLAS,1,12,8,4,1
JALISCO,14,SAN MARTÍN HIDALGO,077,LÁZARO CÁRDENAS,2,25,14,11,2
JALISCO,14,SAN MARTÍN HIDALGO,077,LOS GUERRERO,2,85,43,42,6
JALISCO,14,SAN MARTÍN HIDALGO,077,LOS VERGARA,2,39,16,23,3
JALISCO,14,SAN MARTÍN HIDALGO,077,RÍO GRANDE,3,107,58,49,6
JALISCO,14,SAN MARTÍN HIDALGO,077,SAN ISIDRO PALO VERDE,3,74,27,47,6
JALISCO,14,SAN MARTÍN HIDALGO,077,SAN JACINTITO (EL RANCHITO),2,16,11,5,2
JALISCO,14,SAN MARTÍN HIDALGO,077,SAN JACINTO,2,25,11,14,3
JALISCO,14,SAN MARTÍN HIDALGO,077,SAN JERÓNIMO (LOS BARBOSA),3,82,40,42,6
JALISCO,14,SAN MARTÍN HIDALGO,077,SAN MARTÍN HIDALGO,16,2894,1455,1439,163
JALISCO,14,SAN MARTÍN HIDALGO,077,SANTA CRUZ DE LAS FLORES,5,283,126,157,23
JALISCO,14,SAN MARTÍN HIDALGO,077,SANTA ROSA DEL JILGUERO,2,28,14,14,3
JALISCO,14,SAN MARTÍN HIDALGO,077,TRAPICHE DE ABRA,3,221,99,122,11
JALISCO,14,SAN MARTÍN HIDALGO,077,VENUSTIANO CARRANZA,1,14,7,7,1
JALISCO,14,SAN MIGUEL EL ALTO,078,BELEM,3,168,93,75,9
JALISCO,14,SAN MIGUEL EL ALTO,078,CRUZ DE OROZCO,2,8,3,5,1
JALISCO,14,SAN MIGUEL EL ALTO,078,EL ASTILLERO,1,50,19,31,3
JALISCO,14,SAN MIGUEL EL ALTO,078,EL BAJÍO,3,72,36,36,6
JALISCO,14,SAN MIGUEL EL ALTO,078,EL CUADRADO,3,10,0,10,2
JALISCO,14,SAN MIGUEL EL ALTO,078,EL MASTRANZO,2,38,18,20,4
JALISCO,14,SAN MIGUEL EL ALTO,078,EL RINCÓN DE CHÁVEZ,1,7,3,4,1
JALISCO,14,SAN MIGUEL EL ALTO,078,EL RODADILLO,3,46,22,24,3
JALISCO,14,SAN MIGUEL EL ALTO,078,JESÚS MARÍA,2,22,10,12,3
JALISCO,14,SAN MIGUEL EL ALTO,078,LA ANGOSTURA,3,99,45,54,7
JALISCO,14,SAN MIGUEL EL ALTO,078,LA CIÉNEGA,1,13,4,9,1
JALISCO,14,SAN MIGUEL EL ALTO,078,LA PALMA,2,9,5,4,1
JALISCO,14,SAN MIGUEL EL ALTO,078,LA PERILLA,3,19,8,11,2
JALISCO,14,SAN MIGUEL EL ALTO,078,LA TRINIDAD,3,22,13,9,3
JALISCO,14,SAN MIGUEL EL ALTO,078,LAS CARRETAS,2,29,12,17,3
JALISCO,14,SAN MIGUEL EL ALTO,078,LAS MINAS,1,18,11,7,1
JALISCO,14,SAN MIGUEL EL ALTO,078,LLANO DE LOS CONEJOS,2,20,11,9,2
JALISCO,14,SAN MIGUEL EL ALTO,078,LOS CERRITOS,3,22,15,7,2
JALISCO,14,SAN MIGUEL EL ALTO,078,LOS ONCE PUEBLOS,1,17,6,11,2
JALISCO,14,SAN MIGUEL EL ALTO,078,MIRANDILLAS,3,149,57,92,11
JALISCO,14,SAN MIGUEL EL ALTO,078,MONTE ALTO,3,59,24,35,5
JALISCO,14,SAN MIGUEL EL ALTO,078,OJO DE AGUA,2,9,3,6,1
JALISCO,14,SAN MIGUEL EL ALTO,078,SAN JORGE,3,28,13,15,3
JALISCO,14,SAN MIGUEL EL ALTO,078,SAN JOSÉ DE LOS REYNOSO,4,339,176,163,23
JALISCO,14,SAN MIGUEL EL ALTO,078,SAN JOSÉ DEL CUARTO,3,19,8,11,3
JALISCO,14,SAN MIGUEL EL ALTO,078,SAN MIGUEL EL ALTO,37,6263,3167,3096,354
JALISCO,14,SAN MIGUEL EL ALTO,078,SANTA ROSA,3,43,23,20,3
JALISCO,14,SAN MIGUEL EL ALTO,078,SINAGUA,2,22,12,10,2
JALISCO,14,SAN MIGUEL EL ALTO,078,TIERRA BLANCA,1,5,2,3,1
JALISCO,14,GÓMEZ FARÍAS,079,COFRADÍA DEL ROSARIO,2,33,20,13,2
JALISCO,14,GÓMEZ FARÍAS,079,EJIDO UNO DE FEBRERO (SAN NICOLÁS),1,13,4,9,1
JALISCO,14,GÓMEZ FARÍAS,079,EL CORRALITO,3,38,23,15,3
JALISCO,14,GÓMEZ FARÍAS,079,EL RODEO,3,248,128,120,11
JALISCO,14,GÓMEZ FARÍAS,079,LA CALAVERA,3,7,4,3,2
JALISCO,14,GÓMEZ FARÍAS,079,LOS OCUARES,1,2,1,1,1
JALISCO,14,GÓMEZ FARÍAS,079,SAN ANDRÉS IXTLÁN,10,1336,668,668,60
JALISCO,14,GÓMEZ FARÍAS,079,SAN SEBASTIÁN DEL SUR,13,2383,1160,1223,125
JALISCO,14,SAN SEBASTIÁN DEL OESTE,080,AMATANEJO,3,14,4,10,4
JALISCO,14,SAN SEBASTIÁN DEL OESTE,080,COFRADÍA SANTA CRUZ DE CAMOTLÁN,3,23,15,8,4
JALISCO,14,SAN SEBASTIÁN DEL OESTE,080,COLIMILLA,1,6,3,3,1
JALISCO,14,SAN SEBASTIÁN DEL OESTE,080,COPALES (LOS COPALITOS),2,18,12,6,2
JALISCO,14,SAN SEBASTIÁN DEL OESTE,080,EL CARRIZO,3,54,32,22,6
JALISCO,14,SAN SEBASTIÁN DEL OESTE,080,EL TASAJAL,1,5,2,3,1
JALISCO,14,SAN SEBASTIÁN DEL OESTE,080,LA ESTANCIA DE LANDEROS,3,109,50,59,10
JALISCO,14,SAN SEBASTIÁN DEL OESTE,080,LA ESTANZUELA,2,6,1,5,2
JALISCO,14,SAN SEBASTIÁN DEL OESTE,080,LA PALMA (LAS PALMAS),3,29,14,15,3
JALISCO,14,SAN SEBASTIÁN DEL OESTE,080,LA TORTUGA,3,53,26,27,5
JALISCO,14,SAN SEBASTIÁN DEL OESTE,080,LAS MILPILLAS,1,6,3,3,1
JALISCO,14,SAN SEBASTIÁN DEL OESTE,080,LOS CHARCOS,2,21,15,6,2
JALISCO,14,SAN SEBASTIÁN DEL OESTE,080,LOS REYES,1,9,7,2,1
JALISCO,14,SAN SEBASTIÁN DEL OESTE,080,POTRERO DE LOS BARRERA,3,15,11,4,2
JALISCO,14,SAN SEBASTIÁN DEL OESTE,080,PUEBLITO SAN PABLO (EL PUEBLITO),3,53,27,26,4
JALISCO,14,SAN SEBASTIÁN DEL OESTE,080,SAN FELIPE DE HÍJAR,5,364,184,180,31
JALISCO,14,SAN SEBASTIÁN DEL OESTE,080,SAN ISIDRO (LA HACIENDITA),3,22,8,14,3
JALISCO,14,SAN SEBASTIÁN DEL OESTE,080,SAN JUAN DE ARRIBA,1,5,5,0,1
JALISCO,14,SAN SEBASTIÁN DEL OESTE,080,SAN SEBASTIÁN DEL OESTE,4,241,127,114,17
JALISCO,14,SAN SEBASTIÁN DEL OESTE,080,SANTA ANA,1,3,1,2,1
JALISCO,14,SAN SEBASTIÁN DEL OESTE,080,SANTIAGO DE PINOS,3,128,63,65,10
JALISCO,14,SAN SEBASTIÁN DEL OESTE,080,SOYATÁN,3,25,16,9,3
JALISCO,14,SAN SEBASTIÁN DEL OESTE,080,TELEACAPAN,3,15,7,8,2
JALISCO,14,SANTA MARÍA DE LOS ÁNGELES,081,BARRIO DE TAPIAS,2,59,34,25,5
JALISCO,14,SANTA MARÍA DE LOS ÁNGELES,081,COLONIA DIECIOCHO DE MARZO (EL CORRAL DE LOS TOROS),2,9,3,6,2
JALISCO,14,SANTA MARÍA DE LOS ÁNGELES,081,COLONIA VEINTIUNO DE MARZO (LA HIEDRITA),2,43,24,19,3
JALISCO,14,SANTA MARÍA DE LOS ÁNGELES,081,EL FRAILE,2,28,13,15,2
JALISCO,14,SANTA MARÍA DE LOS ÁNGELES,081,HUACASCO (SAN JOSÉ DE HUASCASCO),3,75,43,32,6
JALISCO,14,SANTA MARÍA DE LOS ÁNGELES,081,LAS ÁNIMAS,2,34,16,18,4
JALISCO,14,SANTA MARÍA DE LOS ÁNGELES,081,LAS LIEBRES,3,17,10,7,3
JALISCO,14,SANTA MARÍA DE LOS ÁNGELES,081,LOS SAUCES,2,16,11,5,2
JALISCO,14,SANTA MARÍA DE LOS ÁNGELES,081,SANTA MARÍA DE LOS ÁNGELES,6,413,214,199,38
JALISCO,14,SANTA MARÍA DE LOS ÁNGELES,081,SAUZ DE LOS MÁRQUEZ,3,72,36,36,8
JALISCO,14,SANTA MARÍA DE LOS ÁNGELES,081,TENASCO DE ABAJO,1,4,3,1,1
JALISCO,14,SANTA MARÍA DE LOS ÁNGELES,081,TENASCO DE ARRIBA,3,63,28,35,6
JALISCO,14,SAYULA,082,AMATITLÁN,1,84,44,40,3
JALISCO,14,SAYULA,082,EL REPARO,3,124,60,64,6
JALISCO,14,SAYULA,082,SAYULA,41,7483,3765,3718,430
JALISCO,14,SAYULA,082,USMAJAC,11,2053,1015,1038,109
JALISCO,14,TALA,083,ACACIAS,3,705,354,351,45
JALISCO,14,TALA,083,AHUISCULCO,5,480,248,232,31
JALISCO,14,TALA,083,CASTRO URDIALES (PACANA),3,722,371,351,37
JALISCO,14,TALA,083,CUISILLOS,7,1205,600,605,75
JALISCO,14,TALA,083,CUXPALA,4,342,161,181,12
JALISCO,14,TALA,083,EL RANCHITO (SAN ISIDRO),2,84,34,50,4
JALISCO,14,TALA,083,EL REFUGIO,7,973,455,518,41
JALISCO,14,TALA,083,LA VILLITA,2,184,96,88,8
JALISCO,14,TALA,083,LAS NAVAJAS,4,496,247,249,22
JALISCO,14,TALA,083,LOS RUISEÑORES,12,3420,1654,1766,141
JALISCO,14,TALA,083,SAN ANTONIO MAZATEPEC,2,50,26,24,3
JALISCO,14,TALA,083,SAN IGNACIO DE CARBONERAS,1,19,6,13,1
JALISCO,14,TALA,083,SAN ISIDRO MAZATEPEC,8,1640,823,817,94
JALISCO,14,TALA,083,SAN JUAN DE LOS ARCOS,3,251,125,126,12
JALISCO,14,TALA,083,TALA,54,12339,6118,6221,713
JALISCO,14,TALPA DE ALLENDE,084,CABOS,3,56,32,24,6
JALISCO,14,TALPA DE ALLENDE,084,CONCEPCIÓN DEL BRAMADOR (LA CONCHA),4,83,40,43,8
JALISCO,14,TALPA DE ALLENDE,084,CUALE,2,32,18,14,2
JALISCO,14,TALPA DE ALLENDE,084,DESMORONADO (EL REAL),3,46,28,18,3
JALISCO,14,TALPA DE ALLENDE,084,EL BAÑO,2,27,11,16,5
JALISCO,14,TALPA DE ALLENDE,084,EL BRAMADOR,2,28,14,14,2
JALISCO,14,TALPA DE ALLENDE,084,EL CRUCERO,1,3,2,1,1
JALISCO,14,TALPA DE ALLENDE,084,EL LIMONCILLO,2,10,4,6,2
JALISCO,14,TALPA DE ALLENDE,084,EL NACASTE (LA PAROTA),3,10,6,4,2
JALISCO,14,TALPA DE ALLENDE,084,LA CAÑADA,3,84,43,41,6
JALISCO,14,TALPA DE ALLENDE,084,LA CUESTA,5,153,71,82,13
JALISCO,14,TALPA DE ALLENDE,084,LA CUMBRE DE GUADALUPE (LA CUMBRE DE LOS ARRASTRADOS),3,26,16,10,2
JALISCO,14,TALPA DE ALLENDE,084,LAS COLONIAS,1,6,4,2,1
JALISCO,14,TALPA DE ALLENDE,084,LAS GUÁSIMAS,2,8,5,3,1
JALISCO,14,TALPA DE ALLENDE,084,LAS HORMIGAS,2,8,4,4,2
JALISCO,14,TALPA DE ALLENDE,084,LOS CERRITOS,3,26,15,11,3
JALISCO,14,TALPA DE ALLENDE,084,LOS ENCINOS,1,4,0,4,1
JALISCO,14,TALPA DE ALLENDE,084,LOS LOBOS,3,34,17,17,3
JALISCO,14,TALPA DE ALLENDE,084,LOS OCOTES,3,115,53,62,8
JALISCO,14,TALPA DE ALLENDE,084,LOS ZAPOTES,3,77,30,47,6
JALISCO,14,TALPA DE ALLENDE,084,MURGUÍA,2,8,4,4,1
JALISCO,14,TALPA DE ALLENDE,084,SAN ANDRÉS,3,21,12,9,3
JALISCO,14,TALPA DE ALLENDE,084,SANTA LUCÍA DE LA CUESTA (SANTA LUCÍA),2,9,3,6,1
JALISCO,14,TALPA DE ALLENDE,084,SOYATÁN,1,10,7,3,1
JALISCO,14,TALPA DE ALLENDE,084,TALPA DE ALLENDE,17,2745,1386,1359,151
JALISCO,14,TALPA DE ALLENDE,084,TESCALAMA,2,17,6,11,2
JALISCO,14,TALPA DE ALLENDE,084,TOLEDO,3,40,16,24,3
JALISCO,14,TAMAZULA DE GORDIANO,085,AGUA SALADA,1,6,4,2,1
JALISCO,14,TAMAZULA DE GORDIANO,085,AGUA ZARCA,4,77,46,31,7
JALISCO,14,TAMAZULA DE GORDIANO,085,APATZINGÁN,1,6,4,2,1
JALISCO,14,TAMAZULA DE GORDIANO,085,ARROYO HONDO,3,99,52,47,6
JALISCO,14,TAMAZULA DE GORDIANO,085,CALLEJONES,2,87,41,46,7
JALISCO,14,TAMAZULA DE GORDIANO,085,CAÑADA MESA BLANCA (MESA BLANCA),2,12,5,7,1
JALISCO,14,TAMAZULA DE GORDIANO,085,COFRADÍA DE ABAJO,1,16,9,7,1
JALISCO,14,TAMAZULA DE GORDIANO,085,CUESTA DE SAN LÁZARO,2,26,13,13,2
JALISCO,14,TAMAZULA DE GORDIANO,085,EL AGUACATE,1,7,5,2,1
JALISCO,14,TAMAZULA DE GORDIANO,085,EL ATASCOSO,3,29,15,14,3
JALISCO,14,TAMAZULA DE GORDIANO,085,EL CAPULÍN,2,8,5,3,1
JALISCO,14,TAMAZULA DE GORDIANO,085,EL LIMÓN,2,9,6,3,2
JALISCO,14,TAMAZULA DE GORDIANO,085,EL PITAHAYO,3,78,44,34,6
JALISCO,14,TAMAZULA DE GORDIANO,085,EL RODEO,1,4,1,3,1
JALISCO,14,TAMAZULA DE GORDIANO,085,EL TARAY,3,79,37,42,6
JALISCO,14,TAMAZULA DE GORDIANO,085,EL TULILLO,3,87,39,48,6
JALISCO,14,TAMAZULA DE GORDIANO,085,EL VELADERO,3,85,52,33,6
JALISCO,14,TAMAZULA DE GORDIANO,085,HACIENDA VIEJA,1,6,3,3,1
JALISCO,14,TAMAZULA DE GORDIANO,085,HIGUERAS SAN MIGUEL,2,22,10,12,2
JALISCO,14,TAMAZULA DE GORDIANO,085,JOYA DE LOS INDIOS,2,5,3,2,2
JALISCO,14,TAMAZULA DE GORDIANO,085,LA ALBERCA,3,40,16,24,5
JALISCO,14,TAMAZULA DE GORDIANO,085,LA ESTANCIA,2,159,82,77,9
JALISCO,14,TAMAZULA DE GORDIANO,085,LA GARITA,5,341,179,162,21
JALISCO,14,TAMAZULA DE GORDIANO,085,LA JOYA DEL SALTO (CAÑADA DEL SALTO),1,12,8,4,1
JALISCO,14,TAMAZULA DE GORDIANO,085,LA PALMITA,3,17,10,7,3
JALISCO,14,TAMAZULA DE GORDIANO,085,LA PEÑA COLORADA,2,17,10,7,2
JALISCO,14,TAMAZULA DE GORDIANO,085,LA ROSA,1,6,3,3,1
JALISCO,14,TAMAZULA DE GORDIANO,085,LA SIDRA,1,9,4,5,1
JALISCO,14,TAMAZULA DE GORDIANO,085,LA YERBABUENA,2,66,28,38,5
JALISCO,14,TAMAZULA DE GORDIANO,085,LAS JUNTAS DE MOTA (LAS JUNTAS),1,11,6,5,1
JALISCO,14,TAMAZULA DE GORDIANO,085,LAS VALLAS,2,37,18,19,3
JALISCO,14,TAMAZULA DE GORDIANO,085,LOS CIMIENTOS,2,4,1,3,2
JALISCO,14,TAMAZULA DE GORDIANO,085,LOS GATOS Y ANEXOS (RANCHO DEL PADRE),4,60,33,27,6
JALISCO,14,TAMAZULA DE GORDIANO,085,LOS RUSIOS (RUSIOS DE ABAJO),1,1,0,1,1
JALISCO,14,TAMAZULA DE GORDIANO,085,MESA BLANCA,1,8,4,4,1
JALISCO,14,TAMAZULA DE GORDIANO,085,MORELOS (SANTA ROSA),3,169,82,87,16
JALISCO,14,TAMAZULA DE GORDIANO,085,NIGROMANTE (SAN JUAN DE LA MONTAÑA),3,53,30,23,5
JALISCO,14,TAMAZULA DE GORDIANO,085,NUEVO CENTRO DE POBLACIÓN EL CORDONCILLO,2,25,11,14,2
JALISCO,14,TAMAZULA DE GORDIANO,085,ONCE PUEBLOS,1,12,9,3,1
JALISCO,14,TAMAZULA DE GORDIANO,085,PASO DE GANADO,2,82,39,43,5
JALISCO,14,TAMAZULA DE GORDIANO,085,PORTEZUELO NUEVO,1,12,6,6,1
JALISCO,14,TAMAZULA DE GORDIANO,085,POTRERO DEL SALTO,1,16,5,11,1
JALISCO,14,TAMAZULA DE GORDIANO,085,RINCÓN DEL AGUACATE,1,16,7,9,2
JALISCO,14,TAMAZULA DE GORDIANO,085,SAN FERNANDO,1,1,1,0,1
JALISCO,14,TAMAZULA DE GORDIANO,085,SAN FRANCISCO,3,152,80,72,11
JALISCO,14,TAMAZULA DE GORDIANO,085,SAN VICENTE,2,190,87,103,8
JALISCO,14,TAMAZULA DE GORDIANO,085,SOYATLÁN DE AFUERA,6,365,183,182,18
JALISCO,14,TAMAZULA DE GORDIANO,085,SOYATLÁN DE LA PRESA (LA PRESA),3,59,28,31,5
JALISCO,14,TAMAZULA DE GORDIANO,085,TAMAZULA DE GORDIANO,37,5893,2907,2986,388
JALISCO,14,TAMAZULA DE GORDIANO,085,VILLA DE CONTLA (CONTLA),5,526,277,249,32
JALISCO,14,TAMAZULA DE GORDIANO,085,VISTA HERMOSA (SANTA CRUZ DEL CORTIJO),6,906,457,449,47
JALISCO,14,TAPALPA,086,ATACCO,5,1127,551,576,55
JALISCO,14,TAPALPA,086,BUENAVISTA,4,133,73,60,6
JALISCO,14,TAPALPA,086,COPALA,2,117,55,62,5
JALISCO,14,TAPALPA,086,EL PITAHAYO DE LA PROVIDENCIA,1,9,4,5,1
JALISCO,14,TAPALPA,086,EL TACAMO,3,12,6,6,2
JALISCO,14,TAPALPA,086,FERRERÍA DE TULA,3,125,68,57,8
JALISCO,14,TAPALPA,086,JUANACATLÁN,4,1037,507,530,33
JALISCO,14,TAPALPA,086,LA BARRANCA DEL REFUGIO,2,47,19,28,3
JALISCO,14,TAPALPA,086,LA CAÑADA TEZCALTILTI,2,47,25,22,3
JALISCO,14,TAPALPA,086,LA COFRADÍA DEL ROSARIO,1,17,8,9,2
JALISCO,14,TAPALPA,086,LA CRUZ,3,84,38,46,5
JALISCO,14,TAPALPA,086,LA LAGUNILLA,4,122,54,68,9
JALISCO,14,TAPALPA,086,LA PROVIDENCIA,1,29,11,18,2
JALISCO,14,TAPALPA,086,LA VARILLITA,1,9,4,5,1
JALISCO,14,TAPALPA,086,LAS GALERAS,2,13,9,4,1
JALISCO,14,TAPALPA,086,LAS MORAS,2,13,7,6,1
JALISCO,14,TAPALPA,086,LOMA ALTA,1,49,25,24,3
JALISCO,14,TAPALPA,086,LOS ESPINOS,4,270,133,137,14
JALISCO,14,TAPALPA,086,LOS ROBLES,1,17,5,12,1
JALISCO,14,TAPALPA,086,OJO DE AGUA,1,8,5,3,1
JALISCO,14,TAPALPA,086,PUEBLO NUEVO,2,87,50,37,4
JALISCO,14,TAPALPA,086,PUNTA DE AGUA,2,45,21,24,3
JALISCO,14,TAPALPA,086,SAN ANTONIO (SAN ANTONIO DE PADUA),3,317,159,158,14
JALISCO,14,TAPALPA,086,SAN FRANCISCO DE TULA (SAN FRANCISQUITO),3,36,15,21,3
JALISCO,14,TAPALPA,086,SAN ISIDRO DE LA PROVIDENCIA,1,12,8,4,1
JALISCO,14,TAPALPA,086,SAN MARTÍN DE LAS FLORES,2,106,48,58,5
JALISCO,14,TAPALPA,086,SAN MIGUEL,3,45,29,16,4
JALISCO,14,TAPALPA,086,SAN PEDRO (EL CUIZ),1,10,5,5,1
JALISCO,14,TAPALPA,086,TAPALPA,15,2509,1251,1258,119
JALISCO,14,TAPALPA,086,YERBABUENA,3,94,41,53,6
JALISCO,14,TECALITLÁN,087,ACUEDUCTO [FRACCIONAMIENTO],4,968,480,488,94
JALISCO,14,TECALITLÁN,087,AHUIJULLO,3,38,15,23,5
JALISCO,14,TECALITLÁN,087,ALOTITLÁN,3,14,2,12,2
JALISCO,14,TECALITLÁN,087,BARRANCA DE LOS ALTOS (LLANITOS),2,6,4,2,1
JALISCO,14,TECALITLÁN,087,CANUTILLO,3,16,11,5,2
JALISCO,14,TECALITLÁN,087,CARDO SANTO,1,12,7,5,1
JALISCO,14,TECALITLÁN,087,COLOMITOS,2,4,0,4,2
JALISCO,14,TECALITLÁN,087,CRUCERO LA PLOMOSA,2,20,14,6,2
JALISCO,14,TECALITLÁN,087,EL RAYO,3,26,15,11,3
JALISCO,14,TECALITLÁN,087,EL TIGRE,3,26,10,16,2
JALISCO,14,TECALITLÁN,087,EL VARAL,3,12,4,8,2
JALISCO,14,TECALITLÁN,087,LA AMARILLERA,3,6,6,0,2
JALISCO,14,TECALITLÁN,087,LA LISTONA,2,4,2,2,1
JALISCO,14,TECALITLÁN,087,LA MESA DE SAN ANTONIO,2,6,0,6,2
JALISCO,14,TECALITLÁN,087,LA MESITA,3,5,1,4,2
JALISCO,14,TECALITLÁN,087,LA PLOMOSA,2,15,6,9,2
JALISCO,14,TECALITLÁN,087,LA PURÍSIMA,2,122,62,60,7
JALISCO,14,TECALITLÁN,087,LAS ÁNIMAS,3,4,2,2,2
JALISCO,14,TECALITLÁN,087,LAS MARAVILLAS,3,18,10,8,2
JALISCO,14,TECALITLÁN,087,LLANITO DE PIEDRAS VERDES,3,12,6,6,2
JALISCO,14,TECALITLÁN,087,LOS AGUACATES,3,3,2,1,2
JALISCO,14,TECALITLÁN,087,LOS BORREGOS (LAS BORREGAS),2,13,4,9,2
JALISCO,14,TECALITLÁN,087,MESA EL GRINGO,1,11,5,6,1
JALISCO,14,TECALITLÁN,087,MEZCALITOS,2,4,1,3,1
JALISCO,14,TECALITLÁN,087,SAN ISIDRO,2,13,5,8,2
JALISCO,14,TECALITLÁN,087,SAN PEDRO,2,13,7,6,2
JALISCO,14,TECALITLÁN,087,SANTIAGO,2,24,15,9,2
JALISCO,14,TECALITLÁN,087,TECALITLÁN,16,2472,1253,1219,107
JALISCO,14,TECOLOTLÁN,088,AMBROSIO,1,15,7,8,1
JALISCO,14,TECOLOTLÁN,088,AYOTITLÁN,4,332,151,181,22
JALISCO,14,TECOLOTLÁN,088,COFRADÍA DE DUENDES,3,141,60,81,8
JALISCO,14,TECOLOTLÁN,088,EL GUAJOLOTE (RANCHO ALVARADO),2,15,6,9,2
JALISCO,14,TECOLOTLÁN,088,EL RODEO VIEJO (EL COPAL COLORADO),2,27,14,13,2
JALISCO,14,TECOLOTLÁN,088,LA CIÉNEGA,2,9,4,5,1
JALISCO,14,TECOLOTLÁN,088,LAS CALAVERAS (EJIDO TENEXTITLÁN),1,17,9,8,1
JALISCO,14,TECOLOTLÁN,088,LINDAVISTA (LAS PLAZUELAS),1,4,2,2,1
JALISCO,14,TECOLOTLÁN,088,LOS AILES,2,26,12,14,2
JALISCO,14,TECOLOTLÁN,088,LOS CUARTOS,1,1,0,1,1
JALISCO,14,TECOLOTLÁN,088,OJO DE AGUA,2,58,27,31,4
JALISCO,14,TECOLOTLÁN,088,PALO ALTO,3,94,54,40,6
JALISCO,14,TECOLOTLÁN,088,PUERTAS CUATAS,2,157,77,80,6
JALISCO,14,TECOLOTLÁN,088,QUILA,4,265,144,121,16
JALISCO,14,TECOLOTLÁN,088,QUILILLA,3,113,52,61,8
JALISCO,14,TECOLOTLÁN,088,SAN BUENAVENTURA,1,8,5,3,1
JALISCO,14,TECOLOTLÁN,088,SAN JOSÉ,2,31,15,16,3
JALISCO,14,TECOLOTLÁN,088,SAN RAFAEL,3,33,19,14,4
JALISCO,14,TECOLOTLÁN,088,TAMAZULITA,4,294,146,148,19
JALISCO,14,TECOLOTLÁN,088,TECOLOTLÁN,19,2338,1174,1164,160
JALISCO,14,TECOLOTLÁN,088,TENEXTITLÁN,1,21,14,7,2
JALISCO,14,TECOLOTLÁN,088,VILLEGAS DE ABAJO,1,5,4,1,1
JALISCO,14,TECOLOTLÁN,088,VILLEGAS DE ARRIBA,3,55,26,29,6
JALISCO,14,TECHALUTA DE MONTENEGRO,089,ANOCA,2,32,15,17,3
JALISCO,14,TECHALUTA DE MONTENEGRO,089,EL AGUA DEL SAUCO,2,6,4,2,2
JALISCO,14,TECHALUTA DE MONTENEGRO,089,EL ZAPOTE (SAN MIGUEL DEL ZAPOTE),3,120,51,69,9
JALISCO,14,TECHALUTA DE MONTENEGRO,089,LA HERMOSURA,2,55,27,28,3
JALISCO,14,TECHALUTA DE MONTENEGRO,089,TECHALUTA DE MONTENEGRO,7,749,364,385,45
JALISCO,14,TENAMAXTLÁN,090,COLOTITLÁN,3,156,78,78,9
JALISCO,14,TENAMAXTLÁN,090,JUANACATLÁN,3,138,78,60,10
JALISCO,14,TENAMAXTLÁN,090,MIRAPLANES,2,9,4,5,2
JALISCO,14,TENAMAXTLÁN,090,PALO BLANCO,1,11,6,5,1
JALISCO,14,TENAMAXTLÁN,090,SAN IGNACIO,2,17,7,10,2
JALISCO,14,TENAMAXTLÁN,090,TENAMAXTLÁN,14,1453,731,722,121
JALISCO,14,TEOCALTICHE,091,AGUA TINTA ABAJO,4,233,129,104,15
JALISCO,14,TEOCALTICHE,091,AHUETITA DE ABAJO,3,54,29,25,4
JALISCO,14,TEOCALTICHE,091,AHUETITA DE ENMEDIO (LA CAPILLA),1,23,13,10,2
JALISCO,14,TEOCALTICHE,091,ANALCO,3,39,23,16,4
JALISCO,14,TEOCALTICHE,091,BELÉN DEL REFUGIO,5,820,438,382,43
JALISCO,14,TEOCALTICHE,091,BUENAVISTA,2,16,11,5,2
JALISCO,14,TEOCALTICHE,091,CALERITA,1,2,0,2,1
JALISCO,14,TEOCALTICHE,091,CERRITO COLORADO,1,9,2,7,2
JALISCO,14,TEOCALTICHE,091,CERRO DE LOS GREGORIOS,1,21,10,11,1
JALISCO,14,TEOCALTICHE,091,CORRAL BLANCO,3,45,26,19,4
JALISCO,14,TEOCALTICHE,091,EL BARRIO,1,49,20,29,3
JALISCO,14,TEOCALTICHE,091,EL DIVISADERO,2,7,4,3,2
JALISCO,14,TEOCALTICHE,091,EL PUEBLITO,3,30,14,16,4
JALISCO,14,TEOCALTICHE,091,EL ROSARIO,4,171,79,92,12
JALISCO,14,TEOCALTICHE,091,EL SALITRE,3,131,66,65,8
JALISCO,14,TEOCALTICHE,091,EL SANTO,3,11,7,4,2
JALISCO,14,TEOCALTICHE,091,EL SAUCITO,3,32,19,13,3
JALISCO,14,TEOCALTICHE,091,EL SOYATAL,3,74,44,30,5
JALISCO,14,TEOCALTICHE,091,EL TABLERO,1,9,5,4,1
JALISCO,14,TEOCALTICHE,091,GAVILÁN DE ABAJO,3,52,27,25,6
JALISCO,14,TEOCALTICHE,091,GAVILÁN DE ARRIBA,2,21,7,14,2
JALISCO,14,TEOCALTICHE,091,HUEJOTITLÁN,3,273,137,136,12
JALISCO,14,TEOCALTICHE,091,JOSÉ DE JESÚS AGUIRRE,3,133,66,67,9
JALISCO,14,TEOCALTICHE,091,LA CALERA,3,178,69,109,9
JALISCO,14,TEOCALTICHE,091,LA CAPILLA,3,24,12,12,3
JALISCO,14,TEOCALTICHE,091,LA HACIENDITA,1,23,17,6,2
JALISCO,14,TEOCALTICHE,091,LA PARRITA,2,35,22,13,3
JALISCO,14,TEOCALTICHE,091,LA TRINIDAD,3,26,15,11,4
JALISCO,14,TEOCALTICHE,091,LAS CAÑADAS,2,31,13,18,3
JALISCO,14,TEOCALTICHE,091,LAS FLORES,3,40,18,22,4
JALISCO,14,TEOCALTICHE,091,LAS TROJES,1,6,2,4,1
JALISCO,14,TEOCALTICHE,091,LOS PÉREZ,1,11,3,8,1
JALISCO,14,TEOCALTICHE,091,LOS POCITOS,2,29,16,13,3
JALISCO,14,TEOCALTICHE,091,MASCUA,3,25,8,17,4
JALISCO,14,TEOCALTICHE,091,MECHOACANEJO,5,699,352,347,33
JALISCO,14,TEOCALTICHE,091,OSTOTÁN,3,17,8,9,2
JALISCO,14,TEOCALTICHE,091,PASO DE LA CANOA,3,28,15,13,4
JALISCO,14,TEOCALTICHE,091,PROVIDENCIA SAN MARTÍN,2,14,7,7,1
JALISCO,14,TEOCALTICHE,091,RANCHO MAYOR,2,22,7,15,2
JALISCO,14,TEOCALTICHE,091,RANCHO NUEVO,3,46,29,17,5
JALISCO,14,TEOCALTICHE,091,SAN ANTONIO DE CALERA (SAN ANTONIO),2,29,14,15,3
JALISCO,14,TEOCALTICHE,091,SAN BERNARDO,2,16,9,7,2
JALISCO,14,TEOCALTICHE,091,SAN ISIDRO DE RAMÍREZ (SAN ISIDRO),3,82,37,45,7
JALISCO,14,TEOCALTICHE,091,SAN JOSÉ DE AJOJÚCAR,2,33,11,22,3
JALISCO,14,TEOCALTICHE,091,SAN JOSÉ DE LA HACIENDITA,1,7,4,3,1
JALISCO,14,TEOCALTICHE,091,SANTA BÁRBARA,1,10,4,6,1
JALISCO,14,TEOCALTICHE,091,TEOCALTICHE,35,5839,2990,2849,383
JALISCO,14,TEOCALTICHE,091,VILLA DE ORNELAS (ORNELAS),4,119,55,64,11
JALISCO,14,TEOCUITATLÁN DE CORONA,092,ATOTONILCO,2,38,22,16,3
JALISCO,14,TEOCUITATLÁN DE CORONA,092,CHAMACUERO,2,36,18,18,3
JALISCO,14,TEOCUITATLÁN DE CORONA,092,CITALA,5,415,201,214,26
JALISCO,14,TEOCUITATLÁN DE CORONA,092,COLONIAS DEL GAVILÁN (FÉLIX RAMOS),2,56,23,33,4
JALISCO,14,TEOCUITATLÁN DE CORONA,092,HUEJOTITLÁN (LA PEÑA),3,17,7,10,3
JALISCO,14,TEOCUITATLÁN DE CORONA,092,LA LOBERA,1,11,8,3,1
JALISCO,14,TEOCUITATLÁN DE CORONA,092,LA MILPILLA,3,114,52,62,7
JALISCO,14,TEOCUITATLÁN DE CORONA,092,LÁZARO CÁRDENAS,2,15,8,7,2
JALISCO,14,TEOCUITATLÁN DE CORONA,092,PUERTA DE CITALA,2,59,30,29,4
JALISCO,14,TEOCUITATLÁN DE CORONA,092,SAN JOSÉ DE GRACIA,3,185,88,97,23
JALISCO,14,TEOCUITATLÁN DE CORONA,092,SAN JUAN CITALA,3,98,52,46,7
JALISCO,14,TEOCUITATLÁN DE CORONA,092,SANTA ROSA,3,97,49,48,6
JALISCO,14,TEOCUITATLÁN DE CORONA,092,TEHUANTEPEC,3,79,40,39,6
JALISCO,14,TEOCUITATLÁN DE CORONA,092,TEOCUITATLÁN DE CORONA,10,1161,561,600,66
JALISCO,14,TEOCUITATLÁN DE CORONA,092,TIERRA BLANCA,1,8,3,5,1
JALISCO,14,TEPATITLÁN DE MORELOS,093,AGUA BLANCA,2,43,23,20,3
JALISCO,14,TEPATITLÁN DE MORELOS,093,AGUA ESCONDIDA,2,38,18,20,3
JALISCO,14,TEPATITLÁN DE MORELOS,093,AGUA NEGRA,2,30,17,13,3
JALISCO,14,TEPATITLÁN DE MORELOS,093,ATOTONILQUILLO (FÁTIMA),2,66,25,41,4
JALISCO,14,TEPATITLÁN DE MORELOS,093,BARRANCA DE LOS LAURELES,3,6,3,3,2
JALISCO,14,TEPATITLÁN DE MORELOS,093,BUENAVISTA,4,188,96,92,10
JALISCO,14,TEPATITLÁN DE MORELOS,093,CALABAZAS (CALABAZAS DE ABAJO),2,46,27,19,3
JALISCO,14,TEPATITLÁN DE MORELOS,093,CAPILLA DE GUADALUPE,25,4523,2287,2236,259
JALISCO,14,TEPATITLÁN DE MORELOS,093,CAPILLA DE MILPILLAS (MILPILLAS),3,594,292,302,33
JALISCO,14,TEPATITLÁN DE MORELOS,093,CERRO DE LA CAMPANA,1,5,3,2,1
JALISCO,14,TEPATITLÁN DE MORELOS,093,CÓRDOBA DE ABAJO,1,11,5,6,1
JALISCO,14,TEPATITLÁN DE MORELOS,093,EL AGUACATE,3,19,12,7,2
JALISCO,14,TEPATITLÁN DE MORELOS,093,EL BAJÍO DE PLASCENCIA,2,67,28,39,4
JALISCO,14,TEPATITLÁN DE MORELOS,093,EL CACALOTE,2,36,18,18,3
JALISCO,14,TEPATITLÁN DE MORELOS,093,EL CAPULÍN (EL CAPULÍN ZARCO),1,6,4,2,1
JALISCO,14,TEPATITLÁN DE MORELOS,093,EL CENTRO,2,29,10,19,3
JALISCO,14,TEPATITLÁN DE MORELOS,093,EL CHISPEADERO (EL CHISPEADERO DE ARRIBA),2,68,43,25,3
JALISCO,14,TEPATITLÁN DE MORELOS,093,EL CUATRO (POSTA EL CUATRO),2,62,23,39,3
JALISCO,14,TEPATITLÁN DE MORELOS,093,EL ESPINO DE ARRIBA,3,36,14,22,3
JALISCO,14,TEPATITLÁN DE MORELOS,093,EL GUAYABO DE ARRIBA,2,33,17,16,3
JALISCO,14,TEPATITLÁN DE MORELOS,093,EL LAUREL,2,40,19,21,4
JALISCO,14,TEPATITLÁN DE MORELOS,093,EL PANTANO DE ABAJO,2,8,6,2,2
JALISCO,14,TEPATITLÁN DE MORELOS,093,EL PINTO,1,16,7,9,1
JALISCO,14,TEPATITLÁN DE MORELOS,093,EL POCHOTE,3,134,71,63,8
JALISCO,14,TEPATITLÁN DE MORELOS,093,EL RAMBLAS (RAMBLAS GRANDE),1,10,8,2,1
JALISCO,14,TEPATITLÁN DE MORELOS,093,EL SAUZ,1,7,6,1,1
JALISCO,14,TEPATITLÁN DE MORELOS,093,EL TEJOCOTE,1,22,9,13,2
JALISCO,14,TEPATITLÁN DE MORELOS,093,EL TEPETATE,1,36,17,19,2
JALISCO,14,TEPATITLÁN DE MORELOS,093,EL TERRERITO,1,9,5,4,1
JALISCO,14,TEPATITLÁN DE MORELOS,093,EL TERRERO,3,34,19,15,3
JALISCO,14,TEPATITLÁN DE MORELOS,093,LA CEBADILLA,3,60,29,31,6
JALISCO,14,TEPATITLÁN DE MORELOS,093,LA CIÉNEGA,2,27,15,12,2
JALISCO,14,TEPATITLÁN DE MORELOS,093,LA CRUZ,1,11,8,3,1
JALISCO,14,TEPATITLÁN DE MORELOS,093,LA GE,2,4,3,1,1
JALISCO,14,TEPATITLÁN DE MORELOS,093,LA LOMA,1,67,35,32,3
JALISCO,14,TEPATITLÁN DE MORELOS,093,LA LOMA DEL PESCADERO,1,15,14,1,1
JALISCO,14,TEPATITLÁN DE MORELOS,093,LA MANGA,2,55,26,29,3
JALISCO,14,TEPATITLÁN DE MORELOS,093,LA MESA DEL GUITARRERO (MESA DE LA GUITARRA),3,86,38,48,5
JALISCO,14,TEPATITLÁN DE MORELOS,093,LA MINA,1,10,4,6,1
JALISCO,14,TEPATITLÁN DE MORELOS,093,LA MOTA,2,65,30,35,4
JALISCO,14,TEPATITLÁN DE MORELOS,093,LA SOLEDAD,1,32,15,17,2
JALISCO,14,TEPATITLÁN DE MORELOS,093,LAGUNA PRIETA,2,7,4,3,2
JALISCO,14,TEPATITLÁN DE MORELOS,093,LAGUNILLAS,1,11,6,5,1
JALISCO,14,TEPATITLÁN DE MORELOS,093,LAS CRUCES DE ARRIBA,3,51,23,28,4
JALISCO,14,TEPATITLÁN DE MORELOS,093,LAS CUATRO MILPAS (EL TEPAME),1,25,12,13,2
JALISCO,14,TEPATITLÁN DE MORELOS,093,LAS HUERTAS,1,16,6,10,1
JALISCO,14,TEPATITLÁN DE MORELOS,093,LAS OJEDA,1,31,12,19,2
JALISCO,14,TEPATITLÁN DE MORELOS,093,LAS PALOMAS,2,20,9,11,2
JALISCO,14,TEPATITLÁN DE MORELOS,093,LATILLAS,3,25,10,15,3
JALISCO,14,TEPATITLÁN DE MORELOS,093,LOMAS DE PALOS ALTOS,1,10,5,5,1
JALISCO,14,TEPATITLÁN DE MORELOS,093,LONDRES,1,6,5,1,1
JALISCO,14,TEPATITLÁN DE MORELOS,093,LOS CERRITOS,3,93,42,51,7
JALISCO,14,TEPATITLÁN DE MORELOS,093,LOS CHARCOS,3,127,63,64,8
JALISCO,14,TEPATITLÁN DE MORELOS,093,LOS MAGUEYES,3,38,16,22,3
JALISCO,14,TEPATITLÁN DE MORELOS,093,LOS PICACHOS,1,19,6,13,1
JALISCO,14,TEPATITLÁN DE MORELOS,093,LOS SAUCES,2,106,52,54,7
JALISCO,14,TEPATITLÁN DE MORELOS,093,LOS SAUCES [FRACCIONAMIENTO],1,37,15,22,2
JALISCO,14,TEPATITLÁN DE MORELOS,093,MAZATITLÁN,2,37,20,17,3
JALISCO,14,TEPATITLÁN DE MORELOS,093,MESA DE LOS VEGA,2,24,10,14,2
JALISCO,14,TEPATITLÁN DE MORELOS,093,MEZCALA,3,425,238,187,18
JALISCO,14,TEPATITLÁN DE MORELOS,093,MILPILLAS DE ABAJO,1,24,11,13,2
JALISCO,14,TEPATITLÁN DE MORELOS,093,NOPALERA DE GONZÁLEZ (LA NOPALERA),2,48,23,25,3
JALISCO,14,TEPATITLÁN DE MORELOS,093,OJO DE AGUA DE ACEVES (SANTA CRUZ),3,98,44,54,6
JALISCO,14,TEPATITLÁN DE MORELOS,093,OJO DE AGUA DE BECERRAS,3,35,19,16,3
JALISCO,14,TEPATITLÁN DE MORELOS,093,OJO DE AGUA DE HERNÁNDEZ,1,3,1,2,1
JALISCO,14,TEPATITLÁN DE MORELOS,093,OJO DE AGUA DE LATILLAS,4,454,258,196,30
JALISCO,14,TEPATITLÁN DE MORELOS,093,PALETA CHICA,1,5,1,4,1
JALISCO,14,TEPATITLÁN DE MORELOS,093,PASO DE CARRETAS,2,35,23,12,3
JALISCO,14,TEPATITLÁN DE MORELOS,093,PEGUEROS,10,1194,603,591,63
JALISCO,14,TEPATITLÁN DE MORELOS,093,PIEDRA BLANCA,2,36,25,11,3
JALISCO,14,TEPATITLÁN DE MORELOS,093,PRESA DE GÓMEZ,3,39,23,16,4
JALISCO,14,TEPATITLÁN DE MORELOS,093,PUERTA DE ACAHUALES,3,94,47,47,6
JALISCO,14,TEPATITLÁN DE MORELOS,093,RAMBLAS GRANDE,1,9,7,2,1
JALISCO,14,TEPATITLÁN DE MORELOS,093,RANCHO VIEJO,1,15,7,8,1
JALISCO,14,TEPATITLÁN DE MORELOS,093,RINCÓN DE VELÁZQUEZ,2,20,12,8,2
JALISCO,14,TEPATITLÁN DE MORELOS,093,SACAMECATE,1,11,4,7,1
JALISCO,14,TEPATITLÁN DE MORELOS,093,SACAMECATES,1,36,19,17,2
JALISCO,14,TEPATITLÁN DE MORELOS,093,SAN ANTONIO DE LOS FRANCO (SAN ANTONIO),2,37,16,21,3
JALISCO,14,TEPATITLÁN DE MORELOS,093,SAN BARTOLO DE ARRIBA,1,11,6,5,1
JALISCO,14,TEPATITLÁN DE MORELOS,093,SAN DIEGO,3,47,22,25,4
JALISCO,14,TEPATITLÁN DE MORELOS,093,SAN FRANCISCO,3,33,15,18,4
JALISCO,14,TEPATITLÁN DE MORELOS,093,SAN JOSÉ DE BAZARTE (LA VILLA),4,242,118,124,13
JALISCO,14,TEPATITLÁN DE MORELOS,093,SAN JOSÉ DE GRACIA,11,1163,598,565,64
JALISCO,14,TEPATITLÁN DE MORELOS,093,SAN PABLO,2,70,33,37,4
JALISCO,14,TEPATITLÁN DE MORELOS,093,SAN RAMÓN,1,22,10,12,1
JALISCO,14,TEPATITLÁN DE MORELOS,093,SANTA ANA,1,9,5,4,1
JALISCO,14,TEPATITLÁN DE MORELOS,093,SANTA BÁRBARA,2,54,27,27,3
JALISCO,14,TEPATITLÁN DE MORELOS,093,SANTANA DE ABAJO,1,23,11,12,2
JALISCO,14,TEPATITLÁN DE MORELOS,093,TECOMATLÁN,4,394,190,204,18
JALISCO,14,TEPATITLÁN DE MORELOS,093,TEPATITLÁN DE MORELOS,148,32120,16889,15231,1941
JALISCO,14,TEQUILA,094,APANICO,2,9,3,6,1
JALISCO,14,TEQUILA,094,ATEMANICA,3,49,21,28,5
JALISCO,14,TEQUILA,094,BELÉN,1,4,4,0,1
JALISCO,14,TEQUILA,094,CHILTILLO,3,15,5,10,2
JALISCO,14,TEQUILA,094,EL ÁLAMO (LOS ÁLAMOS),1,17,8,9,2
JALISCO,14,TEQUILA,094,EL CÓBANO,3,71,35,36,6
JALISCO,14,TEQUILA,094,EL COLOMO,1,4,3,1,1
JALISCO,14,TEQUILA,094,EL LIMÓN,4,35,20,15,4
JALISCO,14,TEQUILA,094,EL LLANITO,3,5,3,2,2
JALISCO,14,TEQUILA,094,EL LLANO (LA PRESA),1,2,1,1,1
JALISCO,14,TEQUILA,094,EL MEDINEÑO,3,164,78,86,9
JALISCO,14,TEQUILA,094,EL OLVIDO,3,79,38,41,5
JALISCO,14,TEQUILA,094,EL SALVADOR,9,1100,554,546,54
JALISCO,14,TEQUILA,094,EL TEPETATE,3,34,19,15,3
JALISCO,14,TEQUILA,094,EL ZAPOTE,2,24,12,12,2
JALISCO,14,TEQUILA,094,JALPILLA,3,36,21,15,3
JALISCO,14,TEQUILA,094,JOSEFA ORTÍZ DE DOMÍNGUEZ,2,118,56,62,5
JALISCO,14,TEQUILA,094,LA COFRADÍA,1,154,79,75,6
JALISCO,14,TEQUILA,094,LA CULEBRA,3,14,8,6,3
JALISCO,14,TEQUILA,094,LA LABOR,3,18,7,11,3
JALISCO,14,TEQUILA,094,LA LAGUNILLA,2,19,9,10,2
JALISCO,14,TEQUILA,094,LA MATITA,3,30,18,12,2
JALISCO,14,TEQUILA,094,LA PUERTA DE SAN PEDRO (LA PUERTA DE ENMEDIO),2,32,12,20,2
JALISCO,14,TEQUILA,094,LOS ÁLAMOS,1,9,4,5,1
JALISCO,14,TEQUILA,094,LOS NARANJOS (EL NARANJO),3,10,3,7,2
JALISCO,14,TEQUILA,094,LOS TANQUES,1,46,20,26,2
JALISCO,14,TEQUILA,094,MITLÁN,3,53,29,24,4
JALISCO,14,TEQUILA,094,OCOTIQUE,3,9,8,1,2
JALISCO,14,TEQUILA,094,OJO DE AGUA,1,7,1,6,1
JALISCO,14,TEQUILA,094,OJOS DE AGUA,1,10,8,2,1
JALISCO,14,TEQUILA,094,PALMITOS,3,56,36,20,5
JALISCO,14,TEQUILA,094,POTRERO DE LOS RIVERA,3,33,13,20,3
JALISCO,14,TEQUILA,094,SAN GASPAR,2,4,2,2,2
JALISCO,14,TEQUILA,094,SAN JOSÉ,1,8,4,4,1
JALISCO,14,TEQUILA,094,SAN MARTÍN DE LAS CAÑAS,3,243,118,125,12
JALISCO,14,TEQUILA,094,SAN PEDRO ANALCO,3,76,34,42,6
JALISCO,14,TEQUILA,094,SAN PEDRO DE LOS LANDEROS,2,18,8,10,2
JALISCO,14,TEQUILA,094,SANTA ANA (LAS ÁNIMAS),2,22,15,7,2
JALISCO,14,TEQUILA,094,SANTA TERESA,3,369,188,181,14
JALISCO,14,TEQUILA,094,TAPEXCO,3,47,26,21,4
JALISCO,14,TEQUILA,094,TEQUILA,47,10248,5127,5121,621
JALISCO,14,TEQUILA,094,TLALTIHUILEC (SAN JOSÉ DEL REFUGIO),3,32,18,14,3
JALISCO,14,TEQUILA,094,TUITÁN,3,75,41,34,6
JALISCO,14,TEUCHITLÁN,095,EL AMARILLO,2,80,30,50,5
JALISCO,14,TEUCHITLÁN,095,GENERAL LUCIO BLANCO (LA MORA),2,51,30,21,5
JALISCO,14,TEUCHITLÁN,095,LA ESTANZUELA,4,516,249,267,23
JALISCO,14,TEUCHITLÁN,095,LA VEGA,3,318,151,167,22
JALISCO,14,TEUCHITLÁN,095,TEUCHITLÁN,9,1059,535,524,66
JALISCO,14,TIZAPÁN EL ALTO,096,CHURINCIO,3,6,3,3,2
JALISCO,14,TIZAPÁN EL ALTO,096,COLONIA MADERO (LA PRESA),3,26,13,13,3
JALISCO,14,TIZAPÁN EL ALTO,096,EL REFUGIO,3,50,25,25,5
JALISCO,14,TIZAPÁN EL ALTO,096,EL VOLANTÍN,3,78,42,36,7
JALISCO,14,TIZAPÁN EL ALTO,096,EL ZAPOTE,3,54,28,26,5
JALISCO,14,TIZAPÁN EL ALTO,096,LA CAÑADA,2,56,23,33,4
JALISCO,14,TIZAPÁN EL ALTO,096,LA ROSA AMARILLA,3,32,13,19,3
JALISCO,14,TIZAPÁN EL ALTO,096,LOS SAUCES,3,9,6,3,2
JALISCO,14,TIZAPÁN EL ALTO,096,MISMALOYA,3,210,118,92,11
JALISCO,14,TIZAPÁN EL ALTO,096,TIZAPÁN EL ALTO,25,4268,2189,2079,185
JALISCO,14,TIZAPÁN EL ALTO,096,VILLA DEL LAGO (EL BARATILLO),2,9,4,5,1
JALISCO,14,TIZAPÁN EL ALTO,096,VILLA EMILIANO ZAPATA (EJIDO MODELO),5,635,316,319,25
JALISCO,14,TLAJOMULCO DE ZÚÑIGA,097,ACATITLÁN (LOS RANCHITOS),2,26,10,16,2
JALISCO,14,TLAJOMULCO DE ZÚÑIGA,097,BUENAVISTA,4,677,349,328,36
JALISCO,14,TLAJOMULCO DE ZÚÑIGA,097,CAJITITLÁN,20,5592,2898,2694,294
JALISCO,14,TLAJOMULCO DE ZÚÑIGA,097,CIMA DEL SOL (FRACCIONAMIENTO CIMA DEL SOL),6,2012,966,1046,84
JALISCO,14,TLAJOMULCO DE ZÚÑIGA,097,COFRADÍA,3,543,264,279,23
JALISCO,14,TLAJOMULCO DE ZÚÑIGA,097,COLINAS DEL ROBLE,1,24,16,8,3
JALISCO,14,TLAJOMULCO DE ZÚÑIGA,097,CRUZ VIEJA (SOLEDAD DE CRUZ VIEJA),2,99,50,49,5
JALISCO,14,TLAJOMULCO DE ZÚÑIGA,097,CUEXCOMATITLÁN,4,640,307,333,34
JALISCO,14,TLAJOMULCO DE ZÚÑIGA,097,EL CAPULÍN,13,4263,2087,2176,180
JALISCO,14,TLAJOMULCO DE ZÚÑIGA,097,EL MIRADOR,2,73,36,37,4
JALISCO,14,TLAJOMULCO DE ZÚÑIGA,097,EL REFUGIO,2,211,99,112,8
JALISCO,14,TLAJOMULCO DE ZÚÑIGA,097,EL TECOLOTE,1,6,3,3,1
JALISCO,14,TLAJOMULCO DE ZÚÑIGA,097,GALAXIA LA NORIA,4,1538,723,815,44
JALISCO,14,TLAJOMULCO DE ZÚÑIGA,097,HACIENDA LOS FRESNOS,6,2250,1072,1178,110
JALISCO,14,TLAJOMULCO DE ZÚÑIGA,097,HACIENDA SANTA FE,68,30015,14762,15253,1242
JALISCO,14,TLAJOMULCO DE ZÚÑIGA,097,JARDINES DE LA CALERA,2,143,74,69,8
JALISCO,14,TLAJOMULCO DE ZÚÑIGA,097,JARDINES DE SAN SEBASTIÁN,2,884,419,465,24
JALISCO,14,TLAJOMULCO DE ZÚÑIGA,097,LA ALAMEDA,9,2894,1461,1433,110
JALISCO,14,TLAJOMULCO DE ZÚÑIGA,097,LA CALERA,4,706,348,358,28
JALISCO,14,TLAJOMULCO DE ZÚÑIGA,097,LA CAÑADA,3,34,12,22,3
JALISCO,14,TLAJOMULCO DE ZÚÑIGA,097,LA ESPERANZA,1,7,4,3,1
JALISCO,14,TLAJOMULCO DE ZÚÑIGA,097,LA PIEDRERA,2,756,387,369,38
JALISCO,14,TLAJOMULCO DE ZÚÑIGA,097,LA PURÍSIMA [FRACCIONAMIENTO],2,742,368,374,21
JALISCO,14,TLAJOMULCO DE ZÚÑIGA,097,LA TIJERA,32,4773,2437,2336,315
JALISCO,14,TLAJOMULCO DE ZÚÑIGA,097,LA UNIÓN DEL CUATRO (SAN JOSÉ DEL VALLE),73,26650,13579,13071,1097
JALISCO,14,TLAJOMULCO DE ZÚÑIGA,097,LOMAS DE TEJEDA,7,4795,2783,2012,300
JALISCO,14,TLAJOMULCO DE ZÚÑIGA,097,LOMAS DEL SUR,28,11409,5570,5839,400
JALISCO,14,TLAJOMULCO DE ZÚÑIGA,097,LOS GAVILANES,18,3849,2019,1830,353
JALISCO,14,TLAJOMULCO DE ZÚÑIGA,097,LOS OCOTES,2,78,42,36,5
JALISCO,14,TLAJOMULCO DE ZÚÑIGA,097,LOS RANCHITOS (LOS CHARCOS),1,10,5,5,1
JALISCO,14,TLAJOMULCO DE ZÚÑIGA,097,LOS SAUCES [FRACCIONAMIENTO],1,40,10,30,2
JALISCO,14,TLAJOMULCO DE ZÚÑIGA,097,PALOMAR,7,712,367,345,39
JALISCO,14,TLAJOMULCO DE ZÚÑIGA,097,RANCHO ALEGRE [FRACCIONAMIENTO],5,1227,613,614,49
JALISCO,14,TLAJOMULCO DE ZÚÑIGA,097,SAN AGUSTÍN,75,12375,6163,6212,618
JALISCO,14,TLAJOMULCO DE ZÚÑIGA,097,SAN JUAN EVANGELISTA (SAN JUAN),3,605,308,297,23
JALISCO,14,TLAJOMULCO DE ZÚÑIGA,097,SAN LUCAS EVANGELISTA,4,809,400,409,35
JALISCO,14,TLAJOMULCO DE ZÚÑIGA,097,SAN MIGUEL CUYUTLÁN,11,2569,1313,1256,106
JALISCO,14,TLAJOMULCO DE ZÚÑIGA,097,SAN SEBASTIÁN EL GRANDE,41,9080,4531,4549,425
JALISCO,14,TLAJOMULCO DE ZÚÑIGA,097,SANTA CRUZ DE LA LOMA (TEPETATES),2,250,119,131,8
JALISCO,14,TLAJOMULCO DE ZÚÑIGA,097,SANTA CRUZ DE LAS FLORES,18,5029,2412,2617,289
JALISCO,14,TLAJOMULCO DE ZÚÑIGA,097,SANTA CRUZ DEL VALLE,41,14645,7332,7313,559
JALISCO,14,TLAJOMULCO DE ZÚÑIGA,097,TLAJOMULCO DE ZÚÑIGA,67,21664,10707,10957,974
JALISCO,14,TLAJOMULCO DE ZÚÑIGA,097,ZAPOTE DEL VALLE (ZAPOTE DE SANTA CRUZ),8,2558,1181,1377,118
JALISCO,14,SAN PEDRO TLAQUEPAQUE,098,COLONIA NIÑOS HÉROES (OJO DE AGUA) [FRACCIONAMIENTO],4,513,227,286,22
JALISCO,14,SAN PEDRO TLAQUEPAQUE,098,LA CALERILLA,2,285,135,150,9
JALISCO,14,SAN PEDRO TLAQUEPAQUE,098,LAS POMAS,2,180,81,99,9
JALISCO,14,SAN PEDRO TLAQUEPAQUE,098,SAN MARTÍN DE LAS FLORES DE ABAJO (LA ABADÍA) [FRACCIONAMIENTO],17,6027,3043,2984,243
JALISCO,14,SAN PEDRO TLAQUEPAQUE,098,SANTA ANITA,39,10275,5318,4957,577
JALISCO,14,SAN PEDRO TLAQUEPAQUE,098,TLAQUEPAQUE,524,147719,74363,73356,9978
JALISCO,14,TOLIMÁN,099,CERRO DE VILLA,3,8,2,6,2
JALISCO,14,TOLIMÁN,099,COPALA,6,1051,479,572,54
JALISCO,14,TOLIMÁN,099,CUAUHTÉMOC,2,39,17,22,3
JALISCO,14,TOLIMÁN,099,EL BOLITAR (ZOPOMA),1,9,4,5,1
JALISCO,14,TOLIMÁN,099,EL PASO REAL,4,143,66,77,9
JALISCO,14,TOLIMÁN,099,EL POCHOTE,2,170,83,87,8
JALISCO,14,TOLIMÁN,099,EL RODEO,3,37,17,20,3
JALISCO,14,TOLIMÁN,099,HUISICHI,3,91,41,50,6
JALISCO,14,TOLIMÁN,099,LA HUARACHA (LA TRINIDAD),2,123,55,68,2
JALISCO,14,TOLIMÁN,099,LA LAGUNA,2,11,6,5,1
JALISCO,14,TOLIMÁN,099,LA LIMA,1,6,3,3,1
JALISCO,14,TOLIMÁN,099,LA LOMA,2,5,2,3,1
JALISCO,14,TOLIMÁN,099,LA PAROTA (LOMA DE SAN ANTONIO),3,122,61,61,8
JALISCO,14,TOLIMÁN,099,LAS CANOAS,3,129,59,70,8
JALISCO,14,TOLIMÁN,099,LLANO DE TOXÍN,2,18,9,9,2
JALISCO,14,TOLIMÁN,099,LOS CERRITOS,2,6,4,2,1
JALISCO,14,TOLIMÁN,099,NUEVO ZOPOMA (EL BOLITAR),1,7,2,5,1
JALISCO,14,TOLIMÁN,099,PUEBLO VIEJO,2,23,7,16,2
JALISCO,14,TOLIMÁN,099,PUERTA DEL PETACAL (EL PETACAL),2,52,25,27,3
JALISCO,14,TOLIMÁN,099,SAN PEDRO TOXÍN,4,208,98,110,10
JALISCO,14,TOLIMÁN,099,SANTA ELENA (SANTA ELENA DE LA CRUZ),3,222,111,111,11
JALISCO,14,TOLIMÁN,099,TEUTLÁN,4,114,57,57,11
JALISCO,14,TOLIMÁN,099,TOLIMÁN,5,593,290,303,37
JALISCO,14,TOLIMÁN,099,TOXÍN,3,26,17,9,3
JALISCO,14,TOMATLÁN,100,BENITO JUÁREZ (ADOLFO RUIZ CORTINES),2,22,8,14,2
JALISCO,14,TOMATLÁN,100,CABREL,3,37,16,21,4
JALISCO,14,TOMATLÁN,100,CACALUTA,3,9,5,4,2
JALISCO,14,TOMATLÁN,100,CAMPO ACOSTA,8,807,388,419,37
JALISCO,14,TOMATLÁN,100,CIMARRONAS,3,20,9,11,2
JALISCO,14,TOMATLÁN,100,COLONIA LAS PALMAS [CAMPAMENTO SAGAR],1,23,13,10,2
JALISCO,14,TOMATLÁN,100,CRUCERO DE LA CRUZ DE LORETO,1,12,7,5,1
JALISCO,14,TOMATLÁN,100,EL AVALITO,1,10,5,5,1
JALISCO,14,TOMATLÁN,100,EL COCO,3,42,19,23,3
JALISCO,14,TOMATLÁN,100,EL CORRIDO,3,64,31,33,7
JALISCO,14,TOMATLÁN,100,EL CRIADERO,2,24,10,14,3
JALISCO,14,TOMATLÁN,100,EL CRIADERO (CRIADEROS),1,2,0,2,1
JALISCO,14,TOMATLÁN,100,EL CRUCERO,2,19,10,9,3
JALISCO,14,TOMATLÁN,100,EL GUAMÚCHIL,3,21,4,17,3
JALISCO,14,TOMATLÁN,100,EL LIMÓN,3,20,8,12,2
JALISCO,14,TOMATLÁN,100,EL MAPACHE,3,89,47,42,6
JALISCO,14,TOMATLÁN,100,EL NARANJO,1,7,3,4,1
JALISCO,14,TOMATLÁN,100,EL NARANJO (LOS PINOS),1,2,0,2,1
JALISCO,14,TOMATLÁN,100,EL OCOTILLO,3,21,13,8,2
JALISCO,14,TOMATLÁN,100,EL PORTEZUELO,2,30,12,18,3
JALISCO,14,TOMATLÁN,100,EL REALITO,3,42,27,15,4
JALISCO,14,TOMATLÁN,100,EL TIGRE,2,34,11,23,4
JALISCO,14,TOMATLÁN,100,EL TULE,4,267,145,122,26
JALISCO,14,TOMATLÁN,100,EMILIANO ZAPATA YAUTEPEC (AGUA ZARCA),2,60,25,35,4
JALISCO,14,TOMATLÁN,100,GARGANTILLO (LA HACIENDA),5,275,144,131,19
JALISCO,14,TOMATLÁN,100,HIDALGO,1,19,10,9,1
JALISCO,14,TOMATLÁN,100,HIGUERA BLANCA,2,32,14,18,3
JALISCO,14,TOMATLÁN,100,JOSÉ MARÍA MORELOS,10,936,451,485,54
JALISCO,14,TOMATLÁN,100,JOSÉ MARÍA PINO SUÁREZ (NUEVO NAHUAPA),10,1059,562,497,62
JALISCO,14,TOMATLÁN,100,LA CRUZ DE LORETO,7,546,285,261,36
JALISCO,14,TOMATLÁN,100,LA CUMBRE,4,289,128,161,15
JALISCO,14,TOMATLÁN,100,LA GLORIA,3,183,87,96,12
JALISCO,14,TOMATLÁN,100,LA PINTADA,2,23,8,15,2
JALISCO,14,TOMATLÁN,100,LAS PARTIDAS,3,13,7,6,2
JALISCO,14,TOMATLÁN,100,LAS PILITAS,1,10,5,5,1
JALISCO,14,TOMATLÁN,100,LÁZARO CÁRDENAS (LA NANCY),3,150,78,72,8
JALISCO,14,TOMATLÁN,100,LLANO DEL TORO,1,36,17,19,3
JALISCO,14,TOMATLÁN,100,LLANO GRANDE,4,269,141,128,17
JALISCO,14,TOMATLÁN,100,LÓPEZ MATEOS,2,5,1,4,2
JALISCO,14,TOMATLÁN,100,LOS ÁNGELES,3,27,19,8,2
JALISCO,14,TOMATLÁN,100,LOS DIQUES,1,11,6,5,1
JALISCO,14,TOMATLÁN,100,LOS TERREROS,5,209,89,120,13
JALISCO,14,TOMATLÁN,100,MALOBACO,3,33,16,17,3
JALISCO,14,TOMATLÁN,100,NAHUAPA,2,22,11,11,2
JALISCO,14,TOMATLÁN,100,NINGUNO [ASERRADERO],3,14,8,6,2
JALISCO,14,TOMATLÁN,100,NUEVO SANTIAGO,2,73,41,32,6
JALISCO,14,TOMATLÁN,100,PALMILLAS,1,13,9,4,1
JALISCO,14,TOMATLÁN,100,PILOTO (CORRALITO DE PILOTO),3,32,11,21,3
JALISCO,14,TOMATLÁN,100,PLAN DE AYALA,3,218,103,115,13
JALISCO,14,TOMATLÁN,100,POCHOTITÁN,3,40,21,19,4
JALISCO,14,TOMATLÁN,100,PRESA CAJÓN DE PEÑA (LA PRESA),3,36,15,21,3
JALISCO,14,TOMATLÁN,100,PUENTECILLAS,1,12,5,7,1
JALISCO,14,TOMATLÁN,100,SAN IGNACIO (JUAN IGNACIO),2,9,8,1,3
JALISCO,14,TOMATLÁN,100,SAN RAFAEL DE LOS MORENO,4,164,75,89,16
JALISCO,14,TOMATLÁN,100,SANTA GERTRUDIS,3,40,22,18,4
JALISCO,14,TOMATLÁN,100,TEOCINTE (TEOCINTLE),2,22,9,13,3
JALISCO,14,TOMATLÁN,100,TEQUESQUITE,3,216,113,103,18
JALISCO,14,TOMATLÁN,100,TOMATLÁN,18,2727,1405,1322,193
JALISCO,14,TOMATLÁN,100,VALLE DE MAJAHUAS (EL POBLADO),2,27,13,14,3
JALISCO,14,TOMATLÁN,100,VICENTE GUERRERO (LAS LOMAS COLORADAS),1,45,18,27,2
JALISCO,14,TONALÁ,101,AGUA BLANCA,1,35,16,19,2
JALISCO,14,TONALÁ,101,COYULA,33,10093,4937,5156,415
JALISCO,14,TONALÁ,101,EL TEPAME,2,554,99,455,56
JALISCO,14,TONALÁ,101,EL VADO,4,449,210,239,17
JALISCO,14,TONALÁ,101,LA PUNTA,10,2121,1033,1088,81
JALISCO,14,TONALÁ,101,LOS AMIALES,3,80,35,45,6
JALISCO,14,TONALÁ,101,MISMALOYA (FRACCIONAMIENTO PEDREGAL DE SANTA MARTHA),2,196,102,94,10
JALISCO,14,TONALÁ,101,NINGUNO [CAMPAMENTO COLIMILLA],1,111,56,55,4
JALISCO,14,TONALÁ,101,PASEO DE LAS CAÑADAS,4,9802,5517,4285,546
JALISCO,14,TONALÁ,101,PUENTE GRANDE,13,1817,900,917,105
JALISCO,14,TONALÁ,101,SAN FRANCISCO DE LA SOLEDAD (SAN FRANCISCO),9,1663,844,819,48
JALISCO,14,TONALÁ,101,TONALÁ,412,103176,51554,51622,5727
JALISCO,14,TONAYA,102,AMACUAUTITLÁN,1,15,6,9,1
JALISCO,14,TONAYA,102,COATLANCILLO,3,118,52,66,9
JALISCO,14,TONAYA,102,EL CERRITO,4,43,22,21,6
JALISCO,14,TONAYA,102,EL PASO DE SAN FRANCISCO,1,6,5,1,1
JALISCO,14,TONAYA,102,LA COFRADÍA,2,25,16,9,3
JALISCO,14,TONAYA,102,LA PIÑA,1,8,1,7,1
JALISCO,14,TONAYA,102,LAS HIGUERAS,3,34,20,14,4
JALISCO,14,TONAYA,102,LAS LIEBRES (LA LIEBRE),1,5,3,2,1
JALISCO,14,TONAYA,102,LOS ASMOLES,2,30,15,15,2
JALISCO,14,TONAYA,102,LOS GONZÁLEZ,1,5,3,2,1
JALISCO,14,TONAYA,102,METAPAN,1,17,10,7,1
JALISCO,14,TONAYA,102,SANTA GERTRUDIS,1,13,7,6,1
JALISCO,14,TONAYA,102,TONAYA,10,1199,575,624,73
JALISCO,14,TONILA,103,EJIDO POBLADO JUAN BARRAGÁN,1,14,6,8,1
JALISCO,14,TONILA,103,LA COFRADÍA,2,85,45,40,6
JALISCO,14,TONILA,103,LA ESPERANZA,2,38,15,23,4
JALISCO,14,TONILA,103,SAN MARCOS,4,489,261,228,24
JALISCO,14,TONILA,103,TENEXCAMILPA,3,180,80,100,22
JALISCO,14,TONILA,103,TONILA,6,767,390,377,55
JALISCO,14,TOTATICHE,104,ACASPULCO,2,14,10,4,2
JALISCO,14,TOTATICHE,104,ACATEPULCO,2,8,4,4,2
JALISCO,14,TOTATICHE,104,AGUA ZARCA,1,4,2,2,1
JALISCO,14,TOTATICHE,104,ARROYO DE RAMÍREZ,1,14,9,5,1
JALISCO,14,TOTATICHE,104,BALCONES DE CRISTO REY,1,7,1,6,1
JALISCO,14,TOTATICHE,104,CIÉNEGA DE SANTA ROSA (LA CIÉNEGA),1,11,5,6,1
JALISCO,14,TOTATICHE,104,LA CEMENTERA,3,40,20,20,3
JALISCO,14,TOTATICHE,104,SANTA LUCÍA,1,1,1,0,1
JALISCO,14,TOTATICHE,104,SANTA MARÍA DE GRACIA,2,15,9,6,2
JALISCO,14,TOTATICHE,104,SANTA RITA,2,62,36,26,4
JALISCO,14,TOTATICHE,104,TEMASTIÁN (LA CANTERA),4,288,144,144,23
JALISCO,14,TOTATICHE,104,TOTATICHE,7,631,276,355,64
JALISCO,14,TOTOTLÁN,105,CARROZAS,3,273,134,139,16
JALISCO,14,TOTOTLÁN,105,COINA GRANDE,5,101,60,41,7
JALISCO,14,TOTOTLÁN,105,CUESTA CHICA,2,39,19,20,3
JALISCO,14,TOTOTLÁN,105,CUESTA DE OVEJAS,1,17,11,6,2
JALISCO,14,TOTOTLÁN,105,CUESTA GRANDE,1,30,21,9,2
JALISCO,14,TOTOTLÁN,105,EL DIQUE (SAN JOSÉ DE LOS RÍOS),1,9,5,4,1
JALISCO,14,TOTOTLÁN,105,EL PUERTO DEL SABINO,1,2,2,0,1
JALISCO,14,TOTOTLÁN,105,GARABATOS,1,32,15,17,2
JALISCO,14,TOTOTLÁN,105,LA CAJA DE AGUA,1,39,17,22,4
JALISCO,14,TOTOTLÁN,105,LA FLOREÑA,2,55,29,26,4
JALISCO,14,TOTOTLÁN,105,LA FLORIDA,2,47,19,28,4
JALISCO,14,TOTOTLÁN,105,LA HUARACHA,2,14,6,8,2
JALISCO,14,TOTOTLÁN,105,LA ISLA,4,136,65,71,8
JALISCO,14,TOTOTLÁN,105,LA LAJA DE GÓMEZ,1,14,7,7,1
JALISCO,14,TOTOTLÁN,105,LA TIRICIA,1,8,2,6,1
JALISCO,14,TOTOTLÁN,105,LAS ERAS,2,43,22,21,3
JALISCO,14,TOTOTLÁN,105,LOS OJOS DE AGUA,1,8,4,4,1
JALISCO,14,TOTOTLÁN,105,MESA DE ANAYA (EL AMILOTE),1,11,3,8,1
JALISCO,14,TOTOTLÁN,105,MORALES DE GUERRERO,1,6,4,2,1
JALISCO,14,TOTOTLÁN,105,NUEVO REFUGIO DE AFUERA (NUEVO REFUGIO),5,497,265,232,22
JALISCO,14,TOTOTLÁN,105,PALO DULCE,2,34,15,19,3
JALISCO,14,TOTOTLÁN,105,RAMBLAS CHICO,2,79,51,28,6
JALISCO,14,TOTOTLÁN,105,RÍOS DE RUIZ,1,12,6,6,2
JALISCO,14,TOTOTLÁN,105,SAN AGUSTÍN (CAPULINES),2,61,34,27,4
JALISCO,14,TOTOTLÁN,105,SAN ANTONIO DE GÓMEZ,1,67,33,34,4
JALISCO,14,TOTOTLÁN,105,SAN FRANCISCO DE LA CAL,2,336,163,173,14
JALISCO,14,TOTOTLÁN,105,SAN ISIDRO,3,219,105,114,11
JALISCO,14,TOTOTLÁN,105,SAN JOSÉ DEL MONTE (TRONERAS),1,8,2,6,1
JALISCO,14,TOTOTLÁN,105,SAN RAMÓN,2,20,11,9,2
JALISCO,14,TOTOTLÁN,105,TOTOTLÁN,18,2685,1369,1316,148
JALISCO,14,TOTOTLÁN,105,UNIÓN DE GUADALUPE,3,82,44,38,5
JALISCO,14,TOTOTLÁN,105,YERBABUENA,1,9,3,6,1
JALISCO,14,TUXCACUESCO,106,APULCO,1,23,14,9,2
JALISCO,14,TUXCACUESCO,106,CHACHAHUATLÁN,2,41,22,19,3
JALISCO,14,TUXCACUESCO,106,EL CAMICHÍN,4,83,40,43,8
JALISCO,14,TUXCACUESCO,106,EL CEBOLLAL,2,270,126,144,9
JALISCO,14,TUXCACUESCO,106,EL PLATANAR,1,19,7,12,2
JALISCO,14,TUXCACUESCO,106,EL REPARITO,2,11,8,3,2
JALISCO,14,TUXCACUESCO,106,EL TEMASCAL,2,15,8,7,2
JALISCO,14,TUXCACUESCO,106,LA CAÑITA,3,72,36,36,5
JALISCO,14,TUXCACUESCO,106,LA PIEDRA,3,6,2,4,2
JALISCO,14,TUXCACUESCO,106,LA ROSA,1,48,26,22,3
JALISCO,14,TUXCACUESCO,106,LOS GONZÁLEZ,3,69,36,33,5
JALISCO,14,TUXCACUESCO,106,LOS NOXTLES,2,8,4,4,1
JALISCO,14,TUXCACUESCO,106,SAN MIGUEL,4,166,82,84,10
JALISCO,14,TUXCACUESCO,106,TUXCACUESCO,10,639,337,302,38
JALISCO,14,TUXCACUESCO,106,VENTANAS,2,11,6,5,2
JALISCO,14,TUXCACUESCO,106,ZENZONTLA,3,76,36,40,7
JALISCO,14,TUXCUECA,107,EL SAUCITO,1,33,12,21,2
JALISCO,14,TUXCUECA,107,EL TEPEGUAJE,3,73,32,41,5
JALISCO,14,TUXCUECA,107,LAS CEBOLLAS,4,110,54,56,6
JALISCO,14,TUXCUECA,107,PURUAGUA DE RAMÓN CORONA,1,24,13,11,2
JALISCO,14,TUXCUECA,107,SAN LUIS SOYATLÁN,8,1025,512,513,48
JALISCO,14,TUXCUECA,107,SAN NICOLÁS DE ACUÑA (SAN NICOLÁS),2,148,60,88,7
JALISCO,14,TUXCUECA,107,TUXCUECA,5,400,217,183,20
JALISCO,14,TUXPAN,108,AGOSTO,3,221,114,107,14
JALISCO,14,TUXPAN,108,ATENQUIQUE,4,210,88,122,12
JALISCO,14,TUXPAN,108,BUEN PAÍS,2,28,12,16,3
JALISCO,14,TUXPAN,108,EJIDO POBLADO ATENQUIQUE,2,20,7,13,2
JALISCO,14,TUXPAN,108,EL NUEVO POBLADO,2,54,27,27,4
JALISCO,14,TUXPAN,108,EL PARAÍSO,2,11,7,4,1
JALISCO,14,TUXPAN,108,HACIENDA SAN MAMÉS,2,109,61,48,6
JALISCO,14,TUXPAN,108,LA HIGUERA,4,282,146,136,21
JALISCO,14,TUXPAN,108,LAS CANOAS,1,10,3,7,1
JALISCO,14,TUXPAN,108,LOS LAURELES,2,29,13,16,3
JALISCO,14,TUXPAN,108,LOS MAZOS,2,24,15,9,2
JALISCO,14,TUXPAN,108,MONTELONGO,1,23,8,15,2
JALISCO,14,TUXPAN,108,PADILLA,1,4,1,3,1
JALISCO,14,TUXPAN,108,PASO DE SAN JUAN,2,31,13,18,3
JALISCO,14,TUXPAN,108,PIALLA,2,6,6,0,1
JALISCO,14,TUXPAN,108,PLATANAR,2,76,33,43,6
JALISCO,14,TUXPAN,108,PLATANARILLO,1,18,12,6,1
JALISCO,14,TUXPAN,108,RANCHO NIÑO,3,41,18,23,4
JALISCO,14,TUXPAN,108,SAN JUAN ESPANATICA (EL PUEBLITO),2,161,76,85,8
JALISCO,14,TUXPAN,108,SANTA MARÍA,1,5,2,3,1
JALISCO,14,TUXPAN,108,TUXPAN,35,7310,3597,3713,381
JALISCO,14,TUXPAN,108,VEINTIUNO DE NOVIEMBRE,3,96,51,45,17
JALISCO,14,UNIÓN DE SAN ANTONIO,109,ARRONERAS DE LOURDES (ARRONERAS),2,10,4,6,1
JALISCO,14,UNIÓN DE SAN ANTONIO,109,ARROYO DEL PALO,1,44,16,28,3
JALISCO,14,UNIÓN DE SAN ANTONIO,109,CAÑADA DE MENA,2,33,14,19,3
JALISCO,14,UNIÓN DE SAN ANTONIO,109,CHARCO REDONDO (FÁTIMA),1,30,13,17,2
JALISCO,14,UNIÓN DE SAN ANTONIO,109,CHURINTZIO,1,8,2,6,1
JALISCO,14,UNIÓN DE SAN ANTONIO,109,EJIDO LAS AGUJAS (EL MAGUEY),1,40,8,32,2
JALISCO,14,UNIÓN DE SAN ANTONIO,109,EL CEDRO,1,39,17,22,3
JALISCO,14,UNIÓN DE SAN ANTONIO,109,EL JARAL,1,6,2,4,1
JALISCO,14,UNIÓN DE SAN ANTONIO,109,EL LOBO (EL LOBO DE PRIMAVERA),1,8,3,5,1
JALISCO,14,UNIÓN DE SAN ANTONIO,109,EL SALTILLO DE VELÁZQUEZ,1,4,1,3,1
JALISCO,14,UNIÓN DE SAN ANTONIO,109,EL SAUCILLO DE PRIMAVERA,2,153,82,71,7
JALISCO,14,UNIÓN DE SAN ANTONIO,109,HALCONEROS,1,32,8,24,2
JALISCO,14,UNIÓN DE SAN ANTONIO,109,LA LOMA ALTA (ESTACIÓN LOMA ALTA),2,13,9,4,2
JALISCO,14,UNIÓN DE SAN ANTONIO,109,LA NORIA (LAS NORIAS DE LAS VUELTAS),3,68,35,33,5
JALISCO,14,UNIÓN DE SAN ANTONIO,109,LA ROSA DE CASTILLA (EJIDO JARAMILLO DE ABAJO),2,159,74,85,8
JALISCO,14,UNIÓN DE SAN ANTONIO,109,LA TRINIDAD,4,104,46,58,8
JALISCO,14,UNIÓN DE SAN ANTONIO,109,LAS PRESITAS,2,49,22,27,3
JALISCO,14,UNIÓN DE SAN ANTONIO,109,LAS TORTUGAS,1,154,67,87,6
JALISCO,14,UNIÓN DE SAN ANTONIO,109,LLANOS DE BASILIO,3,34,16,18,3
JALISCO,14,UNIÓN DE SAN ANTONIO,109,LOMA DE SOTELOS,2,85,40,45,5
JALISCO,14,UNIÓN DE SAN ANTONIO,109,LOMA DEL AIRE (LOMITA DEL AIRE),1,10,1,9,1
JALISCO,14,UNIÓN DE SAN ANTONIO,109,LOMAS DE SANTA GERTRUDIS,3,66,33,33,5
JALISCO,14,UNIÓN DE SAN ANTONIO,109,LOS CUARTOS (LOS CUARTOS DE PRIMAVERA),1,7,5,2,1
JALISCO,14,UNIÓN DE SAN ANTONIO,109,PALO ALTO,1,17,12,5,2
JALISCO,14,UNIÓN DE SAN ANTONIO,109,PEDRITO [ESTACIÓN],1,52,30,22,3
JALISCO,14,UNIÓN DE SAN ANTONIO,109,PRIMAVERA (HACIENDA DE PRIMAVERA),1,8,4,4,1
JALISCO,14,UNIÓN DE SAN ANTONIO,109,RÍO DE VÁZQUEZ,1,30,14,16,2
JALISCO,14,UNIÓN DE SAN ANTONIO,109,SALTO ZURITA,1,19,10,9,1
JALISCO,14,UNIÓN DE SAN ANTONIO,109,SAN ANTONIO DE LA GARZA,2,50,25,25,4
JALISCO,14,UNIÓN DE SAN ANTONIO,109,SAN BARTOLO DE GONZÁLEZ (SAN BARTOLO),1,74,34,40,4
JALISCO,14,UNIÓN DE SAN ANTONIO,109,SAN IGNACIO,3,46,24,22,4
JALISCO,14,UNIÓN DE SAN ANTONIO,109,SAN JOSÉ DE GORDOA,3,66,33,33,4
JALISCO,14,UNIÓN DE SAN ANTONIO,109,SAN JOSÉ DE LAS PALMAS,4,118,63,55,8
JALISCO,14,UNIÓN DE SAN ANTONIO,109,SAN JOSÉ DEL CALICHE (EL CALICHE),4,429,208,221,18
JALISCO,14,UNIÓN DE SAN ANTONIO,109,SAN JOSÉ EL ALTO,1,5,2,3,1
JALISCO,14,UNIÓN DE SAN ANTONIO,109,SANTA TERESA,1,40,20,20,3
JALISCO,14,UNIÓN DE SAN ANTONIO,109,SANTILLANES,1,22,11,11,1
JALISCO,14,UNIÓN DE SAN ANTONIO,109,TLACUITAPAN,4,245,154,91,14
JALISCO,14,UNIÓN DE SAN ANTONIO,109,UNIÓN DE SAN ANTONIO,13,2276,1151,1125,125
JALISCO,14,UNIÓN DE SAN ANTONIO,109,VIZCAÍNO,3,39,18,21,4
JALISCO,14,UNIÓN DE TULA,110,COLONIA TRIGOMIL,2,74,42,32,5
JALISCO,14,UNIÓN DE TULA,110,IXTLAHUACÁN DE SANTIAGO,2,63,28,35,5
JALISCO,14,UNIÓN DE TULA,110,LA PIÑUELA,2,41,20,21,3
JALISCO,14,UNIÓN DE TULA,110,MANZANILLITO,1,12,4,8,1
JALISCO,14,UNIÓN DE TULA,110,RANCHO EL TERRERO,1,18,8,10,1
JALISCO,14,UNIÓN DE TULA,110,SAN AGUSTÍN (EL CARRIZAL),2,34,19,15,4
JALISCO,14,UNIÓN DE TULA,110,SAN CAYETANO,3,67,35,32,4
JALISCO,14,UNIÓN DE TULA,110,SAN CLEMENTE,4,218,103,115,23
JALISCO,14,UNIÓN DE TULA,110,SAN GASPAR,2,50,23,27,4
JALISCO,14,UNIÓN DE TULA,110,SAN JOSÉ DE ÁVILA,2,21,12,9,3
JALISCO,14,UNIÓN DE TULA,110,SANTA ANA,1,10,2,8,1
JALISCO,14,UNIÓN DE TULA,110,SANTA FE,1,9,3,6,1
JALISCO,14,UNIÓN DE TULA,110,SANTA ROSA DE LIMA (SANTA ROSA),3,40,20,20,4
JALISCO,14,UNIÓN DE TULA,110,TACOTÁN (LA ALPATAHUA),6,294,153,141,17
JALISCO,14,UNIÓN DE TULA,110,UNIÓN DE TULA,21,2840,1540,1300,219
JALISCO,14,VALLE DE GUADALUPE,111,CARRETERO DE ABAJO,2,36,21,15,3
JALISCO,14,VALLE DE GUADALUPE,111,EL OCOTE,2,32,14,18,3
JALISCO,14,VALLE DE GUADALUPE,111,FALDA DE RAMBLAS,1,47,27,20,3
JALISCO,14,VALLE DE GUADALUPE,111,JOYA DE ARRIBA,3,18,8,10,2
JALISCO,14,VALLE DE GUADALUPE,111,LA BAILADORA,3,41,22,19,4
JALISCO,14,VALLE DE GUADALUPE,111,LA MANGA,3,35,11,24,3
JALISCO,14,VALLE DE GUADALUPE,111,PUERTA DE MACIAS,2,22,5,17,2
JALISCO,14,VALLE DE GUADALUPE,111,RANCHO BUENAVISTA (EL RODEO),1,6,3,3,1
JALISCO,14,VALLE DE GUADALUPE,111,SALTO DE AGUA (SALTO DE LOS ÍÑIGUEZ),2,22,11,11,2
JALISCO,14,VALLE DE GUADALUPE,111,SAN RAFAEL,2,21,10,11,2
JALISCO,14,VALLE DE GUADALUPE,111,VALLE DE GUADALUPE,9,1493,772,721,71
JALISCO,14,VALLE DE JUÁREZ,112,BUENAVISTA,2,48,22,26,3
JALISCO,14,VALLE DE JUÁREZ,112,CUATRO ENCINOS,1,13,6,7,1
JALISCO,14,VALLE DE JUÁREZ,112,EL ALGODÓN,3,262,122,140,18
JALISCO,14,VALLE DE JUÁREZ,112,EL MANZANILLO,1,1,1,0,1
JALISCO,14,VALLE DE JUÁREZ,112,EL MORAL,2,5,2,3,1
JALISCO,14,VALLE DE JUÁREZ,112,EL TIGRE,2,7,2,5,2
JALISCO,14,VALLE DE JUÁREZ,112,NOGALES DE AÑIL (LOS NOGALES),2,6,4,2,1
JALISCO,14,VALLE DE JUÁREZ,112,OJO DE AGUA DEL MEZCAL,2,5,3,2,1
JALISCO,14,VALLE DE JUÁREZ,112,OJO DE AGUA DEL PICACHO (EL PLAN),1,12,6,6,1
JALISCO,14,VALLE DE JUÁREZ,112,PASO DE PIEDRA,3,94,49,45,5
JALISCO,14,VALLE DE JUÁREZ,112,PIEDRA PARADA,1,3,2,1,0
JALISCO,14,VALLE DE JUÁREZ,112,TACOTERA,1,52,30,22,3
JALISCO,14,VALLE DE JUÁREZ,112,VALLE DE JUÁREZ,9,1015,527,488,69
JALISCO,14,SAN GABRIEL,113,ALISTA,2,153,65,88,14
JALISCO,14,SAN GABRIEL,113,APANGO,2,261,136,125,12
JALISCO,14,SAN GABRIEL,113,EL AGUAJE,4,155,80,75,8
JALISCO,14,SAN GABRIEL,113,EL JARDÍN,2,29,15,14,2
JALISCO,14,SAN GABRIEL,113,EL JAZMÍN,3,269,145,124,13
JALISCO,14,SAN GABRIEL,113,EL PENAL,2,132,65,67,7
JALISCO,14,SAN GABRIEL,113,EL TEPOZAL,2,27,15,12,2
JALISCO,14,SAN GABRIEL,113,HACIENDA VIEJA,1,13,7,6,1
JALISCO,14,SAN GABRIEL,113,JAHUIQUES,2,6,2,4,1
JALISCO,14,SAN GABRIEL,113,JIQUILPAN,5,347,166,181,22
JALISCO,14,SAN GABRIEL,113,LA CAÑADA,2,47,25,22,4
JALISCO,14,SAN GABRIEL,113,LA CROIX,4,373,190,183,13
JALISCO,14,SAN GABRIEL,113,LA GUADALUPE,1,45,17,28,2
JALISCO,14,SAN GABRIEL,113,LA MANZANILLA,1,114,48,66,6
JALISCO,14,SAN GABRIEL,113,LA TINAJA,1,22,8,14,2
JALISCO,14,SAN GABRIEL,113,LAS VARILLAS,1,23,9,14,1
JALISCO,14,SAN GABRIEL,113,LOS CAMICHINES,3,67,30,37,4
JALISCO,14,SAN GABRIEL,113,LOS FRESNOS,3,127,70,57,7
JALISCO,14,SAN GABRIEL,113,LOS GALLOS,1,5,2,3,1
JALISCO,14,SAN GABRIEL,113,LOS GARCÍA,4,50,30,20,5
JALISCO,14,SAN GABRIEL,113,LOS RANCHITOS,1,10,5,5,1
JALISCO,14,SAN GABRIEL,113,OJO DE AGUA DE APANGO,2,101,48,53,6
JALISCO,14,SAN GABRIEL,113,PRESA DE TIERRA,3,23,8,15,3
JALISCO,14,SAN GABRIEL,113,PUERTO DE LA ESTACADA,2,3,1,2,1
JALISCO,14,SAN GABRIEL,113,SALSIPUEDES,1,35,21,14,2
JALISCO,14,SAN GABRIEL,113,SAN ANTONIO,2,122,64,58,8
JALISCO,14,SAN GABRIEL,113,SAN GABRIEL,9,1658,867,791,97
JALISCO,14,SAN GABRIEL,113,SAN ISIDRO,3,100,46,54,6
JALISCO,14,SAN GABRIEL,113,SAN JOSÉ DEL RINCÓN (SAN JOSÉ DE LAS BURRAS),2,98,49,49,7
JALISCO,14,SAN GABRIEL,113,SAYULAPAN,1,18,13,5,1
JALISCO,14,SAN GABRIEL,113,TOTOLIMIXPA,2,230,109,121,10
JALISCO,14,VILLA CORONA,114,ATOTONILCO EL BAJO,5,492,235,257,33
JALISCO,14,VILLA CORONA,114,BUENAVISTA,3,217,95,122,10
JALISCO,14,VILLA CORONA,114,EL BARRO,2,105,45,60,5
JALISCO,14,VILLA CORONA,114,EL TECUÁN,3,132,60,72,8
JALISCO,14,VILLA CORONA,114,ESTIPAC,8,952,525,427,94
JALISCO,14,VILLA CORONA,114,JUAN GIL PRECIADO (LA LOMA),3,462,284,178,26
JALISCO,14,VILLA CORONA,114,OJO DE AGUA,1,124,63,61,6
JALISCO,14,VILLA CORONA,114,VILLA CORONA,14,2481,1240,1241,149
JALISCO,14,VILLA GUERRERO,115,ADJUNTAS DEL NORTE,2,28,14,14,2
JALISCO,14,VILLA GUERRERO,115,BAJÍO DE SÁNCHEZ (EL BAJÍO),1,54,27,27,5
JALISCO,14,VILLA GUERRERO,115,IZOLTA,3,32,11,21,3
JALISCO,14,VILLA GUERRERO,115,JUANACATIC,1,15,7,8,1
JALISCO,14,VILLA GUERRERO,115,LA CIÉNEGA DE LOS MÁRQUEZ (LA CIÉNEGA),2,6,2,4,2
JALISCO,14,VILLA GUERRERO,115,LA COFRADÍA,1,32,9,23,2
JALISCO,14,VILLA GUERRERO,115,LA GUÁSIMA,2,16,12,4,2
JALISCO,14,VILLA GUERRERO,115,LA NOPALERA (ARROYO DE AGUA),1,15,6,9,1
JALISCO,14,VILLA GUERRERO,115,LOS SAUCES,1,24,9,15,2
JALISCO,14,VILLA GUERRERO,115,LOS VALLES,3,24,13,11,3
JALISCO,14,VILLA GUERRERO,115,OJO DE AGUA DE CARDOS,2,36,13,23,4
JALISCO,14,VILLA GUERRERO,115,PATÁHUAC (PATAGUA),2,31,11,20,3
JALISCO,14,VILLA GUERRERO,115,RANCHO DE ENMEDIO (MANILLAS),2,26,15,11,2
JALISCO,14,VILLA GUERRERO,115,SAN ANTONIO,2,18,7,11,2
JALISCO,14,VILLA GUERRERO,115,SAN LORENZO DE ATZQUELTÁN,3,56,34,22,6
JALISCO,14,VILLA GUERRERO,115,SANTA RITA,2,13,6,7,2
JALISCO,14,VILLA GUERRERO,115,VILLA GUERRERO,8,974,482,492,55
JALISCO,14,VILLA HIDALGO,116,ARROYO SECO DE ARRIBA,3,61,27,34,5
JALISCO,14,VILLA HIDALGO,116,CORRAL BLANCO,2,19,11,8,2
JALISCO,14,VILLA HIDALGO,116,CUSTIQUE,2,16,11,5,2
JALISCO,14,VILLA HIDALGO,116,EL CENTRO,2,20,13,7,2
JALISCO,14,VILLA HIDALGO,116,EL CHILARILLO,3,4,2,2,2
JALISCO,14,VILLA HIDALGO,116,HUERTA DE LOS LOZANO (LA HUERTA),1,14,6,8,1
JALISCO,14,VILLA HIDALGO,116,LOS GONZÁLEZ,2,38,17,21,3
JALISCO,14,VILLA HIDALGO,116,LOS MIMBRES,2,4,1,3,1
JALISCO,14,VILLA HIDALGO,116,LOS YÁÑEZ,3,44,19,25,3
JALISCO,14,VILLA HIDALGO,116,SAN IGNACIO DE ABAJO,2,189,96,93,9
JALISCO,14,VILLA HIDALGO,116,SAN IGNACIO DE ARRIBA,1,7,4,3,1
JALISCO,14,VILLA HIDALGO,116,SAN JUANICO DE ABAJO,2,25,12,13,2
JALISCO,14,VILLA HIDALGO,116,SAN JUANICO DE ARRIBA,4,54,20,34,4
JALISCO,14,VILLA HIDALGO,116,TEPUSCO,2,151,74,77,8
JALISCO,14,VILLA HIDALGO,116,VILLA HIDALGO,27,4344,2198,2146,242
JALISCO,14,CAÑADAS DE OBREGÓN,117,BARRERAS,2,13,6,7,2
JALISCO,14,CAÑADAS DE OBREGÓN,117,CAÑADAS DE OBREGÓN,6,702,347,355,36
JALISCO,14,CAÑADAS DE OBREGÓN,117,CATACHIME,3,58,25,33,4
JALISCO,14,CAÑADAS DE OBREGÓN,117,EL ZAPOTILLO,3,42,20,22,4
JALISCO,14,CAÑADAS DE OBREGÓN,117,LA CUEVA (SANTA ROSALÍA DE LA CUEVA),3,46,28,18,4
JALISCO,14,CAÑADAS DE OBREGÓN,117,LOS YUGOS,1,9,3,6,1
JALISCO,14,CAÑADAS DE OBREGÓN,117,RINCÓN DE GUZMÁN,2,4,2,2,2
JALISCO,14,CAÑADAS DE OBREGÓN,117,TEMACAPULÍN (TEMACA),3,38,21,17,5
JALISCO,14,YAHUALICA DE GONZÁLEZ GALLO,118,AGUA COLORADA CHIQUITA,1,119,63,56,6
JALISCO,14,YAHUALICA DE GONZÁLEZ GALLO,118,APOZOL DE GUTIÉRREZ (APOZOL),1,15,8,7,1
JALISCO,14,YAHUALICA DE GONZÁLEZ GALLO,118,EL BALUARTE,4,43,20,23,6
JALISCO,14,YAHUALICA DE GONZÁLEZ GALLO,118,EL MIRADOR,1,98,45,53,6
JALISCO,14,YAHUALICA DE GONZÁLEZ GALLO,118,EL MONTECILLO DE ABAJO,1,40,18,22,2
JALISCO,14,YAHUALICA DE GONZÁLEZ GALLO,118,EL ÓRGANO,2,63,34,29,4
JALISCO,14,YAHUALICA DE GONZÁLEZ GALLO,118,EL SALTO VERDE,2,5,4,1,1
JALISCO,14,YAHUALICA DE GONZÁLEZ GALLO,118,EL TULILLO,1,5,4,1,1
JALISCO,14,YAHUALICA DE GONZÁLEZ GALLO,118,HUISQUILCO (HUISCUILCO),3,163,89,74,10
JALISCO,14,YAHUALICA DE GONZÁLEZ GALLO,118,LA CERCA BLANCA,2,25,13,12,2
JALISCO,14,YAHUALICA DE GONZÁLEZ GALLO,118,LA CIÉNEGA,1,25,10,15,2
JALISCO,14,YAHUALICA DE GONZÁLEZ GALLO,118,LA CUCHARITA,2,6,4,2,1
JALISCO,14,YAHUALICA DE GONZÁLEZ GALLO,118,LA ESTANCIA,4,18,10,8,3
JALISCO,14,YAHUALICA DE GONZÁLEZ GALLO,118,LA IGLESIA VIEJA,1,27,15,12,2
JALISCO,14,YAHUALICA DE GONZÁLEZ GALLO,118,LA JARRILLA,1,5,2,3,1
JALISCO,14,YAHUALICA DE GONZÁLEZ GALLO,118,LA LABOR DE SAN IGNACIO,4,48,24,24,4
JALISCO,14,YAHUALICA DE GONZÁLEZ GALLO,118,LA MESA DE SAN JOAQUÍN,2,7,2,5,1
JALISCO,14,YAHUALICA DE GONZÁLEZ GALLO,118,LA MESA DEL LICENCIADO,1,4,2,2,1
JALISCO,14,YAHUALICA DE GONZÁLEZ GALLO,118,LA SOLEDAD DE ARRIBA,1,11,5,6,1
JALISCO,14,YAHUALICA DE GONZÁLEZ GALLO,118,LA TAPONA,3,51,26,25,4
JALISCO,14,YAHUALICA DE GONZÁLEZ GALLO,118,LA UVA,1,20,5,15,2
JALISCO,14,YAHUALICA DE GONZÁLEZ GALLO,118,LA ZUMBA,2,3,1,2,2
JALISCO,14,YAHUALICA DE GONZÁLEZ GALLO,118,LAS ÁNIMAS,2,16,7,9,2
JALISCO,14,YAHUALICA DE GONZÁLEZ GALLO,118,LAS MARAVILLAS,2,119,56,63,7
JALISCO,14,YAHUALICA DE GONZÁLEZ GALLO,118,LAS TINAJAS,2,26,16,10,2
JALISCO,14,YAHUALICA DE GONZÁLEZ GALLO,118,LLANO DE LOS RUICES (LLANO DE LOS RUIZ),2,32,14,18,3
JALISCO,14,YAHUALICA DE GONZÁLEZ GALLO,118,LOS LLANITOS,1,7,0,7,1
JALISCO,14,YAHUALICA DE GONZÁLEZ GALLO,118,LOS PASTORES,1,67,26,41,3
JALISCO,14,YAHUALICA DE GONZÁLEZ GALLO,118,LOS PEDERNALES,1,10,5,5,1
JALISCO,14,YAHUALICA DE GONZÁLEZ GALLO,118,MANALISCO,3,147,71,76,11
JALISCO,14,YAHUALICA DE GONZÁLEZ GALLO,118,MESA DEL APOZOL,1,5,3,2,1
JALISCO,14,YAHUALICA DE GONZÁLEZ GALLO,118,NANGUE DEL REFUGIO,1,6,3,3,1
JALISCO,14,YAHUALICA DE GONZÁLEZ GALLO,118,OCOTES DE MOYA,3,37,18,19,4
JALISCO,14,YAHUALICA DE GONZÁLEZ GALLO,118,POTRERO DE LOS SANDOVALES,1,8,4,4,1
JALISCO,14,YAHUALICA DE GONZÁLEZ GALLO,118,RANCHO LOS RUVALCABA,2,18,9,9,2
JALISCO,14,YAHUALICA DE GONZÁLEZ GALLO,118,RÍO COLORADO DE ABAJO,2,48,20,28,3
JALISCO,14,YAHUALICA DE GONZÁLEZ GALLO,118,SAN ISIDRO,3,33,15,18,4
JALISCO,14,YAHUALICA DE GONZÁLEZ GALLO,118,SANTA ANA,1,7,6,1,1
JALISCO,14,YAHUALICA DE GONZÁLEZ GALLO,118,SANTILLÁN,2,11,4,7,2
JALISCO,14,YAHUALICA DE GONZÁLEZ GALLO,118,YAHUALICA DE GONZÁLEZ GALLO,27,3416,1758,1658,201
JALISCO,14,ZACOALCO DE TORRES,119,BARRANCA DE LOS LAURELES,1,9,2,7,1
JALISCO,14,ZACOALCO DE TORRES,119,BARRANCA DE OTATES (BARRANCA DE OTATÁN),2,126,63,63,8
JALISCO,14,ZACOALCO DE TORRES,119,BARRANCA DE SANTA CLARA,4,455,218,237,36
JALISCO,14,ZACOALCO DE TORRES,119,BENITO JUÁREZ (CATARINA UNO),3,172,75,97,11
JALISCO,14,ZACOALCO DE TORRES,119,CACALUTA (LA VILLITA),3,141,71,70,9
JALISCO,14,ZACOALCO DE TORRES,119,EL BRISEÑO (LOS BRISEÑO),2,90,45,45,5
JALISCO,14,ZACOALCO DE TORRES,119,EL CRUCERO DE SAN ISIDRO,1,3,3,0,1
JALISCO,14,ZACOALCO DE TORRES,119,GENERAL ANDRÉS FIGUEROA (CATARINA DOS),3,150,79,71,15
JALISCO,14,ZACOALCO DE TORRES,119,LA CRUZ,3,46,25,21,4
JALISCO,14,ZACOALCO DE TORRES,119,LAS MORAS,3,209,106,103,10
JALISCO,14,ZACOALCO DE TORRES,119,PUEBLO NUEVO,1,32,15,17,2
JALISCO,14,ZACOALCO DE TORRES,119,SAN MARCOS,2,280,148,132,9
JALISCO,14,ZACOALCO DE TORRES,119,SAYULAPAN,3,83,38,45,6
JALISCO,14,ZACOALCO DE TORRES,119,UREÑA,2,32,20,12,2
JALISCO,14,ZACOALCO DE TORRES,119,VERDÍA,4,203,87,116,22
JALISCO,14,ZACOALCO DE TORRES,119,ZACOALCO DE TORRES,30,5038,2533,2505,286
JALISCO,14,ZAPOPAN,120,CAMPESTRE LAS PALOMAS [FRACCIONAMIENTO],11,4134,2076,2058,172
JALISCO,14,ZAPOPAN,120,CERCA MORADA (LAS PRESITAS),1,7,3,4,1
JALISCO,14,ZAPOPAN,120,COPALA,1,39,13,26,2
JALISCO,14,ZAPOPAN,120,COPALITA,3,312,154,158,16
JALISCO,14,ZAPOPAN,120,EJIDO COPALITA,10,2622,1321,1301,107
JALISCO,14,ZAPOPAN,120,EL CRUCERO (CRUCERO DE AMECA),1,106,57,49,5
JALISCO,14,ZAPOPAN,120,EL LAZO (EX-HACIENDA DEL LAZO),4,149,65,84,9
JALISCO,14,ZAPOPAN,120,EL MARTEL,2,473,232,241,14
JALISCO,14,ZAPOPAN,120,EL NUEVO RESPLANDOR [FRACCIONAMIENTO],1,37,18,19,2
JALISCO,14,ZAPOPAN,120,EL QUEMADO,1,12,6,6,2
JALISCO,14,ZAPOPAN,120,FUENTECILLAS,1,40,17,23,1
JALISCO,14,ZAPOPAN,120,HUAXTLA,2,12,6,6,2
JALISCO,14,ZAPOPAN,120,LA CORONILLA DEL OCOTE,2,28,17,11,4
JALISCO,14,ZAPOPAN,120,LA CUCHILLA (EXTRAMUROS DE TESISTÁN),1,12,3,9,1
JALISCO,14,ZAPOPAN,120,LA MESITA,2,43,22,21,5
JALISCO,14,ZAPOPAN,120,LA MOJONERA,4,504,257,247,21
JALISCO,14,ZAPOPAN,120,LA PRIMAVERA,1,231,110,121,9
JALISCO,14,ZAPOPAN,120,LA PROVIDENCIA,3,131,70,61,6
JALISCO,14,ZAPOPAN,120,LA RESERVA,3,75,42,33,7
JALISCO,14,ZAPOPAN,120,LA SOLEDAD,3,15,6,9,2
JALISCO,14,ZAPOPAN,120,LA VENTA DEL ASTILLERO,3,628,312,316,29
JALISCO,14,ZAPOPAN,120,LAS AGUJAS,5,8189,4423,3766,429
JALISCO,14,ZAPOPAN,120,LAS CUEVAS,3,43,25,18,3
JALISCO,14,ZAPOPAN,120,LOMAS DE MONTECHELO (EL PEDREGAL),2,217,117,100,8
JALISCO,14,ZAPOPAN,120,LOS CAMACHOS,1,64,41,23,3
JALISCO,14,ZAPOPAN,120,MIRADOR DEL BOSQUE,4,1076,536,540,34
JALISCO,14,ZAPOPAN,120,NEXTIPAC,12,1850,944,906,141
JALISCO,14,ZAPOPAN,120,PALO GORDO,2,157,81,76,7
JALISCO,14,ZAPOPAN,120,RANCHO SAN JOSÉ DE RÁBAGO,2,678,327,351,24
JALISCO,14,ZAPOPAN,120,SAN ESTEBAN (SAN MIGUEL TATEPOSCO),4,862,454,408,31
JALISCO,14,ZAPOPAN,120,SAN FRANCISCO DE IXCATÁN,3,320,162,158,11
JALISCO,14,ZAPOPAN,120,SAN ISIDRO,4,769,393,376,25
JALISCO,14,ZAPOPAN,120,SAN JOSÉ,1,29,16,13,2
JALISCO,14,ZAPOPAN,120,SAN MARTÍN,1,21,9,12,3
JALISCO,14,ZAPOPAN,120,TESISTÁN (SAN FRANCISCO TESISTÁN),80,24156,12071,12085,1118
JALISCO,14,ZAPOPAN,120,VALLE DE LOS MOLINOS,18,8001,3904,4097,350
JALISCO,14,ZAPOPAN,120,ZAPOPAN,1444,337844,171411,166433,24499
JALISCO,14,ZAPOTILTIC,121,COAMECATILA,2,20,7,13,3
JALISCO,14,ZAPOTILTIC,121,EL COAHUAYOTE (EL ARCO),2,128,63,65,8
JALISCO,14,ZAPOTILTIC,121,EL CORTIJO,2,23,16,7,2
JALISCO,14,ZAPOTILTIC,121,EL RINCÓN,4,651,326,325,39
JALISCO,14,ZAPOTILTIC,121,FERRERÍA DE PROVIDENCIA,4,141,65,76,10
JALISCO,14,ZAPOTILTIC,121,LA TEMPRANILLA,1,19,12,7,2
JALISCO,14,ZAPOTILTIC,121,SAN JOSÉ DE LA TINAJA,3,207,105,102,9
JALISCO,14,ZAPOTILTIC,121,SAN RAFAEL,2,65,36,29,4
JALISCO,14,ZAPOTILTIC,121,SANTA GERTRUDIS,3,52,19,33,4
JALISCO,14,ZAPOTILTIC,121,TASINAXTLA (LA CAÑADA),2,128,70,58,23
JALISCO,14,ZAPOTILTIC,121,VILLA LÁZARO CÁRDENAS (EL ASERRADERO),4,357,178,179,16
JALISCO,14,ZAPOTILTIC,121,ZAPOTILTIC,35,6287,3195,3092,328
JALISCO,14,ZAPOTITLÁN DE VADILLO,122,CHANCUELLAR,2,34,16,18,3
JALISCO,14,ZAPOTITLÁN DE VADILLO,122,EL ESPINAL,2,9,2,7,1
JALISCO,14,ZAPOTITLÁN DE VADILLO,122,EL TECUÁN,3,23,6,17,3
JALISCO,14,ZAPOTITLÁN DE VADILLO,122,HUITZOMETL (LA PROVIDENCIA),2,21,8,13,2
JALISCO,14,ZAPOTITLÁN DE VADILLO,122,LA CRUZ,3,27,17,10,2
JALISCO,14,ZAPOTITLÁN DE VADILLO,122,LOMA DE GUADALUPE (CRUZ BLANCA),2,37,15,22,3
JALISCO,14,ZAPOTITLÁN DE VADILLO,122,LOMA DE LAS FLORES,4,70,35,35,6
JALISCO,14,ZAPOTITLÁN DE VADILLO,122,LOMA DE PEREMPITZ,3,53,25,28,4
JALISCO,14,ZAPOTITLÁN DE VADILLO,122,MAZATÁN (SAN FRANCISCO MAZATÁN),3,51,27,24,3
JALISCO,14,ZAPOTITLÁN DE VADILLO,122,NUEVO PEREMPITZ,1,4,3,1,1
JALISCO,14,ZAPOTITLÁN DE VADILLO,122,SAN CRISTÓBAL,1,9,5,4,1
JALISCO,14,ZAPOTITLÁN DE VADILLO,122,SAN ISIDRO,2,6,1,5,1
JALISCO,14,ZAPOTITLÁN DE VADILLO,122,SAN JOSÉ DEL CARMEN,4,155,84,71,14
JALISCO,14,ZAPOTITLÁN DE VADILLO,122,TELCRUZ,2,34,21,13,2
JALISCO,14,ZAPOTITLÁN DE VADILLO,122,TETAPÁN (TETIAPÁN),2,25,13,12,2
JALISCO,14,ZAPOTITLÁN DE VADILLO,122,ZAPOTITLÁN DE VADILLO,8,1351,661,690,73
JALISCO,14,ZAPOTLÁN DEL REY,123,AHUATLÁN,3,399,197,202,28
JALISCO,14,ZAPOTLÁN DEL REY,123,ATZCATLÁN,3,276,147,129,13
JALISCO,14,ZAPOTLÁN DEL REY,123,CHILA,3,125,67,58,6
JALISCO,14,ZAPOTLÁN DEL REY,123,EL JABALÍ,1,8,5,3,1
JALISCO,14,ZAPOTLÁN DEL REY,123,EL PLATANAR,4,196,103,93,11
JALISCO,14,ZAPOTLÁN DEL REY,123,EL SAUZ,4,174,86,88,11
JALISCO,14,ZAPOTLÁN DEL REY,123,EL TEJOLOTE,1,56,29,27,3
JALISCO,14,ZAPOTLÁN DEL REY,123,LA CAMPANA,4,64,29,35,5
JALISCO,14,ZAPOTLÁN DEL REY,123,LA CAÑADA,2,39,16,23,3
JALISCO,14,ZAPOTLÁN DEL REY,123,LA COLONIA,1,16,9,7,2
JALISCO,14,ZAPOTLÁN DEL REY,123,LA CONSTANCIA,3,164,76,88,10
JALISCO,14,ZAPOTLÁN DEL REY,123,LA NORIA (EL MIRADOR),2,38,21,17,3
JALISCO,14,ZAPOTLÁN DEL REY,123,LA VÍBORA,2,40,16,24,3
JALISCO,14,ZAPOTLÁN DEL REY,123,LOS CERRITOS,4,184,97,87,9
JALISCO,14,ZAPOTLÁN DEL REY,123,LOS FRESNOS,1,110,46,64,5
JALISCO,14,ZAPOTLÁN DEL REY,123,LOS HORNOS,2,8,4,4,2
JALISCO,14,ZAPOTLÁN DEL REY,123,LOS OROZCO,1,84,37,47,3
JALISCO,14,ZAPOTLÁN DEL REY,123,MESA DE AMULA,4,61,26,35,5
JALISCO,14,ZAPOTLÁN DEL REY,123,OTATLÁN,2,99,46,53,5
JALISCO,14,ZAPOTLÁN DEL REY,123,POTRERO DE GÓMEZ,3,131,70,61,8
JALISCO,14,ZAPOTLÁN DEL REY,123,RANCHO NUEVO,1,73,39,34,3
JALISCO,14,ZAPOTLÁN DEL REY,123,RINCÓN DE CHILA,3,32,17,15,3
JALISCO,14,ZAPOTLÁN DEL REY,123,SAN IGNACIO,2,33,21,12,3
JALISCO,14,ZAPOTLÁN DEL REY,123,SANTIAGO TOTOLIMIXPAN (COLONIA LA GUADALUPANA),5,529,254,275,23
JALISCO,14,ZAPOTLÁN DEL REY,123,SOLEDAD DE LOS PÉREZ (LA SOLEDAD),4,130,77,53,6
JALISCO,14,ZAPOTLÁN DEL REY,123,TECUALTITÁN,2,143,66,77,8
JALISCO,14,ZAPOTLÁN DEL REY,123,ZAPOTLÁN DEL REY,7,829,451,378,57
JALISCO,14,ZAPOTLANEJO,124,AGUA BERMEJA,2,928,484,444,57
JALISCO,14,ZAPOTLANEJO,124,AGUA ESCONDIDA,3,98,46,52,7
JALISCO,14,ZAPOTLANEJO,124,AGUA NEGRA,1,124,66,58,6
JALISCO,14,ZAPOTLANEJO,124,ATENGO,1,5,3,2,1
JALISCO,14,ZAPOTLANEJO,124,BUENOS AIRES,2,34,16,18,3
JALISCO,14,ZAPOTLANEJO,124,CARBONERAS,1,13,9,4,1
JALISCO,14,ZAPOTLANEJO,124,CERRITO DE BUENOS AIRES (EL CERRITO),2,30,7,23,2
JALISCO,14,ZAPOTLANEJO,124,COLIMILLA,3,192,91,101,10
JALISCO,14,ZAPOTLANEJO,124,COLONIA LA CRUZ (CIUDAD PERDIDA LOMA DE LA CRUZ),1,61,27,34,3
JALISCO,14,ZAPOTLANEJO,124,CORRALILLOS,2,29,13,16,3
JALISCO,14,ZAPOTLANEJO,124,COYOTES DE ABAJO (RANCHO COYOTES),1,52,30,22,4
JALISCO,14,ZAPOTLANEJO,124,CUCHILLAS,1,14,9,5,1
JALISCO,14,ZAPOTLANEJO,124,EL AGUACATE,2,35,15,20,4
JALISCO,14,ZAPOTLANEJO,124,EL CALABOZO,4,99,55,44,7
JALISCO,14,ZAPOTLANEJO,124,EL CEBADERO,3,26,18,8,2
JALISCO,14,ZAPOTLANEJO,124,EL DURAZNO,3,37,19,18,3
JALISCO,14,ZAPOTLANEJO,124,EL GATO,1,15,10,5,2
JALISCO,14,ZAPOTLANEJO,124,EL GUAJOLOTE,1,17,8,9,1
JALISCO,14,ZAPOTLANEJO,124,EL MAESTRANZO,1,26,11,15,2
JALISCO,14,ZAPOTLANEJO,124,EL MEZQUITE GRANDE,1,288,133,155,10
JALISCO,14,ZAPOTLANEJO,124,EL SALITRE (LA MORA),2,120,50,70,7
JALISCO,14,ZAPOTLANEJO,124,EL SALTO DE LAS PEÑAS,4,116,68,48,7
JALISCO,14,ZAPOTLANEJO,124,EL SAUCILLO,1,20,10,10,1
JALISCO,14,ZAPOTLANEJO,124,EL VENADO,2,22,10,12,2
JALISCO,14,ZAPOTLANEJO,124,HUEJOTITLÁN (HUEJOTITÁN),1,612,292,320,46
JALISCO,14,ZAPOTLANEJO,124,J. ISABEL FLORES,1,208,105,103,6
JALISCO,14,ZAPOTLANEJO,124,JOYA DEL CAMINO (LAS PALMITAS),3,125,59,66,7
JALISCO,14,ZAPOTLANEJO,124,LA ARENA,1,18,9,9,2
JALISCO,14,ZAPOTLANEJO,124,LA CEJA,1,29,17,12,2
JALISCO,14,ZAPOTLANEJO,124,LA COFRADÍA,3,101,49,52,5
JALISCO,14,ZAPOTLANEJO,124,LA JOYA CHICA,2,32,15,17,2
JALISCO,14,ZAPOTLANEJO,124,LA JOYA GRANDE,3,86,42,44,6
JALISCO,14,ZAPOTLANEJO,124,LA LAJA,8,1258,607,651,51
JALISCO,14,ZAPOTLANEJO,124,LA LENTEJA,4,320,172,148,16
JALISCO,14,ZAPOTLANEJO,124,LA LOMA,2,72,35,37,3
JALISCO,14,ZAPOTLANEJO,124,LA MEZQUITERA,1,191,83,108,6
JALISCO,14,ZAPOTLANEJO,124,LA PAZ (PIEDRAS NEGRAS),2,151,74,77,8
JALISCO,14,ZAPOTLANEJO,124,LA PURÍSIMA,2,193,102,91,8
JALISCO,14,ZAPOTLANEJO,124,LA YERBABUENA,2,36,13,23,4
JALISCO,14,ZAPOTLANEJO,124,LAGUNITAS,1,7,2,5,1
JALISCO,14,ZAPOTLANEJO,124,LAS AVISPAS,3,50,22,28,4
JALISCO,14,ZAPOTLANEJO,124,LAS FUENTES,1,41,20,21,2
JALISCO,14,ZAPOTLANEJO,124,LAS LIEBRES (PLAN DE SAN ANTONIO),1,9,6,3,1
JALISCO,14,ZAPOTLANEJO,124,LAS TORTUGAS DEL CACALOTE (TORTUGAS),2,35,19,16,3
JALISCO,14,ZAPOTLANEJO,124,LAS VENADAS,2,61,24,37,4
JALISCO,14,ZAPOTLANEJO,124,LOS CHOMBOS,1,34,18,16,2
JALISCO,14,ZAPOTLANEJO,124,LOS OCOTES,2,7,4,3,2
JALISCO,14,ZAPOTLANEJO,124,LOS PLATOS,4,211,111,100,11
JALISCO,14,ZAPOTLANEJO,124,LOS TEPETATES,2,125,61,64,6
JALISCO,14,ZAPOTLANEJO,124,MATATLÁN,4,451,238,213,31
JALISCO,14,ZAPOTLANEJO,124,MESA COLORADA,1,178,90,88,6
JALISCO,14,ZAPOTLANEJO,124,MONTE DE LA VIRGEN,1,53,25,28,3
JALISCO,14,ZAPOTLANEJO,124,NOXTLA,1,162,78,84,6
JALISCO,14,ZAPOTLANEJO,124,OCOTE DE NUÑO,2,127,66,61,7
JALISCO,14,ZAPOTLANEJO,124,OJO DE AGUA,1,17,8,9,1
JALISCO,14,ZAPOTLANEJO,124,PALO COLORADO,1,8,4,4,1
JALISCO,14,ZAPOTLANEJO,124,PARTIDAS,1,10,5,5,1
JALISCO,14,ZAPOTLANEJO,124,PUEBLO VIEJO,1,26,13,13,2
JALISCO,14,ZAPOTLANEJO,124,PUEBLOS DE LA BARRANCA (EL MAESTRANZO),1,82,35,47,5
JALISCO,14,ZAPOTLANEJO,124,RINCÓN DE POTRERILLOS (POTRERILLOS),1,57,24,33,3
JALISCO,14,ZAPOTLANEJO,124,SALTO DE COYOTES,1,12,8,4,2
JALISCO,14,ZAPOTLANEJO,124,SAN JOAQUÍN (CORRAL FALSO),3,34,20,14,4
JALISCO,14,ZAPOTLANEJO,124,SAN JOAQUÍN ZORRILLOS,2,176,88,88,8
JALISCO,14,ZAPOTLANEJO,124,SAN JOSÉ DE LAS FLORES (GALLINAS DE ARRIBA),3,406,200,206,19
JALISCO,14,ZAPOTLANEJO,124,SAN JUAN BAUTISTA,3,41,23,18,3
JALISCO,14,ZAPOTLANEJO,124,SAN ROMÁN,2,175,85,90,8
JALISCO,14,ZAPOTLANEJO,124,SAN ROQUE,1,55,28,27,2
JALISCO,14,ZAPOTLANEJO,124,SANTA FE,7,794,416,378,50
JALISCO,14,ZAPOTLANEJO,124,SANTA MARÍA (EL TACUACHE),1,32,16,16,1
JALISCO,14,ZAPOTLANEJO,124,SAUCILLO DE MALDONADO (EL SAUCILLO),2,120,60,60,6
JALISCO,14,ZAPOTLANEJO,124,SEÑORITAS,4,79,40,39,11
JALISCO,14,ZAPOTLANEJO,124,TABLAS DE COYOTES,1,5,1,4,1
JALISCO,14,ZAPOTLANEJO,124,TEPAME,1,25,13,12,2
JALISCO,14,ZAPOTLANEJO,124,ZAPOTLANEJO,50,9838,5027,4811,548
JALISCO,14,SAN IGNACIO CERRO GORDO,125,CERRO GORDO,1,23,12,11,1
JALISCO,14,SAN IGNACIO CERRO GORDO,125,EL CAPULIN VERDE,1,16,8,8,1
JALISCO,14,SAN IGNACIO CERRO GORDO,125,EL CODITO,1,124,49,75,6
JALISCO,14,SAN IGNACIO CERRO GORDO,125,EL TEPOZÁN,2,32,16,16,3
JALISCO,14,SAN IGNACIO CERRO GORDO,125,EL VIBORERO,1,66,32,34,4
JALISCO,14,SAN IGNACIO CERRO GORDO,125,HIGUERILLAS,2,30,13,17,2
JALISCO,14,SAN IGNACIO CERRO GORDO,125,JAQUETAS,2,77,35,42,6
JALISCO,14,SAN IGNACIO CERRO GORDO,125,LA LADRILLERA,3,88,53,35,5
JALISCO,14,SAN IGNACIO CERRO GORDO,125,LA LOMA DE LOS AMOLES (LOMA DE SAN PEDRO),2,35,14,21,4
JALISCO,14,SAN IGNACIO CERRO GORDO,125,LA TRINIDAD,4,318,161,157,15
JALISCO,14,SAN IGNACIO CERRO GORDO,125,LOMA ALTA,2,22,17,5,2
JALISCO,14,SAN IGNACIO CERRO GORDO,125,LOS COYOTES,1,27,15,12,1
JALISCO,14,SAN IGNACIO CERRO GORDO,125,LOS DOLORES,4,361,206,155,32
JALISCO,14,SAN IGNACIO CERRO GORDO,125,PALENQUE,3,201,104,97,10
JALISCO,14,SAN IGNACIO CERRO GORDO,125,PASTORES,3,58,27,31,5
JALISCO,14,SAN IGNACIO CERRO GORDO,125,PRESA DE BARAJAS,2,138,69,69,8
JALISCO,14,SAN IGNACIO CERRO GORDO,125,SACAMECATE,4,144,69,75,11
JALISCO,14,SAN IGNACIO CERRO GORDO,125,SAN ANTONIO,1,32,16,16,2
JALISCO,14,SAN IGNACIO CERRO GORDO,125,SAN IGNACIO CERRO GORDO,19,3037,1569,1468,182
JALISCO,14,SAN IGNACIO CERRO GORDO,125,SAN RAMÓN,3,38,14,24,4
JALISCO,14,SAN IGNACIO CERRO GORDO,125,SAN VICENTE,3,38,23,15,3
JALISCO,14,SAN IGNACIO CERRO GORDO,125,TERRERO CHICO,1,50,29,21,3
JALISCO,14,SAN IGNACIO CERRO GORDO,125,TRES PALOS,1,24,13,11,2
JALISCO,14,SAN IGNACIO CERRO GORDO,125,TUNA DE ABAJO (SAN PASCUAL),4,109,56,53,8
JALISCO,14,SAN IGNACIO CERRO GORDO,125,TUNA DE ENMEDIO,1,6,1,5,1
MICHOACÁN DE OCAMPO,16,ACUITZIO,001,ACUITZIO DEL CANJE,16,2355,1240,1115,105
MICHOACÁN DE OCAMPO,16,ACUITZIO,001,ARROYO HONDO,2,19,12,7,2
MICHOACÁN DE OCAMPO,16,ACUITZIO,001,CUTZARO,3,130,65,65,10
MICHOACÁN DE OCAMPO,16,ACUITZIO,001,EL AUXILIO (LOS TANQUES),1,4,0,4,1
MICHOACÁN DE OCAMPO,16,ACUITZIO,001,EL PAREDÓN,1,6,3,3,2
MICHOACÁN DE OCAMPO,16,ACUITZIO,001,EL TZINTZÚN,1,13,7,6,1
MICHOACÁN DE OCAMPO,16,ACUITZIO,001,EL VARAL,1,9,5,4,1
MICHOACÁN DE OCAMPO,16,ACUITZIO,001,HUAJUMBO,2,40,23,17,3
MICHOACÁN DE OCAMPO,16,ACUITZIO,001,LA ANGOSTURA,2,30,17,13,3
MICHOACÁN DE OCAMPO,16,ACUITZIO,001,LA CAMPANA,1,4,1,3,1
MICHOACÁN DE OCAMPO,16,ACUITZIO,001,LA LAJA,2,29,12,17,2
MICHOACÁN DE OCAMPO,16,ACUITZIO,001,LA PALMA,3,70,29,41,7
MICHOACÁN DE OCAMPO,16,ACUITZIO,001,LA PALOMA (ZIPARAPIO EL BAJO),1,8,5,3,1
MICHOACÁN DE OCAMPO,16,ACUITZIO,001,LOS AGUACATES,1,10,4,6,2
MICHOACÁN DE OCAMPO,16,ACUITZIO,001,PÁRAMO,2,56,21,35,3
MICHOACÁN DE OCAMPO,16,ACUITZIO,001,SAN ANDRÉS COAPA,4,226,106,120,15
MICHOACÁN DE OCAMPO,16,ACUITZIO,001,TAMANGUÍO,2,43,18,25,4
MICHOACÁN DE OCAMPO,16,ACUITZIO,001,TIRÍPANO,1,8,3,5,1
MICHOACÁN DE OCAMPO,16,ACUITZIO,001,ZIPARAPIO EL ALTO,2,25,12,13,3
MICHOACÁN DE OCAMPO,16,AGUILILLA,002,AGUILILLA,15,1861,940,921,113
MICHOACÁN DE OCAMPO,16,AGUILILLA,002,BONIFACIO MORENO (EL AGUAJE),5,436,205,231,29
MICHOACÁN DE OCAMPO,16,AGUILILLA,002,CHAPULA,2,25,15,10,3
MICHOACÁN DE OCAMPO,16,AGUILILLA,002,COLONIA LA PAZ [CRUCERO DE DOS AGUAS],2,22,10,12,3
MICHOACÁN DE OCAMPO,16,AGUILILLA,002,DOS AGUAS,3,113,67,46,8
MICHOACÁN DE OCAMPO,16,AGUILILLA,002,EL CHARAPO (PALO ALTO),1,10,6,4,2
MICHOACÁN DE OCAMPO,16,AGUILILLA,002,EL CHICAL,1,7,5,2,1
MICHOACÁN DE OCAMPO,16,AGUILILLA,002,EL LIMONCITO,1,20,6,14,2
MICHOACÁN DE OCAMPO,16,AGUILILLA,002,EL MAMEY,2,7,2,5,1
MICHOACÁN DE OCAMPO,16,AGUILILLA,002,EL PAROTAL,1,8,3,5,1
MICHOACÁN DE OCAMPO,16,AGUILILLA,002,EL RINCÓN,2,5,3,2,2
MICHOACÁN DE OCAMPO,16,AGUILILLA,002,EL ROBLE [VIVEROS],2,5,3,2,1
MICHOACÁN DE OCAMPO,16,AGUILILLA,002,EL RODEO,1,13,8,5,1
MICHOACÁN DE OCAMPO,16,AGUILILLA,002,GENERAL LÁZARO CÁRDENAS (EL LIMÓN),3,102,56,46,7
MICHOACÁN DE OCAMPO,16,AGUILILLA,002,HUISTO,2,27,15,12,2
MICHOACÁN DE OCAMPO,16,AGUILILLA,002,LA CABRA,3,15,8,7,3
MICHOACÁN DE OCAMPO,16,AGUILILLA,002,LAS CANOAS,2,6,3,3,2
MICHOACÁN DE OCAMPO,16,AGUILILLA,002,LOS MANGUITOS,1,4,4,0,1
MICHOACÁN DE OCAMPO,16,AGUILILLA,002,LOS NOGALES (LOS NOGALES DE CHAPULA),1,9,2,7,1
MICHOACÁN DE OCAMPO,16,AGUILILLA,002,NARANJO DE CHILA,2,58,31,27,3
MICHOACÁN DE OCAMPO,16,AGUILILLA,002,NARANJO VIEJO,1,15,9,6,1
MICHOACÁN DE OCAMPO,16,AGUILILLA,002,PALO ALTO (HACIENDA PALO ALTO),2,39,23,16,2
MICHOACÁN DE OCAMPO,16,AGUILILLA,002,PEÑA COLORADA,2,58,33,25,3
MICHOACÁN DE OCAMPO,16,AGUILILLA,002,PORUCHO,3,12,6,6,2
MICHOACÁN DE OCAMPO,16,AGUILILLA,002,POTRERILLOS,2,5,4,1,1
MICHOACÁN DE OCAMPO,16,AGUILILLA,002,PUERTO LA AGUACATERA,1,41,21,20,2
MICHOACÁN DE OCAMPO,16,AGUILILLA,002,RANCHO VIEJO,2,16,4,12,2
MICHOACÁN DE OCAMPO,16,ÁLVARO OBREGÓN,003,ÁLVARO OBREGÓN,15,2431,1254,1177,190
MICHOACÁN DE OCAMPO,16,ÁLVARO OBREGÓN,003,CHEHUAYO CHICO (CHEHUAYITO),2,52,26,26,4
MICHOACÁN DE OCAMPO,16,ÁLVARO OBREGÓN,003,CHEHUAYO GRANDE,3,157,81,76,9
MICHOACÁN DE OCAMPO,16,ÁLVARO OBREGÓN,003,COLONIA EL VENADO,2,87,47,40,7
MICHOACÁN DE OCAMPO,16,ÁLVARO OBREGÓN,003,EL CALVARIO,3,175,80,95,12
MICHOACÁN DE OCAMPO,16,ÁLVARO OBREGÓN,003,EL ZAPOTE [COLONIA AGRÍCOLA],2,39,21,18,4
MICHOACÁN DE OCAMPO,16,ÁLVARO OBREGÓN,003,EMILIANO ZAPATA,3,130,56,74,10
MICHOACÁN DE OCAMPO,16,ÁLVARO OBREGÓN,003,ESTACIÓN DE QUIRIO,1,21,10,11,2
MICHOACÁN DE OCAMPO,16,ÁLVARO OBREGÓN,003,FELIPE ÁNGELES (HACIENDA DE LAS PIEDRAS),2,38,18,20,4
MICHOACÁN DE OCAMPO,16,ÁLVARO OBREGÓN,003,FELIPE CARRILLO PUERTO,3,330,147,183,20
MICHOACÁN DE OCAMPO,16,ÁLVARO OBREGÓN,003,ISLA DE TZIRIO,2,106,59,47,6
MICHOACÁN DE OCAMPO,16,ÁLVARO OBREGÓN,003,LA MINA,5,452,238,214,28
MICHOACÁN DE OCAMPO,16,ÁLVARO OBREGÓN,003,LA PRESA,2,116,58,58,9
MICHOACÁN DE OCAMPO,16,ÁLVARO OBREGÓN,003,LAS TROJES,2,47,27,20,4
MICHOACÁN DE OCAMPO,16,ÁLVARO OBREGÓN,003,LÁZARO CÁRDENAS (LA PURÍSIMA),3,278,148,130,20
MICHOACÁN DE OCAMPO,16,ÁLVARO OBREGÓN,003,LEÓN CÁRDENAS (LA ARDILLA),1,17,10,7,1
MICHOACÁN DE OCAMPO,16,ÁLVARO OBREGÓN,003,PALO BLANCO,2,39,17,22,4
MICHOACÁN DE OCAMPO,16,ÁLVARO OBREGÓN,003,QUIRIO (EX-HACIENDA DE QUIRIO),3,63,29,34,5
MICHOACÁN DE OCAMPO,16,ÁLVARO OBREGÓN,003,TZINTZIMEO,5,318,148,170,36
MICHOACÁN DE OCAMPO,16,ÁLVARO OBREGÓN,003,ZACAPENDO,2,29,17,12,4
MICHOACÁN DE OCAMPO,16,ANGAMACUTIRO,004,AGUA CALIENTE (OJO DE AGUA),3,160,87,73,12
MICHOACÁN DE OCAMPO,16,ANGAMACUTIRO,004,ANGAMACUTIRO DE LA UNIÓN,9,1165,618,547,76
MICHOACÁN DE OCAMPO,16,ANGAMACUTIRO,004,ARAMÚTARO DE LA CAL,2,38,21,17,2
MICHOACÁN DE OCAMPO,16,ANGAMACUTIRO,004,ARANJUEZ,1,27,14,13,2
MICHOACÁN DE OCAMPO,16,ANGAMACUTIRO,004,CURICIPO,1,10,4,6,1
MICHOACÁN DE OCAMPO,16,ANGAMACUTIRO,004,EL MALUCO,4,475,236,239,29
MICHOACÁN DE OCAMPO,16,ANGAMACUTIRO,004,EL ROSARIO,2,83,37,46,6
MICHOACÁN DE OCAMPO,16,ANGAMACUTIRO,004,EL SABINO (LA TAZA),2,14,8,6,2
MICHOACÁN DE OCAMPO,16,ANGAMACUTIRO,004,EL TROJE,3,37,22,15,6
MICHOACÁN DE OCAMPO,16,ANGAMACUTIRO,004,GUADALUPE NORTE (LA HACIENDITA),2,52,29,23,2
MICHOACÁN DE OCAMPO,16,ANGAMACUTIRO,004,GUADALUPE SUR,2,40,17,23,3
MICHOACÁN DE OCAMPO,16,ANGAMACUTIRO,004,GUAYABO BUENAVISTA,2,9,4,5,2
MICHOACÁN DE OCAMPO,16,ANGAMACUTIRO,004,HÉROES DE LA REVOLUCIÓN,2,51,27,24,3
MICHOACÁN DE OCAMPO,16,ANGAMACUTIRO,004,LA ESTANCIA DEL RÍO,4,169,97,72,14
MICHOACÁN DE OCAMPO,16,ANGAMACUTIRO,004,LA PALMA,3,85,43,42,5
MICHOACÁN DE OCAMPO,16,ANGAMACUTIRO,004,LA ZAPOTERA DE TUNILLA,3,54,28,26,5
MICHOACÁN DE OCAMPO,16,ANGAMACUTIRO,004,MIRAVALLE,2,159,73,86,9
MICHOACÁN DE OCAMPO,16,ANGAMACUTIRO,004,NUEVO PARAÍSO,2,31,15,16,2
MICHOACÁN DE OCAMPO,16,ANGAMACUTIRO,004,SAN DIEGO BUENAVISTA,4,94,51,43,5
MICHOACÁN DE OCAMPO,16,ANGAMACUTIRO,004,SAN JOSÉ DEL MALUCO,2,140,75,65,9
MICHOACÁN DE OCAMPO,16,ANGAMACUTIRO,004,SANTIAGO CONGURIPO,3,295,153,142,13
MICHOACÁN DE OCAMPO,16,ANGANGUEO,005,BARRIO SUSTENTABLE MONARCA (LAS CASITAS),1,21,6,15,1
MICHOACÁN DE OCAMPO,16,ANGANGUEO,005,COLONIA INDEPENDENCIA,2,264,136,128,14
MICHOACÁN DE OCAMPO,16,ANGANGUEO,005,DOLORES,2,70,36,34,5
MICHOACÁN DE OCAMPO,16,ANGANGUEO,005,EL PUERTO,1,24,11,13,1
MICHOACÁN DE OCAMPO,16,ANGANGUEO,005,EL TIGRE (NUEVA COMUNIDAD EL TIGRE),2,9,3,6,1
MICHOACÁN DE OCAMPO,16,ANGANGUEO,005,JESÚS DE NAZARENO (LA HACIENDA),3,104,43,61,8
MICHOACÁN DE OCAMPO,16,ANGANGUEO,005,LA RONDANILLA (PRIMER CUARTEL),4,188,97,91,11
MICHOACÁN DE OCAMPO,16,ANGANGUEO,005,LA SALUD,4,329,166,163,12
MICHOACÁN DE OCAMPO,16,ANGANGUEO,005,LAS JARAS,1,7,4,3,1
MICHOACÁN DE OCAMPO,16,ANGANGUEO,005,MANZANA DE LA TRINIDAD (LA JUNTA),1,11,5,6,1
MICHOACÁN DE OCAMPO,16,ANGANGUEO,005,MINERAL DE ANGANGUEO,14,1837,902,935,138
MICHOACÁN DE OCAMPO,16,ANGANGUEO,005,SAN ANTONIO,1,17,7,10,1
MICHOACÁN DE OCAMPO,16,ANGANGUEO,005,SAN MARCIAL,1,20,11,9,1
MICHOACÁN DE OCAMPO,16,ANGANGUEO,005,SEGUNDA MANZANA DE NICOLÁS ROMERO (CAÑADA DEL MUERTO),4,78,35,43,6
MICHOACÁN DE OCAMPO,16,ANGANGUEO,005,SEGUNDO CUARTEL DE RONDANILLA,1,14,8,6,1
MICHOACÁN DE OCAMPO,16,APATZINGÁN,006,ACATLÁN,2,18,10,8,2
MICHOACÁN DE OCAMPO,16,APATZINGÁN,006,APATZINGÁN DE LA CONSTITUCIÓN,163,23848,12346,11502,1696
MICHOACÁN DE OCAMPO,16,APATZINGÁN,006,CALIFORNIA,2,28,7,21,2
MICHOACÁN DE OCAMPO,16,APATZINGÁN,006,CENOBIO MORENO (LAS COLONIAS),5,824,422,402,38
MICHOACÁN DE OCAMPO,16,APATZINGÁN,006,CHANDIO (EJIDO LA CONCHA),4,1702,729,973,88
MICHOACÁN DE OCAMPO,16,APATZINGÁN,006,CHIQUIHUITILLO,3,123,59,64,11
MICHOACÁN DE OCAMPO,16,APATZINGÁN,006,CUAUHTÉMOC CÁRDENAS (EL GUAYABO),3,127,53,74,10
MICHOACÁN DE OCAMPO,16,APATZINGÁN,006,CUERAMATO,3,39,23,16,4
MICHOACÁN DE OCAMPO,16,APATZINGÁN,006,EJIDO JOSÉ MARÍA MORELOS,1,13,9,4,1
MICHOACÁN DE OCAMPO,16,APATZINGÁN,006,EL ALCALDE,3,63,35,28,5
MICHOACÁN DE OCAMPO,16,APATZINGÁN,006,EL CERRO BLANCO (LAS GALERAS),1,8,2,6,3
MICHOACÁN DE OCAMPO,16,APATZINGÁN,006,EL LLANO GRANDE,1,12,5,7,4
MICHOACÁN DE OCAMPO,16,APATZINGÁN,006,EL MANZO,3,79,39,40,6
MICHOACÁN DE OCAMPO,16,APATZINGÁN,006,EL MEZQUITAL (QUELELE),2,12,5,7,2
MICHOACÁN DE OCAMPO,16,APATZINGÁN,006,EL MIRADOR (TEPETATES),3,89,48,41,9
MICHOACÁN DE OCAMPO,16,APATZINGÁN,006,EL MOLINITO (LA PRIMAVERA),2,86,37,49,4
MICHOACÁN DE OCAMPO,16,APATZINGÁN,006,EL MORADO,3,59,33,26,5
MICHOACÁN DE OCAMPO,16,APATZINGÁN,006,EL PINO NUEVO,4,141,75,66,12
MICHOACÁN DE OCAMPO,16,APATZINGÁN,006,EL RECREO,3,320,141,179,18
MICHOACÁN DE OCAMPO,16,APATZINGÁN,006,EL TEPETATE,1,17,10,7,3
MICHOACÁN DE OCAMPO,16,APATZINGÁN,006,EL TESORERO (ALTAMIRA),3,74,37,37,6
MICHOACÁN DE OCAMPO,16,APATZINGÁN,006,EL VALLE DE ACATLÁN,2,11,7,4,2
MICHOACÁN DE OCAMPO,16,APATZINGÁN,006,GUANAJUATILLO,3,42,21,21,4
MICHOACÁN DE OCAMPO,16,APATZINGÁN,006,HOLANDA,4,89,41,48,7
MICHOACÁN DE OCAMPO,16,APATZINGÁN,006,JOSÉ TAFOLLA CABALLERO (LAS DELICIAS) [FRACCIONAMIENTO],1,4,1,3,1
MICHOACÁN DE OCAMPO,16,APATZINGÁN,006,LA COFRADÍA,3,142,65,77,10
MICHOACÁN DE OCAMPO,16,APATZINGÁN,006,LA HUERTA (HACIENDA DE LA HUERTA),3,97,55,42,6
MICHOACÁN DE OCAMPO,16,APATZINGÁN,006,LA NOPALERA ORIENTE,3,230,105,125,14
MICHOACÁN DE OCAMPO,16,APATZINGÁN,006,LA NOPALERA PONIENTE,1,24,10,14,5
MICHOACÁN DE OCAMPO,16,APATZINGÁN,006,LA PIEDRA,2,10,5,5,2
MICHOACÁN DE OCAMPO,16,APATZINGÁN,006,LA PRESA DE ACAHUATO,2,34,12,22,3
MICHOACÁN DE OCAMPO,16,APATZINGÁN,006,LAS BATEAS (EL VENTEADERO),3,58,31,27,7
MICHOACÁN DE OCAMPO,16,APATZINGÁN,006,LAS MARAVILLAS DE ACAHUATO (LA COLONIA),1,19,11,8,1
MICHOACÁN DE OCAMPO,16,APATZINGÁN,006,LAS TINAJAS,1,33,12,21,4
MICHOACÁN DE OCAMPO,16,APATZINGÁN,006,LAS TINAJAS (EL PILAR),1,5,5,0,1
MICHOACÁN DE OCAMPO,16,APATZINGÁN,006,LOMA DE LOS HOYOS,3,297,146,151,20
MICHOACÁN DE OCAMPO,16,APATZINGÁN,006,LOS HORNOS,3,99,49,50,9
MICHOACÁN DE OCAMPO,16,APATZINGÁN,006,LOS LAURELES,1,10,6,4,1
MICHOACÁN DE OCAMPO,16,APATZINGÁN,006,LOS PUERTECITOS (RINCÓN DE LOS BUEYES),3,43,19,24,4
MICHOACÁN DE OCAMPO,16,APATZINGÁN,006,LOS SANDOVAL,3,27,9,18,4
MICHOACÁN DE OCAMPO,16,APATZINGÁN,006,MATA DE PLÁTANO (PUNTA DE AGUA),3,41,21,20,4
MICHOACÁN DE OCAMPO,16,APATZINGÁN,006,PALO ALTO,3,39,17,22,4
MICHOACÁN DE OCAMPO,16,APATZINGÁN,006,PASO DEL CAPIRE,2,10,4,6,2
MICHOACÁN DE OCAMPO,16,APATZINGÁN,006,PRESA DEL ROSARIO,4,289,149,140,19
MICHOACÁN DE OCAMPO,16,APATZINGÁN,006,PUERTA DE ALAMBRE (AYACUATO),2,115,57,58,10
MICHOACÁN DE OCAMPO,16,APATZINGÁN,006,RANCHO SECO,2,5,2,3,1
MICHOACÁN DE OCAMPO,16,APATZINGÁN,006,SAN ANTONIO LA LABOR,3,183,93,90,13
MICHOACÁN DE OCAMPO,16,APATZINGÁN,006,SAN FERNANDO,3,56,29,27,8
MICHOACÁN DE OCAMPO,16,APATZINGÁN,006,SAN JOSÉ DE CHILA,4,137,72,65,10
MICHOACÁN DE OCAMPO,16,APATZINGÁN,006,SAN JOSÉ NUEVO,3,59,34,25,4
MICHOACÁN DE OCAMPO,16,APATZINGÁN,006,SAN JUAN DE LOS PLÁTANOS,4,266,127,139,17
MICHOACÁN DE OCAMPO,16,APATZINGÁN,006,SANTIAGO ACAHUATO,5,438,241,197,24
MICHOACÁN DE OCAMPO,16,APORO,007,ALVARADO,1,4,3,1,1
MICHOACÁN DE OCAMPO,16,APORO,007,APORO,7,838,446,392,48
MICHOACÁN DE OCAMPO,16,APORO,007,ARROYO SECO,2,41,21,20,3
MICHOACÁN DE OCAMPO,16,APORO,007,MANZANA SEGUNDA,1,19,11,8,1
MICHOACÁN DE OCAMPO,16,APORO,007,MARTINILLOS DE JUAN PÉREZ,2,30,17,13,2
MICHOACÁN DE OCAMPO,16,APORO,007,OJO DE AGUA,2,27,11,16,2
MICHOACÁN DE OCAMPO,16,APORO,007,RINCÓN DE SOTO (EL OYAMEL),2,62,29,33,5
MICHOACÁN DE OCAMPO,16,AQUILA,008,AGUA CALIENTE (LA PIÑA),1,9,5,4,1
MICHOACÁN DE OCAMPO,16,AQUILA,008,AQUILA,6,929,472,457,45
MICHOACÁN DE OCAMPO,16,AQUILA,008,ARENAS BLANCAS,1,12,4,8,2
MICHOACÁN DE OCAMPO,16,AQUILA,008,BARRANCA DE LA TROJA,2,5,1,4,1
MICHOACÁN DE OCAMPO,16,AQUILA,008,BARRANCA DE LAS CAMPANAS,1,15,7,8,1
MICHOACÁN DE OCAMPO,16,AQUILA,008,BARRANCA DE LÓPEZ,3,40,20,20,3
MICHOACÁN DE OCAMPO,16,AQUILA,008,BARRANCA DEL POTRERO (EL HIGUERAL),1,5,2,3,1
MICHOACÁN DE OCAMPO,16,AQUILA,008,BARRANCA DEL SAPO,2,18,3,15,2
MICHOACÁN DE OCAMPO,16,AQUILA,008,BEJAMA,2,36,16,20,4
MICHOACÁN DE OCAMPO,16,AQUILA,008,CACHÁN DE ECHEVERRÍA,5,275,148,127,20
MICHOACÁN DE OCAMPO,16,AQUILA,008,CERRO PRIETO,1,7,3,4,1
MICHOACÁN DE OCAMPO,16,AQUILA,008,CHACALA,2,22,12,10,3
MICHOACÁN DE OCAMPO,16,AQUILA,008,CHACALAPA DE COIRE,3,63,33,30,5
MICHOACÁN DE OCAMPO,16,AQUILA,008,CHOCOLA,1,5,2,3,1
MICHOACÁN DE OCAMPO,16,AQUILA,008,COBANERA DE OSTULA,2,61,26,35,5
MICHOACÁN DE OCAMPO,16,AQUILA,008,COBÍGENES,3,47,23,24,4
MICHOACÁN DE OCAMPO,16,AQUILA,008,COCHUMALA,2,7,6,1,2
MICHOACÁN DE OCAMPO,16,AQUILA,008,COIRE,6,356,174,182,24
MICHOACÁN DE OCAMPO,16,AQUILA,008,COIRE VIEJO,1,4,4,0,1
MICHOACÁN DE OCAMPO,16,AQUILA,008,COLOLA,5,455,223,232,33
MICHOACÁN DE OCAMPO,16,AQUILA,008,CORRALITOS,2,19,10,9,2
MICHOACÁN DE OCAMPO,16,AQUILA,008,CRUZ DE CAMPOS,2,75,39,36,4
MICHOACÁN DE OCAMPO,16,AQUILA,008,CUILALA DE HIDALGO,3,84,43,41,6
MICHOACÁN DE OCAMPO,16,AQUILA,008,CUIRLA (LA CHANGUNGUERA DE CÁRDENAS),3,89,39,50,7
MICHOACÁN DE OCAMPO,16,AQUILA,008,EL ACHOTE,2,12,5,7,2
MICHOACÁN DE OCAMPO,16,AQUILA,008,EL ATRANCÓN,2,96,49,47,8
MICHOACÁN DE OCAMPO,16,AQUILA,008,EL CALVARIO (CRUCES DE OSTULA),2,21,7,14,2
MICHOACÁN DE OCAMPO,16,AQUILA,008,EL CARRIZAL,1,4,2,2,0
MICHOACÁN DE OCAMPO,16,AQUILA,008,EL CAYAQUITO,1,3,3,0,1
MICHOACÁN DE OCAMPO,16,AQUILA,008,EL CHICO DEL MORRO,1,18,7,11,1
MICHOACÁN DE OCAMPO,16,AQUILA,008,EL COYUL,2,5,2,3,1
MICHOACÁN DE OCAMPO,16,AQUILA,008,EL DIEZMO,2,47,21,26,4
MICHOACÁN DE OCAMPO,16,AQUILA,008,EL DUIN,4,161,82,79,12
MICHOACÁN DE OCAMPO,16,AQUILA,008,EL FARO DE BUCERÍAS,7,521,304,217,34
MICHOACÁN DE OCAMPO,16,AQUILA,008,EL HIGUERAL,1,20,11,9,1
MICHOACÁN DE OCAMPO,16,AQUILA,008,EL INMEDIATO,1,10,4,6,2
MICHOACÁN DE OCAMPO,16,AQUILA,008,EL LLANO (MADRIGALEÑO),3,17,7,10,2
MICHOACÁN DE OCAMPO,16,AQUILA,008,EL NUEVE,3,19,8,11,3
MICHOACÁN DE OCAMPO,16,AQUILA,008,EL OCOTE,2,17,8,9,2
MICHOACÁN DE OCAMPO,16,AQUILA,008,EL OJO DE AGUA,2,12,6,6,2
MICHOACÁN DE OCAMPO,16,AQUILA,008,EL OTATE,3,63,29,34,6
MICHOACÁN DE OCAMPO,16,AQUILA,008,EL POTRERO DE OSTULA,2,23,11,12,2
MICHOACÁN DE OCAMPO,16,AQUILA,008,EL RASGUÑADO,1,4,4,0,1
MICHOACÁN DE OCAMPO,16,AQUILA,008,EL ROSARIO,3,37,20,17,4
MICHOACÁN DE OCAMPO,16,AQUILA,008,EL SALADO (PALMA ARENA),1,4,2,2,1
MICHOACÁN DE OCAMPO,16,AQUILA,008,EL SAUCITO,2,25,14,11,2
MICHOACÁN DE OCAMPO,16,AQUILA,008,EL SOCORRO,1,11,5,6,1
MICHOACÁN DE OCAMPO,16,AQUILA,008,EL TERRERO,1,6,0,6,1
MICHOACÁN DE OCAMPO,16,AQUILA,008,EL TERRERO DE LA ESTANZUELA,1,13,3,10,1
MICHOACÁN DE OCAMPO,16,AQUILA,008,EL ZAPOTE DE MADERO,3,55,27,28,5
MICHOACÁN DE OCAMPO,16,AQUILA,008,ESTOPILA,3,68,39,29,4
MICHOACÁN DE OCAMPO,16,AQUILA,008,HERRADERO,1,5,2,3,1
MICHOACÁN DE OCAMPO,16,AQUILA,008,HUAHUA,5,197,100,97,15
MICHOACÁN DE OCAMPO,16,AQUILA,008,IXTAPILLA,3,130,63,67,11
MICHOACÁN DE OCAMPO,16,AQUILA,008,LA CIÉNEGA (CIÉNEGA DEL POMARO),2,5,2,3,2
MICHOACÁN DE OCAMPO,16,AQUILA,008,LA COFRADÍA DE OSTULA,5,286,158,128,19
MICHOACÁN DE OCAMPO,16,AQUILA,008,LA CORALILLA,2,8,5,3,2
MICHOACÁN DE OCAMPO,16,AQUILA,008,LA CRUZ DEL COIRE,1,2,1,1,1
MICHOACÁN DE OCAMPO,16,AQUILA,008,LA CUIDARA,1,3,0,3,1
MICHOACÁN DE OCAMPO,16,AQUILA,008,LA ESTANZUELA,3,70,36,34,5
MICHOACÁN DE OCAMPO,16,AQUILA,008,LA LABOR,3,76,38,38,6
MICHOACÁN DE OCAMPO,16,AQUILA,008,LA LAGUNA DE FERNÁNDEZ,1,5,4,1,1
MICHOACÁN DE OCAMPO,16,AQUILA,008,LA MAJADA (LA MAJADITA),2,25,9,16,3
MICHOACÁN DE OCAMPO,16,AQUILA,008,LA MAJAHUITA,1,6,5,1,1
MICHOACÁN DE OCAMPO,16,AQUILA,008,LA MANZANILLERA,2,44,17,27,3
MICHOACÁN DE OCAMPO,16,AQUILA,008,LA MINA DE LA PROVIDENCIA,3,77,47,30,6
MICHOACÁN DE OCAMPO,16,AQUILA,008,LA NARANJA,2,15,6,9,2
MICHOACÁN DE OCAMPO,16,AQUILA,008,LA PALMA SOLA,3,46,20,26,4
MICHOACÁN DE OCAMPO,16,AQUILA,008,LA PAROTA,2,14,8,6,2
MICHOACÁN DE OCAMPO,16,AQUILA,008,LA PAROTITA,1,10,5,5,2
MICHOACÁN DE OCAMPO,16,AQUILA,008,LA PITILLERA,1,5,2,3,1
MICHOACÁN DE OCAMPO,16,AQUILA,008,LA PLACITA DE MORELOS,4,469,236,233,23
MICHOACÁN DE OCAMPO,16,AQUILA,008,LA SIERRITA,1,23,8,15,1
MICHOACÁN DE OCAMPO,16,AQUILA,008,LA TICLA,5,240,110,130,18
MICHOACÁN DE OCAMPO,16,AQUILA,008,LA VAINILLA DE OSTULA,2,10,7,3,1
MICHOACÁN DE OCAMPO,16,AQUILA,008,LAS GÜINAS,1,8,5,3,1
MICHOACÁN DE OCAMPO,16,AQUILA,008,LAS HACIENDAS,2,78,36,42,7
MICHOACÁN DE OCAMPO,16,AQUILA,008,LAS PALMITAS,2,10,6,4,2
MICHOACÁN DE OCAMPO,16,AQUILA,008,LAS TROJITAS UNO,1,5,2,3,1
MICHOACÁN DE OCAMPO,16,AQUILA,008,LINDA VISTA,1,47,35,12,2
MICHOACÁN DE OCAMPO,16,AQUILA,008,LOMAS BLANCAS,2,4,1,3,1
MICHOACÁN DE OCAMPO,16,AQUILA,008,LOS CIMIENTOS,1,5,2,3,1
MICHOACÁN DE OCAMPO,16,AQUILA,008,LOS CUIRES,1,8,5,3,1
MICHOACÁN DE OCAMPO,16,AQUILA,008,LOS ENCINOS,2,21,16,5,3
MICHOACÁN DE OCAMPO,16,AQUILA,008,LOS GALLOS (SAN ISIDRO),3,21,11,10,3
MICHOACÁN DE OCAMPO,16,AQUILA,008,LOS PARAJES,2,9,4,5,2
MICHOACÁN DE OCAMPO,16,AQUILA,008,MAJAHUA,2,33,15,18,3
MICHOACÁN DE OCAMPO,16,AQUILA,008,MAQUILI,3,83,37,46,3
MICHOACÁN DE OCAMPO,16,AQUILA,008,MARIALITOS,3,85,52,33,6
MICHOACÁN DE OCAMPO,16,AQUILA,008,MARUATA,4,315,159,156,24
MICHOACÁN DE OCAMPO,16,AQUILA,008,MOTÍN DEL ORO,4,109,47,62,10
MICHOACÁN DE OCAMPO,16,AQUILA,008,PASO DE NORIA,2,55,32,23,6
MICHOACÁN DE OCAMPO,16,AQUILA,008,PICHILINGUILLO,1,11,6,5,2
MICHOACÁN DE OCAMPO,16,AQUILA,008,POMARO,5,365,169,196,24
MICHOACÁN DE OCAMPO,16,AQUILA,008,PUEBLO NUEVO,2,28,16,12,2
MICHOACÁN DE OCAMPO,16,AQUILA,008,PUERTO DEL TORO,1,8,1,7,1
MICHOACÁN DE OCAMPO,16,AQUILA,008,RANCHO CLARA,2,6,5,1,1
MICHOACÁN DE OCAMPO,16,AQUILA,008,RANCHO DE VALENCIA,1,21,10,11,2
MICHOACÁN DE OCAMPO,16,AQUILA,008,RANCHO VIEJO,1,7,5,2,2
MICHOACÁN DE OCAMPO,16,AQUILA,008,SAN JUAN DE ALIMA,2,57,27,30,5
MICHOACÁN DE OCAMPO,16,AQUILA,008,SAN JUAN DE LAS PALMERAS,1,6,3,3,1
MICHOACÁN DE OCAMPO,16,AQUILA,008,SAN LUIS,1,5,3,2,1
MICHOACÁN DE OCAMPO,16,AQUILA,008,SAN PEDRO NARANJESTIL,5,225,120,105,14
MICHOACÁN DE OCAMPO,16,AQUILA,008,SANTA CRUZ DE CACHÁN,1,27,12,15,2
MICHOACÁN DE OCAMPO,16,AQUILA,008,SANTA MARÍA DE OSTULA,6,635,354,281,33
MICHOACÁN DE OCAMPO,16,AQUILA,008,TIZUPAN,4,127,64,63,12
MICHOACÁN DE OCAMPO,16,AQUILA,008,TOMEN,1,9,3,6,1
MICHOACÁN DE OCAMPO,16,AQUILA,008,VALDOVINOS DEL COIRE,2,27,11,16,2
MICHOACÁN DE OCAMPO,16,AQUILA,008,XAYAKALAN,1,46,22,24,3
MICHOACÁN DE OCAMPO,16,AQUILA,008,ZILAPA,1,16,9,7,2
MICHOACÁN DE OCAMPO,16,ARIO,009,ÁFRICA,2,11,2,9,2
MICHOACÁN DE OCAMPO,16,ARIO,009,AGUA ZARCA DE ORIENTE (EL CAZO),2,8,3,5,1
MICHOACÁN DE OCAMPO,16,ARIO,009,ARAPARÍCUARO,3,113,59,54,8
MICHOACÁN DE OCAMPO,16,ARIO,009,ARIO DE ROSALES,23,5204,2728,2476,241
MICHOACÁN DE OCAMPO,16,ARIO,009,BUEN SUCESO,3,40,14,26,4
MICHOACÁN DE OCAMPO,16,ARIO,009,BUENA VISTA DEL SUR,1,10,2,8,1
MICHOACÁN DE OCAMPO,16,ARIO,009,CHUÉN,2,175,80,95,7
MICHOACÁN DE OCAMPO,16,ARIO,009,CUARAYO,2,19,9,10,2
MICHOACÁN DE OCAMPO,16,ARIO,009,DOCTOR MIGUEL SILVA MACÍAS,4,759,374,385,36
MICHOACÁN DE OCAMPO,16,ARIO,009,EL AGOSTADERO,3,49,20,29,4
MICHOACÁN DE OCAMPO,16,ARIO,009,EL ARENAL,3,70,32,38,6
MICHOACÁN DE OCAMPO,16,ARIO,009,EL CALABOZO,3,97,55,42,6
MICHOACÁN DE OCAMPO,16,ARIO,009,EL CANGREJO,2,12,6,6,2
MICHOACÁN DE OCAMPO,16,ARIO,009,EL CARRIZALILLO DE URAPA,1,8,3,5,1
MICHOACÁN DE OCAMPO,16,ARIO,009,EL CHUPADERO,3,202,103,99,12
MICHOACÁN DE OCAMPO,16,ARIO,009,EL LIMÓN DEL TEJAMANIL,1,3,1,2,2
MICHOACÁN DE OCAMPO,16,ARIO,009,EL MORAL,2,75,40,35,5
MICHOACÁN DE OCAMPO,16,ARIO,009,EL MORTERO,2,4,1,3,2
MICHOACÁN DE OCAMPO,16,ARIO,009,EL ORTIGALITO,3,73,32,41,4
MICHOACÁN DE OCAMPO,16,ARIO,009,EL POTRERO DE PABLO CUIN (ALTITO DE PABLO CUIN),2,25,10,15,2
MICHOACÁN DE OCAMPO,16,ARIO,009,EL PUENTE ALTO,2,24,12,12,2
MICHOACÁN DE OCAMPO,16,ARIO,009,EL SAUCITO (POTRERO DE LOS BUEYES),3,29,15,14,3
MICHOACÁN DE OCAMPO,16,ARIO,009,EL TEJAMANIL,1,7,5,2,1
MICHOACÁN DE OCAMPO,16,ARIO,009,EL TEPAMAL,4,341,183,158,16
MICHOACÁN DE OCAMPO,16,ARIO,009,EL VALLE (VALLE NUEVO),2,7,5,2,2
MICHOACÁN DE OCAMPO,16,ARIO,009,LA BARRA (LA BARRA GRANDE),3,40,22,18,3
MICHOACÁN DE OCAMPO,16,ARIO,009,LA BARRITA (LA BARRA CHICA),2,19,11,8,2
MICHOACÁN DE OCAMPO,16,ARIO,009,LA CANTERA,2,31,21,10,2
MICHOACÁN DE OCAMPO,16,ARIO,009,LA CEBADILLA (LA HACIENDA),1,15,7,8,1
MICHOACÁN DE OCAMPO,16,ARIO,009,LA PAROTA,1,8,6,2,1
MICHOACÁN DE OCAMPO,16,ARIO,009,LA PLAYA DE GUADALUPE,4,104,47,57,11
MICHOACÁN DE OCAMPO,16,ARIO,009,LA SANDÍA,3,40,24,16,4
MICHOACÁN DE OCAMPO,16,ARIO,009,LAS CANALEJAS,3,37,14,23,3
MICHOACÁN DE OCAMPO,16,ARIO,009,LAS CARÁMICUAS,2,57,34,23,5
MICHOACÁN DE OCAMPO,16,ARIO,009,LAS ESCOBILLAS,2,86,44,42,5
MICHOACÁN DE OCAMPO,16,ARIO,009,LAS PUENTES,3,156,71,85,10
MICHOACÁN DE OCAMPO,16,ARIO,009,LOS ATES [HACIENDA],2,161,76,85,9
MICHOACÁN DE OCAMPO,16,ARIO,009,LOS MORALES,2,10,5,5,1
MICHOACÁN DE OCAMPO,16,ARIO,009,LOS NEGROS,2,66,31,35,4
MICHOACÁN DE OCAMPO,16,ARIO,009,LOS PAREOS,2,60,34,26,3
MICHOACÁN DE OCAMPO,16,ARIO,009,MANZANILLO CHICO,2,13,3,10,2
MICHOACÁN DE OCAMPO,16,ARIO,009,MESA DEL MANZANILLO,2,71,27,44,2
MICHOACÁN DE OCAMPO,16,ARIO,009,OJO ZARCO,2,20,7,13,2
MICHOACÁN DE OCAMPO,16,ARIO,009,PABLO CUIN,3,308,144,164,13
MICHOACÁN DE OCAMPO,16,ARIO,009,PALMA CUATA,2,13,5,8,2
MICHOACÁN DE OCAMPO,16,ARIO,009,PALMA DE ALTAMIRA (PALMA DE JUÁREZ),4,299,143,156,17
MICHOACÁN DE OCAMPO,16,ARIO,009,PASO REAL,2,78,37,41,4
MICHOACÁN DE OCAMPO,16,ARIO,009,PLANILLAS,1,6,4,2,1
MICHOACÁN DE OCAMPO,16,ARIO,009,PUENTECILLAS,2,46,28,18,3
MICHOACÁN DE OCAMPO,16,ARIO,009,RANCHO NUEVO (COLIMILLA),3,25,14,11,3
MICHOACÁN DE OCAMPO,16,ARIO,009,RANCHO NUEVO DE CHUÉN,1,46,26,20,3
MICHOACÁN DE OCAMPO,16,ARIO,009,RINCÓN DE LA YERBABUENA (RINCÓN DEL BURRO),1,12,8,4,1
MICHOACÁN DE OCAMPO,16,ARIO,009,SAN CAYETANO,2,23,8,15,2
MICHOACÁN DE OCAMPO,16,ARIO,009,SAN JOSÉ DE CHUÉN,3,208,107,101,12
MICHOACÁN DE OCAMPO,16,ARIO,009,SAN JOSÉ DE LAS CAÑAS,3,66,33,33,6
MICHOACÁN DE OCAMPO,16,ARIO,009,TAHUENAMBO (TABUENAMBO),1,6,2,4,1
MICHOACÁN DE OCAMPO,16,ARIO,009,TIPITARILLO,3,159,75,84,10
MICHOACÁN DE OCAMPO,16,ARIO,009,TIRINDIRITZIO,2,12,6,6,2
MICHOACÁN DE OCAMPO,16,ARIO,009,TRES PALOS,1,6,5,1,1
MICHOACÁN DE OCAMPO,16,ARIO,009,TUNÁCUARO,2,93,50,43,8
MICHOACÁN DE OCAMPO,16,ARIO,009,URAPA,4,352,167,185,18
MICHOACÁN DE OCAMPO,16,ARIO,009,ZATZIO,4,330,176,154,18
MICHOACÁN DE OCAMPO,16,ARTEAGA,010,ANTÚNEZ,1,7,2,5,1
MICHOACÁN DE OCAMPO,16,ARTEAGA,010,ARTEAGA,27,3843,2116,1727,287
MICHOACÁN DE OCAMPO,16,ARTEAGA,010,BRAVO,1,8,1,7,1
MICHOACÁN DE OCAMPO,16,ARTEAGA,010,BUENAVISTA,2,5,3,2,2
MICHOACÁN DE OCAMPO,16,ARTEAGA,010,CERRO DE LA LUMBRE,3,47,22,25,6
MICHOACÁN DE OCAMPO,16,ARTEAGA,010,EL ARENAL,3,65,35,30,10
MICHOACÁN DE OCAMPO,16,ARTEAGA,010,EL CAMPO DE AVIACIÓN,1,10,6,4,1
MICHOACÁN DE OCAMPO,16,ARTEAGA,010,EL CASCALOTE,1,6,3,3,2
MICHOACÁN DE OCAMPO,16,ARTEAGA,010,EL CHANGUNGO,2,19,8,11,4
MICHOACÁN DE OCAMPO,16,ARTEAGA,010,EL CÓBANO,1,5,1,4,1
MICHOACÁN DE OCAMPO,16,ARTEAGA,010,EL DESCANSADERO,1,24,13,11,4
MICHOACÁN DE OCAMPO,16,ARTEAGA,010,EL ESPADÍN,3,10,2,8,3
MICHOACÁN DE OCAMPO,16,ARTEAGA,010,EL ESPINAL (SAN JOSÉ DEL MILAGRO),2,35,16,19,5
MICHOACÁN DE OCAMPO,16,ARTEAGA,010,EL GUAYABITO (LA ORDEÑITA),1,33,19,14,5
MICHOACÁN DE OCAMPO,16,ARTEAGA,010,EL GUAYABO NORTE (EL GUAYABILLO),4,89,52,37,8
MICHOACÁN DE OCAMPO,16,ARTEAGA,010,EL HUINDURE,3,25,14,11,3
MICHOACÁN DE OCAMPO,16,ARTEAGA,010,EL LIMÓN DE FRANCO,4,106,54,52,10
MICHOACÁN DE OCAMPO,16,ARTEAGA,010,EL MOLINO (EL MOLINO DE CATARINA),1,25,12,13,2
MICHOACÁN DE OCAMPO,16,ARTEAGA,010,EL MULETO,1,10,5,5,2
MICHOACÁN DE OCAMPO,16,ARTEAGA,010,EL NARANJITO,1,7,2,5,1
MICHOACÁN DE OCAMPO,16,ARTEAGA,010,EL OTATE,3,36,14,22,8
MICHOACÁN DE OCAMPO,16,ARTEAGA,010,EL PAJAL,2,9,5,4,1
MICHOACÁN DE OCAMPO,16,ARTEAGA,010,EL PAPAYO,2,31,13,18,4
MICHOACÁN DE OCAMPO,16,ARTEAGA,010,EL PERDIDO,1,10,5,5,1
MICHOACÁN DE OCAMPO,16,ARTEAGA,010,EL PLATANITO,2,30,13,17,3
MICHOACÁN DE OCAMPO,16,ARTEAGA,010,EL REPARITO,1,4,3,1,1
MICHOACÁN DE OCAMPO,16,ARTEAGA,010,EL SAUCITO (LOS SAUCITOS),1,22,9,13,3
MICHOACÁN DE OCAMPO,16,ARTEAGA,010,EL SAUZ,1,13,8,5,1
MICHOACÁN DE OCAMPO,16,ARTEAGA,010,EL VALLE,2,24,13,11,3
MICHOACÁN DE OCAMPO,16,ARTEAGA,010,EL ZAPOTE DE TOSCANO,1,12,6,6,2
MICHOACÁN DE OCAMPO,16,ARTEAGA,010,ESPINOSA,5,148,70,78,17
MICHOACÁN DE OCAMPO,16,ARTEAGA,010,INFIERNILLO,1,212,138,74,10
MICHOACÁN DE OCAMPO,16,ARTEAGA,010,INFIERNILLO (MORELOS DE INFIERNILLO),8,546,277,269,40
MICHOACÁN DE OCAMPO,16,ARTEAGA,010,JAUJILLA,1,12,4,8,2
MICHOACÁN DE OCAMPO,16,ARTEAGA,010,LA BOLSA (LAS BOLSAS),1,25,10,15,2
MICHOACÁN DE OCAMPO,16,ARTEAGA,010,LA CIÉNEGA,2,15,7,8,2
MICHOACÁN DE OCAMPO,16,ARTEAGA,010,LA CONCEPCIÓN,3,27,10,17,4
MICHOACÁN DE OCAMPO,16,ARTEAGA,010,LA LAJITA (LOS BERMEJOS),3,45,25,20,6
MICHOACÁN DE OCAMPO,16,ARTEAGA,010,LA PAREJA,4,109,56,53,13
MICHOACÁN DE OCAMPO,16,ARTEAGA,010,LA PAROTERA,2,22,11,11,3
MICHOACÁN DE OCAMPO,16,ARTEAGA,010,LA PEÑITA,1,7,4,3,1
MICHOACÁN DE OCAMPO,16,ARTEAGA,010,LA TINAJA,1,9,4,5,1
MICHOACÁN DE OCAMPO,16,ARTEAGA,010,LA VINATA,3,140,60,80,17
MICHOACÁN DE OCAMPO,16,ARTEAGA,010,LA VUELTA,1,13,6,7,2
MICHOACÁN DE OCAMPO,16,ARTEAGA,010,LAS CAMELINAS,1,3,2,1,1
MICHOACÁN DE OCAMPO,16,ARTEAGA,010,LAS CAÑAS,4,552,306,246,32
MICHOACÁN DE OCAMPO,16,ARTEAGA,010,LAS HEMBRILLAS,1,9,5,4,2
MICHOACÁN DE OCAMPO,16,ARTEAGA,010,LAS HIGUERAS,1,15,6,9,3
MICHOACÁN DE OCAMPO,16,ARTEAGA,010,LAS HUERTITAS,2,9,2,7,2
MICHOACÁN DE OCAMPO,16,ARTEAGA,010,LAS JUNTAS,2,61,28,33,8
MICHOACÁN DE OCAMPO,16,ARTEAGA,010,LAS JUNTAS DE PALOS PRIETOS,2,9,6,3,2
MICHOACÁN DE OCAMPO,16,ARTEAGA,010,LAS LAGUNAS,2,18,8,10,3
MICHOACÁN DE OCAMPO,16,ARTEAGA,010,LOS CAPIRES,1,5,4,1,1
MICHOACÁN DE OCAMPO,16,ARTEAGA,010,LOS COPALES,2,22,11,11,3
MICHOACÁN DE OCAMPO,16,ARTEAGA,010,LOS HABILLOS,1,4,0,4,1
MICHOACÁN DE OCAMPO,16,ARTEAGA,010,LOS HORCONES,2,12,5,7,3
MICHOACÁN DE OCAMPO,16,ARTEAGA,010,LOS POTREROS,1,20,13,7,3
MICHOACÁN DE OCAMPO,16,ARTEAGA,010,LOS POZOS,2,10,6,4,2
MICHOACÁN DE OCAMPO,16,ARTEAGA,010,PALO DULCE (COALCOMECA),1,10,6,4,1
MICHOACÁN DE OCAMPO,16,ARTEAGA,010,PASO DE LA GOLETA,3,43,22,21,4
MICHOACÁN DE OCAMPO,16,ARTEAGA,010,PASO DEL ATUTO (LECHUGUILLAS),1,6,3,3,1
MICHOACÁN DE OCAMPO,16,ARTEAGA,010,PASO DEL CHIVO,1,10,4,6,2
MICHOACÁN DE OCAMPO,16,ARTEAGA,010,PINZANDARÁN,3,94,53,41,12
MICHOACÁN DE OCAMPO,16,ARTEAGA,010,PLAN DE ARMAS,1,11,6,5,2
MICHOACÁN DE OCAMPO,16,ARTEAGA,010,RINCÓN DE VALDÉS,3,20,11,9,4
MICHOACÁN DE OCAMPO,16,ARTEAGA,010,SAN ISIDRO,3,30,16,14,5
MICHOACÁN DE OCAMPO,16,ARTEAGA,010,SAN JOSÉ DE LOS PINOS (MANCHA DE PINOS),1,9,5,4,2
MICHOACÁN DE OCAMPO,16,ARTEAGA,010,TOLUQUILLA,3,40,19,21,4
MICHOACÁN DE OCAMPO,16,ARTEAGA,010,TOTOTÁN,1,8,3,5,1
MICHOACÁN DE OCAMPO,16,ARTEAGA,010,VALLECITOS,1,3,2,1,1
MICHOACÁN DE OCAMPO,16,BRISEÑAS,011,BRISEÑAS DE MATAMOROS,6,1066,539,527,49
MICHOACÁN DE OCAMPO,16,BRISEÑAS,011,CUMUATO,2,109,55,54,8
MICHOACÁN DE OCAMPO,16,BRISEÑAS,011,IBARRA,3,246,127,119,11
MICHOACÁN DE OCAMPO,16,BRISEÑAS,011,PASO DE HIDALGO (PASO DE ÁLAMOS),2,236,116,120,12
MICHOACÁN DE OCAMPO,16,BRISEÑAS,011,SAN MIGUEL,3,26,10,16,4
MICHOACÁN DE OCAMPO,16,BUENAVISTA,012,BENITO JUÁREZ,2,97,55,42,4
MICHOACÁN DE OCAMPO,16,BUENAVISTA,012,BUENAVISTA TOMATLÁN,12,2941,1536,1405,143
MICHOACÁN DE OCAMPO,16,BUENAVISTA,012,BUENAVISTILLA (LA GARITA),2,66,28,38,5
MICHOACÁN DE OCAMPO,16,BUENAVISTA,012,CATALINAS (FRANCISCO VILLA),4,672,353,319,39
MICHOACÁN DE OCAMPO,16,BUENAVISTA,012,CERRITO COLORADO,2,24,17,7,2
MICHOACÁN DE OCAMPO,16,BUENAVISTA,012,CINCO DE MAYO (EL LIMÓN),3,91,40,51,6
MICHOACÁN DE OCAMPO,16,BUENAVISTA,012,DIECIOCHO DE MARZO,5,360,183,177,21
MICHOACÁN DE OCAMPO,16,BUENAVISTA,012,DIVISIÓN DEL NORTE [CRUCERO DE CATALINAS],3,303,145,158,17
MICHOACÁN DE OCAMPO,16,BUENAVISTA,012,EL CARACOL,2,3,2,1,2
MICHOACÁN DE OCAMPO,16,BUENAVISTA,012,EL CHAMIZAL (FLOR DE MAYO),2,38,20,18,3
MICHOACÁN DE OCAMPO,16,BUENAVISTA,012,EL LIMÓN DE LA LUNA,4,119,62,57,7
MICHOACÁN DE OCAMPO,16,BUENAVISTA,012,EL NOPAL (LAS OLLAS),2,22,12,10,2
MICHOACÁN DE OCAMPO,16,BUENAVISTA,012,EL PILÓN,3,71,33,38,7
MICHOACÁN DE OCAMPO,16,BUENAVISTA,012,EL TAMARINDO UNO,1,9,4,5,1
MICHOACÁN DE OCAMPO,16,BUENAVISTA,012,EL TERRERO,3,112,59,53,10
MICHOACÁN DE OCAMPO,16,BUENAVISTA,012,EL TESCALAME,3,23,9,14,3
MICHOACÁN DE OCAMPO,16,BUENAVISTA,012,ERÉNDIRA,2,62,33,29,3
MICHOACÁN DE OCAMPO,16,BUENAVISTA,012,FELIPE ÁNGELES (EL PUJIDO),2,86,31,55,5
MICHOACÁN DE OCAMPO,16,BUENAVISTA,012,FELIPE CARRILLO PUERTO (LA RUANA),14,2097,1059,1038,104
MICHOACÁN DE OCAMPO,16,BUENAVISTA,012,LA ANGOSTURA,3,32,19,13,3
MICHOACÁN DE OCAMPO,16,BUENAVISTA,012,LA CUCHILLA,3,30,11,19,3
MICHOACÁN DE OCAMPO,16,BUENAVISTA,012,LA HUINA (LA HUINA UNO),2,51,26,25,3
MICHOACÁN DE OCAMPO,16,BUENAVISTA,012,LA LUNA,2,22,8,14,2
MICHOACÁN DE OCAMPO,16,BUENAVISTA,012,LAS CARRERAS,1,8,3,5,1
MICHOACÁN DE OCAMPO,16,BUENAVISTA,012,LAS COLONIAS DE LA LUNA,2,28,17,11,2
MICHOACÁN DE OCAMPO,16,BUENAVISTA,012,LAS PAREDES DEL AHOGADO,1,9,4,5,1
MICHOACÁN DE OCAMPO,16,BUENAVISTA,012,LOMA BONITA,1,11,4,7,1
MICHOACÁN DE OCAMPO,16,BUENAVISTA,012,LOS CHARCOS,2,34,17,17,4
MICHOACÁN DE OCAMPO,16,BUENAVISTA,012,PAREDES DOS,3,43,20,23,4
MICHOACÁN DE OCAMPO,16,BUENAVISTA,012,PIZÁNDARO,5,641,333,308,35
MICHOACÁN DE OCAMPO,16,BUENAVISTA,012,PUEBLO VIEJO,2,32,18,14,2
MICHOACÁN DE OCAMPO,16,BUENAVISTA,012,PUNTA DEL AGUA,3,196,119,77,12
MICHOACÁN DE OCAMPO,16,BUENAVISTA,012,RAZO DEL ÓRGANO (VEINTIUNO DE MAYO),3,122,55,67,9
MICHOACÁN DE OCAMPO,16,BUENAVISTA,012,ROSA MORADA (LAS IGUANAS),1,7,3,4,1
MICHOACÁN DE OCAMPO,16,BUENAVISTA,012,SAN ISIDRO,3,37,15,22,3
MICHOACÁN DE OCAMPO,16,BUENAVISTA,012,SAN JOSÉ PIEDRAS BLANCAS,3,126,58,68,7
MICHOACÁN DE OCAMPO,16,BUENAVISTA,012,SANTA ANA AMATLÁN,6,841,407,434,51
MICHOACÁN DE OCAMPO,16,BUENAVISTA,012,VICENTE GUERRERO,3,202,108,94,9
MICHOACÁN DE OCAMPO,16,BUENAVISTA,012,ZIMANCA,3,100,53,47,8
MICHOACÁN DE OCAMPO,16,BUENAVISTA,012,ZIRAPETIRO,2,20,10,10,2
MICHOACÁN DE OCAMPO,16,CARÁCUARO,013,ACUYO,4,117,60,57,8
MICHOACÁN DE OCAMPO,16,CARÁCUARO,013,CAÑADA DE LOS LIMONES,1,7,5,2,1
MICHOACÁN DE OCAMPO,16,CARÁCUARO,013,CAPIRE DE BRAVO (EL CAPIRE BRAVO),3,20,9,11,4
MICHOACÁN DE OCAMPO,16,CARÁCUARO,013,CARÁCUARO DE MORELOS,8,1409,698,711,90
MICHOACÁN DE OCAMPO,16,CARÁCUARO,013,CARASUMBAPIO,1,4,3,1,1
MICHOACÁN DE OCAMPO,16,CARÁCUARO,013,CEIBAS NEGRAS,2,8,5,3,2
MICHOACÁN DE OCAMPO,16,CARÁCUARO,013,EL ANONITO,1,11,4,7,1
MICHOACÁN DE OCAMPO,16,CARÁCUARO,013,EL ANONO,3,32,18,14,3
MICHOACÁN DE OCAMPO,16,CARÁCUARO,013,EL CARRIZAL,1,19,11,8,2
MICHOACÁN DE OCAMPO,16,CARÁCUARO,013,EL CUITZILLO,2,72,42,30,3
MICHOACÁN DE OCAMPO,16,CARÁCUARO,013,EL GUAYABO,1,12,4,8,1
MICHOACÁN DE OCAMPO,16,CARÁCUARO,013,EL GUAYABO DEL CARMEN,1,4,4,0,1
MICHOACÁN DE OCAMPO,16,CARÁCUARO,013,EL LIMÓN VIEJO,1,5,1,4,1
MICHOACÁN DE OCAMPO,16,CARÁCUARO,013,EL NARANJO (LAS TRINCHERAS),1,5,1,4,1
MICHOACÁN DE OCAMPO,16,CARÁCUARO,013,EL NIETO,2,30,14,16,4
MICHOACÁN DE OCAMPO,16,CARÁCUARO,013,EL PASO DEL PINZÁN,2,14,5,9,2
MICHOACÁN DE OCAMPO,16,CARÁCUARO,013,EL TEPEHUAJE,3,80,42,38,5
MICHOACÁN DE OCAMPO,16,CARÁCUARO,013,EL VALLECILLO,2,16,9,7,2
MICHOACÁN DE OCAMPO,16,CARÁCUARO,013,EL ZAPOTE DE CUENDEO,2,56,28,28,4
MICHOACÁN DE OCAMPO,16,CARÁCUARO,013,EL ZAPOTE DE LOS GÓMEZ,3,77,37,40,6
MICHOACÁN DE OCAMPO,16,CARÁCUARO,013,EL ZAPOTE DE LOS HERRERA,2,6,4,2,1
MICHOACÁN DE OCAMPO,16,CARÁCUARO,013,EL ZAPOTITO,3,32,14,18,3
MICHOACÁN DE OCAMPO,16,CARÁCUARO,013,FRONTERA DE SAN JUAN,1,19,10,9,1
MICHOACÁN DE OCAMPO,16,CARÁCUARO,013,JANINDIPO,1,17,9,8,1
MICHOACÁN DE OCAMPO,16,CARÁCUARO,013,JUNTAS DE CHAPACARÍCUARO,1,5,3,2,1
MICHOACÁN DE OCAMPO,16,CARÁCUARO,013,JUNTAS DEL ANONO (JUNTAS DE LA TORRE),2,46,23,23,2
MICHOACÁN DE OCAMPO,16,CARÁCUARO,013,LA ARBOLEDA,1,7,4,3,1
MICHOACÁN DE OCAMPO,16,CARÁCUARO,013,LA CARRERA,2,20,9,11,2
MICHOACÁN DE OCAMPO,16,CARÁCUARO,013,LA CARRERITA,2,28,12,16,2
MICHOACÁN DE OCAMPO,16,CARÁCUARO,013,LA JOYA (LA JOYA DE LOS PINOS),2,8,6,2,1
MICHOACÁN DE OCAMPO,16,CARÁCUARO,013,LA LAGUNILLA,2,8,5,3,1
MICHOACÁN DE OCAMPO,16,CARÁCUARO,013,LA PALMITA,2,9,3,6,2
MICHOACÁN DE OCAMPO,16,CARÁCUARO,013,LAS ENRAMADAS,2,11,4,7,1
MICHOACÁN DE OCAMPO,16,CARÁCUARO,013,LAS GUACAMAYAS,4,151,66,85,13
MICHOACÁN DE OCAMPO,16,CARÁCUARO,013,LAS JUNTAS DE ABAJO,2,25,15,10,3
MICHOACÁN DE OCAMPO,16,CARÁCUARO,013,LAS PARRAS,2,14,7,7,1
MICHOACÁN DE OCAMPO,16,CARÁCUARO,013,LOS EJES,2,11,2,9,3
MICHOACÁN DE OCAMPO,16,CARÁCUARO,013,PASO DE LA VIRGEN,2,24,10,14,2
MICHOACÁN DE OCAMPO,16,CARÁCUARO,013,PASO DE NÚÑEZ (BUENAVISTA),4,347,169,178,29
MICHOACÁN DE OCAMPO,16,CARÁCUARO,013,PUERTO LOS AMOLES,3,14,7,7,2
MICHOACÁN DE OCAMPO,16,CARÁCUARO,013,QUIRÍNGUARO,1,6,5,1,1
MICHOACÁN DE OCAMPO,16,CARÁCUARO,013,RANCHO VIEJO,2,15,9,6,2
MICHOACÁN DE OCAMPO,16,CARÁCUARO,013,SAN RAFAEL,2,8,1,7,2
MICHOACÁN DE OCAMPO,16,CARÁCUARO,013,ZIRANDANGÁSTICO,3,38,19,19,4
MICHOACÁN DE OCAMPO,16,COAHUAYANA,014,ACHOTÁN,2,45,26,19,3
MICHOACÁN DE OCAMPO,16,COAHUAYANA,014,BOCA DE APIZA,4,127,63,64,11
MICHOACÁN DE OCAMPO,16,COAHUAYANA,014,COAHUAYANA DE HIDALGO,14,1981,1000,981,91
MICHOACÁN DE OCAMPO,16,COAHUAYANA,014,COAHUAYANA VIEJO,6,1437,749,688,96
MICHOACÁN DE OCAMPO,16,COAHUAYANA,014,COLONIA VEINTE DE NOVIEMBRE (EL CAMALOTE),2,57,31,26,11
MICHOACÁN DE OCAMPO,16,COAHUAYANA,014,EL AHIJADERO,2,37,20,17,3
MICHOACÁN DE OCAMPO,16,COAHUAYANA,014,EL CHORUMO,3,28,18,10,4
MICHOACÁN DE OCAMPO,16,COAHUAYANA,014,EL SAUCITO,2,12,7,5,2
MICHOACÁN DE OCAMPO,16,COAHUAYANA,014,EL TICUIZ,2,102,45,57,6
MICHOACÁN DE OCAMPO,16,COAHUAYANA,014,LA ESPERANZA,1,9,3,6,2
MICHOACÁN DE OCAMPO,16,COAHUAYANA,014,LÁZARO CÁRDENAS DEL RÍO (EL ÓRGANO),2,48,21,27,2
MICHOACÁN DE OCAMPO,16,COAHUAYANA,014,OJO DE AGUA DE SAN TELMO,3,125,56,69,9
MICHOACÁN DE OCAMPO,16,COAHUAYANA,014,PALOS MARÍAS,3,61,26,35,6
MICHOACÁN DE OCAMPO,16,COAHUAYANA,014,SAN MIGUEL DEL RÍO (LO DE LUNA),2,13,10,3,2
MICHOACÁN DE OCAMPO,16,COAHUAYANA,014,SAN VICENTE,2,108,51,57,8
MICHOACÁN DE OCAMPO,16,COAHUAYANA,014,SANTA MARÍA MIRAMAR,3,50,24,26,5
MICHOACÁN DE OCAMPO,16,COAHUAYANA,014,ZAPOTÁN,3,166,92,74,12
MICHOACÁN DE OCAMPO,16,COALCOMÁN DE VÁZQUEZ PALLARES,015,BARRANCA SECA,3,40,16,24,3
MICHOACÁN DE OCAMPO,16,COALCOMÁN DE VÁZQUEZ PALLARES,015,CARRICITOS,1,1,1,0,1
MICHOACÁN DE OCAMPO,16,COALCOMÁN DE VÁZQUEZ PALLARES,015,CASA DE PIEDRA,1,1,0,1,1
MICHOACÁN DE OCAMPO,16,COALCOMÁN DE VÁZQUEZ PALLARES,015,CHANIAHUA,1,5,4,1,1
MICHOACÁN DE OCAMPO,16,COALCOMÁN DE VÁZQUEZ PALLARES,015,COALCOMÁN DE VÁZQUEZ PALLARES,19,3374,1722,1652,197
MICHOACÁN DE OCAMPO,16,COALCOMÁN DE VÁZQUEZ PALLARES,015,EL GUAYABILLO,3,18,10,8,4
MICHOACÁN DE OCAMPO,16,COALCOMÁN DE VÁZQUEZ PALLARES,015,EL IZOTE,3,11,5,6,2
MICHOACÁN DE OCAMPO,16,COALCOMÁN DE VÁZQUEZ PALLARES,015,EL MADROÑO,2,5,1,4,1
MICHOACÁN DE OCAMPO,16,COALCOMÁN DE VÁZQUEZ PALLARES,015,EL MIRADOR,1,7,5,2,1
MICHOACÁN DE OCAMPO,16,COALCOMÁN DE VÁZQUEZ PALLARES,015,EL NARANJO,1,37,13,24,2
MICHOACÁN DE OCAMPO,16,COALCOMÁN DE VÁZQUEZ PALLARES,015,EL PUERTO DE LAS CRUCES,2,20,12,8,2
MICHOACÁN DE OCAMPO,16,COALCOMÁN DE VÁZQUEZ PALLARES,015,EL SALITRE DE MARUATA,1,38,16,22,2
MICHOACÁN DE OCAMPO,16,COALCOMÁN DE VÁZQUEZ PALLARES,015,EL TARASCO,1,9,3,6,2
MICHOACÁN DE OCAMPO,16,COALCOMÁN DE VÁZQUEZ PALLARES,015,IXTALA,3,24,10,14,3
MICHOACÁN DE OCAMPO,16,COALCOMÁN DE VÁZQUEZ PALLARES,015,LA CAMPANA,2,5,3,2,1
MICHOACÁN DE OCAMPO,16,COALCOMÁN DE VÁZQUEZ PALLARES,015,LA CAPILLA DE LOS DESMONTES,2,16,8,8,2
MICHOACÁN DE OCAMPO,16,COALCOMÁN DE VÁZQUEZ PALLARES,015,LA CHICHIHUA,1,23,9,14,2
MICHOACÁN DE OCAMPO,16,COALCOMÁN DE VÁZQUEZ PALLARES,015,LA CUCHILLA,1,8,3,5,1
MICHOACÁN DE OCAMPO,16,COALCOMÁN DE VÁZQUEZ PALLARES,015,LA ENRAMADA,2,11,4,7,2
MICHOACÁN DE OCAMPO,16,COALCOMÁN DE VÁZQUEZ PALLARES,015,LA GUADALUPE DEL COBRE,3,58,36,22,4
MICHOACÁN DE OCAMPO,16,COALCOMÁN DE VÁZQUEZ PALLARES,015,LA HIGUERITA DE VENEGAS,1,67,27,40,3
MICHOACÁN DE OCAMPO,16,COALCOMÁN DE VÁZQUEZ PALLARES,015,LA JUANA MARÍA,2,30,15,15,2
MICHOACÁN DE OCAMPO,16,COALCOMÁN DE VÁZQUEZ PALLARES,015,LA MÁQUINA,1,16,8,8,1
MICHOACÁN DE OCAMPO,16,COALCOMÁN DE VÁZQUEZ PALLARES,015,LA NIEVE,3,16,8,8,3
MICHOACÁN DE OCAMPO,16,COALCOMÁN DE VÁZQUEZ PALLARES,015,LA PALMERA,2,8,7,1,1
MICHOACÁN DE OCAMPO,16,COALCOMÁN DE VÁZQUEZ PALLARES,015,LA PARRILLA,3,23,13,10,4
MICHOACÁN DE OCAMPO,16,COALCOMÁN DE VÁZQUEZ PALLARES,015,LA PLACITA,2,10,6,4,2
MICHOACÁN DE OCAMPO,16,COALCOMÁN DE VÁZQUEZ PALLARES,015,LA YERBABUENA,2,3,1,2,1
MICHOACÁN DE OCAMPO,16,COALCOMÁN DE VÁZQUEZ PALLARES,015,LAS TABERNAS,2,9,4,5,2
MICHOACÁN DE OCAMPO,16,COALCOMÁN DE VÁZQUEZ PALLARES,015,LOS CHAPILES,2,22,10,12,3
MICHOACÁN DE OCAMPO,16,COALCOMÁN DE VÁZQUEZ PALLARES,015,LOS DESMONTES,1,15,7,8,1
MICHOACÁN DE OCAMPO,16,COALCOMÁN DE VÁZQUEZ PALLARES,015,LOS LAURELES (EL TERRERO),4,115,61,54,8
MICHOACÁN DE OCAMPO,16,COALCOMÁN DE VÁZQUEZ PALLARES,015,LOS PANTANOS,2,7,1,6,1
MICHOACÁN DE OCAMPO,16,COALCOMÁN DE VÁZQUEZ PALLARES,015,LOS POBRES,1,22,9,13,2
MICHOACÁN DE OCAMPO,16,COALCOMÁN DE VÁZQUEZ PALLARES,015,LOS RANCHOS,3,46,25,21,4
MICHOACÁN DE OCAMPO,16,COALCOMÁN DE VÁZQUEZ PALLARES,015,LOS TEPEHUAJES,1,3,2,1,0
MICHOACÁN DE OCAMPO,16,COALCOMÁN DE VÁZQUEZ PALLARES,015,MARUATILLA,4,212,116,96,15
MICHOACÁN DE OCAMPO,16,COALCOMÁN DE VÁZQUEZ PALLARES,015,OCORLA,1,4,2,2,1
MICHOACÁN DE OCAMPO,16,COALCOMÁN DE VÁZQUEZ PALLARES,015,RANCHO VIEJO,1,16,10,6,1
MICHOACÁN DE OCAMPO,16,COALCOMÁN DE VÁZQUEZ PALLARES,015,SALITRE,1,17,6,11,1
MICHOACÁN DE OCAMPO,16,COALCOMÁN DE VÁZQUEZ PALLARES,015,SAN JOSÉ DE LA MONTAÑA,3,37,15,22,3
MICHOACÁN DE OCAMPO,16,COALCOMÁN DE VÁZQUEZ PALLARES,015,SAN MIGUEL (EL AGUACATE),3,16,7,9,2
MICHOACÁN DE OCAMPO,16,COALCOMÁN DE VÁZQUEZ PALLARES,015,SANTAS MARÍAS,3,16,5,11,3
MICHOACÁN DE OCAMPO,16,COALCOMÁN DE VÁZQUEZ PALLARES,015,TICUILUCAN,1,5,3,2,1
MICHOACÁN DE OCAMPO,16,COALCOMÁN DE VÁZQUEZ PALLARES,015,TROJES,4,149,81,68,10
MICHOACÁN DE OCAMPO,16,COALCOMÁN DE VÁZQUEZ PALLARES,015,VARALOSO,1,4,2,2,1
MICHOACÁN DE OCAMPO,16,COENEO,016,AGUA CALIENTE,2,28,15,13,4
MICHOACÁN DE OCAMPO,16,COENEO,016,BELLAS FUENTES,4,180,88,92,15
MICHOACÁN DE OCAMPO,16,COENEO,016,CARATACUA,1,6,2,4,1
MICHOACÁN DE OCAMPO,16,COENEO,016,CHAHUETO,3,75,39,36,7
MICHOACÁN DE OCAMPO,16,COENEO,016,COENEO DE LA LIBERTAD,8,1247,653,594,77
MICHOACÁN DE OCAMPO,16,COENEO,016,COLONIA BENITO JUÁREZ (LOS CHARCOS),1,8,4,4,1
MICHOACÁN DE OCAMPO,16,COENEO,016,COLONIA FÉLIX IRETA,2,45,24,21,4
MICHOACÁN DE OCAMPO,16,COENEO,016,COMANJA,3,280,150,130,26
MICHOACÁN DE OCAMPO,16,COENEO,016,CORTIJO NUEVO,3,81,43,38,8
MICHOACÁN DE OCAMPO,16,COENEO,016,CORTIJO VIEJO,3,93,42,51,9
MICHOACÁN DE OCAMPO,16,COENEO,016,CÓTIRO,3,29,17,12,4
MICHOACÁN DE OCAMPO,16,COENEO,016,EL COBRERO,2,27,13,14,4
MICHOACÁN DE OCAMPO,16,COENEO,016,EL DURAZNO (SAN JOSÉ DEL DURAZNO),1,5,3,2,1
MICHOACÁN DE OCAMPO,16,COENEO,016,EL PUENTE DEL MIRADOR,2,20,7,13,2
MICHOACÁN DE OCAMPO,16,COENEO,016,EL RODEO,2,24,10,14,2
MICHOACÁN DE OCAMPO,16,COENEO,016,EL TRANSVAL,2,24,12,12,2
MICHOACÁN DE OCAMPO,16,COENEO,016,EMILIANO ZAPATA,1,35,19,16,3
MICHOACÁN DE OCAMPO,16,COENEO,016,LA CAÑADA,4,113,51,62,16
MICHOACÁN DE OCAMPO,16,COENEO,016,LA CIENEGUITA,1,5,1,4,1
MICHOACÁN DE OCAMPO,16,COENEO,016,LA COFRADÍA (EL CAPULÍN),2,11,5,6,4
MICHOACÁN DE OCAMPO,16,COENEO,016,LA CONSTITUCIÓN,1,15,6,9,3
MICHOACÁN DE OCAMPO,16,COENEO,016,LAREDO,2,34,18,16,4
MICHOACÁN DE OCAMPO,16,COENEO,016,LAS MESAS,2,35,12,23,3
MICHOACÁN DE OCAMPO,16,COENEO,016,MATUGEO (SAN MARCOS),3,82,48,34,11
MICHOACÁN DE OCAMPO,16,COENEO,016,PRETORIA,2,38,22,16,5
MICHOACÁN DE OCAMPO,16,COENEO,016,PRIMO TAPIA (EL CHIRIMOYO) [COLONIA],2,109,55,54,7
MICHOACÁN DE OCAMPO,16,COENEO,016,QUENCIO,2,30,12,18,4
MICHOACÁN DE OCAMPO,16,COENEO,016,SAN ISIDRO,3,125,59,66,10
MICHOACÁN DE OCAMPO,16,COENEO,016,SAN PEDRO TACARO,3,93,46,47,9
MICHOACÁN DE OCAMPO,16,COENEO,016,SANTIAGO AZAJO,6,471,243,228,33
MICHOACÁN DE OCAMPO,16,COENEO,016,TACUPO,2,10,4,6,2
MICHOACÁN DE OCAMPO,16,COENEO,016,TUNGUITIRO,4,105,49,56,11
MICHOACÁN DE OCAMPO,16,COENEO,016,ZIPIAJO,6,885,464,421,50
MICHOACÁN DE OCAMPO,16,CONTEPEC,017,AGUA CALIENTE,2,162,84,78,10
MICHOACÁN DE OCAMPO,16,CONTEPEC,017,ARROYO DEL MUERTO (PRESA SANTA TERESA),2,35,18,17,2
MICHOACÁN DE OCAMPO,16,CONTEPEC,017,ATOTONILCO,4,503,235,268,20
MICHOACÁN DE OCAMPO,16,CONTEPEC,017,BRAVO,4,352,183,169,17
MICHOACÁN DE OCAMPO,16,CONTEPEC,017,BUENAVISTA,5,773,413,360,36
MICHOACÁN DE OCAMPO,16,CONTEPEC,017,CANOAS (EL ROSARIO),1,5,1,4,1
MICHOACÁN DE OCAMPO,16,CONTEPEC,017,CERRO AGUJERADO (CUARTEL TERCERO),1,14,7,7,1
MICHOACÁN DE OCAMPO,16,CONTEPEC,017,CERRO PRIETO,2,47,17,30,2
MICHOACÁN DE OCAMPO,16,CONTEPEC,017,COLONIA LA PAZ (EL ZAPOTE),1,25,13,12,1
MICHOACÁN DE OCAMPO,16,CONTEPEC,017,CONTEPEC,12,2504,1282,1222,123
MICHOACÁN DE OCAMPO,16,CONTEPEC,017,EL CAPULÍN,1,22,11,11,2
MICHOACÁN DE OCAMPO,16,CONTEPEC,017,EL CÉREO,2,81,35,46,4
MICHOACÁN DE OCAMPO,16,CONTEPEC,017,EL CÉSPED,2,283,143,140,14
MICHOACÁN DE OCAMPO,16,CONTEPEC,017,EL ENCINO,2,121,57,64,7
MICHOACÁN DE OCAMPO,16,CONTEPEC,017,EL NOGAL (AMPLIACIÓN SAN RAFAEL),2,15,5,10,2
MICHOACÁN DE OCAMPO,16,CONTEPEC,017,EL SOMBRERITO (EL CERRITO),2,45,26,19,3
MICHOACÁN DE OCAMPO,16,CONTEPEC,017,EL TECOLOTE,2,35,21,14,2
MICHOACÁN DE OCAMPO,16,CONTEPEC,017,EL TERRERO,2,23,8,15,3
MICHOACÁN DE OCAMPO,16,CONTEPEC,017,EL ZORRILLO (EL CERRO DEL ÁGUILA),1,8,5,3,1
MICHOACÁN DE OCAMPO,16,CONTEPEC,017,LA ESTANZUELA (LA CHIRIPA),4,91,37,54,4
MICHOACÁN DE OCAMPO,16,CONTEPEC,017,LA HACIENDITA (BORDO DE LA CRUZ),2,40,15,25,4
MICHOACÁN DE OCAMPO,16,CONTEPEC,017,LA HIGUERILLA (LOS LIRIOS),3,238,119,119,12
MICHOACÁN DE OCAMPO,16,CONTEPEC,017,LA PLACITA,1,6,5,1,1
MICHOACÁN DE OCAMPO,16,CONTEPEC,017,LA PUERTA (LA PUERTA DE TEPUXTEPEC),1,7,4,3,1
MICHOACÁN DE OCAMPO,16,CONTEPEC,017,LA RUEDA,2,78,46,32,5
MICHOACÁN DE OCAMPO,16,CONTEPEC,017,LA SOLEDAD,3,18,6,12,3
MICHOACÁN DE OCAMPO,16,CONTEPEC,017,LAS CUEVAS,2,23,14,9,2
MICHOACÁN DE OCAMPO,16,CONTEPEC,017,LAS PERITAS,2,34,16,18,2
MICHOACÁN DE OCAMPO,16,CONTEPEC,017,LAS PILAS,3,73,35,38,5
MICHOACÁN DE OCAMPO,16,CONTEPEC,017,LAS TENERÍAS (LAS TENERÍAS DE TEPETONGO),2,63,30,33,4
MICHOACÁN DE OCAMPO,16,CONTEPEC,017,LÁZARO CÁRDENAS,2,37,24,13,3
MICHOACÁN DE OCAMPO,16,CONTEPEC,017,LLANO LARGO (SANTA ROSA DE LIMA),3,146,69,77,8
MICHOACÁN DE OCAMPO,16,CONTEPEC,017,LOS ARTONES,2,54,32,22,3
MICHOACÁN DE OCAMPO,16,CONTEPEC,017,MELCHOR OCAMPO (PATEO),3,422,210,212,22
MICHOACÁN DE OCAMPO,16,CONTEPEC,017,MOGOTES,3,35,14,21,3
MICHOACÁN DE OCAMPO,16,CONTEPEC,017,PUENTE NEGRO (SAN RAFAEL),1,6,2,4,1
MICHOACÁN DE OCAMPO,16,CONTEPEC,017,SALTO DE TEPUXTEPEC,4,449,233,216,24
MICHOACÁN DE OCAMPO,16,CONTEPEC,017,SAN PEDRO TARÍMBARO,3,188,110,78,11
MICHOACÁN DE OCAMPO,16,CONTEPEC,017,SAN RAFAEL,2,102,51,51,7
MICHOACÁN DE OCAMPO,16,CONTEPEC,017,SANTA MARÍA DE LOS ÁNGELES,2,137,70,67,7
MICHOACÁN DE OCAMPO,16,CONTEPEC,017,SANTA MARÍA LA AHOGADA,2,27,13,14,3
MICHOACÁN DE OCAMPO,16,CONTEPEC,017,TEMAZCALES (EL JACAL),2,53,26,27,3
MICHOACÁN DE OCAMPO,16,CONTEPEC,017,TEPETONGO,4,319,149,170,17
MICHOACÁN DE OCAMPO,16,CONTEPEC,017,VENTA DE BRAVO,3,326,160,166,21
MICHOACÁN DE OCAMPO,16,CONTEPEC,017,YEREJE,2,46,19,27,3
MICHOACÁN DE OCAMPO,16,CONTEPEC,017,ZARAGOZA (PUERTO DE MEDINA),5,270,138,132,17
MICHOACÁN DE OCAMPO,16,COPÁNDARO,018,ARÚMBARO,3,99,44,55,9
MICHOACÁN DE OCAMPO,16,COPÁNDARO,018,CAÑADA DE LA YERBABUENA,3,100,46,54,10
MICHOACÁN DE OCAMPO,16,COPÁNDARO,018,CONGOTZIO,2,15,7,8,2
MICHOACÁN DE OCAMPO,16,COPÁNDARO,018,COPÁNDARO DE GALEANA,5,1084,560,524,82
MICHOACÁN DE OCAMPO,16,COPÁNDARO,018,EL FRESNO,1,4,1,3,1
MICHOACÁN DE OCAMPO,16,COPÁNDARO,018,EL NISPO,2,111,41,70,8
MICHOACÁN DE OCAMPO,16,COPÁNDARO,018,LAS CANOAS,3,101,45,56,7
MICHOACÁN DE OCAMPO,16,COPÁNDARO,018,ROSA DE CASTILLA,3,45,23,22,3
MICHOACÁN DE OCAMPO,16,COPÁNDARO,018,SAN AGUSTÍN DEL MAÍZ,4,342,170,172,22
MICHOACÁN DE OCAMPO,16,COPÁNDARO,018,SANTA RITA,3,185,101,84,12
MICHOACÁN DE OCAMPO,16,COTIJA,019,AGUA DE GALLO,1,10,4,6,1
MICHOACÁN DE OCAMPO,16,COTIJA,019,AYUMBA,2,80,43,37,8
MICHOACÁN DE OCAMPO,16,COTIJA,019,COAMEO GRANDE (COAMEO DE SAN LORENZO),3,28,13,15,3
MICHOACÁN DE OCAMPO,16,COTIJA,019,COTIJA DE LA PAZ,27,3199,1702,1497,252
MICHOACÁN DE OCAMPO,16,COTIJA,019,EL BARRIO,2,48,25,23,3
MICHOACÁN DE OCAMPO,16,COTIJA,019,EL FLECHERO,1,9,6,3,1
MICHOACÁN DE OCAMPO,16,COTIJA,019,EL LOBO,3,85,40,45,6
MICHOACÁN DE OCAMPO,16,COTIJA,019,EL MORAL,2,21,10,11,2
MICHOACÁN DE OCAMPO,16,COTIJA,019,EL PARAÍSO DE RUBÉN ROMERO,2,14,4,10,2
MICHOACÁN DE OCAMPO,16,COTIJA,019,EL PASO,3,55,26,29,3
MICHOACÁN DE OCAMPO,16,COTIJA,019,EL PUERTO,2,31,17,14,2
MICHOACÁN DE OCAMPO,16,COTIJA,019,EL SAUZ,2,30,13,17,3
MICHOACÁN DE OCAMPO,16,COTIJA,019,LA ATARJEA,1,6,1,5,1
MICHOACÁN DE OCAMPO,16,COTIJA,019,LA CUARTILLA,3,53,20,33,4
MICHOACÁN DE OCAMPO,16,COTIJA,019,LA ESPERANZA,3,141,64,77,11
MICHOACÁN DE OCAMPO,16,COTIJA,019,LA RESOLANA,6,113,60,53,10
MICHOACÁN DE OCAMPO,16,COTIJA,019,LOS AMOLES,1,6,2,4,1
MICHOACÁN DE OCAMPO,16,COTIJA,019,LOS CHAPILIS,1,7,4,3,1
MICHOACÁN DE OCAMPO,16,COTIJA,019,LOS ESPINOZAS,1,6,2,4,1
MICHOACÁN DE OCAMPO,16,COTIJA,019,LOS GALLINEROS,4,125,56,69,6
MICHOACÁN DE OCAMPO,16,COTIJA,019,LOS ZAPOTES,2,77,32,45,5
MICHOACÁN DE OCAMPO,16,COTIJA,019,LOURDES (EL PERICO),3,62,26,36,4
MICHOACÁN DE OCAMPO,16,COTIJA,019,PASO DE PIEDRA,1,5,2,3,1
MICHOACÁN DE OCAMPO,16,COTIJA,019,PLAN DEL CERRO (LA PLAYA),3,46,25,21,4
MICHOACÁN DE OCAMPO,16,COTIJA,019,SAN JUANICO,3,105,61,44,10
MICHOACÁN DE OCAMPO,16,COTIJA,019,SAN PABLO,2,28,18,10,2
MICHOACÁN DE OCAMPO,16,COTIJA,019,SANTA MARÍA,1,8,5,3,1
MICHOACÁN DE OCAMPO,16,COTIJA,019,VARAL DE LAS FLORES,1,16,9,7,1
MICHOACÁN DE OCAMPO,16,COTIJA,019,VARAL DE LOS FRESNOS,1,6,3,3,1
MICHOACÁN DE OCAMPO,16,COTIJA,019,VISTA HERMOSA,2,46,21,25,3
MICHOACÁN DE OCAMPO,16,CUITZEO,020,CHUPÍCUARO,2,38,17,21,4
MICHOACÁN DE OCAMPO,16,CUITZEO,020,COLONIA CHUPÍCUARO,3,80,43,37,9
MICHOACÁN DE OCAMPO,16,CUITZEO,020,COLONIA DE RANCHO SECO (EL CERRITO),1,6,3,3,1
MICHOACÁN DE OCAMPO,16,CUITZEO,020,CUAMIO,5,292,131,161,26
MICHOACÁN DE OCAMPO,16,CUITZEO,020,CUARACURIO,3,287,142,145,20
MICHOACÁN DE OCAMPO,16,CUITZEO,020,CUITZEO DEL PORVENIR,18,3179,1668,1511,169
MICHOACÁN DE OCAMPO,16,CUITZEO,020,DOCTOR MIGUEL SILVA (SAN GUILLERMO),3,177,100,77,11
MICHOACÁN DE OCAMPO,16,CUITZEO,020,EPIFANIO C. PÉREZ (SAN MIGUEL),2,55,27,28,3
MICHOACÁN DE OCAMPO,16,CUITZEO,020,JERUCO,3,164,80,84,11
MICHOACÁN DE OCAMPO,16,CUITZEO,020,LA CINTA,1,15,9,6,1
MICHOACÁN DE OCAMPO,16,CUITZEO,020,LA PALMA,1,11,4,7,1
MICHOACÁN DE OCAMPO,16,CUITZEO,020,MARIANO ESCOBEDO (SAN LORENZO),6,1076,550,526,49
MICHOACÁN DE OCAMPO,16,CUITZEO,020,MARIZA [GRANJA],1,163,82,81,5
MICHOACÁN DE OCAMPO,16,CUITZEO,020,PUERTA DEL SALTO (LA PUERTA),1,8,4,4,1
MICHOACÁN DE OCAMPO,16,CUITZEO,020,RANCHO SECO,3,18,9,9,3
MICHOACÁN DE OCAMPO,16,CUITZEO,020,SAN AGUSTÍN DEL PULQUE,5,687,363,324,38
MICHOACÁN DE OCAMPO,16,CUITZEO,020,SAN JUAN BENITO JUÁREZ (SAN JUAN TARARAMEO),5,489,239,250,34
MICHOACÁN DE OCAMPO,16,CHARAPAN,021,CHARAPAN,13,1695,863,832,92
MICHOACÁN DE OCAMPO,16,CHARAPAN,021,COCUCHO,6,1064,528,536,61
MICHOACÁN DE OCAMPO,16,CHARAPAN,021,OCUMICHO,6,898,428,470,46
MICHOACÁN DE OCAMPO,16,CHARAPAN,021,SAN FELIPE DE LOS HERREROS,6,552,276,276,35
MICHOACÁN DE OCAMPO,16,CHARO,022,AGUA FRÍA,2,21,8,13,2
MICHOACÁN DE OCAMPO,16,CHARO,022,ARÚMBARO,3,40,22,18,5
MICHOACÁN DE OCAMPO,16,CHARO,022,CHARO,11,1364,697,667,107
MICHOACÁN DE OCAMPO,16,CHARO,022,EL ÁLAMO,2,5,1,4,1
MICHOACÁN DE OCAMPO,16,CHARO,022,EL ARENAL,2,25,13,12,2
MICHOACÁN DE OCAMPO,16,CHARO,022,EL DURAZNO,2,4,2,2,1
MICHOACÁN DE OCAMPO,16,CHARO,022,EL EPAZOTE,2,13,7,6,2
MICHOACÁN DE OCAMPO,16,CHARO,022,EL PALMAR,3,37,19,18,3
MICHOACÁN DE OCAMPO,16,CHARO,022,EL PEDREGAL,1,53,26,27,4
MICHOACÁN DE OCAMPO,16,CHARO,022,EL VADO,2,35,16,19,2
MICHOACÁN DE OCAMPO,16,CHARO,022,EL VAQUERITO,3,125,58,67,9
MICHOACÁN DE OCAMPO,16,CHARO,022,FRANCISCO I. MADERO (EL PANTANO),2,124,57,67,7
MICHOACÁN DE OCAMPO,16,CHARO,022,IRAPEO,4,953,482,471,81
MICHOACÁN DE OCAMPO,16,CHARO,022,JARIPEO,3,398,200,198,22
MICHOACÁN DE OCAMPO,16,CHARO,022,KILÓMETRO 23,2,26,14,12,2
MICHOACÁN DE OCAMPO,16,CHARO,022,LA ESCALERA,3,49,29,20,6
MICHOACÁN DE OCAMPO,16,CHARO,022,LA GOLETA,3,324,155,169,20
MICHOACÁN DE OCAMPO,16,CHARO,022,LA YERBABUENA,2,9,4,5,2
MICHOACÁN DE OCAMPO,16,CHARO,022,LAS CANOAS (EL PUENTE),2,19,15,4,2
MICHOACÁN DE OCAMPO,16,CHARO,022,LAS MESAS,3,144,63,81,9
MICHOACÁN DE OCAMPO,16,CHARO,022,LAS TROJES [COLONIA],1,21,8,13,2
MICHOACÁN DE OCAMPO,16,CHARO,022,LOS CANTILES,2,11,7,4,1
MICHOACÁN DE OCAMPO,16,CHARO,022,LOS CIMIENTOS,3,34,19,15,4
MICHOACÁN DE OCAMPO,16,CHARO,022,LOS FRESNOS (SANTA MARILLAL),1,8,5,3,1
MICHOACÁN DE OCAMPO,16,CHARO,022,LOS LLANOS,2,73,34,39,5
MICHOACÁN DE OCAMPO,16,CHARO,022,LOS TRIGUILLOS,3,74,33,41,5
MICHOACÁN DE OCAMPO,16,CHARO,022,OJO DE AGUA,2,3,2,1,2
MICHOACÁN DE OCAMPO,16,CHARO,022,PEÑA CARGADA,3,58,28,30,6
MICHOACÁN DE OCAMPO,16,CHARO,022,PIE DE LA MESA,2,60,27,33,5
MICHOACÁN DE OCAMPO,16,CHARO,022,PITORREAL (PINO REAL),2,35,19,16,4
MICHOACÁN DE OCAMPO,16,CHARO,022,PONTEZUELAS,2,29,15,14,3
MICHOACÁN DE OCAMPO,16,CHARO,022,ROSAS DE GUADALUPE [KILÓMETRO CATORCE],2,97,49,48,7
MICHOACÁN DE OCAMPO,16,CHARO,022,SAN ANTONIO CORRALES,4,233,104,129,17
MICHOACÁN DE OCAMPO,16,CHARO,022,SAN FELIPE,2,17,10,7,2
MICHOACÁN DE OCAMPO,16,CHARO,022,UNIÓN DE PROGRESO (LOMAS DE IRAPEO),2,112,59,53,7
MICHOACÁN DE OCAMPO,16,CHARO,022,UÑA DE GATO (RÍO BELO) [CLUB ECOLÓGICO HABITACIONAL],1,8,3,5,1
MICHOACÁN DE OCAMPO,16,CHARO,022,ZURUMBENEO,3,260,142,118,16
MICHOACÁN DE OCAMPO,16,CHAVINDA,023,CHAVINDA,10,1255,647,608,80
MICHOACÁN DE OCAMPO,16,CHAVINDA,023,EL TEPEHUAJE,2,81,36,45,8
MICHOACÁN DE OCAMPO,16,CHAVINDA,023,LA CUESTITA,4,211,108,103,14
MICHOACÁN DE OCAMPO,16,CHAVINDA,023,LA ESPERANZA,4,350,177,173,19
MICHOACÁN DE OCAMPO,16,CHAVINDA,023,LA SOLEDAD,3,29,14,15,4
MICHOACÁN DE OCAMPO,16,CHAVINDA,023,MAGALLANES,1,39,16,23,3
MICHOACÁN DE OCAMPO,16,CHAVINDA,023,SAN JUAN PALMIRA,2,54,28,26,4
MICHOACÁN DE OCAMPO,16,CHERÁN,024,CASIMIRO LECO (EL CERECITO),4,253,125,128,15
MICHOACÁN DE OCAMPO,16,CHERÁN,024,CHERÁN,36,8358,4213,4145,436
MICHOACÁN DE OCAMPO,16,CHERÁN,024,TANACO,7,877,423,454,49
MICHOACÁN DE OCAMPO,16,CHILCHOTA,025,ACACHUÉN,5,701,324,377,39
MICHOACÁN DE OCAMPO,16,CHILCHOTA,025,CARAPAN,11,2018,1030,988,111
MICHOACÁN DE OCAMPO,16,CHILCHOTA,025,CHILCHOTA,12,1825,901,924,101
MICHOACÁN DE OCAMPO,16,CHILCHOTA,025,EL PEDREGAL,1,19,6,13,2
MICHOACÁN DE OCAMPO,16,CHILCHOTA,025,HUÁNCITO,6,1123,572,551,53
MICHOACÁN DE OCAMPO,16,CHILCHOTA,025,HUECATO,4,209,107,102,13
MICHOACÁN DE OCAMPO,16,CHILCHOTA,025,ICHÁN,6,1474,769,705,149
MICHOACÁN DE OCAMPO,16,CHILCHOTA,025,LA COFRADÍA,2,105,48,57,4
MICHOACÁN DE OCAMPO,16,CHILCHOTA,025,LOS NOGALES,3,388,192,196,23
MICHOACÁN DE OCAMPO,16,CHILCHOTA,025,MORELOS (JOSÉ MARÍA MORELOS),3,149,83,66,11
MICHOACÁN DE OCAMPO,16,CHILCHOTA,025,SAN JUAN CARAPAN,4,172,74,98,12
MICHOACÁN DE OCAMPO,16,CHILCHOTA,025,SANTO TOMÁS,4,463,240,223,24
MICHOACÁN DE OCAMPO,16,CHILCHOTA,025,TACURO (SANTA MARÍA TACURO),4,682,354,328,36
MICHOACÁN DE OCAMPO,16,CHILCHOTA,025,TANAQUILLO,6,542,269,273,32
MICHOACÁN DE OCAMPO,16,CHILCHOTA,025,URÉN,4,337,178,159,18
MICHOACÁN DE OCAMPO,16,CHILCHOTA,025,ZOPOCO,5,828,433,395,39
MICHOACÁN DE OCAMPO,16,CHINICUILA,026,AGUA BLANCA (BARRANCA DEL TERESO),3,24,9,15,4
MICHOACÁN DE OCAMPO,16,CHINICUILA,026,BARRANCA DEL LIMONCITO,2,12,7,5,2
MICHOACÁN DE OCAMPO,16,CHINICUILA,026,BARRANCA DEL OCOTE,1,4,2,2,1
MICHOACÁN DE OCAMPO,16,CHINICUILA,026,BARRANCA SECA DE LARIOS,2,36,19,17,2
MICHOACÁN DE OCAMPO,16,CHINICUILA,026,COAHUAYULA (LA SILLETA),3,34,15,19,4
MICHOACÁN DE OCAMPO,16,CHINICUILA,026,EL CHAFRE,1,12,7,5,1
MICHOACÁN DE OCAMPO,16,CHINICUILA,026,EL CHURÉN,2,8,2,6,1
MICHOACÁN DE OCAMPO,16,CHINICUILA,026,EL MIRADOR,2,8,3,5,1
MICHOACÁN DE OCAMPO,16,CHINICUILA,026,EL MORO,1,9,4,5,1
MICHOACÁN DE OCAMPO,16,CHINICUILA,026,EL NARANJILLO (LOS NARANJOS),3,25,16,9,3
MICHOACÁN DE OCAMPO,16,CHINICUILA,026,EL POZO,1,3,0,3,1
MICHOACÁN DE OCAMPO,16,CHINICUILA,026,EL RANCHUAL,2,32,17,15,3
MICHOACÁN DE OCAMPO,16,CHINICUILA,026,EL RASCAVIEJO,1,6,3,3,1
MICHOACÁN DE OCAMPO,16,CHINICUILA,026,EL SAUCITO,1,3,1,2,1
MICHOACÁN DE OCAMPO,16,CHINICUILA,026,EL SÍPIMO,3,24,14,10,3
MICHOACÁN DE OCAMPO,16,CHINICUILA,026,EL TAMARINDO,3,31,18,13,3
MICHOACÁN DE OCAMPO,16,CHINICUILA,026,HIHUITLÁN,4,102,52,50,7
MICHOACÁN DE OCAMPO,16,CHINICUILA,026,HUERTA DE SÁNCHEZ,2,7,2,5,1
MICHOACÁN DE OCAMPO,16,CHINICUILA,026,HUITZONTLA,4,51,32,19,6
MICHOACÁN DE OCAMPO,16,CHINICUILA,026,LA CARDOSANTERA,1,6,1,5,1
MICHOACÁN DE OCAMPO,16,CHINICUILA,026,LA HIGUERA PANDA,1,12,7,5,1
MICHOACÁN DE OCAMPO,16,CHINICUILA,026,LA MINITA,1,7,5,2,1
MICHOACÁN DE OCAMPO,16,CHINICUILA,026,LA NOGALERA,1,13,6,7,1
MICHOACÁN DE OCAMPO,16,CHINICUILA,026,LA NUEZ (LA NUEZ DEL CAIMÁN),3,27,11,16,3
MICHOACÁN DE OCAMPO,16,CHINICUILA,026,LA ROBLERITA,1,9,2,7,1
MICHOACÁN DE OCAMPO,16,CHINICUILA,026,LOS MAGUEYES,1,4,1,3,1
MICHOACÁN DE OCAMPO,16,CHINICUILA,026,OJO DE AGUA,2,8,3,5,3
MICHOACÁN DE OCAMPO,16,CHINICUILA,026,PASO DE ARRIEROS (LA MERCED),2,28,15,13,2
MICHOACÁN DE OCAMPO,16,CHINICUILA,026,POTRERILLOS (PASO DE POTRERILLOS),2,25,17,8,2
MICHOACÁN DE OCAMPO,16,CHINICUILA,026,RANCHO NUEVO (BARRANCA LA TIERRA),3,22,10,12,4
MICHOACÁN DE OCAMPO,16,CHINICUILA,026,SALITRE DE COPALA,3,30,14,16,3
MICHOACÁN DE OCAMPO,16,CHINICUILA,026,SALITRE DE ESTOPILA,4,86,41,45,6
MICHOACÁN DE OCAMPO,16,CHINICUILA,026,TEHUANTEPEC,4,177,89,88,13
MICHOACÁN DE OCAMPO,16,CHINICUILA,026,TEPAME (TEPAMILLO),1,4,1,3,1
MICHOACÁN DE OCAMPO,16,CHINICUILA,026,VILLA VICTORIA,5,364,202,162,23
MICHOACÁN DE OCAMPO,16,CHINICUILA,026,ZAPOTE DE FERNÁNDEZ,1,5,3,2,1
MICHOACÁN DE OCAMPO,16,CHUCÁNDIRO,027,BUENAVISTA,3,13,10,3,2
MICHOACÁN DE OCAMPO,16,CHUCÁNDIRO,027,CARUCHEO GRANDE,1,12,8,4,1
MICHOACÁN DE OCAMPO,16,CHUCÁNDIRO,027,CHUCÁNDIRO,6,485,248,237,42
MICHOACÁN DE OCAMPO,16,CHUCÁNDIRO,027,CRUCES DE BARRERAS,3,95,49,46,7
MICHOACÁN DE OCAMPO,16,CHUCÁNDIRO,027,EL SALITRE,4,112,61,51,11
MICHOACÁN DE OCAMPO,16,CHUCÁNDIRO,027,EL SALTO,2,27,14,13,2
MICHOACÁN DE OCAMPO,16,CHUCÁNDIRO,027,LA PRESA,1,16,9,7,1
MICHOACÁN DE OCAMPO,16,CHUCÁNDIRO,027,LAS ARENAS,3,31,16,15,3
MICHOACÁN DE OCAMPO,16,CHUCÁNDIRO,027,SAN SEBASTIÁN,2,38,20,18,3
MICHOACÁN DE OCAMPO,16,CHUCÁNDIRO,027,SANTA INÉS,2,10,7,3,2
MICHOACÁN DE OCAMPO,16,CHUCÁNDIRO,027,TANIMIRECHE,1,9,4,5,1
MICHOACÁN DE OCAMPO,16,CHUCÁNDIRO,027,URUNDANEO,3,54,26,28,5
MICHOACÁN DE OCAMPO,16,CHURINTZIO,028,CHANGUITIRO,2,28,12,16,2
MICHOACÁN DE OCAMPO,16,CHURINTZIO,028,CHURINTZIO,5,627,314,313,46
MICHOACÁN DE OCAMPO,16,CHURINTZIO,028,EL FUERTE,2,6,3,3,1
MICHOACÁN DE OCAMPO,16,CHURINTZIO,028,EL JAGÜEY DE REYNAGA,1,7,3,4,1
MICHOACÁN DE OCAMPO,16,CHURINTZIO,028,EL SABINO,1,20,12,8,1
MICHOACÁN DE OCAMPO,16,CHURINTZIO,028,EL SALTO,1,9,4,5,1
MICHOACÁN DE OCAMPO,16,CHURINTZIO,028,HUAPAMACATO,3,147,66,81,7
MICHOACÁN DE OCAMPO,16,CHURINTZIO,028,LA HIGUERA,2,18,9,9,2
MICHOACÁN DE OCAMPO,16,CHURINTZIO,028,LA NORIA,3,65,33,32,4
MICHOACÁN DE OCAMPO,16,CHURINTZIO,028,LAS CRUCES,2,12,6,6,2
MICHOACÁN DE OCAMPO,16,CHURINTZIO,028,NUEVO MORELOS (EL RANCHITO),1,9,2,7,1
MICHOACÁN DE OCAMPO,16,CHURINTZIO,028,PATZÍMARO DE AVIÑA (PATZÍMARO DEL RINCÓN),2,24,11,13,2
MICHOACÁN DE OCAMPO,16,CHURINTZIO,028,SAN JUAN BAUTISTA ARAMUTARO,2,4,2,2,1
MICHOACÁN DE OCAMPO,16,CHURINTZIO,028,SAN VICENTE (LA LOMA),3,24,10,14,3
MICHOACÁN DE OCAMPO,16,CHURINTZIO,028,SANGUIJUELAS,2,15,8,7,2
MICHOACÁN DE OCAMPO,16,CHURINTZIO,028,TORRECILLAS,2,32,13,19,2
MICHOACÁN DE OCAMPO,16,CHURUMUCO,029,ANGAMIO,3,32,15,17,3
MICHOACÁN DE OCAMPO,16,CHURUMUCO,029,CHURUMUCO DE MORELOS,10,1332,711,621,92
MICHOACÁN DE OCAMPO,16,CHURUMUCO,029,CUIRIPAN,2,11,3,8,2
MICHOACÁN DE OCAMPO,16,CHURUMUCO,029,CUITZÁN,2,14,8,6,2
MICHOACÁN DE OCAMPO,16,CHURUMUCO,029,EL AHUIJOTE,2,59,26,33,3
MICHOACÁN DE OCAMPO,16,CHURUMUCO,029,EL CHOCOLATE,1,3,2,1,1
MICHOACÁN DE OCAMPO,16,CHURUMUCO,029,EL CUIRINDAL,4,71,33,38,7
MICHOACÁN DE OCAMPO,16,CHURUMUCO,029,EL GUAYABO,2,10,7,3,2
MICHOACÁN DE OCAMPO,16,CHURUMUCO,029,EL OLVIDO,1,1,0,1,1
MICHOACÁN DE OCAMPO,16,CHURUMUCO,029,EL PITIRAL,3,181,87,94,11
MICHOACÁN DE OCAMPO,16,CHURUMUCO,029,EL PLATANAR,2,33,18,15,3
MICHOACÁN DE OCAMPO,16,CHURUMUCO,029,EL SALITRE,2,42,25,17,3
MICHOACÁN DE OCAMPO,16,CHURUMUCO,029,EL TIMBIRICHE,4,106,49,57,8
MICHOACÁN DE OCAMPO,16,CHURUMUCO,029,LA CANDELARIA,3,59,33,26,8
MICHOACÁN DE OCAMPO,16,CHURUMUCO,029,LA CAÑA,4,72,29,43,8
MICHOACÁN DE OCAMPO,16,CHURUMUCO,029,LA NORIA,1,17,8,9,2
MICHOACÁN DE OCAMPO,16,CHURUMUCO,029,LAS FLORES,2,26,7,19,3
MICHOACÁN DE OCAMPO,16,CHURUMUCO,029,LAS JUNTAS DE POTURO,2,18,10,8,3
MICHOACÁN DE OCAMPO,16,CHURUMUCO,029,LAS PILAS,3,91,48,43,6
MICHOACÁN DE OCAMPO,16,CHURUMUCO,029,LAVADEROS DEL SALITRE,2,18,10,8,3
MICHOACÁN DE OCAMPO,16,CHURUMUCO,029,LOMA EL GUAYACÁN,4,160,73,87,11
MICHOACÁN DE OCAMPO,16,CHURUMUCO,029,LOS CIMIENTOS,2,33,15,18,2
MICHOACÁN DE OCAMPO,16,CHURUMUCO,029,LOS HORNITOS,1,6,2,4,1
MICHOACÁN DE OCAMPO,16,CHURUMUCO,029,MELCHOR OCAMPO (CUNUATO),3,32,17,15,4
MICHOACÁN DE OCAMPO,16,CHURUMUCO,029,OJO DE AGUA DE POTURO,2,42,17,25,3
MICHOACÁN DE OCAMPO,16,CHURUMUCO,029,PALMA DE HUARO,4,61,32,29,11
MICHOACÁN DE OCAMPO,16,CHURUMUCO,029,PASO DE PALMILLAS,4,82,38,44,10
MICHOACÁN DE OCAMPO,16,CHURUMUCO,029,POTRERO DE CORPUS,3,53,29,24,4
MICHOACÁN DE OCAMPO,16,CHURUMUCO,029,POTURO,5,552,304,248,33
MICHOACÁN DE OCAMPO,16,CHURUMUCO,029,PUERTO DE RUEDAS (EL ANCÓN),3,38,21,17,3
MICHOACÁN DE OCAMPO,16,CHURUMUCO,029,RAMÍREZ DEL VARAL (PUERTO DEL VARAL),3,26,15,11,4
MICHOACÁN DE OCAMPO,16,CHURUMUCO,029,SAN ANTONIO,2,14,7,7,2
MICHOACÁN DE OCAMPO,16,CHURUMUCO,029,SAN MARTÍN DE LA LUZ,4,127,54,73,13
MICHOACÁN DE OCAMPO,16,CHURUMUCO,029,SANTA ELENA,3,21,7,14,3
MICHOACÁN DE OCAMPO,16,CHURUMUCO,029,SANTA ROSA,2,20,11,9,3
MICHOACÁN DE OCAMPO,16,CHURUMUCO,029,VALDOVINOS,1,8,2,6,1
MICHOACÁN DE OCAMPO,16,ECUANDUREO,030,COLESIO,3,183,101,82,11
MICHOACÁN DE OCAMPO,16,ECUANDUREO,030,ECUANDUREO,7,1043,552,491,62
MICHOACÁN DE OCAMPO,16,ECUANDUREO,030,LA BARRANCA,1,9,5,4,1
MICHOACÁN DE OCAMPO,16,ECUANDUREO,030,LA CAÑADA DE MORENO,1,6,5,1,1
MICHOACÁN DE OCAMPO,16,ECUANDUREO,030,LA ESTANCIA DE GÓMEZ,2,18,7,11,4
MICHOACÁN DE OCAMPO,16,ECUANDUREO,030,LA NOPALERA,1,5,3,2,1
MICHOACÁN DE OCAMPO,16,ECUANDUREO,030,LA SOLEDAD,2,59,35,24,7
MICHOACÁN DE OCAMPO,16,ECUANDUREO,030,LAS FUENTES,2,71,34,37,6
MICHOACÁN DE OCAMPO,16,ECUANDUREO,030,LAS MAJADAS (LA FLORIDA),2,10,6,4,2
MICHOACÁN DE OCAMPO,16,ECUANDUREO,030,LAS MARAVILLAS,2,15,9,6,3
MICHOACÁN DE OCAMPO,16,ECUANDUREO,030,LAS TORCAZAS,2,31,17,14,3
MICHOACÁN DE OCAMPO,16,ECUANDUREO,030,MORENO DE BRAVO,2,43,19,24,2
MICHOACÁN DE OCAMPO,16,ECUANDUREO,030,MORENO DE VALENCIA,1,10,4,6,1
MICHOACÁN DE OCAMPO,16,ECUANDUREO,030,PUERTA DE VARGAS,1,12,2,10,1
MICHOACÁN DE OCAMPO,16,ECUANDUREO,030,QUIRINGUICHARO (LA HACIENDA),3,381,192,189,25
MICHOACÁN DE OCAMPO,16,ECUANDUREO,030,RINCÓN GRANDE,2,128,64,64,8
MICHOACÁN DE OCAMPO,16,ECUANDUREO,030,UCÁCUARO,2,87,46,41,7
MICHOACÁN DE OCAMPO,16,EPITACIO HUERTA,031,ASTILLERO BOTIJA,2,43,18,25,4
MICHOACÁN DE OCAMPO,16,EPITACIO HUERTA,031,CANINDO Y PEDREGAL,2,141,66,75,6
MICHOACÁN DE OCAMPO,16,EPITACIO HUERTA,031,CAÑADA DE GARCÍA (CUARTEL CAÑADA),2,31,14,17,3
MICHOACÁN DE OCAMPO,16,EPITACIO HUERTA,031,CASA COLORADA,1,11,4,7,2
MICHOACÁN DE OCAMPO,16,EPITACIO HUERTA,031,EL ASTILLERO (EL CARMEN ASTILLERO),5,183,80,103,12
MICHOACÁN DE OCAMPO,16,EPITACIO HUERTA,031,EL BELLOTAL UNO,2,8,6,2,1
MICHOACÁN DE OCAMPO,16,EPITACIO HUERTA,031,EL CERRITO,2,46,20,26,3
MICHOACÁN DE OCAMPO,16,EPITACIO HUERTA,031,EL RODEO,1,26,14,12,2
MICHOACÁN DE OCAMPO,16,EPITACIO HUERTA,031,EL SALITRILLO (OJO DE AGUA DE SALITRILLO),2,14,6,8,2
MICHOACÁN DE OCAMPO,16,EPITACIO HUERTA,031,EL TEJOCOTE POLVILLAS (FÁTIMA),2,12,6,6,2
MICHOACÁN DE OCAMPO,16,EPITACIO HUERTA,031,EL TEPOZÁN,1,31,15,16,2
MICHOACÁN DE OCAMPO,16,EPITACIO HUERTA,031,EL VENADO,1,34,17,17,2
MICHOACÁN DE OCAMPO,16,EPITACIO HUERTA,031,EMILIANO ZAPATA (PUEBLO NUEVO),2,83,36,47,5
MICHOACÁN DE OCAMPO,16,EPITACIO HUERTA,031,EPITACIO HUERTA,8,1374,724,650,82
MICHOACÁN DE OCAMPO,16,EPITACIO HUERTA,031,ESTANZUELA LOS LULOS (SANTA ROSA),1,39,18,21,6
MICHOACÁN DE OCAMPO,16,EPITACIO HUERTA,031,EX-HACIENDA SALITRILLO,1,12,6,6,3
MICHOACÁN DE OCAMPO,16,EPITACIO HUERTA,031,FRACCIÓN LA PAZ [EJIDO NUEVO CORONEO],2,58,25,33,6
MICHOACÁN DE OCAMPO,16,EPITACIO HUERTA,031,GUADALUPE LA PAZ [EJIDO NUEVO CORONEO],1,20,9,11,1
MICHOACÁN DE OCAMPO,16,EPITACIO HUERTA,031,LA LUZ,4,152,78,74,12
MICHOACÁN DE OCAMPO,16,EPITACIO HUERTA,031,LA MARGARITA (EL PUERTO),2,33,22,11,4
MICHOACÁN DE OCAMPO,16,EPITACIO HUERTA,031,LA PALMA,3,52,27,25,6
MICHOACÁN DE OCAMPO,16,EPITACIO HUERTA,031,LA PAZ,2,30,10,20,2
MICHOACÁN DE OCAMPO,16,EPITACIO HUERTA,031,LA TENENCIA DE GUERRERO (HORMIGAS UNO),3,36,17,19,3
MICHOACÁN DE OCAMPO,16,EPITACIO HUERTA,031,LOMA DE EN MEDIO,1,54,28,26,2
MICHOACÁN DE OCAMPO,16,EPITACIO HUERTA,031,LOS ÁNGELES (SAN LORENZO),2,28,13,15,2
MICHOACÁN DE OCAMPO,16,EPITACIO HUERTA,031,LOS DOLORES,3,448,203,245,33
MICHOACÁN DE OCAMPO,16,EPITACIO HUERTA,031,MOLINOS DE CABALLERO,2,55,29,26,2
MICHOACÁN DE OCAMPO,16,EPITACIO HUERTA,031,SAN ANTONIO MOLINOS,4,334,152,182,19
MICHOACÁN DE OCAMPO,16,EPITACIO HUERTA,031,SAN BERNARDO,2,67,39,28,3
MICHOACÁN DE OCAMPO,16,EPITACIO HUERTA,031,SAN CRISTÓBAL (LOS ÁLAMOS),3,98,48,50,8
MICHOACÁN DE OCAMPO,16,EPITACIO HUERTA,031,SAN MATEO [EJIDO EL SALITRILLO],1,13,5,8,1
MICHOACÁN DE OCAMPO,16,EPITACIO HUERTA,031,SAN MIGUEL LA RATA (SAN ANDRÉS),1,40,16,24,2
MICHOACÁN DE OCAMPO,16,EPITACIO HUERTA,031,SANTA ANITA OJO DE AGUA,1,6,4,2,1
MICHOACÁN DE OCAMPO,16,EPITACIO HUERTA,031,SANTA CRUZ OJO DE AGUA,4,142,68,74,11
MICHOACÁN DE OCAMPO,16,EPITACIO HUERTA,031,SANTA GENOVEVA (CUARTEL DE GUERRERO),1,22,14,8,2
MICHOACÁN DE OCAMPO,16,EPITACIO HUERTA,031,TEJOCOTE SAN ISIDRO (LA PROVIDENCIA),2,46,20,26,2
MICHOACÁN DE OCAMPO,16,EPITACIO HUERTA,031,YEREJE CABEZAS,1,16,8,8,1
MICHOACÁN DE OCAMPO,16,EPITACIO HUERTA,031,YEREJE CANTERAS,1,22,12,10,1
MICHOACÁN DE OCAMPO,16,ERONGARÍCUARO,032,ARÓCUTIN,5,250,131,119,20
MICHOACÁN DE OCAMPO,16,ERONGARÍCUARO,032,COLONIA LÁZARO CÁRDENAS,4,155,81,74,12
MICHOACÁN DE OCAMPO,16,ERONGARÍCUARO,032,COLONIA REVOLUCIÓN (LA ORTIGA),2,37,15,22,4
MICHOACÁN DE OCAMPO,16,ERONGARÍCUARO,032,ERONGARÍCUARO,7,926,448,478,96
MICHOACÁN DE OCAMPO,16,ERONGARÍCUARO,032,JARÁCUARO,5,848,419,429,46
MICHOACÁN DE OCAMPO,16,ERONGARÍCUARO,032,LA ZARZAMORA,3,55,24,31,7
MICHOACÁN DE OCAMPO,16,ERONGARÍCUARO,032,NAPÍZARO,3,86,43,43,9
MICHOACÁN DE OCAMPO,16,ERONGARÍCUARO,032,PUÁCUARO,5,520,239,281,32
MICHOACÁN DE OCAMPO,16,ERONGARÍCUARO,032,SAN FRANCISCO URICHO,4,361,190,171,24
MICHOACÁN DE OCAMPO,16,ERONGARÍCUARO,032,SAN JOSÉ OPONGUIO,3,60,23,37,6
MICHOACÁN DE OCAMPO,16,ERONGARÍCUARO,032,SAN MIGUEL NOCUTZEPO,2,162,82,80,12
MICHOACÁN DE OCAMPO,16,ERONGARÍCUARO,032,TOCUARO,2,94,42,52,7
MICHOACÁN DE OCAMPO,16,ERONGARÍCUARO,032,YOTÁTIRO,2,59,39,20,5
MICHOACÁN DE OCAMPO,16,ERONGARÍCUARO,032,ZINCIRO,3,91,43,48,7
MICHOACÁN DE OCAMPO,16,GABRIEL ZAMORA,033,BARRANCA HONDA,1,10,3,7,1
MICHOACÁN DE OCAMPO,16,GABRIEL ZAMORA,033,CAPIRE DE LOMBARDÍA (EL CAPIRI),3,538,274,264,33
MICHOACÁN DE OCAMPO,16,GABRIEL ZAMORA,033,CHARAPENDO,4,336,174,162,26
MICHOACÁN DE OCAMPO,16,GABRIEL ZAMORA,033,EL ATUTO (TANQUES ATUTO),2,25,7,18,4
MICHOACÁN DE OCAMPO,16,GABRIEL ZAMORA,033,EL HUACO,3,265,128,137,19
MICHOACÁN DE OCAMPO,16,GABRIEL ZAMORA,033,EL INGENIO (EL PUENTE CANAL),2,25,16,9,3
MICHOACÁN DE OCAMPO,16,GABRIEL ZAMORA,033,EL SIFÓN,2,34,18,16,3
MICHOACÁN DE OCAMPO,16,GABRIEL ZAMORA,033,LA GALLINA,3,83,43,40,6
MICHOACÁN DE OCAMPO,16,GABRIEL ZAMORA,033,LA LAGUNA,3,75,40,35,8
MICHOACÁN DE OCAMPO,16,GABRIEL ZAMORA,033,LAS MINITAS,1,9,4,5,2
MICHOACÁN DE OCAMPO,16,GABRIEL ZAMORA,033,LOMBARDÍA,16,3222,1625,1597,178
MICHOACÁN DE OCAMPO,16,GABRIEL ZAMORA,033,LOS CAJONES,4,265,129,136,17
MICHOACÁN DE OCAMPO,16,GABRIEL ZAMORA,033,SANTA CASILDA,4,439,215,224,29
MICHOACÁN DE OCAMPO,16,GABRIEL ZAMORA,033,TEQUECARÁN,1,11,6,5,1
MICHOACÁN DE OCAMPO,16,GABRIEL ZAMORA,033,TZIRITZÍCUARO,2,47,28,19,5
MICHOACÁN DE OCAMPO,16,HIDALGO,034,AGOSTITLÁN,8,1111,592,519,58
MICHOACÁN DE OCAMPO,16,HIDALGO,034,AGUA AZUL,2,7,4,3,2
MICHOACÁN DE OCAMPO,16,HIDALGO,034,AGUA DEL PINO,2,20,9,11,2
MICHOACÁN DE OCAMPO,16,HIDALGO,034,AGUA FRÍA (PÍZCUARO),2,6,3,3,1
MICHOACÁN DE OCAMPO,16,HIDALGO,034,ARROYO LARGO,2,28,11,17,2
MICHOACÁN DE OCAMPO,16,HIDALGO,034,BUENAVISTA,1,14,4,10,2
MICHOACÁN DE OCAMPO,16,HIDALGO,034,CASAS PINTAS,2,58,28,30,3
MICHOACÁN DE OCAMPO,16,HIDALGO,034,CERRO DEL MACHO 2,2,5,4,1,2
MICHOACÁN DE OCAMPO,16,HIDALGO,034,CIENEGUILLAS,3,113,60,53,5
MICHOACÁN DE OCAMPO,16,HIDALGO,034,CIUDAD HIDALGO,107,19200,9854,9346,1310
MICHOACÁN DE OCAMPO,16,HIDALGO,034,COLONIA BENITO JUÁREZ,2,76,47,29,6
MICHOACÁN DE OCAMPO,16,HIDALGO,034,COLONIA MATA DE PINOS,3,53,25,28,3
MICHOACÁN DE OCAMPO,16,HIDALGO,034,CRUZ DE CAMINOS,2,67,31,36,3
MICHOACÁN DE OCAMPO,16,HIDALGO,034,CUCHIPITIO PALOS SECOS,2,22,10,12,3
MICHOACÁN DE OCAMPO,16,HIDALGO,034,CUITZILLOS,3,40,19,21,4
MICHOACÁN DE OCAMPO,16,HIDALGO,034,EJIDO RINCÓN DE RUBIOS (RANCHO RUIZ),1,23,10,13,2
MICHOACÁN DE OCAMPO,16,HIDALGO,034,EL AGOSTADERITO,2,12,6,6,2
MICHOACÁN DE OCAMPO,16,HIDALGO,034,EL ASTILLERO (ASTILLEROS),1,1,0,1,1
MICHOACÁN DE OCAMPO,16,HIDALGO,034,EL BAYO,2,41,23,18,3
MICHOACÁN DE OCAMPO,16,HIDALGO,034,EL CAPULÍN,2,55,29,26,5
MICHOACÁN DE OCAMPO,16,HIDALGO,034,EL CARACOL,3,121,61,60,8
MICHOACÁN DE OCAMPO,16,HIDALGO,034,EL CARRIZO,2,9,3,6,1
MICHOACÁN DE OCAMPO,16,HIDALGO,034,EL CHAPARRO,4,293,157,136,16
MICHOACÁN DE OCAMPO,16,HIDALGO,034,EL CORTIJO,3,139,67,72,7
MICHOACÁN DE OCAMPO,16,HIDALGO,034,EL JARAL (JANAMORO),2,174,92,82,9
MICHOACÁN DE OCAMPO,16,HIDALGO,034,EL MOLCAJETE,2,17,10,7,2
MICHOACÁN DE OCAMPO,16,HIDALGO,034,EL PEDREGAL,2,32,14,18,3
MICHOACÁN DE OCAMPO,16,HIDALGO,034,EL PITORREAL (CERRO PRIETO),2,37,20,17,3
MICHOACÁN DE OCAMPO,16,HIDALGO,034,EL PORVENIR,3,183,106,77,10
MICHOACÁN DE OCAMPO,16,HIDALGO,034,EL POTRERO DE LA VIRGEN,3,349,188,161,18
MICHOACÁN DE OCAMPO,16,HIDALGO,034,EL RETAJE,2,8,6,2,1
MICHOACÁN DE OCAMPO,16,HIDALGO,034,EL RETRANQUE (LA PRESA DE PUCUATO),2,17,7,10,2
MICHOACÁN DE OCAMPO,16,HIDALGO,034,EL SALITRE,2,7,2,5,1
MICHOACÁN DE OCAMPO,16,HIDALGO,034,EL SEÑALADERO,2,19,13,6,2
MICHOACÁN DE OCAMPO,16,HIDALGO,034,EL TEPETATE,3,14,6,8,3
MICHOACÁN DE OCAMPO,16,HIDALGO,034,EL TREN,2,5,3,2,1
MICHOACÁN DE OCAMPO,16,HIDALGO,034,ESTANCO DE SAN MATÍAS,2,40,22,18,3
MICHOACÁN DE OCAMPO,16,HIDALGO,034,HUAJÚMBARO,5,555,306,249,32
MICHOACÁN DE OCAMPO,16,HIDALGO,034,HUANIQUEO,3,147,75,72,9
MICHOACÁN DE OCAMPO,16,HIDALGO,034,JOSÉ MARÍA MORELOS (ZIRIPEO),3,154,78,76,11
MICHOACÁN DE OCAMPO,16,HIDALGO,034,JOYAS DE BIRRUETE (JANAMORO),3,46,25,21,4
MICHOACÁN DE OCAMPO,16,HIDALGO,034,LA CONGUERA,3,32,19,13,3
MICHOACÁN DE OCAMPO,16,HIDALGO,034,LA FRONTINA,1,129,62,67,8
MICHOACÁN DE OCAMPO,16,HIDALGO,034,LA GRANJA (PUERTO LA GRANJA),3,46,26,20,4
MICHOACÁN DE OCAMPO,16,HIDALGO,034,LA HUERTA,2,7,3,4,1
MICHOACÁN DE OCAMPO,16,HIDALGO,034,LA MESA,5,43,18,25,6
MICHOACÁN DE OCAMPO,16,HIDALGO,034,LA MINA,3,37,15,22,3
MICHOACÁN DE OCAMPO,16,HIDALGO,034,LA PALMA,2,13,5,8,3
MICHOACÁN DE OCAMPO,16,HIDALGO,034,LA TEJA,2,84,42,42,5
MICHOACÁN DE OCAMPO,16,HIDALGO,034,LA TOMA,3,51,22,29,4
MICHOACÁN DE OCAMPO,16,HIDALGO,034,LA VENTA DE SAN ANDRÉS,2,55,27,28,3
MICHOACÁN DE OCAMPO,16,HIDALGO,034,LA VERÓNICA,2,18,10,8,2
MICHOACÁN DE OCAMPO,16,HIDALGO,034,LA YERBABUENA,2,9,6,3,2
MICHOACÁN DE OCAMPO,16,HIDALGO,034,LAGUNA SECA,2,5,2,3,1
MICHOACÁN DE OCAMPO,16,HIDALGO,034,LAS CALERAS,2,75,38,37,7
MICHOACÁN DE OCAMPO,16,HIDALGO,034,LAS CANOYITAS,3,8,5,3,2
MICHOACÁN DE OCAMPO,16,HIDALGO,034,LAS CAPILLAS,3,27,11,16,3
MICHOACÁN DE OCAMPO,16,HIDALGO,034,LAS ESPINAS DE LA UNIÓN,3,14,6,8,3
MICHOACÁN DE OCAMPO,16,HIDALGO,034,LAS GRUTAS,3,156,69,87,12
MICHOACÁN DE OCAMPO,16,HIDALGO,034,LAS JOYAS,1,9,5,4,1
MICHOACÁN DE OCAMPO,16,HIDALGO,034,LAS JOYITAS,3,23,11,12,4
MICHOACÁN DE OCAMPO,16,HIDALGO,034,LAS PALMITAS,1,249,114,135,12
MICHOACÁN DE OCAMPO,16,HIDALGO,034,LAS PILAS,3,214,107,107,12
MICHOACÁN DE OCAMPO,16,HIDALGO,034,LAS PITAYAS DOS,2,8,3,5,1
MICHOACÁN DE OCAMPO,16,HIDALGO,034,LAS TABLAS,1,11,1,10,1
MICHOACÁN DE OCAMPO,16,HIDALGO,034,LÁZARO CÁRDENAS,1,32,13,19,2
MICHOACÁN DE OCAMPO,16,HIDALGO,034,LLANO DE AGOSTITLÁN,2,106,54,52,7
MICHOACÁN DE OCAMPO,16,HIDALGO,034,LOS ADOBES,2,25,10,15,3
MICHOACÁN DE OCAMPO,16,HIDALGO,034,LOS CEDRITOS,3,59,29,30,3
MICHOACÁN DE OCAMPO,16,HIDALGO,034,LOS CHORROS,3,39,20,19,4
MICHOACÁN DE OCAMPO,16,HIDALGO,034,LOS FRESNOS,3,14,7,7,3
MICHOACÁN DE OCAMPO,16,HIDALGO,034,LOS PATIOS,2,31,15,16,3
MICHOACÁN DE OCAMPO,16,HIDALGO,034,LOS PINITOS,1,16,6,10,2
MICHOACÁN DE OCAMPO,16,HIDALGO,034,LOS POZOS,3,80,37,43,5
MICHOACÁN DE OCAMPO,16,HIDALGO,034,MATA DE PINOS,3,168,95,73,10
MICHOACÁN DE OCAMPO,16,HIDALGO,034,MATA VENADO,2,7,6,1,1
MICHOACÁN DE OCAMPO,16,HIDALGO,034,MESA DE GUADALUPE (LA NORIA),4,143,70,73,11
MICHOACÁN DE OCAMPO,16,HIDALGO,034,MIL CUMBRES,1,17,8,9,2
MICHOACÁN DE OCAMPO,16,HIDALGO,034,MONTE CHIQUITO,2,18,11,7,2
MICHOACÁN DE OCAMPO,16,HIDALGO,034,MONTE OSCURO,2,10,5,5,2
MICHOACÁN DE OCAMPO,16,HIDALGO,034,PALOMAS (CERRO DEL GALLO),2,15,8,7,2
MICHOACÁN DE OCAMPO,16,HIDALGO,034,PALOMILLAS,2,43,22,21,3
MICHOACÁN DE OCAMPO,16,HIDALGO,034,PALOS SECOS,3,24,13,11,3
MICHOACÁN DE OCAMPO,16,HIDALGO,034,PEÑUELAS (EL TREN PEÑUELAS),1,2,0,2,1
MICHOACÁN DE OCAMPO,16,HIDALGO,034,PIE DE LA CUESTA,2,5,3,2,1
MICHOACÁN DE OCAMPO,16,HIDALGO,034,PIEDRA GORDA,2,18,8,10,2
MICHOACÁN DE OCAMPO,16,HIDALGO,034,PIEDRA PARADA,3,38,20,18,4
MICHOACÁN DE OCAMPO,16,HIDALGO,034,PINO GORDO,2,9,6,3,2
MICHOACÁN DE OCAMPO,16,HIDALGO,034,PLAN DE SANTA ROSA (PLAN DE HUANIQUEO),1,10,4,6,1
MICHOACÁN DE OCAMPO,16,HIDALGO,034,PUCUATO,4,185,100,85,14
MICHOACÁN DE OCAMPO,16,HIDALGO,034,PUENTE DE TIERRA,4,219,109,110,15
MICHOACÁN DE OCAMPO,16,HIDALGO,034,PUENTE DE VACAS,3,13,5,8,3
MICHOACÁN DE OCAMPO,16,HIDALGO,034,PUENTE DEL ENCINO,2,17,6,11,2
MICHOACÁN DE OCAMPO,16,HIDALGO,034,PUENTE LAS GALLINAS,1,8,2,6,1
MICHOACÁN DE OCAMPO,16,HIDALGO,034,PUERTO DE CUITAREO (PUERTO DEL SAGRADO CORAZÓN),3,84,39,45,6
MICHOACÁN DE OCAMPO,16,HIDALGO,034,PUERTO DE PUCUATO (LA COOPERATIVA),1,4,2,2,1
MICHOACÁN DE OCAMPO,16,HIDALGO,034,RANCHO ALEGRE,1,5,4,1,1
MICHOACÁN DE OCAMPO,16,HIDALGO,034,RINCÓN DE ESCOBEDO (JANAMORO),1,21,10,11,3
MICHOACÁN DE OCAMPO,16,HIDALGO,034,RINCÓN DE PITAHAYAS,2,21,10,11,2
MICHOACÁN DE OCAMPO,16,HIDALGO,034,RINCÓN DE RUBIOS,3,126,53,73,9
MICHOACÁN DE OCAMPO,16,HIDALGO,034,SABANETA,2,6,3,3,1
MICHOACÁN DE OCAMPO,16,HIDALGO,034,SAN ÁNGEL,2,13,5,8,2
MICHOACÁN DE OCAMPO,16,HIDALGO,034,SAN ANTONIO VILLALONGÍN,6,639,381,258,35
MICHOACÁN DE OCAMPO,16,HIDALGO,034,SAN BARTOLO CUITAREO,8,1250,624,626,56
MICHOACÁN DE OCAMPO,16,HIDALGO,034,SAN ISIDRO,3,361,170,191,17
MICHOACÁN DE OCAMPO,16,HIDALGO,034,SAN ISIDRO ALTA HUERTA,3,152,70,82,9
MICHOACÁN DE OCAMPO,16,HIDALGO,034,SAN JERÓNIMO,2,90,39,51,4
MICHOACÁN DE OCAMPO,16,HIDALGO,034,SAN JERÓNIMO (RINCÓN DE SAN JERÓNIMO) [FRACCIONAMIENTO],2,51,25,26,5
MICHOACÁN DE OCAMPO,16,HIDALGO,034,SAN JOSÉ (LA FÁBRICA),2,10,9,1,2
MICHOACÁN DE OCAMPO,16,HIDALGO,034,SAN JOSÉ IRAPEO (LA CASA DEL PADRE),2,31,14,17,3
MICHOACÁN DE OCAMPO,16,HIDALGO,034,SAN JUAN DE DIOS JAUJA,2,4,3,1,2
MICHOACÁN DE OCAMPO,16,HIDALGO,034,SAN LUCAS HUARIRAPEO (LA MESA DE SAN LUCAS),5,369,182,187,20
MICHOACÁN DE OCAMPO,16,HIDALGO,034,SAN MATÍAS GRANDE,6,1201,600,601,55
MICHOACÁN DE OCAMPO,16,HIDALGO,034,SAN NICOLÁS CUCHIPITIO,2,12,8,4,2
MICHOACÁN DE OCAMPO,16,HIDALGO,034,SAN PEDRO JÁCUARO (LAS JOYAS),6,1079,568,511,54
MICHOACÁN DE OCAMPO,16,HIDALGO,034,SAN RAFAEL,2,6,1,5,1
MICHOACÁN DE OCAMPO,16,HIDALGO,034,SERRANO,2,9,4,5,1
MICHOACÁN DE OCAMPO,16,HIDALGO,034,SOLACHE,2,66,38,28,4
MICHOACÁN DE OCAMPO,16,HIDALGO,034,TACARIO,3,65,31,34,6
MICHOACÁN DE OCAMPO,16,HIDALGO,034,TEMBENDADO (TEMENDAO),3,172,89,83,12
MICHOACÁN DE OCAMPO,16,HIDALGO,034,TIERRAS COLORADAS,3,24,15,9,3
MICHOACÁN DE OCAMPO,16,HIDALGO,034,TIERRAS COLORADAS DE SAN PEDRO,2,51,24,27,2
MICHOACÁN DE OCAMPO,16,LA HUACANA,035,AGUA BLANCA,3,91,44,47,8
MICHOACÁN DE OCAMPO,16,LA HUACANA,035,ARRONJADERO (LA CUESTA),3,35,15,20,4
MICHOACÁN DE OCAMPO,16,LA HUACANA,035,BELLAS FUENTES (NUEVO CENTRO),4,347,176,171,29
MICHOACÁN DE OCAMPO,16,LA HUACANA,035,CERRITO COLORADO,2,26,10,16,3
MICHOACÁN DE OCAMPO,16,LA HUACANA,035,CUIMBO,2,29,20,9,5
MICHOACÁN DE OCAMPO,16,LA HUACANA,035,CUPUÁN DEL RÍO,4,422,261,161,27
MICHOACÁN DE OCAMPO,16,LA HUACANA,035,EL ARROYO DEL ESPÍRITU SANTO,2,18,8,10,2
MICHOACÁN DE OCAMPO,16,LA HUACANA,035,EL CANELO,3,58,31,27,5
MICHOACÁN DE OCAMPO,16,LA HUACANA,035,EL CAPIRE DE OROPEO,2,21,9,12,3
MICHOACÁN DE OCAMPO,16,LA HUACANA,035,EL CHÁUZ,5,683,327,356,43
MICHOACÁN DE OCAMPO,16,LA HUACANA,035,EL CHILAR,2,22,11,11,2
MICHOACÁN DE OCAMPO,16,LA HUACANA,035,EL CIRUELO,3,59,24,35,6
MICHOACÁN DE OCAMPO,16,LA HUACANA,035,EL COLORADO,2,6,4,2,2
MICHOACÁN DE OCAMPO,16,LA HUACANA,035,EL EMBARCADERO,1,4,3,1,1
MICHOACÁN DE OCAMPO,16,LA HUACANA,035,EL ESTRADITO,1,8,5,3,1
MICHOACÁN DE OCAMPO,16,LA HUACANA,035,EL LEÓN COLGADO,1,7,4,3,1
MICHOACÁN DE OCAMPO,16,LA HUACANA,035,EL LIMONCITO,2,18,7,11,3
MICHOACÁN DE OCAMPO,16,LA HUACANA,035,EL LINDERO,2,48,20,28,3
MICHOACÁN DE OCAMPO,16,LA HUACANA,035,EL NARANJITO (LIMÓN DE JORULLO),2,11,3,8,2
MICHOACÁN DE OCAMPO,16,LA HUACANA,035,EL PALMAR,2,33,13,20,5
MICHOACÁN DE OCAMPO,16,LA HUACANA,035,EL REPARO DE LUNA,2,19,10,9,3
MICHOACÁN DE OCAMPO,16,LA HUACANA,035,EL TERRERO (DAVID C. MANJARREZ),2,13,6,7,2
MICHOACÁN DE OCAMPO,16,LA HUACANA,035,EL TERRERO (EL CUATRO),1,6,4,2,1
MICHOACÁN DE OCAMPO,16,LA HUACANA,035,EL VALLE (EL VALLECITO),3,60,33,27,6
MICHOACÁN DE OCAMPO,16,LA HUACANA,035,ERNESTO RODRÍGUEZ [COLONIA],2,197,95,102,17
MICHOACÁN DE OCAMPO,16,LA HUACANA,035,FINCAS DE INGUARÁN,3,63,24,39,8
MICHOACÁN DE OCAMPO,16,LA HUACANA,035,GUADALUPE DE OROPEO,2,24,14,10,2
MICHOACÁN DE OCAMPO,16,LA HUACANA,035,HACIENDA VIEJA,2,28,15,13,3
MICHOACÁN DE OCAMPO,16,LA HUACANA,035,HUATZIRÁN,2,20,8,12,3
MICHOACÁN DE OCAMPO,16,LA HUACANA,035,ICHAMIO,3,262,116,146,15
MICHOACÁN DE OCAMPO,16,LA HUACANA,035,LA ALGODONERA,3,13,7,6,2
MICHOACÁN DE OCAMPO,16,LA HUACANA,035,LA CAJA DE ZICUIRÁN,1,11,7,4,1
MICHOACÁN DE OCAMPO,16,LA HUACANA,035,LA CURUCA,1,6,3,3,1
MICHOACÁN DE OCAMPO,16,LA HUACANA,035,LA GALLINA (VISTA HERMOSA),1,10,7,3,1
MICHOACÁN DE OCAMPO,16,LA HUACANA,035,LA HUACANA,14,2153,1078,1075,137
MICHOACÁN DE OCAMPO,16,LA HUACANA,035,LA JOYA DE ÁLVAREZ,1,22,13,9,2
MICHOACÁN DE OCAMPO,16,LA HUACANA,035,LA PEDREGOSA,2,30,12,18,3
MICHOACÁN DE OCAMPO,16,LA HUACANA,035,LA PEÑA DE CUPUÁN,3,26,14,12,3
MICHOACÁN DE OCAMPO,16,LA HUACANA,035,LA PRESA DE ZICUIRÁN,1,13,6,7,2
MICHOACÁN DE OCAMPO,16,LA HUACANA,035,LA SAUDA (LA COLONIA),2,48,23,25,5
MICHOACÁN DE OCAMPO,16,LA HUACANA,035,LAS ANONAS,1,5,2,3,1
MICHOACÁN DE OCAMPO,16,LA HUACANA,035,LAS CARÁMICUAS,1,18,11,7,1
MICHOACÁN DE OCAMPO,16,LA HUACANA,035,LAS CRUCES (LAS CRUCITAS),1,10,5,5,1
MICHOACÁN DE OCAMPO,16,LA HUACANA,035,LAS HIGUERAS,2,15,6,9,2
MICHOACÁN DE OCAMPO,16,LA HUACANA,035,LAS PILAS,2,15,6,9,2
MICHOACÁN DE OCAMPO,16,LA HUACANA,035,LOS CIRIANCITOS (LÁZARO CÁRDENAS),3,196,96,100,14
MICHOACÁN DE OCAMPO,16,LA HUACANA,035,LOS COPALES,3,61,27,34,6
MICHOACÁN DE OCAMPO,16,LA HUACANA,035,LOS OLIVOS,3,98,47,51,11
MICHOACÁN DE OCAMPO,16,LA HUACANA,035,LOS POCITOS,3,88,34,54,6
MICHOACÁN DE OCAMPO,16,LA HUACANA,035,MANGA DE CHÁVEZ,2,15,7,8,3
MICHOACÁN DE OCAMPO,16,LA HUACANA,035,MANGA DE CUIMBO,4,243,145,98,12
MICHOACÁN DE OCAMPO,16,LA HUACANA,035,MATA DE PLÁTANO,4,191,87,104,17
MICHOACÁN DE OCAMPO,16,LA HUACANA,035,NARANJO DE JORULLO,1,11,6,5,1
MICHOACÁN DE OCAMPO,16,LA HUACANA,035,NARANJO DE TZIRITZÍCUARO,4,93,54,39,10
MICHOACÁN DE OCAMPO,16,LA HUACANA,035,NUEVO INGUARÁN (SAN NICOLÁS),3,38,17,21,4
MICHOACÁN DE OCAMPO,16,LA HUACANA,035,OJO DE AGUA DE SAN IGNACIO,4,100,49,51,13
MICHOACÁN DE OCAMPO,16,LA HUACANA,035,OROPEO,4,98,49,49,11
MICHOACÁN DE OCAMPO,16,LA HUACANA,035,PIEDRA VERDE,3,133,61,72,11
MICHOACÁN DE OCAMPO,16,LA HUACANA,035,POTRERILLOS DE RENTERÍA (CUPUANCILLO),4,69,40,29,8
MICHOACÁN DE OCAMPO,16,LA HUACANA,035,PUEBLO VIEJO,2,63,34,29,5
MICHOACÁN DE OCAMPO,16,LA HUACANA,035,PUERTA DE LA PLAYA,2,33,16,17,3
MICHOACÁN DE OCAMPO,16,LA HUACANA,035,PUERTO SAN SIMÓN (CERRO DE BURRAS),1,25,11,14,3
MICHOACÁN DE OCAMPO,16,LA HUACANA,035,SAN FRANCISCO DE LOS RANCHOS (EL FALSETE),3,144,76,68,10
MICHOACÁN DE OCAMPO,16,LA HUACANA,035,SAN JOSÉ CAYACO,3,116,52,64,14
MICHOACÁN DE OCAMPO,16,LA HUACANA,035,SAN MIGUEL DE LA LAGUNA (LAS ESTANCIAS),2,43,19,24,2
MICHOACÁN DE OCAMPO,16,LA HUACANA,035,SAN MIGUEL SILAHUA (LA NOPALERA),4,113,57,56,12
MICHOACÁN DE OCAMPO,16,LA HUACANA,035,SAN PEDRO BARAJAS,3,118,67,51,11
MICHOACÁN DE OCAMPO,16,LA HUACANA,035,SAN PEDRO JORULLO,2,19,6,13,2
MICHOACÁN DE OCAMPO,16,LA HUACANA,035,SANTA MARÍA (CHANGUNGAL),3,42,20,22,6
MICHOACÁN DE OCAMPO,16,LA HUACANA,035,SIN AGUA (RANCHO NUEVO),2,36,18,18,3
MICHOACÁN DE OCAMPO,16,LA HUACANA,035,TAMO,2,24,9,15,3
MICHOACÁN DE OCAMPO,16,LA HUACANA,035,VILLAHERMOSA,2,13,7,6,2
MICHOACÁN DE OCAMPO,16,LA HUACANA,035,ZAPOTE DE JORULLO,1,9,5,4,2
MICHOACÁN DE OCAMPO,16,LA HUACANA,035,ZAPOTE DE LAS CUATAS,2,25,11,14,3
MICHOACÁN DE OCAMPO,16,LA HUACANA,035,ZICUIRÁN,6,909,462,447,58
MICHOACÁN DE OCAMPO,16,HUANDACAREO,036,CAPACHO,5,358,170,188,23
MICHOACÁN DE OCAMPO,16,HUANDACAREO,036,HUANDACAREO,14,1762,904,858,121
MICHOACÁN DE OCAMPO,16,HUANDACAREO,036,LA ESTANCIA,3,194,84,110,11
MICHOACÁN DE OCAMPO,16,HUANDACAREO,036,SAN JOSÉ CUARO,4,266,129,137,18
MICHOACÁN DE OCAMPO,16,HUANDACAREO,036,TUPATARILLO,2,11,7,4,2
MICHOACÁN DE OCAMPO,16,HUANDACAREO,036,TUPÁTARO,3,27,11,16,3
MICHOACÁN DE OCAMPO,16,HUANIQUEO,037,COEPERIO,2,24,16,8,4
MICHOACÁN DE OCAMPO,16,HUANIQUEO,037,COLONIA 20 DE NOVIEMBRE,1,7,3,4,1
MICHOACÁN DE OCAMPO,16,HUANIQUEO,037,EL CERRITO,2,38,12,26,3
MICHOACÁN DE OCAMPO,16,HUANIQUEO,037,HUANIQUEO DE MORALES,7,655,346,309,54
MICHOACÁN DE OCAMPO,16,HUANIQUEO,037,HUAPEO,2,23,10,13,2
MICHOACÁN DE OCAMPO,16,HUANIQUEO,037,JESÚS MARÍA,2,43,21,22,4
MICHOACÁN DE OCAMPO,16,HUANIQUEO,037,LA MANZA,3,52,25,27,6
MICHOACÁN DE OCAMPO,16,HUANIQUEO,037,LA PRESA,2,22,12,10,4
MICHOACÁN DE OCAMPO,16,HUANIQUEO,037,OJO DE AGUA (OJO DE AGUA DE MANZA),1,11,4,7,1
MICHOACÁN DE OCAMPO,16,HUANIQUEO,037,PUENTE DE SAN ISIDRO,2,19,10,9,2
MICHOACÁN DE OCAMPO,16,HUANIQUEO,037,PUERTA DE JARIPITIRO,3,51,27,24,7
MICHOACÁN DE OCAMPO,16,HUANIQUEO,037,SAN NICOLÁS DE LAS PIEDRAS,2,21,11,10,2
MICHOACÁN DE OCAMPO,16,HUANIQUEO,037,SAN PEDRO PURUÁTIRO,3,78,45,33,9
MICHOACÁN DE OCAMPO,16,HUANIQUEO,037,SANTA FE DE LA LABOR,2,7,4,3,2
MICHOACÁN DE OCAMPO,16,HUANIQUEO,037,SANTIAGO CONGREGACIÓN,2,36,21,15,3
MICHOACÁN DE OCAMPO,16,HUANIQUEO,037,TACUPILLO,3,60,34,26,7
MICHOACÁN DE OCAMPO,16,HUANIQUEO,037,TECACHO,3,175,84,91,13
MICHOACÁN DE OCAMPO,16,HUANIQUEO,037,TENDEPARACUA,3,66,28,38,8
MICHOACÁN DE OCAMPO,16,HUETAMO,038,ACOPEO,2,35,21,14,3
MICHOACÁN DE OCAMPO,16,HUETAMO,038,AGUA DE LA VIRGEN,2,17,8,9,2
MICHOACÁN DE OCAMPO,16,HUETAMO,038,AGUA FRÍA,1,3,0,3,2
MICHOACÁN DE OCAMPO,16,HUETAMO,038,ANGANDICO,2,14,6,8,4
MICHOACÁN DE OCAMPO,16,HUETAMO,038,ARROYO SECO,2,46,24,22,7
MICHOACÁN DE OCAMPO,16,HUETAMO,038,ARUA,2,8,3,5,2
MICHOACÁN DE OCAMPO,16,HUETAMO,038,ATZÍMBARO,3,60,27,33,6
MICHOACÁN DE OCAMPO,16,HUETAMO,038,BAZTÁN DEL COBRE,4,183,77,106,12
MICHOACÁN DE OCAMPO,16,HUETAMO,038,BUENAVISTA UNO (BUENAVISTA DE LAS ANONAS),3,93,57,36,7
MICHOACÁN DE OCAMPO,16,HUETAMO,038,CAPEO,3,125,61,64,10
MICHOACÁN DE OCAMPO,16,HUETAMO,038,CHARÁCUARO,2,52,27,25,4
MICHOACÁN DE OCAMPO,16,HUETAMO,038,CHIHUERO,2,42,23,19,3
MICHOACÁN DE OCAMPO,16,HUETAMO,038,COENANDIO,2,32,18,14,3
MICHOACÁN DE OCAMPO,16,HUETAMO,038,COLONIA J. DAVID TELLITUD (SANTA RITA),4,128,59,69,12
MICHOACÁN DE OCAMPO,16,HUETAMO,038,COMBURINDIO,4,180,89,91,20
MICHOACÁN DE OCAMPO,16,HUETAMO,038,CUARO,2,8,5,3,2
MICHOACÁN DE OCAMPO,16,HUETAMO,038,EL CARMEN,2,21,8,13,2
MICHOACÁN DE OCAMPO,16,HUETAMO,038,EL CASCALOTE,1,12,1,11,2
MICHOACÁN DE OCAMPO,16,HUETAMO,038,EL CUAJILOTE,2,12,6,6,2
MICHOACÁN DE OCAMPO,16,HUETAMO,038,EL GUSANO DE SANTIAGO,3,27,15,12,5
MICHOACÁN DE OCAMPO,16,HUETAMO,038,EL NARANJO,3,22,9,13,3
MICHOACÁN DE OCAMPO,16,HUETAMO,038,EL OCUARO,4,106,54,52,12
MICHOACÁN DE OCAMPO,16,HUETAMO,038,EL PINZÁN,2,47,21,26,4
MICHOACÁN DE OCAMPO,16,HUETAMO,038,EL POTRERO,2,18,6,12,2
MICHOACÁN DE OCAMPO,16,HUETAMO,038,EL REPARO,4,35,10,25,5
MICHOACÁN DE OCAMPO,16,HUETAMO,038,EL RODEO,2,15,6,9,2
MICHOACÁN DE OCAMPO,16,HUETAMO,038,EL ROSARIO,3,138,65,73,15
MICHOACÁN DE OCAMPO,16,HUETAMO,038,EL SAUZ,3,36,20,16,3
MICHOACÁN DE OCAMPO,16,HUETAMO,038,EL TIMBINAL,1,12,7,5,1
MICHOACÁN DE OCAMPO,16,HUETAMO,038,ESTIMUCHA,2,54,22,32,3
MICHOACÁN DE OCAMPO,16,HUETAMO,038,GUAYABO DE LOS VALDEZ,2,6,1,5,1
MICHOACÁN DE OCAMPO,16,HUETAMO,038,HUATICHAPIO,2,30,17,13,2
MICHOACÁN DE OCAMPO,16,HUETAMO,038,HUETAMO DE NÚÑEZ,42,7407,3744,3663,482
MICHOACÁN DE OCAMPO,16,HUETAMO,038,IRÁMUCO,4,103,58,45,11
MICHOACÁN DE OCAMPO,16,HUETAMO,038,LA CUCHILLA,2,38,14,24,5
MICHOACÁN DE OCAMPO,16,HUETAMO,038,LA ERA,3,26,9,17,3
MICHOACÁN DE OCAMPO,16,HUETAMO,038,LA ESTANCIA,2,29,14,15,3
MICHOACÁN DE OCAMPO,16,HUETAMO,038,LA GARITA,2,42,22,20,3
MICHOACÁN DE OCAMPO,16,HUETAMO,038,LA LAJA,3,46,22,24,3
MICHOACÁN DE OCAMPO,16,HUETAMO,038,LA PAROTA,3,146,63,83,11
MICHOACÁN DE OCAMPO,16,HUETAMO,038,LA QUETZERÍA (LA QUESERÍA),3,133,67,66,7
MICHOACÁN DE OCAMPO,16,HUETAMO,038,LA RODILLERA,2,9,2,7,2
MICHOACÁN DE OCAMPO,16,HUETAMO,038,LA TIRINGUCHA,2,22,9,13,3
MICHOACÁN DE OCAMPO,16,HUETAMO,038,LAS ANONAS (LAS ANONAS DE LOS JAIMES),2,19,13,6,2
MICHOACÁN DE OCAMPO,16,HUETAMO,038,LAS CARÁMICUAS,2,26,12,14,3
MICHOACÁN DE OCAMPO,16,HUETAMO,038,LAS CEIBAS,3,37,19,18,4
MICHOACÁN DE OCAMPO,16,HUETAMO,038,LAS CEIBAS DE PATACEO,2,38,13,25,3
MICHOACÁN DE OCAMPO,16,HUETAMO,038,LAS TRINCHERAS,2,18,12,6,3
MICHOACÁN DE OCAMPO,16,HUETAMO,038,LOS CUACHALALATES,2,45,20,25,6
MICHOACÁN DE OCAMPO,16,HUETAMO,038,LOS HORNITOS,2,38,18,20,7
MICHOACÁN DE OCAMPO,16,HUETAMO,038,LOS HORNOS (LA CACAMICUA),2,78,43,35,5
MICHOACÁN DE OCAMPO,16,HUETAMO,038,LOS LIMONES,1,9,4,5,1
MICHOACÁN DE OCAMPO,16,HUETAMO,038,MESA DE TOTOTLÁN,3,38,17,21,3
MICHOACÁN DE OCAMPO,16,HUETAMO,038,OJO DE AGUA DE URO,3,39,18,21,3
MICHOACÁN DE OCAMPO,16,HUETAMO,038,PEÑA PRIETA (LA TRAMPA),1,5,2,3,2
MICHOACÁN DE OCAMPO,16,HUETAMO,038,PINZANANGAPIO,3,29,13,16,6
MICHOACÁN DE OCAMPO,16,HUETAMO,038,PUERTAS CUATAS,1,1,1,0,1
MICHOACÁN DE OCAMPO,16,HUETAMO,038,PURECHUCHO (EL BRASIL),4,220,107,113,25
MICHOACÁN DE OCAMPO,16,HUETAMO,038,QUENCHENDIO,3,78,36,42,7
MICHOACÁN DE OCAMPO,16,HUETAMO,038,RINCÓN DE LAS TRUCHAS,3,20,8,12,3
MICHOACÁN DE OCAMPO,16,HUETAMO,038,SAN ANTONIO,2,71,35,36,7
MICHOACÁN DE OCAMPO,16,HUETAMO,038,SAN IGNACIO,3,38,15,23,5
MICHOACÁN DE OCAMPO,16,HUETAMO,038,SAN JERÓNIMO,4,433,235,198,26
MICHOACÁN DE OCAMPO,16,HUETAMO,038,SAN MIGUEL MONTECILLOS (MONTECILLOS),5,168,77,91,17
MICHOACÁN DE OCAMPO,16,HUETAMO,038,SAN NICOLÁS ARROYO HONDO,3,111,51,60,12
MICHOACÁN DE OCAMPO,16,HUETAMO,038,SANCHIQUEO,3,26,15,11,3
MICHOACÁN DE OCAMPO,16,HUETAMO,038,SANTA ELENA,2,8,5,3,1
MICHOACÁN DE OCAMPO,16,HUETAMO,038,SANTA GERTRUDIS,3,19,10,9,2
MICHOACÁN DE OCAMPO,16,HUETAMO,038,SANTA MARÍA,4,105,45,60,11
MICHOACÁN DE OCAMPO,16,HUETAMO,038,SANTIAGO CONGURIPO,4,101,48,53,9
MICHOACÁN DE OCAMPO,16,HUETAMO,038,TERRERO DE LOS DÍAZ,1,97,41,56,6
MICHOACÁN DE OCAMPO,16,HUETAMO,038,TURITZIO,4,99,53,46,11
MICHOACÁN DE OCAMPO,16,HUETAMO,038,TZIRITZÍCUARO,3,182,84,98,15
MICHOACÁN DE OCAMPO,16,HUETAMO,038,URO,1,3,2,1,2
MICHOACÁN DE OCAMPO,16,HUETAMO,038,USPIO,2,18,6,12,3
MICHOACÁN DE OCAMPO,16,HUETAMO,038,ZACANGUIRETE,2,14,3,11,2
MICHOACÁN DE OCAMPO,16,HUETAMO,038,ZAPOTE DE LOS DÍAZ,1,27,13,14,2
MICHOACÁN DE OCAMPO,16,HUETAMO,038,ZICUIRÁN,1,6,2,4,1
MICHOACÁN DE OCAMPO,16,HUIRAMBA,039,EL CARMEN,2,124,64,60,9
MICHOACÁN DE OCAMPO,16,HUIRAMBA,039,EL PEDREGAL,3,298,130,168,16
MICHOACÁN DE OCAMPO,16,HUIRAMBA,039,EL REFUGIO,1,9,7,2,1
MICHOACÁN DE OCAMPO,16,HUIRAMBA,039,EL SOBRADO,4,447,227,220,29
MICHOACÁN DE OCAMPO,16,HUIRAMBA,039,HUIRAMBA,5,1320,708,612,69
MICHOACÁN DE OCAMPO,16,HUIRAMBA,039,LA NOPALERITA,1,6,4,2,1
MICHOACÁN DE OCAMPO,16,HUIRAMBA,039,LA PRESA,2,81,47,34,8
MICHOACÁN DE OCAMPO,16,HUIRAMBA,039,LA PROVIDENCIA,1,8,5,3,1
MICHOACÁN DE OCAMPO,16,HUIRAMBA,039,LA REUNIÓN,1,29,14,15,2
MICHOACÁN DE OCAMPO,16,HUIRAMBA,039,LAS TABLAS,2,94,51,43,8
MICHOACÁN DE OCAMPO,16,HUIRAMBA,039,LOS CERRITOS,2,26,15,11,3
MICHOACÁN DE OCAMPO,16,HUIRAMBA,039,QUIRÍNGUARO (SAN SIMÓN QUIRÍNGUARO),2,56,28,28,4
MICHOACÁN DE OCAMPO,16,HUIRAMBA,039,TUPÁTARO,3,308,154,154,15
MICHOACÁN DE OCAMPO,16,INDAPARAPEO,040,CAÑADA DEL AGUA,3,48,25,23,5
MICHOACÁN DE OCAMPO,16,INDAPARAPEO,040,COLONIA BENITO JUÁREZ (CHAPITIRO),4,225,113,112,14
MICHOACÁN DE OCAMPO,16,INDAPARAPEO,040,COLONIA DE GUADALUPE,2,195,105,90,13
MICHOACÁN DE OCAMPO,16,INDAPARAPEO,040,COLONIA DEL TRIUNFO (LA TEPACUA),2,63,25,38,4
MICHOACÁN DE OCAMPO,16,INDAPARAPEO,040,ESTACIÓN DE QUIRIO (QUIRIO),1,52,20,32,3
MICHOACÁN DE OCAMPO,16,INDAPARAPEO,040,INDAPARAPEO,13,2102,1078,1024,125
MICHOACÁN DE OCAMPO,16,INDAPARAPEO,040,LA ARPITA,1,7,3,4,1
MICHOACÁN DE OCAMPO,16,INDAPARAPEO,040,LA HERRADURA,1,8,1,7,1
MICHOACÁN DE OCAMPO,16,INDAPARAPEO,040,LAS HUERTAS,2,25,15,10,2
MICHOACÁN DE OCAMPO,16,INDAPARAPEO,040,LAS PERAS,3,48,19,29,4
MICHOACÁN DE OCAMPO,16,INDAPARAPEO,040,LAS PITAHAYAS,3,207,105,102,10
MICHOACÁN DE OCAMPO,16,INDAPARAPEO,040,LOS CIMIENTOS,1,6,3,3,1
MICHOACÁN DE OCAMPO,16,INDAPARAPEO,040,LOS NARANJOS,2,45,20,25,4
MICHOACÁN DE OCAMPO,16,INDAPARAPEO,040,PLAN DE LA SALUD,1,7,4,3,1
MICHOACÁN DE OCAMPO,16,INDAPARAPEO,040,PLAN DE LAS PALMAS,3,132,59,73,8
MICHOACÁN DE OCAMPO,16,INDAPARAPEO,040,PUEBLO NUEVO,3,118,62,56,11
MICHOACÁN DE OCAMPO,16,INDAPARAPEO,040,SAN LUCAS PÍO,5,858,435,423,38
MICHOACÁN DE OCAMPO,16,INDAPARAPEO,040,ZACAPENDO,2,60,30,30,5
MICHOACÁN DE OCAMPO,16,IRIMBO,041,BALVANEDA,2,24,18,6,2
MICHOACÁN DE OCAMPO,16,IRIMBO,041,CERRITO BLANCO,2,36,22,14,2
MICHOACÁN DE OCAMPO,16,IRIMBO,041,CHUPIO,2,49,28,21,4
MICHOACÁN DE OCAMPO,16,IRIMBO,041,CONCHARRÁS,1,4,2,2,1
MICHOACÁN DE OCAMPO,16,IRIMBO,041,CRISTO REY,2,54,31,23,4
MICHOACÁN DE OCAMPO,16,IRIMBO,041,EL COLORÍN (SEIS DE JUNIO),2,28,16,12,3
MICHOACÁN DE OCAMPO,16,IRIMBO,041,EL SALITRE,2,153,74,79,8
MICHOACÁN DE OCAMPO,16,IRIMBO,041,EL TINACO,2,68,38,30,4
MICHOACÁN DE OCAMPO,16,IRIMBO,041,EL ZORRILLO,1,19,13,6,1
MICHOACÁN DE OCAMPO,16,IRIMBO,041,ESTACIÓN IRIMBO,2,25,10,15,2
MICHOACÁN DE OCAMPO,16,IRIMBO,041,GARAMBULLO,1,7,5,2,1
MICHOACÁN DE OCAMPO,16,IRIMBO,041,IRIMBO,7,1285,671,614,78
MICHOACÁN DE OCAMPO,16,IRIMBO,041,LA CUAJADA,2,30,14,16,2
MICHOACÁN DE OCAMPO,16,IRIMBO,041,LA FRONTERA,2,152,79,73,9
MICHOACÁN DE OCAMPO,16,IRIMBO,041,LLANO GRANDE,3,51,24,27,4
MICHOACÁN DE OCAMPO,16,IRIMBO,041,LOMA DE CHUPIO,2,30,15,15,2
MICHOACÁN DE OCAMPO,16,IRIMBO,041,LOS MARZOS EJIDO,1,35,22,13,3
MICHOACÁN DE OCAMPO,16,IRIMBO,041,LOS MARZOS PEQUEÑA,2,27,12,15,2
MICHOACÁN DE OCAMPO,16,IRIMBO,041,LOS MOGOTES,2,20,10,10,2
MICHOACÁN DE OCAMPO,16,IRIMBO,041,SAN FRANCISCO EPUNGUIO,3,195,101,94,12
MICHOACÁN DE OCAMPO,16,IRIMBO,041,SAN JOSÉ DE MAGALLANES,4,428,216,212,26
MICHOACÁN DE OCAMPO,16,IRIMBO,041,SAN LORENZO QUERÉNDARO,5,533,267,266,28
MICHOACÁN DE OCAMPO,16,IRIMBO,041,SAN MIGUEL EL ALTO,3,46,23,23,4
MICHOACÁN DE OCAMPO,16,IRIMBO,041,SAN MIGUEL LA VIRGEN,2,34,15,19,2
MICHOACÁN DE OCAMPO,16,IRIMBO,041,SAN VICENTE EL CHICO (MANZANA DE SAN VICENTE),2,105,52,53,7
MICHOACÁN DE OCAMPO,16,IRIMBO,041,TZINTZINGAREO,5,782,412,370,35
MICHOACÁN DE OCAMPO,16,IXTLÁN,042,CAMUCUATO,2,62,29,33,4
MICHOACÁN DE OCAMPO,16,IXTLÁN,042,EL COLONGO,2,121,65,56,8
MICHOACÁN DE OCAMPO,16,IXTLÁN,042,EL LIMÓN,2,138,69,69,6
MICHOACÁN DE OCAMPO,16,IXTLÁN,042,EL SALITRE,2,71,34,37,5
MICHOACÁN DE OCAMPO,16,IXTLÁN,042,EL VALENCIANO,2,87,38,49,5
MICHOACÁN DE OCAMPO,16,IXTLÁN,042,IXTLÁN DE LOS HERVORES,12,1505,764,741,80
MICHOACÁN DE OCAMPO,16,IXTLÁN,042,LA ESTANZUELA,3,221,111,110,12
MICHOACÁN DE OCAMPO,16,IXTLÁN,042,LA PLAZA DEL LIMÓN,4,334,169,165,26
MICHOACÁN DE OCAMPO,16,IXTLÁN,042,RINCÓN DEL MEZQUITE,3,105,52,53,8
MICHOACÁN DE OCAMPO,16,IXTLÁN,042,SAN CRISTÓBAL,2,47,26,21,3
MICHOACÁN DE OCAMPO,16,IXTLÁN,042,SAN SIMÓN,3,153,74,79,10
MICHOACÁN DE OCAMPO,16,JACONA,043,ANTORCHA CAMPESINA [COLONIA],3,72,31,41,6
MICHOACÁN DE OCAMPO,16,JACONA,043,EL PLATANAL (LA PLANTA),4,686,371,315,37
MICHOACÁN DE OCAMPO,16,JACONA,043,ESTANCIA DE IGARTUA,2,192,102,90,9
MICHOACÁN DE OCAMPO,16,JACONA,043,JACONA DE PLANCARTE,59,11851,5872,5979,660
MICHOACÁN DE OCAMPO,16,JACONA,043,RANCHO NUEVO (JOYAS DEL PEDREGAL),2,98,44,54,5
MICHOACÁN DE OCAMPO,16,JACONA,043,TAMÁNDARO,2,155,84,71,8
MICHOACÁN DE OCAMPO,16,JIMÉNEZ,044,CAURIO DE GUADALUPE (CABRÍO),5,360,174,186,29
MICHOACÁN DE OCAMPO,16,JIMÉNEZ,044,CAURIO DE LA RINCONADA,3,66,31,35,5
MICHOACÁN DE OCAMPO,16,JIMÉNEZ,044,CERRITO LARGO (LOS CERRITOS),3,32,14,18,5
MICHOACÁN DE OCAMPO,16,JIMÉNEZ,044,CHAPITIRO,3,32,12,20,4
MICHOACÁN DE OCAMPO,16,JIMÉNEZ,044,COPÁNDARO (COPÁNDARO DEL CUATRO),4,364,202,162,23
MICHOACÁN DE OCAMPO,16,JIMÉNEZ,044,EL CUATRO,3,75,36,39,8
MICHOACÁN DE OCAMPO,16,JIMÉNEZ,044,EL RANCHITO,2,7,4,3,2
MICHOACÁN DE OCAMPO,16,JIMÉNEZ,044,EL ZAPOTE,3,44,21,23,5
MICHOACÁN DE OCAMPO,16,JIMÉNEZ,044,HUANDACUCA (MARIANA),2,22,9,13,2
MICHOACÁN DE OCAMPO,16,JIMÉNEZ,044,LA ESTANCIA (LA PRESA DE WILSON),2,13,6,7,2
MICHOACÁN DE OCAMPO,16,JIMÉNEZ,044,LA SOLEDAD,1,6,2,4,1
MICHOACÁN DE OCAMPO,16,JIMÉNEZ,044,LAS COLONIAS,4,268,138,130,19
MICHOACÁN DE OCAMPO,16,JIMÉNEZ,044,LOS ESPINOS,3,119,60,59,11
MICHOACÁN DE OCAMPO,16,JIMÉNEZ,044,TUMBIO,2,34,17,17,3
MICHOACÁN DE OCAMPO,16,JIMÉNEZ,044,VILLA JIMÉNEZ,9,1099,555,544,87
MICHOACÁN DE OCAMPO,16,JIMÉNEZ,044,ZIPIMEO,3,113,61,52,11
MICHOACÁN DE OCAMPO,16,JIQUILPAN,045,ABADIANO (LOS BAJOS),2,80,43,37,2
MICHOACÁN DE OCAMPO,16,JIQUILPAN,045,EL FRESNO,2,50,25,25,4
MICHOACÁN DE OCAMPO,16,JIQUILPAN,045,FRANCISCO SARABIA (CERRITO PELÓN),3,232,120,112,14
MICHOACÁN DE OCAMPO,16,JIQUILPAN,045,JIQUILPAN DE JUÁREZ,45,8497,4272,4225,579
MICHOACÁN DE OCAMPO,16,JIQUILPAN,045,JOSÉ ABADIANO (LOS ALTOS),4,164,98,66,9
MICHOACÁN DE OCAMPO,16,JIQUILPAN,045,LAGUNITA,2,60,30,30,3
MICHOACÁN DE OCAMPO,16,JIQUILPAN,045,LAS ÁNIMAS,2,25,15,10,2
MICHOACÁN DE OCAMPO,16,JIQUILPAN,045,LOS REMEDIOS,4,585,307,278,26
MICHOACÁN DE OCAMPO,16,JIQUILPAN,045,LOS TÁBANOS,3,25,16,9,3
MICHOACÁN DE OCAMPO,16,JIQUILPAN,045,NIÑOS HÉROES,1,4,0,4,1
MICHOACÁN DE OCAMPO,16,JIQUILPAN,045,PALOS ALTOS,1,16,10,6,1
MICHOACÁN DE OCAMPO,16,JIQUILPAN,045,PAREDONES,2,53,25,28,2
MICHOACÁN DE OCAMPO,16,JIQUILPAN,045,SANTA BÁRBARA,3,133,68,65,7
MICHOACÁN DE OCAMPO,16,JUÁREZ,046,AGUA DE LA PIEDRA,1,9,2,7,1
MICHOACÁN DE OCAMPO,16,JUÁREZ,046,BENITO JUÁREZ,6,1361,716,645,72
MICHOACÁN DE OCAMPO,16,JUÁREZ,046,BUENAVISTA DE ZAPATA (EL ATORÓN),2,68,28,40,4
MICHOACÁN DE OCAMPO,16,JUÁREZ,046,CERRO COLORADO,3,261,124,137,13
MICHOACÁN DE OCAMPO,16,JUÁREZ,046,EL AGUAJE,2,39,17,22,3
MICHOACÁN DE OCAMPO,16,JUÁREZ,046,EL LLANO,1,4,3,1,1
MICHOACÁN DE OCAMPO,16,JUÁREZ,046,ENANDIO,2,65,44,21,6
MICHOACÁN DE OCAMPO,16,JUÁREZ,046,GUANORO,2,57,29,28,4
MICHOACÁN DE OCAMPO,16,JUÁREZ,046,IRAPEO DE MADERO,2,5,4,1,1
MICHOACÁN DE OCAMPO,16,JUÁREZ,046,LANDERO,2,42,17,25,3
MICHOACÁN DE OCAMPO,16,JUÁREZ,046,LOMA LINDA,2,9,4,5,1
MICHOACÁN DE OCAMPO,16,JUÁREZ,046,OROCUTÍN DE SERDÁN,2,40,28,12,2
MICHOACÁN DE OCAMPO,16,JUÁREZ,046,PARÍCUARO,4,712,367,345,39
MICHOACÁN DE OCAMPO,16,JUÁREZ,046,PUERTO DE LOS LAURELES,1,21,10,11,1
MICHOACÁN DE OCAMPO,16,JUÁREZ,046,PUERTO DE TIMBUSCATÍO (LA ALCANTARILLA),2,38,17,21,3
MICHOACÁN DE OCAMPO,16,JUÁREZ,046,RODEO,2,87,30,57,6
MICHOACÁN DE OCAMPO,16,JUÁREZ,046,SANTA ANA DE GUERRERO (EL CASCABEL),2,206,97,109,11
MICHOACÁN DE OCAMPO,16,JUÁREZ,046,SANTA CRUZ,1,16,7,9,1
MICHOACÁN DE OCAMPO,16,JUÁREZ,046,TIMBUSCATÍO,3,89,41,48,5
MICHOACÁN DE OCAMPO,16,JUÁREZ,046,ZICATA CHICO (ZICATA CHICO DE MORELOS),2,30,17,13,2
MICHOACÁN DE OCAMPO,16,JUÁREZ,046,ZICATA DE MORELOS (ZICATA GRANDE DE MORELOS),3,111,47,64,7
MICHOACÁN DE OCAMPO,16,JUNGAPEO,047,AGUA SALADA,4,250,117,133,16
MICHOACÁN DE OCAMPO,16,JUNGAPEO,047,CERRITO DEL MUERTO,2,167,90,77,9
MICHOACÁN DE OCAMPO,16,JUNGAPEO,047,COLONIA NUEVA,2,68,25,43,4
MICHOACÁN DE OCAMPO,16,JUNGAPEO,047,CÓPORO,2,12,9,3,2
MICHOACÁN DE OCAMPO,16,JUNGAPEO,047,EL ARENAL,2,33,16,17,2
MICHOACÁN DE OCAMPO,16,JUNGAPEO,047,EL BARRO,3,47,32,15,5
MICHOACÁN DE OCAMPO,16,JUNGAPEO,047,EL CARRIZAL,3,66,31,35,4
MICHOACÁN DE OCAMPO,16,JUNGAPEO,047,EL CIRIÁN,1,6,4,2,1
MICHOACÁN DE OCAMPO,16,JUNGAPEO,047,EL ESPINAL,2,20,7,13,2
MICHOACÁN DE OCAMPO,16,JUNGAPEO,047,EL MANGO,2,109,49,60,6
MICHOACÁN DE OCAMPO,16,JUNGAPEO,047,EL PASO,2,27,13,14,2
MICHOACÁN DE OCAMPO,16,JUNGAPEO,047,EL PUERTO DE JUNGAPEO,4,254,138,116,12
MICHOACÁN DE OCAMPO,16,JUNGAPEO,047,EL TAMARINDO,1,5,4,1,1
MICHOACÁN DE OCAMPO,16,JUNGAPEO,047,EL TEPEHUAJE,1,6,5,1,1
MICHOACÁN DE OCAMPO,16,JUNGAPEO,047,HUANGUITÍO,4,312,170,142,14
MICHOACÁN DE OCAMPO,16,JUNGAPEO,047,JUNGAPEO DE JUÁREZ,12,1767,922,845,110
MICHOACÁN DE OCAMPO,16,JUNGAPEO,047,LA FLORIDA,3,154,69,85,9
MICHOACÁN DE OCAMPO,16,JUNGAPEO,047,LA GARITA,4,259,140,119,17
MICHOACÁN DE OCAMPO,16,JUNGAPEO,047,LA LAJA,1,6,4,2,1
MICHOACÁN DE OCAMPO,16,JUNGAPEO,047,LA MESA DEL CAMPO,1,2,0,2,1
MICHOACÁN DE OCAMPO,16,JUNGAPEO,047,LA MORA,3,213,113,100,10
MICHOACÁN DE OCAMPO,16,JUNGAPEO,047,LA SOLEDAD,3,208,103,105,9
MICHOACÁN DE OCAMPO,16,JUNGAPEO,047,LA VEGA,2,10,5,5,2
MICHOACÁN DE OCAMPO,16,JUNGAPEO,047,LA YERBABUENA,2,9,3,6,1
MICHOACÁN DE OCAMPO,16,JUNGAPEO,047,LAS ANONAS,3,105,52,53,7
MICHOACÁN DE OCAMPO,16,JUNGAPEO,047,LAS CANOAS,2,12,8,4,2
MICHOACÁN DE OCAMPO,16,JUNGAPEO,047,LAS CUCHILLAS,2,14,6,8,2
MICHOACÁN DE OCAMPO,16,JUNGAPEO,047,LAS ESCOBAS,2,15,8,7,3
MICHOACÁN DE OCAMPO,16,JUNGAPEO,047,LAS GUÁSIMAS,2,11,5,6,2
MICHOACÁN DE OCAMPO,16,JUNGAPEO,047,LÁZARO CÁRDENAS,4,375,181,194,23
MICHOACÁN DE OCAMPO,16,JUNGAPEO,047,LOS SAUCES,1,10,1,9,1
MICHOACÁN DE OCAMPO,16,JUNGAPEO,047,PIEDRAS DE LUMBRE,2,56,33,23,5
MICHOACÁN DE OCAMPO,16,JUNGAPEO,047,PÚCUARO,2,36,14,22,3
MICHOACÁN DE OCAMPO,16,JUNGAPEO,047,PUEBLO VIEJO,3,43,18,25,3
MICHOACÁN DE OCAMPO,16,JUNGAPEO,047,PUERTO ITZIAPO,3,40,18,22,3
MICHOACÁN DE OCAMPO,16,JUNGAPEO,047,VEINTE DE NOVIEMBRE,2,17,10,7,2
MICHOACÁN DE OCAMPO,16,LAGUNILLAS,048,EL ROMERAL (EL JICOTE),2,50,25,25,4
MICHOACÁN DE OCAMPO,16,LAGUNILLAS,048,FONTEZUELAS,3,159,75,84,11
MICHOACÁN DE OCAMPO,16,LAGUNILLAS,048,HUATZANGIO,3,164,73,91,11
MICHOACÁN DE OCAMPO,16,LAGUNILLAS,048,LA CAJA,2,109,56,53,8
MICHOACÁN DE OCAMPO,16,LAGUNILLAS,048,LA LOMA,1,15,8,7,1
MICHOACÁN DE OCAMPO,16,LAGUNILLAS,048,LAGUNILLAS,5,809,395,414,52
MICHOACÁN DE OCAMPO,16,LAGUNILLAS,048,LAS PILAS,2,45,22,23,3
MICHOACÁN DE OCAMPO,16,LAGUNILLAS,048,OJO DE AGUA DE PASTORES,3,50,19,31,4
MICHOACÁN DE OCAMPO,16,LAGUNILLAS,048,PASTORES,1,23,10,13,2
MICHOACÁN DE OCAMPO,16,MADERO,049,ACATÉN,4,100,46,54,9
MICHOACÁN DE OCAMPO,16,MADERO,049,ARENAL,1,16,10,6,1
MICHOACÁN DE OCAMPO,16,MADERO,049,BALCONES,1,23,9,14,1
MICHOACÁN DE OCAMPO,16,MADERO,049,BUENAVISTA (EL PEDREGAL),1,23,12,11,1
MICHOACÁN DE OCAMPO,16,MADERO,049,CAHUATZIO (CAGUATZIO),3,42,18,24,4
MICHOACÁN DE OCAMPO,16,MADERO,049,CERRO BLANCO (CABUAYANA),3,24,15,9,3
MICHOACÁN DE OCAMPO,16,MADERO,049,CERRO GALLO (PUERTO LA OSAMENTA),3,38,17,21,3
MICHOACÁN DE OCAMPO,16,MADERO,049,CERRO PRIETO,1,4,2,2,1
MICHOACÁN DE OCAMPO,16,MADERO,049,CODALLOS,1,15,9,6,2
MICHOACÁN DE OCAMPO,16,MADERO,049,CORONILLAS,1,6,1,5,1
MICHOACÁN DE OCAMPO,16,MADERO,049,CUINDORA,2,24,16,8,2
MICHOACÁN DE OCAMPO,16,MADERO,049,DERRUMBADERO,1,8,5,3,1
MICHOACÁN DE OCAMPO,16,MADERO,049,EL AHIJADERO,3,74,32,42,5
MICHOACÁN DE OCAMPO,16,MADERO,049,EL AÑIL (MESA EL AÑIL),2,14,8,6,2
MICHOACÁN DE OCAMPO,16,MADERO,049,EL BOSQUE,2,38,13,25,3
MICHOACÁN DE OCAMPO,16,MADERO,049,EL CAJETE,1,7,2,5,1
MICHOACÁN DE OCAMPO,16,MADERO,049,EL CAPULÍN,3,45,23,22,3
MICHOACÁN DE OCAMPO,16,MADERO,049,EL CARACOL,2,35,16,19,4
MICHOACÁN DE OCAMPO,16,MADERO,049,EL CARRIZAL,4,91,46,45,7
MICHOACÁN DE OCAMPO,16,MADERO,049,EL CHILAR,1,4,1,3,1
MICHOACÁN DE OCAMPO,16,MADERO,049,EL EJE,2,22,11,11,2
MICHOACÁN DE OCAMPO,16,MADERO,049,EL GATAL,3,53,28,25,4
MICHOACÁN DE OCAMPO,16,MADERO,049,EL PUENTE DE SAN JOSÉ (EL PUENTE UNO),1,4,4,0,1
MICHOACÁN DE OCAMPO,16,MADERO,049,EL RANCHITO,3,17,8,9,2
MICHOACÁN DE OCAMPO,16,MADERO,049,EL REAL,1,12,8,4,1
MICHOACÁN DE OCAMPO,16,MADERO,049,EL TEJOCOTE,2,12,6,6,2
MICHOACÁN DE OCAMPO,16,MADERO,049,EL TERRANATE,3,112,50,62,7
MICHOACÁN DE OCAMPO,16,MADERO,049,EL TIZATE,1,4,3,1,1
MICHOACÁN DE OCAMPO,16,MADERO,049,EL ZANGARRO,2,60,21,39,4
MICHOACÁN DE OCAMPO,16,MADERO,049,ETÚCUARO,4,354,172,182,22
MICHOACÁN DE OCAMPO,16,MADERO,049,LA CARPINTERÍA,2,34,11,23,3
MICHOACÁN DE OCAMPO,16,MADERO,049,LA CUMBRE,3,81,40,41,6
MICHOACÁN DE OCAMPO,16,MADERO,049,LA MESA DEL SALTO (LA MESA DEL SALTO CHICO),1,12,2,10,1
MICHOACÁN DE OCAMPO,16,MADERO,049,LA SIERRITA,1,8,5,3,1
MICHOACÁN DE OCAMPO,16,MADERO,049,LA SOLEDADITA,3,77,38,39,5
MICHOACÁN DE OCAMPO,16,MADERO,049,LA YERBABUENA,1,18,11,7,1
MICHOACÁN DE OCAMPO,16,MADERO,049,LAGUNA SECA,3,109,48,61,5
MICHOACÁN DE OCAMPO,16,MADERO,049,LAS JUNTAS,1,18,10,8,2
MICHOACÁN DE OCAMPO,16,MADERO,049,LAS PILITAS,2,9,2,7,1
MICHOACÁN DE OCAMPO,16,MADERO,049,LOMA DE CANCHO,2,104,49,55,5
MICHOACÁN DE OCAMPO,16,MADERO,049,LOS AGUACATES,2,18,7,11,2
MICHOACÁN DE OCAMPO,16,MADERO,049,LOS GUAYABOS DOS,1,15,3,12,2
MICHOACÁN DE OCAMPO,16,MADERO,049,LOS NOGALES,1,7,2,5,1
MICHOACÁN DE OCAMPO,16,MADERO,049,LOS PLANES,2,6,2,4,1
MICHOACÁN DE OCAMPO,16,MADERO,049,LOS PLANES DE ETÚCUARO,1,15,7,8,1
MICHOACÁN DE OCAMPO,16,MADERO,049,MILPILLAS,2,18,6,12,2
MICHOACÁN DE OCAMPO,16,MADERO,049,MORENO,3,37,20,17,3
MICHOACÁN DE OCAMPO,16,MADERO,049,PALIZADA,2,46,22,24,4
MICHOACÁN DE OCAMPO,16,MADERO,049,PARRITAS (EL AGUACATE),3,26,14,12,3
MICHOACÁN DE OCAMPO,16,MADERO,049,PEÑA REDONDA,1,7,5,2,1
MICHOACÁN DE OCAMPO,16,MADERO,049,PIUMO,3,50,21,29,4
MICHOACÁN DE OCAMPO,16,MADERO,049,PLATANALILLO,3,40,17,23,3
MICHOACÁN DE OCAMPO,16,MADERO,049,PUENTE CORAZA (EL ENCINO DE LAS CHICAS),2,83,40,43,4
MICHOACÁN DE OCAMPO,16,MADERO,049,PUERTO DEL ZAPOTE,1,7,3,4,1
MICHOACÁN DE OCAMPO,16,MADERO,049,PUNTA DE LA LOMA,1,10,8,2,1
MICHOACÁN DE OCAMPO,16,MADERO,049,RANCHITO,1,4,3,1,1
MICHOACÁN DE OCAMPO,16,MADERO,049,RANCHO DE PORÚAS (LA TARJEA),3,49,22,27,3
MICHOACÁN DE OCAMPO,16,MADERO,049,RANCHO GRANDE,1,16,2,14,1
MICHOACÁN DE OCAMPO,16,MADERO,049,SALTO CHICO,1,10,3,7,1
MICHOACÁN DE OCAMPO,16,MADERO,049,SAN DIEGO CURUCUPATZEO,3,141,67,74,11
MICHOACÁN DE OCAMPO,16,MADERO,049,SAN JOSÉ DE LAS CIDRAS,4,60,25,35,7
MICHOACÁN DE OCAMPO,16,MADERO,049,SAN JUAN,1,9,4,5,1
MICHOACÁN DE OCAMPO,16,MADERO,049,SAN PEDRO PIEDRAS GORDAS,2,34,17,17,2
MICHOACÁN DE OCAMPO,16,MADERO,049,SANTA CATARINA,2,18,4,14,2
MICHOACÁN DE OCAMPO,16,MADERO,049,SANTAS MARÍAS,2,43,19,24,3
MICHOACÁN DE OCAMPO,16,MADERO,049,SINDA,1,11,6,5,1
MICHOACÁN DE OCAMPO,16,MADERO,049,TURIO,1,3,1,2,1
MICHOACÁN DE OCAMPO,16,MADERO,049,UCASIRO,2,12,6,6,2
MICHOACÁN DE OCAMPO,16,MADERO,049,VILLA MADERO,11,2506,1276,1230,114
MICHOACÁN DE OCAMPO,16,MADERO,049,ZIPARAPIO EL BAJO,1,13,7,6,1
MICHOACÁN DE OCAMPO,16,MARAVATÍO,050,AGUA ROSADA,2,32,15,17,2
MICHOACÁN DE OCAMPO,16,MARAVATÍO,050,APEO,3,658,326,332,37
MICHOACÁN DE OCAMPO,16,MARAVATÍO,050,BARRIO DE SAN MIGUEL,2,35,19,16,3
MICHOACÁN DE OCAMPO,16,MARAVATÍO,050,CAMPO HERMOSO,3,205,101,104,14
MICHOACÁN DE OCAMPO,16,MARAVATÍO,050,CASA BLANCA,2,202,93,109,9
MICHOACÁN DE OCAMPO,16,MARAVATÍO,050,CEBADILLAS,2,44,23,21,2
MICHOACÁN DE OCAMPO,16,MARAVATÍO,050,CEBADILLAS CORRAL FALSO,4,79,50,29,8
MICHOACÁN DE OCAMPO,16,MARAVATÍO,050,CEBADILLAS SEGUNDAS,3,131,74,57,9
MICHOACÁN DE OCAMPO,16,MARAVATÍO,050,CERRO AZUL,3,23,12,11,3
MICHOACÁN DE OCAMPO,16,MARAVATÍO,050,CLISERIO VILLAFUERTE EL CHICO,2,53,23,30,4
MICHOACÁN DE OCAMPO,16,MARAVATÍO,050,CLISERIO VILLAFUERTE EL GRANDE,2,28,15,13,2
MICHOACÁN DE OCAMPO,16,MARAVATÍO,050,COLONIA GENERAL FELIPE ÁNGELES,2,9,6,3,2
MICHOACÁN DE OCAMPO,16,MARAVATÍO,050,COLONIA GUADALUPE,1,40,18,22,3
MICHOACÁN DE OCAMPO,16,MARAVATÍO,050,CUARTEL QUINTO,3,462,228,234,23
MICHOACÁN DE OCAMPO,16,MARAVATÍO,050,EJIDO DE POMAS (POBLADO DE DOLORES),1,43,23,20,3
MICHOACÁN DE OCAMPO,16,MARAVATÍO,050,EJIDO JESÚS DEL MONTE,1,10,7,3,1
MICHOACÁN DE OCAMPO,16,MARAVATÍO,050,EL AGUAJE (CUARTEL AGUAJE),2,16,7,9,2
MICHOACÁN DE OCAMPO,16,MARAVATÍO,050,EL BOTÍN,2,3,1,2,1
MICHOACÁN DE OCAMPO,16,MARAVATÍO,050,EL CHUPADERO (SAN MIGUEL CHUPADERO),3,112,58,54,6
MICHOACÁN DE OCAMPO,16,MARAVATÍO,050,EL COLORADO,3,82,36,46,5
MICHOACÁN DE OCAMPO,16,MARAVATÍO,050,EL GIGANTE,3,157,76,81,11
MICHOACÁN DE OCAMPO,16,MARAVATÍO,050,EL GIGANTITO,1,4,3,1,1
MICHOACÁN DE OCAMPO,16,MARAVATÍO,050,EL JAGÜEY,2,25,12,13,2
MICHOACÁN DE OCAMPO,16,MARAVATÍO,050,EL MORAL,2,34,15,19,3
MICHOACÁN DE OCAMPO,16,MARAVATÍO,050,EL PEDREGAL,3,32,18,14,3
MICHOACÁN DE OCAMPO,16,MARAVATÍO,050,EL PUERTO,1,5,3,2,1
MICHOACÁN DE OCAMPO,16,MARAVATÍO,050,EL SAUCILLO PRIMERO,2,82,44,38,5
MICHOACÁN DE OCAMPO,16,MARAVATÍO,050,EL TEJERO,2,93,45,48,8
MICHOACÁN DE OCAMPO,16,MARAVATÍO,050,EL TEJOCOTE,2,52,24,28,4
MICHOACÁN DE OCAMPO,16,MARAVATÍO,050,ENCINILLAS,2,55,30,25,4
MICHOACÁN DE OCAMPO,16,MARAVATÍO,050,ESTANCIA DE PAQUISIHUATO,2,24,8,16,2
MICHOACÁN DE OCAMPO,16,MARAVATÍO,050,ESTANCIA DE SANTA ELENA,2,33,17,16,3
MICHOACÁN DE OCAMPO,16,MARAVATÍO,050,EX-HACIENDA DE GUAPAMACÁTARO,1,4,3,1,1
MICHOACÁN DE OCAMPO,16,MARAVATÍO,050,EX-HACIENDA SANTA ELENA,2,80,36,44,4
MICHOACÁN DE OCAMPO,16,MARAVATÍO,050,GUAPAMACÁTARO,6,153,74,79,9
MICHOACÁN DE OCAMPO,16,MARAVATÍO,050,HUAJUMBARITO,2,67,36,31,5
MICHOACÁN DE OCAMPO,16,MARAVATÍO,050,HUANIMORO,2,47,22,25,3
MICHOACÁN DE OCAMPO,16,MARAVATÍO,050,HUARAQUEO,3,100,52,48,7
MICHOACÁN DE OCAMPO,16,MARAVATÍO,050,JESÚS DEL MONTE,1,34,16,18,2
MICHOACÁN DE OCAMPO,16,MARAVATÍO,050,JOYAS DEL PILAR,2,7,4,3,1
MICHOACÁN DE OCAMPO,16,MARAVATÍO,050,LA COYOTA,2,78,46,32,5
MICHOACÁN DE OCAMPO,16,MARAVATÍO,050,LA GRANJA,2,68,29,39,3
MICHOACÁN DE OCAMPO,16,MARAVATÍO,050,LA HUERTA,3,163,74,89,10
MICHOACÁN DE OCAMPO,16,MARAVATÍO,050,LA LAJA,5,77,50,27,8
MICHOACÁN DE OCAMPO,16,MARAVATÍO,050,LA MESA CHIQUITA (LAS MESITAS),2,8,5,3,1
MICHOACÁN DE OCAMPO,16,MARAVATÍO,050,LA NOPALERA,2,30,17,13,4
MICHOACÁN DE OCAMPO,16,MARAVATÍO,050,LAGUNA SECA [EJIDO POZO DE TRES PIEDRAS],2,48,24,24,3
MICHOACÁN DE OCAMPO,16,MARAVATÍO,050,LAGUNILLAS,1,6,3,3,1
MICHOACÁN DE OCAMPO,16,MARAVATÍO,050,LAS JOYAS,2,22,11,11,3
MICHOACÁN DE OCAMPO,16,MARAVATÍO,050,LAS MESAS,1,5,4,1,1
MICHOACÁN DE OCAMPO,16,MARAVATÍO,050,LAS PALOMAS,4,224,130,94,17
MICHOACÁN DE OCAMPO,16,MARAVATÍO,050,LAS POMAS [CONGREGACIÓN],4,110,54,56,9
MICHOACÁN DE OCAMPO,16,MARAVATÍO,050,LLANO GRANDE,3,179,92,87,14
MICHOACÁN DE OCAMPO,16,MARAVATÍO,050,LOMA DE LA ROSA (TORRE DEL JARAL),3,191,105,86,11
MICHOACÁN DE OCAMPO,16,MARAVATÍO,050,LOMA DE SAN MIGUEL,2,286,156,130,14
MICHOACÁN DE OCAMPO,16,MARAVATÍO,050,LOMA DEL GALLO,2,74,40,34,5
MICHOACÁN DE OCAMPO,16,MARAVATÍO,050,LOS BANCOS,2,12,5,7,1
MICHOACÁN DE OCAMPO,16,MARAVATÍO,050,LOS OCOTES [EJIDO LOS OCOTES],2,13,8,5,2
MICHOACÁN DE OCAMPO,16,MARAVATÍO,050,LOS OLIVOS,2,8,4,4,1
MICHOACÁN DE OCAMPO,16,MARAVATÍO,050,MARAVATÍO DE OCAMPO,69,11348,6099,5249,695
MICHOACÁN DE OCAMPO,16,MARAVATÍO,050,MELCHOR OCAMPO,2,59,32,27,5
MICHOACÁN DE OCAMPO,16,MARAVATÍO,050,MESA DEL LEÓN,3,34,21,13,3
MICHOACÁN DE OCAMPO,16,MARAVATÍO,050,MINA DE SAN VIDAL,1,20,9,11,1
MICHOACÁN DE OCAMPO,16,MARAVATÍO,050,PALOMAS (LA PRESITA),1,9,5,4,1
MICHOACÁN DE OCAMPO,16,MARAVATÍO,050,PEÑA BLANCA,2,20,10,10,2
MICHOACÁN DE OCAMPO,16,MARAVATÍO,050,PEÑA BLANCA PEQUEÑA PROPIEDAD,3,25,10,15,2
MICHOACÁN DE OCAMPO,16,MARAVATÍO,050,POMOCA,2,93,44,49,5
MICHOACÁN DE OCAMPO,16,MARAVATÍO,050,POMOQUITA,2,145,70,75,9
MICHOACÁN DE OCAMPO,16,MARAVATÍO,050,PUEBLO NUEVO,2,52,28,24,3
MICHOACÁN DE OCAMPO,16,MARAVATÍO,050,RINCÓN DE HUARAQUEO,2,25,14,11,2
MICHOACÁN DE OCAMPO,16,MARAVATÍO,050,SAN ISIDRITO,2,4,2,2,1
MICHOACÁN DE OCAMPO,16,MARAVATÍO,050,SAN ISIDRO,2,103,53,50,4
MICHOACÁN DE OCAMPO,16,MARAVATÍO,050,SAN JOSÉ DEL RODEO,3,117,60,57,7
MICHOACÁN DE OCAMPO,16,MARAVATÍO,050,SAN JUAN BUENAVISTA,2,47,25,22,3
MICHOACÁN DE OCAMPO,16,MARAVATÍO,050,SAN LORENZO,2,23,7,16,2
MICHOACÁN DE OCAMPO,16,MARAVATÍO,050,SAN MIGUEL CURINHUATO,7,804,392,412,33
MICHOACÁN DE OCAMPO,16,MARAVATÍO,050,SAN MIGUEL EL ALTO (EL PUERTO),6,317,150,167,22
MICHOACÁN DE OCAMPO,16,MARAVATÍO,050,SAN NICOLASITO,3,100,49,51,8
MICHOACÁN DE OCAMPO,16,MARAVATÍO,050,SAN RAMÓN,4,472,241,231,17
MICHOACÁN DE OCAMPO,16,MARAVATÍO,050,SAN VICENTE EL GRANDE (SAN VICENTE),3,163,72,91,11
MICHOACÁN DE OCAMPO,16,MARAVATÍO,050,SANDI,2,25,15,10,2
MICHOACÁN DE OCAMPO,16,MARAVATÍO,050,SANTA ANA (CUARTEL SEGUNDO),3,116,59,57,10
MICHOACÁN DE OCAMPO,16,MARAVATÍO,050,SANTA CRUZ,2,20,8,12,3
MICHOACÁN DE OCAMPO,16,MARAVATÍO,050,SANTA CRUZ (RANCHO VIEJO),2,5,0,5,1
MICHOACÁN DE OCAMPO,16,MARAVATÍO,050,SANTA ELENA,3,395,188,207,21
MICHOACÁN DE OCAMPO,16,MARAVATÍO,050,SANTA MÓNICA,2,65,39,26,4
MICHOACÁN DE OCAMPO,16,MARAVATÍO,050,SANTA ROSA,2,80,34,46,4
MICHOACÁN DE OCAMPO,16,MARAVATÍO,050,SANTIAGO PURIATZÍCUARO,7,945,446,499,39
MICHOACÁN DE OCAMPO,16,MARAVATÍO,050,TECARIO JESÚS DEL MONTE,2,44,21,23,3
MICHOACÁN DE OCAMPO,16,MARAVATÍO,050,TENERÍAS,2,59,27,32,5
MICHOACÁN DE OCAMPO,16,MARAVATÍO,050,TOLUQUILLA,2,28,10,18,3
MICHOACÁN DE OCAMPO,16,MARAVATÍO,050,TORRE BLANCA (GUAPAMACÁTARO),1,14,6,8,2
MICHOACÁN DE OCAMPO,16,MARAVATÍO,050,TUNGAREO,10,2295,1220,1075,98
MICHOACÁN DE OCAMPO,16,MARAVATÍO,050,TZIRITZÍCUARO (NATIVITAS),6,548,289,259,26
MICHOACÁN DE OCAMPO,16,MARAVATÍO,050,URIPITIO,6,714,324,390,31
MICHOACÁN DE OCAMPO,16,MARAVATÍO,050,YURÉCUARO (SAN JUAN YURÉCUARO),5,269,158,111,12
MICHOACÁN DE OCAMPO,16,MARCOS CASTELLANOS,051,EL ESPINO,1,4,1,3,1
MICHOACÁN DE OCAMPO,16,MARCOS CASTELLANOS,051,EL JARRERO,1,35,16,19,2
MICHOACÁN DE OCAMPO,16,MARCOS CASTELLANOS,051,EL SABINO,3,140,58,82,10
MICHOACÁN DE OCAMPO,16,MARCOS CASTELLANOS,051,LA ARENA,3,28,16,12,4
MICHOACÁN DE OCAMPO,16,MARCOS CASTELLANOS,051,LA ESTANCIA DEL MONTE (CHINA),3,41,24,17,4
MICHOACÁN DE OCAMPO,16,MARCOS CASTELLANOS,051,LA ROSA,2,35,18,17,2
MICHOACÁN DE OCAMPO,16,MARCOS CASTELLANOS,051,LOS COJOS,1,4,4,0,1
MICHOACÁN DE OCAMPO,16,MARCOS CASTELLANOS,051,OJO DE RANA,4,314,164,150,16
MICHOACÁN DE OCAMPO,16,MARCOS CASTELLANOS,051,SAN JOSÉ DE GRACIA,13,2347,1204,1143,102
MICHOACÁN DE OCAMPO,16,MARCOS CASTELLANOS,051,SAN MIGUEL,2,23,7,16,2
MICHOACÁN DE OCAMPO,16,LÁZARO CÁRDENAS,052,ACALPICAN DE MORELOS,4,369,182,187,26
MICHOACÁN DE OCAMPO,16,LÁZARO CÁRDENAS,052,BAHÍA BUFADERO (CALETA DE CAMPOS),6,816,416,400,43
MICHOACÁN DE OCAMPO,16,LÁZARO CÁRDENAS,052,BORDONAL,3,135,55,80,12
MICHOACÁN DE OCAMPO,16,LÁZARO CÁRDENAS,052,BRISAMAR,1,68,30,38,6
MICHOACÁN DE OCAMPO,16,LÁZARO CÁRDENAS,052,BRUNO CUEVAS,1,60,28,32,3
MICHOACÁN DE OCAMPO,16,LÁZARO CÁRDENAS,052,BUENOS AIRES,10,1726,865,861,101
MICHOACÁN DE OCAMPO,16,LÁZARO CÁRDENAS,052,CAMICHINES,1,12,10,2,1
MICHOACÁN DE OCAMPO,16,LÁZARO CÁRDENAS,052,CHUCUTITÁN,4,423,219,204,25
MICHOACÁN DE OCAMPO,16,LÁZARO CÁRDENAS,052,CHUQUIAPAN,4,90,37,53,12
MICHOACÁN DE OCAMPO,16,LÁZARO CÁRDENAS,052,CHUTA,1,21,11,10,2
MICHOACÁN DE OCAMPO,16,LÁZARO CÁRDENAS,052,CIUDAD LÁZARO CÁRDENAS,156,28605,14281,14324,2060
MICHOACÁN DE OCAMPO,16,LÁZARO CÁRDENAS,052,EL AHIJADERO,1,114,57,57,6
MICHOACÁN DE OCAMPO,16,LÁZARO CÁRDENAS,052,EL ARENAL,1,5,2,3,1
MICHOACÁN DE OCAMPO,16,LÁZARO CÁRDENAS,052,EL BORDÓN DE POPOYUTA (LOS BORDONES),1,7,4,3,1
MICHOACÁN DE OCAMPO,16,LÁZARO CÁRDENAS,052,EL COLOMO (SAN MIGUEL),2,38,15,23,3
MICHOACÁN DE OCAMPO,16,LÁZARO CÁRDENAS,052,EL GUAYABO SUR,1,5,3,2,1
MICHOACÁN DE OCAMPO,16,LÁZARO CÁRDENAS,052,EL HABILLAL,5,422,199,223,27
MICHOACÁN DE OCAMPO,16,LÁZARO CÁRDENAS,052,EL MIRADOR,1,105,40,65,6
MICHOACÁN DE OCAMPO,16,LÁZARO CÁRDENAS,052,EL NARANJITO,2,9,7,2,1
MICHOACÁN DE OCAMPO,16,LÁZARO CÁRDENAS,052,EL REYNO,2,35,22,13,3
MICHOACÁN DE OCAMPO,16,LÁZARO CÁRDENAS,052,EL TAHUAZAL,4,162,78,84,12
MICHOACÁN DE OCAMPO,16,LÁZARO CÁRDENAS,052,LA MANZANILLA UNO,1,21,12,9,2
MICHOACÁN DE OCAMPO,16,LÁZARO CÁRDENAS,052,LA MIRA,21,2780,1349,1431,190
MICHOACÁN DE OCAMPO,16,LÁZARO CÁRDENAS,052,LA ORILLA,11,1893,926,967,127
MICHOACÁN DE OCAMPO,16,LÁZARO CÁRDENAS,052,LA PALMITA,1,66,25,41,6
MICHOACÁN DE OCAMPO,16,LÁZARO CÁRDENAS,052,LA SOLEDAD,1,10,6,4,1
MICHOACÁN DE OCAMPO,16,LÁZARO CÁRDENAS,052,LA VILLITA,3,411,190,221,22
MICHOACÁN DE OCAMPO,16,LÁZARO CÁRDENAS,052,LAS CALABACILLAS,1,10,7,3,1
MICHOACÁN DE OCAMPO,16,LÁZARO CÁRDENAS,052,LAS CALABAZAS,1,8,6,2,2
MICHOACÁN DE OCAMPO,16,LÁZARO CÁRDENAS,052,LAS GUACAMAYAS,77,12689,6504,6185,790
MICHOACÁN DE OCAMPO,16,LÁZARO CÁRDENAS,052,LAS HIGUERAS,1,8,3,5,2
MICHOACÁN DE OCAMPO,16,LÁZARO CÁRDENAS,052,LAS MESAS DEL LIMÓN,1,46,25,21,4
MICHOACÁN DE OCAMPO,16,LÁZARO CÁRDENAS,052,LAS PEÑAS,2,27,17,10,3
MICHOACÁN DE OCAMPO,16,LÁZARO CÁRDENAS,052,LOS AMATES,3,52,21,31,7
MICHOACÁN DE OCAMPO,16,LÁZARO CÁRDENAS,052,LOS COYOTES,4,283,131,152,20
MICHOACÁN DE OCAMPO,16,LÁZARO CÁRDENAS,052,LOS LLANOS DEL BEJUCO,3,57,27,30,10
MICHOACÁN DE OCAMPO,16,LÁZARO CÁRDENAS,052,MEXCALHUACÁN,3,158,61,97,10
MICHOACÁN DE OCAMPO,16,LÁZARO CÁRDENAS,052,MOVIMIENTO URBANO POPULAR [COLONIA],1,15,5,10,2
MICHOACÁN DE OCAMPO,16,LÁZARO CÁRDENAS,052,NEXPA (NEIXPA),3,66,31,35,7
MICHOACÁN DE OCAMPO,16,LÁZARO CÁRDENAS,052,PLAYA AZUL,6,637,306,331,44
MICHOACÁN DE OCAMPO,16,LÁZARO CÁRDENAS,052,PLAYA DE GUERRA,1,33,13,20,3
MICHOACÁN DE OCAMPO,16,LÁZARO CÁRDENAS,052,POPOYUTA,1,10,4,6,1
MICHOACÁN DE OCAMPO,16,LÁZARO CÁRDENAS,052,PUENTE DE LA VÍA,2,163,86,77,12
MICHOACÁN DE OCAMPO,16,LÁZARO CÁRDENAS,052,PUERTO NUEVO,1,106,56,50,6
MICHOACÁN DE OCAMPO,16,LÁZARO CÁRDENAS,052,RANCHO PANAMÁ,2,11,6,5,2
MICHOACÁN DE OCAMPO,16,LÁZARO CÁRDENAS,052,SAN BLAS,1,246,108,138,14
MICHOACÁN DE OCAMPO,16,LÁZARO CÁRDENAS,052,SAN JUAN BOSCO,3,162,75,87,13
MICHOACÁN DE OCAMPO,16,LÁZARO CÁRDENAS,052,SAN RAFAEL,4,145,84,61,17
MICHOACÁN DE OCAMPO,16,LÁZARO CÁRDENAS,052,SOLERA DE AGUA,2,65,29,36,6
MICHOACÁN DE OCAMPO,16,LÁZARO CÁRDENAS,052,TEOLÁN,3,40,21,19,5
MICHOACÁN DE OCAMPO,16,MORELIA,053,ARACURIO,3,343,173,170,19
MICHOACÁN DE OCAMPO,16,MORELIA,053,ARROYO COLORADO,3,134,54,80,9
MICHOACÁN DE OCAMPO,16,MORELIA,053,ASIENTO DE PIEDRA (EL CHIRIHUINDO),2,67,39,28,4
MICHOACÁN DE OCAMPO,16,MORELIA,053,ATAPANEO,3,925,449,476,48
MICHOACÁN DE OCAMPO,16,MORELIA,053,ATÉCUARO,4,344,176,168,16
MICHOACÁN DE OCAMPO,16,MORELIA,053,BUENAVISTA,8,135,65,70,12
MICHOACÁN DE OCAMPO,16,MORELIA,053,CAPULA,7,1509,771,738,74
MICHOACÁN DE OCAMPO,16,MORELIA,053,CERRITOS,3,322,138,184,14
MICHOACÁN DE OCAMPO,16,MORELIA,053,CHIHUERIO,3,132,63,69,11
MICHOACÁN DE OCAMPO,16,MORELIA,053,CHIQUIMITÍO,4,449,253,196,28
MICHOACÁN DE OCAMPO,16,MORELIA,053,COÍNTZIO,3,158,75,83,11
MICHOACÁN DE OCAMPO,16,MORELIA,053,COLONIA SAN JAVIER XANAMORO,1,98,47,51,6
MICHOACÁN DE OCAMPO,16,MORELIA,053,CORO GRANDE,3,131,71,60,11
MICHOACÁN DE OCAMPO,16,MORELIA,053,COTZURIO,4,348,186,162,24
MICHOACÁN DE OCAMPO,16,MORELIA,053,CUANAJILLO DEL TORO,1,9,5,4,1
MICHOACÁN DE OCAMPO,16,MORELIA,053,CUANAJILLO GRANDE,3,123,70,53,8
MICHOACÁN DE OCAMPO,16,MORELIA,053,CUTO DE LA ESPERANZA,4,409,210,199,19
MICHOACÁN DE OCAMPO,16,MORELIA,053,EL AGUA ESCONDIDA,3,21,11,10,3
MICHOACÁN DE OCAMPO,16,MORELIA,053,EL BAÑITO,1,6,2,4,1
MICHOACÁN DE OCAMPO,16,MORELIA,053,EL CARRETERO,1,65,32,33,5
MICHOACÁN DE OCAMPO,16,MORELIA,053,EL CERRITO ITZÍCUARO,3,236,116,120,14
MICHOACÁN DE OCAMPO,16,MORELIA,053,EL CORREO,2,123,62,61,8
MICHOACÁN DE OCAMPO,16,MORELIA,053,EL DURAZNO,4,409,195,214,27
MICHOACÁN DE OCAMPO,16,MORELIA,053,EL ESCOBAL,3,100,45,55,6
MICHOACÁN DE OCAMPO,16,MORELIA,053,EL LAURELITO (LA IZAMA),2,21,7,14,2
MICHOACÁN DE OCAMPO,16,MORELIA,053,EL PORVENIR (RANCHO DE JESÚS),3,71,34,37,7
MICHOACÁN DE OCAMPO,16,MORELIA,053,EL REPARO,2,101,51,50,7
MICHOACÁN DE OCAMPO,16,MORELIA,053,EL RESUMIDERO,3,80,32,48,10
MICHOACÁN DE OCAMPO,16,MORELIA,053,EL TARAY,2,43,23,20,4
MICHOACÁN DE OCAMPO,16,MORELIA,053,EMILIANO ZAPATA,2,358,196,162,17
MICHOACÁN DE OCAMPO,16,MORELIA,053,ESTACIÓN JÁCUARO (COLONIA LA REUNIÓN),2,200,90,110,8
MICHOACÁN DE OCAMPO,16,MORELIA,053,FRANCISCO J. MÚGICA,1,15,7,8,1
MICHOACÁN DE OCAMPO,16,MORELIA,053,GAVIOTAS DE QUINCEO,1,64,24,40,4
MICHOACÁN DE OCAMPO,16,MORELIA,053,HERMENEGILDO GALEANA,2,29,17,12,2
MICHOACÁN DE OCAMPO,16,MORELIA,053,HOJAS ANCHAS,1,20,8,12,2
MICHOACÁN DE OCAMPO,16,MORELIA,053,HUERTITAS,1,13,6,7,3
MICHOACÁN DE OCAMPO,16,MORELIA,053,ICHAQUEO,2,59,19,40,3
MICHOACÁN DE OCAMPO,16,MORELIA,053,IRATZIO,3,196,92,104,13
MICHOACÁN DE OCAMPO,16,MORELIA,053,ISAAC ARRIAGA (NORIEGA),2,42,26,16,2
MICHOACÁN DE OCAMPO,16,MORELIA,053,JERÉCUARO,2,48,25,23,4
MICHOACÁN DE OCAMPO,16,MORELIA,053,JESÚS DEL MONTE (LA CAPILLA),7,1919,985,934,131
MICHOACÁN DE OCAMPO,16,MORELIA,053,JOYA DE BUENAVISTA,2,47,20,27,3
MICHOACÁN DE OCAMPO,16,MORELIA,053,JOYA DE LA HUERTA,3,107,70,37,9
MICHOACÁN DE OCAMPO,16,MORELIA,053,JOYITAS,3,134,70,64,10
MICHOACÁN DE OCAMPO,16,MORELIA,053,LA ALBERCA,2,42,16,26,3
MICHOACÁN DE OCAMPO,16,MORELIA,053,LA CARBONERA,2,36,14,22,3
MICHOACÁN DE OCAMPO,16,MORELIA,053,LA CIÉNEGA (TORRECILLAS DE ATÉCUARO),2,17,7,10,3
MICHOACÁN DE OCAMPO,16,MORELIA,053,LA CIENEGUITA (LA CIÉNEGA),3,40,17,23,4
MICHOACÁN DE OCAMPO,16,MORELIA,053,LA COFRADÍA,2,19,9,10,3
MICHOACÁN DE OCAMPO,16,MORELIA,053,LA CONCEPCIÓN,3,135,61,74,11
MICHOACÁN DE OCAMPO,16,MORELIA,053,LA ESTANCIA,3,232,115,117,12
MICHOACÁN DE OCAMPO,16,MORELIA,053,LA MAIZA,1,17,9,8,1
MICHOACÁN DE OCAMPO,16,MORELIA,053,LA MINTZITA,6,447,213,234,30
MICHOACÁN DE OCAMPO,16,MORELIA,053,LA PALMA,4,606,289,317,31
MICHOACÁN DE OCAMPO,16,MORELIA,053,LA PALMITA (LA TRAMPA),1,6,1,5,1
MICHOACÁN DE OCAMPO,16,MORELIA,053,LA PRESA (LA PRESA DE CHIQUIMITÍO),3,52,21,31,5
MICHOACÁN DE OCAMPO,16,MORELIA,053,LA TUNA MANZA,3,63,32,31,4
MICHOACÁN DE OCAMPO,16,MORELIA,053,LA YERBABUENA,2,27,15,12,3
MICHOACÁN DE OCAMPO,16,MORELIA,053,LAS CRUCES,2,13,7,6,2
MICHOACÁN DE OCAMPO,16,MORELIA,053,LAS FLORES,3,70,32,38,5
MICHOACÁN DE OCAMPO,16,MORELIA,053,LAS PALOMAS,2,22,7,15,3
MICHOACÁN DE OCAMPO,16,MORELIA,053,LAS TROJES,1,15,6,9,1
MICHOACÁN DE OCAMPO,16,MORELIA,053,LOMA CALIENTE,2,52,23,29,3
MICHOACÁN DE OCAMPO,16,MORELIA,053,LOS CUERVOS,1,3,1,2,1
MICHOACÁN DE OCAMPO,16,MORELIA,053,LOS PIRULES,1,97,45,52,6
MICHOACÁN DE OCAMPO,16,MORELIA,053,MORELIA,1135,240126,124976,115150,19374
MICHOACÁN DE OCAMPO,16,MORELIA,053,MORELOS,11,1720,853,867,105
MICHOACÁN DE OCAMPO,16,MORELIA,053,NIEVES,4,174,86,88,17
MICHOACÁN DE OCAMPO,16,MORELIA,053,NUEVA FLORIDA,2,99,54,45,7
MICHOACÁN DE OCAMPO,16,MORELIA,053,PARRITAS,2,9,5,4,1
MICHOACÁN DE OCAMPO,16,MORELIA,053,POTRERILLOS,3,74,40,34,6
MICHOACÁN DE OCAMPO,16,MORELIA,053,PUERTO DE BUENAVISTA (LÁZARO CÁRDENAS),5,520,252,268,28
MICHOACÁN DE OCAMPO,16,MORELIA,053,PUERTO DEL MADROÑO,2,33,17,16,4
MICHOACÁN DE OCAMPO,16,MORELIA,053,RÍO BELLO (EL CAMPAMENTO),2,78,35,43,5
MICHOACÁN DE OCAMPO,16,MORELIA,053,SAN ANTONIO,3,662,320,342,33
MICHOACÁN DE OCAMPO,16,MORELIA,053,SAN ANTONIO CARUPO,3,53,33,20,6
MICHOACÁN DE OCAMPO,16,MORELIA,053,SAN ANTONIO COAPA,3,103,52,51,6
MICHOACÁN DE OCAMPO,16,MORELIA,053,SAN ANTONIO PARANGARE,2,74,35,39,5
MICHOACÁN DE OCAMPO,16,MORELIA,053,SAN BERNABÉ,2,38,20,18,3
MICHOACÁN DE OCAMPO,16,MORELIA,053,SAN CARLOS COAPA,2,26,11,15,2
MICHOACÁN DE OCAMPO,16,MORELIA,053,SAN ISIDRO ITZÍCUARO,4,553,265,288,27
MICHOACÁN DE OCAMPO,16,MORELIA,053,SAN JOSÉ COAPA,3,166,94,72,12
MICHOACÁN DE OCAMPO,16,MORELIA,053,SAN JOSÉ DE LAS TORRES,3,297,159,138,12
MICHOACÁN DE OCAMPO,16,MORELIA,053,SAN JOSÉ ITZÍCUARO (RANCHO NUEVO),7,1478,718,760,71
MICHOACÁN DE OCAMPO,16,MORELIA,053,SAN JUANITO ITZÍCUARO,6,630,301,329,42
MICHOACÁN DE OCAMPO,16,MORELIA,053,SAN MIGUEL COAPA,2,34,17,17,2
MICHOACÁN DE OCAMPO,16,MORELIA,053,SAN MIGUEL DEL MONTE,4,325,168,157,19
MICHOACÁN DE OCAMPO,16,MORELIA,053,SAN NICOLÁS OBISPO,6,1002,501,501,50
MICHOACÁN DE OCAMPO,16,MORELIA,053,SAN RAFAEL COAPA,3,211,101,110,13
MICHOACÁN DE OCAMPO,16,MORELIA,053,SANTA ROSALÍA,2,51,22,29,3
MICHOACÁN DE OCAMPO,16,MORELIA,053,SANTIAGO UNDAMEO,4,639,334,305,32
MICHOACÁN DE OCAMPO,16,MORELIA,053,TACÍCUARO,3,303,149,154,17
MICHOACÁN DE OCAMPO,16,MORELIA,053,TAREHUICHO,1,8,6,2,2
MICHOACÁN DE OCAMPO,16,MORELIA,053,TEREMENDO DE LOS REYES,4,482,225,257,26
MICHOACÁN DE OCAMPO,16,MORELIA,053,TEREMENDO JASSO,2,143,86,57,6
MICHOACÁN DE OCAMPO,16,MORELIA,053,TIRIO,3,113,53,60,11
MICHOACÁN DE OCAMPO,16,MORELIA,053,TIRIPETÍO,4,1024,241,783,63
MICHOACÁN DE OCAMPO,16,MORELIA,053,TIRISTARÁN,1,15,7,8,1
MICHOACÁN DE OCAMPO,16,MORELIA,053,TORRECILLAS (LA TORRECILLA),3,40,24,16,4
MICHOACÁN DE OCAMPO,16,MORELIA,053,TUMBISCA,4,163,84,79,8
MICHOACÁN DE OCAMPO,16,MORELIA,053,TZINTZIMACATO CHICO,2,65,33,32,4
MICHOACÁN DE OCAMPO,16,MORELIA,053,TZINTZIMACATO GRANDE,3,119,61,58,7
MICHOACÁN DE OCAMPO,16,MORELIA,053,UMÉCUARO,3,99,55,44,7
MICHOACÁN DE OCAMPO,16,MORELIA,053,URUAPILLA,3,227,127,100,12
MICHOACÁN DE OCAMPO,16,MORELIA,053,ZAJO CHICO,1,10,4,6,1
MICHOACÁN DE OCAMPO,16,MORELIA,053,ZAJO GRANDE,3,65,27,38,4
MICHOACÁN DE OCAMPO,16,MORELIA,053,ZIMPANIO SUR,1,7,2,5,1
MICHOACÁN DE OCAMPO,16,MORELOS,054,COLONIA EL GRANJENO (SAN JUAN DE ULÚA),1,4,2,2,1
MICHOACÁN DE OCAMPO,16,MORELOS,054,EL DESMONTE,2,34,20,14,3
MICHOACÁN DE OCAMPO,16,MORELOS,054,EL FRESNO,2,28,15,13,3
MICHOACÁN DE OCAMPO,16,MORELOS,054,EL GRANJENO,1,53,18,35,1
MICHOACÁN DE OCAMPO,16,MORELOS,054,EL PROGRESO MORELOS (LA ESTANCIA),2,10,3,7,2
MICHOACÁN DE OCAMPO,16,MORELOS,054,JURUREMBA,2,32,18,14,3
MICHOACÁN DE OCAMPO,16,MORELOS,054,LA CRUZ DEL NIÑO,2,29,16,13,3
MICHOACÁN DE OCAMPO,16,MORELOS,054,LA LUZ,4,144,76,68,15
MICHOACÁN DE OCAMPO,16,MORELOS,054,LA NORIA,1,10,7,3,1
MICHOACÁN DE OCAMPO,16,MORELOS,054,LA PALMA,2,26,14,12,2
MICHOACÁN DE OCAMPO,16,MORELOS,054,LA PUERTA DEL DESMONTE,2,28,19,9,3
MICHOACÁN DE OCAMPO,16,MORELOS,054,LA SALUD,2,27,14,13,3
MICHOACÁN DE OCAMPO,16,MORELOS,054,LA VIGA,3,31,18,13,5
MICHOACÁN DE OCAMPO,16,MORELOS,054,RANCHO DE GUADALUPE,2,21,7,14,2
MICHOACÁN DE OCAMPO,16,MORELOS,054,SAN ÁNGEL,3,49,28,21,7
MICHOACÁN DE OCAMPO,16,MORELOS,054,SAN ISIDRO (SAN ISIDRO DE LA VUELTA),2,21,14,7,2
MICHOACÁN DE OCAMPO,16,MORELOS,054,SAN JOSÉ DEL NARANJO (PUERTA DE HUANGO VIEJO),1,8,2,6,1
MICHOACÁN DE OCAMPO,16,MORELOS,054,SAN MIGUEL (HUANGO EL VIEJO),3,29,10,19,4
MICHOACÁN DE OCAMPO,16,MORELOS,054,SAN MIGUEL TUMBASTATIRO,2,16,7,9,2
MICHOACÁN DE OCAMPO,16,MORELOS,054,SAN NICOLÁS TUMBASTATIRO (CAÑADA DE ABAJO),3,117,54,63,10
MICHOACÁN DE OCAMPO,16,MORELOS,054,SAN RAFAEL (RANCHO VIEJO),2,12,8,4,2
MICHOACÁN DE OCAMPO,16,MORELOS,054,SAN VICENTE (LA CRUZ DE SAN VICENTE),1,23,10,13,3
MICHOACÁN DE OCAMPO,16,MORELOS,054,VILLA MORELOS,7,731,377,354,46
MICHOACÁN DE OCAMPO,16,MORELOS,054,ZÁRATE,3,61,24,37,8
MICHOACÁN DE OCAMPO,16,MORELOS,054,ZIRACUARÉNDIRO,2,21,11,10,2
MICHOACÁN DE OCAMPO,16,MÚGICA,055,COLONIA 17 DE NOVIEMBRE,2,14,7,7,2
MICHOACÁN DE OCAMPO,16,MÚGICA,055,CUATRO CAMINOS,2,356,179,177,16
MICHOACÁN DE OCAMPO,16,MÚGICA,055,EL CEÑIDOR,5,670,334,336,37
MICHOACÁN DE OCAMPO,16,MÚGICA,055,EL COLUMPIO,3,33,16,17,3
MICHOACÁN DE OCAMPO,16,MÚGICA,055,EL GUAYABO VIEJO,3,47,23,24,4
MICHOACÁN DE OCAMPO,16,MÚGICA,055,EL LETRERO,5,553,275,278,32
MICHOACÁN DE OCAMPO,16,MÚGICA,055,EL MARQUÉS,2,11,9,2,2
MICHOACÁN DE OCAMPO,16,MÚGICA,055,EL PANDO (CAPIRIPANDO),3,80,39,41,9
MICHOACÁN DE OCAMPO,16,MÚGICA,055,ESTACIÓN CEÑIDOR,2,78,39,39,6
MICHOACÁN DE OCAMPO,16,MÚGICA,055,ESTACIÓN NUEVA ITALIA,2,112,55,57,8
MICHOACÁN DE OCAMPO,16,MÚGICA,055,GÁMBARA,5,852,444,408,56
MICHOACÁN DE OCAMPO,16,MÚGICA,055,LA SOLEDAD (EL JABALÍ),2,22,13,9,3
MICHOACÁN DE OCAMPO,16,MÚGICA,055,NUEVA ITALIA DE RUIZ,38,8146,4211,3935,476
MICHOACÁN DE OCAMPO,16,MÚGICA,055,NUEVO CAPIRIO,3,173,89,84,12
MICHOACÁN DE OCAMPO,16,MÚGICA,055,NUEVO CORÓNDIRO,3,173,105,68,7
MICHOACÁN DE OCAMPO,16,MÚGICA,055,PITIRE,1,12,6,6,1
MICHOACÁN DE OCAMPO,16,MÚGICA,055,RANCHO NUEVO (PUEBLO NUEVO),3,104,58,46,11
MICHOACÁN DE OCAMPO,16,MÚGICA,055,SANTO DOMINGO,3,17,8,9,2
MICHOACÁN DE OCAMPO,16,MÚGICA,055,VISTA HERMOSA (EL CANAL),3,22,11,11,3
MICHOACÁN DE OCAMPO,16,NAHUATZEN,056,ARANTEPACUA,7,1013,516,497,55
MICHOACÁN DE OCAMPO,16,NAHUATZEN,056,COMACHUÉN,8,1870,941,929,82
MICHOACÁN DE OCAMPO,16,NAHUATZEN,056,EL PADRE,1,7,5,2,1
MICHOACÁN DE OCAMPO,16,NAHUATZEN,056,EL PINO,2,65,28,37,6
MICHOACÁN DE OCAMPO,16,NAHUATZEN,056,LA MOJONERA,3,326,157,169,23
MICHOACÁN DE OCAMPO,16,NAHUATZEN,056,NAHUATZEN,18,3305,1629,1676,211
MICHOACÁN DE OCAMPO,16,NAHUATZEN,056,SAN ISIDRO,3,170,81,89,12
MICHOACÁN DE OCAMPO,16,NAHUATZEN,056,SEVINA,6,1074,533,541,56
MICHOACÁN DE OCAMPO,16,NAHUATZEN,056,TURÍCUARO,8,1241,634,607,65
MICHOACÁN DE OCAMPO,16,NOCUPÉTARO,057,AGUA AGRIA,2,25,8,17,2
MICHOACÁN DE OCAMPO,16,NOCUPÉTARO,057,AGUA SANTA,2,14,5,9,2
MICHOACÁN DE OCAMPO,16,NOCUPÉTARO,057,APARANDÁN (MESA DE APARANDÁN),2,17,9,8,2
MICHOACÁN DE OCAMPO,16,NOCUPÉTARO,057,CUIMBO (COIMBO),1,5,0,5,1
MICHOACÁN DE OCAMPO,16,NOCUPÉTARO,057,EL ATRAVESAÑO,1,6,3,3,1
MICHOACÁN DE OCAMPO,16,NOCUPÉTARO,057,EL CALABOZO,2,21,10,11,2
MICHOACÁN DE OCAMPO,16,NOCUPÉTARO,057,EL CASCALOTE,2,23,12,11,3
MICHOACÁN DE OCAMPO,16,NOCUPÉTARO,057,EL CIRIÁN,3,28,10,18,3
MICHOACÁN DE OCAMPO,16,NOCUPÉTARO,057,EL MANGUITO,1,3,2,1,1
MICHOACÁN DE OCAMPO,16,NOCUPÉTARO,057,EL PALO BLANCO,1,4,1,3,1
MICHOACÁN DE OCAMPO,16,NOCUPÉTARO,057,EL PLATANAL (HACIENDA DEL PLATANAL),1,5,2,3,1
MICHOACÁN DE OCAMPO,16,NOCUPÉTARO,057,EL QUINO,2,5,2,3,2
MICHOACÁN DE OCAMPO,16,NOCUPÉTARO,057,EL RODEO,2,29,13,16,3
MICHOACÁN DE OCAMPO,16,NOCUPÉTARO,057,EL SAUZ,2,19,10,9,2
MICHOACÁN DE OCAMPO,16,NOCUPÉTARO,057,EL ZAPOTE,1,13,7,6,2
MICHOACÁN DE OCAMPO,16,NOCUPÉTARO,057,GUAGINIQUIL (GUAJINIQUIL),2,12,4,8,2
MICHOACÁN DE OCAMPO,16,NOCUPÉTARO,057,HACIENDA DE GUADALUPE (TAMARINDO),3,66,33,33,5
MICHOACÁN DE OCAMPO,16,NOCUPÉTARO,057,LA ESTANCIA GRANDE,4,92,44,48,7
MICHOACÁN DE OCAMPO,16,NOCUPÉTARO,057,LA LOMA BLANCA,3,25,13,12,4
MICHOACÁN DE OCAMPO,16,NOCUPÉTARO,057,LA LOMA DEL COPAL,3,20,7,13,2
MICHOACÁN DE OCAMPO,16,NOCUPÉTARO,057,LA SANGUIJUELA,2,11,6,5,1
MICHOACÁN DE OCAMPO,16,NOCUPÉTARO,057,LAS ANONAS,2,7,4,3,1
MICHOACÁN DE OCAMPO,16,NOCUPÉTARO,057,LAS CALABAZAS,2,5,1,4,1
MICHOACÁN DE OCAMPO,16,NOCUPÉTARO,057,LAS COCINAS,2,32,13,19,2
MICHOACÁN DE OCAMPO,16,NOCUPÉTARO,057,LAS HUERTAS,3,23,12,11,3
MICHOACÁN DE OCAMPO,16,NOCUPÉTARO,057,LAS PALMAS,2,18,10,8,2
MICHOACÁN DE OCAMPO,16,NOCUPÉTARO,057,LAS PAROTAS,3,34,16,18,4
MICHOACÁN DE OCAMPO,16,NOCUPÉTARO,057,LAS PILAS,4,112,51,61,10
MICHOACÁN DE OCAMPO,16,NOCUPÉTARO,057,LAS TROJES,1,28,12,16,2
MICHOACÁN DE OCAMPO,16,NOCUPÉTARO,057,LOS CUIRINDALES,2,12,7,5,2
MICHOACÁN DE OCAMPO,16,NOCUPÉTARO,057,LOS PLANES,2,25,13,12,3
MICHOACÁN DE OCAMPO,16,NOCUPÉTARO,057,MARIANA,2,22,15,7,2
MICHOACÁN DE OCAMPO,16,NOCUPÉTARO,057,MELCHOR OCAMPO (SAN ANTONIO DE LAS HUERTAS),4,215,108,107,17
MICHOACÁN DE OCAMPO,16,NOCUPÉTARO,057,NOCUPÉTARO DE MORELOS,7,1247,637,610,62
MICHOACÁN DE OCAMPO,16,NOCUPÉTARO,057,OJO DE AGUA DEL COBRE,1,16,10,6,2
MICHOACÁN DE OCAMPO,16,NOCUPÉTARO,057,SAN JUAN,2,7,4,3,1
MICHOACÁN DE OCAMPO,16,NOCUPÉTARO,057,SAN JUAN DE LA CONCEPCIÓN,2,5,1,4,1
MICHOACÁN DE OCAMPO,16,NOCUPÉTARO,057,SANTA BÁRBARA (EL REPARO),4,70,33,37,9
MICHOACÁN DE OCAMPO,16,NOCUPÉTARO,057,SANTA INÉS (LA ESCONDIDA),1,4,1,3,1
MICHOACÁN DE OCAMPO,16,NOCUPÉTARO,057,SANTO DOMINGO,2,17,8,9,2
MICHOACÁN DE OCAMPO,16,NOCUPÉTARO,057,UPÁCUARO,2,13,5,8,1
MICHOACÁN DE OCAMPO,16,NOCUPÉTARO,057,VISTA BELLA,2,26,10,16,3
MICHOACÁN DE OCAMPO,16,NUEVO PARANGARICUTIRO,058,AGUA BLANCA,2,5,3,2,1
MICHOACÁN DE OCAMPO,16,NUEVO PARANGARICUTIRO,058,AGUA CHIQUITA,2,11,5,6,2
MICHOACÁN DE OCAMPO,16,NUEVO PARANGARICUTIRO,058,AHUANITO,2,59,30,29,5
MICHOACÁN DE OCAMPO,16,NUEVO PARANGARICUTIRO,058,ARANDÍN,2,119,68,51,8
MICHOACÁN DE OCAMPO,16,NUEVO PARANGARICUTIRO,058,CANOA ALTA,1,7,4,3,1
MICHOACÁN DE OCAMPO,16,NUEVO PARANGARICUTIRO,058,EL DURAZNO,1,5,3,2,1
MICHOACÁN DE OCAMPO,16,NUEVO PARANGARICUTIRO,058,EL FRESNO,3,26,15,11,3
MICHOACÁN DE OCAMPO,16,NUEVO PARANGARICUTIRO,058,EL LLANO,2,33,24,9,3
MICHOACÁN DE OCAMPO,16,NUEVO PARANGARICUTIRO,058,EL MIRADOR,1,15,6,9,1
MICHOACÁN DE OCAMPO,16,NUEVO PARANGARICUTIRO,058,EL TEJAMANIL,3,12,6,6,3
MICHOACÁN DE OCAMPO,16,NUEVO PARANGARICUTIRO,058,LA ESCONDIDA,1,7,4,3,1
MICHOACÁN DE OCAMPO,16,NUEVO PARANGARICUTIRO,058,LA HIERBABUENA,2,9,4,5,2
MICHOACÁN DE OCAMPO,16,NUEVO PARANGARICUTIRO,058,LA PACATA,2,22,10,12,2
MICHOACÁN DE OCAMPO,16,NUEVO PARANGARICUTIRO,058,LAS AMAPOLAS,3,29,11,18,4
MICHOACÁN DE OCAMPO,16,NUEVO PARANGARICUTIRO,058,LAS BARRANCAS,3,35,25,10,3
MICHOACÁN DE OCAMPO,16,NUEVO PARANGARICUTIRO,058,LOS AGUACATES,1,24,9,15,2
MICHOACÁN DE OCAMPO,16,NUEVO PARANGARICUTIRO,058,LOS ARROYOS,1,10,3,7,1
MICHOACÁN DE OCAMPO,16,NUEVO PARANGARICUTIRO,058,LOS LOBOS,3,95,40,55,5
MICHOACÁN DE OCAMPO,16,NUEVO PARANGARICUTIRO,058,MILPILLAS,3,121,61,60,8
MICHOACÁN DE OCAMPO,16,NUEVO PARANGARICUTIRO,058,NUEVO SAN JUAN PARANGARICUTIRO,28,4516,2249,2267,263
MICHOACÁN DE OCAMPO,16,NUEVO PARANGARICUTIRO,058,PANGUARO,1,6,2,4,1
MICHOACÁN DE OCAMPO,16,NUEVO PARANGARICUTIRO,058,PUENTE DE TIERRA (LA PAZ),2,23,12,11,2
MICHOACÁN DE OCAMPO,16,NUEVO PARANGARICUTIRO,058,SAN ANTONIO,1,31,14,17,2
MICHOACÁN DE OCAMPO,16,NUEVO PARANGARICUTIRO,058,SANTA CATARINA,2,10,4,6,2
MICHOACÁN DE OCAMPO,16,NUEVO PARANGARICUTIRO,058,ZACÁNDARO,2,65,27,38,5
MICHOACÁN DE OCAMPO,16,NUEVO PARANGARICUTIRO,058,ZIRICUTI (LOS PAJARITOS),2,22,12,10,2
MICHOACÁN DE OCAMPO,16,NUEVO PARANGARICUTIRO,058,ZORUMUTAL,1,1,1,0,1
MICHOACÁN DE OCAMPO,16,NUEVO URECHO,059,CACANGUIO,1,6,4,2,1
MICHOACÁN DE OCAMPO,16,NUEVO URECHO,059,CHACHALACA,1,56,31,25,5
MICHOACÁN DE OCAMPO,16,NUEVO URECHO,059,EL CALVARIO,3,106,53,53,7
MICHOACÁN DE OCAMPO,16,NUEVO URECHO,059,EL CAPIRITO,2,43,25,18,4
MICHOACÁN DE OCAMPO,16,NUEVO URECHO,059,EL MIRADOR,2,25,16,9,3
MICHOACÁN DE OCAMPO,16,NUEVO URECHO,059,EL NARANJO,2,18,10,8,3
MICHOACÁN DE OCAMPO,16,NUEVO URECHO,059,EL TEJABÁN,1,34,20,14,2
MICHOACÁN DE OCAMPO,16,NUEVO URECHO,059,ICHACHICO,2,38,18,20,3
MICHOACÁN DE OCAMPO,16,NUEVO URECHO,059,LA CEBADILLA (LAS PITAS),1,6,2,4,1
MICHOACÁN DE OCAMPO,16,NUEVO URECHO,059,LA IBÉRICA (LA GOTERA),6,356,180,176,27
MICHOACÁN DE OCAMPO,16,NUEVO URECHO,059,LAS PILAS,2,23,15,8,3
MICHOACÁN DE OCAMPO,16,NUEVO URECHO,059,LAS TROJAS (LAS TROJES),3,88,42,46,7
MICHOACÁN DE OCAMPO,16,NUEVO URECHO,059,LOS OTATES,3,161,74,87,10
MICHOACÁN DE OCAMPO,16,NUEVO URECHO,059,LOS SABINOS,2,40,17,23,3
MICHOACÁN DE OCAMPO,16,NUEVO URECHO,059,NUEVO URECHO,4,544,291,253,40
MICHOACÁN DE OCAMPO,16,NUEVO URECHO,059,SAN JOSÉ DEL SALTO,1,5,3,2,1
MICHOACÁN DE OCAMPO,16,NUEVO URECHO,059,SAN VICENTE,4,228,135,93,19
MICHOACÁN DE OCAMPO,16,NUEVO URECHO,059,SANTA EFIGENIA,2,20,11,9,2
MICHOACÁN DE OCAMPO,16,NUEVO URECHO,059,TEPENAHUA,2,75,30,45,5
MICHOACÁN DE OCAMPO,16,NUEVO URECHO,059,TIERRAS COLORADAS,2,27,15,12,3
MICHOACÁN DE OCAMPO,16,NUEVO URECHO,059,TIPÍTARO,3,87,46,41,8
MICHOACÁN DE OCAMPO,16,NUEVO URECHO,059,VILLA ERÉNDIRA (EL TRES),3,183,95,88,11
MICHOACÁN DE OCAMPO,16,NUMARÁN,060,CAÑADA DE RAMÍREZ,4,351,174,177,20
MICHOACÁN DE OCAMPO,16,NUMARÁN,060,EL PALMITO,2,130,69,61,5
MICHOACÁN DE OCAMPO,16,NUMARÁN,060,EL TRIUNFO,3,107,51,56,6
MICHOACÁN DE OCAMPO,16,NUMARÁN,060,JAPACURIO,2,59,27,32,4
MICHOACÁN DE OCAMPO,16,NUMARÁN,060,JARIPITIRO,2,37,20,17,3
MICHOACÁN DE OCAMPO,16,NUMARÁN,060,LA TEPUZA,4,198,100,98,8
MICHOACÁN DE OCAMPO,16,NUMARÁN,060,LA UNIÓN (UNIÓN DE GUADALUPE),2,38,17,21,3
MICHOACÁN DE OCAMPO,16,NUMARÁN,060,NUEVO MORELOS (COLONIA NUEVO MORELOS),1,35,17,18,2
MICHOACÁN DE OCAMPO,16,NUMARÁN,060,NUMARÁN,10,1492,758,734,74
MICHOACÁN DE OCAMPO,16,OCAMPO,061,CERRO PRIETO,3,247,128,119,8
MICHOACÁN DE OCAMPO,16,OCAMPO,061,CIENEGUILLAS,2,58,20,38,3
MICHOACÁN DE OCAMPO,16,OCAMPO,061,CUARTEL DE EMILIANO ZAPATA,2,162,70,92,8
MICHOACÁN DE OCAMPO,16,OCAMPO,061,CUARTEL LA MESA (EL ASOLEADERO),4,380,187,193,18
MICHOACÁN DE OCAMPO,16,OCAMPO,061,CUARTEL LAS PALMAS,2,172,91,81,6
MICHOACÁN DE OCAMPO,16,OCAMPO,061,EJIDO EL ROSARIO,7,1068,530,538,47
MICHOACÁN DE OCAMPO,16,OCAMPO,061,EJIDO LAS TROJES,2,68,35,33,4
MICHOACÁN DE OCAMPO,16,OCAMPO,061,EL LLANO (CERRO DE LA COCINA),3,36,18,18,4
MICHOACÁN DE OCAMPO,16,OCAMPO,061,EL PASO,2,174,81,93,8
MICHOACÁN DE OCAMPO,16,OCAMPO,061,EL SOLDADO ANÓNIMO,2,115,66,49,8
MICHOACÁN DE OCAMPO,16,OCAMPO,061,HERVIDERO Y PLANCHA (CUAUHTÉMOC),2,76,29,47,3
MICHOACÁN DE OCAMPO,16,OCAMPO,061,LA MANZANA DE SANTA CRUZ,3,157,84,73,8
MICHOACÁN DE OCAMPO,16,OCAMPO,061,LAGUNA VERDE,3,125,56,69,10
MICHOACÁN DE OCAMPO,16,OCAMPO,061,LOS TEPETATES,1,6,2,4,1
MICHOACÁN DE OCAMPO,16,OCAMPO,061,MANZANA DE DOLORES,2,47,24,23,3
MICHOACÁN DE OCAMPO,16,OCAMPO,061,MANZANA DE SAN LUIS,6,1006,486,520,36
MICHOACÁN DE OCAMPO,16,OCAMPO,061,MANZANA DEL CENTRO DE SAN CRISTÓBAL,5,675,346,329,34
MICHOACÁN DE OCAMPO,16,OCAMPO,061,MANZANA DEL TEJOCOTE,1,48,25,23,4
MICHOACÁN DE OCAMPO,16,OCAMPO,061,MANZANA EL MORTERO DE SAN CRISTÓBAL,3,65,27,38,6
MICHOACÁN DE OCAMPO,16,OCAMPO,061,MANZANA EL PASO DE SAN CRISTÓBAL,1,13,5,8,1
MICHOACÁN DE OCAMPO,16,OCAMPO,061,MANZANA EL TEJOCOTE,1,18,4,14,1
MICHOACÁN DE OCAMPO,16,OCAMPO,061,MANZANA LA CIÉNEGA,2,25,11,14,3
MICHOACÁN DE OCAMPO,16,OCAMPO,061,MANZANA LOS REMEDIOS,2,28,12,16,2
MICHOACÁN DE OCAMPO,16,OCAMPO,061,MANZANA RANCHO ESCONDIDO,3,172,85,87,9
MICHOACÁN DE OCAMPO,16,OCAMPO,061,MESA EL ARENAL,2,25,18,7,2
MICHOACÁN DE OCAMPO,16,OCAMPO,061,OCAMPO,9,2246,1137,1109,130
MICHOACÁN DE OCAMPO,16,OCAMPO,061,OJO DE AGUA,1,11,8,3,1
MICHOACÁN DE OCAMPO,16,OCAMPO,061,SAN JUAN,2,85,32,53,4
MICHOACÁN DE OCAMPO,16,OCAMPO,061,SANTA ANA,2,60,27,33,3
MICHOACÁN DE OCAMPO,16,PAJACUARÁN,062,EL CHACOLOTE,2,39,21,18,3
MICHOACÁN DE OCAMPO,16,PAJACUARÁN,062,EL COMETA,3,118,55,63,9
MICHOACÁN DE OCAMPO,16,PAJACUARÁN,062,EL PARACHO,5,336,163,173,19
MICHOACÁN DE OCAMPO,16,PAJACUARÁN,062,FRAY DOMÍNGUEZ (LOS ZAPOTES),2,23,9,14,2
MICHOACÁN DE OCAMPO,16,PAJACUARÁN,062,LA HIGUERA,3,54,25,29,5
MICHOACÁN DE OCAMPO,16,PAJACUARÁN,062,LA LUZ,6,633,324,309,40
MICHOACÁN DE OCAMPO,16,PAJACUARÁN,062,LOS QUIOTES,2,37,20,17,2
MICHOACÁN DE OCAMPO,16,PAJACUARÁN,062,PAJACUARÁN,12,2089,1101,988,94
MICHOACÁN DE OCAMPO,16,PAJACUARÁN,062,PASO DE LIMÓN (COLONIA AMADO NERVO),1,511,276,235,17
MICHOACÁN DE OCAMPO,16,PAJACUARÁN,062,PERIBÁN,2,44,30,14,2
MICHOACÁN DE OCAMPO,16,PAJACUARÁN,062,SAN GREGORIO,4,364,183,181,17
MICHOACÁN DE OCAMPO,16,PAJACUARÁN,062,TECOMATÁN,3,221,118,103,11
MICHOACÁN DE OCAMPO,16,PANINDÍCUARO,063,AGUANATO (AGUANUATO),5,202,103,99,16
MICHOACÁN DE OCAMPO,16,PANINDÍCUARO,063,BELLA VISTA,3,73,45,28,4
MICHOACÁN DE OCAMPO,16,PANINDÍCUARO,063,BOTELLO (ALTAMIRA),2,29,17,12,2
MICHOACÁN DE OCAMPO,16,PANINDÍCUARO,063,CURIMEO,4,299,161,138,22
MICHOACÁN DE OCAMPO,16,PANINDÍCUARO,063,EL FRESNO DE LA REFORMA,5,123,61,62,13
MICHOACÁN DE OCAMPO,16,PANINDÍCUARO,063,ESTACIÓN DE CURIMEO (EL CERRITO),2,12,8,4,2
MICHOACÁN DE OCAMPO,16,PANINDÍCUARO,063,EX-HACIENDA DE CURIMEO,2,63,33,30,7
MICHOACÁN DE OCAMPO,16,PANINDÍCUARO,063,IRANCUÁTARO,2,69,27,42,5
MICHOACÁN DE OCAMPO,16,PANINDÍCUARO,063,J. TRINIDAD REGALADO (LA COLONIA),4,187,99,88,13
MICHOACÁN DE OCAMPO,16,PANINDÍCUARO,063,LA CAÑADA,3,44,21,23,6
MICHOACÁN DE OCAMPO,16,PANINDÍCUARO,063,LA CÓRDOBA,2,34,18,16,3
MICHOACÁN DE OCAMPO,16,PANINDÍCUARO,063,LA LUZ,4,296,164,132,20
MICHOACÁN DE OCAMPO,16,PANINDÍCUARO,063,LOS ALVARADOS,2,52,24,28,4
MICHOACÁN DE OCAMPO,16,PANINDÍCUARO,063,OJO DE AGUA DE SEÑORA,3,19,7,12,3
MICHOACÁN DE OCAMPO,16,PANINDÍCUARO,063,PANINDÍCUARO,8,1739,888,851,126
MICHOACÁN DE OCAMPO,16,PANINDÍCUARO,063,PIRITZIO (PIRICHO),2,15,8,7,2
MICHOACÁN DE OCAMPO,16,PANINDÍCUARO,063,POMÁCUARO,2,50,28,22,3
MICHOACÁN DE OCAMPO,16,PANINDÍCUARO,063,RANCHOS DE EPEJAN (LA LOMA),2,16,9,7,2
MICHOACÁN DE OCAMPO,16,PANINDÍCUARO,063,ROBALCABO,2,46,25,21,3
MICHOACÁN DE OCAMPO,16,PANINDÍCUARO,063,SAN DIEGO AMÉCUARO,2,45,24,21,4
MICHOACÁN DE OCAMPO,16,PANINDÍCUARO,063,SAN MIGUEL EPEJAN,4,285,146,139,21
MICHOACÁN DE OCAMPO,16,PANINDÍCUARO,063,SAN VICENTE,2,22,11,11,2
MICHOACÁN DE OCAMPO,16,PANINDÍCUARO,063,TANGUATO,2,21,12,9,2
MICHOACÁN DE OCAMPO,16,PANINDÍCUARO,063,UREQUÍO,3,140,81,59,11
MICHOACÁN DE OCAMPO,16,PARÁCUARO,064,ANTÚNEZ (MORELOS),12,2141,1102,1039,122
MICHOACÁN DE OCAMPO,16,PARÁCUARO,064,BUENOS AIRES,3,253,130,123,13
MICHOACÁN DE OCAMPO,16,PARÁCUARO,064,CANAL DE PEDERNALES,1,3,1,2,1
MICHOACÁN DE OCAMPO,16,PARÁCUARO,064,CANCITA,4,201,92,109,18
MICHOACÁN DE OCAMPO,16,PARÁCUARO,064,CHONENGO,4,128,60,68,11
MICHOACÁN DE OCAMPO,16,PARÁCUARO,064,CIUDAD MORELOS [CRUCERO DE PARÁCUARO],1,6,2,4,1
MICHOACÁN DE OCAMPO,16,PARÁCUARO,064,CRUCERO DE PARÁCUARO,2,76,36,40,7
MICHOACÁN DE OCAMPO,16,PARÁCUARO,064,CRUCERO LAS YEGUAS,2,128,59,69,8
MICHOACÁN DE OCAMPO,16,PARÁCUARO,064,EL CARRIZO,2,39,22,17,3
MICHOACÁN DE OCAMPO,16,PARÁCUARO,064,EL CAULOTE,4,192,87,105,14
MICHOACÁN DE OCAMPO,16,PARÁCUARO,064,EL JUNCO,1,15,9,6,2
MICHOACÁN DE OCAMPO,16,PARÁCUARO,064,EL TEPEHUAJE,2,23,13,10,3
MICHOACÁN DE OCAMPO,16,PARÁCUARO,064,EL VALLE,3,20,10,10,3
MICHOACÁN DE OCAMPO,16,PARÁCUARO,064,EL VARAL (EL OREJANO),2,76,36,40,5
MICHOACÁN DE OCAMPO,16,PARÁCUARO,064,ESPAÑITA,3,27,17,10,4
MICHOACÁN DE OCAMPO,16,PARÁCUARO,064,GUADALUPE,1,20,11,9,2
MICHOACÁN DE OCAMPO,16,PARÁCUARO,064,LA BATEA,2,34,16,18,3
MICHOACÁN DE OCAMPO,16,PARÁCUARO,064,LA ESTANCIA,5,273,141,132,22
MICHOACÁN DE OCAMPO,16,PARÁCUARO,064,LAS CRUCITAS,3,124,73,51,10
MICHOACÁN DE OCAMPO,16,PARÁCUARO,064,LAS ORDEÑITAS,3,48,28,20,4
MICHOACÁN DE OCAMPO,16,PARÁCUARO,064,LAS YEGUAS,4,275,144,131,15
MICHOACÁN DE OCAMPO,16,PARÁCUARO,064,LOS BANCOS,3,208,94,114,14
MICHOACÁN DE OCAMPO,16,PARÁCUARO,064,LOS POZOS,4,165,79,86,15
MICHOACÁN DE OCAMPO,16,PARÁCUARO,064,LOS TIQUICHES,1,8,6,2,1
MICHOACÁN DE OCAMPO,16,PARÁCUARO,064,MARAVATÍO,2,14,5,9,2
MICHOACÁN DE OCAMPO,16,PARÁCUARO,064,MONTE GRANDE,3,38,14,24,4
MICHOACÁN DE OCAMPO,16,PARÁCUARO,064,PARÁCUARO,12,1578,811,767,119
MICHOACÁN DE OCAMPO,16,PARÁCUARO,064,PIEDRA PARADA,1,6,2,4,1
MICHOACÁN DE OCAMPO,16,PARÁCUARO,064,PRIMERO DE SEPTIEMBRE,1,16,11,5,2
MICHOACÁN DE OCAMPO,16,PARÁCUARO,064,PUERTA CHICA (BARRIO SECO),2,63,38,25,4
MICHOACÁN DE OCAMPO,16,PARÁCUARO,064,USPERO (REYNOSA),6,320,167,153,23
MICHOACÁN DE OCAMPO,16,PARÁCUARO,064,VEINTE DE NOVIEMBRE,4,195,101,94,14
MICHOACÁN DE OCAMPO,16,PARACHO,065,AHUIRÁN,5,534,249,285,29
MICHOACÁN DE OCAMPO,16,PARACHO,065,ARANZA (ARANTZÁN),4,506,254,252,29
MICHOACÁN DE OCAMPO,16,PARACHO,065,ARATO,2,15,10,5,3
MICHOACÁN DE OCAMPO,16,PARACHO,065,CHERÁN ATZICUIRÍN (CHERANÁSTICO),6,743,367,376,43
MICHOACÁN DE OCAMPO,16,PARACHO,065,NURIO,7,1089,520,569,69
MICHOACÁN DE OCAMPO,16,PARACHO,065,PARACHO DE VERDUZCO,37,5731,2791,2940,374
MICHOACÁN DE OCAMPO,16,PARACHO,065,POMACUARÁN (POMOCUARÁN),4,441,208,233,25
MICHOACÁN DE OCAMPO,16,PARACHO,065,QUINCEO,7,886,438,448,50
MICHOACÁN DE OCAMPO,16,PARACHO,065,SANTA MARÍA URAPICHO,6,553,276,277,31
MICHOACÁN DE OCAMPO,16,PÁTZCUARO,066,AGUA NUEVA,1,339,177,162,12
MICHOACÁN DE OCAMPO,16,PÁTZCUARO,066,AJUNO,3,383,198,185,24
MICHOACÁN DE OCAMPO,16,PÁTZCUARO,066,BUENAVISTA,2,146,66,80,6
MICHOACÁN DE OCAMPO,16,PÁTZCUARO,066,CANACUCHO,4,274,130,144,16
MICHOACÁN DE OCAMPO,16,PÁTZCUARO,066,CHAPULTEPEC,2,45,28,17,3
MICHOACÁN DE OCAMPO,16,PÁTZCUARO,066,COLONIA MIGUEL HIDALGO (LA CADENITA),2,32,18,14,3
MICHOACÁN DE OCAMPO,16,PÁTZCUARO,066,CONDÉMBARO,3,105,51,54,5
MICHOACÁN DE OCAMPO,16,PÁTZCUARO,066,CUANAJO,10,1368,697,671,83
MICHOACÁN DE OCAMPO,16,PÁTZCUARO,066,EL MANZANILLAL (COLONIA ENRIQUE RAMÍREZ),1,51,28,23,2
MICHOACÁN DE OCAMPO,16,PÁTZCUARO,066,EL MIRADOR,1,45,14,31,4
MICHOACÁN DE OCAMPO,16,PÁTZCUARO,066,EL REFUGIO,2,127,72,55,7
MICHOACÁN DE OCAMPO,16,PÁTZCUARO,066,EL ZAPOTE,3,125,49,76,8
MICHOACÁN DE OCAMPO,16,PÁTZCUARO,066,ESTACIÓN DE AJUNO (SANTA ISABEL AJUNO),2,57,33,24,4
MICHOACÁN DE OCAMPO,16,PÁTZCUARO,066,HUECORIO,5,1106,564,542,123
MICHOACÁN DE OCAMPO,16,PÁTZCUARO,066,ISLA DE TECUENA,2,81,39,42,4
MICHOACÁN DE OCAMPO,16,PÁTZCUARO,066,ISLA YUNUÉN,3,30,16,14,3
MICHOACÁN DE OCAMPO,16,PÁTZCUARO,066,JANITZIO (ISLA JANITZIO),8,651,358,293,43
MICHOACÁN DE OCAMPO,16,PÁTZCUARO,066,JOYA DE LOS MOLINOS,2,172,68,104,9
MICHOACÁN DE OCAMPO,16,PÁTZCUARO,066,LA LAGUNITA,1,46,24,22,4
MICHOACÁN DE OCAMPO,16,PÁTZCUARO,066,LA NORIA,1,31,12,19,2
MICHOACÁN DE OCAMPO,16,PÁTZCUARO,066,LA PEQUEÑA TINAJITA,1,14,8,6,1
MICHOACÁN DE OCAMPO,16,PÁTZCUARO,066,LA TINAJA,2,36,16,20,3
MICHOACÁN DE OCAMPO,16,PÁTZCUARO,066,LA VITELA (LOS POZOS),2,58,30,28,4
MICHOACÁN DE OCAMPO,16,PÁTZCUARO,066,LAS PALMITAS,3,114,57,57,7
MICHOACÁN DE OCAMPO,16,PÁTZCUARO,066,LAS TROJES DEL DURAZNO,3,258,125,133,14
MICHOACÁN DE OCAMPO,16,PÁTZCUARO,066,LÁZARO CÁRDENAS (SAN BARTOLO PAREO),5,344,182,162,24
MICHOACÁN DE OCAMPO,16,PÁTZCUARO,066,LOS TANQUES,1,27,14,13,1
MICHOACÁN DE OCAMPO,16,PÁTZCUARO,066,OJOS DE AGUA,2,18,7,11,2
MICHOACÁN DE OCAMPO,16,PÁTZCUARO,066,PÁTZCUARO,97,18851,9838,9013,1179
MICHOACÁN DE OCAMPO,16,PÁTZCUARO,066,PUEBLO NUEVO,1,15,10,5,1
MICHOACÁN DE OCAMPO,16,PÁTZCUARO,066,PUERTA DE CADENA,5,184,95,89,16
MICHOACÁN DE OCAMPO,16,PÁTZCUARO,066,SAN MIGUEL CHARAHUÉN,5,251,126,125,15
MICHOACÁN DE OCAMPO,16,PÁTZCUARO,066,SAN PEDRO PAREO,3,106,55,51,11
MICHOACÁN DE OCAMPO,16,PÁTZCUARO,066,SANTA ANA CHAPITIRO,4,185,86,99,14
MICHOACÁN DE OCAMPO,16,PÁTZCUARO,066,SANTA JUANA,4,554,278,276,32
MICHOACÁN DE OCAMPO,16,PÁTZCUARO,066,SANTA MARÍA HUIRAMANGARO (SAN JUAN TUMBIO),6,744,371,373,45
MICHOACÁN DE OCAMPO,16,PÁTZCUARO,066,TZENTZÉNGUARO,3,69,29,40,6
MICHOACÁN DE OCAMPO,16,PÁTZCUARO,066,UNGUARÁN (INGUARÁN),2,80,44,36,4
MICHOACÁN DE OCAMPO,16,PÁTZCUARO,066,URANDÉN DE MORELOS (ISLA URANDÉN DE MORELOS),2,65,34,31,6
MICHOACÁN DE OCAMPO,16,PÁTZCUARO,066,YURETZIO,3,70,37,33,4
MICHOACÁN DE OCAMPO,16,PÁTZCUARO,066,ZURUMÚTARO (TZURUMÚTARO),4,1211,574,637,66
MICHOACÁN DE OCAMPO,16,PENJAMILLO,067,ANSIHUACUARO,3,242,123,119,12
MICHOACÁN DE OCAMPO,16,PENJAMILLO,067,ARROYUELOS,2,29,16,13,2
MICHOACÁN DE OCAMPO,16,PENJAMILLO,067,COLONIA EL PLATANAL,1,49,24,25,3
MICHOACÁN DE OCAMPO,16,PENJAMILLO,067,EL COLORADO,3,164,68,96,10
MICHOACÁN DE OCAMPO,16,PENJAMILLO,067,EL GUAYABO,3,48,26,22,4
MICHOACÁN DE OCAMPO,16,PENJAMILLO,067,EL MEZQUITE DE HERNÁNDEZ,2,24,6,18,2
MICHOACÁN DE OCAMPO,16,PENJAMILLO,067,EL NUEVO VADO BLANCO (TIJUANITA),1,9,3,6,1
MICHOACÁN DE OCAMPO,16,PENJAMILLO,067,EL TECUÁN,2,34,13,21,3
MICHOACÁN DE OCAMPO,16,PENJAMILLO,067,EL VIEJO RODEO,2,20,7,13,2
MICHOACÁN DE OCAMPO,16,PENJAMILLO,067,GUÁNDARO,4,283,134,149,16
MICHOACÁN DE OCAMPO,16,PENJAMILLO,067,LA CUESTITA,2,23,15,8,2
MICHOACÁN DE OCAMPO,16,PENJAMILLO,067,LA GARZA,2,9,6,3,3
MICHOACÁN DE OCAMPO,16,PENJAMILLO,067,LA LABORCILLA,1,4,3,1,1
MICHOACÁN DE OCAMPO,16,PENJAMILLO,067,LA LUZ,3,91,47,44,5
MICHOACÁN DE OCAMPO,16,PENJAMILLO,067,LA POMA,2,21,12,9,2
MICHOACÁN DE OCAMPO,16,PENJAMILLO,067,LOS FRESNOS,2,24,9,15,2
MICHOACÁN DE OCAMPO,16,PENJAMILLO,067,LOS OTATES,2,10,5,5,1
MICHOACÁN DE OCAMPO,16,PENJAMILLO,067,NUEVO RODEO,2,30,11,19,3
MICHOACÁN DE OCAMPO,16,PENJAMILLO,067,PATAMBARILLO,3,96,50,46,8
MICHOACÁN DE OCAMPO,16,PENJAMILLO,067,PATÁMBARO,3,58,27,31,4
MICHOACÁN DE OCAMPO,16,PENJAMILLO,067,PENJAMILLO DE DEGOLLADO,9,1330,668,662,111
MICHOACÁN DE OCAMPO,16,PENJAMILLO,067,SAN ANTONIO CARUPO,3,75,37,38,6
MICHOACÁN DE OCAMPO,16,PENJAMILLO,067,SAN ISIDRO,3,49,17,32,3
MICHOACÁN DE OCAMPO,16,PENJAMILLO,067,SAN JOSÉ DE RÁBAGO,3,93,43,50,7
MICHOACÁN DE OCAMPO,16,PENJAMILLO,067,SANTA FE DEL RÍO,4,224,121,103,12
MICHOACÁN DE OCAMPO,16,PENJAMILLO,067,TIRIMÁCUARO (VALENCIANA),3,178,80,98,12
MICHOACÁN DE OCAMPO,16,PENJAMILLO,067,VADO BLANCO,2,26,14,12,2
MICHOACÁN DE OCAMPO,16,PENJAMILLO,067,ZIQUÍTARO,4,266,144,122,17
MICHOACÁN DE OCAMPO,16,PERIBÁN,068,COPETIRO,2,50,25,25,2
MICHOACÁN DE OCAMPO,16,PERIBÁN,068,CORONA,5,664,297,367,29
MICHOACÁN DE OCAMPO,16,PERIBÁN,068,EL CARRIZALILLO,1,8,4,4,1
MICHOACÁN DE OCAMPO,16,PERIBÁN,068,GILDARDO MAGAÑA (LOS ÁNGELES),3,759,390,369,35
MICHOACÁN DE OCAMPO,16,PERIBÁN,068,HUATARILLO,2,80,47,33,5
MICHOACÁN DE OCAMPO,16,PERIBÁN,068,LA FÁBRICA,2,50,23,27,4
MICHOACÁN DE OCAMPO,16,PERIBÁN,068,LA YERBABUENA,2,95,43,52,7
MICHOACÁN DE OCAMPO,16,PERIBÁN,068,LAS TINAJAS,2,20,10,10,2
MICHOACÁN DE OCAMPO,16,PERIBÁN,068,LOS PASTORES,2,52,27,25,3
MICHOACÁN DE OCAMPO,16,PERIBÁN,068,MAGALLÓN,1,11,3,8,1
MICHOACÁN DE OCAMPO,16,PERIBÁN,068,PARAMBÉN,2,28,17,11,3
MICHOACÁN DE OCAMPO,16,PERIBÁN,068,PARASTACO,2,30,15,15,2
MICHOACÁN DE OCAMPO,16,PERIBÁN,068,PASO DE LA NIEVE,1,10,6,4,1
MICHOACÁN DE OCAMPO,16,PERIBÁN,068,PERIBÁN DE RAMOS,26,5491,2815,2676,249
MICHOACÁN DE OCAMPO,16,PERIBÁN,068,PLAN DE AYALA,3,116,52,64,7
MICHOACÁN DE OCAMPO,16,PERIBÁN,068,SAN FRANCISCO PERIBÁN,4,580,306,274,29
MICHOACÁN DE OCAMPO,16,PERIBÁN,068,SAN JOSÉ APUPÁTARO,2,55,23,32,5
MICHOACÁN DE OCAMPO,16,PERIBÁN,068,TENGÜERÁN,1,3,2,1,1
MICHOACÁN DE OCAMPO,16,LA PIEDAD,069,ACUITZIO,3,129,72,57,9
MICHOACÁN DE OCAMPO,16,LA PIEDAD,069,COLONIA MELCHOR OCAMPO (ÁNIMAS GUSGAS),2,44,23,21,3
MICHOACÁN DE OCAMPO,16,LA PIEDAD,069,CUJUARATO,3,47,31,16,5
MICHOACÁN DE OCAMPO,16,LA PIEDAD,069,EL ALGODONAL,4,149,85,64,10
MICHOACÁN DE OCAMPO,16,LA PIEDAD,069,EL CALABOCITO,2,45,24,21,4
MICHOACÁN DE OCAMPO,16,LA PIEDAD,069,EL CAUDILLO (CHORRERA DE SILVA),2,21,11,10,3
MICHOACÁN DE OCAMPO,16,LA PIEDAD,069,EL FUERTE (SAN JUAN DEL FUERTE),5,284,137,147,15
MICHOACÁN DE OCAMPO,16,LA PIEDAD,069,EL PANDILLO,1,15,5,10,1
MICHOACÁN DE OCAMPO,16,LA PIEDAD,069,EL ZAPOTE,1,15,6,9,3
MICHOACÁN DE OCAMPO,16,LA PIEDAD,069,GRANJA DE LOS ZAMBRANO,1,91,48,43,5
MICHOACÁN DE OCAMPO,16,LA PIEDAD,069,GUANAJUATILLO,2,160,79,81,9
MICHOACÁN DE OCAMPO,16,LA PIEDAD,069,HIGUERA DE SAN RAFAEL (LAS HIGUERAS),2,43,20,23,5
MICHOACÁN DE OCAMPO,16,LA PIEDAD,069,JAUJA,2,9,6,3,2
MICHOACÁN DE OCAMPO,16,LA PIEDAD,069,LA CAMPANA,3,24,10,14,3
MICHOACÁN DE OCAMPO,16,LA PIEDAD,069,LA ESCOBA,2,21,10,11,2
MICHOACÁN DE OCAMPO,16,LA PIEDAD,069,LA PIEDAD DE CABADAS,145,25305,13049,12256,1526
MICHOACÁN DE OCAMPO,16,LA PIEDAD,069,LA PROVIDENCIA,3,33,18,15,4
MICHOACÁN DE OCAMPO,16,LA PIEDAD,069,LAS CANOAS DEL SALTO,1,3,1,2,1
MICHOACÁN DE OCAMPO,16,LA PIEDAD,069,LOS GUAJES,4,310,154,156,13
MICHOACÁN DE OCAMPO,16,LA PIEDAD,069,LOS LÓPEZ,1,9,4,5,1
MICHOACÁN DE OCAMPO,16,LA PIEDAD,069,LOS OCALES (TRINO LÓPEZ RAMÍREZ),2,210,109,101,7
MICHOACÁN DE OCAMPO,16,LA PIEDAD,069,OJO DE AGUA DE SERRATO,3,54,30,24,5
MICHOACÁN DE OCAMPO,16,LA PIEDAD,069,PAREDONES,3,72,31,41,6
MICHOACÁN DE OCAMPO,16,LA PIEDAD,069,RÍO GRANDE,4,366,170,196,18
MICHOACÁN DE OCAMPO,16,LA PIEDAD,069,SAN CRISTÓBAL,1,22,8,14,1
MICHOACÁN DE OCAMPO,16,LA PIEDAD,069,SAN JOAQUÍN,1,6,3,3,1
MICHOACÁN DE OCAMPO,16,LA PIEDAD,069,SANTA CATARINA,1,14,7,7,1
MICHOACÁN DE OCAMPO,16,LA PIEDAD,069,TANQUE DE PEÑA,3,60,21,39,5
MICHOACÁN DE OCAMPO,16,LA PIEDAD,069,TAQUISCUAREO (LA FINCA),2,39,23,16,3
MICHOACÁN DE OCAMPO,16,LA PIEDAD,069,TICUITACO (TOCUITACO),2,61,30,31,5
MICHOACÁN DE OCAMPO,16,LA PIEDAD,069,VILLAS DE LAS LOMAS,1,207,103,104,7
MICHOACÁN DE OCAMPO,16,LA PIEDAD,069,ZARAGOZA,2,107,55,52,7
MICHOACÁN DE OCAMPO,16,PURÉPERO,070,DOS ESTRELLAS DE JIMÉNEZ,5,147,64,83,11
MICHOACÁN DE OCAMPO,16,PURÉPERO,070,LA ALBERCA,3,9,4,5,2
MICHOACÁN DE OCAMPO,16,PURÉPERO,070,PURÉPERO DE ECHÁIZ,17,2874,1430,1444,180
MICHOACÁN DE OCAMPO,16,PURÉPERO,070,VILLA MENDOZA,2,25,7,18,2
MICHOACÁN DE OCAMPO,16,PURUÁNDIRO,071,BATUECAS,3,116,58,58,8
MICHOACÁN DE OCAMPO,16,PURUÁNDIRO,071,CHAMACUERO,3,163,77,86,10
MICHOACÁN DE OCAMPO,16,PURUÁNDIRO,071,EL ARMADILLO,3,63,36,27,8
MICHOACÁN DE OCAMPO,16,PURUÁNDIRO,071,EL GRANJENAL,2,34,13,21,3
MICHOACÁN DE OCAMPO,16,PURUÁNDIRO,071,EL PILAR,4,274,131,143,16
MICHOACÁN DE OCAMPO,16,PURUÁNDIRO,071,EL PUEBLITO,3,74,37,37,7
MICHOACÁN DE OCAMPO,16,PURUÁNDIRO,071,EL RINCÓN DE DON PEDRO,1,2,1,1,1
MICHOACÁN DE OCAMPO,16,PURUÁNDIRO,071,GALEANA,8,673,326,347,40
MICHOACÁN DE OCAMPO,16,PURUÁNDIRO,071,HUATAJO,3,115,49,66,10
MICHOACÁN DE OCAMPO,16,PURUÁNDIRO,071,ISAAC ARRIAGA (SANTA ANA MANCERA),4,528,266,262,34
MICHOACÁN DE OCAMPO,16,PURUÁNDIRO,071,JANAMBO,3,268,126,142,14
MICHOACÁN DE OCAMPO,16,PURUÁNDIRO,071,JANAMUATO,3,331,156,175,18
MICHOACÁN DE OCAMPO,16,PURUÁNDIRO,071,LA BARRANCA,3,101,46,55,9
MICHOACÁN DE OCAMPO,16,PURUÁNDIRO,071,LA COFRADÍA,2,103,58,45,8
MICHOACÁN DE OCAMPO,16,PURUÁNDIRO,071,LA EXCUSA,3,117,66,51,10
MICHOACÁN DE OCAMPO,16,PURUÁNDIRO,071,LA HIGUERA,2,25,14,11,2
MICHOACÁN DE OCAMPO,16,PURUÁNDIRO,071,LA QUEMADA,3,59,21,38,6
MICHOACÁN DE OCAMPO,16,PURUÁNDIRO,071,LA QUEMADITA,1,13,5,8,1
MICHOACÁN DE OCAMPO,16,PURUÁNDIRO,071,LA SOLEDAD DE SANTA ANA,4,216,105,111,16
MICHOACÁN DE OCAMPO,16,PURUÁNDIRO,071,LAS LETRAS,3,344,181,163,19
MICHOACÁN DE OCAMPO,16,PURUÁNDIRO,071,LAS RANAS,5,209,108,101,13
MICHOACÁN DE OCAMPO,16,PURUÁNDIRO,071,LAS TORTUGAS (EMILIANO ZAPATA),3,87,49,38,7
MICHOACÁN DE OCAMPO,16,PURUÁNDIRO,071,LOS REYES,4,174,87,87,12
MICHOACÁN DE OCAMPO,16,PURUÁNDIRO,071,MANUEL VILLALONGÍN,4,381,188,193,25
MICHOACÁN DE OCAMPO,16,PURUÁNDIRO,071,NUEVO PROGRESO (CASAS VIEJAS),3,155,80,75,18
MICHOACÁN DE OCAMPO,16,PURUÁNDIRO,071,PIEDRAS ANCHAS,3,145,64,81,10
MICHOACÁN DE OCAMPO,16,PURUÁNDIRO,071,POTRERO DEL TABLÓN,1,18,11,7,1
MICHOACÁN DE OCAMPO,16,PURUÁNDIRO,071,PURUÁNDIRO,40,7448,3815,3633,512
MICHOACÁN DE OCAMPO,16,PURUÁNDIRO,071,SABINO BUENAVISTA,2,104,47,57,8
MICHOACÁN DE OCAMPO,16,PURUÁNDIRO,071,SAN ISIDRO DE LA CUESTA,2,28,11,17,3
MICHOACÁN DE OCAMPO,16,PURUÁNDIRO,071,SAN JOSÉ DEL REPARO,2,163,87,76,9
MICHOACÁN DE OCAMPO,16,PURUÁNDIRO,071,SAN JOSÉ OTUNGUITIRO,1,22,6,16,2
MICHOACÁN DE OCAMPO,16,PURUÁNDIRO,071,SAN LORENZO,4,461,244,217,23
MICHOACÁN DE OCAMPO,16,PURUÁNDIRO,071,SAN MIGUEL,2,57,28,29,4
MICHOACÁN DE OCAMPO,16,PURUÁNDIRO,071,SAN NICOLÁS,3,64,41,23,5
MICHOACÁN DE OCAMPO,16,PURUÁNDIRO,071,SAN PEDRO (SAN PEDRO CARANO),6,621,306,315,31
MICHOACÁN DE OCAMPO,16,PURUÁNDIRO,071,SANGUIJUELAS,4,337,149,188,16
MICHOACÁN DE OCAMPO,16,PURUÁNDIRO,071,SANTA CLARA,5,481,246,235,30
MICHOACÁN DE OCAMPO,16,PURUÁNDIRO,071,SANTA TERESA,2,8,5,3,1
MICHOACÁN DE OCAMPO,16,PURUÁNDIRO,071,URURUTA,3,161,78,83,11
MICHOACÁN DE OCAMPO,16,PURUÁNDIRO,071,VILLACHUATO,4,736,366,370,38
MICHOACÁN DE OCAMPO,16,QUERÉNDARO,072,EL CASTILLO,2,73,36,37,6
MICHOACÁN DE OCAMPO,16,QUERÉNDARO,072,EL NOPAL,3,33,16,17,3
MICHOACÁN DE OCAMPO,16,QUERÉNDARO,072,EL TEMPLETE,2,10,6,4,1
MICHOACÁN DE OCAMPO,16,QUERÉNDARO,072,LA ESTANCIA,3,65,30,35,6
MICHOACÁN DE OCAMPO,16,QUERÉNDARO,072,MILPILLAS,1,8,4,4,1
MICHOACÁN DE OCAMPO,16,QUERÉNDARO,072,OJO DE AGUA (EL SAUZ),2,7,5,2,1
MICHOACÁN DE OCAMPO,16,QUERÉNDARO,072,OJO DE AGUA GRANDE,2,30,13,17,2
MICHOACÁN DE OCAMPO,16,QUERÉNDARO,072,PALO GRUESO (LA TROJA),2,11,6,5,2
MICHOACÁN DE OCAMPO,16,QUERÉNDARO,072,PEÑA BLANCA,2,4,0,4,1
MICHOACÁN DE OCAMPO,16,QUERÉNDARO,072,PUEBLO VIEJO,4,173,89,84,15
MICHOACÁN DE OCAMPO,16,QUERÉNDARO,072,QUERÉNDARO,13,2349,1228,1121,112
MICHOACÁN DE OCAMPO,16,QUERÉNDARO,072,REAL DE OTZUMATLÁN,2,29,18,11,2
MICHOACÁN DE OCAMPO,16,QUERÉNDARO,072,RINCÓN DE ZETINA,2,24,15,9,2
MICHOACÁN DE OCAMPO,16,QUERÉNDARO,072,RÍO DE PARRAS (OTZUMATLÁN),3,160,86,74,12
MICHOACÁN DE OCAMPO,16,QUERÉNDARO,072,SAN JOSÉ DE LA CUMBRE,4,98,53,45,9
MICHOACÁN DE OCAMPO,16,QUERÉNDARO,072,SAN MIGUEL LAS CUEVAS,2,19,11,8,3
MICHOACÁN DE OCAMPO,16,QUERÉNDARO,072,SANTO DOMINGO,3,13,8,5,4
MICHOACÁN DE OCAMPO,16,QUERÉNDARO,072,TIRADORES (SAN ANTONIO TIRADORES),3,67,34,33,6
MICHOACÁN DE OCAMPO,16,QUIROGA,073,ATZIMBO,3,163,83,80,8
MICHOACÁN DE OCAMPO,16,QUIROGA,073,CARÍNGARO,2,52,28,24,3
MICHOACÁN DE OCAMPO,16,QUIROGA,073,ICUACATO,3,172,90,82,12
MICHOACÁN DE OCAMPO,16,QUIROGA,073,QUIROGA,19,4147,2151,1996,214
MICHOACÁN DE OCAMPO,16,QUIROGA,073,SAN ANDRÉS ZIRÓNDARO,5,511,261,250,27
MICHOACÁN DE OCAMPO,16,QUIROGA,073,SAN JERÓNIMO PURENCHÉCUARO,5,590,324,266,38
MICHOACÁN DE OCAMPO,16,QUIROGA,073,SANAMBO,3,84,37,47,8
MICHOACÁN DE OCAMPO,16,QUIROGA,073,SANTA FE DE LA LAGUNA,8,1474,767,707,89
MICHOACÁN DE OCAMPO,16,COJUMATLÁN DE RÉGULES,074,CALLEJÓN DE LA CALERA,2,41,18,23,3
MICHOACÁN DE OCAMPO,16,COJUMATLÁN DE RÉGULES,074,COJUMATLÁN DE RÉGULES,8,1639,810,829,65
MICHOACÁN DE OCAMPO,16,COJUMATLÁN DE RÉGULES,074,EL NOGAL,3,34,19,15,3
MICHOACÁN DE OCAMPO,16,COJUMATLÁN DE RÉGULES,074,LA PUNTITA,3,108,36,72,6
MICHOACÁN DE OCAMPO,16,COJUMATLÁN DE RÉGULES,074,PALO ALTO,3,129,64,65,8
MICHOACÁN DE OCAMPO,16,COJUMATLÁN DE RÉGULES,074,PETATÁN (ISLA DE PETATÁN),2,85,43,42,4
MICHOACÁN DE OCAMPO,16,COJUMATLÁN DE RÉGULES,074,PUERTA DE COJUMATLÁN,1,14,7,7,1
MICHOACÁN DE OCAMPO,16,COJUMATLÁN DE RÉGULES,074,PUERTO DE LEÓN,2,38,18,20,2
MICHOACÁN DE OCAMPO,16,COJUMATLÁN DE RÉGULES,074,RINCÓN DE MARÍA,2,49,26,23,3
MICHOACÁN DE OCAMPO,16,COJUMATLÁN DE RÉGULES,074,SAN ISIDRO DE LA ROSA (EL CERRO),3,183,84,99,9
MICHOACÁN DE OCAMPO,16,LOS REYES,075,ATAPAN,7,499,244,255,31
MICHOACÁN DE OCAMPO,16,LOS REYES,075,CHANIRO (XHANIRO),2,138,66,72,7
MICHOACÁN DE OCAMPO,16,LOS REYES,075,CHERATILLO,3,52,30,22,5
MICHOACÁN DE OCAMPO,16,LOS REYES,075,CHERATO,4,212,104,108,12
MICHOACÁN DE OCAMPO,16,LOS REYES,075,DIECIOCHO DE MARZO,2,32,15,17,2
MICHOACÁN DE OCAMPO,16,LOS REYES,075,IMBARÁCUARO,1,32,16,16,2
MICHOACÁN DE OCAMPO,16,LOS REYES,075,J. JESÚS DÍAZ TZIRIO,6,767,387,380,37
MICHOACÁN DE OCAMPO,16,LOS REYES,075,LA PALMA,5,198,98,100,14
MICHOACÁN DE OCAMPO,16,LOS REYES,075,LA TINAJA,2,209,108,101,9
MICHOACÁN DE OCAMPO,16,LOS REYES,075,LA ZARZAMORA,4,465,224,241,24
MICHOACÁN DE OCAMPO,16,LOS REYES,075,LOS LIMONES,3,243,130,113,13
MICHOACÁN DE OCAMPO,16,LOS REYES,075,LOS PALILLOS,5,185,103,82,12
MICHOACÁN DE OCAMPO,16,LOS REYES,075,LOS POZOS (TZIRIO CHICO),2,34,21,13,3
MICHOACÁN DE OCAMPO,16,LOS REYES,075,LOS REYES DE SALGADO,69,12843,6579,6264,797
MICHOACÁN DE OCAMPO,16,LOS REYES,075,ORUSCATO,3,64,26,38,6
MICHOACÁN DE OCAMPO,16,LOS REYES,075,PAMATÁCUARO,9,1344,653,691,79
MICHOACÁN DE OCAMPO,16,LOS REYES,075,QUERÉNDARO,2,62,26,36,5
MICHOACÁN DE OCAMPO,16,LOS REYES,075,SAN ANTONIO TIERRAS BLANCAS,4,392,193,199,22
MICHOACÁN DE OCAMPO,16,LOS REYES,075,SAN BENITO,4,482,245,237,23
MICHOACÁN DE OCAMPO,16,LOS REYES,075,SAN ISIDRO,5,675,327,348,31
MICHOACÁN DE OCAMPO,16,LOS REYES,075,SAN JOSÉ DE GRACIA,3,50,21,29,4
MICHOACÁN DE OCAMPO,16,LOS REYES,075,SAN LUIS (SURÉN),3,79,35,44,6
MICHOACÁN DE OCAMPO,16,LOS REYES,075,SAN MARCOS,2,11,4,7,2
MICHOACÁN DE OCAMPO,16,LOS REYES,075,SAN RAFAEL,4,288,147,141,12
MICHOACÁN DE OCAMPO,16,LOS REYES,075,SAN SEBASTIÁN,4,711,346,365,30
MICHOACÁN DE OCAMPO,16,LOS REYES,075,SANTA ROSA,6,334,144,190,15
MICHOACÁN DE OCAMPO,16,LOS REYES,075,SICUICHO,7,592,308,284,39
MICHOACÁN DE OCAMPO,16,LOS REYES,075,URINGUITIRO (SAN MARTÍN),4,290,147,143,12
MICHOACÁN DE OCAMPO,16,LOS REYES,075,ZACÁN,5,261,118,143,18
MICHOACÁN DE OCAMPO,16,SAHUAYO,076,EL AGUACATE (BARRANCA DEL AGUACATE),2,13,8,5,2
MICHOACÁN DE OCAMPO,16,SAHUAYO,076,EL GÜIRIO,2,28,19,9,2
MICHOACÁN DE OCAMPO,16,SAHUAYO,076,LA YERBABUENA,3,313,143,170,18
MICHOACÁN DE OCAMPO,16,SAHUAYO,076,LAS GALLINAS (EL POBLADO DE LAS GALLINAS),2,10,9,1,2
MICHOACÁN DE OCAMPO,16,SAHUAYO,076,LAS GALLINAS (LA HACIENDA),1,15,6,9,1
MICHOACÁN DE OCAMPO,16,SAHUAYO,076,SAHUAYO DE MORELOS,107,17287,8812,8475,1154
MICHOACÁN DE OCAMPO,16,SAHUAYO,076,TUNA MANZA,2,43,19,24,3
MICHOACÁN DE OCAMPO,16,SAN LUCAS,077,ANGAO (ANGAO DE LOS HERRERA),3,155,82,73,14
MICHOACÁN DE OCAMPO,16,SAN LUCAS,077,BUENA VISTA,2,22,11,11,3
MICHOACÁN DE OCAMPO,16,SAN LUCAS,077,CAPIRE VERDE,2,16,9,7,2
MICHOACÁN DE OCAMPO,16,SAN LUCAS,077,CEIBA SECA,2,30,14,16,3
MICHOACÁN DE OCAMPO,16,SAN LUCAS,077,CEIBAS ALTAS,1,24,10,14,2
MICHOACÁN DE OCAMPO,16,SAN LUCAS,077,CHARACHARANDO,3,53,25,28,4
MICHOACÁN DE OCAMPO,16,SAN LUCAS,077,CHUMBÍTARO,4,177,96,81,14
MICHOACÁN DE OCAMPO,16,SAN LUCAS,077,CORRAL VIEJO,2,20,9,11,4
MICHOACÁN DE OCAMPO,16,SAN LUCAS,077,CUAUHTÉMOC (HUARICHI),2,68,27,41,6
MICHOACÁN DE OCAMPO,16,SAN LUCAS,077,EL APARTADERO,1,5,0,5,1
MICHOACÁN DE OCAMPO,16,SAN LUCAS,077,EL CUAJILOTE,2,51,25,26,6
MICHOACÁN DE OCAMPO,16,SAN LUCAS,077,EL CUERAMO,2,44,19,25,5
MICHOACÁN DE OCAMPO,16,SAN LUCAS,077,EL MACHUQUE (PLAN DEL REPARO),4,90,50,40,10
MICHOACÁN DE OCAMPO,16,SAN LUCAS,077,EL NARANJO,1,12,6,6,1
MICHOACÁN DE OCAMPO,16,SAN LUCAS,077,EL TAMARINDO,1,7,2,5,1
MICHOACÁN DE OCAMPO,16,SAN LUCAS,077,LA ANGOSTURA DEL CANJE,1,6,3,3,2
MICHOACÁN DE OCAMPO,16,SAN LUCAS,077,LA CHICA,1,8,4,4,1
MICHOACÁN DE OCAMPO,16,SAN LUCAS,077,LA ESTANCIA,3,53,29,24,5
MICHOACÁN DE OCAMPO,16,SAN LUCAS,077,LA HUIZACHERA (EL HUIZACHAL),2,47,23,24,6
MICHOACÁN DE OCAMPO,16,SAN LUCAS,077,LA LAJA (LA LAJITA),2,23,12,11,2
MICHOACÁN DE OCAMPO,16,SAN LUCAS,077,LA MAGUEYERA (BARRIO DE LAS FLORES),1,12,6,6,4
MICHOACÁN DE OCAMPO,16,SAN LUCAS,077,LAS PAREDES,2,27,13,14,5
MICHOACÁN DE OCAMPO,16,SAN LUCAS,077,LIMÓN DE MONTE GRANDE,2,8,5,3,2
MICHOACÁN DE OCAMPO,16,SAN LUCAS,077,LOS BANCOS,2,41,20,21,3
MICHOACÁN DE OCAMPO,16,SAN LUCAS,077,LOS LIMONES Y ANEXOS,1,6,1,5,1
MICHOACÁN DE OCAMPO,16,SAN LUCAS,077,MONTE GRANDE,2,12,4,8,3
MICHOACÁN DE OCAMPO,16,SAN LUCAS,077,PASO DE CORUPO (CUIZILLO),3,79,41,38,8
MICHOACÁN DE OCAMPO,16,SAN LUCAS,077,PINZÁN COLORADO,2,23,10,13,3
MICHOACÁN DE OCAMPO,16,SAN LUCAS,077,QUERUTZEO (QUERUSEO),1,6,4,2,1
MICHOACÁN DE OCAMPO,16,SAN LUCAS,077,RINCÓN DE SAN FRANCISCO,1,12,5,7,1
MICHOACÁN DE OCAMPO,16,SAN LUCAS,077,SALGUERO,2,147,78,69,13
MICHOACÁN DE OCAMPO,16,SAN LUCAS,077,SAN JERÓNIMO,2,115,63,52,8
MICHOACÁN DE OCAMPO,16,SAN LUCAS,077,SAN LUCAS,13,1375,766,609,163
MICHOACÁN DE OCAMPO,16,SAN LUCAS,077,SAN NICOLÁS,2,30,11,19,3
MICHOACÁN DE OCAMPO,16,SAN LUCAS,077,SAN PEDRITO,3,73,36,37,6
MICHOACÁN DE OCAMPO,16,SAN LUCAS,077,SAN PEDRO EL GRANDE,2,20,7,13,6
MICHOACÁN DE OCAMPO,16,SAN LUCAS,077,SANTA CRUZ DE VILLA GÓMEZ,2,76,27,49,7
MICHOACÁN DE OCAMPO,16,SAN LUCAS,077,TACUPA,2,104,45,59,8
MICHOACÁN DE OCAMPO,16,SAN LUCAS,077,TERRERO PRIETO,3,64,33,31,7
MICHOACÁN DE OCAMPO,16,SAN LUCAS,077,TIRINGUEO DE ARRIBA,3,26,11,15,4
MICHOACÁN DE OCAMPO,16,SAN LUCAS,077,VICENTE RIVA PALACIO,7,1380,687,693,91
MICHOACÁN DE OCAMPO,16,SANTA ANA MAYA,078,EJIDO SAN RAFAEL (COLONIA BUENAVISTA),2,20,11,9,2
MICHOACÁN DE OCAMPO,16,SANTA ANA MAYA,078,EL CUERVO,3,36,17,19,6
MICHOACÁN DE OCAMPO,16,SANTA ANA MAYA,078,EL SALTO UNO,2,54,29,25,3
MICHOACÁN DE OCAMPO,16,SANTA ANA MAYA,078,EL TORONJO,3,212,105,107,14
MICHOACÁN DE OCAMPO,16,SANTA ANA MAYA,078,HUACAO,3,160,87,73,11
MICHOACÁN DE OCAMPO,16,SANTA ANA MAYA,078,LA LADERA (LA LUZ),2,18,6,12,2
MICHOACÁN DE OCAMPO,16,SANTA ANA MAYA,078,LA LOBERA,3,144,76,68,13
MICHOACÁN DE OCAMPO,16,SANTA ANA MAYA,078,MESA RICA,2,7,4,3,2
MICHOACÁN DE OCAMPO,16,SANTA ANA MAYA,078,POTZUNDAREO,2,35,17,18,3
MICHOACÁN DE OCAMPO,16,SANTA ANA MAYA,078,PUERTO DE CABRAS (PUERTO DE LA CRUZ),3,122,62,60,7
MICHOACÁN DE OCAMPO,16,SANTA ANA MAYA,078,SAN NICOLÁS CUIRITZEO,2,47,27,20,3
MICHOACÁN DE OCAMPO,16,SANTA ANA MAYA,078,SAN RAFAEL DEL CARRIZAL,4,195,96,99,15
MICHOACÁN DE OCAMPO,16,SANTA ANA MAYA,078,SANTA ANA MAYA,9,1670,857,813,90
MICHOACÁN DE OCAMPO,16,SALVADOR ESCALANTE,079,AGUA VERDE,3,118,58,60,7
MICHOACÁN DE OCAMPO,16,SALVADOR ESCALANTE,079,CAMÉMBARO,5,250,118,132,16
MICHOACÁN DE OCAMPO,16,SALVADOR ESCALANTE,079,CARATZITUMBIO,2,26,10,16,2
MICHOACÁN DE OCAMPO,16,SALVADOR ESCALANTE,079,CHAPA (CHAPA NUEVO),3,363,182,181,22
MICHOACÁN DE OCAMPO,16,SALVADOR ESCALANTE,079,COMIÉMBARO,3,34,15,19,3
MICHOACÁN DE OCAMPO,16,SALVADOR ESCALANTE,079,COPIO,1,27,12,15,2
MICHOACÁN DE OCAMPO,16,SALVADOR ESCALANTE,079,CUANAJILLO,3,103,51,52,7
MICHOACÁN DE OCAMPO,16,SALVADOR ESCALANTE,079,CUANGATZIO,3,103,52,51,8
MICHOACÁN DE OCAMPO,16,SALVADOR ESCALANTE,079,CUIRINDICHO (CURINDICHO),2,19,11,8,2
MICHOACÁN DE OCAMPO,16,SALVADOR ESCALANTE,079,CUITZITÁN,3,90,51,39,8
MICHOACÁN DE OCAMPO,16,SALVADOR ESCALANTE,079,CUNGO,2,97,48,49,7
MICHOACÁN DE OCAMPO,16,SALVADOR ESCALANTE,079,EL CARMEN,2,44,19,25,3
MICHOACÁN DE OCAMPO,16,SALVADOR ESCALANTE,079,EL GUAYABO,2,7,3,4,1
MICHOACÁN DE OCAMPO,16,SALVADOR ESCALANTE,079,EL JABALÍ,3,32,19,13,3
MICHOACÁN DE OCAMPO,16,SALVADOR ESCALANTE,079,EL QUERENDAL,2,33,14,19,3
MICHOACÁN DE OCAMPO,16,SALVADOR ESCALANTE,079,EL ROMERO,2,45,23,22,3
MICHOACÁN DE OCAMPO,16,SALVADOR ESCALANTE,079,EL TARASCÓN,3,127,73,54,10
MICHOACÁN DE OCAMPO,16,SALVADOR ESCALANTE,079,EL TEPETATE,3,160,77,83,10
MICHOACÁN DE OCAMPO,16,SALVADOR ESCALANTE,079,ESPAÑITA,2,35,20,15,3
MICHOACÁN DE OCAMPO,16,SALVADOR ESCALANTE,079,FELIPE TZINTZUN (LA MESA),3,153,72,81,10
MICHOACÁN DE OCAMPO,16,SALVADOR ESCALANTE,079,HUANIQUEO,1,22,7,15,2
MICHOACÁN DE OCAMPO,16,SALVADOR ESCALANTE,079,IRAMUCO,3,92,46,46,7
MICHOACÁN DE OCAMPO,16,SALVADOR ESCALANTE,079,IRÍCUARO (SAN MIGUEL),3,109,56,53,7
MICHOACÁN DE OCAMPO,16,SALVADOR ESCALANTE,079,IZTARO,5,592,326,266,27
MICHOACÁN DE OCAMPO,16,SALVADOR ESCALANTE,079,JUJÚCATO (EL GARBANZO),3,159,70,89,11
MICHOACÁN DE OCAMPO,16,SALVADOR ESCALANTE,079,LA CRUZ,2,13,4,9,2
MICHOACÁN DE OCAMPO,16,SALVADOR ESCALANTE,079,LA ESMERALDA (LA FÁBRICA),3,44,20,24,5
MICHOACÁN DE OCAMPO,16,SALVADOR ESCALANTE,079,LA POPOTERA,2,18,13,5,2
MICHOACÁN DE OCAMPO,16,SALVADOR ESCALANTE,079,LA QUERENDA,2,7,7,0,1
MICHOACÁN DE OCAMPO,16,SALVADOR ESCALANTE,079,LAS CHARANDAS,2,29,16,13,3
MICHOACÁN DE OCAMPO,16,SALVADOR ESCALANTE,079,LAS TROJES,1,8,3,5,1
MICHOACÁN DE OCAMPO,16,SALVADOR ESCALANTE,079,LOS CEDROS,1,27,13,14,2
MICHOACÁN DE OCAMPO,16,SALVADOR ESCALANTE,079,LOS MANZANILLOS,2,18,11,7,2
MICHOACÁN DE OCAMPO,16,SALVADOR ESCALANTE,079,MONTE GRANDE,2,41,17,24,3
MICHOACÁN DE OCAMPO,16,SALVADOR ESCALANTE,079,OPOPEO,15,2976,1500,1476,154
MICHOACÁN DE OCAMPO,16,SALVADOR ESCALANTE,079,PALMA DE SANDOVAL,3,90,48,42,6
MICHOACÁN DE OCAMPO,16,SALVADOR ESCALANTE,079,PARAMUÉN,3,459,203,256,28
MICHOACÁN DE OCAMPO,16,SALVADOR ESCALANTE,079,PASO DE CAMÉMBARO,1,18,11,7,2
MICHOACÁN DE OCAMPO,16,SALVADOR ESCALANTE,079,PASO DEL MUERTO,3,65,38,27,8
MICHOACÁN DE OCAMPO,16,SALVADOR ESCALANTE,079,PICUAREMBO,2,64,32,32,4
MICHOACÁN DE OCAMPO,16,SALVADOR ESCALANTE,079,PLUTARCO ELÍAS CALLES (COPÁNDARO),3,84,44,40,7
MICHOACÁN DE OCAMPO,16,SALVADOR ESCALANTE,079,PUENTE ALTO (LA LAGARTIJA),3,27,9,18,4
MICHOACÁN DE OCAMPO,16,SALVADOR ESCALANTE,079,PUNZUMARÁN,2,6,4,2,1
MICHOACÁN DE OCAMPO,16,SALVADOR ESCALANTE,079,SAN GREGORIO,3,382,175,207,20
MICHOACÁN DE OCAMPO,16,SALVADOR ESCALANTE,079,SAN JOSÉ CUANAJILLO,2,71,31,40,4
MICHOACÁN DE OCAMPO,16,SALVADOR ESCALANTE,079,SANTA ANA,2,98,53,45,5
MICHOACÁN DE OCAMPO,16,SALVADOR ESCALANTE,079,SANTA CLARA DEL COBRE,20,4372,2238,2134,186
MICHOACÁN DE OCAMPO,16,SALVADOR ESCALANTE,079,SANTA RITA,2,44,24,20,3
MICHOACÁN DE OCAMPO,16,SALVADOR ESCALANTE,079,SANTA ROSA,2,5,4,1,1
MICHOACÁN DE OCAMPO,16,SALVADOR ESCALANTE,079,TOLLONGUIO,2,14,8,6,2
MICHOACÁN DE OCAMPO,16,SALVADOR ESCALANTE,079,TURIÁN ALTO (TURIÁN EL ALTO),2,38,21,17,2
MICHOACÁN DE OCAMPO,16,SALVADOR ESCALANTE,079,TURIÁN BAJO (TURIÁN EL BAJO),3,103,57,46,6
MICHOACÁN DE OCAMPO,16,SALVADOR ESCALANTE,079,TURIRÁN,4,233,140,93,14
MICHOACÁN DE OCAMPO,16,SALVADOR ESCALANTE,079,TZINTZAMBA (LA SIZAMBA),2,62,28,34,3
MICHOACÁN DE OCAMPO,16,SALVADOR ESCALANTE,079,ZINAMBA,2,13,8,5,1
MICHOACÁN DE OCAMPO,16,SALVADOR ESCALANTE,079,ZIRAHUÉN,6,890,480,410,49
MICHOACÁN DE OCAMPO,16,SENGUIO,080,CACHIVI,3,105,50,55,7
MICHOACÁN DE OCAMPO,16,SENGUIO,080,CERRO DEL TECOMATE,2,39,25,14,3
MICHOACÁN DE OCAMPO,16,SENGUIO,080,CHINCUA (COLONIA EMILIANO ZAPATA),4,322,133,189,15
MICHOACÁN DE OCAMPO,16,SENGUIO,080,CUARTEL TERCERO (TUPÁTARO),2,273,123,150,13
MICHOACÁN DE OCAMPO,16,SENGUIO,080,EL CALABOZO PRIMERA FRACCIÓN,3,371,189,182,17
MICHOACÁN DE OCAMPO,16,SENGUIO,080,EL CALABOZO SEGUNDA FRACCIÓN,3,53,23,30,3
MICHOACÁN DE OCAMPO,16,SENGUIO,080,EL HUÉRFANO (EMILIANO ZAPATA),2,61,29,32,3
MICHOACÁN DE OCAMPO,16,SENGUIO,080,EL PUERTO,2,10,6,4,2
MICHOACÁN DE OCAMPO,16,SENGUIO,080,EL SALITRILLO,3,50,31,19,4
MICHOACÁN DE OCAMPO,16,SENGUIO,080,EL TEJOCOTE,2,76,39,37,4
MICHOACÁN DE OCAMPO,16,SENGUIO,080,EMILIANO ZAPATA (LA CUAJADA),2,44,22,22,3
MICHOACÁN DE OCAMPO,16,SENGUIO,080,EX-HACIENDA DE SOTO,2,172,85,87,9
MICHOACÁN DE OCAMPO,16,SENGUIO,080,GUADALUPE (RANCHO DE GUADALUPE),2,12,6,6,1
MICHOACÁN DE OCAMPO,16,SENGUIO,080,HACIENDA DE SAN ANTONIO (SEGUNDA DE SAN ANTONIO),4,134,71,63,6
MICHOACÁN DE OCAMPO,16,SENGUIO,080,JOSÉ MARÍA MORELOS (MANZANA GUADALUPE),3,347,173,174,18
MICHOACÁN DE OCAMPO,16,SENGUIO,080,LA CAPILLA DE OCOTLÁN,2,29,15,14,2
MICHOACÁN DE OCAMPO,16,SENGUIO,080,LA LAGUNITA,2,13,4,9,2
MICHOACÁN DE OCAMPO,16,SENGUIO,080,LA LOMA,1,22,13,9,1
MICHOACÁN DE OCAMPO,16,SENGUIO,080,LAS CRUCES,3,46,30,16,5
MICHOACÁN DE OCAMPO,16,SENGUIO,080,LOS AILES (RÍO DE LOS AILES),2,95,49,46,5
MICHOACÁN DE OCAMPO,16,SENGUIO,080,LOS SAUCES,2,99,56,43,6
MICHOACÁN DE OCAMPO,16,SENGUIO,080,MANZANA DE CARINDAPAZ UNO,3,63,30,33,5
MICHOACÁN DE OCAMPO,16,SENGUIO,080,MILPILLAS,2,11,3,8,2
MICHOACÁN DE OCAMPO,16,SENGUIO,080,PICHARDO PEÑA BLANCA,2,144,58,86,7
MICHOACÁN DE OCAMPO,16,SENGUIO,080,PRESA QUEBRADA,1,7,3,4,1
MICHOACÁN DE OCAMPO,16,SENGUIO,080,ROSA AZUL,2,82,42,40,4
MICHOACÁN DE OCAMPO,16,SENGUIO,080,SAN ANTONIO PRIMERA FRACCIÓN,3,84,42,42,4
MICHOACÁN DE OCAMPO,16,SENGUIO,080,SAN JOSÉ SOTO,3,168,78,90,9
MICHOACÁN DE OCAMPO,16,SENGUIO,080,SAN JUAN HUERTA,5,218,126,92,12
MICHOACÁN DE OCAMPO,16,SENGUIO,080,SAN NICOLÁS TARIMORO,2,41,17,24,3
MICHOACÁN DE OCAMPO,16,SENGUIO,080,SAN RAFAEL (EL TOTE) [RANCHO],1,8,1,7,1
MICHOACÁN DE OCAMPO,16,SENGUIO,080,SENGUIO,6,1152,610,542,81
MICHOACÁN DE OCAMPO,16,SENGUIO,080,TARIMORO,1,18,8,10,1
MICHOACÁN DE OCAMPO,16,SENGUIO,080,TARIMORO VILLAMAR,2,13,7,6,2
MICHOACÁN DE OCAMPO,16,SENGUIO,080,TUPÁTARO,6,587,311,276,30
MICHOACÁN DE OCAMPO,16,SUSUPUATO,081,COPÁNDARO (SANTIAGO),4,234,122,112,16
MICHOACÁN DE OCAMPO,16,SUSUPUATO,081,DOLORES (EX-HACIENDA DE DOLORES),4,258,132,126,16
MICHOACÁN DE OCAMPO,16,SUSUPUATO,081,EL BONETE,3,22,16,6,3
MICHOACÁN DE OCAMPO,16,SUSUPUATO,081,EL CARRIZAL,2,19,10,9,2
MICHOACÁN DE OCAMPO,16,SUSUPUATO,081,EL ESTANCO,1,14,4,10,1
MICHOACÁN DE OCAMPO,16,SUSUPUATO,081,EL HONDABLE,1,20,13,7,1
MICHOACÁN DE OCAMPO,16,SUSUPUATO,081,EL LLANO DEL CONEJO,1,7,4,3,1
MICHOACÁN DE OCAMPO,16,SUSUPUATO,081,EL NARANJO (LOS LIMONES),4,122,53,69,8
MICHOACÁN DE OCAMPO,16,SUSUPUATO,081,EL RINCÓN,2,40,23,17,3
MICHOACÁN DE OCAMPO,16,SUSUPUATO,081,EL SALITRE,2,16,10,6,3
MICHOACÁN DE OCAMPO,16,SUSUPUATO,081,EL SALTO,2,37,21,16,2
MICHOACÁN DE OCAMPO,16,SUSUPUATO,081,EL TANQUE,2,27,12,15,2
MICHOACÁN DE OCAMPO,16,SUSUPUATO,081,EL TREMESINO,2,92,46,46,9
MICHOACÁN DE OCAMPO,16,SUSUPUATO,081,GENGUARO,2,36,18,18,2
MICHOACÁN DE OCAMPO,16,SUSUPUATO,081,GUAYABO CHICO,3,35,18,17,4
MICHOACÁN DE OCAMPO,16,SUSUPUATO,081,LA CAÑADA,1,4,1,3,1
MICHOACÁN DE OCAMPO,16,SUSUPUATO,081,LA LOMA,1,34,13,21,2
MICHOACÁN DE OCAMPO,16,SUSUPUATO,081,LA LOMA (LOS HOYOS),1,8,6,2,1
MICHOACÁN DE OCAMPO,16,SUSUPUATO,081,LA PALMA,2,24,10,14,3
MICHOACÁN DE OCAMPO,16,SUSUPUATO,081,LA PLUMA,1,10,4,6,1
MICHOACÁN DE OCAMPO,16,SUSUPUATO,081,LAS LAJAS,1,18,10,8,2
MICHOACÁN DE OCAMPO,16,SUSUPUATO,081,LAS MARAVILLAS,2,92,47,45,5
MICHOACÁN DE OCAMPO,16,SUSUPUATO,081,LOS GUAJES,2,44,24,20,3
MICHOACÁN DE OCAMPO,16,SUSUPUATO,081,MESA GRANDE (MESA DEL ZACATÓN),1,5,2,3,1
MICHOACÁN DE OCAMPO,16,SUSUPUATO,081,MESA RICA,2,38,22,16,3
MICHOACÁN DE OCAMPO,16,SUSUPUATO,081,PUERTO DEL CERRO PELÓN (PUERTO DE SUSUPUATO),2,4,3,1,2
MICHOACÁN DE OCAMPO,16,SUSUPUATO,081,RANCHO VIEJO,4,340,175,165,17
MICHOACÁN DE OCAMPO,16,SUSUPUATO,081,SUSUPUATO DE GUERRERO,4,292,173,119,19
MICHOACÁN DE OCAMPO,16,TACÁMBARO,082,BUENAVISTA,1,13,9,4,1
MICHOACÁN DE OCAMPO,16,TACÁMBARO,082,CANÍCUARO,2,113,64,49,5
MICHOACÁN DE OCAMPO,16,TACÁMBARO,082,CARACHA,2,91,41,50,5
MICHOACÁN DE OCAMPO,16,TACÁMBARO,082,CARAMÉCUARO,2,54,22,32,3
MICHOACÁN DE OCAMPO,16,TACÁMBARO,082,CHARAPIO,1,6,2,4,1
MICHOACÁN DE OCAMPO,16,TACÁMBARO,082,CHIPÍCUARO,2,65,35,30,3
MICHOACÁN DE OCAMPO,16,TACÁMBARO,082,CHUPIO,4,647,305,342,57
MICHOACÁN DE OCAMPO,16,TACÁMBARO,082,CHURUMUCO,2,72,28,44,3
MICHOACÁN DE OCAMPO,16,TACÁMBARO,082,CÓPITERO,4,323,158,165,16
MICHOACÁN DE OCAMPO,16,TACÁMBARO,082,CRUZ DEL PLATO,2,38,23,15,2
MICHOACÁN DE OCAMPO,16,TACÁMBARO,082,CRUZ GORDA,3,115,64,51,8
MICHOACÁN DE OCAMPO,16,TACÁMBARO,082,EL ATASCOSO,2,36,19,17,3
MICHOACÁN DE OCAMPO,16,TACÁMBARO,082,EL CIRIÁN,2,6,3,3,2
MICHOACÁN DE OCAMPO,16,TACÁMBARO,082,EL COLORÍN GRANDE,2,97,44,53,4
MICHOACÁN DE OCAMPO,16,TACÁMBARO,082,EL CONEJO,2,27,12,15,2
MICHOACÁN DE OCAMPO,16,TACÁMBARO,082,EL DURAZNO,3,151,82,69,9
MICHOACÁN DE OCAMPO,16,TACÁMBARO,082,EL GIGANTE,2,281,137,144,12
MICHOACÁN DE OCAMPO,16,TACÁMBARO,082,EL MAYORAZGO,3,158,89,69,9
MICHOACÁN DE OCAMPO,16,TACÁMBARO,082,EL PANTANO (EL CUIJE),1,36,16,20,2
MICHOACÁN DE OCAMPO,16,TACÁMBARO,082,EL PEDREGOSO,3,138,68,70,8
MICHOACÁN DE OCAMPO,16,TACÁMBARO,082,EL RINCÓN DE SHÓRICUARO,1,18,6,12,2
MICHOACÁN DE OCAMPO,16,TACÁMBARO,082,EL SALTO,2,25,18,7,2
MICHOACÁN DE OCAMPO,16,TACÁMBARO,082,EL TERRERO,2,137,68,69,8
MICHOACÁN DE OCAMPO,16,TACÁMBARO,082,HACIENDA LA PEQUEÑITA,2,76,41,35,4
MICHOACÁN DE OCAMPO,16,TACÁMBARO,082,JOYA DE CHARAPIO,3,31,17,14,3
MICHOACÁN DE OCAMPO,16,TACÁMBARO,082,JOYA DE LA VIHUELA,3,199,90,109,10
MICHOACÁN DE OCAMPO,16,TACÁMBARO,082,LA CUCHA,2,37,18,19,2
MICHOACÁN DE OCAMPO,16,TACÁMBARO,082,LA GUARDIA,2,138,69,69,7
MICHOACÁN DE OCAMPO,16,TACÁMBARO,082,LA IGLESIA VIEJA,1,4,1,3,1
MICHOACÁN DE OCAMPO,16,TACÁMBARO,082,LA LOMA,3,182,83,99,11
MICHOACÁN DE OCAMPO,16,TACÁMBARO,082,LA PITAYA DE COPITERO,2,29,22,7,3
MICHOACÁN DE OCAMPO,16,TACÁMBARO,082,LA SOLEDAD,1,6,1,5,1
MICHOACÁN DE OCAMPO,16,TACÁMBARO,082,LA TIJERA,2,13,9,4,2
MICHOACÁN DE OCAMPO,16,TACÁMBARO,082,LA TINAJA,1,8,2,6,1
MICHOACÁN DE OCAMPO,16,TACÁMBARO,082,LA VIÑA,1,33,22,11,2
MICHOACÁN DE OCAMPO,16,TACÁMBARO,082,LA YÁCATA,3,384,168,216,15
MICHOACÁN DE OCAMPO,16,TACÁMBARO,082,LA YERBABUENA,3,26,13,13,3
MICHOACÁN DE OCAMPO,16,TACÁMBARO,082,LAS JOYAS (EL POBLADO),3,269,142,127,21
MICHOACÁN DE OCAMPO,16,TACÁMBARO,082,LAS JOYAS ALTAS,2,121,58,63,8
MICHOACÁN DE OCAMPO,16,TACÁMBARO,082,LAS LATAS,2,70,36,34,4
MICHOACÁN DE OCAMPO,16,TACÁMBARO,082,LOS CAJONES,1,4,1,3,1
MICHOACÁN DE OCAMPO,16,TACÁMBARO,082,LOS COYOTES,2,38,22,16,2
MICHOACÁN DE OCAMPO,16,TACÁMBARO,082,LOS GUAYABOS,1,5,4,1,1
MICHOACÁN DE OCAMPO,16,TACÁMBARO,082,LOS MORALES,2,57,31,26,3
MICHOACÁN DE OCAMPO,16,TACÁMBARO,082,LOS PLANES,1,3,1,2,1
MICHOACÁN DE OCAMPO,16,TACÁMBARO,082,LOS SAUCES,1,6,3,3,1
MICHOACÁN DE OCAMPO,16,TACÁMBARO,082,OJO DE AGUA DE CHUPIO (LA NORIA),4,204,115,89,11
MICHOACÁN DE OCAMPO,16,TACÁMBARO,082,PAROCHO (LAS PAREDES),3,112,61,51,7
MICHOACÁN DE OCAMPO,16,TACÁMBARO,082,PASO DE MORELOS (LA PAROTITA),4,387,194,193,19
MICHOACÁN DE OCAMPO,16,TACÁMBARO,082,PASO DE SERRANO (LA FUNDICIÓN),2,32,14,18,2
MICHOACÁN DE OCAMPO,16,TACÁMBARO,082,PEDERNALES,9,1564,786,778,92
MICHOACÁN DE OCAMPO,16,TACÁMBARO,082,PETEMBO,3,122,52,70,9
MICHOACÁN DE OCAMPO,16,TACÁMBARO,082,PIEDRA DEL MOLINO,2,47,22,25,4
MICHOACÁN DE OCAMPO,16,TACÁMBARO,082,PLAN DE LA CÁRCEL (PUENTE DEL EJE),2,61,29,32,3
MICHOACÁN DE OCAMPO,16,TACÁMBARO,082,PLAZA DE GALLOS,2,96,44,52,5
MICHOACÁN DE OCAMPO,16,TACÁMBARO,082,PUEBLO VIEJO DE TECARIO,1,22,12,10,1
MICHOACÁN DE OCAMPO,16,TACÁMBARO,082,PUENTE DE ÁNIMAS,3,162,82,80,9
MICHOACÁN DE OCAMPO,16,TACÁMBARO,082,PUENTE DE SAN ANDRÉS,2,58,31,27,3
MICHOACÁN DE OCAMPO,16,TACÁMBARO,082,PUENTE DE TIERRA,2,52,26,26,3
MICHOACÁN DE OCAMPO,16,TACÁMBARO,082,PUENTE EL ZAPOTE,2,47,24,23,2
MICHOACÁN DE OCAMPO,16,TACÁMBARO,082,QUITERIO,2,65,34,31,5
MICHOACÁN DE OCAMPO,16,TACÁMBARO,082,SAN AGUSTÍN,2,82,46,36,3
MICHOACÁN DE OCAMPO,16,TACÁMBARO,082,SAN ANTONIO BUENAVISTA,2,12,6,6,2
MICHOACÁN DE OCAMPO,16,TACÁMBARO,082,SAN ANTONIO DE VIÑA,2,199,89,110,8
MICHOACÁN DE OCAMPO,16,TACÁMBARO,082,SAN JERÓNIMO (LA MESA REDONDA),1,4,1,3,1
MICHOACÁN DE OCAMPO,16,TACÁMBARO,082,SAN JERÓNIMO ARROYO DE APO (HUATZANGUÍO),2,19,7,12,2
MICHOACÁN DE OCAMPO,16,TACÁMBARO,082,SAN JOSÉ ARAMÚTARO,1,35,14,21,2
MICHOACÁN DE OCAMPO,16,TACÁMBARO,082,SAN JOSÉ BUENAVISTA (MESA DE TAMÁCUARO),2,54,31,23,4
MICHOACÁN DE OCAMPO,16,TACÁMBARO,082,SAN JOSÉ CHICO,2,42,27,15,2
MICHOACÁN DE OCAMPO,16,TACÁMBARO,082,SAN JOSÉ DE LOS LAURELES,2,99,48,51,5
MICHOACÁN DE OCAMPO,16,TACÁMBARO,082,SAN JOSÉ GRANDE,2,73,41,32,4
MICHOACÁN DE OCAMPO,16,TACÁMBARO,082,SAN JUAN DE VIÑA,4,851,432,419,51
MICHOACÁN DE OCAMPO,16,TACÁMBARO,082,SAN JUAN TECARIO,2,138,58,80,7
MICHOACÁN DE OCAMPO,16,TACÁMBARO,082,SAN LORENZO,1,80,36,44,4
MICHOACÁN DE OCAMPO,16,TACÁMBARO,082,SAN MIGUEL TAMÁCUARO,3,195,83,112,11
MICHOACÁN DE OCAMPO,16,TACÁMBARO,082,SAN RAFAEL LEJÍA,3,97,50,47,7
MICHOACÁN DE OCAMPO,16,TACÁMBARO,082,SAN RAFAEL TECARIO (EL POBLADO),4,631,322,309,28
MICHOACÁN DE OCAMPO,16,TACÁMBARO,082,SAN VICENTE,2,25,9,16,2
MICHOACÁN DE OCAMPO,16,TACÁMBARO,082,SAN VICENTE COFRADÍA,2,64,34,30,3
MICHOACÁN DE OCAMPO,16,TACÁMBARO,082,SANTA PAULA,2,71,34,37,4
MICHOACÁN DE OCAMPO,16,TACÁMBARO,082,SANTA RITA,1,5,1,4,1
MICHOACÁN DE OCAMPO,16,TACÁMBARO,082,SANTA RITA PRIMERA,3,263,122,141,11
MICHOACÁN DE OCAMPO,16,TACÁMBARO,082,SANTA RITA SEGUNDA,2,101,51,50,5
MICHOACÁN DE OCAMPO,16,TACÁMBARO,082,SANTAS MARÍAS,3,277,149,128,16
MICHOACÁN DE OCAMPO,16,TACÁMBARO,082,SERRANO,4,381,216,165,15
MICHOACÁN DE OCAMPO,16,TACÁMBARO,082,SOPOMIO,2,28,13,15,2
MICHOACÁN DE OCAMPO,16,TACÁMBARO,082,TACÁMBARO DE CODALLOS,37,8965,4543,4422,464
MICHOACÁN DE OCAMPO,16,TACÁMBARO,082,TECARIO,7,1975,977,998,106
MICHOACÁN DE OCAMPO,16,TACÁMBARO,082,TESTERAZO,3,233,110,123,14
MICHOACÁN DE OCAMPO,16,TACÁMBARO,082,TIRIAPO,2,58,29,29,3
MICHOACÁN DE OCAMPO,16,TACÁMBARO,082,UPANGUARO,2,29,13,16,2
MICHOACÁN DE OCAMPO,16,TACÁMBARO,082,YORICOSTIO (LA VILLITA),4,557,290,267,26
MICHOACÁN DE OCAMPO,16,TANCÍTARO,083,ACÚMBARO,2,27,16,11,2
MICHOACÁN DE OCAMPO,16,TANCÍTARO,083,AGUA DE CHEPE,3,51,28,23,4
MICHOACÁN DE OCAMPO,16,TANCÍTARO,083,AGUA NUEVA,2,56,33,23,3
MICHOACÁN DE OCAMPO,16,TANCÍTARO,083,AGUA ZARCA,6,313,165,148,17
MICHOACÁN DE OCAMPO,16,TANCÍTARO,083,AGUACATE DEL SUR,2,127,70,57,6
MICHOACÁN DE OCAMPO,16,TANCÍTARO,083,APO,3,419,231,188,19
MICHOACÁN DE OCAMPO,16,TANCÍTARO,083,APÚNDARO,2,114,70,44,7
MICHOACÁN DE OCAMPO,16,TANCÍTARO,083,ARAPARÍCUARO (APARÍCUARO),2,196,95,101,9
MICHOACÁN DE OCAMPO,16,TANCÍTARO,083,BARRANQUILLAS (RINCÓN DE BARRANQUILLAS),3,223,117,106,10
MICHOACÁN DE OCAMPO,16,TANCÍTARO,083,CHIRIMOYO,1,5,1,4,1
MICHOACÁN DE OCAMPO,16,TANCÍTARO,083,CHORITIRO,1,109,60,49,5
MICHOACÁN DE OCAMPO,16,TANCÍTARO,083,COLONIA SAN ANTONIO,2,18,9,9,2
MICHOACÁN DE OCAMPO,16,TANCÍTARO,083,CONDÉMBARO,2,511,261,250,17
MICHOACÁN DE OCAMPO,16,TANCÍTARO,083,EL AGUACATE PONIENTE,1,48,25,23,2
MICHOACÁN DE OCAMPO,16,TANCÍTARO,083,EL CAHULOTE,1,15,6,9,1
MICHOACÁN DE OCAMPO,16,TANCÍTARO,083,EL CAPULÍN,1,4,4,0,1
MICHOACÁN DE OCAMPO,16,TANCÍTARO,083,EL CARRIZAL,2,29,18,11,2
MICHOACÁN DE OCAMPO,16,TANCÍTARO,083,EL CHILAR,1,25,9,16,2
MICHOACÁN DE OCAMPO,16,TANCÍTARO,083,EL CHUPADERO,2,33,14,19,2
MICHOACÁN DE OCAMPO,16,TANCÍTARO,083,EL CORTIJO,3,55,26,29,3
MICHOACÁN DE OCAMPO,16,TANCÍTARO,083,EL CUATE,2,112,54,58,6
MICHOACÁN DE OCAMPO,16,TANCÍTARO,083,EL JACAL,2,37,20,17,3
MICHOACÁN DE OCAMPO,16,TANCÍTARO,083,EL MORAL (LA MORA),1,7,3,4,1
MICHOACÁN DE OCAMPO,16,TANCÍTARO,083,EL PALMITO DEL SUR,1,18,6,12,2
MICHOACÁN DE OCAMPO,16,TANCÍTARO,083,EL PINABETE,1,17,9,8,1
MICHOACÁN DE OCAMPO,16,TANCÍTARO,083,EL REPARO (LA PRESA EL REPARO),2,15,5,10,3
MICHOACÁN DE OCAMPO,16,TANCÍTARO,083,EL TEPAMO,2,10,7,3,1
MICHOACÁN DE OCAMPO,16,TANCÍTARO,083,EL TEPEHUAJE,1,6,3,3,1
MICHOACÁN DE OCAMPO,16,TANCÍTARO,083,EL TIZATE,1,43,23,20,2
MICHOACÁN DE OCAMPO,16,TANCÍTARO,083,EL ZAPOTE,2,87,43,44,3
MICHOACÁN DE OCAMPO,16,TANCÍTARO,083,ENÁNDIRO,2,42,18,24,3
MICHOACÁN DE OCAMPO,16,TANCÍTARO,083,GARACHICO,2,35,21,14,2
MICHOACÁN DE OCAMPO,16,TANCÍTARO,083,HUARICHO,2,12,6,6,1
MICHOACÁN DE OCAMPO,16,TANCÍTARO,083,LA ALBERCA,3,28,14,14,3
MICHOACÁN DE OCAMPO,16,TANCÍTARO,083,LA LAGUNILLA,1,49,25,24,2
MICHOACÁN DE OCAMPO,16,TANCÍTARO,083,LA MESA DEL DURAZNO,2,35,17,18,2
MICHOACÁN DE OCAMPO,16,TANCÍTARO,083,LA PEÑITA,2,47,23,24,3
MICHOACÁN DE OCAMPO,16,TANCÍTARO,083,LA SOLEDAD,2,28,13,15,2
MICHOACÁN DE OCAMPO,16,TANCÍTARO,083,LA TINAJA,3,39,16,23,5
MICHOACÁN DE OCAMPO,16,TANCÍTARO,083,LAS CANOAS,2,24,9,15,3
MICHOACÁN DE OCAMPO,16,TANCÍTARO,083,LAS JUNTAS DE ENÁNDIRO,2,19,7,12,2
MICHOACÁN DE OCAMPO,16,TANCÍTARO,083,LOS FRESNOS,2,141,68,73,8
MICHOACÁN DE OCAMPO,16,TANCÍTARO,083,LOS GRANADOS,2,45,27,18,3
MICHOACÁN DE OCAMPO,16,TANCÍTARO,083,LOS LLANITOS,2,11,9,2,2
MICHOACÁN DE OCAMPO,16,TANCÍTARO,083,LOS OJOS DE AGUA,1,7,3,4,1
MICHOACÁN DE OCAMPO,16,TANCÍTARO,083,OJO DE AGUA (EL OJO DE AGUA DEL PALMITO),1,10,7,3,1
MICHOACÁN DE OCAMPO,16,TANCÍTARO,083,OJO ZARCO,3,69,35,34,5
MICHOACÁN DE OCAMPO,16,TANCÍTARO,083,PALO PICADO,2,11,7,4,2
MICHOACÁN DE OCAMPO,16,TANCÍTARO,083,PANZINDA,2,14,6,8,2
MICHOACÁN DE OCAMPO,16,TANCÍTARO,083,PAREO,6,767,400,367,50
MICHOACÁN DE OCAMPO,16,TANCÍTARO,083,PATÁMBURO,2,28,13,15,2
MICHOACÁN DE OCAMPO,16,TANCÍTARO,083,PÚCUARO,2,66,36,30,4
MICHOACÁN DE OCAMPO,16,TANCÍTARO,083,RANCHO NUEVO,3,88,47,41,5
MICHOACÁN DE OCAMPO,16,TANCÍTARO,083,SANTA CATARINA,2,214,106,108,11
MICHOACÁN DE OCAMPO,16,TANCÍTARO,083,SOLEDAD DEL PONIENTE,2,87,39,48,4
MICHOACÁN DE OCAMPO,16,TANCÍTARO,083,TANCÍTARO,18,3602,1832,1770,222
MICHOACÁN DE OCAMPO,16,TANCÍTARO,083,URINGÜITIRO,3,218,123,95,9
MICHOACÁN DE OCAMPO,16,TANCÍTARO,083,ZIRIMBO,1,143,72,71,5
MICHOACÁN DE OCAMPO,16,TANCÍTARO,083,ZIRIMONDIRO,2,268,138,130,10
MICHOACÁN DE OCAMPO,16,TANCÍTARO,083,ZOROMÚTARO (PUERTO DE ZOROMÚTARO),2,31,16,15,3
MICHOACÁN DE OCAMPO,16,TANGAMANDAPIO,084,CHURINTZIO,2,126,62,64,8
MICHOACÁN DE OCAMPO,16,TANGAMANDAPIO,084,EL CEREZO,1,22,15,7,2
MICHOACÁN DE OCAMPO,16,TANGAMANDAPIO,084,EL GUAYABO,1,7,3,4,1
MICHOACÁN DE OCAMPO,16,TANGAMANDAPIO,084,EL NOPALITO,2,13,7,6,2
MICHOACÁN DE OCAMPO,16,TANGAMANDAPIO,084,EL SAUCILLO,3,99,46,53,5
MICHOACÁN DE OCAMPO,16,TANGAMANDAPIO,084,HUARACHANILLO DE ABAJO,1,12,3,9,1
MICHOACÁN DE OCAMPO,16,TANGAMANDAPIO,084,LA CANTERA,8,1274,674,600,63
MICHOACÁN DE OCAMPO,16,TANGAMANDAPIO,084,LAS ENCINILLAS,2,13,5,8,2
MICHOACÁN DE OCAMPO,16,TANGAMANDAPIO,084,LOS HUCUARES,4,244,102,142,14
MICHOACÁN DE OCAMPO,16,TANGAMANDAPIO,084,PASO DEL MOLINO,3,76,35,41,5
MICHOACÁN DE OCAMPO,16,TANGAMANDAPIO,084,QUERÉNGUARO,3,145,81,64,9
MICHOACÁN DE OCAMPO,16,TANGAMANDAPIO,084,SANTIAGO TANGAMANDAPIO,14,2661,1326,1335,151
MICHOACÁN DE OCAMPO,16,TANGAMANDAPIO,084,TARECUATO,17,3300,1644,1656,135
MICHOACÁN DE OCAMPO,16,TANGAMANDAPIO,084,TELONZO,2,168,88,80,9
MICHOACÁN DE OCAMPO,16,TANGANCÍCUARO,085,ADOLFO RUIZ CORTINES (CAPRICHO),4,334,176,158,17
MICHOACÁN DE OCAMPO,16,TANGANCÍCUARO,085,ARANZA,3,154,78,76,13
MICHOACÁN DE OCAMPO,16,TANGANCÍCUARO,085,BUENA VISTA,2,67,29,38,4
MICHOACÁN DE OCAMPO,16,TANGANCÍCUARO,085,ETÚCUARO,3,251,127,124,13
MICHOACÁN DE OCAMPO,16,TANGANCÍCUARO,085,FRANCISCO J. MÚJICA (LA GUARACHA),2,36,22,14,3
MICHOACÁN DE OCAMPO,16,TANGANCÍCUARO,085,GENERAL DÁMASO CÁRDENAS (PÁRAMO),3,153,75,78,10
MICHOACÁN DE OCAMPO,16,TANGANCÍCUARO,085,GÓMEZ FARÍAS,3,186,92,94,11
MICHOACÁN DE OCAMPO,16,TANGANCÍCUARO,085,GUARACHANILLO (GUARACHANILLO DE ARRIBA),1,29,13,16,1
MICHOACÁN DE OCAMPO,16,TANGANCÍCUARO,085,LAS MALVINAS (ANTORCHA)[COLONIA],2,74,37,37,4
MICHOACÁN DE OCAMPO,16,TANGANCÍCUARO,085,LAS ORDEÑAS,2,32,15,17,3
MICHOACÁN DE OCAMPO,16,TANGANCÍCUARO,085,LOS LOBOS,4,175,89,86,12
MICHOACÁN DE OCAMPO,16,TANGANCÍCUARO,085,PATAMBAN (PATAMBAM),7,963,472,491,50
MICHOACÁN DE OCAMPO,16,TANGANCÍCUARO,085,SAN ANTONIO OCAMPO,5,147,73,74,9
MICHOACÁN DE OCAMPO,16,TANGANCÍCUARO,085,SAN JOSÉ DE GRACIA (SAN JOSÉ OCUMICHO),3,169,78,91,10
MICHOACÁN DE OCAMPO,16,TANGANCÍCUARO,085,SAUZ DE GUZMÁN,3,182,98,84,10
MICHOACÁN DE OCAMPO,16,TANGANCÍCUARO,085,TANGANCÍCUARO DE ARISTA,32,4688,2419,2269,287
MICHOACÁN DE OCAMPO,16,TANGANCÍCUARO,085,TENGÜECHO,4,371,190,181,20
MICHOACÁN DE OCAMPO,16,TANGANCÍCUARO,085,TIERRAS BLANCAS,2,93,46,47,7
MICHOACÁN DE OCAMPO,16,TANGANCÍCUARO,085,VALLE DE GUADALUPE,4,165,91,74,16
MICHOACÁN DE OCAMPO,16,TANHUATO,086,EL CALVARIO (EL BARRENO),2,184,87,97,8
MICHOACÁN DE OCAMPO,16,TANHUATO,086,LA PRESA,1,15,8,7,1
MICHOACÁN DE OCAMPO,16,TANHUATO,086,LAS CIENEGUITAS,4,266,138,128,13
MICHOACÁN DE OCAMPO,16,TANHUATO,086,LOS CHARCOS,3,236,116,120,12
MICHOACÁN DE OCAMPO,16,TANHUATO,086,RANCHO NUEVO,2,28,14,14,2
MICHOACÁN DE OCAMPO,16,TANHUATO,086,SAN JOSÉ DE VARGAS,3,87,40,47,6
MICHOACÁN DE OCAMPO,16,TANHUATO,086,TANHUATO DE GUERRERO,14,1941,976,965,89
MICHOACÁN DE OCAMPO,16,TANHUATO,086,TARIMORO,3,201,93,108,9
MICHOACÁN DE OCAMPO,16,TANHUATO,086,TINAJA DE VARGAS,3,137,73,64,9
MICHOACÁN DE OCAMPO,16,TANHUATO,086,VILLANUEVA (VILLA NUEVA),2,107,55,52,6
MICHOACÁN DE OCAMPO,16,TARETAN,087,CHUPANGUÍO,1,53,28,25,3
MICHOACÁN DE OCAMPO,16,TARETAN,087,EL GUAYABO (HUERTA SANTA ANA),2,36,16,20,3
MICHOACÁN DE OCAMPO,16,TARETAN,087,EL HOYO DEL AIRE,3,93,48,45,7
MICHOACÁN DE OCAMPO,16,TARETAN,087,EL PINO,2,79,47,32,4
MICHOACÁN DE OCAMPO,16,TARETAN,087,EL TAREPE,1,8,4,4,1
MICHOACÁN DE OCAMPO,16,TARETAN,087,EMILIANO ZAPATA,1,58,33,25,3
MICHOACÁN DE OCAMPO,16,TARETAN,087,LA FLORIDA,2,100,52,48,9
MICHOACÁN DE OCAMPO,16,TARETAN,087,LA LAGUNILLA,2,9,5,4,1
MICHOACÁN DE OCAMPO,16,TARETAN,087,LA PURÍSIMA,3,140,80,60,11
MICHOACÁN DE OCAMPO,16,TARETAN,087,MESA DE CÁZAREZ,3,127,59,68,9
MICHOACÁN DE OCAMPO,16,TARETAN,087,PRESA SAN JUAN,2,5,2,3,1
MICHOACÁN DE OCAMPO,16,TARETAN,087,RANCHO SECO,3,140,57,83,10
MICHOACÁN DE OCAMPO,16,TARETAN,087,SAN JOAQUÍN,1,25,9,16,2
MICHOACÁN DE OCAMPO,16,TARETAN,087,TAHUEJO,3,163,85,78,12
MICHOACÁN DE OCAMPO,16,TARETAN,087,TARETAN,14,2506,1270,1236,148
MICHOACÁN DE OCAMPO,16,TARETAN,087,TERRENATE,2,24,16,8,3
MICHOACÁN DE OCAMPO,16,TARETAN,087,TOMENDÁN,5,559,282,277,32
MICHOACÁN DE OCAMPO,16,TARÍMBARO,088,ARÍNDEO,1,6,4,2,1
MICHOACÁN DE OCAMPO,16,TARÍMBARO,088,CAMPESTRE TARÍMBARO,2,849,451,398,35
MICHOACÁN DE OCAMPO,16,TARÍMBARO,088,CAÑADA DE LOS SAUCES,4,219,106,113,17
MICHOACÁN DE OCAMPO,16,TARÍMBARO,088,CAÑADA DEL HERRERO,3,182,89,93,11
MICHOACÁN DE OCAMPO,16,TARÍMBARO,088,COLONIA INDEPENDENCIA,2,78,39,39,6
MICHOACÁN DE OCAMPO,16,TARÍMBARO,088,COLONIA MIGUEL HIDALGO,2,251,135,116,16
MICHOACÁN DE OCAMPO,16,TARÍMBARO,088,COLONIA VERÓNICA LÓPEZ,1,131,63,68,5
MICHOACÁN DE OCAMPO,16,TARÍMBARO,088,COTZIO,2,94,38,56,8
MICHOACÁN DE OCAMPO,16,TARÍMBARO,088,CUPARÁTARO,3,172,87,85,12
MICHOACÁN DE OCAMPO,16,TARÍMBARO,088,CUTO DEL PORVENIR,5,954,443,511,47
MICHOACÁN DE OCAMPO,16,TARÍMBARO,088,EL CARRIZAL,2,39,21,18,2
MICHOACÁN DE OCAMPO,16,TARÍMBARO,088,EL COLEGIO,2,154,81,73,9
MICHOACÁN DE OCAMPO,16,TARÍMBARO,088,EL CUITZILLO CHICO,3,261,131,130,17
MICHOACÁN DE OCAMPO,16,TARÍMBARO,088,EL CUITZILLO GRANDE,4,647,327,320,38
MICHOACÁN DE OCAMPO,16,TARÍMBARO,088,EL CURIRO,2,23,9,14,3
MICHOACÁN DE OCAMPO,16,TARÍMBARO,088,EL LOMETÓN,2,62,29,33,4
MICHOACÁN DE OCAMPO,16,TARÍMBARO,088,EL PUESTO,2,34,12,22,3
MICHOACÁN DE OCAMPO,16,TARÍMBARO,088,EX-HACIENDA DE GUADALUPE,3,282,123,159,11
MICHOACÁN DE OCAMPO,16,TARÍMBARO,088,FELIPE ÁNGELES,2,197,95,102,8
MICHOACÁN DE OCAMPO,16,TARÍMBARO,088,FRACCIONAMIENTO ERANDENI,2,75,34,41,8
MICHOACÁN DE OCAMPO,16,TARÍMBARO,088,FRACCIONAMIENTO GALAXIA TARÍMBARO,4,1079,528,551,49
MICHOACÁN DE OCAMPO,16,TARÍMBARO,088,FRACCIONAMIENTO HACIENDA DEL SOL,2,208,102,106,8
MICHOACÁN DE OCAMPO,16,TARÍMBARO,088,FRACCIONAMIENTO LA CANTERA,1,136,67,69,6
MICHOACÁN DE OCAMPO,16,TARÍMBARO,088,FRACCIONAMIENTO LAS ESPIGAS,3,277,134,143,14
MICHOACÁN DE OCAMPO,16,TARÍMBARO,088,FRACCIONAMIENTO LAURELES ERÉNDIRA,1,91,50,41,6
MICHOACÁN DE OCAMPO,16,TARÍMBARO,088,FRACCIONAMIENTO PASEO SANTA FE,1,47,29,18,3
MICHOACÁN DE OCAMPO,16,TARÍMBARO,088,FRACCIONAMIENTO PUERTA DEL SOL,2,637,306,331,24
MICHOACÁN DE OCAMPO,16,TARÍMBARO,088,JAMAICA,4,224,112,112,16
MICHOACÁN DE OCAMPO,16,TARÍMBARO,088,LA CONCEPCIÓN (LA CONCHITA),2,16,6,10,2
MICHOACÁN DE OCAMPO,16,TARÍMBARO,088,LA MAGDALENA (EX-HACIENDA DE LA MAGDALENA),3,733,372,361,65
MICHOACÁN DE OCAMPO,16,TARÍMBARO,088,LA NORIA,3,140,58,82,11
MICHOACÁN DE OCAMPO,16,TARÍMBARO,088,LA PALMA (LAS PALMAS),9,1149,527,622,70
MICHOACÁN DE OCAMPO,16,TARÍMBARO,088,LAS CORONILLAS,3,10,3,7,2
MICHOACÁN DE OCAMPO,16,TARÍMBARO,088,LOS RUISEÑORES,1,72,28,44,4
MICHOACÁN DE OCAMPO,16,TARÍMBARO,088,MESÓN NUEVO,3,236,124,112,14
MICHOACÁN DE OCAMPO,16,TARÍMBARO,088,PEÑA DEL PANAL,3,345,172,173,17
MICHOACÁN DE OCAMPO,16,TARÍMBARO,088,RANCHO NUEVO,2,99,45,54,6
MICHOACÁN DE OCAMPO,16,TARÍMBARO,088,REAL HACIENDA (METRÓPOLIS),1,155,68,87,9
MICHOACÁN DE OCAMPO,16,TARÍMBARO,088,SAN JOSÉ DE LA TRINIDAD,10,401,172,229,68
MICHOACÁN DE OCAMPO,16,TARÍMBARO,088,SAN PEDRO DE LOS SAUCES,5,774,375,399,50
MICHOACÁN DE OCAMPO,16,TARÍMBARO,088,SANTA ANA DEL ARCO,3,110,53,57,11
MICHOACÁN DE OCAMPO,16,TARÍMBARO,088,SANTA CRUZ,3,166,80,86,9
MICHOACÁN DE OCAMPO,16,TARÍMBARO,088,SANTA MARÍA,4,201,97,104,14
MICHOACÁN DE OCAMPO,16,TARÍMBARO,088,TARÍMBARO,34,8932,4595,4337,618
MICHOACÁN DE OCAMPO,16,TARÍMBARO,088,TÉJARO DE LOS IZQUIERDO,8,845,423,422,56
MICHOACÁN DE OCAMPO,16,TARÍMBARO,088,URUÉTARO,5,687,342,345,39
MICHOACÁN DE OCAMPO,16,TEPALCATEPEC,089,ÁLVARO OBREGÓN,1,6,3,3,1
MICHOACÁN DE OCAMPO,16,TEPALCATEPEC,089,CANSANGÜE,2,31,15,16,2
MICHOACÁN DE OCAMPO,16,TEPALCATEPEC,089,CARAPUATO,2,31,17,14,2
MICHOACÁN DE OCAMPO,16,TEPALCATEPEC,089,COLOMOTITÁN,2,51,26,25,6
MICHOACÁN DE OCAMPO,16,TEPALCATEPEC,089,EL BEJUCO,4,72,39,33,9
MICHOACÁN DE OCAMPO,16,TEPALCATEPEC,089,EL CAJÓN,1,16,11,5,1
MICHOACÁN DE OCAMPO,16,TEPALCATEPEC,089,EL MONTOSO,3,17,6,11,3
MICHOACÁN DE OCAMPO,16,TEPALCATEPEC,089,LA BOCANDA,1,15,6,9,1
MICHOACÁN DE OCAMPO,16,TEPALCATEPEC,089,LA ESTANZUELA,1,7,4,3,1
MICHOACÁN DE OCAMPO,16,TEPALCATEPEC,089,LA LIMONERA DEL TERRENATE,1,5,3,2,1
MICHOACÁN DE OCAMPO,16,TEPALCATEPEC,089,LA ORDEÑITA,3,27,19,8,3
MICHOACÁN DE OCAMPO,16,TEPALCATEPEC,089,LA RAYA (CAPRICHO),3,27,18,9,3
MICHOACÁN DE OCAMPO,16,TEPALCATEPEC,089,LA ROMERA,2,41,20,21,3
MICHOACÁN DE OCAMPO,16,TEPALCATEPEC,089,LAS JUNTAS,2,17,9,8,3
MICHOACÁN DE OCAMPO,16,TEPALCATEPEC,089,LAS MESAS DEL TERRENATE,3,24,11,13,4
MICHOACÁN DE OCAMPO,16,TEPALCATEPEC,089,LOMA BLANCA,3,76,38,38,11
MICHOACÁN DE OCAMPO,16,TEPALCATEPEC,089,LOS ANONILLOS,2,17,12,5,3
MICHOACÁN DE OCAMPO,16,TEPALCATEPEC,089,LOS AVILLOS,3,25,10,15,4
MICHOACÁN DE OCAMPO,16,TEPALCATEPEC,089,LOS HORCONES,1,25,14,11,2
MICHOACÁN DE OCAMPO,16,TEPALCATEPEC,089,NUEVO CORONGOROS,3,73,41,32,7
MICHOACÁN DE OCAMPO,16,TEPALCATEPEC,089,PANCHA LÓPEZ,3,47,29,18,3
MICHOACÁN DE OCAMPO,16,TEPALCATEPEC,089,PINOLAPA,1,5,4,1,1
MICHOACÁN DE OCAMPO,16,TEPALCATEPEC,089,PLAZA VIEJA,2,36,20,16,4
MICHOACÁN DE OCAMPO,16,TEPALCATEPEC,089,SAN ISIDRO TECUILUCA,4,214,111,103,22
MICHOACÁN DE OCAMPO,16,TEPALCATEPEC,089,TAIXTÁN,3,105,53,52,6
MICHOACÁN DE OCAMPO,16,TEPALCATEPEC,089,TEPALCATEPEC,28,4042,2088,1954,257
MICHOACÁN DE OCAMPO,16,TEPALCATEPEC,089,TEPEMEZQUITES,2,16,7,9,2
MICHOACÁN DE OCAMPO,16,TEPALCATEPEC,089,ZOQUITITA,2,8,3,5,1
MICHOACÁN DE OCAMPO,16,TINGAMBATO,090,ANGACHUÉN,1,61,27,34,3
MICHOACÁN DE OCAMPO,16,TINGAMBATO,090,EL MESÓN,1,29,17,12,3
MICHOACÁN DE OCAMPO,16,TINGAMBATO,090,LA ESCONDIDA,3,258,124,134,13
MICHOACÁN DE OCAMPO,16,TINGAMBATO,090,PARANGÜITIRO,1,7,4,3,1
MICHOACÁN DE OCAMPO,16,TINGAMBATO,090,SAN FRANCISCO PICHÁTARO,10,1642,811,831,83
MICHOACÁN DE OCAMPO,16,TINGAMBATO,090,TINGAMBATO,12,2463,1268,1195,113
MICHOACÁN DE OCAMPO,16,TINGÜINDÍN,091,AQUILES SERDÁN (SAN ÁNGEL),3,145,77,68,10
MICHOACÁN DE OCAMPO,16,TINGÜINDÍN,091,BARRIO ALTO,1,12,7,5,3
MICHOACÁN DE OCAMPO,16,TINGÜINDÍN,091,CHUCANDIRÁN,2,18,6,12,2
MICHOACÁN DE OCAMPO,16,TINGÜINDÍN,091,EL MERCADO,2,15,8,7,3
MICHOACÁN DE OCAMPO,16,TINGÜINDÍN,091,EL TECOLOTE,2,19,8,11,3
MICHOACÁN DE OCAMPO,16,TINGÜINDÍN,091,GUÁSCUARO DE MÚGICA,4,190,98,92,14
MICHOACÁN DE OCAMPO,16,TINGÜINDÍN,091,LOS LAURELES,3,106,56,50,7
MICHOACÁN DE OCAMPO,16,TINGÜINDÍN,091,RINCÓN DEL CHINO,2,29,14,15,3
MICHOACÁN DE OCAMPO,16,TINGÜINDÍN,091,SAN JUANICO,2,51,24,27,3
MICHOACÁN DE OCAMPO,16,TINGÜINDÍN,091,SAN MIGUEL (LOS RANCHITOS),3,102,46,56,8
MICHOACÁN DE OCAMPO,16,TINGÜINDÍN,091,TACÁTZCUARO,6,431,224,207,25
MICHOACÁN DE OCAMPO,16,TINGÜINDÍN,091,TATA LÁZARO (RANCHO FLORES),3,163,77,86,12
MICHOACÁN DE OCAMPO,16,TINGÜINDÍN,091,TINGÜINDÍN,12,2524,1287,1237,110
MICHOACÁN DE OCAMPO,16,TIQUICHEO DE NICOLÁS ROMERO,092,ALBARRÁN,1,87,48,39,6
MICHOACÁN DE OCAMPO,16,TIQUICHEO DE NICOLÁS ROMERO,092,ARROYO DE LAS VACAS,3,39,25,14,5
MICHOACÁN DE OCAMPO,16,TIQUICHEO DE NICOLÁS ROMERO,092,ARROYO VERDE,1,8,3,5,1
MICHOACÁN DE OCAMPO,16,TIQUICHEO DE NICOLÁS ROMERO,092,BUENAVISTA,5,27,14,13,3
MICHOACÁN DE OCAMPO,16,TIQUICHEO DE NICOLÁS ROMERO,092,CARAMÉCUARO,1,8,3,5,1
MICHOACÁN DE OCAMPO,16,TIQUICHEO DE NICOLÁS ROMERO,092,CEIBAS DE TRUJILLO,4,348,211,137,17
MICHOACÁN DE OCAMPO,16,TIQUICHEO DE NICOLÁS ROMERO,092,COPÁNDARO,1,12,6,6,2
MICHOACÁN DE OCAMPO,16,TIQUICHEO DE NICOLÁS ROMERO,092,CUARANGUEO,3,27,15,12,2
MICHOACÁN DE OCAMPO,16,TIQUICHEO DE NICOLÁS ROMERO,092,EL AGUACATE,1,5,2,3,1
MICHOACÁN DE OCAMPO,16,TIQUICHEO DE NICOLÁS ROMERO,092,EL ALGODÓN,1,6,2,4,1
MICHOACÁN DE OCAMPO,16,TIQUICHEO DE NICOLÁS ROMERO,092,EL CARACOL,2,13,6,7,2
MICHOACÁN DE OCAMPO,16,TIQUICHEO DE NICOLÁS ROMERO,092,EL CARRIZO (EL PASO DEL CARRIZO),1,12,6,6,1
MICHOACÁN DE OCAMPO,16,TIQUICHEO DE NICOLÁS ROMERO,092,EL CIRIÁN GRANDE,3,46,22,24,5
MICHOACÁN DE OCAMPO,16,TIQUICHEO DE NICOLÁS ROMERO,092,EL GUAYABO,1,19,6,13,1
MICHOACÁN DE OCAMPO,16,TIQUICHEO DE NICOLÁS ROMERO,092,EL GUAYABO DE CHAPÍN,2,14,8,6,3
MICHOACÁN DE OCAMPO,16,TIQUICHEO DE NICOLÁS ROMERO,092,EL LLANO (SAN MIGUEL CANARIO),4,132,64,68,12
MICHOACÁN DE OCAMPO,16,TIQUICHEO DE NICOLÁS ROMERO,092,EL PALMAR,2,11,5,6,2
MICHOACÁN DE OCAMPO,16,TIQUICHEO DE NICOLÁS ROMERO,092,EL PASO DEL LIMÓN,4,100,46,54,8
MICHOACÁN DE OCAMPO,16,TIQUICHEO DE NICOLÁS ROMERO,092,EL QUERETANO,2,32,15,17,2
MICHOACÁN DE OCAMPO,16,TIQUICHEO DE NICOLÁS ROMERO,092,EL RINCÓN,1,6,4,2,1
MICHOACÁN DE OCAMPO,16,TIQUICHEO DE NICOLÁS ROMERO,092,EL RODEO,3,74,39,35,8
MICHOACÁN DE OCAMPO,16,TIQUICHEO DE NICOLÁS ROMERO,092,EL SAUCILLO,3,19,7,12,2
MICHOACÁN DE OCAMPO,16,TIQUICHEO DE NICOLÁS ROMERO,092,EL TAMARINDO (LA CURVA),1,4,2,2,1
MICHOACÁN DE OCAMPO,16,TIQUICHEO DE NICOLÁS ROMERO,092,EL TEJOCOTE,1,28,16,12,2
MICHOACÁN DE OCAMPO,16,TIQUICHEO DE NICOLÁS ROMERO,092,EL TERRERO,3,40,19,21,6
MICHOACÁN DE OCAMPO,16,TIQUICHEO DE NICOLÁS ROMERO,092,EL TIMBE (EL TIMBRE),3,32,11,21,4
MICHOACÁN DE OCAMPO,16,TIQUICHEO DE NICOLÁS ROMERO,092,EL USHIEL,1,5,3,2,1
MICHOACÁN DE OCAMPO,16,TIQUICHEO DE NICOLÁS ROMERO,092,EL ZAPIÉN,1,5,3,2,1
MICHOACÁN DE OCAMPO,16,TIQUICHEO DE NICOLÁS ROMERO,092,EL ZAPOTE CHICO,3,62,21,41,4
MICHOACÁN DE OCAMPO,16,TIQUICHEO DE NICOLÁS ROMERO,092,EL ZAPOTE GRANDE,3,64,31,33,5
MICHOACÁN DE OCAMPO,16,TIQUICHEO DE NICOLÁS ROMERO,092,GALLITOS (SIETE CARRERAS),4,205,134,71,10
MICHOACÁN DE OCAMPO,16,TIQUICHEO DE NICOLÁS ROMERO,092,HUAHUASCO,4,96,45,51,7
MICHOACÁN DE OCAMPO,16,TIQUICHEO DE NICOLÁS ROMERO,092,LA ANONERA,2,7,5,2,1
MICHOACÁN DE OCAMPO,16,TIQUICHEO DE NICOLÁS ROMERO,092,LA DIBUJADA,2,5,1,4,1
MICHOACÁN DE OCAMPO,16,TIQUICHEO DE NICOLÁS ROMERO,092,LA ESCONDIDA,1,9,3,6,1
MICHOACÁN DE OCAMPO,16,TIQUICHEO DE NICOLÁS ROMERO,092,LA MINITA,2,6,3,3,1
MICHOACÁN DE OCAMPO,16,TIQUICHEO DE NICOLÁS ROMERO,092,LA PAROTA,2,4,3,1,2
MICHOACÁN DE OCAMPO,16,TIQUICHEO DE NICOLÁS ROMERO,092,LA TORRECILLA,2,5,2,3,1
MICHOACÁN DE OCAMPO,16,TIQUICHEO DE NICOLÁS ROMERO,092,LAS ANONAS,2,33,13,20,4
MICHOACÁN DE OCAMPO,16,TIQUICHEO DE NICOLÁS ROMERO,092,LAS CEIBILLAS (PUEBLO VIEJO),2,12,6,6,1
MICHOACÁN DE OCAMPO,16,TIQUICHEO DE NICOLÁS ROMERO,092,LAS PALMAS,1,7,3,4,1
MICHOACÁN DE OCAMPO,16,TIQUICHEO DE NICOLÁS ROMERO,092,LAS PIÑAS,2,6,0,6,1
MICHOACÁN DE OCAMPO,16,TIQUICHEO DE NICOLÁS ROMERO,092,LOMA DE LAS YEGUAS,2,5,3,2,1
MICHOACÁN DE OCAMPO,16,TIQUICHEO DE NICOLÁS ROMERO,092,LOS CORONGOROS,1,2,1,1,1
MICHOACÁN DE OCAMPO,16,TIQUICHEO DE NICOLÁS ROMERO,092,MOJARRAS (SAN CARLOS),4,112,55,57,13
MICHOACÁN DE OCAMPO,16,TIQUICHEO DE NICOLÁS ROMERO,092,NUEVO COPÁNDARO,2,14,8,6,2
MICHOACÁN DE OCAMPO,16,TIQUICHEO DE NICOLÁS ROMERO,092,PAPATZINDÁN DE ROMERO (EL LIMÓN),4,535,285,250,27
MICHOACÁN DE OCAMPO,16,TIQUICHEO DE NICOLÁS ROMERO,092,PLAN DEL SALMERÓN,2,7,2,5,1
MICHOACÁN DE OCAMPO,16,TIQUICHEO DE NICOLÁS ROMERO,092,PUERTO METATES,2,12,6,6,2
MICHOACÁN DE OCAMPO,16,TIQUICHEO DE NICOLÁS ROMERO,092,PURUNGUEO,4,148,72,76,15
MICHOACÁN DE OCAMPO,16,TIQUICHEO DE NICOLÁS ROMERO,092,RIVA PALACIO (EL GUAJOLOTE),3,43,20,23,7
MICHOACÁN DE OCAMPO,16,TIQUICHEO DE NICOLÁS ROMERO,092,SAN PEDRO,2,20,10,10,2
MICHOACÁN DE OCAMPO,16,TIQUICHEO DE NICOLÁS ROMERO,092,TIQUICHEO,8,1073,557,516,65
MICHOACÁN DE OCAMPO,16,TIQUICHEO DE NICOLÁS ROMERO,092,TRIGUITOS,1,15,6,9,1
MICHOACÁN DE OCAMPO,16,TIQUICHEO DE NICOLÁS ROMERO,092,TZENTZÉNGUARO,3,86,42,44,10
MICHOACÁN DE OCAMPO,16,TIQUICHEO DE NICOLÁS ROMERO,092,YOSTIO,2,5,2,3,1
MICHOACÁN DE OCAMPO,16,TIQUICHEO DE NICOLÁS ROMERO,092,ZIRÚCUARO,3,78,41,37,7
MICHOACÁN DE OCAMPO,16,TLALPUJAHUA,093,CERRO ALTO,3,84,41,43,5
MICHOACÁN DE OCAMPO,16,TLALPUJAHUA,093,CHALMITA (CHAZMITI),2,72,39,33,3
MICHOACÁN DE OCAMPO,16,TLALPUJAHUA,093,EL JAZMÍN,2,66,23,43,4
MICHOACÁN DE OCAMPO,16,TLALPUJAHUA,093,EL LLANITO (SEÑOR DEL LLANO),3,65,31,34,4
MICHOACÁN DE OCAMPO,16,TLALPUJAHUA,093,EL REAL (EL REAL DE ARRIBA),2,87,43,44,6
MICHOACÁN DE OCAMPO,16,TLALPUJAHUA,093,ESTANZUELA (LA HACIENDA),2,84,43,41,5
MICHOACÁN DE OCAMPO,16,TLALPUJAHUA,093,GUADALUPE VICTORIA,3,182,89,93,11
MICHOACÁN DE OCAMPO,16,TLALPUJAHUA,093,LA AMÉRICA,1,13,6,7,1
MICHOACÁN DE OCAMPO,16,TLALPUJAHUA,093,LA GRANJA,5,219,106,113,13
MICHOACÁN DE OCAMPO,16,TLALPUJAHUA,093,LA MESA,2,105,57,48,8
MICHOACÁN DE OCAMPO,16,TLALPUJAHUA,093,LA TRAMPA,2,42,18,24,2
MICHOACÁN DE OCAMPO,16,TLALPUJAHUA,093,LOS REMEDIOS,2,203,104,99,10
MICHOACÁN DE OCAMPO,16,TLALPUJAHUA,093,LOS REYES,3,132,68,64,7
MICHOACÁN DE OCAMPO,16,TLALPUJAHUA,093,LOS TREJO (SANTO NIÑO),2,42,20,22,5
MICHOACÁN DE OCAMPO,16,TLALPUJAHUA,093,PLAZA DE GALLOS,1,54,28,26,2
MICHOACÁN DE OCAMPO,16,TLALPUJAHUA,093,PUENTE DE TIERRA,2,76,35,41,5
MICHOACÁN DE OCAMPO,16,TLALPUJAHUA,093,PUERTO DE BERMEO,3,95,55,40,6
MICHOACÁN DE OCAMPO,16,TLALPUJAHUA,093,RINCÓN DEL SAGRADO CORAZÓN (RINCÓN DEL DIABLO),2,15,4,11,2
MICHOACÁN DE OCAMPO,16,TLALPUJAHUA,093,ROSA DE CASTILLA,2,28,11,17,2
MICHOACÁN DE OCAMPO,16,TLALPUJAHUA,093,SAN FRANCISCO DE LOS REYES,5,1013,535,478,55
MICHOACÁN DE OCAMPO,16,TLALPUJAHUA,093,SAN ISIDRO,2,239,115,124,13
MICHOACÁN DE OCAMPO,16,TLALPUJAHUA,093,SAN JOAQUÍN MORELOS,3,109,57,52,6
MICHOACÁN DE OCAMPO,16,TLALPUJAHUA,093,SAN JOSÉ CORRALES,2,216,107,109,9
MICHOACÁN DE OCAMPO,16,TLALPUJAHUA,093,SAN JOSÉ DE GUADALUPE,3,186,89,97,10
MICHOACÁN DE OCAMPO,16,TLALPUJAHUA,093,SAN JUAN DE DIOS,1,8,5,3,1
MICHOACÁN DE OCAMPO,16,TLALPUJAHUA,093,SAN JUAN TLALPUJAHUILLA (TLALPUJAHUILLA),4,225,94,131,14
MICHOACÁN DE OCAMPO,16,TLALPUJAHUA,093,SAN LORENZO SEGUNDO CUARTEL,3,223,108,115,10
MICHOACÁN DE OCAMPO,16,TLALPUJAHUA,093,SAN PEDRO TARÍMBARO,5,480,228,252,24
MICHOACÁN DE OCAMPO,16,TLALPUJAHUA,093,SAN RAFAEL,3,278,139,139,17
MICHOACÁN DE OCAMPO,16,TLALPUJAHUA,093,SANDÍA,2,93,49,44,4
MICHOACÁN DE OCAMPO,16,TLALPUJAHUA,093,SANTA MARÍA DE LOS ÁNGELES,5,335,169,166,17
MICHOACÁN DE OCAMPO,16,TLALPUJAHUA,093,TLACOTEPEC,2,60,31,29,5
MICHOACÁN DE OCAMPO,16,TLALPUJAHUA,093,TLALPUJAHUA DE RAYÓN,15,1982,1077,905,171
MICHOACÁN DE OCAMPO,16,TLAZAZALCA,094,ACUITZERAMO,4,86,39,47,8
MICHOACÁN DE OCAMPO,16,TLAZAZALCA,094,ACÚMBARO (ACÚMBARO DE LAS PILAS),3,64,29,35,7
MICHOACÁN DE OCAMPO,16,TLAZAZALCA,094,COLONIA EL PORVENIR,1,21,10,11,2
MICHOACÁN DE OCAMPO,16,TLAZAZALCA,094,COLONIA GABINO VÁZQUEZ (LOS GUAYABOS),2,62,29,33,4
MICHOACÁN DE OCAMPO,16,TLAZAZALCA,094,EL TECOLOTE,3,30,13,17,4
MICHOACÁN DE OCAMPO,16,TLAZAZALCA,094,GIL,1,14,8,6,2
MICHOACÁN DE OCAMPO,16,TLAZAZALCA,094,HUITZO,3,106,40,66,9
MICHOACÁN DE OCAMPO,16,TLAZAZALCA,094,ICATIRO,1,13,5,8,1
MICHOACÁN DE OCAMPO,16,TLAZAZALCA,094,JAMANDÚCUARO,2,38,18,20,4
MICHOACÁN DE OCAMPO,16,TLAZAZALCA,094,LA ESTANCITA,1,5,2,3,1
MICHOACÁN DE OCAMPO,16,TLAZAZALCA,094,LA YERBABUENA,4,159,75,84,13
MICHOACÁN DE OCAMPO,16,TLAZAZALCA,094,LAS GALLINAS,1,7,4,3,1
MICHOACÁN DE OCAMPO,16,TLAZAZALCA,094,TLAZAZALCA,6,806,448,358,49
MICHOACÁN DE OCAMPO,16,TLAZAZALCA,094,UREPETIRO,3,72,29,43,6
MICHOACÁN DE OCAMPO,16,TOCUMBO,095,EL LIMÓN,1,3,0,3,1
MICHOACÁN DE OCAMPO,16,TOCUMBO,095,EL MANGUITO,1,80,37,43,4
MICHOACÁN DE OCAMPO,16,TOCUMBO,095,EL MOLINITO,1,56,28,28,2
MICHOACÁN DE OCAMPO,16,TOCUMBO,095,LA CALERA,1,31,18,13,1
MICHOACÁN DE OCAMPO,16,TOCUMBO,095,LA LAGUNETA,1,11,4,7,1
MICHOACÁN DE OCAMPO,16,TOCUMBO,095,LA MAGDALENA,2,64,36,28,3
MICHOACÁN DE OCAMPO,16,TOCUMBO,095,LA PAROTA,1,4,3,1,1
MICHOACÁN DE OCAMPO,16,TOCUMBO,095,LA PLAYA,1,6,3,3,1
MICHOACÁN DE OCAMPO,16,TOCUMBO,095,PUENTE DE TOCUMBO,2,17,8,9,3
MICHOACÁN DE OCAMPO,16,TOCUMBO,095,SAN FRANCISCO,2,34,19,15,3
MICHOACÁN DE OCAMPO,16,TOCUMBO,095,SANTA CLARA DE VALLADARES,8,2226,1170,1056,147
MICHOACÁN DE OCAMPO,16,TOCUMBO,095,SANTA INÉS,2,84,40,44,7
MICHOACÁN DE OCAMPO,16,TOCUMBO,095,TOCUMBO,6,505,260,245,41
MICHOACÁN DE OCAMPO,16,TUMBISCATÍO,096,ARUCHITA,1,9,1,8,2
MICHOACÁN DE OCAMPO,16,TUMBISCATÍO,096,EL FRESNAL,1,14,4,10,2
MICHOACÁN DE OCAMPO,16,TUMBISCATÍO,096,EL HUJE,1,9,3,6,1
MICHOACÁN DE OCAMPO,16,TUMBISCATÍO,096,EL NOPAL (LA NOPALERA),1,7,6,1,2
MICHOACÁN DE OCAMPO,16,TUMBISCATÍO,096,EL PEDREGOSO,1,6,3,3,1
MICHOACÁN DE OCAMPO,16,TUMBISCATÍO,096,EL PLATANAL,3,43,22,21,7
MICHOACÁN DE OCAMPO,16,TUMBISCATÍO,096,GENERAL FRANCISCO VILLA (LAS CRUCES),5,312,162,150,30
MICHOACÁN DE OCAMPO,16,TUMBISCATÍO,096,GRACIANO SÁNCHEZ (EL SOCORRO),4,99,51,48,8
MICHOACÁN DE OCAMPO,16,TUMBISCATÍO,096,LA CRUZ,1,2,2,0,1
MICHOACÁN DE OCAMPO,16,TUMBISCATÍO,096,LAS NUEVAS CARAMICUAS,3,40,22,18,6
MICHOACÁN DE OCAMPO,16,TUMBISCATÍO,096,LAS PLAYITAS,4,84,50,34,14
MICHOACÁN DE OCAMPO,16,TUMBISCATÍO,096,LOS CHIVOS,1,6,2,4,2
MICHOACÁN DE OCAMPO,16,TUMBISCATÍO,096,MATA DE PLÁTANO,1,8,4,4,1
MICHOACÁN DE OCAMPO,16,TUMBISCATÍO,096,POTRERILLOS DE CORIA (LA LOMA),3,56,32,24,7
MICHOACÁN DE OCAMPO,16,TUMBISCATÍO,096,SAN ANTONIO,1,6,1,5,1
MICHOACÁN DE OCAMPO,16,TUMBISCATÍO,096,SÁNCHEZ,1,6,4,2,1
MICHOACÁN DE OCAMPO,16,TUMBISCATÍO,096,TIERRA DE BUEYES (TIERRA DE JUÁREZ),2,11,3,8,2
MICHOACÁN DE OCAMPO,16,TUMBISCATÍO,096,TUMBISCATÍO DE RUIZ,5,559,279,280,50
MICHOACÁN DE OCAMPO,16,TURICATO,097,AGUA HEDIONDA (AGUA DULCE),1,16,4,12,1
MICHOACÁN DE OCAMPO,16,TURICATO,097,ARROYO LA HUERTA (LA BARRANCA),3,165,81,84,8
MICHOACÁN DE OCAMPO,16,TURICATO,097,ATIJO,3,55,28,27,4
MICHOACÁN DE OCAMPO,16,TURICATO,097,BAPÁCUARO,1,7,2,5,1
MICHOACÁN DE OCAMPO,16,TURICATO,097,CAHURICA,1,4,2,2,1
MICHOACÁN DE OCAMPO,16,TURICATO,097,CARAMICUAS,3,159,76,83,9
MICHOACÁN DE OCAMPO,16,TURICATO,097,CHIQUITO EL GRANDE,2,60,24,36,6
MICHOACÁN DE OCAMPO,16,TURICATO,097,CIENEGUILLAS DE EN MEDIO,2,49,27,22,3
MICHOACÁN DE OCAMPO,16,TURICATO,097,CIENEGUILLAS DEL HUERTO (CIENEGUILLAS),2,111,55,56,7
MICHOACÁN DE OCAMPO,16,TURICATO,097,CORUMIO,1,3,1,2,1
MICHOACÁN DE OCAMPO,16,TURICATO,097,CRUZ DE CAMINOS,1,5,2,3,1
MICHOACÁN DE OCAMPO,16,TURICATO,097,CUAMÁCUARO,3,32,17,15,5
MICHOACÁN DE OCAMPO,16,TURICATO,097,CUIRINDALES DE MARITANGACHO,1,5,2,3,1
MICHOACÁN DE OCAMPO,16,TURICATO,097,CUITZIÁN CHIQUITO,3,45,21,24,5
MICHOACÁN DE OCAMPO,16,TURICATO,097,CUITZIÁN GRANDE,4,317,166,151,12
MICHOACÁN DE OCAMPO,16,TURICATO,097,EL ARENAL,2,10,6,4,2
MICHOACÁN DE OCAMPO,16,TURICATO,097,EL CAHULOTE DE SANTA ANA,5,861,436,425,40
MICHOACÁN DE OCAMPO,16,TURICATO,097,EL CAHULOTE SECO,3,65,31,34,6
MICHOACÁN DE OCAMPO,16,TURICATO,097,EL CAJONCITO,1,7,2,5,1
MICHOACÁN DE OCAMPO,16,TURICATO,097,EL CAPIRE (EL CAPIRE DE SANABRIA),2,35,20,15,2
MICHOACÁN DE OCAMPO,16,TURICATO,097,EL CAPOTE,2,66,28,38,3
MICHOACÁN DE OCAMPO,16,TURICATO,097,EL CARRIZALILLO,1,18,7,11,1
MICHOACÁN DE OCAMPO,16,TURICATO,097,EL COLORÍN,1,9,3,6,1
MICHOACÁN DE OCAMPO,16,TURICATO,097,EL ENCANTO,3,154,76,78,8
MICHOACÁN DE OCAMPO,16,TURICATO,097,EL ENCUENTRO,2,30,15,15,3
MICHOACÁN DE OCAMPO,16,TURICATO,097,EL GUAYABO,1,7,2,5,1
MICHOACÁN DE OCAMPO,16,TURICATO,097,EL JAZMÍN,2,23,16,7,2
MICHOACÁN DE OCAMPO,16,TURICATO,097,EL OJO DE AGUA (OJO DE AGUA DE ETUCUARILLO),3,46,21,25,4
MICHOACÁN DE OCAMPO,16,TURICATO,097,EL PASO DE LOS BECERROS,1,4,2,2,1
MICHOACÁN DE OCAMPO,16,TURICATO,097,EL PINZÁN,1,29,11,18,2
MICHOACÁN DE OCAMPO,16,TURICATO,097,EL REMATE,2,8,4,4,1
MICHOACÁN DE OCAMPO,16,TURICATO,097,EL REMATE (LLANITOS DE CUCHA),1,6,1,5,1
MICHOACÁN DE OCAMPO,16,TURICATO,097,EL REPARO DE IRANAHUIPIO (LA PAROTA),1,7,3,4,1
MICHOACÁN DE OCAMPO,16,TURICATO,097,EL SALITRE (LOS BAÑOS DEL SALITRE),1,9,4,5,1
MICHOACÁN DE OCAMPO,16,TURICATO,097,EL SAUCITO,1,6,4,2,1
MICHOACÁN DE OCAMPO,16,TURICATO,097,EL TECOLOTE,2,39,18,21,3
MICHOACÁN DE OCAMPO,16,TURICATO,097,EL TIMBIRICHE,1,5,3,2,1
MICHOACÁN DE OCAMPO,16,TURICATO,097,EL ZAPOTE,5,129,79,50,8
MICHOACÁN DE OCAMPO,16,TURICATO,097,ETUCUARILLO,3,100,47,53,7
MICHOACÁN DE OCAMPO,16,TURICATO,097,IRANAHUIPIO,2,59,31,28,6
MICHOACÁN DE OCAMPO,16,TURICATO,097,LA BEJUQUERA,2,14,8,6,2
MICHOACÁN DE OCAMPO,16,TURICATO,097,LA CAPILLA,1,7,2,5,1
MICHOACÁN DE OCAMPO,16,TURICATO,097,LA COFRADÍA,1,6,2,4,1
MICHOACÁN DE OCAMPO,16,TURICATO,097,LA CRUZ DE ATATO,1,2,1,1,1
MICHOACÁN DE OCAMPO,16,TURICATO,097,LA ERMITA (NUEVA JERUSALÉN),3,330,178,152,14
MICHOACÁN DE OCAMPO,16,TURICATO,097,LA INJERTADA,2,50,33,17,3
MICHOACÁN DE OCAMPO,16,TURICATO,097,LA LAJA,1,8,2,6,1
MICHOACÁN DE OCAMPO,16,TURICATO,097,LA LIMONERA,2,18,8,10,3
MICHOACÁN DE OCAMPO,16,TURICATO,097,LA LOBERA,3,65,29,36,5
MICHOACÁN DE OCAMPO,16,TURICATO,097,LA PAROTA DE ATIJO,4,81,45,36,8
MICHOACÁN DE OCAMPO,16,TURICATO,097,LA PUERTA DEL CHOCOLATE (AZINCHETES),2,35,15,20,2
MICHOACÁN DE OCAMPO,16,TURICATO,097,LA PUERTA DEL NARANJO,3,67,37,30,6
MICHOACÁN DE OCAMPO,16,TURICATO,097,LA SALADA,3,118,66,52,9
MICHOACÁN DE OCAMPO,16,TURICATO,097,LAS CAMUCHINAS,2,16,7,9,2
MICHOACÁN DE OCAMPO,16,TURICATO,097,LAS CEIBAS DE CUITZIÁN GRANDE,2,35,26,9,4
MICHOACÁN DE OCAMPO,16,TURICATO,097,LAS NUECES,2,32,19,13,4
MICHOACÁN DE OCAMPO,16,TURICATO,097,LOS ASCINCHETES,2,22,11,11,2
MICHOACÁN DE OCAMPO,16,TURICATO,097,LOS CHIRAPES,1,9,6,3,1
MICHOACÁN DE OCAMPO,16,TURICATO,097,LOS HACHEROS,3,316,164,152,18
MICHOACÁN DE OCAMPO,16,TURICATO,097,LOS MAGUEYES,2,40,21,19,3
MICHOACÁN DE OCAMPO,16,TURICATO,097,LOS NOGALES,4,183,101,82,13
MICHOACÁN DE OCAMPO,16,TURICATO,097,LOS RUCIOS,3,96,40,56,7
MICHOACÁN DE OCAMPO,16,TURICATO,097,LOS SAUCES,2,38,20,18,3
MICHOACÁN DE OCAMPO,16,TURICATO,097,MARITANGACHO,2,22,8,14,3
MICHOACÁN DE OCAMPO,16,TURICATO,097,OJO DE AGUA DE LOS MALDONADO,1,5,3,2,1
MICHOACÁN DE OCAMPO,16,TURICATO,097,OMÍCUARO,3,39,20,19,5
MICHOACÁN DE OCAMPO,16,TURICATO,097,PETATÁN,3,50,27,23,4
MICHOACÁN DE OCAMPO,16,TURICATO,097,PIEDRA DEL AGUA,1,15,6,9,1
MICHOACÁN DE OCAMPO,16,TURICATO,097,PINAL GRANDE,3,219,114,105,13
MICHOACÁN DE OCAMPO,16,TURICATO,097,POTRERILLOS,1,3,3,0,1
MICHOACÁN DE OCAMPO,16,TURICATO,097,PURUARÁN,10,2127,1074,1053,112
MICHOACÁN DE OCAMPO,16,TURICATO,097,SALITRILLO,1,6,4,2,1
MICHOACÁN DE OCAMPO,16,TURICATO,097,SAN CRISTÓBAL DE LOS GUAJES,4,167,105,62,8
MICHOACÁN DE OCAMPO,16,TURICATO,097,SAN FRANCISCO,3,37,20,17,4
MICHOACÁN DE OCAMPO,16,TURICATO,097,SAN JOSÉ TURICATO,1,7,4,3,1
MICHOACÁN DE OCAMPO,16,TURICATO,097,SAN RAFAEL DE IRANAHUIPIO,1,4,0,4,1
MICHOACÁN DE OCAMPO,16,TURICATO,097,SANABRIA (LAS CANOAS),2,35,16,19,2
MICHOACÁN DE OCAMPO,16,TURICATO,097,SANTA CRUZ DE MORELOS,4,286,149,137,16
MICHOACÁN DE OCAMPO,16,TURICATO,097,SAUZ DE LA SIERRA,3,57,24,33,4
MICHOACÁN DE OCAMPO,16,TURICATO,097,SHORIO (CHORIO),1,11,7,4,1
MICHOACÁN DE OCAMPO,16,TURICATO,097,TAVERA,3,281,132,149,18
MICHOACÁN DE OCAMPO,16,TURICATO,097,TURICATO,9,870,441,429,52
MICHOACÁN DE OCAMPO,16,TURICATO,097,ZÁRATE,3,271,157,114,11
MICHOACÁN DE OCAMPO,16,TURICATO,097,ZICUAPO,3,24,14,10,3
MICHOACÁN DE OCAMPO,16,TURICATO,097,ZIHUATZIO,2,108,46,62,7
MICHOACÁN DE OCAMPO,16,TUXPAN,098,ACÚMBARO,2,67,26,41,4
MICHOACÁN DE OCAMPO,16,TUXPAN,098,CERRITO COLORADO,2,89,36,53,5
MICHOACÁN DE OCAMPO,16,TUXPAN,098,COFRADÍA DE GUADALUPE (MANZANA DE COFRADÍA),4,194,87,107,11
MICHOACÁN DE OCAMPO,16,TUXPAN,098,COLONIA CUAUHTÉMOC,1,9,3,6,1
MICHOACÁN DE OCAMPO,16,TUXPAN,098,COLONIA NUEVA MARIEL [RADIO DIFUSORA],1,9,4,5,1
MICHOACÁN DE OCAMPO,16,TUXPAN,098,COLONIA PUERTO DEL OBISPO,3,188,96,92,11
MICHOACÁN DE OCAMPO,16,TUXPAN,098,COLONIA VISTA HERMOSA,1,16,6,10,1
MICHOACÁN DE OCAMPO,16,TUXPAN,098,CORUCHA,1,28,16,12,1
MICHOACÁN DE OCAMPO,16,TUXPAN,098,CRUCERO DE COFRADÍA,1,6,4,2,1
MICHOACÁN DE OCAMPO,16,TUXPAN,098,EL AGUACATE (PRIMERA MANZANA),1,21,15,6,1
MICHOACÁN DE OCAMPO,16,TUXPAN,098,EL AILAR,3,38,17,21,3
MICHOACÁN DE OCAMPO,16,TUXPAN,098,EL DESCOLGADERO,2,13,3,10,2
MICHOACÁN DE OCAMPO,16,TUXPAN,098,EL JAZMÍN,2,98,38,60,7
MICHOACÁN DE OCAMPO,16,TUXPAN,098,EL MALACATE,3,190,96,94,11
MICHOACÁN DE OCAMPO,16,TUXPAN,098,EL PARAÍSO,2,47,19,28,3
MICHOACÁN DE OCAMPO,16,TUXPAN,098,EL SABINAL,1,11,3,8,1
MICHOACÁN DE OCAMPO,16,TUXPAN,098,EL TAMBOR,1,64,38,26,3
MICHOACÁN DE OCAMPO,16,TUXPAN,098,EL TERRERO (PASO DEL MUERTO),2,4,1,3,1
MICHOACÁN DE OCAMPO,16,TUXPAN,098,HUIRUNIO GRANDE,1,40,19,21,3
MICHOACÁN DE OCAMPO,16,TUXPAN,098,JACUARILLO,3,140,74,66,8
MICHOACÁN DE OCAMPO,16,TUXPAN,098,JARIPITÍO,2,136,67,69,8
MICHOACÁN DE OCAMPO,16,TUXPAN,098,LA ERA,1,36,14,22,2
MICHOACÁN DE OCAMPO,16,TUXPAN,098,LA PRESA,1,7,2,5,1
MICHOACÁN DE OCAMPO,16,TUXPAN,098,LA PROVIDENCIA,3,159,69,90,11
MICHOACÁN DE OCAMPO,16,TUXPAN,098,LA SOLEDAD,4,265,136,129,16
MICHOACÁN DE OCAMPO,16,TUXPAN,098,LAGUNA SECA,3,61,20,41,3
MICHOACÁN DE OCAMPO,16,TUXPAN,098,LAS CANOAS,1,6,3,3,1
MICHOACÁN DE OCAMPO,16,TUXPAN,098,LAS JOYAS DE MARZO (LA HOYA DE MARZO),2,50,28,22,3
MICHOACÁN DE OCAMPO,16,TUXPAN,098,LAURELITOS,2,30,13,17,3
MICHOACÁN DE OCAMPO,16,TUXPAN,098,LOS AILES,3,84,42,42,6
MICHOACÁN DE OCAMPO,16,TUXPAN,098,LOS FRESNOS,2,24,11,13,3
MICHOACÁN DE OCAMPO,16,TUXPAN,098,LOS LOBOS,1,14,8,6,1
MICHOACÁN DE OCAMPO,16,TUXPAN,098,MILPILLAS (EL CAPULÍN),2,19,4,15,2
MICHOACÁN DE OCAMPO,16,TUXPAN,098,ORTIGA DE LA REFORMA,2,18,5,13,2
MICHOACÁN DE OCAMPO,16,TUXPAN,098,PALO BLANCO,2,52,22,30,4
MICHOACÁN DE OCAMPO,16,TUXPAN,098,PATÁMBARO,2,18,8,10,2
MICHOACÁN DE OCAMPO,16,TUXPAN,098,PUERTO DE LA CANTERA (LAS PALMITAS),2,53,26,27,3
MICHOACÁN DE OCAMPO,16,TUXPAN,098,PUERTO DEL OBISPO,3,22,13,9,3
MICHOACÁN DE OCAMPO,16,TUXPAN,098,RINCÓN DE CORUCHA,3,111,53,58,9
MICHOACÁN DE OCAMPO,16,TUXPAN,098,RINCÓN DE SÁNCHEZ,2,36,20,16,4
MICHOACÁN DE OCAMPO,16,TUXPAN,098,SAN VICTORIANO,1,130,61,69,5
MICHOACÁN DE OCAMPO,16,TUXPAN,098,SANTA ANA,3,453,212,241,25
MICHOACÁN DE OCAMPO,16,TUXPAN,098,SANTA CATARINA,1,10,6,4,1
MICHOACÁN DE OCAMPO,16,TUXPAN,098,TURUNDEO,4,362,203,159,24
MICHOACÁN DE OCAMPO,16,TUXPAN,098,TUXPAN,18,2555,1259,1296,157
MICHOACÁN DE OCAMPO,16,TUZANTLA,099,ACUCHA DE CAJONCITOS,2,33,13,20,2
MICHOACÁN DE OCAMPO,16,TUZANTLA,099,ARROYO SECO,2,139,65,74,7
MICHOACÁN DE OCAMPO,16,TUZANTLA,099,BEJUCALILLOS,1,6,3,3,1
MICHOACÁN DE OCAMPO,16,TUZANTLA,099,CAÑA QUEMADA,2,51,32,19,4
MICHOACÁN DE OCAMPO,16,TUZANTLA,099,CASAS VIEJAS,2,9,6,3,1
MICHOACÁN DE OCAMPO,16,TUZANTLA,099,CEIBAS DEL PILÓN CHICO,1,7,4,3,1
MICHOACÁN DE OCAMPO,16,TUZANTLA,099,CHIRAGANGUEO,3,26,17,9,5
MICHOACÁN DE OCAMPO,16,TUZANTLA,099,CUAULOTE,3,34,15,19,3
MICHOACÁN DE OCAMPO,16,TUZANTLA,099,EL AGUA GRANDE,2,13,9,4,2
MICHOACÁN DE OCAMPO,16,TUZANTLA,099,EL ASOLEADERO DE TIRIPITÍO,1,14,4,10,1
MICHOACÁN DE OCAMPO,16,TUZANTLA,099,EL BALSEADERO,1,12,5,7,1
MICHOACÁN DE OCAMPO,16,TUZANTLA,099,EL CASCALOTE DEL SALITRE (EL SALITRE),4,145,66,79,11
MICHOACÁN DE OCAMPO,16,TUZANTLA,099,EL CUAJILOTE,2,15,8,7,2
MICHOACÁN DE OCAMPO,16,TUZANTLA,099,EL DURAZNO,3,12,4,8,2
MICHOACÁN DE OCAMPO,16,TUZANTLA,099,EL FRESNO (ALGODÓN DE LA SOLEDAD GRANDE),3,14,5,9,2
MICHOACÁN DE OCAMPO,16,TUZANTLA,099,EL MOLINITO,2,4,3,1,2
MICHOACÁN DE OCAMPO,16,TUZANTLA,099,EL OLIVO,4,151,67,84,12
MICHOACÁN DE OCAMPO,16,TUZANTLA,099,EL PANTANO,1,8,5,3,1
MICHOACÁN DE OCAMPO,16,TUZANTLA,099,EL PASO DE LA VIRGEN,2,20,11,9,2
MICHOACÁN DE OCAMPO,16,TUZANTLA,099,EL RANCHITO,2,8,2,6,1
MICHOACÁN DE OCAMPO,16,TUZANTLA,099,EL REVENTÓN UNO,2,24,10,14,2
MICHOACÁN DE OCAMPO,16,TUZANTLA,099,EL RODEO DE SOLEDAD GRANDE,3,47,19,28,3
MICHOACÁN DE OCAMPO,16,TUZANTLA,099,EL TIMBINAL,1,4,1,3,1
MICHOACÁN DE OCAMPO,16,TUZANTLA,099,FRANCISCO VILLA (POTRERILLOS),2,45,26,19,3
MICHOACÁN DE OCAMPO,16,TUZANTLA,099,HUACAZ (PUEBLO NUEVO),2,22,10,12,3
MICHOACÁN DE OCAMPO,16,TUZANTLA,099,JOYAS DE VIGAS,3,26,16,10,3
MICHOACÁN DE OCAMPO,16,TUZANTLA,099,LA CARBONERA,2,31,12,19,3
MICHOACÁN DE OCAMPO,16,TUZANTLA,099,LA ESCONDIDA,2,3,0,3,1
MICHOACÁN DE OCAMPO,16,TUZANTLA,099,LA GUACAMAYA,3,59,27,32,4
MICHOACÁN DE OCAMPO,16,TUZANTLA,099,LA LAJA UNO,2,21,13,8,3
MICHOACÁN DE OCAMPO,16,TUZANTLA,099,LA LAJITA,2,10,8,2,1
MICHOACÁN DE OCAMPO,16,TUZANTLA,099,LA LOMA BONITA,1,10,5,5,1
MICHOACÁN DE OCAMPO,16,TUZANTLA,099,LA PAROTA DEL BRASIL,3,52,30,22,3
MICHOACÁN DE OCAMPO,16,TUZANTLA,099,LA PINZANERA,1,5,1,4,1
MICHOACÁN DE OCAMPO,16,TUZANTLA,099,LA QUIRINGUCA,1,9,6,3,1
MICHOACÁN DE OCAMPO,16,TUZANTLA,099,LA RAYUELA,1,7,0,7,1
MICHOACÁN DE OCAMPO,16,TUZANTLA,099,LAS ANONAS,2,13,6,7,2
MICHOACÁN DE OCAMPO,16,TUZANTLA,099,LAS JUNTAS DEL TANQUE,4,190,100,90,13
MICHOACÁN DE OCAMPO,16,TUZANTLA,099,LAS LAJAS DEL BOSQUE,2,11,3,8,2
MICHOACÁN DE OCAMPO,16,TUZANTLA,099,LAS PAROTAS (PAROTA DE TERRERO),2,12,5,7,2
MICHOACÁN DE OCAMPO,16,TUZANTLA,099,LOS ANONOS,2,19,13,6,3
MICHOACÁN DE OCAMPO,16,TUZANTLA,099,LOS GUAJES DE TEAMARO,1,9,3,6,1
MICHOACÁN DE OCAMPO,16,TUZANTLA,099,LOS GUAJES DE TERÁN,2,5,2,3,1
MICHOACÁN DE OCAMPO,16,TUZANTLA,099,LOS OTATES,2,17,9,8,3
MICHOACÁN DE OCAMPO,16,TUZANTLA,099,LOS PINZANES,2,18,9,9,2
MICHOACÁN DE OCAMPO,16,TUZANTLA,099,LOS PLANES,1,5,4,1,1
MICHOACÁN DE OCAMPO,16,TUZANTLA,099,LOS TEPEHUAJES,1,2,1,1,1
MICHOACÁN DE OCAMPO,16,TUZANTLA,099,MAGUEY ACUITZIO (LA POLILLA),2,20,8,12,2
MICHOACÁN DE OCAMPO,16,TUZANTLA,099,MELCHOR OCAMPO (PASO DE TIERRA CALIENTE),1,124,74,50,5
MICHOACÁN DE OCAMPO,16,TUZANTLA,099,MESA DE LAS ÁNIMAS,1,12,4,8,1
MICHOACÁN DE OCAMPO,16,TUZANTLA,099,MESA DEL AIRE,2,19,9,10,2
MICHOACÁN DE OCAMPO,16,TUZANTLA,099,MESA EL ENCINAL,3,18,11,7,3
MICHOACÁN DE OCAMPO,16,TUZANTLA,099,ORGANISTA Y POTRERILLOS,2,34,19,15,3
MICHOACÁN DE OCAMPO,16,TUZANTLA,099,PASO ANCHO,2,51,22,29,3
MICHOACÁN DE OCAMPO,16,TUZANTLA,099,PASO NICOLÁS ROMERO (LAS PUERCAS),2,10,3,7,2
MICHOACÁN DE OCAMPO,16,TUZANTLA,099,PUERTO COLORADO,2,5,2,3,1
MICHOACÁN DE OCAMPO,16,TUZANTLA,099,SAN PATRICIO BUENAVISTA,1,5,2,3,1
MICHOACÁN DE OCAMPO,16,TUZANTLA,099,SINGANCHO,1,10,7,3,1
MICHOACÁN DE OCAMPO,16,TUZANTLA,099,SOLEDAD GRANDE,3,25,14,11,3
MICHOACÁN DE OCAMPO,16,TUZANTLA,099,TAMATA,2,11,6,5,2
MICHOACÁN DE OCAMPO,16,TUZANTLA,099,TARACATÍO,3,59,24,35,7
MICHOACÁN DE OCAMPO,16,TUZANTLA,099,TIRIPETÍO,2,31,14,17,4
MICHOACÁN DE OCAMPO,16,TUZANTLA,099,TUZANTLA,13,1363,735,628,98
MICHOACÁN DE OCAMPO,16,TZINTZUNTZAN,100,COENEMBO,2,54,29,25,5
MICHOACÁN DE OCAMPO,16,TZINTZUNTZAN,100,COLONIA LÁZARO CÁRDENAS,2,40,21,19,3
MICHOACÁN DE OCAMPO,16,TZINTZUNTZAN,100,CUCUCHUCHO (SAN PEDRO),5,188,102,86,16
MICHOACÁN DE OCAMPO,16,TZINTZUNTZAN,100,EL JAGÜEY (EL MOLINO),3,134,66,68,8
MICHOACÁN DE OCAMPO,16,TZINTZUNTZAN,100,EL TIGRE,2,65,27,38,5
MICHOACÁN DE OCAMPO,16,TZINTZUNTZAN,100,ICHUPIO,3,55,23,32,5
MICHOACÁN DE OCAMPO,16,TZINTZUNTZAN,100,IHUATZIO,7,989,498,491,56
MICHOACÁN DE OCAMPO,16,TZINTZUNTZAN,100,ISLA DE PACANDA (ISLA PACANDA),3,79,33,46,7
MICHOACÁN DE OCAMPO,16,TZINTZUNTZAN,100,LA NORIA,1,15,8,7,1
MICHOACÁN DE OCAMPO,16,TZINTZUNTZAN,100,LAS CUEVAS,2,20,9,11,3
MICHOACÁN DE OCAMPO,16,TZINTZUNTZAN,100,LOS CORRALES,4,141,75,66,14
MICHOACÁN DE OCAMPO,16,TZINTZUNTZAN,100,NUEVO RODEO,2,53,27,26,4
MICHOACÁN DE OCAMPO,16,TZINTZUNTZAN,100,PATAMBICHO,2,46,22,24,4
MICHOACÁN DE OCAMPO,16,TZINTZUNTZAN,100,SANABRIA,2,17,10,7,2
MICHOACÁN DE OCAMPO,16,TZINTZUNTZAN,100,SANTA CRUZ,3,105,55,50,7
MICHOACÁN DE OCAMPO,16,TZINTZUNTZAN,100,TARERÍO,2,43,22,21,3
MICHOACÁN DE OCAMPO,16,TZINTZUNTZAN,100,TZINTZUNTZAN,10,1380,702,678,105
MICHOACÁN DE OCAMPO,16,TZINTZUNTZAN,100,TZINTZUNTZITA,2,24,13,11,2
MICHOACÁN DE OCAMPO,16,TZINTZUNTZAN,100,TZIRANGA,1,4,3,1,1
MICHOACÁN DE OCAMPO,16,TZINTZUNTZAN,100,UCASANÁSTACUA,3,46,28,18,4
MICHOACÁN DE OCAMPO,16,TZITZIO,101,AGUA CALIENTE,1,7,3,4,1
MICHOACÁN DE OCAMPO,16,TZITZIO,101,AGUA FRÍA,2,90,47,43,6
MICHOACÁN DE OCAMPO,16,TZITZIO,101,ARROYO DEL TORO,2,13,8,5,2
MICHOACÁN DE OCAMPO,16,TZITZIO,101,CERRITOS,1,5,1,4,1
MICHOACÁN DE OCAMPO,16,TZITZIO,101,CHINAPA (PUENTE DE CHINAPA),2,19,9,10,2
MICHOACÁN DE OCAMPO,16,TZITZIO,101,COPUYO,3,46,20,26,3
MICHOACÁN DE OCAMPO,16,TZITZIO,101,DEVANADOR DE RIVERA,4,192,102,90,13
MICHOACÁN DE OCAMPO,16,TZITZIO,101,EL AGUACATE,1,14,9,5,1
MICHOACÁN DE OCAMPO,16,TZITZIO,101,EL BUEY,1,3,2,1,1
MICHOACÁN DE OCAMPO,16,TZITZIO,101,EL CHILAR,2,6,2,4,1
MICHOACÁN DE OCAMPO,16,TZITZIO,101,EL DERRUMBADERO,1,12,6,6,1
MICHOACÁN DE OCAMPO,16,TZITZIO,101,EL DURAZNO,2,22,12,10,2
MICHOACÁN DE OCAMPO,16,TZITZIO,101,EL LIMÓN,1,9,4,5,1
MICHOACÁN DE OCAMPO,16,TZITZIO,101,EL MANGUITO,1,5,2,3,1
MICHOACÁN DE OCAMPO,16,TZITZIO,101,EL MEZCAL,3,43,21,22,3
MICHOACÁN DE OCAMPO,16,TZITZIO,101,EL PALMARITO,3,23,12,11,3
MICHOACÁN DE OCAMPO,16,TZITZIO,101,EL PINO,2,8,4,4,1
MICHOACÁN DE OCAMPO,16,TZITZIO,101,EL PLATANILLO,4,89,53,36,6
MICHOACÁN DE OCAMPO,16,TZITZIO,101,EL PUERTO DE LA MUÑECA,2,7,5,2,1
MICHOACÁN DE OCAMPO,16,TZITZIO,101,EL REPARO,2,23,9,14,2
MICHOACÁN DE OCAMPO,16,TZITZIO,101,EL TEPAMAL,3,19,14,5,2
MICHOACÁN DE OCAMPO,16,TZITZIO,101,EL TEPEHUAJE,2,9,5,4,1
MICHOACÁN DE OCAMPO,16,TZITZIO,101,EL ZAPOTILLO,1,10,6,4,1
MICHOACÁN DE OCAMPO,16,TZITZIO,101,GUAYABO DE DERRUMBADERO (LA CHATANICUA),2,42,16,26,3
MICHOACÁN DE OCAMPO,16,TZITZIO,101,GUAYABO DE RUIZ,3,6,3,3,3
MICHOACÁN DE OCAMPO,16,TZITZIO,101,JAHUICAL,2,10,6,4,2
MICHOACÁN DE OCAMPO,16,TZITZIO,101,LA BUFA,1,3,3,0,1
MICHOACÁN DE OCAMPO,16,TZITZIO,101,LA COFRADÍA,2,9,5,4,1
MICHOACÁN DE OCAMPO,16,TZITZIO,101,LA HUERTA,1,7,5,2,1
MICHOACÁN DE OCAMPO,16,TZITZIO,101,LA LAGUNITA,1,7,2,5,1
MICHOACÁN DE OCAMPO,16,TZITZIO,101,LA LAJA,3,29,17,12,3
MICHOACÁN DE OCAMPO,16,TZITZIO,101,LAS GALLERAS,2,22,9,13,2
MICHOACÁN DE OCAMPO,16,TZITZIO,101,LAS MESAS,3,22,9,13,3
MICHOACÁN DE OCAMPO,16,TZITZIO,101,LAS SAIBAS,1,4,3,1,1
MICHOACÁN DE OCAMPO,16,TZITZIO,101,LAS TAMACUAS,2,14,8,6,2
MICHOACÁN DE OCAMPO,16,TZITZIO,101,LOS AGUACATES,2,7,4,3,1
MICHOACÁN DE OCAMPO,16,TZITZIO,101,LOS AZARES,2,15,8,7,1
MICHOACÁN DE OCAMPO,16,TZITZIO,101,LOS LLANITOS (LOS PELILLOS),2,12,4,8,2
MICHOACÁN DE OCAMPO,16,TZITZIO,101,LOS PARAJES (EL PINAL),1,12,6,6,1
MICHOACÁN DE OCAMPO,16,TZITZIO,101,LOS PLANES (EL PLAN),1,12,5,7,1
MICHOACÁN DE OCAMPO,16,TZITZIO,101,LOS PLANES (LA PINZANERA),2,5,5,0,1
MICHOACÁN DE OCAMPO,16,TZITZIO,101,LOS TIMONES,2,11,7,4,3
MICHOACÁN DE OCAMPO,16,TZITZIO,101,MANZANA DE QUERETANILLO,2,47,21,26,4
MICHOACÁN DE OCAMPO,16,TZITZIO,101,PÁRAMO,3,45,17,28,3
MICHOACÁN DE OCAMPO,16,TZITZIO,101,PASO ANCHO,2,21,13,8,2
MICHOACÁN DE OCAMPO,16,TZITZIO,101,PIEDRA DEL AGUA (PEÑA DEL AGUA),2,3,2,1,1
MICHOACÁN DE OCAMPO,16,TZITZIO,101,PLAN DE GUADALUPE (LAS IGUANAS),2,29,17,12,2
MICHOACÁN DE OCAMPO,16,TZITZIO,101,SANTA ROSA (LA DESVIACIÓN),1,21,12,9,2
MICHOACÁN DE OCAMPO,16,TZITZIO,101,SANTAS MARÍAS,3,32,21,11,3
MICHOACÁN DE OCAMPO,16,TZITZIO,101,TAFETÁN,4,591,274,317,40
MICHOACÁN DE OCAMPO,16,TZITZIO,101,TIQUIHUITUCHA,2,40,24,16,3
MICHOACÁN DE OCAMPO,16,TZITZIO,101,TROJITAS (LAS TROJAS),1,9,2,7,1
MICHOACÁN DE OCAMPO,16,TZITZIO,101,TZITZIO,4,466,250,216,32
MICHOACÁN DE OCAMPO,16,TZITZIO,101,YRANCHE,2,68,37,31,4
MICHOACÁN DE OCAMPO,16,URUAPAN,102,ANGAHUAN,11,2321,1201,1120,109
MICHOACÁN DE OCAMPO,16,URUAPAN,102,BETANIA,2,10,2,8,2
MICHOACÁN DE OCAMPO,16,URUAPAN,102,CALTZONTZIN,8,1708,865,843,81
MICHOACÁN DE OCAMPO,16,URUAPAN,102,CAMPAMENTO ZUMPIMITO (LA PLANTA),3,635,310,325,26
MICHOACÁN DE OCAMPO,16,URUAPAN,102,CAPÁCUARO,12,2419,1205,1214,107
MICHOACÁN DE OCAMPO,16,URUAPAN,102,CHERANGUERÁN,4,181,88,93,10
MICHOACÁN DE OCAMPO,16,URUAPAN,102,CHIMILPA (EL ZAPOTE),2,8,3,5,1
MICHOACÁN DE OCAMPO,16,URUAPAN,102,CORUPO,5,395,199,196,21
MICHOACÁN DE OCAMPO,16,URUAPAN,102,CUTZATO (CUISATO),4,338,188,150,18
MICHOACÁN DE OCAMPO,16,URUAPAN,102,EL ARROYO COLORADO,2,129,65,64,6
MICHOACÁN DE OCAMPO,16,URUAPAN,102,EL DURAZNO,3,73,40,33,5
MICHOACÁN DE OCAMPO,16,URUAPAN,102,EL HUCAZ (UKÁS),1,4,2,2,1
MICHOACÁN DE OCAMPO,16,URUAPAN,102,EL MANGUITO (CASAS BLANCAS),1,13,5,8,1
MICHOACÁN DE OCAMPO,16,URUAPAN,102,EL MANGUITO (EL CATORCE),2,14,5,9,2
MICHOACÁN DE OCAMPO,16,URUAPAN,102,EL PUERTO,2,46,21,25,3
MICHOACÁN DE OCAMPO,16,URUAPAN,102,EL SABINO,4,201,109,92,14
MICHOACÁN DE OCAMPO,16,URUAPAN,102,HUIMBÁN,1,9,7,2,1
MICHOACÁN DE OCAMPO,16,URUAPAN,102,JICALÁN (LA PINERITA),4,506,239,267,23
MICHOACÁN DE OCAMPO,16,URUAPAN,102,JICALÁN VIEJO (LA LAGUNA),2,10,7,3,1
MICHOACÁN DE OCAMPO,16,URUAPAN,102,JUCUTÁCATO,6,760,397,363,38
MICHOACÁN DE OCAMPO,16,URUAPAN,102,LA BASILIA,3,329,178,151,18
MICHOACÁN DE OCAMPO,16,URUAPAN,102,LA CARATACUA,3,45,23,22,3
MICHOACÁN DE OCAMPO,16,URUAPAN,102,LA COFRADÍA,2,459,233,226,17
MICHOACÁN DE OCAMPO,16,URUAPAN,102,LA CORTINA,1,46,22,24,2
MICHOACÁN DE OCAMPO,16,URUAPAN,102,LA JOYA DE LOS CHIVOS,2,11,6,5,1
MICHOACÁN DE OCAMPO,16,URUAPAN,102,LA LOMA,2,32,16,16,3
MICHOACÁN DE OCAMPO,16,URUAPAN,102,LAS COCINAS,3,93,34,59,8
MICHOACÁN DE OCAMPO,16,URUAPAN,102,LAS PAJAS,2,11,5,6,2
MICHOACÁN DE OCAMPO,16,URUAPAN,102,LOS DURAZNOS,1,77,42,35,6
MICHOACÁN DE OCAMPO,16,URUAPAN,102,MATA DE PLÁTANO,3,53,27,26,4
MICHOACÁN DE OCAMPO,16,URUAPAN,102,MATANGUARÁN (SAN JOSÉ DEL VALLE),3,214,113,101,10
MICHOACÁN DE OCAMPO,16,URUAPAN,102,NUEVO SAN MARTÍN (PIEDRA PARTIDA),3,65,32,33,5
MICHOACÁN DE OCAMPO,16,URUAPAN,102,NUEVO ZIROSTO,5,733,343,390,42
MICHOACÁN DE OCAMPO,16,URUAPAN,102,ORAPÓNDIRO,3,51,25,26,4
MICHOACÁN DE OCAMPO,16,URUAPAN,102,SAN LORENZO,10,1368,667,701,77
MICHOACÁN DE OCAMPO,16,URUAPAN,102,SAN MARCOS,3,106,53,53,10
MICHOACÁN DE OCAMPO,16,URUAPAN,102,SAN MARTÍN BUENOS AIRES (PIEDRA PARTIDA),2,4,3,1,2
MICHOACÁN DE OCAMPO,16,URUAPAN,102,SANTA ANA ZIROSTO,2,287,143,144,13
MICHOACÁN DE OCAMPO,16,URUAPAN,102,SANTA FE,2,13,9,4,2
MICHOACÁN DE OCAMPO,16,URUAPAN,102,TANAXHURI,3,72,40,32,5
MICHOACÁN DE OCAMPO,16,URUAPAN,102,TEJERÍAS (TEJERÍAS DE SANTA CATARINA),3,455,223,232,18
MICHOACÁN DE OCAMPO,16,URUAPAN,102,TIAMBA,2,75,39,36,5
MICHOACÁN DE OCAMPO,16,URUAPAN,102,TOREO ALTO (TOREO EL ALTO),4,1368,610,758,210
MICHOACÁN DE OCAMPO,16,URUAPAN,102,TOREO BAJO (EL TOREO BAJO),5,1056,511,545,56
MICHOACÁN DE OCAMPO,16,URUAPAN,102,URUAPAN,423,75227,37792,37435,4747
MICHOACÁN DE OCAMPO,16,URUAPAN,102,ZIRAPONDIRO,3,56,28,28,4
MICHOACÁN DE OCAMPO,16,VENUSTIANO CARRANZA,103,CERRITO DE PESCADORES (EL TEPETATE),3,74,45,29,4
MICHOACÁN DE OCAMPO,16,VENUSTIANO CARRANZA,103,CUATRO ESQUINAS,2,22,10,12,2
MICHOACÁN DE OCAMPO,16,VENUSTIANO CARRANZA,103,CUMUATILLO,3,599,310,289,25
MICHOACÁN DE OCAMPO,16,VENUSTIANO CARRANZA,103,EL FORTÍN,3,173,90,83,10
MICHOACÁN DE OCAMPO,16,VENUSTIANO CARRANZA,103,LA MAGDALENA,3,102,45,57,7
MICHOACÁN DE OCAMPO,16,VENUSTIANO CARRANZA,103,LA PALMA (LA PALMA DE JESÚS),8,747,385,362,42
MICHOACÁN DE OCAMPO,16,VENUSTIANO CARRANZA,103,LA SÁBILA,3,52,27,25,5
MICHOACÁN DE OCAMPO,16,VENUSTIANO CARRANZA,103,OJO DE AGUA,3,176,90,86,11
MICHOACÁN DE OCAMPO,16,VENUSTIANO CARRANZA,103,PUEBLO VIEJO,2,160,79,81,8
MICHOACÁN DE OCAMPO,16,VENUSTIANO CARRANZA,103,SAN PEDRO CAHRO,18,2631,1351,1280,125
MICHOACÁN DE OCAMPO,16,VILLAMAR,104,BENITO JUÁREZ (SAN BENITO),1,8,3,5,1
MICHOACÁN DE OCAMPO,16,VILLAMAR,104,CERRITO COLORADO,3,90,40,50,7
MICHOACÁN DE OCAMPO,16,VILLAMAR,104,CERRITO DE COTIJARÁN,2,74,25,49,7
MICHOACÁN DE OCAMPO,16,VILLAMAR,104,COAMEO CHICO,2,12,10,2,2
MICHOACÁN DE OCAMPO,16,VILLAMAR,104,EL FRESNO,3,67,29,38,5
MICHOACÁN DE OCAMPO,16,VILLAMAR,104,EL PLATANAL,4,494,256,238,25
MICHOACÁN DE OCAMPO,16,VILLAMAR,104,EL SALITRE,2,42,25,17,3
MICHOACÁN DE OCAMPO,16,VILLAMAR,104,EL VARAL,2,51,27,24,4
MICHOACÁN DE OCAMPO,16,VILLAMAR,104,EL ZAPOTITO,2,49,27,22,4
MICHOACÁN DE OCAMPO,16,VILLAMAR,104,EMILIANO ZAPATA,6,884,445,439,71
MICHOACÁN DE OCAMPO,16,VILLAMAR,104,JARIPO,3,70,34,36,10
MICHOACÁN DE OCAMPO,16,VILLAMAR,104,LA ORTIGA DE SAN ANTONIO GUARACHA,2,39,15,24,3
MICHOACÁN DE OCAMPO,16,VILLAMAR,104,LA PALMITA (LA PALMA),2,48,20,28,4
MICHOACÁN DE OCAMPO,16,VILLAMAR,104,LA PRESA NUEVA,3,67,36,31,4
MICHOACÁN DE OCAMPO,16,VILLAMAR,104,LAS ESTACAS,3,90,43,47,8
MICHOACÁN DE OCAMPO,16,VILLAMAR,104,LAS ZARQUILLAS,3,106,49,57,8
MICHOACÁN DE OCAMPO,16,VILLAMAR,104,LOS GRANADOS,3,36,16,20,3
MICHOACÁN DE OCAMPO,16,VILLAMAR,104,NICOLÁS ROMERO,2,53,18,35,3
MICHOACÁN DE OCAMPO,16,VILLAMAR,104,SAN ANTONIO GUARACHA,4,340,163,177,22
MICHOACÁN DE OCAMPO,16,VILLAMAR,104,SAN MIGUEL,1,11,6,5,1
MICHOACÁN DE OCAMPO,16,VILLAMAR,104,TARIMORO,2,34,17,17,2
MICHOACÁN DE OCAMPO,16,VILLAMAR,104,TUMBISCATO,1,6,4,2,1
MICHOACÁN DE OCAMPO,16,VILLAMAR,104,VILLAMAR,5,605,316,289,57
MICHOACÁN DE OCAMPO,16,VISTA HERMOSA,105,EL ALVAREÑO,3,440,218,222,21
MICHOACÁN DE OCAMPO,16,VISTA HERMOSA,105,EL CAPULÍN,5,436,202,234,21
MICHOACÁN DE OCAMPO,16,VISTA HERMOSA,105,EL CUENQUEÑO,2,178,79,99,7
MICHOACÁN DE OCAMPO,16,VISTA HERMOSA,105,LA ANGOSTURA,3,287,130,157,17
MICHOACÁN DE OCAMPO,16,VISTA HERMOSA,105,LOS PILARES,2,182,87,95,7
MICHOACÁN DE OCAMPO,16,VISTA HERMOSA,105,NEGRETE (LA ESTACIÓN DE NEGRETE),1,4,2,2,1
MICHOACÁN DE OCAMPO,16,VISTA HERMOSA,105,VISTA HERMOSA DE NEGRETE,14,2712,1388,1324,145
MICHOACÁN DE OCAMPO,16,YURÉCUARO,106,CERRO COLORADO,2,57,28,29,2
MICHOACÁN DE OCAMPO,16,YURÉCUARO,106,COLONIA EMILIANO ZAPATA,2,37,14,23,3
MICHOACÁN DE OCAMPO,16,YURÉCUARO,106,EL CAMICHE,4,144,79,65,11
MICHOACÁN DE OCAMPO,16,YURÉCUARO,106,EL CERRO BLANCO,2,32,17,15,2
MICHOACÁN DE OCAMPO,16,YURÉCUARO,106,EL REFUGIO,3,146,72,74,7
MICHOACÁN DE OCAMPO,16,YURÉCUARO,106,EL TEQUESQUITE,3,307,144,163,12
MICHOACÁN DE OCAMPO,16,YURÉCUARO,106,LA JOYA,2,38,9,29,2
MICHOACÁN DE OCAMPO,16,YURÉCUARO,106,MONTELEÓN,3,241,127,114,14
MICHOACÁN DE OCAMPO,16,YURÉCUARO,106,MUNGUÍA,1,7,4,3,1
MICHOACÁN DE OCAMPO,16,YURÉCUARO,106,SAN ANTONIO,3,71,40,31,4
MICHOACÁN DE OCAMPO,16,YURÉCUARO,106,YURÉCUARO,30,4921,2507,2414,228
MICHOACÁN DE OCAMPO,16,ZACAPU,107,BARRANCA HONDA,2,12,7,5,2
MICHOACÁN DE OCAMPO,16,ZACAPU,107,BUENAVISTA,2,46,19,27,5
MICHOACÁN DE OCAMPO,16,ZACAPU,107,CANTABRIA,4,289,145,144,25
MICHOACÁN DE OCAMPO,16,ZACAPU,107,COLONIA ERÉNDIRA,4,282,141,141,17
MICHOACÁN DE OCAMPO,16,ZACAPU,107,DAVID FRANCO REYES,3,118,52,66,10
MICHOACÁN DE OCAMPO,16,ZACAPU,107,EL COYOLOTE,3,77,35,42,8
MICHOACÁN DE OCAMPO,16,ZACAPU,107,EL PUEBLITO,4,288,146,142,16
MICHOACÁN DE OCAMPO,16,ZACAPU,107,LA COFRADÍA,2,26,12,14,3
MICHOACÁN DE OCAMPO,16,ZACAPU,107,LA ESCONDIDA,3,151,70,81,20
MICHOACÁN DE OCAMPO,16,ZACAPU,107,LA VIRGEN,2,67,29,38,7
MICHOACÁN DE OCAMPO,16,ZACAPU,107,LA YESCA,2,43,22,21,3
MICHOACÁN DE OCAMPO,16,ZACAPU,107,LAS CABRAS,2,19,11,8,3
MICHOACÁN DE OCAMPO,16,ZACAPU,107,LAS CANOAS,3,204,99,105,10
MICHOACÁN DE OCAMPO,16,ZACAPU,107,LOS LLANOS,3,144,77,67,10
MICHOACÁN DE OCAMPO,16,ZACAPU,107,MORELOS,2,43,21,22,3
MICHOACÁN DE OCAMPO,16,ZACAPU,107,NARANJA DE TAPIA,5,641,335,306,43
MICHOACÁN DE OCAMPO,16,ZACAPU,107,RANCHO ALEGRE,2,31,14,17,2
MICHOACÁN DE OCAMPO,16,ZACAPU,107,RINCÓN DE SAN MIGUEL SEGUNDA SECCIÓN,2,61,29,32,5
MICHOACÁN DE OCAMPO,16,ZACAPU,107,SAN ANTONIO PÚCUARO [FRACCIONAMIENTO],2,10,5,5,1
MICHOACÁN DE OCAMPO,16,ZACAPU,107,SAN ANTONIO TARIÁCURI,3,161,81,80,18
MICHOACÁN DE OCAMPO,16,ZACAPU,107,SANTA GERTRUDIS,2,76,34,42,7
MICHOACÁN DE OCAMPO,16,ZACAPU,107,TAREJERO,3,276,150,126,21
MICHOACÁN DE OCAMPO,16,ZACAPU,107,TIRÍNDARO,9,2988,1744,1244,167
MICHOACÁN DE OCAMPO,16,ZACAPU,107,VISTA HERMOSA,3,164,90,74,10
MICHOACÁN DE OCAMPO,16,ZACAPU,107,ZACAPU,96,13377,6880,6497,929
MICHOACÁN DE OCAMPO,16,ZAMORA,108,AQUILES SERDÁN (SANTIAGUILLO),3,278,167,111,13
MICHOACÁN DE OCAMPO,16,ZAMORA,108,ARIO DE RAYÓN (ARIO SANTA MÓNICA),8,2114,1098,1016,109
MICHOACÁN DE OCAMPO,16,ZAMORA,108,ATACHEO DE REGALADO,4,288,151,137,18
MICHOACÁN DE OCAMPO,16,ZAMORA,108,ATECUCARIO DE LA CONSTITUCIÓN (ATECUARIO),5,793,411,382,36
MICHOACÁN DE OCAMPO,16,ZAMORA,108,CANINDO,2,166,72,94,8
MICHOACÁN DE OCAMPO,16,ZAMORA,108,CHAPARACO,4,716,357,359,65
MICHOACÁN DE OCAMPO,16,ZAMORA,108,EL CERRITO DE CATIPUATO (CERRITO DE ORTIZ),2,52,28,24,4
MICHOACÁN DE OCAMPO,16,ZAMORA,108,EL ESPÍRITU,2,65,42,23,4
MICHOACÁN DE OCAMPO,16,ZAMORA,108,EL GUAMÚCHIL,2,30,12,18,3
MICHOACÁN DE OCAMPO,16,ZAMORA,108,EL LLANO,2,95,44,51,5
MICHOACÁN DE OCAMPO,16,ZAMORA,108,EL SAUZ DE ABAJO,4,333,160,173,19
MICHOACÁN DE OCAMPO,16,ZAMORA,108,EL SAUZ DE ARRIBA,1,8,4,4,1
MICHOACÁN DE OCAMPO,16,ZAMORA,108,EL SAUZ DE MAGAÑA,3,83,50,33,7
MICHOACÁN DE OCAMPO,16,ZAMORA,108,JOSÉ GUADALUPE RODRÍGUEZ MORALES (PALO BLANCO),1,6,2,4,1
MICHOACÁN DE OCAMPO,16,ZAMORA,108,LA ESTANCIA DE AMEZCUA,3,273,137,136,16
MICHOACÁN DE OCAMPO,16,ZAMORA,108,LA LABOR (EJIDO DE INDEPENDENCIA),2,20,8,12,2
MICHOACÁN DE OCAMPO,16,ZAMORA,108,LA LADERA,2,92,36,56,7
MICHOACÁN DE OCAMPO,16,ZAMORA,108,LA RINCONADA,3,560,287,273,28
MICHOACÁN DE OCAMPO,16,ZAMORA,108,LA SAUCEDA,5,787,401,386,40
MICHOACÁN DE OCAMPO,16,ZAMORA,108,LICENCIADO LUIS DONALDO COLOSIO [COLONIA],2,14,8,6,2
MICHOACÁN DE OCAMPO,16,ZAMORA,108,LINDA VISTA,6,768,372,396,31
MICHOACÁN DE OCAMPO,16,ZAMORA,108,OJO DE AGUA,2,79,45,34,4
MICHOACÁN DE OCAMPO,16,ZAMORA,108,PRIMERO DE MAYO (LA BEATILLA)[COLONIA],1,156,91,65,6
MICHOACÁN DE OCAMPO,16,ZAMORA,108,PUENTE DE TUBOS,2,96,47,49,7
MICHOACÁN DE OCAMPO,16,ZAMORA,108,ROMERO DE GUZMÁN,2,189,97,92,11
MICHOACÁN DE OCAMPO,16,ZAMORA,108,ROMERO DE TORRES,2,167,70,97,11
MICHOACÁN DE OCAMPO,16,ZAMORA,108,SAN ESTEBAN (EJIDO SANTA CRUZ),2,53,28,25,3
MICHOACÁN DE OCAMPO,16,ZAMORA,108,TIERRAS BLANCAS,2,62,33,29,3
MICHOACÁN DE OCAMPO,16,ZAMORA,108,VILLA ZAPATA (EL GUAYABO),1,5,4,1,1
MICHOACÁN DE OCAMPO,16,ZAMORA,108,VILLAFUERTE,2,49,26,23,3
MICHOACÁN DE OCAMPO,16,ZAMORA,108,ZAMORA DE HIDALGO,235,42297,21667,20630,2800
MICHOACÁN DE OCAMPO,16,ZINÁPARO,109,EL TIGRE (EL REFUGIO),3,80,41,39,5
MICHOACÁN DE OCAMPO,16,ZINÁPARO,109,LA PAJITA,2,10,5,5,2
MICHOACÁN DE OCAMPO,16,ZINÁPARO,109,SANTA BÁRBARA,1,10,6,4,1
MICHOACÁN DE OCAMPO,16,ZINÁPARO,109,ZINÁPARO,8,435,225,210,25
MICHOACÁN DE OCAMPO,16,ZINÁPARO,109,ZIPAQUÍO,1,7,2,5,1
MICHOACÁN DE OCAMPO,16,ZINAPÉCUARO,110,ARARÓ,4,334,161,173,17
MICHOACÁN DE OCAMPO,16,ZINAPÉCUARO,110,BELISARIO DOMÍNGUEZ,3,319,165,154,18
MICHOACÁN DE OCAMPO,16,ZINAPÉCUARO,110,BOCANEO (SAN PEDRO),5,303,142,161,20
MICHOACÁN DE OCAMPO,16,ZINAPÉCUARO,110,BUENAVISTA (SAN MIGUEL BUENAVISTA),4,222,114,108,19
MICHOACÁN DE OCAMPO,16,ZINAPÉCUARO,110,COLONIA DE CORO,2,65,34,31,7
MICHOACÁN DE OCAMPO,16,ZINAPÉCUARO,110,COLONIA EJIDAL EUSEBIO LUNA (ZÓCALO),2,33,12,21,3
MICHOACÁN DE OCAMPO,16,ZINAPÉCUARO,110,CRUZ DE CAMINOS (ENTRONQUE JERÁHUARO),1,22,9,13,1
MICHOACÁN DE OCAMPO,16,ZINAPÉCUARO,110,EL COLORADO (LOS PINOS),2,29,12,17,3
MICHOACÁN DE OCAMPO,16,ZINAPÉCUARO,110,EL FRESNO,2,24,9,15,3
MICHOACÁN DE OCAMPO,16,ZINAPÉCUARO,110,EL JARAL (EL JARAL LAGUNILLAS),2,22,9,13,2
MICHOACÁN DE OCAMPO,16,ZINAPÉCUARO,110,EL JARALILLO,2,18,7,11,2
MICHOACÁN DE OCAMPO,16,ZINAPÉCUARO,110,EL POTRERO,2,42,18,24,3
MICHOACÁN DE OCAMPO,16,ZINAPÉCUARO,110,EL RINCÓN DE JERÁHUARO,2,43,26,17,2
MICHOACÁN DE OCAMPO,16,ZINAPÉCUARO,110,EL ROSARIO (EL TAPANCO),3,16,7,9,2
MICHOACÁN DE OCAMPO,16,ZINAPÉCUARO,110,EL SALTO,2,41,22,19,2
MICHOACÁN DE OCAMPO,16,ZINAPÉCUARO,110,EL TICO,2,109,45,64,5
MICHOACÁN DE OCAMPO,16,ZINAPÉCUARO,110,EL ZAPOTE (EL ZAPOTE BAJO),2,15,8,7,2
MICHOACÁN DE OCAMPO,16,ZINAPÉCUARO,110,FRANCISCO VILLA,4,454,221,233,25
MICHOACÁN DE OCAMPO,16,ZINAPÉCUARO,110,HERIBERTO JARA (LA PRESA),2,58,26,32,4
MICHOACÁN DE OCAMPO,16,ZINAPÉCUARO,110,HUAJÚMBARO (HUAJÚMBARO DE GUADALUPE),4,394,221,173,22
MICHOACÁN DE OCAMPO,16,ZINAPÉCUARO,110,JACUARILLO (JUCUARILLO),2,53,26,27,4
MICHOACÁN DE OCAMPO,16,ZINAPÉCUARO,110,JOSÉ MARÍA MORELOS (LA YEGÜERÍA),3,341,188,153,21
MICHOACÁN DE OCAMPO,16,ZINAPÉCUARO,110,LA GALERA (SAN JOAQUÍN JARIPEO),2,102,48,54,7
MICHOACÁN DE OCAMPO,16,ZINAPÉCUARO,110,LA VENTA DEL CAPULÍN,1,10,4,6,1
MICHOACÁN DE OCAMPO,16,ZINAPÉCUARO,110,LAS CRUCES,2,11,5,6,2
MICHOACÁN DE OCAMPO,16,ZINAPÉCUARO,110,LAS PALOMAS,1,11,5,6,1
MICHOACÁN DE OCAMPO,16,ZINAPÉCUARO,110,LOS GUERREROS (EL FONDO),2,17,8,9,3
MICHOACÁN DE OCAMPO,16,ZINAPÉCUARO,110,LOS TRIGOS,2,23,3,20,3
MICHOACÁN DE OCAMPO,16,ZINAPÉCUARO,110,OJO DE AGUA DE BUCIO,4,284,133,151,20
MICHOACÁN DE OCAMPO,16,ZINAPÉCUARO,110,OJO DE AGUA DEL CUERVO,3,92,45,47,5
MICHOACÁN DE OCAMPO,16,ZINAPÉCUARO,110,OJOS DE AGUA,2,72,31,41,5
MICHOACÁN DE OCAMPO,16,ZINAPÉCUARO,110,QUERÉNDARO [ESTACIÓN],4,371,172,199,28
MICHOACÁN DE OCAMPO,16,ZINAPÉCUARO,110,SAN BARTOLOMÉ CORO,3,76,44,32,7
MICHOACÁN DE OCAMPO,16,ZINAPÉCUARO,110,SAN BERNARDO,2,34,17,17,4
MICHOACÁN DE OCAMPO,16,ZINAPÉCUARO,110,SAN ILDEFONSO,3,155,85,70,9
MICHOACÁN DE OCAMPO,16,ZINAPÉCUARO,110,SAN JOAQUÍN JARIPEO (LA EX-HACIENDA),2,61,23,38,4
MICHOACÁN DE OCAMPO,16,ZINAPÉCUARO,110,SAN JOSÉ CARPINTERO,3,52,24,28,7
MICHOACÁN DE OCAMPO,16,ZINAPÉCUARO,110,SAN JOSÉ DEL RINCÓN (EL RINCÓN DE TAIMEO),3,41,18,23,5
MICHOACÁN DE OCAMPO,16,ZINAPÉCUARO,110,SAN JOSÉ LA TRASQUILA,1,10,5,5,1
MICHOACÁN DE OCAMPO,16,ZINAPÉCUARO,110,SAN MIGUEL LAS PALOMAS (ZACAZONAPAN),3,62,30,32,7
MICHOACÁN DE OCAMPO,16,ZINAPÉCUARO,110,SAN MIGUEL TAIMEO,3,169,87,82,14
MICHOACÁN DE OCAMPO,16,ZINAPÉCUARO,110,SAN NICOLÁS SIMIRAO,2,32,16,16,4
MICHOACÁN DE OCAMPO,16,ZINAPÉCUARO,110,SANTA CLARA DEL TULE,2,129,68,61,9
MICHOACÁN DE OCAMPO,16,ZINAPÉCUARO,110,SANTA CRUZ,1,75,42,33,6
MICHOACÁN DE OCAMPO,16,ZINAPÉCUARO,110,TAIMEO EL CHICO (LA YERBABUENA),3,112,67,45,8
MICHOACÁN DE OCAMPO,16,ZINAPÉCUARO,110,UCAREO,4,907,481,426,57
MICHOACÁN DE OCAMPO,16,ZINAPÉCUARO,110,VALLE DE JUÁREZ (JERÁHUARO),5,611,320,291,35
MICHOACÁN DE OCAMPO,16,ZINAPÉCUARO,110,ZINAPÉCUARO DE FIGUEROA,28,4435,2237,2198,306
MICHOACÁN DE OCAMPO,16,ZINAPÉCUARO,110,ZIRÓNDARO,3,29,14,15,2
MICHOACÁN DE OCAMPO,16,ZIRACUARETIRO,111,CARACHA,4,348,166,182,21
MICHOACÁN DE OCAMPO,16,ZIRACUARETIRO,111,EL COPAL,2,65,32,33,4
MICHOACÁN DE OCAMPO,16,ZIRACUARETIRO,111,EL FRESNO,2,78,28,50,4
MICHOACÁN DE OCAMPO,16,ZIRACUARETIRO,111,LA CIÉNEGA (LOS NARANJOS),3,120,54,66,8
MICHOACÁN DE OCAMPO,16,ZIRACUARETIRO,111,LOS FRESNITOS,2,17,8,9,2
MICHOACÁN DE OCAMPO,16,ZIRACUARETIRO,111,PATUÁN,2,355,184,171,16
MICHOACÁN DE OCAMPO,16,ZIRACUARETIRO,111,SAN ANDRÉS CORU,4,623,310,313,30
MICHOACÁN DE OCAMPO,16,ZIRACUARETIRO,111,SAN ÁNGEL ZURUMUCAPIO,11,1731,861,870,80
MICHOACÁN DE OCAMPO,16,ZIRACUARETIRO,111,ZIRACUARETIRO,10,1482,791,691,78
MICHOACÁN DE OCAMPO,16,ZIRACUARETIRO,111,ZIRASPÉN,2,53,22,31,3
MICHOACÁN DE OCAMPO,16,ZIRACUARETIRO,111,ZIRIMÍCUARO,3,400,201,199,22
MICHOACÁN DE OCAMPO,16,ZITÁCUARO,112,AGUA BLANCA (LA PALMA),3,146,81,65,9
MICHOACÁN DE OCAMPO,16,ZITÁCUARO,112,APUTZIO DE JUÁREZ (SANTA MARÍA),4,399,195,204,22
MICHOACÁN DE OCAMPO,16,ZITÁCUARO,112,ARMADILLOS (TERCERA MANZANA DE TIMBINEO),2,39,24,15,3
MICHOACÁN DE OCAMPO,16,ZITÁCUARO,112,BOCA DE LA CAÑADA (QUARTA MANZANA DE CRESCENCIO MORALES),3,106,54,52,7
MICHOACÁN DE OCAMPO,16,ZITÁCUARO,112,CAMÉMBARO,2,118,63,55,8
MICHOACÁN DE OCAMPO,16,ZITÁCUARO,112,CARPINTEROS,4,211,118,93,12
MICHOACÁN DE OCAMPO,16,ZITÁCUARO,112,CERRO ANCHO (SEGUNDA MANZANA DE NICOLÁS ROMERO),1,17,8,9,1
MICHOACÁN DE OCAMPO,16,ZITÁCUARO,112,CHIMUSDÁ (CUARTA MANZANA DE DONACIANO OJEDA),4,294,168,126,18
MICHOACÁN DE OCAMPO,16,ZITÁCUARO,112,COLONIA ADOLFO LÓPEZ MATEOS,1,49,22,27,3
MICHOACÁN DE OCAMPO,16,ZITÁCUARO,112,COLONIA EMILIANO ZAPATA (SAN JUAN ZITÁCUARO),3,704,358,346,25
MICHOACÁN DE OCAMPO,16,ZITÁCUARO,112,CRESCENCIO MORALES (SAN MATEO),8,824,407,417,55
MICHOACÁN DE OCAMPO,16,ZITÁCUARO,112,DONACIANO OJEDA (PRIMERA Y SEGUNDA MANZANA SAN FRANCISCO),8,361,185,176,21
MICHOACÁN DE OCAMPO,16,ZITÁCUARO,112,DOS RÍOS (BARBECHOS),3,84,39,45,4
MICHOACÁN DE OCAMPO,16,ZITÁCUARO,112,EL AGUACATE,4,502,236,266,19
MICHOACÁN DE OCAMPO,16,ZITÁCUARO,112,EL BORDO,2,40,18,22,3
MICHOACÁN DE OCAMPO,16,ZITÁCUARO,112,EL CAMPAMENTO (SEXTA MANZANA DE NICOLÁS ROMERO),2,153,77,76,10
MICHOACÁN DE OCAMPO,16,ZITÁCUARO,112,EL CAPULÍN,1,9,2,7,1
MICHOACÁN DE OCAMPO,16,ZITÁCUARO,112,EL CAPULÍN (TERCERA MANZANA DE CRESCENCIO MORALES),1,16,9,7,1
MICHOACÁN DE OCAMPO,16,ZITÁCUARO,112,EL ESPINAL (LOS ESPINALES),1,17,8,9,1
MICHOACÁN DE OCAMPO,16,ZITÁCUARO,112,EL GRANJENO,2,67,30,37,3
MICHOACÁN DE OCAMPO,16,ZITÁCUARO,112,EL HORTELANO (PUERTO DE SANTA MARÍA),4,104,47,57,6
MICHOACÁN DE OCAMPO,16,ZITÁCUARO,112,EL KILÓMETRO (LLANO DE SAN FELIPE),4,72,34,38,6
MICHOACÁN DE OCAMPO,16,ZITÁCUARO,112,EL LINDERO (SEGUNDA MANZANA DE CRESCENCIO MORALES),3,75,40,35,5
MICHOACÁN DE OCAMPO,16,ZITÁCUARO,112,EL LLANO DE CURUNGUEO,3,78,42,36,5
MICHOACÁN DE OCAMPO,16,ZITÁCUARO,112,EL NARANJO,2,52,25,27,4
MICHOACÁN DE OCAMPO,16,ZITÁCUARO,112,EL PEDREGAL,3,37,18,19,4
MICHOACÁN DE OCAMPO,16,ZITÁCUARO,112,EL RINCÓN DE SAN FELIPE (TERCERA MANZANA SAN FELIPE),4,230,106,124,11
MICHOACÁN DE OCAMPO,16,ZITÁCUARO,112,EL RINCÓN DE VECHI,2,28,10,18,3
MICHOACÁN DE OCAMPO,16,ZITÁCUARO,112,EL SANTÍSIMO (QUINTA MANZANA DE CRESCENCIO MORALES),2,52,18,34,7
MICHOACÁN DE OCAMPO,16,ZITÁCUARO,112,EL SAUZ (TERCERA MANZANA),1,3,1,2,1
MICHOACÁN DE OCAMPO,16,ZITÁCUARO,112,EL SOMBRERETE (TERCERA MANZANA DE CURUNGUEO),2,44,29,15,4
MICHOACÁN DE OCAMPO,16,ZITÁCUARO,112,EL TIGRE (SEGUNDA MANZANA DE CRESCENCIO MORALES),3,150,76,74,8
MICHOACÁN DE OCAMPO,16,ZITÁCUARO,112,EL TIGRITO (SEGUNDA MANZANA DE CRESCENCIO MORALES),2,63,38,25,5
MICHOACÁN DE OCAMPO,16,ZITÁCUARO,112,FRANCISCO SERRATO (SAN BARTOLO),8,482,239,243,30
MICHOACÁN DE OCAMPO,16,ZITÁCUARO,112,HERÓICA ZITÁCUARO,113,25340,13455,11885,1781
MICHOACÁN DE OCAMPO,16,ZITÁCUARO,112,IGNACIO LÓPEZ RAYÓN (COYOTA PRIMERA MANZANA),4,296,146,150,15
MICHOACÁN DE OCAMPO,16,ZITÁCUARO,112,KILÓMETRO ONCE,2,51,28,23,4
MICHOACÁN DE OCAMPO,16,ZITÁCUARO,112,LA AGUACATERA DEL MONTE,2,8,3,5,1
MICHOACÁN DE OCAMPO,16,ZITÁCUARO,112,LA BARRANCA (QUINTA MANZANA CRESCENCIO MORALES),5,283,141,142,20
MICHOACÁN DE OCAMPO,16,ZITÁCUARO,112,LA CAPILLA (TERCERA MANZANA DE FRANCISCO SERRATO),4,119,57,62,11
MICHOACÁN DE OCAMPO,16,ZITÁCUARO,112,LA COLONIA DE APUTZIO,2,46,26,20,4
MICHOACÁN DE OCAMPO,16,ZITÁCUARO,112,LA CORTINA,2,41,18,23,3
MICHOACÁN DE OCAMPO,16,ZITÁCUARO,112,LA CUMBRE (QUINTA MANZANA DE CRESCENCIO MORALES),2,48,19,29,3
MICHOACÁN DE OCAMPO,16,ZITÁCUARO,112,LA DIETA (SEGUNDA MANZANA DE CRESCENCIO MORALES),3,131,54,77,7
MICHOACÁN DE OCAMPO,16,ZITÁCUARO,112,LA ENCARNACIÓN,4,899,444,455,62
MICHOACÁN DE OCAMPO,16,ZITÁCUARO,112,LA FUNDICIÓN (QUINTA MANZANA),5,529,278,251,29
MICHOACÁN DE OCAMPO,16,ZITÁCUARO,112,LA GIRONDA (HACIENDA LA GIRONDA),3,77,33,44,6
MICHOACÁN DE OCAMPO,16,ZITÁCUARO,112,LA GUITARRITA (LA GUITARRA),1,6,2,4,1
MICHOACÁN DE OCAMPO,16,ZITÁCUARO,112,LA JOYA DE MANZANILLO (SEGUNDA MANZANA),1,19,8,11,2
MICHOACÁN DE OCAMPO,16,ZITÁCUARO,112,LA MESA,1,10,5,5,1
MICHOACÁN DE OCAMPO,16,ZITÁCUARO,112,LA MESA (LA MESA DE CEDANO),4,492,208,284,24
MICHOACÁN DE OCAMPO,16,ZITÁCUARO,112,LA MESA DEL RINCÓN DE CURUNGUEO,1,9,3,6,1
MICHOACÁN DE OCAMPO,16,ZITÁCUARO,112,LA PALMA,6,673,332,341,28
MICHOACÁN DE OCAMPO,16,ZITÁCUARO,112,LA PERA (LA MORA EL AGUACATE),4,191,89,102,9
MICHOACÁN DE OCAMPO,16,ZITÁCUARO,112,LA PRESA (SEGUNDA MANZANA BARRIO DE SANTA CRUZ),2,94,41,53,6
MICHOACÁN DE OCAMPO,16,ZITÁCUARO,112,LA SOLEDAD (CUARTA MANZANA DE FRANCISCO SERRATO),2,107,51,56,8
MICHOACÁN DE OCAMPO,16,ZITÁCUARO,112,LA VIGUITA (CUARTA MANZANA DE CRESCENCIO MORALES),2,127,59,68,6
MICHOACÁN DE OCAMPO,16,ZITÁCUARO,112,LA Y GRIEGA,3,154,80,74,10
MICHOACÁN DE OCAMPO,16,ZITÁCUARO,112,LA ZIRANDA (EL FRESNO),3,111,48,63,7
MICHOACÁN DE OCAMPO,16,ZITÁCUARO,112,LAS LOMAS DE APUTZIO (LAS LOMAS),3,71,25,46,6
MICHOACÁN DE OCAMPO,16,ZITÁCUARO,112,LAS MAJADAS (RANCHO DE GUADALUPE),3,118,61,57,6
MICHOACÁN DE OCAMPO,16,ZITÁCUARO,112,LAS PERAS,1,12,7,5,1
MICHOACÁN DE OCAMPO,16,ZITÁCUARO,112,LAS PILAS,2,18,8,10,2
MICHOACÁN DE OCAMPO,16,ZITÁCUARO,112,LAS PILITAS,2,14,4,10,1
MICHOACÁN DE OCAMPO,16,ZITÁCUARO,112,LAS ROSAS,2,57,29,28,4
MICHOACÁN DE OCAMPO,16,ZITÁCUARO,112,LAS TILIAS (LA HACIENDITA),2,26,16,10,3
MICHOACÁN DE OCAMPO,16,ZITÁCUARO,112,LECHUGUILLAS,2,20,8,12,2
MICHOACÁN DE OCAMPO,16,ZITÁCUARO,112,LINDA VISTA (EL BOSQUE),2,76,36,40,5
MICHOACÁN DE OCAMPO,16,ZITÁCUARO,112,LOMA DE APARICIO,3,95,55,40,5
MICHOACÁN DE OCAMPO,16,ZITÁCUARO,112,LOMA LARGA,2,40,17,23,4
MICHOACÁN DE OCAMPO,16,ZITÁCUARO,112,LOS AILES,1,26,8,18,2
MICHOACÁN DE OCAMPO,16,ZITÁCUARO,112,LOS ESCOBALES (QUINTA MANZANA DE CRESCENCIO MORALES),4,201,112,89,15
MICHOACÁN DE OCAMPO,16,ZITÁCUARO,112,LOS LAMPAZOS (TERCERA MANZANA),2,4,1,3,1
MICHOACÁN DE OCAMPO,16,ZITÁCUARO,112,LOS POLVILLOS (EL CRUCERO),2,58,28,30,4
MICHOACÁN DE OCAMPO,16,ZITÁCUARO,112,LOS REYES (QUINTA MANZANA),2,6,3,3,1
MICHOACÁN DE OCAMPO,16,ZITÁCUARO,112,LOS ZAPOTES (PUERTO LOS ZAPOTES),3,59,21,38,7
MICHOACÁN DE OCAMPO,16,ZITÁCUARO,112,MACHO DE AGUA (QUINTA MANZANA DE CRESCENCIO MORALES),6,519,268,251,26
MICHOACÁN DE OCAMPO,16,ZITÁCUARO,112,MACUTZIO,2,97,50,47,7
MICHOACÁN DE OCAMPO,16,ZITÁCUARO,112,MANZANILLOS (PRIMERA MANZANA),4,136,67,69,11
MICHOACÁN DE OCAMPO,16,ZITÁCUARO,112,MESA DE LOMA LARGA (LOMA BONITA),2,65,35,30,3
MICHOACÁN DE OCAMPO,16,ZITÁCUARO,112,MESA DE LOS ALZATI (MESA DE SAN FELIPE),4,296,146,150,14
MICHOACÁN DE OCAMPO,16,ZITÁCUARO,112,MESAS DE ENANDIO (CUARTA MANZANA),3,242,126,116,9
MICHOACÁN DE OCAMPO,16,ZITÁCUARO,112,OCURIO,4,345,170,175,19
MICHOACÁN DE OCAMPO,16,ZITÁCUARO,112,OJO DE AGUA (TERCERA MANZANA DE ZIRAHUATO),1,10,6,4,1
MICHOACÁN DE OCAMPO,16,ZITÁCUARO,112,PIEDRA AHUMADA,2,29,16,13,3
MICHOACÁN DE OCAMPO,16,ZITÁCUARO,112,PUENTECILLAS (TERCERA MANZANA DE DONACIANO OJEDA),2,47,18,29,4
MICHOACÁN DE OCAMPO,16,ZITÁCUARO,112,PUENTECILLAS (TERCERA MANZANA DE ZIRAHUATO),4,194,95,99,14
MICHOACÁN DE OCAMPO,16,ZITÁCUARO,112,PUENTEZUELAS (TERCERA MANZANA DE CURUNGUEO),2,57,29,28,4
MICHOACÁN DE OCAMPO,16,ZITÁCUARO,112,PUERTO AZUL (QUINTA MANZANA DE SAN FELIPE),3,87,40,47,7
MICHOACÁN DE OCAMPO,16,ZITÁCUARO,112,RINCÓN DE CURUNGUEO (SEGUNADA MANZANA DE CURUNGUEO),3,290,150,140,17
MICHOACÁN DE OCAMPO,16,ZITÁCUARO,112,RINCÓN DE NICOLÁS ROMERO (CEDROS TERCERA MANZANA),13,1670,855,815,74
MICHOACÁN DE OCAMPO,16,ZITÁCUARO,112,RINCÓN DEL AHORCADO,3,108,59,49,7
MICHOACÁN DE OCAMPO,16,ZITÁCUARO,112,ROSA SANTA,1,5,2,3,1
MICHOACÁN DE OCAMPO,16,ZITÁCUARO,112,ROSAS DE ZÍCATA,2,14,6,8,2
MICHOACÁN DE OCAMPO,16,ZITÁCUARO,112,SAN FELIPE LOS ALZATI (COLONIA NUEVA),9,2736,1591,1145,194
MICHOACÁN DE OCAMPO,16,ZITÁCUARO,112,SAN FRANCISCO CURUNGUEO,7,968,497,471,55
MICHOACÁN DE OCAMPO,16,ZITÁCUARO,112,SAN MIGUEL CHICHIMEQUILLAS,1,143,63,80,8
MICHOACÁN DE OCAMPO,16,ZITÁCUARO,112,SEIS PALOS (QUINTA MANZANA DE SAN MIGUEL),2,139,67,72,7
MICHOACÁN DE OCAMPO,16,ZITÁCUARO,112,SILVA DE ABAJO,3,167,87,80,10
MICHOACÁN DE OCAMPO,16,ZITÁCUARO,112,SILVA DE ARRIBA (EL CHORRITO),2,46,22,24,3
MICHOACÁN DE OCAMPO,16,ZITÁCUARO,112,TERCERA MANZANA DE MANZANILLOS (EL RANCHO),1,60,30,30,6
MICHOACÁN DE OCAMPO,16,ZITÁCUARO,112,TIMBINEO LOS CONTRERAS,4,89,44,45,7
MICHOACÁN DE OCAMPO,16,ZITÁCUARO,112,TOMA DE AGUA,3,289,151,138,14
MICHOACÁN DE OCAMPO,16,ZITÁCUARO,112,VALLE VERDE,3,274,137,137,15
MICHOACÁN DE OCAMPO,16,ZITÁCUARO,112,ZIRAHUATO DE LOS BERNAL,10,730,341,389,48
MICHOACÁN DE OCAMPO,16,ZITÁCUARO,112,ZITÁCUARO [PARQUE INDUSTRIAL],4,144,80,64,24
MICHOACÁN DE OCAMPO,16,JOSÉ SIXTO VERDUZCO,113,AGUA CALIENTE DE SAN SEBASTIÁN,3,54,24,30,5
MICHOACÁN DE OCAMPO,16,JOSÉ SIXTO VERDUZCO,113,COLONIA MELCHOR OCAMPO,1,6,4,2,1
MICHOACÁN DE OCAMPO,16,JOSÉ SIXTO VERDUZCO,113,COLONIA MORELOS,2,23,10,13,2
MICHOACÁN DE OCAMPO,16,JOSÉ SIXTO VERDUZCO,113,EL ARCO,3,143,81,62,11
MICHOACÁN DE OCAMPO,16,JOSÉ SIXTO VERDUZCO,113,GILDARDO MAGAÑA,4,190,106,84,11
MICHOACÁN DE OCAMPO,16,JOSÉ SIXTO VERDUZCO,113,GODINO,3,88,45,43,9
MICHOACÁN DE OCAMPO,16,JOSÉ SIXTO VERDUZCO,113,HÉROES DE CHAPULTEPEC (RODEO DE SAN ANTONIO),3,237,134,103,10
MICHOACÁN DE OCAMPO,16,JOSÉ SIXTO VERDUZCO,113,LA CALERA (NACIMIENTOS),4,293,152,141,17
MICHOACÁN DE OCAMPO,16,JOSÉ SIXTO VERDUZCO,113,LOS CORRALES,2,65,34,31,4
MICHOACÁN DE OCAMPO,16,JOSÉ SIXTO VERDUZCO,113,MANCERA,4,303,154,149,15
MICHOACÁN DE OCAMPO,16,JOSÉ SIXTO VERDUZCO,113,MEZQUITE GORDO,3,79,39,40,6
MICHOACÁN DE OCAMPO,16,JOSÉ SIXTO VERDUZCO,113,PASTOR ORTIZ,12,1683,854,829,88
MICHOACÁN DE OCAMPO,16,JOSÉ SIXTO VERDUZCO,113,SAN ISIDRO TIERRAS BLANCAS,2,41,22,19,2
MICHOACÁN DE OCAMPO,16,JOSÉ SIXTO VERDUZCO,113,SAN JOSÉ HUIPANA,6,743,387,356,39
MICHOACÁN DE OCAMPO,16,JOSÉ SIXTO VERDUZCO,113,SAN MARTÍN,5,408,203,205,30
MICHOACÁN DE OCAMPO,16,JOSÉ SIXTO VERDUZCO,113,TAFOLLA (JOSÉ MARÍA TAFOLLA),3,143,56,87,8
MICHOACÁN DE OCAMPO,16,JOSÉ SIXTO VERDUZCO,113,TRES MEZQUITES,4,339,186,153,22
MICHOACÁN DE OCAMPO,16,JOSÉ SIXTO VERDUZCO,113,UNIÓN JUÁREZ (AGUA GORDA),5,307,156,151,18
MICHOACÁN DE OCAMPO,16,JOSÉ SIXTO VERDUZCO,113,ZAPOTE DE PARRAS,2,79,38,41,8
MORELOS,17,AMACUZAC,001,AMACUZAC,7,1321,657,664,91
MORELOS,17,AMACUZAC,001,CAJONES,3,79,44,35,7
MORELOS,17,AMACUZAC,001,CAMPO NUEVO,1,5,3,2,1
MORELOS,17,AMACUZAC,001,CASAHUATLÁN,5,355,188,167,22
MORELOS,17,AMACUZAC,001,COAHUIXTLA,3,215,109,106,13
MORELOS,17,AMACUZAC,001,COLONIA EJIDAL,1,30,16,14,2
MORELOS,17,AMACUZAC,001,COLONIA EL CAMPAMENTO,1,11,5,6,1
MORELOS,17,AMACUZAC,001,COLONIA OJO DE AGUA,2,99,53,46,5
MORELOS,17,AMACUZAC,001,HUAJINTLÁN,4,393,191,202,26
MORELOS,17,AMACUZAC,001,LOS LIMONES,1,5,4,1,1
MORELOS,17,AMACUZAC,001,MIAHUATLÁN (EL CUIJI),3,127,47,80,7
MORELOS,17,AMACUZAC,001,RANCHO NUEVO,4,177,92,85,12
MORELOS,17,AMACUZAC,001,SAN GABRIEL LAS PALMAS,5,395,190,205,21
MORELOS,17,AMACUZAC,001,TEACALCO,3,198,104,94,10
MORELOS,17,AMACUZAC,001,ZOQUITAL,3,39,26,13,4
MORELOS,17,ATLATLAHUCAN,002,AMPLIACIÓN SAN ANTONIO,1,1055,639,416,60
MORELOS,17,ATLATLAHUCAN,002,ATLATLAHUCAN,18,3017,1594,1423,133
MORELOS,17,ATLATLAHUCAN,002,COLONIA KILÓMETRO 88,2,309,162,147,11
MORELOS,17,ATLATLAHUCAN,002,COLONIA POZO MANCERA,2,50,23,27,3
MORELOS,17,ATLATLAHUCAN,002,COLONIA SAN FRANCISCO,6,263,119,144,20
MORELOS,17,ATLATLAHUCAN,002,EL ASTILLERO,2,59,28,31,3
MORELOS,17,ATLATLAHUCAN,002,FRACCIONAMIENTO LOMAS DE COCOYOC,4,314,180,134,34
MORELOS,17,ATLATLAHUCAN,002,LAS MINAS,2,222,116,106,9
MORELOS,17,ATLATLAHUCAN,002,LOS CERRITOS,4,158,35,123,11
MORELOS,17,ATLATLAHUCAN,002,SAN DIEGO TEPANTONGO,3,108,49,59,7
MORELOS,17,ATLATLAHUCAN,002,SAN JUAN TEXCALPAN,3,339,154,185,12
MORELOS,17,ATLATLAHUCAN,002,SANTA INÉS,2,5,3,2,1
MORELOS,17,ATLATLAHUCAN,002,TLALTETELCO (SAN MIGUEL TLALTETELCO),3,399,199,200,16
MORELOS,17,ATLATLAHUCAN,002,UNIDAD HABITACIONAL VICENTE GUERRERO,2,165,73,92,6
MORELOS,17,AXOCHIAPAN,003,AHUAXTLA,2,93,32,61,4
MORELOS,17,AXOCHIAPAN,003,ATLACAHUALOYA,3,840,423,417,31
MORELOS,17,AXOCHIAPAN,003,AXOCHIAPAN,27,5150,2735,2415,273
MORELOS,17,AXOCHIAPAN,003,CAMPO JICAMAL,1,39,17,22,2
MORELOS,17,AXOCHIAPAN,003,CAYEHUACÁN,3,68,29,39,4
MORELOS,17,AXOCHIAPAN,003,JOAQUÍN CAMAÑO,3,97,32,65,6
MORELOS,17,AXOCHIAPAN,003,LA TOMA,2,51,23,28,4
MORELOS,17,AXOCHIAPAN,003,LOS GAVILANES,1,9,3,6,1
MORELOS,17,AXOCHIAPAN,003,MARCELINO RODRÍGUEZ (SAN IGNACIO),5,812,413,399,30
MORELOS,17,AXOCHIAPAN,003,PALO BLANCO,2,67,29,38,3
MORELOS,17,AXOCHIAPAN,003,PATUALA [PARAJE],1,14,7,7,1
MORELOS,17,AXOCHIAPAN,003,QUEBRANTADERO,3,426,194,232,19
MORELOS,17,AXOCHIAPAN,003,TELIXTAC,5,1201,614,587,50
MORELOS,17,AXOCHIAPAN,003,TLALAYO,3,262,114,148,10
MORELOS,17,AYALA,004,ABELARDO L. RODRÍGUEZ,3,270,131,139,12
MORELOS,17,AYALA,004,ANENECUILCO,13,1561,807,754,83
MORELOS,17,AYALA,004,BENITO JUÁREZ,1,64,31,33,3
MORELOS,17,AYALA,004,BUENA VISTA,4,1888,1146,742,87
MORELOS,17,AYALA,004,CHINAMECA,5,700,359,341,45
MORELOS,17,AYALA,004,CIUDAD AYALA,23,2146,1025,1121,172
MORELOS,17,AYALA,004,COLONIA AMPLIACIÓN CRUZ VERDE,1,77,36,41,4
MORELOS,17,AYALA,004,COLONIA EJIDAL RAFAEL MERINO,1,454,332,122,22
MORELOS,17,AYALA,004,COLONIA GENERAL EMILIANO ZAPATA (EL CHIVATERO),2,68,37,31,4
MORELOS,17,AYALA,004,COLONIA LAS ARBOLEDAS,2,246,116,130,8
MORELOS,17,AYALA,004,COLONIA LEOPOLDO HEREDIA,2,425,200,225,16
MORELOS,17,AYALA,004,CONSTANCIO FARFÁN (LA PASCUALA),3,375,185,190,15
MORELOS,17,AYALA,004,EL MIRADOR,1,10,5,5,1
MORELOS,17,AYALA,004,EL SALITRE,3,280,127,153,12
MORELOS,17,AYALA,004,EL VERGEL,2,129,61,68,8
MORELOS,17,AYALA,004,HUACATLACO (LOS ANONOS),3,71,32,39,6
MORELOS,17,AYALA,004,HUITZILILLA,5,510,255,255,24
MORELOS,17,AYALA,004,JALOXTOC,6,943,462,481,49
MORELOS,17,AYALA,004,MOYOTEPEC,5,849,415,434,49
MORELOS,17,AYALA,004,NIÑOS HÉROES,3,207,94,113,9
MORELOS,17,AYALA,004,OLINTEPEC,6,428,207,221,20
MORELOS,17,AYALA,004,PALO BLANCO,2,56,33,23,3
MORELOS,17,AYALA,004,RANCHO EL PAÑUELO,3,54,23,31,4
MORELOS,17,AYALA,004,SAN JUAN AHUEHUEYO,4,434,214,220,21
MORELOS,17,AYALA,004,SAN PEDRO APATLACO,12,1547,802,745,74
MORELOS,17,AYALA,004,SAN VICENTE DE JUÁREZ (LAS PIEDRAS),3,259,132,127,11
MORELOS,17,AYALA,004,TECOMALCO,3,75,34,41,7
MORELOS,17,AYALA,004,TENEXTEPANGO,17,2588,1252,1336,117
MORELOS,17,AYALA,004,TLAYECAC,7,1103,544,559,46
MORELOS,17,AYALA,004,UNIDAD HABITACIONAL 10 DE ABRIL,3,362,169,193,17
MORELOS,17,AYALA,004,UNIDAD HABITACIONAL MARIANO MATAMOROS,2,126,58,68,7
MORELOS,17,AYALA,004,VALLE DE MORELOS,1,68,31,37,3
MORELOS,17,COATLÁN DEL RÍO,005,APANCINGO,3,122,59,63,7
MORELOS,17,COATLÁN DEL RÍO,005,BENITO JUÁREZ,2,51,19,32,3
MORELOS,17,COATLÁN DEL RÍO,005,BUENAVISTA DE ALDAMA,1,17,7,10,1
MORELOS,17,COATLÁN DEL RÍO,005,CHAVARRÍA,3,212,106,106,10
MORELOS,17,COATLÁN DEL RÍO,005,COATLÁN DEL RÍO,6,598,303,295,47
MORELOS,17,COATLÁN DEL RÍO,005,COCOYOTLA,3,177,98,79,11
MORELOS,17,COATLÁN DEL RÍO,005,COLONIA CUAUHTÉMOC,2,52,25,27,4
MORELOS,17,COATLÁN DEL RÍO,005,COLONIA MORELOS,2,99,48,51,5
MORELOS,17,COATLÁN DEL RÍO,005,EL AXIXINTLE (EL TREINTA Y CINCO),1,10,2,8,1
MORELOS,17,COATLÁN DEL RÍO,005,MICHAPA,4,492,229,263,20
MORELOS,17,COATLÁN DEL RÍO,005,SAN ANTONIO,1,6,1,5,1
MORELOS,17,COATLÁN DEL RÍO,005,TILANCINGO,3,192,89,103,10
MORELOS,17,CUAUTLA,006,19 DE FEBRERO DE 1812,2,102,53,49,7
MORELOS,17,CUAUTLA,006,AMPLIACIÓN BIZNAGA UNO,2,27,13,14,3
MORELOS,17,CUAUTLA,006,AMPLIACIÓN FRANCISCO I. MADERO,2,345,174,171,15
MORELOS,17,CUAUTLA,006,AMPLIACIÓN GABRIEL TEPEPA,11,3551,1908,1643,231
MORELOS,17,CUAUTLA,006,AMPLIACIÓN IZTACCÍHUATL,2,3310,1238,2072,31
MORELOS,17,CUAUTLA,006,AMPLIACIÓN NARCISO MENDOZA,1,22,13,9,1
MORELOS,17,CUAUTLA,006,CALDERÓN,3,417,192,225,16
MORELOS,17,CUAUTLA,006,CAMPO EL GUAJE,2,17,11,6,2
MORELOS,17,CUAUTLA,006,CAMPO NUEVO,1,64,31,33,3
MORELOS,17,CUAUTLA,006,COLONIA EL PARAÍSO,1,27,13,14,3
MORELOS,17,CUAUTLA,006,CUAUTLA,366,51111,26178,24933,3202
MORELOS,17,CUAUTLA,006,EL POLVORÍN,1,357,176,181,12
MORELOS,17,CUAUTLA,006,EMPLEADO MUNICIPAL,2,142,74,68,8
MORELOS,17,CUAUTLA,006,EUSEBIO JÁUREGUI (LA ANGOSTURA),6,1717,710,1007,85
MORELOS,17,CUAUTLA,006,EX-HACIENDA EL HOSPITAL,4,497,247,250,27
MORELOS,17,CUAUTLA,006,HÉROE DE NACOZARI,3,549,43,506,34
MORELOS,17,CUAUTLA,006,NARCISO MENDOZA,1,122,54,68,6
MORELOS,17,CUAUTLA,006,PEÑA FLORES (PALO VERDE),5,421,222,199,24
MORELOS,17,CUAUTLA,006,PLAN DE AYALA,1,729,414,315,21
MORELOS,17,CUAUTLA,006,PUXTLA,2,159,78,81,8
MORELOS,17,CUAUTLA,006,TIERRA Y LIBERTAD,1,8,3,5,1
MORELOS,17,CUERNAVACA,007,BUENAVISTA DEL MONTE,4,322,149,173,15
MORELOS,17,CUERNAVACA,007,CERRITOS DE GARCÍA,3,194,109,85,18
MORELOS,17,CUERNAVACA,007,CUERNAVACA,954,122406,64115,58291,11659
MORELOS,17,CUERNAVACA,007,EL CEBADAL,2,6,2,4,1
MORELOS,17,CUERNAVACA,007,VILLA SANTIAGO,1,140,64,76,6
MORELOS,17,EMILIANO ZAPATA,008,CAMPO EL CAPULÍN (LA PRESA),4,324,138,186,32
MORELOS,17,EMILIANO ZAPATA,008,CAMPO EL ÓRGANO,1,25,12,13,2
MORELOS,17,EMILIANO ZAPATA,008,CAMPO EL TOMATAL,2,119,46,73,27
MORELOS,17,EMILIANO ZAPATA,008,COLONIA EL GUANTE,2,108,48,60,6
MORELOS,17,EMILIANO ZAPATA,008,COLONIA MODESTO RANGEL,3,580,301,279,19
MORELOS,17,EMILIANO ZAPATA,008,EMILIANO ZAPATA,90,10076,4975,5101,622
MORELOS,17,EMILIANO ZAPATA,008,PALO ESCRITO (COLONIA BENITO JUÁREZ),3,5182,2330,2852,500
MORELOS,17,EMILIANO ZAPATA,008,SAN JOSÉ DE LAS CUMBRES,3,584,278,306,21
MORELOS,17,EMILIANO ZAPATA,008,TEPETZINGO,3,528,241,287,23
MORELOS,17,EMILIANO ZAPATA,008,TETECALITA,4,755,358,397,25
MORELOS,17,EMILIANO ZAPATA,008,TEZOYUCA,10,1515,729,786,61
MORELOS,17,EMILIANO ZAPATA,008,TRES DE MAYO,6,1394,682,712,71
MORELOS,17,HUITZILAC,009,COAJOMULCO,4,457,224,233,21
MORELOS,17,HUITZILAC,009,FIERRO DEL TORO,3,16,8,8,3
MORELOS,17,HUITZILAC,009,FRACCIONAMIENTO SIERRA ENCANTADA,1,166,85,81,6
MORELOS,17,HUITZILAC,009,HUITZILAC,13,2537,1286,1251,151
MORELOS,17,HUITZILAC,009,KILÓMETRO 47 (ENTRADA AL CAPULÍN),1,8,3,5,1
MORELOS,17,HUITZILAC,009,RINCÓN DEL BOSQUE (LA PALMA),2,151,79,72,8
MORELOS,17,HUITZILAC,009,TECALTITLA,2,83,32,51,7
MORELOS,17,HUITZILAC,009,TRES MARÍAS,6,1426,692,734,61
MORELOS,17,JANTETELCO,010,AMAYUCA,12,1702,874,828,82
MORELOS,17,JANTETELCO,010,CHALCATZINGO,4,475,234,241,23
MORELOS,17,JANTETELCO,010,COLONIA CUATRO CAMINOS,1,22,13,9,2
MORELOS,17,JANTETELCO,010,COLONIA MANUEL ALARCÓN,1,179,77,102,6
MORELOS,17,JANTETELCO,010,JANTETELCO,10,1407,712,695,77
MORELOS,17,JANTETELCO,010,SAN ANTONIO LA ESPERANZA,2,46,16,30,3
MORELOS,17,JANTETELCO,010,TENANGO (SANTA ANA),4,326,156,170,19
MORELOS,17,JIUTEPEC,011,AMPLIACIÓN LAS FUENTES,4,1126,544,582,49
MORELOS,17,JIUTEPEC,011,CALERA CHICA,10,2304,1218,1086,132
MORELOS,17,JIUTEPEC,011,CLISERIO ALANÍS (SAN GASPAR),6,528,261,267,33
MORELOS,17,JIUTEPEC,011,COLONIA LOMA BONITA,1,115,52,63,4
MORELOS,17,JIUTEPEC,011,EL TEXCAL,2,2967,1352,1615,293
MORELOS,17,JIUTEPEC,011,FRACCIONAMIENTO EL PARAJE (KILÓMETRO 14),1,87,52,35,4
MORELOS,17,JIUTEPEC,011,INDEPENDENCIA,5,678,363,315,31
MORELOS,17,JIUTEPEC,011,JIUTEPEC,299,37897,18807,19090,2208
MORELOS,17,JIUTEPEC,011,PROGRESO,11,1504,714,790,66
MORELOS,17,JOJUTLA,012,CHISCO,3,113,62,51,7
MORELOS,17,JOJUTLA,012,COLONIA AMPLIACIÓN SANTA MARÍA,1,24,11,13,2
MORELOS,17,JOJUTLA,012,COLONIA EL PARAÍSO (COLONIA VICENTE GUERRERO),1,25,15,10,2
MORELOS,17,JOJUTLA,012,COLONIA GUADALUPE,1,135,62,73,6
MORELOS,17,JOJUTLA,012,COLONIA LA AZUCHILERA,1,7,4,3,1
MORELOS,17,JOJUTLA,012,HIGUERÓN,5,750,378,372,33
MORELOS,17,JOJUTLA,012,JICARERO,4,1224,818,406,68
MORELOS,17,JOJUTLA,012,JOJUTLA,65,10771,5569,5202,662
MORELOS,17,JOJUTLA,012,LOS LAGARTOS,2,42,19,23,4
MORELOS,17,JOJUTLA,012,NICOLÁS BRAVO,3,208,101,107,11
MORELOS,17,JOJUTLA,012,PEDRO AMARO,6,534,255,279,29
MORELOS,17,JOJUTLA,012,RÍO SECO,2,49,31,18,3
MORELOS,17,JOJUTLA,012,TEHUIXTLA,7,1424,732,692,91
MORELOS,17,JOJUTLA,012,TEQUESQUITENGO,3,368,186,182,22
MORELOS,17,JOJUTLA,012,TLATENCHI,9,955,462,493,55
MORELOS,17,JOJUTLA,012,UNIDAD HABITACIONAL JOSÉ MARÍA MORELOS Y PAVÓN,8,480,245,235,62
MORELOS,17,JOJUTLA,012,VICENTE ARANDA (SAN RAFAEL),2,30,10,20,3
MORELOS,17,JONACATEPEC DE LEANDRO VALLE,013,AMACUITLAPILCO,4,450,228,222,19
MORELOS,17,JONACATEPEC DE LEANDRO VALLE,013,COLONIA EMILIANO ZAPATA,2,108,45,63,4
MORELOS,17,JONACATEPEC DE LEANDRO VALLE,013,COLONIA SAN MARTÍN,2,228,110,118,12
MORELOS,17,JONACATEPEC DE LEANDRO VALLE,013,JONACATEPEC DE LEANDRO VALLE,26,3226,1706,1520,181
MORELOS,17,JONACATEPEC DE LEANDRO VALLE,013,TETELILLA,5,1237,649,588,50
MORELOS,17,JONACATEPEC DE LEANDRO VALLE,013,TLAYCA,2,54,30,24,3
MORELOS,17,MAZATEPEC,014,COLONIA EL FLORIDO,4,141,91,50,33
MORELOS,17,MAZATEPEC,014,COLONIA JUSTO SIERRA,9,1697,903,794,82
MORELOS,17,MAZATEPEC,014,CUAUCHICHINOLA,4,504,234,270,22
MORELOS,17,MAZATEPEC,014,MAZATEPEC,5,593,339,254,57
MORELOS,17,MAZATEPEC,014,SANTA CRUZ VISTA ALEGRE,2,193,96,97,8
MORELOS,17,MIACATLÁN,015,COLONIA ÁLVARO OBREGÓN,2,172,80,92,9
MORELOS,17,MIACATLÁN,015,EL RINCÓN,2,15,11,4,2
MORELOS,17,MIACATLÁN,015,EL RODEO,4,301,137,164,13
MORELOS,17,MIACATLÁN,015,EL TERRERO,3,14,7,7,3
MORELOS,17,MIACATLÁN,015,LA CAMPESINA (COLONIA LOS TULIPANES),2,265,134,131,12
MORELOS,17,MIACATLÁN,015,MIACATLÁN,20,2936,1483,1453,203
MORELOS,17,MIACATLÁN,015,PALO GRANDE,2,40,11,29,3
MORELOS,17,MIACATLÁN,015,PALPAN DE BARANDA,3,126,63,63,7
MORELOS,17,MIACATLÁN,015,RANCHO VIEJO,3,18,12,6,2
MORELOS,17,MIACATLÁN,015,TLAJOTLA,1,17,8,9,1
MORELOS,17,OCUITUCO,016,HUECAHUASCO,5,446,234,212,24
MORELOS,17,OCUITUCO,016,HUEJOTENGO (SAN MARCOS),2,138,68,70,8
MORELOS,17,OCUITUCO,016,HUEPALCALCO (SAN MIGUEL),3,274,129,145,11
MORELOS,17,OCUITUCO,016,JUMILTEPEC,6,971,486,485,45
MORELOS,17,OCUITUCO,016,METEPEC,6,769,387,382,31
MORELOS,17,OCUITUCO,016,OCOXALTEPEC,3,314,152,162,14
MORELOS,17,OCUITUCO,016,OCUITUCO,7,1786,869,917,90
MORELOS,17,OCUITUCO,016,SANTA MÓNICA,1,21,9,12,2
MORELOS,17,PUENTE DE IXTLA,017,24 DE FEBRERO,2,58,24,34,4
MORELOS,17,PUENTE DE IXTLA,017,AHUEHUETZINGO,4,301,153,148,13
MORELOS,17,PUENTE DE IXTLA,017,AMPLIACIÓN BENITO JUÁREZ,1,179,83,96,6
MORELOS,17,PUENTE DE IXTLA,017,COLONIA VALLE BONITO (LOS ARCOS CAÍDOS),3,71,34,37,5
MORELOS,17,PUENTE DE IXTLA,017,EL COCO,2,74,34,40,4
MORELOS,17,PUENTE DE IXTLA,017,EL ESTUDIANTE,3,406,193,213,21
MORELOS,17,PUENTE DE IXTLA,017,EL SALTO,3,29,14,15,4
MORELOS,17,PUENTE DE IXTLA,017,EL ZAPOTE,3,42,20,22,5
MORELOS,17,PUENTE DE IXTLA,017,LA TIGRA,3,96,56,40,6
MORELOS,17,PUENTE DE IXTLA,017,LOMA FLORIDA,1,18,9,9,1
MORELOS,17,PUENTE DE IXTLA,017,LOS ÍDOLOS,3,48,18,30,4
MORELOS,17,PUENTE DE IXTLA,017,PUENTE DE IXTLA,41,6992,3617,3375,465
MORELOS,17,PUENTE DE IXTLA,017,PUENTE EL NARANJO,3,13,7,6,2
MORELOS,17,PUENTE DE IXTLA,017,SAN JOSÉ VISTA HERMOSA,6,614,305,309,28
MORELOS,17,PUENTE DE IXTLA,017,TILZAPOTLA,7,761,376,385,49
MORELOS,17,TEMIXCO,018,CAMPO EL RAYO (ACATLIPA),5,310,202,108,62
MORELOS,17,TEMIXCO,018,COLONIA ADOLFO LÓPEZ MATEOS,1,9,2,7,1
MORELOS,17,TEMIXCO,018,COLONIA MIGUEL HIDALGO,4,129,59,70,12
MORELOS,17,TEMIXCO,018,COLONIA SANTA ÚRSULA,2,174,86,88,8
MORELOS,17,TEMIXCO,018,CONJUNTO URBANO CAMPO VERDE,1,74,33,41,3
MORELOS,17,TEMIXCO,018,CUENTEPEC,6,920,457,463,41
MORELOS,17,TEMIXCO,018,ETERNA PRIMAVERA,2,228,113,115,8
MORELOS,17,TEMIXCO,018,SAN AGUSTÍN TETLAMA,3,486,236,250,17
MORELOS,17,TEMIXCO,018,SOLIDARIDAD,3,184,99,85,9
MORELOS,17,TEMIXCO,018,TEMIXCO,188,25435,12876,12559,1679
MORELOS,17,TEPALCINGO,019,ADOLFO LÓPEZ MATEOS,2,49,23,26,3
MORELOS,17,TEPALCINGO,019,ATOTONILCO,3,346,170,176,16
MORELOS,17,TEPALCINGO,019,COLONIA BUENOS AIRES,1,67,35,32,3
MORELOS,17,TEPALCINGO,019,CRUZ DE JARAMALLA (COLONIA LAURO ORTEGA),2,43,17,26,3
MORELOS,17,TEPALCINGO,019,EL LIMÓN DE CUAUCHICHINOLA,2,15,6,9,2
MORELOS,17,TEPALCINGO,019,EL TEPEHUAJE,3,28,10,18,3
MORELOS,17,TEPALCINGO,019,EMILIANO ZAPATA,1,71,42,29,3
MORELOS,17,TEPALCINGO,019,HUITCHILA,4,446,233,213,21
MORELOS,17,TEPALCINGO,019,IXTLILCO EL CHICO,3,275,139,136,13
MORELOS,17,TEPALCINGO,019,IXTLILCO EL GRANDE,6,635,314,321,31
MORELOS,17,TEPALCINGO,019,LOS SAUCES,3,71,35,36,6
MORELOS,17,TEPALCINGO,019,LOS TULIPANES,1,282,213,69,23
MORELOS,17,TEPALCINGO,019,TEPALCINGO,18,2434,1274,1160,167
MORELOS,17,TEPALCINGO,019,ZACAPALCO,4,332,172,160,18
MORELOS,17,TEPOZTLÁN,020,ACOLAPAN,2,258,123,135,9
MORELOS,17,TEPOZTLÁN,020,AMATLÁN DE QUETZALCÓATL,3,177,96,81,11
MORELOS,17,TEPOZTLÁN,020,COLONIA ÁNGEL BOCANEGRA (ADOLFO LÓPEZ MATEOS),1,195,105,90,7
MORELOS,17,TEPOZTLÁN,020,COLONIA LOMA ESMERALDA,1,184,90,94,6
MORELOS,17,TEPOZTLÁN,020,SAN ANDRÉS DE LA CAL,4,245,108,137,12
MORELOS,17,TEPOZTLÁN,020,SAN JUAN TLACOTENCO,4,400,184,216,24
MORELOS,17,TEPOZTLÁN,020,SANTA CATARINA,5,1178,600,578,47
MORELOS,17,TEPOZTLÁN,020,SANTIAGO TEPETLAPA,3,768,398,370,33
MORELOS,17,TEPOZTLÁN,020,SANTO DOMINGO OCOTITLÁN,3,201,91,110,12
MORELOS,17,TEPOZTLÁN,020,TEPOZTLÁN,37,3685,1866,1819,202
MORELOS,17,TEPOZTLÁN,020,TEXIO,1,575,238,337,26
MORELOS,17,TEPOZTLÁN,020,TLALTÉPETL,2,22,10,12,2
MORELOS,17,TETECALA,021,ACTOPAN,1,72,39,33,4
MORELOS,17,TETECALA,021,COLONIA EL CHARCO,2,694,375,319,35
MORELOS,17,TETECALA,021,COLONIA FRANCISCO SARABIA,1,57,34,23,4
MORELOS,17,TETECALA,021,COLONIA MARIANO MATAMOROS,3,40,20,20,3
MORELOS,17,TETECALA,021,COLONIA SONORA,1,24,10,14,1
MORELOS,17,TETECALA,021,CONTLALCO,2,47,18,29,3
MORELOS,17,TETECALA,021,CUAUTLITA,2,45,21,24,3
MORELOS,17,TETECALA,021,TETECALA,7,1064,575,489,74
MORELOS,17,TETELA DEL VOLCÁN,022,SAN MIGUEL,2,447,217,230,16
MORELOS,17,TETELA DEL VOLCÁN,022,TETELA DEL VOLCÁN,12,3119,1650,1469,148
MORELOS,17,TETELA DEL VOLCÁN,022,TLALMIMILULPAN (SAN PEDRO),3,386,191,195,21
MORELOS,17,TETELA DEL VOLCÁN,022,ZACAPECHPA (ZACAPEZUCA),2,35,11,24,2
MORELOS,17,TLALNEPANTLA,023,EL PEDREGAL,3,55,34,21,4
MORELOS,17,TLALNEPANTLA,023,EL VIGÍA (SAN NICOLÁS DEL MONTE),2,168,84,84,8
MORELOS,17,TLALNEPANTLA,023,FELIPE NERI (CUATEPEC),3,346,181,165,17
MORELOS,17,TLALNEPANTLA,023,TLALNEPANTLA,5,1714,914,800,79
MORELOS,17,TLALTIZAPÁN DE ZAPATA,024,ACAMILPA,3,260,115,145,12
MORELOS,17,TLALTIZAPÁN DE ZAPATA,024,AMPLIACIÓN ZARAGOZA,1,34,13,21,2
MORELOS,17,TLALTIZAPÁN DE ZAPATA,024,BARRANCA HONDA,3,193,96,97,11
MORELOS,17,TLALTIZAPÁN DE ZAPATA,024,BONIFACIO GARCÍA (COLONIA ALEJANDRA),2,283,137,146,13
MORELOS,17,TLALTIZAPÁN DE ZAPATA,024,COLONIA 10 DE MAYO (LA MATANZA),2,17,7,10,2
MORELOS,17,TLALTIZAPÁN DE ZAPATA,024,COLONIA PALO PRIETO (CHIPITONGO),2,114,63,51,7
MORELOS,17,TLALTIZAPÁN DE ZAPATA,024,EL MIRADOR,3,432,211,221,15
MORELOS,17,TLALTIZAPÁN DE ZAPATA,024,HUATECALCO,5,513,247,266,20
MORELOS,17,TLALTIZAPÁN DE ZAPATA,024,OTILIO MONTAÑO,1,46,18,28,3
MORELOS,17,TLALTIZAPÁN DE ZAPATA,024,PUEBLO NUEVO,3,229,119,110,11
MORELOS,17,TLALTIZAPÁN DE ZAPATA,024,SAN PABLO HIDALGO,3,117,60,57,7
MORELOS,17,TLALTIZAPÁN DE ZAPATA,024,SAN RAFAEL ZARAGOZA,3,246,117,129,11
MORELOS,17,TLALTIZAPÁN DE ZAPATA,024,SANTA ROSA TREINTA,12,2125,1037,1088,130
MORELOS,17,TLALTIZAPÁN DE ZAPATA,024,TEMILPA NUEVO,2,74,36,38,4
MORELOS,17,TLALTIZAPÁN DE ZAPATA,024,TEMILPA VIEJO,3,117,52,65,7
MORELOS,17,TLALTIZAPÁN DE ZAPATA,024,TEMIMILCINGO,3,209,107,102,11
MORELOS,17,TLALTIZAPÁN DE ZAPATA,024,TICUMÁN,5,790,349,441,43
MORELOS,17,TLALTIZAPÁN DE ZAPATA,024,TLALTIZAPÁN,23,2812,1468,1344,183
MORELOS,17,TLAQUILTENANGO,025,AJUCHITLÁN,3,37,20,17,3
MORELOS,17,TLAQUILTENANGO,025,ALFREDO V. BONFIL (CHACAMPALCO),5,537,252,285,27
MORELOS,17,TLAQUILTENANGO,025,CHIMALACATLÁN,3,61,35,26,5
MORELOS,17,TLAQUILTENANGO,025,COAXITLÁN,3,84,41,43,6
MORELOS,17,TLAQUILTENANGO,025,COLONIA 3 DE MAYO (EL TEPIOLOL),3,165,75,90,8
MORELOS,17,TLAQUILTENANGO,025,COLONIA MANZANAREZ,2,121,73,48,9
MORELOS,17,TLAQUILTENANGO,025,HUAUTLA,4,423,253,170,14
MORELOS,17,TLAQUILTENANGO,025,HUAXTLA,1,4,2,2,1
MORELOS,17,TLAQUILTENANGO,025,HUIXASTLA,3,40,22,18,4
MORELOS,17,TLAQUILTENANGO,025,LA ERA (CALALPA),3,113,57,56,7
MORELOS,17,TLAQUILTENANGO,025,LA MEZQUITERA (EL ASTILLERO),3,105,57,48,7
MORELOS,17,TLAQUILTENANGO,025,LAS BÓVEDAS,2,18,11,7,2
MORELOS,17,TLAQUILTENANGO,025,LAS CARPAS,1,40,16,24,2
MORELOS,17,TLAQUILTENANGO,025,LORENZO VÁZQUEZ (SANTA CRUZ),3,150,76,74,11
MORELOS,17,TLAQUILTENANGO,025,LOS DORMIDOS,2,7,1,6,1
MORELOS,17,TLAQUILTENANGO,025,LOS ELOTES (SAN MIGUEL DE LOS ELOTES),1,9,6,3,1
MORELOS,17,TLAQUILTENANGO,025,LOS PRESIDENTES,2,249,123,126,10
MORELOS,17,TLAQUILTENANGO,025,NEXPA,3,94,39,55,7
MORELOS,17,TLAQUILTENANGO,025,PALO GRANDE,2,39,17,22,3
MORELOS,17,TLAQUILTENANGO,025,PUEBLO VIEJO,4,169,74,95,10
MORELOS,17,TLAQUILTENANGO,025,QUILAMULA,3,123,53,70,8
MORELOS,17,TLAQUILTENANGO,025,RANCHO VIEJO,2,9,5,4,2
MORELOS,17,TLAQUILTENANGO,025,SAN JOSÉ DE PALA,3,101,60,41,7
MORELOS,17,TLAQUILTENANGO,025,SANTIOPA,2,20,11,9,2
MORELOS,17,TLAQUILTENANGO,025,TLAQUILTENANGO,19,2418,1168,1250,171
MORELOS,17,TLAQUILTENANGO,025,UNIDAD HABITACIONAL EMILIANO ZAPATA,2,48,17,31,3
MORELOS,17,TLAQUILTENANGO,025,VALLE DE VÁZQUEZ (LOS HORNOS),4,304,156,148,22
MORELOS,17,TLAQUILTENANGO,025,XICATLACOTLA,2,50,23,27,3
MORELOS,17,TLAQUILTENANGO,025,XOCHIPALA,2,15,10,5,2
MORELOS,17,TLAYACAPAN,026,AMATLIPAC (SAN AGUSTÍN AMATLIPAC),3,245,117,128,12
MORELOS,17,TLAYACAPAN,026,COLONIA JERICÓ,2,82,43,39,5
MORELOS,17,TLAYACAPAN,026,COLONIA TEXALO (LA CERÁMICA),1,72,32,40,22
MORELOS,17,TLAYACAPAN,026,CUAUHTEMPAN (SAN ANDRÉS CUAUHTEMPAN),3,289,130,159,12
MORELOS,17,TLAYACAPAN,026,EL GOLÁN,2,155,84,71,8
MORELOS,17,TLAYACAPAN,026,EMILIANO ZAPATA,1,6,1,5,1
MORELOS,17,TLAYACAPAN,026,EX-HACIENDA PANTITLÁN,2,72,34,38,4
MORELOS,17,TLAYACAPAN,026,LAS VIVIANAS,2,207,94,113,8
MORELOS,17,TLAYACAPAN,026,LOS LAURELES (SAN JOSÉ DE LOS LAURELES),3,283,146,137,14
MORELOS,17,TLAYACAPAN,026,NACATONGO,2,247,121,126,8
MORELOS,17,TLAYACAPAN,026,TLAYACAPAN,24,1781,894,887,127
MORELOS,17,TOTOLAPAN,027,AHUATLÁN (ASUNCIÓN AHUATLÁN),3,447,318,129,27
MORELOS,17,TOTOLAPAN,027,BARRIO SAN MARCOS (EL MORAL),2,41,24,17,3
MORELOS,17,TOTOLAPAN,027,EL FUERTE (SAN MIGUEL),2,44,16,28,3
MORELOS,17,TOTOLAPAN,027,EL LLANITO,1,77,40,37,3
MORELOS,17,TOTOLAPAN,027,LA CAÑADA (SAN SEBASTIÁN),2,87,48,39,5
MORELOS,17,TOTOLAPAN,027,NEPOPUALCO,3,419,192,227,19
MORELOS,17,TOTOLAPAN,027,TEPETLIXPITA,4,575,298,277,22
MORELOS,17,TOTOLAPAN,027,TOTOLAPAN,7,1181,594,587,44
MORELOS,17,TOTOLAPAN,027,VILLA NICOLÁS ZAPATA,3,47,24,23,5
MORELOS,17,XOCHITEPEC,028,ALPUYECA,9,1510,764,746,65
MORELOS,17,XOCHITEPEC,028,AMPLIACIÓN MIGUEL HIDALGO,2,32,11,21,3
MORELOS,17,XOCHITEPEC,028,ATLACHOLOAYA,12,1284,622,662,52
MORELOS,17,XOCHITEPEC,028,CHICONCUAC,8,1177,585,592,47
MORELOS,17,XOCHITEPEC,028,COAXCOMAC,1,32,9,23,15
MORELOS,17,XOCHITEPEC,028,COLONIA 3 DE MAYO (EL PUENTE),1,5,2,3,1
MORELOS,17,XOCHITEPEC,028,COLONIA HUMBERTO GUTIÉRREZ CORONA,2,146,71,75,8
MORELOS,17,XOCHITEPEC,028,COLONIA LA PINTORA,1,20,12,8,2
MORELOS,17,XOCHITEPEC,028,COLONIA LAS FLORES,3,697,347,350,30
MORELOS,17,XOCHITEPEC,028,FRANCISCO VILLA,4,521,237,284,19
MORELOS,17,XOCHITEPEC,028,LA ESPERANZA,1,28,13,15,1
MORELOS,17,XOCHITEPEC,028,LAS PALMAS,2,627,309,318,31
MORELOS,17,XOCHITEPEC,028,REAL DEL PUENTE (EL GALLITO),7,3075,1501,1574,254
MORELOS,17,XOCHITEPEC,028,UNIDAD HABITACIONAL JOSÉ MARÍA MORELOS Y PAVÓN,11,2819,1420,1399,105
MORELOS,17,XOCHITEPEC,028,XOCHITEPEC,49,4021,1972,2049,278
MORELOS,17,YAUTEPEC,029,AMPLIACIÓN ÁLVARO LEONEL (REVOLUCIÓN DEL SUR),1,105,50,55,4
MORELOS,17,YAUTEPEC,029,AMPLIACIÓN ATLIHUAYAN,3,811,425,386,30
MORELOS,17,YAUTEPEC,029,CAMPO LA TEHUIXTLERA,3,44,20,24,4
MORELOS,17,YAUTEPEC,029,COCOYOC,10,1353,669,684,61
MORELOS,17,YAUTEPEC,029,COLONIA MIGUEL HIDALGO (LOS CUARTOS),4,241,125,116,13
MORELOS,17,YAUTEPEC,029,COLONIA SANTA LUCÍA (AMPLIACIÓN ITZAMATITLÁN),2,8,6,2,1
MORELOS,17,YAUTEPEC,029,CORRAL GRANDE,1,27,17,10,1
MORELOS,17,YAUTEPEC,029,DIEGO RUIZ,2,17,10,7,2
MORELOS,17,YAUTEPEC,029,EL CARACOL (CAMPO CHIQUITO),2,60,23,37,4
MORELOS,17,YAUTEPEC,029,EL CAUDILLO DEL SUR,1,9,5,4,1
MORELOS,17,YAUTEPEC,029,EL ROCÍO,2,60,17,43,5
MORELOS,17,YAUTEPEC,029,EL ZARCO,2,95,52,43,6
MORELOS,17,YAUTEPEC,029,EMILIANO ZAPATA (CASAHUATES),1,17,10,7,1
MORELOS,17,YAUTEPEC,029,EMILIANO ZAPATA (PALO MOCHO),2,33,14,19,3
MORELOS,17,YAUTEPEC,029,IGNACIO BASTIDA (SANTA CATARINA TLAYCA),3,194,98,96,11
MORELOS,17,YAUTEPEC,029,ITZAMATITLÁN,1,70,38,32,3
MORELOS,17,YAUTEPEC,029,JOSÉ ORTIZ (SAN MARTÍN),2,112,54,58,7
MORELOS,17,YAUTEPEC,029,LA JOYA,12,1765,842,923,110
MORELOS,17,YAUTEPEC,029,LA NOPALERA,3,234,125,109,11
MORELOS,17,YAUTEPEC,029,LÁZARO CÁRDENAS (EL EMPALME),2,145,74,71,7
MORELOS,17,YAUTEPEC,029,LOS ARCOS,9,1251,673,578,55
MORELOS,17,YAUTEPEC,029,LUCIO MORENO,1,28,19,9,11
MORELOS,17,YAUTEPEC,029,OACALCO,10,1554,810,744,95
MORELOS,17,YAUTEPEC,029,OAXTEPEC,17,1821,881,940,165
MORELOS,17,YAUTEPEC,029,SAN ISIDRO,1,90,56,34,29
MORELOS,17,YAUTEPEC,029,YAUTEPEC DE ZARAGOZA,127,14265,7189,7076,856
MORELOS,17,YECAPIXTLA,030,ACHICHIPICO,3,418,205,213,21
MORELOS,17,YECAPIXTLA,030,ADOLFO LÓPEZ MATEOS,2,203,100,103,8
MORELOS,17,YECAPIXTLA,030,COLONIA AQUILES SERDÁN,5,1391,680,711,48
MORELOS,17,YECAPIXTLA,030,COLONIA PARAÍSO ESCONDIDO,2,16,5,11,2
MORELOS,17,YECAPIXTLA,030,COLONIA PARAÍSO LAS FLORES,3,51,24,27,4
MORELOS,17,YECAPIXTLA,030,HUEXCA,3,251,120,131,11
MORELOS,17,YECAPIXTLA,030,JUAN MORALES,8,1911,954,957,99
MORELOS,17,YECAPIXTLA,030,LA ESTACIÓN DE YECAPIXTLA,2,10,2,8,1
MORELOS,17,YECAPIXTLA,030,LOS CAPULINES,3,68,35,33,6
MORELOS,17,YECAPIXTLA,030,LOS LIMONES,3,77,35,42,7
MORELOS,17,YECAPIXTLA,030,MIXTLALCINGO,2,243,101,142,8
MORELOS,17,YECAPIXTLA,030,PAZULCO,3,120,60,60,6
MORELOS,17,YECAPIXTLA,030,RANCHO SAN MARCOS,1,27,18,9,15
MORELOS,17,YECAPIXTLA,030,TECAJEC,4,422,205,217,20
MORELOS,17,YECAPIXTLA,030,TEXCALA,3,321,145,176,13
MORELOS,17,YECAPIXTLA,030,TEZONTETELCO,3,64,33,31,5
MORELOS,17,YECAPIXTLA,030,TLAMOMULCO,2,47,30,17,3
MORELOS,17,YECAPIXTLA,030,XOCHITLÁN,4,624,297,327,22
MORELOS,17,YECAPIXTLA,030,YECAPIXTECA,3,357,182,175,15
MORELOS,17,YECAPIXTLA,030,YECAPIXTLA,38,4690,2266,2424,282
MORELOS,17,YECAPIXTLA,030,ZACAHUACATLA,2,8,4,4,2
MORELOS,17,ZACATEPEC,031,AMPLIACIÓN PLUTARCO ELÍAS CALLES,1,53,30,23,3
MORELOS,17,ZACATEPEC,031,COLONIA POZA HONDA,1,11,5,6,1
MORELOS,17,ZACATEPEC,031,SAN ANTONIO CHIVERÍAS,3,160,79,81,11
MORELOS,17,ZACATEPEC,031,SAN NICOLÁS GALEANA,13,2976,1541,1435,171
MORELOS,17,ZACATEPEC,031,ZACATEPEC DE HIDALGO,59,10040,4377,5663,645
MORELOS,17,ZACUALPAN DE AMILPAS,032,COLONIA EMILIANO ZAPATA,1,11,4,7,1
MORELOS,17,ZACUALPAN DE AMILPAS,032,LA PRESA (EL CERRO DE LA ERA),2,8,4,4,1
MORELOS,17,ZACUALPAN DE AMILPAS,032,TLACOTEPEC,10,1214,595,619,58
MORELOS,17,ZACUALPAN DE AMILPAS,032,ZACUALPAN DE AMILPAS,17,783,388,395,61
MORELOS,17,TEMOAC,033,AMILCINGO,6,1140,748,392,75
MORELOS,17,TEMOAC,033,EL PUENTE NUEVO,1,21,12,9,2
MORELOS,17,TEMOAC,033,HUAZULCO,4,740,385,355,35
MORELOS,17,TEMOAC,033,POPOTLÁN (BARRIO SANTO TOMÁS),3,207,99,108,11
MORELOS,17,TEMOAC,033,TEMOAC,11,2444,1249,1195,104
MORELOS,17,COATETELCO,034,COATETELCO CENTRO,9,1429,727,702,58
MORELOS,17,COATETELCO,034,EL MUELLE,1,115,66,49,5
MORELOS,17,COATETELCO,034,GENERAL PEDRO SAAVEDRA,1,59,33,26,3
MORELOS,17,COATETELCO,034,XOCHICALCO,8,515,243,272,28
MORELOS,17,XOXOCOTLA,035,CAMPO ANENEHUILCO,2,608,301,307,58
MORELOS,17,XOXOCOTLA,035,MORELOS,1,10,7,3,7
MORELOS,17,XOXOCOTLA,035,XOXOCOTLA CENTRO,18,5533,2984,2549,241
MORELOS,17,HUEYAPAN,036,BARRIO DE SAN MIGUEL,15,1969,1003,966,79
MORELOS,17,HUEYAPAN,036,OLIVAR,1,9,2,7,1
MORELOS,17,HUEYAPAN,036,TLALCOMULCO,1,17,11,6,1
MÉXICO,15,ACAMBAY DE RUÍZ CASTAÑEDA,001,AGOSTADERO (SAN JOSÉ AGOSTADERO),4,423,232,191,33
MÉXICO,15,ACAMBAY DE RUÍZ CASTAÑEDA,001,AGUA LIMPIA,2,22,12,10,3
MÉXICO,15,ACAMBAY DE RUÍZ CASTAÑEDA,001,BARRANCAS,1,8,3,5,2
MÉXICO,15,ACAMBAY DE RUÍZ CASTAÑEDA,001,BARRIO DE GUADALUPE,3,62,21,41,7
MÉXICO,15,ACAMBAY DE RUÍZ CASTAÑEDA,001,BARRIO LA PEÑITA,1,8,4,4,1
MÉXICO,15,ACAMBAY DE RUÍZ CASTAÑEDA,001,BOSHI CHIQUITO,2,97,51,46,5
MÉXICO,15,ACAMBAY DE RUÍZ CASTAÑEDA,001,BOSHI GRANDE,2,13,5,8,3
MÉXICO,15,ACAMBAY DE RUÍZ CASTAÑEDA,001,BOSHINDO,4,327,172,155,19
MÉXICO,15,ACAMBAY DE RUÍZ CASTAÑEDA,001,BOTÍ (BOTÍ AGOSTADERO),3,99,41,58,7
MÉXICO,15,ACAMBAY DE RUÍZ CASTAÑEDA,001,BOTIDI,1,8,4,4,1
MÉXICO,15,ACAMBAY DE RUÍZ CASTAÑEDA,001,BOVINI,4,159,81,78,13
MÉXICO,15,ACAMBAY DE RUÍZ CASTAÑEDA,001,BUENAVISTA,1,102,48,54,6
MÉXICO,15,ACAMBAY DE RUÍZ CASTAÑEDA,001,CAÑADA DEL GALLO,2,46,27,19,4
MÉXICO,15,ACAMBAY DE RUÍZ CASTAÑEDA,001,CHANTEJE,2,16,7,9,2
MÉXICO,15,ACAMBAY DE RUÍZ CASTAÑEDA,001,CONEJERAS,3,298,162,136,15
MÉXICO,15,ACAMBAY DE RUÍZ CASTAÑEDA,001,DATEJE,2,48,19,29,3
MÉXICO,15,ACAMBAY DE RUÍZ CASTAÑEDA,001,DETIÑA (SAN ANTONIO DETIÑA),5,499,238,261,29
MÉXICO,15,ACAMBAY DE RUÍZ CASTAÑEDA,001,DETIÑA EJIDO,2,12,8,4,2
MÉXICO,15,ACAMBAY DE RUÍZ CASTAÑEDA,001,DONGU (DONGU CENTRO),6,307,142,165,17
MÉXICO,15,ACAMBAY DE RUÍZ CASTAÑEDA,001,DONGU BARRIO DOS,1,37,18,19,3
MÉXICO,15,ACAMBAY DE RUÍZ CASTAÑEDA,001,DONGU BARRIO UNO,1,5,4,1,1
MÉXICO,15,ACAMBAY DE RUÍZ CASTAÑEDA,001,DONGU PUERTO,2,120,56,64,6
MÉXICO,15,ACAMBAY DE RUÍZ CASTAÑEDA,001,DOXTEJÉ BARRIO I,5,349,188,161,19
MÉXICO,15,ACAMBAY DE RUÍZ CASTAÑEDA,001,DOXTEJÉ BARRIO II,1,15,12,3,1
MÉXICO,15,ACAMBAY DE RUÍZ CASTAÑEDA,001,DOXTEJÉ CENTRO,4,317,149,168,18
MÉXICO,15,ACAMBAY DE RUÍZ CASTAÑEDA,001,EL CAPULÍN (BARRIO EL CAPULÍN LA LOMA),2,32,20,12,4
MÉXICO,15,ACAMBAY DE RUÍZ CASTAÑEDA,001,EL ERMITAÑO,3,69,27,42,4
MÉXICO,15,ACAMBAY DE RUÍZ CASTAÑEDA,001,EL MEDRANO,4,396,268,128,23
MÉXICO,15,ACAMBAY DE RUÍZ CASTAÑEDA,001,EL PEDREGAL DE TIXMADEJÉ,1,18,9,9,1
MÉXICO,15,ACAMBAY DE RUÍZ CASTAÑEDA,001,ENDEJE,2,136,69,67,7
MÉXICO,15,ACAMBAY DE RUÍZ CASTAÑEDA,001,ESDOCA (ESDOCA CENTRO),1,8,6,2,1
MÉXICO,15,ACAMBAY DE RUÍZ CASTAÑEDA,001,ESDOCA BARRIO I,1,10,4,6,1
MÉXICO,15,ACAMBAY DE RUÍZ CASTAÑEDA,001,GANDO,2,46,20,26,5
MÉXICO,15,ACAMBAY DE RUÍZ CASTAÑEDA,001,GANZDA,5,953,451,502,49
MÉXICO,15,ACAMBAY DE RUÍZ CASTAÑEDA,001,HONDIGA,2,19,9,10,2
MÉXICO,15,ACAMBAY DE RUÍZ CASTAÑEDA,001,HUAMANGO (LA MESA DE SAN MIGUEL HUAMANGO),2,10,8,2,2
MÉXICO,15,ACAMBAY DE RUÍZ CASTAÑEDA,001,JUANDO,4,242,128,114,27
MÉXICO,15,ACAMBAY DE RUÍZ CASTAÑEDA,001,LA CARIDAD,2,91,46,45,7
MÉXICO,15,ACAMBAY DE RUÍZ CASTAÑEDA,001,LA ESTANCIA SECTOR I,5,330,169,161,18
MÉXICO,15,ACAMBAY DE RUÍZ CASTAÑEDA,001,LA ESTANCIA SECTOR II,2,87,37,50,6
MÉXICO,15,ACAMBAY DE RUÍZ CASTAÑEDA,001,LA FLORIDA,3,39,22,17,3
MÉXICO,15,ACAMBAY DE RUÍZ CASTAÑEDA,001,LA HUERTA,2,56,34,22,3
MÉXICO,15,ACAMBAY DE RUÍZ CASTAÑEDA,001,LA LAGUNA,2,22,7,15,3
MÉXICO,15,ACAMBAY DE RUÍZ CASTAÑEDA,001,LA LOMA (SANTA MARÍA LA LOMA),3,206,97,109,17
MÉXICO,15,ACAMBAY DE RUÍZ CASTAÑEDA,001,LA MANGA,2,74,34,40,4
MÉXICO,15,ACAMBAY DE RUÍZ CASTAÑEDA,001,LA NOPALERA,3,43,21,22,5
MÉXICO,15,ACAMBAY DE RUÍZ CASTAÑEDA,001,LA PALMA,4,229,118,111,14
MÉXICO,15,ACAMBAY DE RUÍZ CASTAÑEDA,001,LA SOLEDAD,5,306,154,152,34
MÉXICO,15,ACAMBAY DE RUÍZ CASTAÑEDA,001,LA TERESA (SANTA TERESA),2,53,24,29,4
MÉXICO,15,ACAMBAY DE RUÍZ CASTAÑEDA,001,LA VENTA (BARRIO LA VENTA),3,173,93,80,9
MÉXICO,15,ACAMBAY DE RUÍZ CASTAÑEDA,001,LAS ARENAS (SAN AGUSTÍN),4,376,178,198,18
MÉXICO,15,ACAMBAY DE RUÍZ CASTAÑEDA,001,LAS MANGAS,3,68,39,29,5
MÉXICO,15,ACAMBAY DE RUÍZ CASTAÑEDA,001,LAS POMAS EJIDO DE DATEJE,3,14,7,7,3
MÉXICO,15,ACAMBAY DE RUÍZ CASTAÑEDA,001,LAS TROJES,2,54,27,27,3
MÉXICO,15,ACAMBAY DE RUÍZ CASTAÑEDA,001,LOMA DE ENMEDIO,2,48,21,27,4
MÉXICO,15,ACAMBAY DE RUÍZ CASTAÑEDA,001,LOMA DE SAN ÁNGEL,2,53,26,27,4
MÉXICO,15,ACAMBAY DE RUÍZ CASTAÑEDA,001,LOMA DEL FRESNO,1,17,8,9,2
MÉXICO,15,ACAMBAY DE RUÍZ CASTAÑEDA,001,LOMA LINDA,2,70,33,37,4
MÉXICO,15,ACAMBAY DE RUÍZ CASTAÑEDA,001,LOS CHARCOS,2,107,48,59,7
MÉXICO,15,ACAMBAY DE RUÍZ CASTAÑEDA,001,LOS PILARES,3,168,78,90,11
MÉXICO,15,ACAMBAY DE RUÍZ CASTAÑEDA,001,LOS SAUCES,2,28,16,12,3
MÉXICO,15,ACAMBAY DE RUÍZ CASTAÑEDA,001,LOS TORILES,3,109,53,56,9
MÉXICO,15,ACAMBAY DE RUÍZ CASTAÑEDA,001,MADO SECTOR DOS,2,52,22,30,6
MÉXICO,15,ACAMBAY DE RUÍZ CASTAÑEDA,001,MADO SECTOR UNO,3,167,83,84,11
MÉXICO,15,ACAMBAY DE RUÍZ CASTAÑEDA,001,MUYTEJE,2,66,33,33,4
MÉXICO,15,ACAMBAY DE RUÍZ CASTAÑEDA,001,PATHÉ,3,423,226,197,19
MÉXICO,15,ACAMBAY DE RUÍZ CASTAÑEDA,001,PUEBLO NUEVO,9,1139,550,589,55
MÉXICO,15,ACAMBAY DE RUÍZ CASTAÑEDA,001,PUENTECILLAS,3,360,167,193,18
MÉXICO,15,ACAMBAY DE RUÍZ CASTAÑEDA,001,RINCÓN DE JUANDO,2,84,40,44,5
MÉXICO,15,ACAMBAY DE RUÍZ CASTAÑEDA,001,RINCÓN DE SAN FRANCISCO SHAXNI,5,71,36,35,7
MÉXICO,15,ACAMBAY DE RUÍZ CASTAÑEDA,001,SAN FRANCISCO SHAXNI,4,519,238,281,30
MÉXICO,15,ACAMBAY DE RUÍZ CASTAÑEDA,001,SAN FRANCISCO SHAXNI EJIDO,2,223,121,102,10
MÉXICO,15,ACAMBAY DE RUÍZ CASTAÑEDA,001,SAN ILDEFONSO (SAN ILDEFONSO YOLOTEPEC),2,151,66,85,8
MÉXICO,15,ACAMBAY DE RUÍZ CASTAÑEDA,001,SAN JOSÉ BOCTÓ,2,79,38,41,5
MÉXICO,15,ACAMBAY DE RUÍZ CASTAÑEDA,001,SAN JUANICO SECTOR DOS,4,215,115,100,12
MÉXICO,15,ACAMBAY DE RUÍZ CASTAÑEDA,001,SAN JUANICO SECTOR UNO,4,275,131,144,14
MÉXICO,15,ACAMBAY DE RUÍZ CASTAÑEDA,001,SAN NICOLÁS ACAMBAY,3,144,80,64,11
MÉXICO,15,ACAMBAY DE RUÍZ CASTAÑEDA,001,SAN PEDRO DE LOS METATES,4,525,275,250,28
MÉXICO,15,ACAMBAY DE RUÍZ CASTAÑEDA,001,SANTA MARÍA LAS ARENAS,2,45,24,21,3
MÉXICO,15,ACAMBAY DE RUÍZ CASTAÑEDA,001,SANTA MARÍA TIXMADEJÉ (TIXMADEJÉ GRANDE),4,461,241,220,44
MÉXICO,15,ACAMBAY DE RUÍZ CASTAÑEDA,001,SEGUNDA MANZANA DE SAN NICOLÁS,1,23,9,14,1
MÉXICO,15,ACAMBAY DE RUÍZ CASTAÑEDA,001,TIXMADEJÉ CHIQUITO,12,822,417,405,47
MÉXICO,15,ACAMBAY DE RUÍZ CASTAÑEDA,001,VILLA DE ACAMBAY DE RUÍZ CASTAÑEDA,15,4524,2428,2096,331
MÉXICO,15,ACOLMAN,002,ACOLMAN DE NEZAHUALCÓYOTL,66,14948,7654,7294,783
MÉXICO,15,ACOLMAN,002,EJIDOS DE CUANALÁN,1,122,57,65,6
MÉXICO,15,ACOLMAN,002,LA CONCEPCIÓN (XOMETLA),1,283,148,135,16
MÉXICO,15,ACOLMAN,002,MISIÓN SAN AGUSTÍN [CONJUNTO URBANO],1,241,118,123,13
MÉXICO,15,ACOLMAN,002,SAN BARTOLO,5,533,270,263,20
MÉXICO,15,ACOLMAN,002,SAN LUCAS TEPANGO,3,181,88,93,12
MÉXICO,15,ACOLMAN,002,SAN MARCOS NEPANTLA,5,864,446,418,38
MÉXICO,15,ACOLMAN,002,SAN MIGUEL XOMETLA,6,1344,664,680,53
MÉXICO,15,ACOLMAN,002,SAN PEDRO TEPETITLÁN,3,291,126,165,18
MÉXICO,15,ACOLMAN,002,SANTA CATARINA,12,3555,1905,1650,127
MÉXICO,15,ACOLMAN,002,TEPEXPAN,53,11045,5436,5609,714
MÉXICO,15,ACULCO,003,ACULCO DE ESPINOZA,13,3027,1670,1357,272
MÉXICO,15,ACULCO,003,ARROYO ZARCO EJIDO,5,737,368,369,31
MÉXICO,15,ACULCO,003,ARROYO ZARCO PUEBLO,1,413,217,196,24
MÉXICO,15,ACULCO,003,BAÑE,4,196,90,106,12
MÉXICO,15,ACULCO,003,BAÑE PRIMERA MANZANA,3,62,34,28,4
MÉXICO,15,ACULCO,003,BARRANCAS,2,42,23,19,3
MÉXICO,15,ACULCO,003,BARRIO DE TOTOLOPAN (EJIDO DE TOTOLOAPAN),2,48,19,29,3
MÉXICO,15,ACULCO,003,BIMBO,1,6,4,2,1
MÉXICO,15,ACULCO,003,EJIDO DE SANTA MARÍA NATIVITAS,1,20,12,8,1
MÉXICO,15,ACULCO,003,EJIDO LAS ÁNIMAS,2,40,21,19,4
MÉXICO,15,ACULCO,003,EJIDO SAN JOAQUÍN COSCOMATEPEC,1,116,63,53,6
MÉXICO,15,ACULCO,003,EL AZAFRÁN CENTRO,5,361,186,175,25
MÉXICO,15,ACULCO,003,EL AZAFRÁN TERCERA MANZANA,2,100,52,48,7
MÉXICO,15,ACULCO,003,EL BONXHI,3,174,81,93,11
MÉXICO,15,ACULCO,003,EL COLORADO,4,296,149,147,14
MÉXICO,15,ACULCO,003,EL MOGOTE,3,341,167,174,17
MÉXICO,15,ACULCO,003,EL TIXHIÑU,2,50,26,24,3
MÉXICO,15,ACULCO,003,EL ZETHE (JAZMÍN),4,226,113,113,13
MÉXICO,15,ACULCO,003,EL ZETHE EL LLANO,2,12,7,5,2
MÉXICO,15,ACULCO,003,ENCINILLAS EJIDO,1,34,14,20,2
MÉXICO,15,ACULCO,003,FONDO,3,242,112,130,15
MÉXICO,15,ACULCO,003,GUNYO ORIENTE,1,11,4,7,1
MÉXICO,15,ACULCO,003,GUNYO PONIENTE,6,224,113,111,14
MÉXICO,15,ACULCO,003,HIGUERILLAS C,2,34,13,21,3
MÉXICO,15,ACULCO,003,JURICA,2,66,35,31,5
MÉXICO,15,ACULCO,003,LA COFRADÍA GRANDE,3,55,29,26,4
MÉXICO,15,ACULCO,003,LA CONCEPCIÓN EJIDO,3,311,157,154,14
MÉXICO,15,ACULCO,003,LA CONCEPCIÓN PUEBLO,6,356,188,168,18
MÉXICO,15,ACULCO,003,LA ESTANCIA,2,48,27,21,3
MÉXICO,15,ACULCO,003,LA SOLEDAD BARRIO,1,45,14,31,2
MÉXICO,15,ACULCO,003,LA SOLEDAD EJIDO,4,552,269,283,40
MÉXICO,15,ACULCO,003,LAS LAJAS,2,61,29,32,3
MÉXICO,15,ACULCO,003,LOMA ALTA CABRESTEROS,3,114,63,51,9
MÉXICO,15,ACULCO,003,LOS AILES,2,53,24,29,6
MÉXICO,15,ACULCO,003,LOS GAVILANES,1,7,4,3,1
MÉXICO,15,ACULCO,003,ÑADO BUENAVISTA,3,197,107,90,14
MÉXICO,15,ACULCO,003,PRESA DEL TEPOZÁN,2,33,13,20,2
MÉXICO,15,ACULCO,003,SAN ANTONIO ARROYO ZARCO,2,69,29,40,5
MÉXICO,15,ACULCO,003,SAN ANTONIO EL ZETHE,1,21,11,10,1
MÉXICO,15,ACULCO,003,SAN ANTONIO PUEBLO,5,236,116,120,14
MÉXICO,15,ACULCO,003,SAN FRANCISQUITO,2,72,39,33,4
MÉXICO,15,ACULCO,003,SAN JERÓNIMO BARRIO,2,31,14,17,2
MÉXICO,15,ACULCO,003,SAN JERÓNIMO EJIDO,4,312,138,174,17
MÉXICO,15,ACULCO,003,SAN JOAQUÍN COSCOMATEPEC,3,150,70,80,9
MÉXICO,15,ACULCO,003,SAN LUCAS TOTOLMALOYA,11,1649,853,796,81
MÉXICO,15,ACULCO,003,SAN MARTÍN EJIDO,12,533,271,262,29
MÉXICO,15,ACULCO,003,SAN PEDRO DENXHI CENTRO,7,423,223,200,20
MÉXICO,15,ACULCO,003,SAN PEDRO DENXHI SEGUNDO CUARTEL,1,49,22,27,4
MÉXICO,15,ACULCO,003,SANTA ANA MATLAVAT CENTRO,6,430,203,227,22
MÉXICO,15,ACULCO,003,SANTA MARÍA NATIVITAS,5,813,422,391,46
MÉXICO,15,ACULCO,003,SANTA MARÍA NATIVITAS SEGUNDO CUARTEL,1,8,2,6,1
MÉXICO,15,ACULCO,003,SANTIAGO OXTOC TOXHIÉ,5,184,89,95,12
MÉXICO,15,ALMOLOYA DE ALQUISIRAS,004,AGUA FRÍA,3,387,184,203,26
MÉXICO,15,ALMOLOYA DE ALQUISIRAS,004,AHUACATITLÁN (AGUACATITLÁN),2,54,28,26,3
MÉXICO,15,ALMOLOYA DE ALQUISIRAS,004,ALMOLOYA DE ALQUISIRAS,6,772,371,401,51
MÉXICO,15,ALMOLOYA DE ALQUISIRAS,004,AQUIAPAN,4,90,48,42,9
MÉXICO,15,ALMOLOYA DE ALQUISIRAS,004,BUENOS AIRES,3,92,50,42,10
MÉXICO,15,ALMOLOYA DE ALQUISIRAS,004,CAPULMANCA,2,36,19,17,4
MÉXICO,15,ALMOLOYA DE ALQUISIRAS,004,CERRO DE TLAPEXCO (SEGUNDA MANZANA),2,14,8,6,2
MÉXICO,15,ALMOLOYA DE ALQUISIRAS,004,CERRO DEL GUAYABO,2,42,15,27,4
MÉXICO,15,ALMOLOYA DE ALQUISIRAS,004,CUARTA MANZANA,3,353,184,169,39
MÉXICO,15,ALMOLOYA DE ALQUISIRAS,004,CUAUHTENCO,3,126,67,59,8
MÉXICO,15,ALMOLOYA DE ALQUISIRAS,004,EL MIRADOR,2,20,9,11,2
MÉXICO,15,ALMOLOYA DE ALQUISIRAS,004,JALTEPEC DE ARRIBA,2,49,25,24,4
MÉXICO,15,ALMOLOYA DE ALQUISIRAS,004,LA BARRANCA,2,17,9,8,3
MÉXICO,15,ALMOLOYA DE ALQUISIRAS,004,LA LOBERA,1,7,4,3,1
MÉXICO,15,ALMOLOYA DE ALQUISIRAS,004,LA UNIÓN RIVA PALACIO,4,148,71,77,12
MÉXICO,15,ALMOLOYA DE ALQUISIRAS,004,LAS MESAS,3,113,54,59,8
MÉXICO,15,ALMOLOYA DE ALQUISIRAS,004,LLANO DE LAS CASAS,3,48,26,22,4
MÉXICO,15,ALMOLOYA DE ALQUISIRAS,004,LOMA LARGA,2,26,12,14,3
MÉXICO,15,ALMOLOYA DE ALQUISIRAS,004,LOS PINOS,4,149,84,65,15
MÉXICO,15,ALMOLOYA DE ALQUISIRAS,004,MESA DEL RÍO,3,190,100,90,37
MÉXICO,15,ALMOLOYA DE ALQUISIRAS,004,PLAN DE VIGAS,4,159,88,71,14
MÉXICO,15,ALMOLOYA DE ALQUISIRAS,004,PLUTARCO GONZÁLEZ (HIGUERAS),2,48,26,22,4
MÉXICO,15,ALMOLOYA DE ALQUISIRAS,004,QUINTA MANZANA,4,202,96,106,15
MÉXICO,15,ALMOLOYA DE ALQUISIRAS,004,RANCHO DE LOS PÉREZ,2,18,8,10,4
MÉXICO,15,ALMOLOYA DE ALQUISIRAS,004,SAN ANDRÉS TEPETITLÁN,4,395,172,223,30
MÉXICO,15,ALMOLOYA DE ALQUISIRAS,004,SAN ANTONIO PACHUQUILLA,4,123,67,56,11
MÉXICO,15,ALMOLOYA DE ALQUISIRAS,004,SAN JOSÉ TIZATES (TIZATES),4,164,74,90,13
MÉXICO,15,ALMOLOYA DE ALQUISIRAS,004,SEXTA MANZANA,2,26,19,7,2
MÉXICO,15,ALMOLOYA DE ALQUISIRAS,004,TEPEHUAJES,4,133,59,74,15
MÉXICO,15,ALMOLOYA DE ALQUISIRAS,004,TOTOLTEPEC DE ARRIBA,3,32,19,13,4
MÉXICO,15,ALMOLOYA DE ALQUISIRAS,004,TOTOLTEPEC DE LA PAZ,3,35,22,13,4
MÉXICO,15,ALMOLOYA DE ALQUISIRAS,004,TRIGUILLOS,2,13,4,9,3
MÉXICO,15,ALMOLOYA DE ALQUISIRAS,004,VISTA HERMOSA,2,21,12,9,3
MÉXICO,15,ALMOLOYA DE ALQUISIRAS,004,YERBABUENA,2,13,9,4,3
MÉXICO,15,ALMOLOYA DE JUÁREZ,005,ARROYO ZARCO,5,115,63,52,10
MÉXICO,15,ALMOLOYA DE JUÁREZ,005,BARRIO DE LA CABECERA TERCERA SECCIÓN,1,49,25,24,3
MÉXICO,15,ALMOLOYA DE JUÁREZ,005,BARRIO DEL CARMEN,2,109,65,44,6
MÉXICO,15,ALMOLOYA DE JUÁREZ,005,BARRIO DEL JACAL DE YEBUCIVÍ,4,118,52,66,8
MÉXICO,15,ALMOLOYA DE JUÁREZ,005,BARRIO EL PLAN OCOYOTEPEC,2,64,26,38,4
MÉXICO,15,ALMOLOYA DE JUÁREZ,005,BARRIO LA UNIÓN DE OCOYOTEPEC,3,116,61,55,7
MÉXICO,15,ALMOLOYA DE JUÁREZ,005,BARRIO LOS LAGARTOS YEBUCIVÍ,2,71,35,36,4
MÉXICO,15,ALMOLOYA DE JUÁREZ,005,BARRIO SAN PEDRO (LA CONCEPCIÓN SAN PEDRO),1,129,60,69,8
MÉXICO,15,ALMOLOYA DE JUÁREZ,005,BARRIO SAN PEDRO ZONA NORTE,2,906,450,456,38
MÉXICO,15,ALMOLOYA DE JUÁREZ,005,BENITO JUÁREZ,5,481,244,237,22
MÉXICO,15,ALMOLOYA DE JUÁREZ,005,BUENAVISTA YEBUCIVÍ,3,50,22,28,5
MÉXICO,15,ALMOLOYA DE JUÁREZ,005,CAÑADA DE GUADARRAMA,6,681,316,365,31
MÉXICO,15,ALMOLOYA DE JUÁREZ,005,CASA NUEVA (CASA NUEVA YEBUCIVÍ),3,131,70,61,10
MÉXICO,15,ALMOLOYA DE JUÁREZ,005,CIENEGUILLAS DE GUADALUPE,5,1379,663,716,140
MÉXICO,15,ALMOLOYA DE JUÁREZ,005,CIENEGUILLAS DE MAÑONES,4,108,55,53,7
MÉXICO,15,ALMOLOYA DE JUÁREZ,005,COLONIA BELLAVISTA,4,388,201,187,17
MÉXICO,15,ALMOLOYA DE JUÁREZ,005,COLONIA LÁZARO CÁRDENAS (LA TRAMPA),1,8,5,3,1
MÉXICO,15,ALMOLOYA DE JUÁREZ,005,CONJUNTO HABITACIONAL ECOLÓGICO SUTEYM,2,452,231,221,18
MÉXICO,15,ALMOLOYA DE JUÁREZ,005,DILATADA SUR (DILATADA),4,249,124,125,16
MÉXICO,15,ALMOLOYA DE JUÁREZ,005,EJIDO DE SAN PEDRO,4,533,274,259,22
MÉXICO,15,ALMOLOYA DE JUÁREZ,005,EJIDO EL ESTANCO,6,221,100,121,14
MÉXICO,15,ALMOLOYA DE JUÁREZ,005,EJIDO LA GAVIA (SAN JOSÉ LA GAVIA),8,593,285,308,32
MÉXICO,15,ALMOLOYA DE JUÁREZ,005,EJIDO SAN ANTONIO OCOYOTEPEC,2,82,38,44,4
MÉXICO,15,ALMOLOYA DE JUÁREZ,005,EJIDO SAN DIEGO,1,118,66,52,9
MÉXICO,15,ALMOLOYA DE JUÁREZ,005,EJIDO SANTA MARÍA NATIVITAS (EJIDO TRES BARRANCAS),2,270,114,156,14
MÉXICO,15,ALMOLOYA DE JUÁREZ,005,EL ESTANCO,7,427,223,204,30
MÉXICO,15,ALMOLOYA DE JUÁREZ,005,EL SANTITO (BARRIO EL SANTITO YEBUCIVÍ),3,170,96,74,11
MÉXICO,15,ALMOLOYA DE JUÁREZ,005,EL TEPETATAL,2,419,208,211,15
MÉXICO,15,ALMOLOYA DE JUÁREZ,005,EL TULILLO,2,87,47,40,6
MÉXICO,15,ALMOLOYA DE JUÁREZ,005,FRACCIONAMIENTO COLINAS DEL SOL,1,201,89,112,12
MÉXICO,15,ALMOLOYA DE JUÁREZ,005,LA CABECERA,9,2380,1170,1210,99
MÉXICO,15,ALMOLOYA DE JUÁREZ,005,LA HORTALIZA,3,43,22,21,4
MÉXICO,15,ALMOLOYA DE JUÁREZ,005,LA LAGUNITA YEBUCIVÍ,2,37,20,17,4
MÉXICO,15,ALMOLOYA DE JUÁREZ,005,LA LIMA,1,35,20,15,3
MÉXICO,15,ALMOLOYA DE JUÁREZ,005,LA SOLEDAD OCOYOTEPEC,3,90,34,56,6
MÉXICO,15,ALMOLOYA DE JUÁREZ,005,LA TINAJA,2,19,9,10,2
MÉXICO,15,ALMOLOYA DE JUÁREZ,005,LAGUNA DE TABERNILLAS (EL RESBALOSO),6,460,231,229,23
MÉXICO,15,ALMOLOYA DE JUÁREZ,005,LOMA BLANCA,2,27,8,19,3
MÉXICO,15,ALMOLOYA DE JUÁREZ,005,LOMA DE LA TINAJA,2,40,18,22,4
MÉXICO,15,ALMOLOYA DE JUÁREZ,005,LOMA DE SAN MIGUEL,2,41,21,20,4
MÉXICO,15,ALMOLOYA DE JUÁREZ,005,LOMA DEL JACAL (LOMA DE LAS MANGAS),1,39,24,15,2
MÉXICO,15,ALMOLOYA DE JUÁREZ,005,LOMA DEL SALITRE (COLONIA LOMA DEL SALITRE),4,305,143,162,21
MÉXICO,15,ALMOLOYA DE JUÁREZ,005,MAYORAZGO DE LEÓN (ESTACIÓN RÍO MÉXICO),6,1379,644,735,74
MÉXICO,15,ALMOLOYA DE JUÁREZ,005,MEXTEPEC (EX-HACIENDA MEXTEPEC),5,1199,605,594,60
MÉXICO,15,ALMOLOYA DE JUÁREZ,005,MINA MÉXICO,6,1017,508,509,45
MÉXICO,15,ALMOLOYA DE JUÁREZ,005,OCOYOTEPEC (OCOYOTEPEC CENTRO),2,109,67,42,5
MÉXICO,15,ALMOLOYA DE JUÁREZ,005,PALOS AMARILLOS (PALOS AMARILLOS YEBUCIVÍ),7,382,173,209,22
MÉXICO,15,ALMOLOYA DE JUÁREZ,005,PAREDÓN CENTRO,5,90,44,46,8
MÉXICO,15,ALMOLOYA DE JUÁREZ,005,PAREDÓN EJIDO,5,645,316,329,32
MÉXICO,15,ALMOLOYA DE JUÁREZ,005,POTEJE NORTE,3,191,91,100,10
MÉXICO,15,ALMOLOYA DE JUÁREZ,005,POTEJE SUR,4,494,244,250,24
MÉXICO,15,ALMOLOYA DE JUÁREZ,005,RANCHERÍA DE SAN DIEGO (CIÉNEGA DE SAN DIEGO),4,216,99,117,11
MÉXICO,15,ALMOLOYA DE JUÁREZ,005,RÍO FRÍO (RÍO FRÍO YEBUCIVÍ),2,195,94,101,8
MÉXICO,15,ALMOLOYA DE JUÁREZ,005,ROSA MORADA,3,110,58,52,5
MÉXICO,15,ALMOLOYA DE JUÁREZ,005,SALITRE DE MAÑONES,8,491,222,269,26
MÉXICO,15,ALMOLOYA DE JUÁREZ,005,SAN AGUSTÍN CITLALI,8,1106,570,536,48
MÉXICO,15,ALMOLOYA DE JUÁREZ,005,SAN AGUSTÍN LAS TABLAS,2,126,54,72,5
MÉXICO,15,ALMOLOYA DE JUÁREZ,005,SAN AGUSTÍN POTEJE CENTRO,5,595,309,286,30
MÉXICO,15,ALMOLOYA DE JUÁREZ,005,SAN AGUSTÍN TABERNILLAS,1,133,77,56,16
MÉXICO,15,ALMOLOYA DE JUÁREZ,005,SAN ANTONIO ATOTONILCO,2,116,49,67,5
MÉXICO,15,ALMOLOYA DE JUÁREZ,005,SAN ANTONIO BUENAVISTA,3,134,59,75,12
MÉXICO,15,ALMOLOYA DE JUÁREZ,005,SAN CRISTÓBAL,2,42,23,19,3
MÉXICO,15,ALMOLOYA DE JUÁREZ,005,SAN FRANCISCO TLALCILALCALPAN,19,4752,2365,2387,193
MÉXICO,15,ALMOLOYA DE JUÁREZ,005,SAN ISIDRO (EL RESERVADO),3,440,208,232,15
MÉXICO,15,ALMOLOYA DE JUÁREZ,005,SAN LORENZO CUAUHTENCO,3,573,287,286,22
MÉXICO,15,ALMOLOYA DE JUÁREZ,005,SAN MATEO TLALCHICHILPAN,4,1259,620,639,68
MÉXICO,15,ALMOLOYA DE JUÁREZ,005,SAN MIGUEL ALMOLOYÁN,9,1638,799,839,66
MÉXICO,15,ALMOLOYA DE JUÁREZ,005,SAN NICOLÁS AMEALCO,3,315,143,172,18
MÉXICO,15,ALMOLOYA DE JUÁREZ,005,SAN PEDRO DE LA HORTALIZA (EJIDO ALMOLOYÁN),6,691,331,360,30
MÉXICO,15,ALMOLOYA DE JUÁREZ,005,SANTA JUANA CENTRO (LA PALMA),4,371,166,205,45
MÉXICO,15,ALMOLOYA DE JUÁREZ,005,SANTA JUANA PRIMERA SECCIÓN,14,2366,1197,1169,104
MÉXICO,15,ALMOLOYA DE JUÁREZ,005,SANTA JUANA SEGUNDA SECCIÓN,2,83,35,48,4
MÉXICO,15,ALMOLOYA DE JUÁREZ,005,SANTA MARÍA NATIVITAS,6,1818,949,869,69
MÉXICO,15,ALMOLOYA DE JUÁREZ,005,SANTIAGUITO,1,21,12,9,2
MÉXICO,15,ALMOLOYA DE JUÁREZ,005,SANTIAGUITO TLALCILALCALLI,6,5143,2062,3081,243
MÉXICO,15,ALMOLOYA DE JUÁREZ,005,TABERNILLAS (SANTA CATARINA),5,777,399,378,34
MÉXICO,15,ALMOLOYA DE JUÁREZ,005,VILLA DE ALMOLOYA DE JUÁREZ,11,3634,1934,1700,211
MÉXICO,15,ALMOLOYA DE JUÁREZ,005,YEBUCIVÍ CENTRO (YEBUCIVÍ),3,399,204,195,23
MÉXICO,15,ALMOLOYA DEL RÍO,006,ALMOLOYA DEL RÍO,13,4169,2127,2042,239
MÉXICO,15,AMANALCO,007,AGUA BENDITA,4,151,72,79,11
MÉXICO,15,AMANALCO,007,AMANALCO DE BECERRA,7,1780,918,862,118
MÉXICO,15,AMANALCO,007,CAPILLA VIEJA,4,100,56,44,10
MÉXICO,15,AMANALCO,007,CORRAL DE PIEDRA,2,37,14,23,4
MÉXICO,15,AMANALCO,007,EL ANCÓN,3,65,29,36,5
MÉXICO,15,AMANALCO,007,EL CAPULÍN PRIMERA SECCIÓN,2,72,29,43,5
MÉXICO,15,AMANALCO,007,EL CAPULÍN SEGUNDA SECCIÓN,4,161,72,89,10
MÉXICO,15,AMANALCO,007,EL CAPULÍN TERCERA SECCIÓN (PALO MANCORNADO),1,13,7,6,1
MÉXICO,15,AMANALCO,007,EL PEDREGAL,2,57,23,34,5
MÉXICO,15,AMANALCO,007,EL POTRERO,7,425,192,233,31
MÉXICO,15,AMANALCO,007,EL POTRERO SEGUNDA SECCIÓN,1,8,6,2,1
MÉXICO,15,AMANALCO,007,EL TEMPORAL,4,94,51,43,8
MÉXICO,15,AMANALCO,007,HACIENDA NUEVA,3,24,11,13,3
MÉXICO,15,AMANALCO,007,HUACAL VIEJO,2,35,18,17,3
MÉXICO,15,AMANALCO,007,LAS PILAS,1,7,3,4,1
MÉXICO,15,AMANALCO,007,POLVILLOS (SAN BARTOLO QUINTA SECCIÓN),4,472,243,229,19
MÉXICO,15,AMANALCO,007,PUEBLO NUEVO,4,198,94,104,14
MÉXICO,15,AMANALCO,007,RINCÓN DE GUADALUPE,5,148,74,74,11
MÉXICO,15,AMANALCO,007,SAN BARTOLO,6,1020,508,512,45
MÉXICO,15,AMANALCO,007,SAN JERÓNIMO,9,705,394,311,46
MÉXICO,15,AMANALCO,007,SAN JUAN,5,516,269,247,27
MÉXICO,15,AMANALCO,007,SAN LUCAS,7,382,172,210,17
MÉXICO,15,AMANALCO,007,SAN LUCAS CUARTA SECCIÓN (SAN FRANCISCO),2,26,13,13,3
MÉXICO,15,AMANALCO,007,SAN MATEO,7,698,330,368,42
MÉXICO,15,AMANALCO,007,SAN MATEO QUINTA SECCIÓN (LA PROVIDENCIA),2,33,20,13,4
MÉXICO,15,AMANALCO,007,SAN MIGUEL (SAN MIGUEL TENEXTEPEC),4,154,74,80,9
MÉXICO,15,AMANALCO,007,SAN SEBASTIÁN EL CHICO,3,42,21,21,4
MÉXICO,15,AMANALCO,007,SAN SEBASTIÁN EL GRANDE,6,250,135,115,15
MÉXICO,15,AMATEPEC,008,AGUACATITLÁN (LA CARRETA),1,4,2,2,1
MÉXICO,15,AMATEPEC,008,AMADORES (LOS AMADOR),2,22,11,11,4
MÉXICO,15,AMATEPEC,008,AMATEPEC,5,650,307,343,55
MÉXICO,15,AMATEPEC,008,AVIACIÓN (CAMPO DE AVIACIÓN),1,239,124,115,12
MÉXICO,15,AMATEPEC,008,AYUQUILA,4,113,58,55,9
MÉXICO,15,AMATEPEC,008,BARRANCA DE ESMERALDAS (LA GÜILA),2,8,4,4,2
MÉXICO,15,AMATEPEC,008,BARRANCA DEL COYOL,1,3,2,1,1
MÉXICO,15,AMATEPEC,008,BARRANCA DEL MAMEY,1,4,1,3,1
MÉXICO,15,AMATEPEC,008,BARRIO DE LA UVA,2,22,7,15,2
MÉXICO,15,AMATEPEC,008,BUENAVISTA,2,25,10,15,3
MÉXICO,15,AMATEPEC,008,CERRO DE LAS ÁNIMAS (EL CERRO DE LAS ÁNIMAS),3,47,30,17,9
MÉXICO,15,AMATEPEC,008,CERRO DE TLACOTEPEC (TLACOTEPEC),1,2,0,2,1
MÉXICO,15,AMATEPEC,008,CERRO DEL CAMPO,4,337,166,171,38
MÉXICO,15,AMATEPEC,008,CERRO DEL COYOL,1,9,5,4,1
MÉXICO,15,AMATEPEC,008,CERRO VERDE,1,7,5,2,1
MÉXICO,15,AMATEPEC,008,CHARCO HONDO (EL TLACUACHE),2,31,14,17,2
MÉXICO,15,AMATEPEC,008,CINCUENTA ARROBAS,5,145,78,67,15
MÉXICO,15,AMATEPEC,008,COAHUILOTES (LOS COAHUILOTES),3,72,38,34,9
MÉXICO,15,AMATEPEC,008,CORRAL DE PIEDRA,2,21,11,10,3
MÉXICO,15,AMATEPEC,008,CORRAL VIEJO,4,59,30,29,8
MÉXICO,15,AMATEPEC,008,COYOL DE SAN SIMÓN,2,43,27,16,4
MÉXICO,15,AMATEPEC,008,CRISTO REY (GUACAMAYAS),2,10,9,1,2
MÉXICO,15,AMATEPEC,008,CRUCERO CERRO DEL CAMPO,2,21,8,13,3
MÉXICO,15,AMATEPEC,008,CUADRILLA DE LÓPEZ,2,34,21,13,4
MÉXICO,15,AMATEPEC,008,CUADRILLA DEL NARANJO (RINCÓN DEL NARANJO),2,17,12,5,2
MÉXICO,15,AMATEPEC,008,CUADRILLA NUEVA,2,47,26,21,6
MÉXICO,15,AMATEPEC,008,EL AGUACATE,1,7,1,6,1
MÉXICO,15,AMATEPEC,008,EL AGUACATE (EL AGUACATE SAN MARTÍN),1,3,1,2,1
MÉXICO,15,AMATEPEC,008,EL AGUACATITO (CUADRILLA DE JAIMES),1,15,10,5,1
MÉXICO,15,AMATEPEC,008,EL ARRAYÁN,1,16,9,7,1
MÉXICO,15,AMATEPEC,008,EL CONEJO (CONEJO VIEJO),3,152,89,63,15
MÉXICO,15,AMATEPEC,008,EL CONSUELO,3,50,24,26,6
MÉXICO,15,AMATEPEC,008,EL CONVENTO,1,6,3,3,2
MÉXICO,15,AMATEPEC,008,EL COYOL,1,14,7,7,1
MÉXICO,15,AMATEPEC,008,EL FRESNO,4,75,30,45,10
MÉXICO,15,AMATEPEC,008,EL LLANO,4,22,10,12,4
MÉXICO,15,AMATEPEC,008,EL MALPASO,3,63,33,30,5
MÉXICO,15,AMATEPEC,008,EL MONTEAL (BARRANCA PAPALOAPAN),3,20,14,6,2
MÉXICO,15,AMATEPEC,008,EL ORTIGO,2,42,27,15,3
MÉXICO,15,AMATEPEC,008,EL PANTALÓN,1,29,17,12,3
MÉXICO,15,AMATEPEC,008,EL PANTEÓN DE SAN FELIPE DE JESÚS,1,5,4,1,1
MÉXICO,15,AMATEPEC,008,EL PARAJE,2,9,3,6,2
MÉXICO,15,AMATEPEC,008,EL PUERTO,2,62,28,34,5
MÉXICO,15,AMATEPEC,008,EL RANCHO,3,117,51,66,7
MÉXICO,15,AMATEPEC,008,EL RODEO,2,22,13,9,3
MÉXICO,15,AMATEPEC,008,EL SITIO,4,61,26,35,9
MÉXICO,15,AMATEPEC,008,EL TLAPANCO,2,13,7,6,2
MÉXICO,15,AMATEPEC,008,EL VELADERO,2,87,46,41,7
MÉXICO,15,AMATEPEC,008,EL ZAPOTE,3,56,33,23,4
MÉXICO,15,AMATEPEC,008,EL ZAPOTE (EL ZAPOTE LÓPEZ),1,12,6,6,1
MÉXICO,15,AMATEPEC,008,ENCINAL VERDE,4,74,39,35,5
MÉXICO,15,AMATEPEC,008,EX-HACIENDA RODEO MATUZ (EL RODEO),4,45,21,24,8
MÉXICO,15,AMATEPEC,008,GÜIJAS BLANCAS,2,30,12,18,2
MÉXICO,15,AMATEPEC,008,HUIXTITLA,3,45,22,23,5
MÉXICO,15,AMATEPEC,008,JOYA DE LA VENTA,2,10,3,7,2
MÉXICO,15,AMATEPEC,008,LA CHAQUETA,1,7,2,5,2
MÉXICO,15,AMATEPEC,008,LA CHUPA ROSA,2,21,9,12,3
MÉXICO,15,AMATEPEC,008,LA COFRADÍA,5,156,78,78,13
MÉXICO,15,AMATEPEC,008,LA GOLETA,5,183,105,78,23
MÉXICO,15,AMATEPEC,008,LA MORA,2,19,5,14,3
MÉXICO,15,AMATEPEC,008,LA PAROTA (LA PAROTA TEPEHUAJES),2,45,20,25,3
MÉXICO,15,AMATEPEC,008,LA RAYUELA,2,28,14,14,5
MÉXICO,15,AMATEPEC,008,LAS CEIBAS,1,5,2,3,2
MÉXICO,15,AMATEPEC,008,LAS JOYAS,4,83,48,35,10
MÉXICO,15,AMATEPEC,008,LAS LATAS (AYUQUILA),3,46,20,26,5
MÉXICO,15,AMATEPEC,008,LOS ENCINOS,2,28,14,14,4
MÉXICO,15,AMATEPEC,008,LOS ESPINOS,2,12,9,3,2
MÉXICO,15,AMATEPEC,008,LOS GUAJES,1,6,3,3,2
MÉXICO,15,AMATEPEC,008,LOS ÓRGANOS,1,8,5,3,1
MÉXICO,15,AMATEPEC,008,LOS SABINOS,2,57,25,32,3
MÉXICO,15,AMATEPEC,008,LOS TIMBRES,3,68,31,37,9
MÉXICO,15,AMATEPEC,008,MANGO MATUZ,2,15,4,11,4
MÉXICO,15,AMATEPEC,008,MATUZ PUERTO DEL RODEO,2,15,7,8,3
MÉXICO,15,AMATEPEC,008,MEYUCA,1,11,5,6,1
MÉXICO,15,AMATEPEC,008,PALMAR CHICO,8,785,370,415,64
MÉXICO,15,AMATEPEC,008,PALMARILLOS,3,148,66,82,10
MÉXICO,15,AMATEPEC,008,PEÑA DEL CUERVO,2,14,6,8,2
MÉXICO,15,AMATEPEC,008,PINZANES MATUZ,1,5,3,2,1
MÉXICO,15,AMATEPEC,008,PUEBLO NUEVO (SAN LUCAS PUEBLO NUEVO),3,74,42,32,7
MÉXICO,15,AMATEPEC,008,PUENTE DEL RODEO,2,5,2,3,2
MÉXICO,15,AMATEPEC,008,PUENTE VIEJO,4,129,66,63,12
MÉXICO,15,AMATEPEC,008,QUIMICHATENCO (BARRANCA DE QUIMICHATENCO),4,104,59,45,11
MÉXICO,15,AMATEPEC,008,RINCÓN DE ESMERALDAS,2,17,10,7,2
MÉXICO,15,AMATEPEC,008,RINCÓN DE LA COFRADÍA,2,38,17,21,3
MÉXICO,15,AMATEPEC,008,RINCÓN DE SAN SIMÓN,2,25,9,16,3
MÉXICO,15,AMATEPEC,008,SALITRE DE LÓPEZ,3,34,18,16,3
MÉXICO,15,AMATEPEC,008,SALITRE PALMARILLOS,3,239,116,123,18
MÉXICO,15,AMATEPEC,008,SALITRE SANTA BÁRBARA (SANTA BÁRBARA),2,23,13,10,3
MÉXICO,15,AMATEPEC,008,SAN FELIPE DE JESÚS,3,71,38,33,6
MÉXICO,15,AMATEPEC,008,SAN FRANCISCO DE LOS PINZANES,2,25,13,12,6
MÉXICO,15,AMATEPEC,008,SAN JOSÉ (SAN JOSÉ DEL PALMAR),1,8,4,4,1
MÉXICO,15,AMATEPEC,008,SAN MARCOS,2,7,2,5,2
MÉXICO,15,AMATEPEC,008,SAN MARTÍN,4,122,61,61,11
MÉXICO,15,AMATEPEC,008,SAN MIGUEL (SAN MIGUEL ZINACAUSTO),4,83,44,39,10
MÉXICO,15,AMATEPEC,008,SAN SIMÓN (SAN SIMÓN ZOZOCOLTEPEC),4,456,265,191,30
MÉXICO,15,AMATEPEC,008,SANTIAGO,4,83,37,46,10
MÉXICO,15,AMATEPEC,008,TEPEHUAJES (TEPEHUAJES DE ABAJO),1,7,4,3,1
MÉXICO,15,AMATEPEC,008,TEPEHUAJES UNO (TEPEHUAJES DE ARRIBA),3,24,13,11,4
MÉXICO,15,AMATEPEC,008,TEPEHUASTITLÁN,3,29,14,15,4
MÉXICO,15,AMATEPEC,008,TEZULULOMA (TESHULULOMA),2,9,3,6,2
MÉXICO,15,AMATEPEC,008,TIERRA AZUL,2,100,50,50,8
MÉXICO,15,AMATEPEC,008,ZACATONES,2,51,25,26,3
MÉXICO,15,AMECAMECA,009,AMECAMECA DE JUÁREZ,61,14453,7935,6518,941
MÉXICO,15,AMECAMECA,009,FÁBRICA TEXTIL (BARRIO DE PANOAYA),3,210,97,113,15
MÉXICO,15,AMECAMECA,009,SAN ANTONIO ZOYATZINGO,5,903,439,464,70
MÉXICO,15,AMECAMECA,009,SAN DIEGO HUEHUECALCO,3,204,106,98,11
MÉXICO,15,AMECAMECA,009,SAN FRANCISCO ZENTLALPAN,6,642,297,345,52
MÉXICO,15,AMECAMECA,009,SAN PEDRO NEXAPA,7,1572,789,783,92
MÉXICO,15,AMECAMECA,009,SANTA ISABEL CHALMA,5,632,316,316,56
MÉXICO,15,AMECAMECA,009,SANTIAGO CUAUHTENCO,3,344,161,183,15
MÉXICO,15,APAXCO,010,APAXCO DE OCAMPO,23,5124,2671,2453,267
MÉXICO,15,APAXCO,010,COLONIA JUÁREZ,2,207,115,92,9
MÉXICO,15,APAXCO,010,COYOTILLOS,4,642,318,324,27
MÉXICO,15,APAXCO,010,EL MIRADOR,1,96,47,49,6
MÉXICO,15,APAXCO,010,EL PIXQUAY,2,281,134,147,11
MÉXICO,15,APAXCO,010,PÉREZ DE GALEANA,3,420,211,209,15
MÉXICO,15,APAXCO,010,SANTA MARÍA APAXCO,4,1768,818,950,154
MÉXICO,15,ATENCO,011,CONSTITUCIÓN EL SALADO,2,208,94,114,8
MÉXICO,15,ATENCO,011,EJIDO DE NEXQUIPAYAC,1,588,305,283,33
MÉXICO,15,ATENCO,011,EJIDO SAN SALVADOR ACUEXCOMAC (EJIDO LA PURÍSIMA),4,1274,574,700,125
MÉXICO,15,ATENCO,011,FRANCISCO I. MADERO,2,133,59,74,5
MÉXICO,15,ATENCO,011,GRANJAS EL ARENAL,2,663,345,318,18
MÉXICO,15,ATENCO,011,LA PASTORÍA,3,1043,575,468,75
MÉXICO,15,ATENCO,011,SAN CRISTÓBAL NEXQUIPAYAC,11,1284,641,643,63
MÉXICO,15,ATENCO,011,SAN SALVADOR ATENCO,18,5005,2564,2441,230
MÉXICO,15,ATENCO,011,SANTA ISABEL IXTAPAN,5,804,391,413,29
MÉXICO,15,ATENCO,011,SANTA ROSA,5,1115,566,549,41
MÉXICO,15,ATENCO,011,ZAPOTLÁN,4,588,288,300,27
MÉXICO,15,ATIZAPÁN,012,COLONIA LIBERTAD,3,813,442,371,45
MÉXICO,15,ATIZAPÁN,012,SANTA CRUZ ATIZAPÁN,13,2808,1395,1413,137
MÉXICO,15,ATIZAPÁN DE ZARAGOZA,013,CIUDAD LÓPEZ MATEOS,464,113151,57665,55486,7125
MÉXICO,15,ATIZAPÁN DE ZARAGOZA,013,RANCHO BLANCO EJIDO DE ESPÍRITU SANTO,8,522,257,265,46
MÉXICO,15,ATIZAPÁN DE ZARAGOZA,013,VIEJO MADÍN,4,920,435,485,73
MÉXICO,15,ATLACOMULCO,014,ATLACOMULCO DE FABELA,68,16683,8512,8171,1332
MÉXICO,15,ATLACOMULCO,014,BOBASHÍ DE GUADALUPE,4,491,243,248,20
MÉXICO,15,ATLACOMULCO,014,BOMBATEVI EJIDO (EJIDO SANTA CRUZ BOMBATEVI),4,695,332,363,32
MÉXICO,15,ATLACOMULCO,014,CERRITO COLORADO,2,49,30,19,3
MÉXICO,15,ATLACOMULCO,014,CHOSTO DE LOS JARROS,5,695,350,345,43
MÉXICO,15,ATLACOMULCO,014,COLONIA RÍO LERMA (TIC TI),1,237,122,115,11
MÉXICO,15,ATLACOMULCO,014,CUENDÓ,4,417,182,235,18
MÉXICO,15,ATLACOMULCO,014,DIXIMOXI,2,31,16,15,3
MÉXICO,15,ATLACOMULCO,014,DOLORES LA JOYA,3,150,72,78,10
MÉXICO,15,ATLACOMULCO,014,EJIDO DEL RINCÓN DE LA CANDELARIA,1,5,3,2,1
MÉXICO,15,ATLACOMULCO,014,EL ESPEJEL,1,149,73,76,6
MÉXICO,15,ATLACOMULCO,014,EL RINCÓN DE LA CANDELARIA,3,129,66,63,9
MÉXICO,15,ATLACOMULCO,014,EL SALTO,3,54,24,30,4
MÉXICO,15,ATLACOMULCO,014,LA MESA DE CHOSTO,4,527,262,265,26
MÉXICO,15,ATLACOMULCO,014,LA PALMA,1,18,10,8,1
MÉXICO,15,ATLACOMULCO,014,MANTO DEL RÍO,1,58,37,21,3
MÉXICO,15,ATLACOMULCO,014,MANTO DEL RÍO PUEBLO,6,613,296,317,32
MÉXICO,15,ATLACOMULCO,014,RANCHO SAN MARTÍN,3,1484,867,617,66
MÉXICO,15,ATLACOMULCO,014,SAN ANTONIO ENCHISI,7,1522,780,742,92
MÉXICO,15,ATLACOMULCO,014,SAN BARTOLO EL ARENAL,3,147,71,76,10
MÉXICO,15,ATLACOMULCO,014,SAN BARTOLO LANZADOS,3,274,133,141,17
MÉXICO,15,ATLACOMULCO,014,SAN FELIPE PUEBLO NUEVO,4,414,206,208,23
MÉXICO,15,ATLACOMULCO,014,SAN FRANCISCO CHALCHIHUAPAN,7,1965,1181,784,124
MÉXICO,15,ATLACOMULCO,014,SAN IGNACIO DE LOYOLA,2,34,13,21,3
MÉXICO,15,ATLACOMULCO,014,SAN JERÓNIMO DE LOS JARROS,6,908,502,406,39
MÉXICO,15,ATLACOMULCO,014,SAN JOSÉ DEL TUNAL,3,300,136,164,17
MÉXICO,15,ATLACOMULCO,014,SAN JOSÉ TOXI,4,283,128,155,18
MÉXICO,15,ATLACOMULCO,014,SAN JUAN DE LOS JARROS,5,1243,658,585,72
MÉXICO,15,ATLACOMULCO,014,SAN LORENZO TLACOTEPEC,11,2452,1248,1204,110
MÉXICO,15,ATLACOMULCO,014,SAN LUIS BORO,3,217,99,118,14
MÉXICO,15,ATLACOMULCO,014,SAN PABLO ATOTONILCO,2,152,81,71,8
MÉXICO,15,ATLACOMULCO,014,SAN PEDRO DEL ROSAL,8,1515,763,752,70
MÉXICO,15,ATLACOMULCO,014,SANTA BÁRBARA [PARQUE INDUSTRIAL],1,102,47,55,6
MÉXICO,15,ATLACOMULCO,014,SANTA CRUZ BOMBATEVI,6,471,229,242,54
MÉXICO,15,ATLACOMULCO,014,SANTIAGO ACUTZILAPAN,11,2560,1299,1261,116
MÉXICO,15,ATLACOMULCO,014,SANTO DOMINGO SHOMEJÉ,4,1131,571,560,57
MÉXICO,15,ATLACOMULCO,014,TECOAC (SANTA MARÍA NATIVITAS),5,569,290,279,31
MÉXICO,15,ATLACOMULCO,014,TIERRAS BLANCAS,2,49,27,22,4
MÉXICO,15,ATLACOMULCO,014,VALLE DE LOS SAUCES [CONJUNTO URBANO],1,191,80,111,6
MÉXICO,15,ATLACOMULCO,014,ZONA INDUSTRIAL,1,200,126,74,3
MÉXICO,15,ATLAUTLA,015,ATLAUTLA DE VICTORIA,15,4301,2035,2266,302
MÉXICO,15,ATLAUTLA,015,EL MIRADOR,1,241,113,128,8
MÉXICO,15,ATLAUTLA,015,POPO PARK,3,443,207,236,19
MÉXICO,15,ATLAUTLA,015,SAN ANDRÉS TLALAMAC,6,888,413,475,51
MÉXICO,15,ATLAUTLA,015,SAN JUAN GRANDE,2,55,28,27,4
MÉXICO,15,ATLAUTLA,015,SAN JUAN TEHUIXTITLÁN,7,1389,689,700,72
MÉXICO,15,ATLAUTLA,015,SAN JUAN TEPECOCULCO,6,1061,519,542,52
MÉXICO,15,AXAPUSCO,016,ATLA (TECUAUTITLÁN ATLA),3,50,23,27,5
MÉXICO,15,AXAPUSCO,016,AXAPUSCO,12,1585,793,792,86
MÉXICO,15,AXAPUSCO,016,BARRIO SAN BARTOLO ALTO,1,10,4,6,1
MÉXICO,15,AXAPUSCO,016,GUADALUPE RELINAS,4,162,81,81,12
MÉXICO,15,AXAPUSCO,016,JALTEPEC,9,1214,582,632,79
MÉXICO,15,AXAPUSCO,016,SAN ANTONIO COAYUCA,3,90,40,50,7
MÉXICO,15,AXAPUSCO,016,SAN ANTONIO OMETUSCO,4,118,63,55,10
MÉXICO,15,AXAPUSCO,016,SAN FELIPE ZACATEPEC,4,254,119,135,13
MÉXICO,15,AXAPUSCO,016,SAN MIGUEL OMETUSCO,2,26,12,14,3
MÉXICO,15,AXAPUSCO,016,SAN NICOLÁS TETEPANTLA,2,96,51,45,5
MÉXICO,15,AXAPUSCO,016,SAN PABLO XUCHITL,4,184,89,95,11
MÉXICO,15,AXAPUSCO,016,SANTA MARÍA ACTIPAC,8,998,535,463,69
MÉXICO,15,AXAPUSCO,016,SANTO DOMINGO AZTACAMECA,10,3107,1830,1277,180
MÉXICO,15,AXAPUSCO,016,TLAMAPA,4,345,204,141,21
MÉXICO,15,AXAPUSCO,016,XALA,3,178,97,81,10
MÉXICO,15,AXAPUSCO,016,ZACATEPEC,2,32,19,13,4
MÉXICO,15,AYAPANGO,017,AYAPANGO DE GABRIEL RAMOS M.,8,1351,683,668,143
MÉXICO,15,AYAPANGO,017,MIHUACÁN,1,8,3,5,2
MÉXICO,15,AYAPANGO,017,PAHUACÁN,4,333,147,186,15
MÉXICO,15,AYAPANGO,017,POXTLA,2,164,86,78,7
MÉXICO,15,AYAPANGO,017,TLAMAPA,2,81,38,43,5
MÉXICO,15,CALIMAYA,018,CALIMAYA DE DÍAZ GONZÁLEZ,21,6219,3359,2860,429
MÉXICO,15,CALIMAYA,018,COLONIA ARBOLEDAS (SAN ANDRÉS),1,222,119,103,21
MÉXICO,15,CALIMAYA,018,FRACCIONAMIENTO VALLE DEL NEVADO,1,278,146,132,11
MÉXICO,15,CALIMAYA,018,HACIENDA DE LAS FUENTES [FRACCIONAMIENTO],2,283,126,157,12
MÉXICO,15,CALIMAYA,018,LA CONCEPCIÓN COATIPAC (LA CONCHITA),5,772,369,403,35
MÉXICO,15,CALIMAYA,018,LAS JARILLAS,3,238,100,138,10
MÉXICO,15,CALIMAYA,018,SAN ANDRÉS OCOTLÁN,14,2105,1013,1092,110
MÉXICO,15,CALIMAYA,018,SAN BARTOLITO TLALTELOLCO,4,578,271,307,30
MÉXICO,15,CALIMAYA,018,SAN DIEGO LA HUERTA,2,239,142,97,16
MÉXICO,15,CALIMAYA,018,SAN LORENZO CUAUHTENCO,4,596,302,294,31
MÉXICO,15,CALIMAYA,018,SAN MARCOS DE LA CRUZ,6,377,191,186,43
MÉXICO,15,CALIMAYA,018,SANTA MARÍA NATIVITAS,10,1670,847,823,107
MÉXICO,15,CALIMAYA,018,ZARAGOZA DE GUADALUPE,9,1985,981,1004,91
MÉXICO,15,CAPULHUAC,019,AGUA BLANCA,2,188,103,85,7
MÉXICO,15,CAPULHUAC,019,CAPULHUAC DE MIRAFUENTES,24,6347,3453,2894,447
MÉXICO,15,CAPULHUAC,019,LOMAS DE SAN JUAN,1,277,189,88,27
MÉXICO,15,CAPULHUAC,019,SAN JUAN BAUTISTA,1,101,65,36,4
MÉXICO,15,CAPULHUAC,019,SAN MIGUEL ALMAYA,7,1193,586,607,77
MÉXICO,15,CAPULHUAC,019,SAN NICOLÁS TLAZALA,6,1270,628,642,53
MÉXICO,15,COACALCO DE BERRIOZÁBAL,020,BOSQUES DE COACALCO,2,811,454,357,110
MÉXICO,15,COACALCO DE BERRIOZÁBAL,020,SAN FRANCISCO COACALCO,345,78043,39771,38272,5367
MÉXICO,15,COATEPEC HARINAS,021,ACUITLAPILCO,5,573,263,310,32
MÉXICO,15,COATEPEC HARINAS,021,AGUA AMARGA,6,385,211,174,19
MÉXICO,15,COATEPEC HARINAS,021,AGUA BENDITA,4,195,96,99,14
MÉXICO,15,COATEPEC HARINAS,021,ALTA DE LAJA AZUL,1,20,11,9,2
MÉXICO,15,COATEPEC HARINAS,021,BAJA DE LAJA AZUL,2,19,8,11,4
MÉXICO,15,COATEPEC HARINAS,021,CAPULÍN REDONDO,3,104,51,53,5
MÉXICO,15,COATEPEC HARINAS,021,CHILTEPEC DE HIDALGO,3,269,154,115,20
MÉXICO,15,COATEPEC HARINAS,021,COATEPEC HARINAS,10,882,478,404,45
MÉXICO,15,COATEPEC HARINAS,021,COCHISQUILA,4,208,108,100,16
MÉXICO,15,COATEPEC HARINAS,021,COLONIA EL POTRERO (EL POTRERO),4,446,275,171,41
MÉXICO,15,COATEPEC HARINAS,021,COLONIA GUADALUPE,2,118,58,60,7
MÉXICO,15,COATEPEC HARINAS,021,CRUZ DE PIEDRA,2,109,53,56,8
MÉXICO,15,COATEPEC HARINAS,021,CUENTLA,1,10,5,5,1
MÉXICO,15,COATEPEC HARINAS,021,EL CEDRITO,4,170,77,93,11
MÉXICO,15,COATEPEC HARINAS,021,EL PICACHO,4,116,50,66,13
MÉXICO,15,COATEPEC HARINAS,021,EL POTRERITO (EL POTRERO),2,123,59,64,7
MÉXICO,15,COATEPEC HARINAS,021,EL REYNOSO,3,494,312,182,32
MÉXICO,15,COATEPEC HARINAS,021,EL TELAR,4,160,78,82,13
MÉXICO,15,COATEPEC HARINAS,021,HUAYANALCO,3,73,37,36,5
MÉXICO,15,COATEPEC HARINAS,021,IXTLAHUACA DE VILLADA,3,150,77,73,12
MÉXICO,15,COATEPEC HARINAS,021,LA CERCADA,2,66,29,37,4
MÉXICO,15,COATEPEC HARINAS,021,LA CONCHITA,3,58,30,28,4
MÉXICO,15,COATEPEC HARINAS,021,LA GALERA,2,68,35,33,6
MÉXICO,15,COATEPEC HARINAS,021,LAS JARAS,3,31,17,14,3
MÉXICO,15,COATEPEC HARINAS,021,LAS MESAS,2,24,10,14,3
MÉXICO,15,COATEPEC HARINAS,021,LAS TROJES,3,51,19,32,5
MÉXICO,15,COATEPEC HARINAS,021,LAS VUELTAS,4,236,120,116,15
MÉXICO,15,COATEPEC HARINAS,021,LLANO GRANDE,4,366,178,188,19
MÉXICO,15,COATEPEC HARINAS,021,LOMA DE ACUITLAPILCO,2,161,89,72,7
MÉXICO,15,COATEPEC HARINAS,021,LOS FRESNOS,2,78,35,43,4
MÉXICO,15,COATEPEC HARINAS,021,MEYUCA DE MORELOS (MEYUCA),3,169,79,90,16
MÉXICO,15,COATEPEC HARINAS,021,MONTE DE LAS VUELTAS,3,66,34,32,8
MÉXICO,15,COATEPEC HARINAS,021,PIEDRAS ANCHAS (PRIMERA DEL MONTE),1,65,31,34,3
MÉXICO,15,COATEPEC HARINAS,021,PLAN DE SAN FRANCISCO,3,129,64,65,7
MÉXICO,15,COATEPEC HARINAS,021,POTRERO REDONDO,3,130,53,77,6
MÉXICO,15,COATEPEC HARINAS,021,PRIMERA DE ANALCO,3,190,99,91,10
MÉXICO,15,COATEPEC HARINAS,021,PRIMERA DE SAN MIGUEL (LA PUNTA),1,29,11,18,2
MÉXICO,15,COATEPEC HARINAS,021,PRIMERA DE SANTA ANA,4,1518,787,731,67
MÉXICO,15,COATEPEC HARINAS,021,PRIMERA DE ZACANGUILLO (SANTO NIÑO DOCTOR),2,174,90,84,7
MÉXICO,15,COATEPEC HARINAS,021,PRIMERA DEL MONTE (LA PRESA),4,309,159,150,18
MÉXICO,15,COATEPEC HARINAS,021,PUERTA DEL CARMEN,2,114,67,47,5
MÉXICO,15,COATEPEC HARINAS,021,SAN FERNANDO,2,80,49,31,4
MÉXICO,15,COATEPEC HARINAS,021,SAN JOSÉ DEL PROGRESO (SAN JOSÉ),5,250,120,130,14
MÉXICO,15,COATEPEC HARINAS,021,SAN LUIS (COLONIA HIDALGO),4,489,266,223,52
MÉXICO,15,COATEPEC HARINAS,021,SAN MARTÍN EL SALTO,3,109,52,57,5
MÉXICO,15,COATEPEC HARINAS,021,SAN PEDRO,1,29,18,11,2
MÉXICO,15,COATEPEC HARINAS,021,SANTO NIÑO,1,16,9,7,1
MÉXICO,15,COATEPEC HARINAS,021,SEGUNDA DE ANALCO (LA PRESA),1,15,9,6,1
MÉXICO,15,COATEPEC HARINAS,021,SEGUNDA DE SAN MIGUEL (EL CERRITO),1,146,69,77,8
MÉXICO,15,COATEPEC HARINAS,021,SEGUNDA DE SANTA ANA,6,817,531,286,78
MÉXICO,15,COATEPEC HARINAS,021,SEGUNDA DE ZACANGUILLO,1,16,8,8,1
MÉXICO,15,COATEPEC HARINAS,021,SEGUNDA DEL MONTE (LA PRESA),2,371,194,177,23
MÉXICO,15,COATEPEC HARINAS,021,TECOLOTEPEC,7,288,153,135,20
MÉXICO,15,COATEPEC HARINAS,021,TEOCOTITLA,4,252,130,122,15
MÉXICO,15,COATEPEC HARINAS,021,ZACATONES (SAN FELIPE DE JESÚS),4,341,170,171,17
MÉXICO,15,COCOTITLÁN,022,COCOTITLÁN,12,2946,1437,1509,154
MÉXICO,15,COCOTITLÁN,022,SAN ANDRÉS METLA,4,361,176,185,17
MÉXICO,15,COYOTEPEC,023,COYOTEPEC,42,11235,5600,5635,556
MÉXICO,15,COYOTEPEC,023,LA PLANADA,4,587,297,290,26
MÉXICO,15,COYOTEPEC,023,LA RENDA,1,54,24,30,5
MÉXICO,15,COYOTEPEC,023,LOMAS DE GUADALUPE,3,37,28,9,4
MÉXICO,15,CUAUTITLÁN,024,ÁLAMOS III [CONJUNTO URBANO],1,76,42,34,4
MÉXICO,15,CUAUTITLÁN,024,COLONIA VENECIA,1,183,96,87,6
MÉXICO,15,CUAUTITLÁN,024,CUAUTITLÁN,128,28792,14584,14208,1629
MÉXICO,15,CUAUTITLÁN,024,FRACCIÓN SAN ROQUE (EL PRIETO),2,167,80,87,12
MÉXICO,15,CUAUTITLÁN,024,FRACCIONAMIENTO PARQUE SAN MATEO (HACIENDA SAN MATEO),2,748,374,374,28
MÉXICO,15,CUAUTITLÁN,024,PASEOS DEL BOSQUE [CONJUNTO URBANO],2,540,217,323,21
MÉXICO,15,CUAUTITLÁN,024,SAN MATEO IXTACALCO,18,2330,1158,1172,141
MÉXICO,15,CUAUTITLÁN,024,SANTA MARÍA HUECATITLA,3,993,501,492,46
MÉXICO,15,CHALCO,025,CASERÍO DE CORTÉS,2,107,47,60,8
MÉXICO,15,CHALCO,025,CHALCO DE DÍAZ COVARRUBIAS,229,59947,32934,27013,3527
MÉXICO,15,CHALCO,025,COLONIA CALLE SANTA CRUZ AMALINALCO,3,449,212,237,16
MÉXICO,15,CHALCO,025,EL POTRERO,1,208,95,113,6
MÉXICO,15,CHALCO,025,LA CANDELARIA TLAPALA,9,4131,1679,2452,205
MÉXICO,15,CHALCO,025,LOS ÁLAMOS [CONJUNTO URBANO],5,1337,663,674,59
MÉXICO,15,CHALCO,025,LOS HÉROES CHALCO [CONJUNTO URBANO],1,83,41,42,4
MÉXICO,15,CHALCO,025,MARGARITA MORÁN,1,239,106,133,8
MÉXICO,15,CHALCO,025,PUEBLO NUEVO [CONJUNTO URBANO],2,637,336,301,26
MÉXICO,15,CHALCO,025,SAN GREGORIO CUAUTZINGO,15,3443,1702,1741,249
MÉXICO,15,CHALCO,025,SAN JUAN TEZOMPA,9,1485,722,763,88
MÉXICO,15,CHALCO,025,SAN LUCAS AMALINALCO,4,1331,659,672,52
MÉXICO,15,CHALCO,025,SAN MARCOS HUIXTOCO,21,4328,2115,2213,204
MÉXICO,15,CHALCO,025,SAN MARTÍN CUAUTLALPAN,44,12902,6340,6562,547
MÉXICO,15,CHALCO,025,SAN MARTÍN XICO NUEVO,5,679,333,346,41
MÉXICO,15,CHALCO,025,SAN MATEO HUITZILZINGO,13,2179,1058,1121,100
MÉXICO,15,CHALCO,025,SAN MATEO TEZOQUIPAN MIRAFLORES,18,3813,1992,1821,235
MÉXICO,15,CHALCO,025,SAN PABLO ATLAZALPAN,14,3954,1945,2009,155
MÉXICO,15,CHALCO,025,SANTA CATARINA AYOTZINGO,10,2766,1365,1401,177
MÉXICO,15,CHALCO,025,SANTA MARÍA HUEXOCULCO,12,3060,1540,1520,135
MÉXICO,15,CHALCO,025,VILLAS DE SAN MARTÍN [CONJUNTO URBANO],1,219,110,109,9
MÉXICO,15,CHAPA DE MOTA,026,BARAJAS,4,69,36,33,9
MÉXICO,15,CHAPA DE MOTA,026,CADENQUI,4,214,107,107,14
MÉXICO,15,CHAPA DE MOTA,026,CHAPA DE MOTA,3,542,275,267,30
MÉXICO,15,CHAPA DE MOTA,026,DAMATE,2,18,14,4,3
MÉXICO,15,CHAPA DE MOTA,026,DONGU,10,929,487,442,47
MÉXICO,15,CHAPA DE MOTA,026,EJIDO DE BARAJAS (HACIENDA VIEJA),2,57,29,28,4
MÉXICO,15,CHAPA DE MOTA,026,EJIDO DE SAN FELIPE COAMANGO,4,699,378,321,45
MÉXICO,15,CHAPA DE MOTA,026,EL CHABACANO,2,25,11,14,3
MÉXICO,15,CHAPA DE MOTA,026,EL QUINTE,3,520,252,268,18
MÉXICO,15,CHAPA DE MOTA,026,EL SALTO,3,24,11,13,3
MÉXICO,15,CHAPA DE MOTA,026,LA CONCEPCIÓN,2,40,21,19,4
MÉXICO,15,CHAPA DE MOTA,026,LA ESPERANZA,2,142,77,65,7
MÉXICO,15,CHAPA DE MOTA,026,LA LADERA,3,241,113,128,11
MÉXICO,15,CHAPA DE MOTA,026,LA LOMA,2,13,5,8,2
MÉXICO,15,CHAPA DE MOTA,026,LA PALMA,2,57,21,36,3
MÉXICO,15,CHAPA DE MOTA,026,LA SOLEDAD (EL MOGOTE),2,29,13,16,2
MÉXICO,15,CHAPA DE MOTA,026,LAS ÁNIMAS,3,43,18,25,5
MÉXICO,15,CHAPA DE MOTA,026,LOS LIMONES,1,5,4,1,1
MÉXICO,15,CHAPA DE MOTA,026,MACAVACA (SANTA ANA MACAVACA),4,379,197,182,23
MÉXICO,15,CHAPA DE MOTA,026,MEFI,3,509,274,235,24
MÉXICO,15,CHAPA DE MOTA,026,SAN FELIPE COAMANGO,8,1305,640,665,73
MÉXICO,15,CHAPA DE MOTA,026,SAN FRANCISCO DE LAS TABLAS,6,198,89,109,15
MÉXICO,15,CHAPA DE MOTA,026,SAN GABRIEL,2,292,154,138,14
MÉXICO,15,CHAPA DE MOTA,026,SAN JOSÉ AMPABI,3,49,23,26,4
MÉXICO,15,CHAPA DE MOTA,026,SAN JUAN TUXTEPEC,10,995,499,496,52
MÉXICO,15,CHAPA DE MOTA,026,SANTA ELENA,2,107,39,68,6
MÉXICO,15,CHAPA DE MOTA,026,SANTA MARÍA,5,483,234,249,24
MÉXICO,15,CHAPA DE MOTA,026,TENJAY,3,192,93,99,14
MÉXICO,15,CHAPA DE MOTA,026,VENTEY,3,43,21,22,4
MÉXICO,15,CHAPA DE MOTA,026,XHOÑE,4,114,54,60,8
MÉXICO,15,CHAPA DE MOTA,026,XHOTE,2,49,26,23,4
MÉXICO,15,CHAPULTEPEC,027,CHAPULTEPEC,8,2616,1318,1298,215
MÉXICO,15,CHAPULTEPEC,027,UNIDAD HABITACIONAL SANTA TERESA,1,106,51,55,6
MÉXICO,15,CHIAUTLA,028,ATENGUILLO,2,222,105,117,9
MÉXICO,15,CHIAUTLA,028,CHIAUTLA,32,8381,4409,3972,523
MÉXICO,15,CHIAUTLA,028,LA CONCEPCIÓN,2,407,217,190,15
MÉXICO,15,CHIAUTLA,028,OCOPULCO,5,598,303,295,26
MÉXICO,15,CHIAUTLA,028,SAN LUCAS HUITZILHUACÁN,2,207,100,107,8
MÉXICO,15,CHIAUTLA,028,SANTIAGO CHIMALPA (CHIMALPA),3,475,240,235,19
MÉXICO,15,CHIAUTLA,028,TEPETITLÁN,5,632,268,364,52
MÉXICO,15,CHIAUTLA,028,TLALTECAHUACÁN,2,230,108,122,10
MÉXICO,15,CHICOLOAPAN,029,CHICOLOAPAN DE JUÁREZ,163,44949,22711,22238,2456
MÉXICO,15,CHICOLOAPAN,029,EJIDO LA COPALERA,3,620,339,281,26
MÉXICO,15,CHICOLOAPAN,029,LOMA DE GUADALUPE,1,552,240,312,20
MÉXICO,15,CHICONCUAC,030,CHICONCUAC DE JUÁREZ,21,5242,2615,2627,256
MÉXICO,15,CHIMALHUACÁN,031,CHIMALHUACÁN,630,154761,78274,76487,7367
MÉXICO,15,CHIMALHUACÁN,031,COLONIA DIECISIETE DE MARZO,5,698,342,356,28
MÉXICO,15,CHIMALHUACÁN,031,XOCHIACA PARTE ALTA,4,479,223,256,18
MÉXICO,15,CHIMALHUACÁN,031,ZAPOTLA,5,812,411,401,27
MÉXICO,15,DONATO GUERRA,032,BARRIO DE ARRIBA DE SAN JUAN XOCONUSCO,4,104,62,42,12
MÉXICO,15,DONATO GUERRA,032,BATÁN CHICO,3,117,67,50,9
MÉXICO,15,DONATO GUERRA,032,BATÁN GRANDE,2,45,22,23,3
MÉXICO,15,DONATO GUERRA,032,CABECERA DE INDÍGENAS PRIMER CUARTEL,5,131,66,65,6
MÉXICO,15,DONATO GUERRA,032,CABECERA DE INDÍGENAS SEGUNDO CUARTEL,4,439,218,221,17
MÉXICO,15,DONATO GUERRA,032,EJIDO DE SAN LUCAS TEXCALTITLÁN (SABANILLAS),1,17,12,5,2
MÉXICO,15,DONATO GUERRA,032,EL CAPULÍN,2,47,23,24,3
MÉXICO,15,DONATO GUERRA,032,EL ZAPOTE,3,47,25,22,4
MÉXICO,15,DONATO GUERRA,032,LA FUNDICIÓN,3,32,16,16,4
MÉXICO,15,DONATO GUERRA,032,LLANO REDONDO DE ZARAGOZA (LLANO REDONDO),2,28,14,14,2
MÉXICO,15,DONATO GUERRA,032,MACHEROS,4,145,69,76,9
MÉXICO,15,DONATO GUERRA,032,MESAS ALTAS DE XOCONUSCO,4,186,95,91,14
MÉXICO,15,DONATO GUERRA,032,RANCHERÍA DE SAN MARTÍN OBISPO,6,767,375,392,41
MÉXICO,15,DONATO GUERRA,032,SAN AGUSTÍN DE LAS PALMAS (SAN AGUSTÍN),6,858,437,421,30
MÉXICO,15,DONATO GUERRA,032,SAN ANTONIO DE LA LAGUNA,5,442,221,221,23
MÉXICO,15,DONATO GUERRA,032,SAN ANTONIO HIDALGO (RANCHERÍA DE SAN ANTONIO),2,129,69,60,7
MÉXICO,15,DONATO GUERRA,032,SAN FRANCISCO MIHUALTEPEC,4,706,357,349,40
MÉXICO,15,DONATO GUERRA,032,SAN JOSÉ TILOSTOC,3,60,23,37,5
MÉXICO,15,DONATO GUERRA,032,SAN JUAN XOCONUSCO,7,856,424,432,41
MÉXICO,15,DONATO GUERRA,032,SAN LUCAS TEXCALTITLÁN,4,536,265,271,26
MÉXICO,15,DONATO GUERRA,032,SAN MARTÍN OBISPO (SAN MARTÍN SAN PEDRO),2,287,134,153,14
MÉXICO,15,DONATO GUERRA,032,SAN MIGUEL XOOLTEPEC,6,507,229,278,21
MÉXICO,15,DONATO GUERRA,032,SAN SIMÓN DE LA LAGUNA,8,1207,609,598,56
MÉXICO,15,DONATO GUERRA,032,SANTIAGO HUITLAPALTEPEC,9,528,251,277,30
MÉXICO,15,DONATO GUERRA,032,VÍCUAROS,1,32,21,11,1
MÉXICO,15,DONATO GUERRA,032,VILLA DONATO GUERRA,12,1669,823,846,100
MÉXICO,15,ECATEPEC DE MORELOS,033,ECATEPEC DE MORELOS,1478,330564,166704,163860,19182
MÉXICO,15,ECATEPEC DE MORELOS,033,TIERRA BLANCA SEGUNDA SECCIÓN (EJIDO ECATEPEC),3,95,48,47,11
MÉXICO,15,ECATEPEC DE MORELOS,033,VISTA HERMOSA,7,1237,606,631,57
MÉXICO,15,ECATZINGO,034,ECATZINGO DE HIDALGO,11,2168,1066,1102,84
MÉXICO,15,ECATZINGO,034,SAN JUAN TLACOTOMPA (TLACOTOMPA),4,368,177,191,15
MÉXICO,15,ECATZINGO,034,SAN MARCOS TECOMAXUSCO,4,264,121,143,14
MÉXICO,15,HUEHUETOCA,035,BARRANCA PRIETA,2,202,108,94,8
MÉXICO,15,HUEHUETOCA,035,CASA NUEVA,2,275,136,139,11
MÉXICO,15,HUEHUETOCA,035,CITARA,2,741,391,350,29
MÉXICO,15,HUEHUETOCA,035,EL DORADO HUEHUETOCA,9,1600,795,805,65
MÉXICO,15,HUEHUETOCA,035,EL SITIO (EJIDO DE JALPA),1,100,44,56,18
MÉXICO,15,HUEHUETOCA,035,EX-HACIENDA DE XALPA,7,1715,846,869,83
MÉXICO,15,HUEHUETOCA,035,GALAXIA HUEHUETOCA,1,79,36,43,1
MÉXICO,15,HUEHUETOCA,035,HUEHUETOCA,64,18384,9193,9191,1075
MÉXICO,15,HUEHUETOCA,035,JOROBAS,5,1494,778,716,77
MÉXICO,15,HUEHUETOCA,035,LA CAÑADA,3,368,186,182,14
MÉXICO,15,HUEHUETOCA,035,SALITRILLO,9,3299,1745,1554,147
MÉXICO,15,HUEHUETOCA,035,SAN BARTOLO,10,2142,1053,1089,91
MÉXICO,15,HUEHUETOCA,035,SAN MIGUEL DE LOS JAGÜEYES,18,3380,1660,1720,150
MÉXICO,15,HUEHUETOCA,035,SAN PEDRO XALPA,3,560,272,288,26
MÉXICO,15,HUEHUETOCA,035,SANTA MARÍA,5,2077,1116,961,88
MÉXICO,15,HUEHUETOCA,035,SANTA TERESA,21,5127,2517,2610,240
MÉXICO,15,HUEHUETOCA,035,URBI VILLA DEL REY,2,913,466,447,12
MÉXICO,15,HUEYPOXTLA,036,CASA BLANCA (EX-HACIENDA CASA BLANCA),3,101,49,52,7
MÉXICO,15,HUEYPOXTLA,036,COLONIA EL CAPULÍN,1,195,87,108,6
MÉXICO,15,HUEYPOXTLA,036,EL CARMEN,4,771,364,407,27
MÉXICO,15,HUEYPOXTLA,036,EMILIANO ZAPATA (SAN JOSÉ BATA),4,474,239,235,26
MÉXICO,15,HUEYPOXTLA,036,HUEYPOXTLA,10,2392,1232,1160,160
MÉXICO,15,HUEYPOXTLA,036,JILOTZINGO,8,1705,874,831,70
MÉXICO,15,HUEYPOXTLA,036,NOPALA (GUADALUPE NOPALA),6,442,218,224,24
MÉXICO,15,HUEYPOXTLA,036,SAN FRANCISCO ZACACALCO,9,1951,954,997,109
MÉXICO,15,HUEYPOXTLA,036,SAN PEDRO LA GLORIA,4,178,84,94,14
MÉXICO,15,HUEYPOXTLA,036,SANTA MARÍA AJOLOAPAN,13,2295,1178,1117,95
MÉXICO,15,HUEYPOXTLA,036,TEZONTLALPA DE ZAPATA (TEZONTLALPAN),4,344,166,178,17
MÉXICO,15,HUEYPOXTLA,036,TIANGUISTONGO,4,598,297,301,24
MÉXICO,15,HUIXQUILUCAN,037,AGUA BENDITA,3,95,43,52,9
MÉXICO,15,HUIXQUILUCAN,037,AGUA BLANCA,2,150,68,82,7
MÉXICO,15,HUIXQUILUCAN,037,BARRIO DE SAN RAMÓN,5,579,283,296,31
MÉXICO,15,HUIXQUILUCAN,037,DOS RÍOS,5,1532,770,762,56
MÉXICO,15,HUIXQUILUCAN,037,EL CERRITO,2,150,71,79,7
MÉXICO,15,HUIXQUILUCAN,037,EL GUARDA (PUERTO EL GUARDA),3,325,168,157,16
MÉXICO,15,HUIXQUILUCAN,037,EL HIELO,2,59,25,34,5
MÉXICO,15,HUIXQUILUCAN,037,EL LAUREL,1,187,79,108,6
MÉXICO,15,HUIXQUILUCAN,037,EL PALACIO,2,671,338,333,23
MÉXICO,15,HUIXQUILUCAN,037,HUILOTEAPAN (SAN JOSÉ HUILOTEAPAN),1,116,64,52,6
MÉXICO,15,HUIXQUILUCAN,037,HUIXQUILUCAN DE DEGOLLADO,118,26723,14145,12578,3295
MÉXICO,15,HUIXQUILUCAN,037,IGNACIO ALLENDE,4,345,163,182,17
MÉXICO,15,HUIXQUILUCAN,037,JESÚS DEL MONTE,17,3514,1764,1750,225
MÉXICO,15,HUIXQUILUCAN,037,LA CAÑADA,2,175,84,91,8
MÉXICO,15,HUIXQUILUCAN,037,LA GLORIETA,1,146,76,70,6
MÉXICO,15,HUIXQUILUCAN,037,LLANO GRANDE (SAN MIGUEL LLANO GRANDE),2,327,147,180,15
MÉXICO,15,HUIXQUILUCAN,037,MAGDALENA CHICHICASPA,20,7544,3592,3952,282
MÉXICO,15,HUIXQUILUCAN,037,NAUCALPAN DE JUÁREZ,35,6817,3309,3508,311
MÉXICO,15,HUIXQUILUCAN,037,PARAJE EL MIRADOR,1,114,47,67,6
MÉXICO,15,HUIXQUILUCAN,037,PARAJE LA PERA,2,129,66,63,4
MÉXICO,15,HUIXQUILUCAN,037,PIEDRA GRANDE,3,229,109,120,11
MÉXICO,15,HUIXQUILUCAN,037,PIEDRA LARGA,3,113,55,58,8
MÉXICO,15,HUIXQUILUCAN,037,SAN BARTOLOMÉ COATEPEC,13,1711,876,835,87
MÉXICO,15,HUIXQUILUCAN,037,SAN CRISTÓBAL TEXCALUCAN,8,1511,754,757,64
MÉXICO,15,HUIXQUILUCAN,037,SAN FRANCISCO AYOTUZCO,5,792,381,411,31
MÉXICO,15,HUIXQUILUCAN,037,SAN JACINTO,2,406,197,209,18
MÉXICO,15,HUIXQUILUCAN,037,SAN JUAN YAUTEPEC,3,366,190,176,16
MÉXICO,15,HUIXQUILUCAN,037,SANTA CRUZ AYOTUZCO,7,1713,867,846,104
MÉXICO,15,HUIXQUILUCAN,037,SANTIAGO YANCUITLALPAN,7,1583,798,785,72
MÉXICO,15,HUIXQUILUCAN,037,ZACAMULPA,7,1295,628,667,57
MÉXICO,15,ISIDRO FABELA,038,CAIXTE,1,11,5,6,1
MÉXICO,15,ISIDRO FABELA,038,CAÑADA DE ONOFRES,4,369,174,195,14
MÉXICO,15,ISIDRO FABELA,038,COLONIA LAURELES,1,14,8,6,3
MÉXICO,15,ISIDRO FABELA,038,COLONIA MIRAFLORES,2,358,172,186,13
MÉXICO,15,ISIDRO FABELA,038,EJIDO MIRAFLORES,3,542,277,265,53
MÉXICO,15,ISIDRO FABELA,038,RANCHERÍA PALOMAS (LOS TACHOS),2,26,13,13,2
MÉXICO,15,ISIDRO FABELA,038,TLAZALA DE FABELA,9,1968,1075,893,140
MÉXICO,15,IXTAPALUCA,039,AMPLIACIÓN SAN FRANCISCO,3,709,340,369,25
MÉXICO,15,IXTAPALUCA,039,COATEPEC,12,2103,1037,1066,101
MÉXICO,15,IXTAPALUCA,039,COLONIA JULIO CHÁVEZ LÓPEZ (UPREZ),2,415,190,225,17
MÉXICO,15,IXTAPALUCA,039,EJIDO EL CAPULÍN,1,57,33,24,3
MÉXICO,15,IXTAPALUCA,039,EL PATRONATO DEL MAGUEY (SANTA ROSA),1,9,3,6,5
MÉXICO,15,IXTAPALUCA,039,IXTAPALUCA,377,91773,46927,44846,5301
MÉXICO,15,IXTAPALUCA,039,JORGE JIMÉNEZ CANTÚ,7,1299,657,642,64
MÉXICO,15,IXTAPALUCA,039,LA CAÑADA,2,337,166,171,14
MÉXICO,15,IXTAPALUCA,039,LA GUADALUPANA,1,39,20,19,4
MÉXICO,15,IXTAPALUCA,039,LLANO GRANDE,1,23,11,12,2
MÉXICO,15,IXTAPALUCA,039,LOS HORNOS,3,76,32,44,8
MÉXICO,15,IXTAPALUCA,039,MANUEL ÁVILA CAMACHO,5,653,326,327,30
MÉXICO,15,IXTAPALUCA,039,PUEBLO NUEVO (SAN ISIDRO LABRADOR),2,210,103,107,8
MÉXICO,15,IXTAPALUCA,039,RANCHO LOMA ANCHA,2,18,5,13,2
MÉXICO,15,IXTAPALUCA,039,RANCHO VERDE,2,353,179,174,12
MÉXICO,15,IXTAPALUCA,039,RÍO FRÍO DE JUÁREZ,6,1481,747,734,67
MÉXICO,15,IXTAPALUCA,039,SAN BUENAVENTURA,20,3868,1951,1917,179
MÉXICO,15,IXTAPALUCA,039,SAN FRANCISCO ACUAUTLA,28,6678,3297,3381,262
MÉXICO,15,IXTAPALUCA,039,SAN JERÓNIMO CUATRO VIENTOS,23,4672,2281,2391,208
MÉXICO,15,IXTAPALUCA,039,TETITLA,1,26,12,14,3
MÉXICO,15,IXTAPALUCA,039,ZOQUIAPAN,13,2507,1426,1081,138
MÉXICO,15,IXTAPAN DE LA SAL,040,AHUACATITLÁN,8,459,245,214,73
MÉXICO,15,IXTAPAN DE LA SAL,040,COAXUSCO,2,75,37,38,4
MÉXICO,15,IXTAPAN DE LA SAL,040,COLONIA 3 DE MAYO,2,118,60,58,8
MÉXICO,15,IXTAPAN DE LA SAL,040,EL ABROJO,2,89,37,52,4
MÉXICO,15,IXTAPAN DE LA SAL,040,EL ARENAL DE LAS OLLAS,2,34,17,17,3
MÉXICO,15,IXTAPAN DE LA SAL,040,EL REFUGIO,2,71,30,41,4
MÉXICO,15,IXTAPAN DE LA SAL,040,EL RINCÓN DE DIOS YERBAS BUENAS,1,19,10,9,2
MÉXICO,15,IXTAPAN DE LA SAL,040,EL SALITRE,5,1247,677,570,103
MÉXICO,15,IXTAPAN DE LA SAL,040,IXTAPAN DE LA SAL,43,5565,2950,2615,456
MÉXICO,15,IXTAPAN DE LA SAL,040,LLANO DE LA UNIÓN,3,130,67,63,11
MÉXICO,15,IXTAPAN DE LA SAL,040,LLANO DE SAN DIEGO,1,17,8,9,1
MÉXICO,15,IXTAPAN DE LA SAL,040,LOS NARANJOS,2,46,21,25,4
MÉXICO,15,IXTAPAN DE LA SAL,040,MALINALTENANGO,5,186,96,90,14
MÉXICO,15,IXTAPAN DE LA SAL,040,MESÓN NUEVO,3,291,145,146,14
MÉXICO,15,IXTAPAN DE LA SAL,040,PLAN DE SAN MIGUEL,2,66,28,38,4
MÉXICO,15,IXTAPAN DE LA SAL,040,PORTEZUELOS,3,20,12,8,3
MÉXICO,15,IXTAPAN DE LA SAL,040,PUERTA GRANDE,2,62,26,36,4
MÉXICO,15,IXTAPAN DE LA SAL,040,SAN ALEJO,3,580,290,290,26
MÉXICO,15,IXTAPAN DE LA SAL,040,SAN DIEGO ALCALÁ,2,39,16,23,5
MÉXICO,15,IXTAPAN DE LA SAL,040,SAN JOSÉ DEL ARENAL,6,204,96,108,14
MÉXICO,15,IXTAPAN DE LA SAL,040,SAN MIGUEL LADERAS,4,248,143,105,12
MÉXICO,15,IXTAPAN DE LA SAL,040,SAN PABLO,3,21,13,8,3
MÉXICO,15,IXTAPAN DE LA SAL,040,SAN PEDRO TLACOCHACA,2,14,11,3,3
MÉXICO,15,IXTAPAN DE LA SAL,040,SANTA ANA XOCHUCA,2,63,25,38,3
MÉXICO,15,IXTAPAN DE LA SAL,040,TECOMATEPEC,3,387,189,198,26
MÉXICO,15,IXTAPAN DE LA SAL,040,TLACOCHACA,3,68,31,37,5
MÉXICO,15,IXTAPAN DE LA SAL,040,YAUTEPEC,3,55,28,27,5
MÉXICO,15,IXTAPAN DE LA SAL,040,YERBAS BUENAS,4,140,69,71,11
MÉXICO,15,IXTAPAN DEL ORO,041,AYALITA,2,40,23,17,3
MÉXICO,15,IXTAPAN DEL ORO,041,EJIDO DE MIAHUATLÁN,2,12,6,6,2
MÉXICO,15,IXTAPAN DEL ORO,041,EL CHILAR,3,60,26,34,5
MÉXICO,15,IXTAPAN DEL ORO,041,EL TEPERREAL,2,45,20,25,3
MÉXICO,15,IXTAPAN DEL ORO,041,IXTAPAN DEL ORO,4,445,225,220,23
MÉXICO,15,IXTAPAN DEL ORO,041,LA CALERA DE LOS GALLOS,3,156,82,74,9
MÉXICO,15,IXTAPAN DEL ORO,041,LA MESA DE SAN MARTÍN,2,48,25,23,3
MÉXICO,15,IXTAPAN DEL ORO,041,LA PUERTA,3,12,7,5,3
MÉXICO,15,IXTAPAN DEL ORO,041,MIAHUATLÁN DE HIDALGO (SANTA CRUZ MIAHUATLÁN),5,600,290,310,26
MÉXICO,15,IXTAPAN DEL ORO,041,MILPILLAS,2,28,17,11,4
MÉXICO,15,IXTAPAN DEL ORO,041,PEÑA COLORADA,3,34,16,18,4
MÉXICO,15,IXTAPAN DEL ORO,041,SAN MARTÍN OCOXOCHITEPEC (SAN MARTÍN),2,47,30,17,3
MÉXICO,15,IXTAPAN DEL ORO,041,SAN MIGUEL IXTAPAN,2,35,16,19,3
MÉXICO,15,IXTAPAN DEL ORO,041,SAN TELMO,2,5,1,4,2
MÉXICO,15,IXTAPAN DEL ORO,041,SANTA CRUZ VIEJO,2,24,13,11,2
MÉXICO,15,IXTAPAN DEL ORO,041,TUTUAPAN,3,175,90,85,11
MÉXICO,15,IXTLAHUACA,042,ATOTONILCO,2,168,86,82,8
MÉXICO,15,IXTLAHUACA,042,BARRIO DE SAN PEDRO,8,8828,5120,3708,451
MÉXICO,15,IXTLAHUACA,042,COLONIA CUAUHTÉMOC,2,71,36,35,4
MÉXICO,15,IXTLAHUACA,042,COLONIA FRANCISCO I. MADERO,1,36,20,16,3
MÉXICO,15,IXTLAHUACA,042,DOLORES ENYEGE,4,191,89,102,10
MÉXICO,15,IXTLAHUACA,042,EJIDO DE LA CONCEPCIÓN DE LOS BAÑOS,2,71,43,28,4
MÉXICO,15,IXTLAHUACA,042,EJIDO DE LA CONCEPCIÓN DE LOS BAÑOS PRIMERO,1,103,53,50,5
MÉXICO,15,IXTLAHUACA,042,EL RINCÓN DE LOS PERALES,3,115,62,53,7
MÉXICO,15,IXTLAHUACA,042,EMILIANO ZAPATA (SANTO DOMINGO),10,1723,887,836,96
MÉXICO,15,IXTLAHUACA,042,GUADALUPE CACHI,6,878,452,426,42
MÉXICO,15,IXTLAHUACA,042,GUADALUPE DEL RÍO,2,130,65,65,9
MÉXICO,15,IXTLAHUACA,042,HUEREJE,5,432,216,216,23
MÉXICO,15,IXTLAHUACA,042,IXTLAHUACA DE RAYÓN,29,6190,3212,2978,333
MÉXICO,15,IXTLAHUACA,042,JALPA DE DOLORES,2,60,33,27,5
MÉXICO,15,IXTLAHUACA,042,JALPA DE LOS BAÑOS,4,688,333,355,32
MÉXICO,15,IXTLAHUACA,042,LA CONCEPCIÓN DE LOS BAÑOS,13,2784,1374,1410,195
MÉXICO,15,IXTLAHUACA,042,LA CONCEPCIÓN ENYEGE,7,752,358,394,52
MÉXICO,15,IXTLAHUACA,042,LA GUADALUPANA (EL SAUCO),7,292,146,146,18
MÉXICO,15,IXTLAHUACA,042,LA PURÍSIMA,4,714,354,360,54
MÉXICO,15,IXTLAHUACA,042,SAN ANDRÉS DEL PEDREGAL,4,302,141,161,16
MÉXICO,15,IXTLAHUACA,042,SAN ANTONIO BONIXI,7,700,326,374,34
MÉXICO,15,IXTLAHUACA,042,SAN ANTONIO DE LOS REMEDIOS,5,159,88,71,9
MÉXICO,15,IXTLAHUACA,042,SAN BARTOLO DEL LLANO,13,3144,1675,1469,170
MÉXICO,15,IXTLAHUACA,042,SAN CRISTÓBAL DE LOS BAÑOS,11,1910,968,942,77
MÉXICO,15,IXTLAHUACA,042,SAN FRANCISCO DE GUZMÁN,3,323,171,152,14
MÉXICO,15,IXTLAHUACA,042,SAN FRANCISCO DEL RÍO,3,303,148,155,13
MÉXICO,15,IXTLAHUACA,042,SAN FRANCISCO IXTLAHUACA,3,147,72,75,7
MÉXICO,15,IXTLAHUACA,042,SAN IGNACIO DEL PEDREGAL,4,288,135,153,21
MÉXICO,15,IXTLAHUACA,042,SAN ILDEFONSO,2,300,140,160,17
MÉXICO,15,IXTLAHUACA,042,SAN ISIDRO BOXIPE,5,712,347,365,35
MÉXICO,15,IXTLAHUACA,042,SAN JERÓNIMO IXTAPANTONGO,6,754,390,364,39
MÉXICO,15,IXTLAHUACA,042,SAN JOAQUÍN EL JUNCO,4,1198,636,562,71
MÉXICO,15,IXTLAHUACA,042,SAN JOAQUÍN LA CABECERA,5,791,400,391,43
MÉXICO,15,IXTLAHUACA,042,SAN JOSÉ DEL RÍO,2,117,54,63,9
MÉXICO,15,IXTLAHUACA,042,SAN JUAN DE LAS MANZANAS,6,1023,526,497,48
MÉXICO,15,IXTLAHUACA,042,SAN LORENZO TOXICO,13,2133,1077,1056,104
MÉXICO,15,IXTLAHUACA,042,SAN MATEO IXTLAHUACA,7,627,287,340,50
MÉXICO,15,IXTLAHUACA,042,SAN MIGUEL EL ALTO (RANCHOS VIEJOS),3,40,17,23,6
MÉXICO,15,IXTLAHUACA,042,SAN MIGUEL ENYEGE,6,662,338,324,46
MÉXICO,15,IXTLAHUACA,042,SAN PABLO DE LOS REMEDIOS,4,306,164,142,21
MÉXICO,15,IXTLAHUACA,042,SAN PEDRO DE LOS BAÑOS,13,2688,1335,1353,143
MÉXICO,15,IXTLAHUACA,042,SAN PEDRO LA CABECERA,7,2574,1645,929,305
MÉXICO,15,IXTLAHUACA,042,SANTA ANA IXTLAHUACA (SANTA ANA IXTLAHUACINGO),8,1999,1066,933,135
MÉXICO,15,IXTLAHUACA,042,SANTA ANA LA LADERA,9,698,326,372,38
MÉXICO,15,IXTLAHUACA,042,SANTA MARÍA DEL LLANO,6,1050,520,530,47
MÉXICO,15,IXTLAHUACA,042,SANTO DOMINGO DE GUZMÁN,8,2492,1483,1009,161
MÉXICO,15,IXTLAHUACA,042,SHIRA,1,11,6,5,2
MÉXICO,15,IXTLAHUACA,042,TROJES,2,157,82,75,8
MÉXICO,15,XALATLACO,043,ÁGUILA (LA MESA),3,651,323,328,25
MÉXICO,15,XALATLACO,043,BARRIO SAN AGUSTÍN,2,564,295,269,22
MÉXICO,15,XALATLACO,043,COEXAPA,2,138,67,71,8
MÉXICO,15,XALATLACO,043,CRUZ LARGA,2,109,47,62,6
MÉXICO,15,XALATLACO,043,EL CAPULÍN,4,84,40,44,9
MÉXICO,15,XALATLACO,043,EL YETE,3,25,10,15,3
MÉXICO,15,XALATLACO,043,ESCALERILLAS (BARRIO SAN FRANCISCO),1,101,50,51,7
MÉXICO,15,XALATLACO,043,MEZAPA LA FÁBRICA,1,25,12,13,2
MÉXICO,15,XALATLACO,043,MORELOS,2,250,124,126,9
MÉXICO,15,XALATLACO,043,POTRERO,2,97,48,49,4
MÉXICO,15,XALATLACO,043,SAN JUAN TOMASQUILLO,4,449,223,226,18
MÉXICO,15,XALATLACO,043,SANTA FE MEZAPA,2,213,101,112,8
MÉXICO,15,XALATLACO,043,TEJOCOTES,2,76,44,32,6
MÉXICO,15,XALATLACO,043,XALATLACO,17,5495,3019,2476,404
MÉXICO,15,JALTENCO,044,ALBORADA JALTENCO,15,3424,1642,1782,136
MÉXICO,15,JALTENCO,044,JALTENCO,13,3300,1727,1573,233
MÉXICO,15,JILOTEPEC,045,AGUA ESCONDIDA,5,479,240,239,30
MÉXICO,15,JILOTEPEC,045,ALDAMA,7,388,195,193,21
MÉXICO,15,JILOTEPEC,045,BOSQUE DE CANALEJAS (MANZANA SEXTA CANALEJAS),1,11,8,3,1
MÉXICO,15,JILOTEPEC,045,BUENAVISTA,3,438,225,213,20
MÉXICO,15,JILOTEPEC,045,CALPULALPAN (PRIMERA MANZANA CENTRO),5,750,366,384,46
MÉXICO,15,JILOTEPEC,045,CANALEJAS,11,2195,1071,1124,173
MÉXICO,15,JILOTEPEC,045,COSCOMATE DEL PROGRESO,10,585,266,319,32
MÉXICO,15,JILOTEPEC,045,DANXHO,5,299,149,150,19
MÉXICO,15,JILOTEPEC,045,DEDENI DOLORES,2,50,22,28,3
MÉXICO,15,JILOTEPEC,045,DENJHI,2,75,36,39,7
MÉXICO,15,JILOTEPEC,045,DEXCANI ALTO,2,27,9,18,4
MÉXICO,15,JILOTEPEC,045,DEXCANI BAJO,2,78,41,37,6
MÉXICO,15,JILOTEPEC,045,DOXHICHO,5,272,121,151,16
MÉXICO,15,JILOTEPEC,045,EJIDO DE COSCOMATE DEL PROGRESO,3,808,340,468,79
MÉXICO,15,JILOTEPEC,045,EJIDO DE JILOTEPEC,5,4211,2295,1916,164
MÉXICO,15,JILOTEPEC,045,EJIDO DE LAS MANZANAS,2,13,6,7,2
MÉXICO,15,JILOTEPEC,045,EJIDO DE SAN LORENZO OCTEYUCO,4,426,202,224,25
MÉXICO,15,JILOTEPEC,045,EL BARRETE,1,11,7,4,1
MÉXICO,15,JILOTEPEC,045,EL DURAZNO DE CUAUHTÉMOC,4,139,63,76,9
MÉXICO,15,JILOTEPEC,045,EL FRESNO,1,44,24,20,2
MÉXICO,15,JILOTEPEC,045,EL HUISACHE (TERCERA MANZANA DE DEXCANI ALTO),2,63,28,35,4
MÉXICO,15,JILOTEPEC,045,EL MAGUEYAL,2,27,11,16,2
MÉXICO,15,JILOTEPEC,045,EL RINCÓN,7,184,92,92,16
MÉXICO,15,JILOTEPEC,045,EL ROSAL,7,306,140,166,18
MÉXICO,15,JILOTEPEC,045,EL SALTILLITO (CALPULALPAN CUARTA MANZANA),2,110,49,61,7
MÉXICO,15,JILOTEPEC,045,EL SALTILLO,3,296,161,135,14
MÉXICO,15,JILOTEPEC,045,EL XHITEY,3,216,103,113,10
MÉXICO,15,JILOTEPEC,045,EMILIANO ZAPATA,1,22,9,13,1
MÉXICO,15,JILOTEPEC,045,JILOTEPEC DE MOLINA ENRÍQUEZ,43,8065,4327,3738,589
MÉXICO,15,JILOTEPEC,045,LA COMUNIDAD,9,795,393,402,47
MÉXICO,15,JILOTEPEC,045,LA HUARACHA,1,14,5,9,1
MÉXICO,15,JILOTEPEC,045,LA MAQUEDA (EJIDO DE SAN LORENZO NENAMICOYAN),2,63,32,31,4
MÉXICO,15,JILOTEPEC,045,LAS HUERTAS,5,1013,515,498,39
MÉXICO,15,JILOTEPEC,045,LAS JARAS (CALPULALPAN SEGUNDA MANZANA),1,10,3,7,1
MÉXICO,15,JILOTEPEC,045,LAS MANZANAS,3,292,128,164,13
MÉXICO,15,JILOTEPEC,045,LLANO GRANDE,2,35,11,24,4
MÉXICO,15,JILOTEPEC,045,MAGUEYCITOS,1,42,20,22,3
MÉXICO,15,JILOTEPEC,045,MATAXHI,2,22,7,15,2
MÉXICO,15,JILOTEPEC,045,OCTEYUCO 2000,1,156,65,91,6
MÉXICO,15,JILOTEPEC,045,OJO DE AGUA,4,533,253,280,46
MÉXICO,15,JILOTEPEC,045,SAN IGNACIO DE LOYOLA (SAN IGNACIO),2,23,10,13,3
MÉXICO,15,JILOTEPEC,045,SAN JUAN ACAZUCHITLÁN (SAN JUANICO),8,802,410,392,78
MÉXICO,15,JILOTEPEC,045,SAN LORENZO NENAMICOYAN,5,586,267,319,52
MÉXICO,15,JILOTEPEC,045,SAN LORENZO OCTEYUCO,5,608,302,306,27
MÉXICO,15,JILOTEPEC,045,SAN MARTÍN TUCHICUITLAPILCO,8,427,212,215,23
MÉXICO,15,JILOTEPEC,045,SAN MIGUEL DE LA VICTORIA,11,561,276,285,37
MÉXICO,15,JILOTEPEC,045,SAN PABLO HUANTEPEC,9,728,357,371,40
MÉXICO,15,JILOTEPEC,045,SAN VICENTE (CALPULALPAN TERCERA MANZANA),2,207,108,99,9
MÉXICO,15,JILOTEPEC,045,SANTA MARTHA DE LA CRUZ,1,31,14,17,3
MÉXICO,15,JILOTEPEC,045,SANTIAGO OXTHOC,5,216,104,112,17
MÉXICO,15,JILOTEPEC,045,TECOLAPAN,3,68,35,33,7
MÉXICO,15,JILOTEPEC,045,TEUPAN (PIEDRAS NEGRAS),4,140,67,73,11
MÉXICO,15,JILOTEPEC,045,XHIMÓJAY,6,474,239,235,45
MÉXICO,15,JILOTEPEC,045,XHIXHATA,3,439,208,231,26
MÉXICO,15,JILOTZINGO,046,BARRIO LA CUESTA,1,28,9,19,1
MÉXICO,15,JILOTZINGO,046,ESPÍRITU SANTO,16,919,464,455,73
MÉXICO,15,JILOTZINGO,046,QUISHIGUADA,2,210,115,95,14
MÉXICO,15,JILOTZINGO,046,SAN JOSÉ DE LAS MANZANAS,2,246,120,126,11
MÉXICO,15,JILOTZINGO,046,SAN LUIS AYUCAN,7,1780,921,859,99
MÉXICO,15,JILOTZINGO,046,SAN MIGUEL TECPAN,2,195,90,105,8
MÉXICO,15,JILOTZINGO,046,SANTA ANA JILOTZINGO,6,545,237,308,40
MÉXICO,15,JILOTZINGO,046,SANTA MARÍA MAZATLA,11,1629,826,803,114
MÉXICO,15,JIQUIPILCO,047,BUENOS AIRES,6,669,326,343,35
MÉXICO,15,JIQUIPILCO,047,COLONIA BENITO JUÁREZ SAN FELIPE SANTIAGO,1,79,39,40,6
MÉXICO,15,JIQUIPILCO,047,COLONIA EMILIANO ZAPATA,3,140,88,52,10
MÉXICO,15,JIQUIPILCO,047,COLONIA LA PURÍSIMA,2,168,73,95,9
MÉXICO,15,JIQUIPILCO,047,DOLORES AMARILLAS,3,209,110,99,17
MÉXICO,15,JIQUIPILCO,047,EJIDO DE MAÑI,4,217,112,105,19
MÉXICO,15,JIQUIPILCO,047,EJIDO DE SANTA MARÍA NATIVITAS,1,21,14,7,1
MÉXICO,15,JIQUIPILCO,047,EJIDO LLANO GRANDE (PLANTA PILOTO),4,343,167,176,19
MÉXICO,15,JIQUIPILCO,047,EJIDO LOMA DE MALACOTA (LOMA DE MALACOTA),6,931,462,469,46
MÉXICO,15,JIQUIPILCO,047,EL JARAL (TIERRA MONTÓN),4,234,109,125,12
MÉXICO,15,JIQUIPILCO,047,JIQUIPILCO,8,1449,728,721,66
MÉXICO,15,JIQUIPILCO,047,LA NOPALERA,2,38,18,20,3
MÉXICO,15,JIQUIPILCO,047,LA PASTORA,4,65,31,34,6
MÉXICO,15,JIQUIPILCO,047,LOMA DE ENDOTZI (MANZANA SEXTA),5,1055,531,524,44
MÉXICO,15,JIQUIPILCO,047,LOMA DE HIDALGO,8,707,370,337,34
MÉXICO,15,JIQUIPILCO,047,LOMA DE SAN FELIPE,2,170,87,83,8
MÉXICO,15,JIQUIPILCO,047,LOMA DE SAN PEDRO,2,7,5,2,2
MÉXICO,15,JIQUIPILCO,047,LOMA DEL ASTILLERO,5,834,423,411,87
MÉXICO,15,JIQUIPILCO,047,LOMA DEL MADROÑO,2,120,64,56,8
MÉXICO,15,JIQUIPILCO,047,LOMA HIDALGO MANZANA CUARTA,1,19,11,8,1
MÉXICO,15,JIQUIPILCO,047,LOMA VICENTE GUERRERO,2,69,27,42,4
MÉXICO,15,JIQUIPILCO,047,MANZANA CUARTA,2,51,26,25,3
MÉXICO,15,JIQUIPILCO,047,MANZANA CUARTA DE SANTA CRUZ TEPEXPAN,2,101,55,46,6
MÉXICO,15,JIQUIPILCO,047,MANZANA QUINTA (LA CAÑADA),3,559,267,292,30
MÉXICO,15,JIQUIPILCO,047,MANZANA QUINTA DE SAN BARTOLO OXTOTITLÁN,1,65,34,31,3
MÉXICO,15,JIQUIPILCO,047,MANZANA SEGUNDA,2,178,100,78,8
MÉXICO,15,JIQUIPILCO,047,MANZANA SEXTA PARTE ALTA,1,12,4,8,1
MÉXICO,15,JIQUIPILCO,047,MANZANA SEXTA PARTE CENTRO,2,110,58,52,5
MÉXICO,15,JIQUIPILCO,047,MANZANA TERCERA (BODO),3,187,81,106,12
MÉXICO,15,JIQUIPILCO,047,MANZANA TERCERA DE SANTA CRUZ TEPEXPAN,2,517,262,255,20
MÉXICO,15,JIQUIPILCO,047,MANZANA TERCERA LOMA DE HIDALGO,1,51,28,23,3
MÉXICO,15,JIQUIPILCO,047,MANZANA TERCERA PANTHÉ,3,102,55,47,6
MÉXICO,15,JIQUIPILCO,047,MOXTEJE,4,414,199,215,22
MÉXICO,15,JIQUIPILCO,047,PIE DEL CERRO,3,62,30,32,6
MÉXICO,15,JIQUIPILCO,047,PORTEZUELO,3,207,109,98,13
MÉXICO,15,JIQUIPILCO,047,PRIMERA MANZANA DE SANTA CRUZ TEPEXPAN,12,2478,1279,1199,131
MÉXICO,15,JIQUIPILCO,047,RANCHERÍA DE MAÑI (EX-HACIENDA DE MAÑI),1,17,9,8,1
MÉXICO,15,JIQUIPILCO,047,RANCHERÍA DE SILA (EJIDO DE SILA),4,83,42,41,6
MÉXICO,15,JIQUIPILCO,047,RANCHO ALEGRE,3,192,90,102,11
MÉXICO,15,JIQUIPILCO,047,RANCHO COLORADO,2,71,34,37,5
MÉXICO,15,JIQUIPILCO,047,SAN ANTONIO NIXINI,3,253,136,117,12
MÉXICO,15,JIQUIPILCO,047,SAN BARTOLO OXTOTITLÁN,13,1325,658,667,66
MÉXICO,15,JIQUIPILCO,047,SAN FELIPE Y SANTIAGO,10,1599,846,753,79
MÉXICO,15,JIQUIPILCO,047,SAN FRANCISCO EL ALTO,2,63,33,30,6
MÉXICO,15,JIQUIPILCO,047,SAN FRANCISCO PORTEZUELO,1,13,8,5,1
MÉXICO,15,JIQUIPILCO,047,SAN ISIDRO,2,60,22,38,3
MÉXICO,15,JIQUIPILCO,047,SAN JOSÉ DEL SITIO,6,761,355,406,45
MÉXICO,15,JIQUIPILCO,047,SAN MARTÍN MORELOS,4,189,101,88,13
MÉXICO,15,JIQUIPILCO,047,SAN MIGUEL YUXTEPEC,6,277,136,141,21
MÉXICO,15,JIQUIPILCO,047,SANTA ISABEL,4,962,521,441,62
MÉXICO,15,JIQUIPILCO,047,SANTA MARÍA NATIVITAS,10,752,374,378,42
MÉXICO,15,JIQUIPILCO,047,TIERRA BLANCA,2,453,222,231,16
MÉXICO,15,JOCOTITLÁN,048,15 DE AGOSTO,2,48,22,26,4
MÉXICO,15,JOCOTITLÁN,048,BARRIO DE BOYECHA,4,105,53,52,9
MÉXICO,15,JOCOTITLÁN,048,BARRIO DE LA LUZ,2,194,94,100,10
MÉXICO,15,JOCOTITLÁN,048,BARRIO DE SAN JACINTO,1,11,5,6,1
MÉXICO,15,JOCOTITLÁN,048,BARRIO DE SAN JOAQUÍN,3,1236,589,647,84
MÉXICO,15,JOCOTITLÁN,048,BARRIO DE TULA,2,13,4,9,2
MÉXICO,15,JOCOTITLÁN,048,BARRIO LA SOLEDAD,1,53,27,26,3
MÉXICO,15,JOCOTITLÁN,048,BARRIO LA TENERÍA,1,32,19,13,2
MÉXICO,15,JOCOTITLÁN,048,BARRIO LA VENTA,2,25,13,12,3
MÉXICO,15,JOCOTITLÁN,048,CIUDAD DE JOCOTITLÁN,17,8380,3916,4464,391
MÉXICO,15,JOCOTITLÁN,048,CONCEPCIÓN CARO,5,321,165,156,18
MÉXICO,15,JOCOTITLÁN,048,EL LINDERO,2,141,69,72,7
MÉXICO,15,JOCOTITLÁN,048,EL PROGRESO,2,40,17,23,4
MÉXICO,15,JOCOTITLÁN,048,EL RUSO,3,101,55,46,5
MÉXICO,15,JOCOTITLÁN,048,ENGUINDO SAN ISIDRO,1,15,10,5,1
MÉXICO,15,JOCOTITLÁN,048,HACIENDA PASTEJE,6,781,367,414,56
MÉXICO,15,JOCOTITLÁN,048,HUEMETLA,4,166,79,87,14
MÉXICO,15,JOCOTITLÁN,048,LA LOMA DE ENDARE,2,144,76,68,8
MÉXICO,15,JOCOTITLÁN,048,LA PROVIDENCIA,3,331,149,182,20
MÉXICO,15,JOCOTITLÁN,048,LAS ÁNIMAS VILLEJE,2,86,47,39,7
MÉXICO,15,JOCOTITLÁN,048,LAS FUENTES YECHE,2,62,31,31,4
MÉXICO,15,JOCOTITLÁN,048,LOS JAVIERES,1,7,5,2,1
MÉXICO,15,JOCOTITLÁN,048,LOS REYES,5,601,277,324,39
MÉXICO,15,JOCOTITLÁN,048,MAVORO,6,707,328,379,34
MÉXICO,15,JOCOTITLÁN,048,MEJE,2,90,46,44,5
MÉXICO,15,JOCOTITLÁN,048,OJO DE AGUA,2,103,44,59,7
MÉXICO,15,JOCOTITLÁN,048,SAN FRANCISCO CHEJE,6,719,348,371,43
MÉXICO,15,JOCOTITLÁN,048,SAN JOSÉ BOQUI,2,155,76,79,8
MÉXICO,15,JOCOTITLÁN,048,SAN JUAN COAJOMULCO,8,1201,641,560,66
MÉXICO,15,JOCOTITLÁN,048,SAN MARCOS COAJOMULCO,3,159,82,77,9
MÉXICO,15,JOCOTITLÁN,048,SAN MIGUEL TENOCHTITLÁN,7,1247,625,622,81
MÉXICO,15,JOCOTITLÁN,048,SANTA MARÍA CITENDEJE,7,1387,698,689,74
MÉXICO,15,JOCOTITLÁN,048,SANTA MARÍA ENDARE,3,264,120,144,18
MÉXICO,15,JOCOTITLÁN,048,SANTIAGO CASANDEJE,10,1084,554,530,69
MÉXICO,15,JOCOTITLÁN,048,SANTIAGO YECHE,10,1162,584,578,66
MÉXICO,15,JOCOTITLÁN,048,SIFFARI,3,76,38,38,4
MÉXICO,15,JOCOTITLÁN,048,TIACAQUE,4,184,93,91,13
MÉXICO,15,JOQUICINGO,049,EL GUARDA DE GUERRERO (SAN JOSÉ EL GUARDA),3,345,187,158,22
MÉXICO,15,JOQUICINGO,049,JOQUICINGO DE LEÓN GUZMÁN,6,1177,567,610,89
MÉXICO,15,JOQUICINGO,049,MAXTLECA DE GALEANA,4,325,153,172,17
MÉXICO,15,JOQUICINGO,049,SAN MIGUEL DE OCAMPO,3,235,106,129,13
MÉXICO,15,JOQUICINGO,049,TECHUCHULCO DE ALLENDE,8,1744,926,818,87
MÉXICO,15,JUCHITEPEC,050,JUCHITEPEC DE MARIANO RIVAPALACIO,16,4149,2035,2114,248
MÉXICO,15,JUCHITEPEC,050,SAN MATÍAS CUIJINGO,8,2474,1308,1166,95
MÉXICO,15,LERMA,051,AMOMOLULCO,2,63,33,30,4
MÉXICO,15,LERMA,051,BARRANCA GRANDE,2,123,58,65,6
MÉXICO,15,LERMA,051,CAÑADA DE ALFERES,2,28,13,15,2
MÉXICO,15,LERMA,051,CASA BLANCA (TIERRAS NUEVAS),1,3,0,3,1
MÉXICO,15,LERMA,051,COLONIA 5 DE MAYO,3,378,179,199,16
MÉXICO,15,LERMA,051,COLONIA ADOLFO LÓPEZ MATEOS HUITZIZILAPAN,1,309,143,166,12
MÉXICO,15,LERMA,051,COLONIA AGRÍCOLA ANALCO,2,323,149,174,13
MÉXICO,15,LERMA,051,COLONIA ÁLVARO OBREGÓN TLALMIMILOLPAN,4,1012,517,495,39
MÉXICO,15,LERMA,051,COLONIA EMILIANO ZAPATA,1,593,291,302,18
MÉXICO,15,LERMA,051,COLONIA FRANCISCO I. MADERO,2,147,73,74,8
MÉXICO,15,LERMA,051,COLONIA GUADALUPE VICTORIA HUITZIZILAPAN,4,879,457,422,52
MÉXICO,15,LERMA,051,COLONIA LOS CEDROS,1,106,58,48,5
MÉXICO,15,LERMA,051,COLONIA N'DEXI HUITZIZILAPAN,3,27,11,16,3
MÉXICO,15,LERMA,051,CRISTO REY,1,22,12,10,2
MÉXICO,15,LERMA,051,DOLORES (RANCHERÍA DOLORES),1,43,18,25,3
MÉXICO,15,LERMA,051,EL ESPINO,2,345,176,169,14
MÉXICO,15,LERMA,051,EL ESPINO PERALTA,2,93,45,48,5
MÉXICO,15,LERMA,051,FLOR DE GALLO HUITZIZILAPAN,2,61,32,29,4
MÉXICO,15,LERMA,051,LA CONCEPCIÓN XOCHICUAUTLA,5,476,232,244,21
MÉXICO,15,LERMA,051,LA LUPITA (CASAS VIEJAS),2,10,4,6,2
MÉXICO,15,LERMA,051,LA PEDRERA,1,82,44,38,15
MÉXICO,15,LERMA,051,LA REFORMA TLALMIMILOLPAN,2,252,119,133,12
MÉXICO,15,LERMA,051,LAS MESAS HUITZIZILAPAN,2,83,42,41,4
MÉXICO,15,LERMA,051,LERMA DE VILLADA,64,16796,8411,8385,1065
MÉXICO,15,LERMA,051,METATE VIEJO TLALMIMILOLPAN,2,198,104,94,10
MÉXICO,15,LERMA,051,NUEVA AMEYALCO,1,521,262,259,13
MÉXICO,15,LERMA,051,PUEBLO NUEVO TLALMIMILOLPAN,4,586,264,322,22
MÉXICO,15,LERMA,051,SALAZAR,3,258,134,124,12
MÉXICO,15,LERMA,051,SAN AGUSTÍN HUITZIZILAPAN,3,352,170,182,17
MÉXICO,15,LERMA,051,SAN FRANCISCO XOCHICUAUTLA,6,977,459,518,49
MÉXICO,15,LERMA,051,SAN JOSÉ EL LLANITO,2,187,97,90,8
MÉXICO,15,LERMA,051,SAN LORENZO HUITZIZILAPAN,6,738,373,365,34
MÉXICO,15,LERMA,051,SAN MARTÍN LAS RAJAS HUITZIZILAPAN,5,403,204,199,20
MÉXICO,15,LERMA,051,SAN MATEO ATARASQUILLO,6,1400,637,763,105
MÉXICO,15,LERMA,051,SAN MIGUEL AMEYALCO,5,2072,1059,1013,101
MÉXICO,15,LERMA,051,SAN NICOLÁS PERALTA,6,1251,629,622,65
MÉXICO,15,LERMA,051,SAN PEDRO HUITZIZILAPAN,4,511,260,251,24
MÉXICO,15,LERMA,051,SAN PEDRO TULTEPEC,10,3079,1493,1586,145
MÉXICO,15,LERMA,051,SANTA CATARINA,3,799,387,412,39
MÉXICO,15,LERMA,051,SANTA CRUZ CHIGNAHUAPAN,5,315,148,167,26
MÉXICO,15,LERMA,051,SANTA CRUZ HUITZIZILAPAN,3,225,109,116,10
MÉXICO,15,LERMA,051,SANTA CRUZ TULTEPEC,2,120,62,58,6
MÉXICO,15,LERMA,051,SANTA MARÍA ATARASQUILLO,19,10559,5140,5419,749
MÉXICO,15,LERMA,051,SANTA MARÍA TLALMIMILOLPAN,6,2307,1254,1053,242
MÉXICO,15,LERMA,051,SANTIAGO ANALCO,4,556,284,272,31
MÉXICO,15,LERMA,051,ZACAMULPA HUITZIZILAPAN,3,632,313,319,26
MÉXICO,15,LERMA,051,ZACAMULPA TLALMIMILOLPAN,3,289,146,143,12
MÉXICO,15,MALINALCO,052,AMATE AMARILLO,2,29,18,11,3
MÉXICO,15,MALINALCO,052,CAMPOS DE SAN MARTÍN,4,641,346,295,28
MÉXICO,15,MALINALCO,052,CHALMA,5,508,274,234,24
MÉXICO,15,MALINALCO,052,COLONIA ALDAMA,2,64,32,32,4
MÉXICO,15,MALINALCO,052,COLONIA HIDALGO,2,74,33,41,4
MÉXICO,15,MALINALCO,052,COLONIA JUÁREZ,4,216,107,109,14
MÉXICO,15,MALINALCO,052,EL PLATANAR,3,130,68,62,11
MÉXICO,15,MALINALCO,052,EL PUENTECITO,4,442,227,215,65
MÉXICO,15,MALINALCO,052,EL ZAPOTE,2,10,4,6,2
MÉXICO,15,MALINALCO,052,JALMOLONGA (LA HACIENDA),3,327,155,172,16
MÉXICO,15,MALINALCO,052,JESÚS MARÍA,1,15,12,3,1
MÉXICO,15,MALINALCO,052,LA ANGOSTURA,1,11,5,6,1
MÉXICO,15,MALINALCO,052,LA JOYA REDONDA,2,20,9,11,2
MÉXICO,15,MALINALCO,052,LA LADRILLERA,3,429,212,217,50
MÉXICO,15,MALINALCO,052,LA LOMA DE SAN FELIPE,1,19,10,9,1
MÉXICO,15,MALINALCO,052,LOMA DEL CÓPORO,2,52,26,26,4
MÉXICO,15,MALINALCO,052,MALINALCO,8,1645,836,809,77
MÉXICO,15,MALINALCO,052,MONTE GRANDE,3,61,29,32,5
MÉXICO,15,MALINALCO,052,NOXTEPEC DE ZARAGOZA (EL AGUACATE),5,139,82,57,10
MÉXICO,15,MALINALCO,052,PACHUQUILLA,3,67,29,38,5
MÉXICO,15,MALINALCO,052,PALMAR DE GUADALUPE,4,205,106,99,13
MÉXICO,15,MALINALCO,052,PUENTE CAPORAL (LA GUANCHA),3,134,64,70,8
MÉXICO,15,MALINALCO,052,SAN ANDRÉS NICOLÁS BRAVO,4,571,308,263,33
MÉXICO,15,MALINALCO,052,SAN NICOLÁS,3,296,131,165,15
MÉXICO,15,MALINALCO,052,SAN PEDRO CHICHICASCO (SAN PEDRO),3,78,37,41,5
MÉXICO,15,MALINALCO,052,SAN SEBASTIÁN,3,550,281,269,20
MÉXICO,15,MALINALCO,052,SAN SIMÓN EL ALTO,4,874,448,426,55
MÉXICO,15,MALINALCO,052,SANTA MARÍA XOQUIAC,3,63,27,36,5
MÉXICO,15,MELCHOR OCAMPO,053,LOMAS DE TENOPALCO,2,454,230,224,14
MÉXICO,15,MELCHOR OCAMPO,053,MELCHOR OCAMPO,37,7962,4029,3933,555
MÉXICO,15,MELCHOR OCAMPO,053,RANCHO EL BAÑADERO,1,1377,818,559,93
MÉXICO,15,MELCHOR OCAMPO,053,SAN FRANCISCO TENOPALCO,6,1317,647,670,43
MÉXICO,15,MELCHOR OCAMPO,053,VISITACIÓN,12,2613,1286,1327,101
MÉXICO,15,METEPEC,054,BARRIO SANTIAGUITO,10,2751,1324,1427,155
MÉXICO,15,METEPEC,054,COLONIA AGRÍCOLA ÁLVARO OBREGÓN,3,494,249,245,25
MÉXICO,15,METEPEC,054,COLONIA LLANO GRANDE (EL SALITRE),3,95,50,45,19
MÉXICO,15,METEPEC,054,METEPEC,227,52485,25131,27354,4596
MÉXICO,15,METEPEC,054,RESIDENCIAL FORESTA,1,30,12,18,2
MÉXICO,15,METEPEC,054,SAN BARTOLOMÉ TLALTELULCO,7,2584,1244,1340,202
MÉXICO,15,METEPEC,054,SAN FRANCISCO COAXUSCO,2,478,235,243,23
MÉXICO,15,METEPEC,054,SAN GASPAR TLAHUELILPAN,16,2990,1418,1572,154
MÉXICO,15,METEPEC,054,SAN JERÓNIMO CHICAHUALCO,15,1396,664,732,113
MÉXICO,15,METEPEC,054,SAN JORGE PUEBLO NUEVO,3,210,96,114,11
MÉXICO,15,METEPEC,054,SAN LORENZO COACALCO (SAN LORENZO),5,402,205,197,37
MÉXICO,15,METEPEC,054,SAN LUCAS TUNCO (SAN LUCAS),6,1503,767,736,68
MÉXICO,15,METEPEC,054,SAN MIGUEL TOTOCUITLAPILCO,14,2921,1430,1491,197
MÉXICO,15,METEPEC,054,SAN SALVADOR TIZATLALLI,12,1362,680,682,124
MÉXICO,15,METEPEC,054,SAN SEBASTIÁN,2,581,300,281,21
MÉXICO,15,METEPEC,054,SANTA MARÍA MAGDALENA OCOTITLÁN,14,2217,1053,1164,118
MÉXICO,15,MEXICALTZINGO,055,SAN MATEO MEXICALTZINGO,19,4161,2120,2041,247
MÉXICO,15,MORELOS,056,BARRIO CUARTO (LA LOMA),3,689,320,369,28
MÉXICO,15,MORELOS,056,BARRIO DE XICANI,2,38,6,32,4
MÉXICO,15,MORELOS,056,BARRIO PRIMERO (LA CALAVERA),4,638,306,332,44
MÉXICO,15,MORELOS,056,BARRIO TERCERO,1,11,6,5,1
MÉXICO,15,MORELOS,056,CAXBONCUAC,3,28,14,14,4
MÉXICO,15,MORELOS,056,EJIDO DE SAN ANTONIO,2,69,37,32,7
MÉXICO,15,MORELOS,056,EJIDO SANTA CLARA,3,18,10,8,3
MÉXICO,15,MORELOS,056,EL REINO,3,32,14,18,4
MÉXICO,15,MORELOS,056,LA BELTRÁN,2,26,11,15,2
MÉXICO,15,MORELOS,056,LA CAÑADA,2,19,4,15,2
MÉXICO,15,MORELOS,056,LA CAÑADA (SAN MARCOS TLAZALPAN),2,54,28,26,3
MÉXICO,15,MORELOS,056,LA CRUZ (SAN SIMÓN LA CRUZ),3,52,22,30,4
MÉXICO,15,MORELOS,056,LA FINCA,2,60,34,26,3
MÉXICO,15,MORELOS,056,LA LAGUNILLA,2,16,8,8,2
MÉXICO,15,MORELOS,056,LAGUNA SECA,5,151,69,82,10
MÉXICO,15,MORELOS,056,LOMA DE BUENAVISTA,2,95,53,42,5
MÉXICO,15,MORELOS,056,RANCHERÍA SAN ANTONIO,3,44,26,18,3
MÉXICO,15,MORELOS,056,RANCHO LA MALINCHE,1,61,31,30,6
MÉXICO,15,MORELOS,056,SAN BARTOLO MORELOS,9,1324,681,643,67
MÉXICO,15,MORELOS,056,SAN GREGORIO MACAPEXCO,7,270,135,135,16
MÉXICO,15,MORELOS,056,SAN JOSÉ EL QUELITE,4,81,43,38,9
MÉXICO,15,MORELOS,056,SAN JOSÉ LA EPIFANIA,3,179,89,90,11
MÉXICO,15,MORELOS,056,SAN LORENZO MALACOTA,9,984,499,485,54
MÉXICO,15,MORELOS,056,SAN MARCOS TLAZALPAN,7,1023,523,500,58
MÉXICO,15,MORELOS,056,SAN SEBASTIÁN BUENOS AIRES (SAN SEBASTIÁN),10,973,463,510,47
MÉXICO,15,MORELOS,056,SANTA CLARA DE JUÁREZ,9,1370,663,707,79
MÉXICO,15,MORELOS,056,SANTA CRUZ,2,144,65,79,9
MÉXICO,15,MORELOS,056,TLALPUJAHUILLA,4,114,54,60,7
MÉXICO,15,MORELOS,056,XHINTE DE LAGOS,3,198,96,102,10
MÉXICO,15,NAUCALPAN DE JUÁREZ,057,BARRIO DE BATHA,1,186,107,79,6
MÉXICO,15,NAUCALPAN DE JUÁREZ,057,BARRIO LA VIGA (CERRO LOCO),2,44,23,21,4
MÉXICO,15,NAUCALPAN DE JUÁREZ,057,CHIMALPA VIEJO,1,498,269,229,16
MÉXICO,15,NAUCALPAN DE JUÁREZ,057,EJIDO DEL TEJOCOTE,3,871,441,430,25
MÉXICO,15,NAUCALPAN DE JUÁREZ,057,EJIDO EL CASTILLO,3,291,147,144,17
MÉXICO,15,NAUCALPAN DE JUÁREZ,057,EJIDO SAN MATEO NOPALA (BELLAVISTA),3,476,255,221,28
MÉXICO,15,NAUCALPAN DE JUÁREZ,057,LA UNIDAD HUITZIZILAPAN,1,252,129,123,10
MÉXICO,15,NAUCALPAN DE JUÁREZ,057,LLANO DE LAS FLORES (BARRIO DEL HUESO),1,65,31,34,3
MÉXICO,15,NAUCALPAN DE JUÁREZ,057,NAUCALPAN DE JUÁREZ,757,193443,97248,96195,13527
MÉXICO,15,NAUCALPAN DE JUÁREZ,057,PUENTE DE PIEDRA,2,184,80,104,8
MÉXICO,15,NAUCALPAN DE JUÁREZ,057,RINCÓN VERDE,5,1243,589,654,56
MÉXICO,15,NAUCALPAN DE JUÁREZ,057,SAN FRANCISCO CHIMALPA,12,3300,1602,1698,133
MÉXICO,15,NAUCALPAN DE JUÁREZ,057,SAN JOSÉ POZA HONDA,3,750,382,368,41
MÉXICO,15,NAUCALPAN DE JUÁREZ,057,SAN JOSÉ TEJAMANIL,3,600,292,308,22
MÉXICO,15,NAUCALPAN DE JUÁREZ,057,SANTIAGO TEPATLAXCO,7,1429,690,739,47
MÉXICO,15,NEZAHUALCÓYOTL,058,CIUDAD NEZAHUALCÓYOTL,944,211118,106861,104257,15239
MÉXICO,15,NEXTLALPAN,059,BARRIO SAN FRANCISCO MOLONCO,2,779,411,368,45
MÉXICO,15,NEXTLALPAN,059,COLONIA LOS AGUILUCHOS,2,277,132,145,9
MÉXICO,15,NEXTLALPAN,059,COLONIA POZOS Y VÍAS (FRACCIÓN DIECISIETE A),2,264,125,139,8
MÉXICO,15,NEXTLALPAN,059,EJIDO TENOPALCO,2,810,397,413,24
MÉXICO,15,NEXTLALPAN,059,EJIDO VISITACIÓN,3,55,23,32,5
MÉXICO,15,NEXTLALPAN,059,EX-HACIENDA SANTA INÉS,14,4132,2029,2103,180
MÉXICO,15,NEXTLALPAN,059,PASEOS DEL VALLE,1,557,275,282,19
MÉXICO,15,NEXTLALPAN,059,PRADOS SAN FRANCISCO,3,418,215,203,15
MÉXICO,15,NEXTLALPAN,059,SAN MATEO ACUITLAPILCO,3,603,288,315,25
MÉXICO,15,NEXTLALPAN,059,SAN MIGUEL JALTOCAN,4,563,261,302,28
MÉXICO,15,NEXTLALPAN,059,SANTA ANA NEXTLALPAN,23,5878,2944,2934,330
MÉXICO,15,NEXTLALPAN,059,SANTA INÉS,1,200,96,104,8
MÉXICO,15,NEXTLALPAN,059,SANTIAGO ATOCAN,4,459,200,259,22
MÉXICO,15,NEXTLALPAN,059,TIERRA DE SANTA INÉS,1,161,85,76,4
MÉXICO,15,NICOLÁS ROMERO,060,BARRIO DE GUADALUPE,4,344,188,156,15
MÉXICO,15,NICOLÁS ROMERO,060,CAJA DE AGUA,3,291,123,168,15
MÉXICO,15,NICOLÁS ROMERO,060,CIUDAD NICOLÁS ROMERO,320,73589,37137,36452,3703
MÉXICO,15,NICOLÁS ROMERO,060,COLONIA EL MIRADOR,1,202,93,109,6
MÉXICO,15,NICOLÁS ROMERO,060,COLONIA LLANO GRANDE (NUEVO EJIDO),3,480,251,229,16
MÉXICO,15,NICOLÁS ROMERO,060,COLONIA MORELOS,4,1186,584,602,37
MÉXICO,15,NICOLÁS ROMERO,060,JOYA DEL TEJOCOTE,2,150,71,79,7
MÉXICO,15,NICOLÁS ROMERO,060,LA CONCEPCIÓN (EL ESCOBAL),4,821,384,437,28
MÉXICO,15,NICOLÁS ROMERO,060,LA ESTANCIA,1,98,55,43,4
MÉXICO,15,NICOLÁS ROMERO,060,LOMA DEL RÍO,1,112,67,45,6
MÉXICO,15,NICOLÁS ROMERO,060,LOMA LARGA,1,24,13,11,2
MÉXICO,15,NICOLÁS ROMERO,060,MIRANDA,2,76,36,40,6
MÉXICO,15,NICOLÁS ROMERO,060,PROGRESO INDUSTRIAL,9,2795,1343,1452,106
MÉXICO,15,NICOLÁS ROMERO,060,PUEBLO NUEVO,1,13,4,9,2
MÉXICO,15,NICOLÁS ROMERO,060,PUENTECILLAS CAHUACÁN,4,290,133,157,15
MÉXICO,15,NICOLÁS ROMERO,060,PUERTO MAGÚ,3,548,269,279,20
MÉXICO,15,NICOLÁS ROMERO,060,QUINTO BARRIO (EJIDO CAHUACÁN),2,727,365,362,24
MÉXICO,15,NICOLÁS ROMERO,060,SAN FRANCISCO MAGÚ,12,2013,987,1026,108
MÉXICO,15,NICOLÁS ROMERO,060,SAN JOSÉ EL VIDRIO,11,2474,1232,1242,85
MÉXICO,15,NICOLÁS ROMERO,060,SAN JOSÉ LOS BARBECHOS (LOS BARBECHOS),3,39,17,22,4
MÉXICO,15,NICOLÁS ROMERO,060,SAN JUAN DE LAS TABLAS,3,191,88,103,10
MÉXICO,15,NICOLÁS ROMERO,060,SAN MIGUEL HILA,5,761,379,382,33
MÉXICO,15,NICOLÁS ROMERO,060,SANTA MARÍA MAGDALENA CAHUACÁN,11,2689,1352,1337,158
MÉXICO,15,NICOLÁS ROMERO,060,TRANSFIGURACIÓN,6,746,340,406,36
MÉXICO,15,NICOLÁS ROMERO,060,VEINTIDÓS DE FEBRERO,7,1058,537,521,42
MÉXICO,15,NOPALTEPEC,061,EX-HACIENDA VENTA DE CRUZ,1,6,4,2,1
MÉXICO,15,NOPALTEPEC,061,NOPALTEPEC,7,902,460,442,57
MÉXICO,15,NOPALTEPEC,061,SAN FELIPE TEOTITLÁN,6,1283,709,574,252
MÉXICO,15,NOPALTEPEC,061,SAN MIGUEL ATEPOXCO,4,513,245,268,21
MÉXICO,15,OCOYOACAC,062,COLONIA JUÁREZ (LOS CHIRINOS),13,963,470,493,88
MÉXICO,15,OCOYOACAC,062,EL PEDREGAL DE GUADALUPE HIDALGO,8,3089,1761,1328,287
MÉXICO,15,OCOYOACAC,062,GUADALUPE VICTORIA,2,459,220,239,19
MÉXICO,15,OCOYOACAC,062,JAJALPA (FRACCIONAMIENTO EX-HACIENDA DE JAJALPA),1,37,27,10,3
MÉXICO,15,OCOYOACAC,062,LA MARQUESA,3,722,365,357,32
MÉXICO,15,OCOYOACAC,062,LOMA BONITA,2,270,125,145,11
MÉXICO,15,OCOYOACAC,062,OCOYOACAC,36,7844,3893,3951,415
MÉXICO,15,OCOYOACAC,062,RÍO HONDITO,2,72,36,36,4
MÉXICO,15,OCOYOACAC,062,SAN ANTONIO EL LLANITO,4,397,189,208,20
MÉXICO,15,OCOYOACAC,062,SAN JERÓNIMO ACAZULCO,7,812,413,399,53
MÉXICO,15,OCOYOACAC,062,SAN PEDRO ATLAPULCO,5,870,418,452,75
MÉXICO,15,OCOYOACAC,062,SAN PEDRO CHOLULA,9,1843,929,914,108
MÉXICO,15,OCUILAN,063,AHUATENCO,4,226,119,107,14
MÉXICO,15,OCUILAN,063,AJUCHITLÁN,3,16,9,7,3
MÉXICO,15,OCUILAN,063,AMOLA (SAN ISIDRO AMOLA),2,33,13,20,4
MÉXICO,15,OCUILAN,063,CHALMITA,4,324,155,169,15
MÉXICO,15,OCUILAN,063,CINCO CAMINOS,2,204,109,95,8
MÉXICO,15,OCUILAN,063,COLONIA DOCTOR GUSTAVO BAZ,4,356,171,185,15
MÉXICO,15,OCUILAN,063,COYOLTEPEC,2,75,36,39,5
MÉXICO,15,OCUILAN,063,EL AHUEHUETE,2,28,13,15,2
MÉXICO,15,OCUILAN,063,EL CAPULÍN,2,17,9,8,2
MÉXICO,15,OCUILAN,063,EL PICACHO (SAN ANTONIO EL PICACHO),2,142,65,77,5
MÉXICO,15,OCUILAN,063,EL PUENTE,2,95,50,45,4
MÉXICO,15,OCUILAN,063,LA CAÑADA,2,56,27,29,4
MÉXICO,15,OCUILAN,063,LA CIÉNEGA,3,196,102,94,10
MÉXICO,15,OCUILAN,063,LA ESPERANZA (EL ARENAL),3,95,50,45,7
MÉXICO,15,OCUILAN,063,LA HACIENDITA,2,11,7,4,2
MÉXICO,15,OCUILAN,063,LA LAGUNILLA,2,166,78,88,9
MÉXICO,15,OCUILAN,063,LA LAGUNITA,4,138,69,69,13
MÉXICO,15,OCUILAN,063,LAS TROJES,2,41,19,22,3
MÉXICO,15,OCUILAN,063,LOMAS DE TEOCALTZINGO (LOMA DE TECALZINGO),1,111,62,49,6
MÉXICO,15,OCUILAN,063,LOS MANANTIALES (EL RÍO CHIQUITO),2,91,40,51,5
MÉXICO,15,OCUILAN,063,MEXICAPA,3,45,20,25,4
MÉXICO,15,OCUILAN,063,OCUILAN DE ARTEAGA,8,1752,898,854,105
MÉXICO,15,OCUILAN,063,PASTORÍA (LA PASTORA),3,123,59,64,9
MÉXICO,15,OCUILAN,063,PLAZA NUEVA,3,264,140,124,12
MÉXICO,15,OCUILAN,063,PUEBLO NUEVO,2,32,14,18,3
MÉXICO,15,OCUILAN,063,PUENTE ANCHO,1,19,9,10,1
MÉXICO,15,OCUILAN,063,REFORMA AGRARIA (EL PEDREGAL),2,121,44,77,7
MÉXICO,15,OCUILAN,063,RINCÓN DE LAS BUGAMBILIAS,1,7,3,4,1
MÉXICO,15,OCUILAN,063,SAN JOSÉ EL TÓTOC,3,163,76,87,11
MÉXICO,15,OCUILAN,063,SAN JUAN ATZINGO,7,636,308,328,37
MÉXICO,15,OCUILAN,063,SAN SEBASTIÁN,1,42,15,27,2
MÉXICO,15,OCUILAN,063,SANTA ANA,3,256,120,136,12
MÉXICO,15,OCUILAN,063,SANTA CRUZ TEZONTEPEC (TOTOLTEPEC),4,549,259,290,31
MÉXICO,15,OCUILAN,063,SANTA LUCÍA,4,418,194,224,23
MÉXICO,15,OCUILAN,063,SANTA MARÍA (TLACUTAPA),3,58,32,26,4
MÉXICO,15,OCUILAN,063,SANTA MARTHA,3,376,188,188,20
MÉXICO,15,OCUILAN,063,SANTA MÓNICA,6,1390,694,696,66
MÉXICO,15,OCUILAN,063,TEPETZINGO (TEPEZINGO),2,148,80,68,7
MÉXICO,15,OCUILAN,063,TLATEMPA,2,19,6,13,3
MÉXICO,15,OCUILAN,063,TLECUILCO,2,46,22,24,3
MÉXICO,15,EL ORO,064,ADOLFO LÓPEZ MATEOS,2,315,150,165,12
MÉXICO,15,EL ORO,064,BARRIO DE LAS PEÑITAS,1,95,47,48,14
MÉXICO,15,EL ORO,064,BARRIO DEL GIGANTE,3,159,87,72,11
MÉXICO,15,EL ORO,064,BASSOCO DE HIDALGO,2,55,32,23,4
MÉXICO,15,EL ORO,064,BENEMÉRITO PUEBLO NUEVO DE LOS ÁNGELES,1,5,2,3,1
MÉXICO,15,EL ORO,064,BUENAVISTA,3,158,84,74,9
MÉXICO,15,EL ORO,064,CERRO LLORÓN,2,111,54,57,7
MÉXICO,15,EL ORO,064,CITEJE,2,118,58,60,7
MÉXICO,15,EL ORO,064,COLONIA CUAUHTÉMOC,2,112,56,56,5
MÉXICO,15,EL ORO,064,CONCEPCIÓN PRIMERA,2,244,114,130,9
MÉXICO,15,EL ORO,064,EJIDO SAN NICOLÁS EL ORO (AGUA ESCONDIDA),2,28,10,18,2
MÉXICO,15,EL ORO,064,EJIDO SANTIAGO OXTEMPAN,5,283,147,136,17
MÉXICO,15,EL ORO,064,EL MOGOTE,2,108,51,57,7
MÉXICO,15,EL ORO,064,EL ORO DE HIDALGO,22,4688,2383,2305,255
MÉXICO,15,EL ORO,064,ENDOTEJIARE,2,48,22,26,4
MÉXICO,15,EL ORO,064,LA CONCEPCIÓN (LA CONCEPCIÓN SEGUNDA),2,383,197,186,19
MÉXICO,15,EL ORO,064,LA JORDANA,4,626,320,306,43
MÉXICO,15,EL ORO,064,LA LOMA DE LA CIMA,2,20,14,6,2
MÉXICO,15,EL ORO,064,LA MAGDALENA MORELOS,3,249,118,131,19
MÉXICO,15,EL ORO,064,LA MESA,2,34,11,23,3
MÉXICO,15,EL ORO,064,LA NOPALERA,2,46,22,24,3
MÉXICO,15,EL ORO,064,LA PALMA,2,82,39,43,7
MÉXICO,15,EL ORO,064,LA SOLEDAD,2,54,24,30,3
MÉXICO,15,EL ORO,064,LÁZARO CÁRDENAS,2,47,24,23,3
MÉXICO,15,EL ORO,064,LLANITO CUATRO,2,85,38,47,5
MÉXICO,15,EL ORO,064,LOMA DEL CAPULÍN,3,27,14,13,4
MÉXICO,15,EL ORO,064,PRESA BROCKMAN,4,295,138,157,30
MÉXICO,15,EL ORO,064,PUEBLO NUEVO DE LOS ÁNGELES,5,526,282,244,27
MÉXICO,15,EL ORO,064,SAN ISIDRO EJIDO DE TAPAXCO,2,40,22,18,4
MÉXICO,15,EL ORO,064,SAN NICOLÁS EL ORO (SAN NICOLÁS),2,23,12,11,4
MÉXICO,15,EL ORO,064,SAN NICOLÁS TULTENANGO,6,481,234,247,26
MÉXICO,15,EL ORO,064,SANTA CRUZ EL TEJOCOTE (EL TEJOCOTE),4,355,180,175,21
MÉXICO,15,EL ORO,064,SANTA ROSA DE GUADALUPE,3,115,62,53,19
MÉXICO,15,EL ORO,064,SANTA ROSA DE LIMA,6,277,152,125,23
MÉXICO,15,EL ORO,064,SANTIAGO OXTEMPAN,6,1008,640,368,57
MÉXICO,15,EL ORO,064,TAPAXCO,4,551,270,281,38
MÉXICO,15,EL ORO,064,VENTA DEL AIRE,3,138,67,71,8
MÉXICO,15,EL ORO,064,YOMEJE,1,11,5,6,1
MÉXICO,15,OTUMBA,065,BELÉM,4,359,171,188,19
MÉXICO,15,OTUMBA,065,CUAUTLACINGO,3,652,316,336,24
MÉXICO,15,OTUMBA,065,OTUMBA DE GÓMEZ FARÍAS,20,2939,1438,1501,176
MÉXICO,15,OTUMBA,065,OXTOTIPAC,4,808,403,405,54
MÉXICO,15,OTUMBA,065,SAN FRANCISCO TLALTICA,4,482,233,249,24
MÉXICO,15,OTUMBA,065,SAN JUAN TOCUILA (TOCUILA),1,16,6,10,1
MÉXICO,15,OTUMBA,065,SAN MARCOS (SAN MARCOS TLAXUCHILCO),3,191,88,103,12
MÉXICO,15,OTUMBA,065,SAN MARTÍN AHUATEPEC,4,471,230,241,25
MÉXICO,15,OTUMBA,065,SAN MIGUEL XOLCO,3,164,90,74,11
MÉXICO,15,OTUMBA,065,SANTA BÁRBARA,4,156,74,82,13
MÉXICO,15,OTUMBA,065,SANTIAGO TOLMAN,7,1429,723,706,57
MÉXICO,15,OTUMBA,065,TLALMIMILOLPA,3,315,155,160,28
MÉXICO,15,OTZOLOAPAN,066,AGUA ZARCA (AGUA ZARCA DE ARRIBA),1,8,6,2,2
MÉXICO,15,OTZOLOAPAN,066,BARRIO DE GUADALUPE (LOS LOTES),2,69,39,30,5
MÉXICO,15,OTZOLOAPAN,066,BURRUSQUETA,1,4,3,1,1
MÉXICO,15,OTZOLOAPAN,066,CARRANZA,1,18,9,9,1
MÉXICO,15,OTZOLOAPAN,066,CRUZ BLANCA,4,132,76,56,9
MÉXICO,15,OTZOLOAPAN,066,EL CALVARIO (SAN JOSÉ EL CALVARIO),2,133,65,68,7
MÉXICO,15,OTZOLOAPAN,066,ESTANCIA CHICA,2,30,18,12,2
MÉXICO,15,OTZOLOAPAN,066,OTZOLOAPAN,6,588,278,310,44
MÉXICO,15,OTZOLOAPAN,066,PINAL DEL MARQUESADO,4,149,66,83,10
MÉXICO,15,OTZOLOAPAN,066,SAN MIGUEL DE LA CAMPANA (SAN MIGUEL),2,23,15,8,3
MÉXICO,15,OTZOLOAPAN,066,SAN MIGUEL PIRU (EL PIRU),2,67,26,41,3
MÉXICO,15,OTZOLOAPAN,066,TERREROS,2,39,24,15,3
MÉXICO,15,OTZOLOAPAN,066,ZULUAPAN,2,34,14,20,4
MÉXICO,15,OTZOLOTEPEC,067,BARRIO DE LA ROSA,1,48,27,21,4
MÉXICO,15,OTZOLOTEPEC,067,BARRIO DE SAN JUAN,1,30,15,15,2
MÉXICO,15,OTZOLOTEPEC,067,BARRIO EL CAPULÍN,2,474,248,226,17
MÉXICO,15,OTZOLOTEPEC,067,BARRIO SOLANOS,1,7,3,4,1
MÉXICO,15,OTZOLOTEPEC,067,COLONIA GUADALUPE VICTORIA,4,1603,822,781,56
MÉXICO,15,OTZOLOTEPEC,067,EJIDO DE MOZOQUILPAN,4,280,128,152,13
MÉXICO,15,OTZOLOTEPEC,067,EJIDO DE SAN MATEO CAPULHUAC,2,9,4,5,2
MÉXICO,15,OTZOLOTEPEC,067,FÁBRICA MARÍA (PILAR MARÍA),4,553,267,286,37
MÉXICO,15,OTZOLOTEPEC,067,LA CONCEPCIÓN DE HIDALGO,3,634,310,324,28
MÉXICO,15,OTZOLOTEPEC,067,LA FLORIDA [FRACCIONAMIENTO],1,81,38,43,3
MÉXICO,15,OTZOLOTEPEC,067,LA HUÁNICA,2,159,67,92,8
MÉXICO,15,OTZOLOTEPEC,067,LA Y,2,360,174,186,17
MÉXICO,15,OTZOLOTEPEC,067,PUENTE SAN PEDRO,4,611,283,328,26
MÉXICO,15,OTZOLOTEPEC,067,RANCHO EL OXCO,2,95,40,55,4
MÉXICO,15,OTZOLOTEPEC,067,SAN AGUSTÍN MIMBRES,4,349,160,189,16
MÉXICO,15,OTZOLOTEPEC,067,SAN ISIDRO LAS TROJES,2,389,183,206,15
MÉXICO,15,OTZOLOTEPEC,067,SAN MATEO CAPULHUAC,15,2425,1218,1207,147
MÉXICO,15,OTZOLOTEPEC,067,SAN MATEO MOZOQUILPAN,2,390,208,182,28
MÉXICO,15,OTZOLOTEPEC,067,SANTA ANA JILOTZINGO,7,1498,769,729,87
MÉXICO,15,OTZOLOTEPEC,067,SANTA ANA MAYORAZGO,4,957,466,491,51
MÉXICO,15,OTZOLOTEPEC,067,SANTA MARÍA TETITLA,8,2162,1139,1023,129
MÉXICO,15,OTZOLOTEPEC,067,VILLA CUAUHTÉMOC,37,8108,4184,3924,498
MÉXICO,15,OTZOLOTEPEC,067,VILLA SECA (LA PROVIDENCIA VILLA SECA),3,629,298,331,39
MÉXICO,15,OTZOLOTEPEC,067,ZONA NÚMERO CUATRO SAN MATEO CAPULHUAC,1,78,40,38,3
MÉXICO,15,OTZOLOTEPEC,067,ZONA NÚMERO DOS SAN MATEO CAPULHUAC,2,266,141,125,18
MÉXICO,15,OZUMBA,068,COLONIA GUADALUPE HIDALGO,2,214,106,108,9
MÉXICO,15,OZUMBA,068,OZUMBA DE ALZATE,24,5982,3102,2880,366
MÉXICO,15,OZUMBA,068,SAN JOSÉ TLACOTITLÁN,4,422,226,196,19
MÉXICO,15,OZUMBA,068,SAN LORENZO TLALTECOYAN (TLALTECOYAC),2,84,42,42,5
MÉXICO,15,OZUMBA,068,SAN MATEO TECALCO,4,689,327,362,31
MÉXICO,15,OZUMBA,068,SAN VICENTE CHIMALHUACÁN,5,955,515,440,33
MÉXICO,15,OZUMBA,068,SANTIAGO MAMALHUAZUCA,4,437,225,212,20
MÉXICO,15,PAPALOTLA,069,PAPALOTLA,11,2968,1443,1525,197
MÉXICO,15,LA PAZ,070,ARENAL,1,344,167,177,12
MÉXICO,15,LA PAZ,070,BOSQUES DE LA MAGDALENA,2,138,68,70,7
MÉXICO,15,LA PAZ,070,COLONIA MÁXIMO DE LA CRUZ,2,211,99,112,8
MÉXICO,15,LA PAZ,070,COLONIA TECOMATLÁN,1,150,68,82,16
MÉXICO,15,LA PAZ,070,EL PINO,5,565,304,261,38
MÉXICO,15,LA PAZ,070,EMILIANO ZAPATA,10,838,424,414,55
MÉXICO,15,LA PAZ,070,LA MAGDALENA ATLICPAC,9,1522,762,760,71
MÉXICO,15,LA PAZ,070,LOMAS DE SAN SEBASTIÁN,20,4192,2029,2163,135
MÉXICO,15,LA PAZ,070,LOS REYES ACAQUILPAN,199,55719,28857,26862,3122
MÉXICO,15,LA PAZ,070,SAN ISIDRO,30,5156,2625,2531,234
MÉXICO,15,LA PAZ,070,SAN JOSÉ LAS PALMAS,3,482,236,246,18
MÉXICO,15,LA PAZ,070,SAN SEBASTIÁN CHIMALPA,7,949,480,469,53
MÉXICO,15,LA PAZ,070,TECAMACHALCO,6,4191,1804,2387,200
MÉXICO,15,LA PAZ,070,TECHACHALTITLA,4,503,248,255,18
MÉXICO,15,LA PAZ,070,UNIDAD ACAQUILPAN,1,247,119,128,8
MÉXICO,15,POLOTITLÁN,071,BARRIO LÁZARO CÁRDENAS (SAN RAFAEL),2,65,34,31,3
MÉXICO,15,POLOTITLÁN,071,CELAYITA (SAN JOSÉ CELAYITA),5,642,338,304,29
MÉXICO,15,POLOTITLÁN,071,CERRO GORDO,1,7,6,1,1
MÉXICO,15,POLOTITLÁN,071,EL ÁLAMO,2,95,47,48,4
MÉXICO,15,POLOTITLÁN,071,EL GAVILLERO DE LA TRINIDAD (LA CURVA),2,19,9,10,3
MÉXICO,15,POLOTITLÁN,071,EL TESORO,1,27,11,16,2
MÉXICO,15,POLOTITLÁN,071,ENCINILLAS,2,237,121,116,12
MÉXICO,15,POLOTITLÁN,071,ESTACIÓN POLOTITLÁN (CASAS VIEJAS),3,209,115,94,11
MÉXICO,15,POLOTITLÁN,071,LA PURÍSIMA (BUENAVISTA),1,20,11,9,1
MÉXICO,15,POLOTITLÁN,071,POLOTITLÁN DE LA ILUSTRACIÓN,10,2115,1099,1016,150
MÉXICO,15,POLOTITLÁN,071,RANCHITO DE RUANO,1,7,2,5,1
MÉXICO,15,POLOTITLÁN,071,RANCHO LA MAGDALENA,1,17,8,9,1
MÉXICO,15,POLOTITLÁN,071,RUANO,4,211,106,105,14
MÉXICO,15,POLOTITLÁN,071,SAN AGUSTÍN EL CUERVO,2,69,35,34,3
MÉXICO,15,POLOTITLÁN,071,SAN ANTONIO EL VIEJO,2,318,141,177,12
MÉXICO,15,POLOTITLÁN,071,SAN ANTONIO ESCOBEDO,2,73,43,30,5
MÉXICO,15,POLOTITLÁN,071,SAN ANTONIO POLOTITLÁN,2,55,23,32,3
MÉXICO,15,POLOTITLÁN,071,SAN FRANCISCO ACAZUCHITLALTONGO,4,111,56,55,9
MÉXICO,15,POLOTITLÁN,071,SAN NICOLÁS DE LOS CERRITOS,2,50,22,28,3
MÉXICO,15,POLOTITLÁN,071,TAXHIE,2,59,25,34,3
MÉXICO,15,RAYÓN,072,PARAJE RANCHO SANABRIA,1,120,56,64,7
MÉXICO,15,RAYÓN,072,RANCHO SANABRIA,1,508,297,211,32
MÉXICO,15,RAYÓN,072,SAN JUAN LA ISLA,4,601,274,327,22
MÉXICO,15,RAYÓN,072,SANTA MARÍA RAYÓN,11,2887,1434,1453,171
MÉXICO,15,SAN ANTONIO LA ISLA,073,EX-RANCHO SAN DIMAS,5,1830,870,960,68
MÉXICO,15,SAN ANTONIO LA ISLA,073,SAN ANTONIO LA ISLA,15,3973,2068,1905,237
MÉXICO,15,SAN FELIPE DEL PROGRESO,074,AGUA ZARCA NICHI,2,92,47,45,4
MÉXICO,15,SAN FELIPE DEL PROGRESO,074,BARRIO BOREJE DE SAN ANTONIO LA CIÉNEGA,3,393,179,214,18
MÉXICO,15,SAN FELIPE DEL PROGRESO,074,BARRIO CERRO DE LA LUNA DEL FRESNO NICHI,2,37,15,22,3
MÉXICO,15,SAN FELIPE DEL PROGRESO,074,BARRIO DE LA ERA SAN PABLO TLALCHICHILPA,3,84,44,40,9
MÉXICO,15,SAN FELIPE DEL PROGRESO,074,BARRIO EL AGOSTADERO EJIDO DE SAN JUAN JALPA,2,47,17,30,3
MÉXICO,15,SAN FELIPE DEL PROGRESO,074,BARRIO EL SALTO SAN ANTONIO LA CIÉNEGA,1,33,18,15,1
MÉXICO,15,SAN FELIPE DEL PROGRESO,074,BARRIO LA CAÑADA SAN ANTONIO LA CIÉNEGA,1,16,9,7,1
MÉXICO,15,SAN FELIPE DEL PROGRESO,074,"BARRIO LAS PALOMAS, SANTA ANA NICHI",3,333,164,169,16
MÉXICO,15,SAN FELIPE DEL PROGRESO,074,"BARRIO LAS PRESAS, EJIDO DE SAN JERÓNIMO MAVATÍ",1,51,24,27,3
MÉXICO,15,SAN FELIPE DEL PROGRESO,074,BARRIO SAN FRANCISCO EJIDO DE SAN PABLO TLALCHICHILPA,3,98,44,54,7
MÉXICO,15,SAN FELIPE DEL PROGRESO,074,BARRIO SAN FRANCISCO SAN NICOLÁS GUADALUPE,3,231,115,116,11
MÉXICO,15,SAN FELIPE DEL PROGRESO,074,"BARRIO SAN JOSÉ, EJIDO DE SAN PEDRO EL ALTO",1,226,115,111,6
MÉXICO,15,SAN FELIPE DEL PROGRESO,074,BARRIO SANTA CRUZ DE SAN PABLO TLALCHICHILPA,2,131,63,68,7
MÉXICO,15,SAN FELIPE DEL PROGRESO,074,"BARRIO SANTA CRUZ, SAN PEDRO EL ALTO",2,31,14,17,3
MÉXICO,15,SAN FELIPE DEL PROGRESO,074,BARRIO TEPETITLÁN EMILIO PORTES GIL,5,99,45,54,9
MÉXICO,15,SAN FELIPE DEL PROGRESO,074,"BARRIO TIERRA BLANCA, EJIDO DE SAN PEDRO EL ALTO",1,45,25,20,2
MÉXICO,15,SAN FELIPE DEL PROGRESO,074,CALVARIO BUENAVISTA,3,244,110,134,14
MÉXICO,15,SAN FELIPE DEL PROGRESO,074,CALVARIO DEL CARMEN,12,1463,739,724,71
MÉXICO,15,SAN FELIPE DEL PROGRESO,074,CHARCOS AZULES SAN JERÓNIMO MAVATÍ,2,60,30,30,4
MÉXICO,15,SAN FELIPE DEL PROGRESO,074,CHICHILPA,6,219,112,107,16
MÉXICO,15,SAN FELIPE DEL PROGRESO,074,CHOTEJE,5,290,154,136,18
MÉXICO,15,SAN FELIPE DEL PROGRESO,074,COLONIA GUADALUPE,1,20,10,10,1
MÉXICO,15,SAN FELIPE DEL PROGRESO,074,COLONIA PLATEROS DE PALMILLAS,1,19,6,13,1
MÉXICO,15,SAN FELIPE DEL PROGRESO,074,DIOS PADRE,4,256,136,120,16
MÉXICO,15,SAN FELIPE DEL PROGRESO,074,DOLORES HIDALGO,6,853,416,437,37
MÉXICO,15,SAN FELIPE DEL PROGRESO,074,DOTEGIARE,5,422,191,231,43
MÉXICO,15,SAN FELIPE DEL PROGRESO,074,EJIDO DE LA CONCEPCIÓN CHICO,3,252,129,123,13
MÉXICO,15,SAN FELIPE DEL PROGRESO,074,EJIDO DE SAN FELIPE DEL PROGRESO,3,2992,1281,1711,149
MÉXICO,15,SAN FELIPE DEL PROGRESO,074,EJIDO DE SAN JUAN JALPA,1,35,17,18,3
MÉXICO,15,SAN FELIPE DEL PROGRESO,074,EJIDO DE TLALCHICHILPA,2,60,26,34,4
MÉXICO,15,SAN FELIPE DEL PROGRESO,074,EJIDO DEL TUNAL NENAXI,6,276,146,130,18
MÉXICO,15,SAN FELIPE DEL PROGRESO,074,EJIDO LA VIRGEN,4,326,160,166,16
MÉXICO,15,SAN FELIPE DEL PROGRESO,074,EJIDO SAN AGUSTÍN MEXTEPEC,2,21,11,10,3
MÉXICO,15,SAN FELIPE DEL PROGRESO,074,EL CARMEN OCOTEPEC,5,437,214,223,26
MÉXICO,15,SAN FELIPE DEL PROGRESO,074,EL OBRAJE,2,196,87,109,9
MÉXICO,15,SAN FELIPE DEL PROGRESO,074,EL TUNAL,6,233,106,127,19
MÉXICO,15,SAN FELIPE DEL PROGRESO,074,EMILIO PORTES GIL,9,1790,902,888,111
MÉXICO,15,SAN FELIPE DEL PROGRESO,074,ENCINILLAS DE SAN ANTONIO LA CIÉNEGA,2,99,50,49,4
MÉXICO,15,SAN FELIPE DEL PROGRESO,074,ESTUTEMPAN,2,83,42,41,6
MÉXICO,15,SAN FELIPE DEL PROGRESO,074,FRESNO NICHI,10,1136,565,571,102
MÉXICO,15,SAN FELIPE DEL PROGRESO,074,GUADALUPE COTÉ,3,486,240,246,22
MÉXICO,15,SAN FELIPE DEL PROGRESO,074,LA CABECERA CONCEPCIÓN,2,445,211,234,17
MÉXICO,15,SAN FELIPE DEL PROGRESO,074,LA CONCEPCIÓN CHICO (EL CENTRO),5,172,89,83,11
MÉXICO,15,SAN FELIPE DEL PROGRESO,074,MESA DE LA AGÜITA,3,83,49,34,6
MÉXICO,15,SAN FELIPE DEL PROGRESO,074,PALMILLAS,6,384,191,193,22
MÉXICO,15,SAN FELIPE DEL PROGRESO,074,PURÍSIMA CONCEPCIÓN MAYORAZGO (MAYORAZGO),11,1054,515,539,54
MÉXICO,15,SAN FELIPE DEL PROGRESO,074,RANCHERÍA EL CONSUELO (EL CARMEN),2,39,19,20,3
MÉXICO,15,SAN FELIPE DEL PROGRESO,074,RANCHERÍA LA CARRERA,2,54,21,33,5
MÉXICO,15,SAN FELIPE DEL PROGRESO,074,RANCHERÍA LA CIÉNEGA,3,460,219,241,24
MÉXICO,15,SAN FELIPE DEL PROGRESO,074,RANCHERÍA LA MANZANA,1,28,12,16,3
MÉXICO,15,SAN FELIPE DEL PROGRESO,074,RANCHERÍA LA SOLEDAD,4,273,129,144,10
MÉXICO,15,SAN FELIPE DEL PROGRESO,074,RANCHERÍA LA VIRGEN,5,231,114,117,12
MÉXICO,15,SAN FELIPE DEL PROGRESO,074,RINCÓN DE LOS PIRULES,4,453,250,203,30
MÉXICO,15,SAN FELIPE DEL PROGRESO,074,RIOYOS BUENAVISTA,8,936,477,459,48
MÉXICO,15,SAN FELIPE DEL PROGRESO,074,ROSA DEL CALVARIO,5,174,78,96,13
MÉXICO,15,SAN FELIPE DEL PROGRESO,074,SAN AGUSTÍN MEXTEPEC,5,861,411,450,30
MÉXICO,15,SAN FELIPE DEL PROGRESO,074,SAN ANTONIO DE LAS HUERTAS,5,912,471,441,55
MÉXICO,15,SAN FELIPE DEL PROGRESO,074,SAN ANTONIO LA CIÉNEGA (LA ROSA),5,609,317,292,33
MÉXICO,15,SAN FELIPE DEL PROGRESO,074,SAN ANTONIO MEXTEPEC,7,592,308,284,52
MÉXICO,15,SAN FELIPE DEL PROGRESO,074,SAN FELIPE DEL PROGRESO,18,7029,4209,2820,406
MÉXICO,15,SAN FELIPE DEL PROGRESO,074,SAN JERÓNIMO BONCHETE,5,779,380,399,62
MÉXICO,15,SAN FELIPE DEL PROGRESO,074,SAN JERÓNIMO MAVATÍ,5,276,145,131,15
MÉXICO,15,SAN FELIPE DEL PROGRESO,074,SAN JUAN COTÉ CENTRO,8,548,245,303,26
MÉXICO,15,SAN FELIPE DEL PROGRESO,074,SAN JUAN EVANGELISTA,2,69,28,41,5
MÉXICO,15,SAN FELIPE DEL PROGRESO,074,SAN JUAN JALPA CENTRO,10,562,257,305,31
MÉXICO,15,SAN FELIPE DEL PROGRESO,074,SAN JUAN RIOYOS,2,62,33,29,3
MÉXICO,15,SAN FELIPE DEL PROGRESO,074,SAN LUCAS OCOTEPEC,12,1009,528,481,78
MÉXICO,15,SAN FELIPE DEL PROGRESO,074,SAN MIGUEL LA LABOR,8,1693,875,818,96
MÉXICO,15,SAN FELIPE DEL PROGRESO,074,SAN NICOLÁS GUADALUPE,9,2040,1038,1002,85
MÉXICO,15,SAN FELIPE DEL PROGRESO,074,SAN NICOLÁS MAVATÍ,3,235,115,120,12
MÉXICO,15,SAN FELIPE DEL PROGRESO,074,SAN PABLO TLALCHICHILPA,3,401,198,203,20
MÉXICO,15,SAN FELIPE DEL PROGRESO,074,SAN PEDRO EL ALTO,10,2458,1253,1205,112
MÉXICO,15,SAN FELIPE DEL PROGRESO,074,SAN PEDRO EL CHICO,3,291,137,154,9
MÉXICO,15,SAN FELIPE DEL PROGRESO,074,SANTA ANA NICHI,4,1229,637,592,54
MÉXICO,15,SAN FELIPE DEL PROGRESO,074,SANTA ANA NICHI EJIDO,10,1136,564,572,52
MÉXICO,15,SAN FELIPE DEL PROGRESO,074,SANTA CRUZ MEXTEPEC,3,264,139,125,19
MÉXICO,15,SAN FELIPE DEL PROGRESO,074,SANTA RITA DE LA CUESTA,3,147,71,76,11
MÉXICO,15,SAN FELIPE DEL PROGRESO,074,TLALCHICHILPA,3,186,104,82,10
MÉXICO,15,SAN FELIPE DEL PROGRESO,074,TRES ESTRELLAS,5,425,229,196,24
MÉXICO,15,SAN MARTÍN DE LAS PIRÁMIDES,075,COLONIA ÁLVARO OBREGÓN,2,254,122,132,9
MÉXICO,15,SAN MARTÍN DE LAS PIRÁMIDES,075,IXTLAHUACA,4,564,296,268,29
MÉXICO,15,SAN MARTÍN DE LAS PIRÁMIDES,075,SAN ANTONIO DE LAS PALMAS,3,360,158,202,12
MÉXICO,15,SAN MARTÍN DE LAS PIRÁMIDES,075,SAN JOSÉ CERRO GORDO,2,31,14,17,3
MÉXICO,15,SAN MARTÍN DE LAS PIRÁMIDES,075,SAN MARTÍN DE LAS PIRÁMIDES,11,4155,2151,2004,241
MÉXICO,15,SAN MARTÍN DE LAS PIRÁMIDES,075,SAN PABLO IXQUITLÁN,6,763,381,382,41
MÉXICO,15,SAN MARTÍN DE LAS PIRÁMIDES,075,SANTA MARÍA PALAPA,3,404,207,197,14
MÉXICO,15,SAN MARTÍN DE LAS PIRÁMIDES,075,SANTA MARÍA TEZOMPA,1,15,7,8,1
MÉXICO,15,SAN MARTÍN DE LAS PIRÁMIDES,075,SANTIAGO TEPETITLÁN,3,233,129,104,11
MÉXICO,15,SAN MATEO ATENCO,076,BARRIO DE SAN FRANCISCO (SAN AGUSTÍN),1,28,20,8,10
MÉXICO,15,SAN MATEO ATENCO,076,SAN MATEO ATENCO,75,19601,9681,9920,928
MÉXICO,15,SAN MATEO ATENCO,076,SANTA MARÍA LA ASUNCIÓN,3,706,341,365,27
MÉXICO,15,SAN SIMÓN DE GUERRERO,077,BARRIO DE CRUZ VERDE,1,153,86,67,3
MÉXICO,15,SAN SIMÓN DE GUERRERO,077,BARRIO DEL MONTE,1,13,3,10,2
MÉXICO,15,SAN SIMÓN DE GUERRERO,077,BARRIO SAN JOSÉ (BARRIO TECOLOTE),2,56,23,33,5
MÉXICO,15,SAN SIMÓN DE GUERRERO,077,EL JOCOYOL CUENTLA (JOCOYOLES),2,28,14,14,3
MÉXICO,15,SAN SIMÓN DE GUERRERO,077,EL MANGO CUENTLA (EL MANGO),4,95,40,55,12
MÉXICO,15,SAN SIMÓN DE GUERRERO,077,EL MOMUSTLE,2,13,7,6,2
MÉXICO,15,SAN SIMÓN DE GUERRERO,077,EL ZAPOTE,2,20,12,8,3
MÉXICO,15,SAN SIMÓN DE GUERRERO,077,ESTANCIA VIEJA (SAN JOSÉ LA ESTANCIA),3,117,60,57,11
MÉXICO,15,SAN SIMÓN DE GUERRERO,077,GUARDARRAYA,2,42,20,22,5
MÉXICO,15,SAN SIMÓN DE GUERRERO,077,LA CUMBRE,2,12,5,7,2
MÉXICO,15,SAN SIMÓN DE GUERRERO,077,LA RINCONADA,2,14,9,5,2
MÉXICO,15,SAN SIMÓN DE GUERRERO,077,LOS BERROS CUENTLA,2,40,18,22,4
MÉXICO,15,SAN SIMÓN DE GUERRERO,077,PEÑA REDONDA,2,8,7,1,2
MÉXICO,15,SAN SIMÓN DE GUERRERO,077,RANCHO VIEJO CUENTLA (RANCHO VIEJO),4,51,23,28,8
MÉXICO,15,SAN SIMÓN DE GUERRERO,077,RINCÓN DE LOS TRIGOS,2,12,4,8,2
MÉXICO,15,SAN SIMÓN DE GUERRERO,077,SAN DIEGO CUENTLA (LLANO GRANDE),4,531,290,241,46
MÉXICO,15,SAN SIMÓN DE GUERRERO,077,SAN GABRIEL CUENTLA,4,203,95,108,11
MÉXICO,15,SAN SIMÓN DE GUERRERO,077,SAN SIMÓN DE GUERRERO,4,493,229,264,33
MÉXICO,15,SAN SIMÓN DE GUERRERO,077,TITIPAC CUENTLA (TITIPAC),2,17,7,10,3
MÉXICO,15,SANTO TOMÁS,078,EL JOCOYOL (SAN JOSÉ EL JOCOYOL),1,18,7,11,2
MÉXICO,15,SANTO TOMÁS,078,EL OCOTAL,1,7,4,3,1
MÉXICO,15,SANTO TOMÁS,078,EL SALITRE BRAMADOR,1,22,9,13,1
MÉXICO,15,SANTO TOMÁS,078,EL SIFÓN,1,20,10,10,1
MÉXICO,15,SANTO TOMÁS,078,FRONTÓN VIVERO,1,20,13,7,1
MÉXICO,15,SANTO TOMÁS,078,LA LAGUNA,1,5,0,5,1
MÉXICO,15,SANTO TOMÁS,078,LAS FINCAS,2,213,91,122,8
MÉXICO,15,SANTO TOMÁS,078,LOMA BONITA,1,66,24,42,5
MÉXICO,15,SANTO TOMÁS,078,OJO DE AGUA,3,66,33,33,5
MÉXICO,15,SANTO TOMÁS,078,POBLADO DE SANTO TOMÁS (EL PUERTO SAN ISIDRO),1,12,8,4,1
MÉXICO,15,SANTO TOMÁS,078,POTRERO DE ARRIBA (LA CEIBA),3,43,18,25,5
MÉXICO,15,SANTO TOMÁS,078,PUEBLO VIEJO,1,13,7,6,1
MÉXICO,15,SANTO TOMÁS,078,RINCÓN CHICO,2,130,55,75,8
MÉXICO,15,SANTO TOMÁS,078,RINCÓN VIVERO (EL MARACANÁ),2,95,48,47,7
MÉXICO,15,SANTO TOMÁS,078,SALITRE DE LA CAL (EL ZAPOTE),2,15,8,7,2
MÉXICO,15,SANTO TOMÁS,078,SALITRE TERREROS,2,41,15,26,3
MÉXICO,15,SANTO TOMÁS,078,SAN MIGUEL SANDEMIALMA,4,112,63,49,7
MÉXICO,15,SANTO TOMÁS,078,SAN PEDRO EL CHICO,1,4,1,3,1
MÉXICO,15,SANTO TOMÁS,078,SAN PEDRO EL GRANDE,1,5,1,4,1
MÉXICO,15,SANTO TOMÁS,078,SAN PEDRO IXTAPANTONGO (IXTAPANTONGO),2,101,58,43,4
MÉXICO,15,SANTO TOMÁS,078,SANTA BÁRBARA,3,86,39,47,7
MÉXICO,15,SANTO TOMÁS,078,SANTO TOMÁS DE LOS PLÁTANOS,7,1035,511,524,70
MÉXICO,15,SANTO TOMÁS,078,TACUITAPAN,2,70,40,30,5
MÉXICO,15,SOYANIQUILPAN DE JUÁREZ,079,EL DIVISADERO DE ZAPATA,4,158,79,79,13
MÉXICO,15,SOYANIQUILPAN DE JUÁREZ,079,EL DIVISADERO FRESNO (EL DIVISADERO),3,227,106,121,12
MÉXICO,15,SOYANIQUILPAN DE JUÁREZ,079,GAVILLERO DE SANTA ANA,1,24,12,12,2
MÉXICO,15,SOYANIQUILPAN DE JUÁREZ,079,IGNACIO ZARAGOZA (ZARAGOZA),5,240,121,119,16
MÉXICO,15,SOYANIQUILPAN DE JUÁREZ,079,LA GOLETA,2,47,23,24,3
MÉXICO,15,SOYANIQUILPAN DE JUÁREZ,079,PALOS ALTOS,3,95,37,58,6
MÉXICO,15,SOYANIQUILPAN DE JUÁREZ,079,SAN AGUSTÍN BUENAVISTA,4,218,88,130,12
MÉXICO,15,SOYANIQUILPAN DE JUÁREZ,079,SAN FRANCISCO SOYANIQUILPAN,11,2195,1105,1090,116
MÉXICO,15,SOYANIQUILPAN DE JUÁREZ,079,SAN ISIDRO (COLONIA SAN ISIDRO),2,34,21,13,3
MÉXICO,15,SOYANIQUILPAN DE JUÁREZ,079,SAN JOSÉ DEGUEDÓ,7,366,175,191,23
MÉXICO,15,SOYANIQUILPAN DE JUÁREZ,079,SAN JUAN DAXTHI,5,304,147,157,16
MÉXICO,15,SOYANIQUILPAN DE JUÁREZ,079,SAN JUAN DEL CUERVO (EL CUERVO),1,11,6,5,1
MÉXICO,15,SULTEPEC,080,ASERRADERO VIEJO,1,8,4,4,1
MÉXICO,15,SULTEPEC,080,ATZUMPA,5,178,85,93,15
MÉXICO,15,SULTEPEC,080,BARRIO LA LAGUNA,2,10,6,4,2
MÉXICO,15,SULTEPEC,080,CAPULA,3,347,174,173,16
MÉXICO,15,SULTEPEC,080,CAPULATENGO,2,8,3,5,1
MÉXICO,15,SULTEPEC,080,CIGUAPILA,3,20,10,10,3
MÉXICO,15,SULTEPEC,080,COJALTITLA,1,16,9,7,2
MÉXICO,15,SULTEPEC,080,COQUILLO,4,81,44,37,10
MÉXICO,15,SULTEPEC,080,CRUZ DE CEDRO,5,116,63,53,8
MÉXICO,15,SULTEPEC,080,CUATRO CRUCES,2,24,9,15,2
MÉXICO,15,SULTEPEC,080,DIEGO SÁNCHEZ,3,121,68,53,7
MÉXICO,15,SULTEPEC,080,EJIDO DE SULTEPEQUITO,3,82,46,36,8
MÉXICO,15,SULTEPEC,080,EJIDO LA VIRGEN,1,3,2,1,1
MÉXICO,15,SULTEPEC,080,EL CALVARITO,2,40,22,18,3
MÉXICO,15,SULTEPEC,080,EL HUIZACHE,2,29,13,16,3
MÉXICO,15,SULTEPEC,080,EL MOMOXTLE,3,27,8,19,3
MÉXICO,15,SULTEPEC,080,EL NARANJO,4,65,34,31,7
MÉXICO,15,SULTEPEC,080,EL PICACHO,2,37,28,9,5
MÉXICO,15,SULTEPEC,080,EL POTRERO (POTRERO DE GUADALUPE),3,38,18,20,4
MÉXICO,15,SULTEPEC,080,EL PUERTO DEL TEAMATE (PUERTO DE LAS MAJADAS),1,4,3,1,1
MÉXICO,15,SULTEPEC,080,EL RANCHITO,2,48,26,22,3
MÉXICO,15,SULTEPEC,080,EL RINCÓN DEL CRISTO (RINCONADA DEL CRISTO),6,101,48,53,12
MÉXICO,15,SULTEPEC,080,EL SALITRE,1,7,3,4,1
MÉXICO,15,SULTEPEC,080,EL TEAMATE,6,89,46,43,18
MÉXICO,15,SULTEPEC,080,FILO DE LOS AMATES,1,3,3,0,1
MÉXICO,15,SULTEPEC,080,HACIENDA DE REAL DE ABAJO (SANTA LUCÍA),1,17,6,11,1
MÉXICO,15,SULTEPEC,080,JALPAN (JALPA),8,174,96,78,20
MÉXICO,15,SULTEPEC,080,LA ALBARRADA,3,38,15,23,5
MÉXICO,15,SULTEPEC,080,LA CIÉNEGA,3,25,12,13,3
MÉXICO,15,SULTEPEC,080,LA TROJA VIEJA,2,29,19,10,3
MÉXICO,15,SULTEPEC,080,LA UNIÓN,2,23,11,12,2
MÉXICO,15,SULTEPEC,080,LAGUNA SECA,4,118,61,57,12
MÉXICO,15,SULTEPEC,080,LAGUNA VERDE,3,74,40,34,8
MÉXICO,15,SULTEPEC,080,LAS MESAS,4,88,45,43,7
MÉXICO,15,SULTEPEC,080,LAS PEÑAS,1,16,9,7,1
MÉXICO,15,SULTEPEC,080,LOS EPAZOTES,2,34,14,20,2
MÉXICO,15,SULTEPEC,080,MANIAL DE GUADALUPE DE ABAJO,3,29,11,18,3
MÉXICO,15,SULTEPEC,080,MANIAL DE GUADALUPE DE ARRIBA,4,56,30,26,9
MÉXICO,15,SULTEPEC,080,MANZANILLOS,2,17,5,12,2
MÉXICO,15,SULTEPEC,080,METLALTEPEC,4,106,52,54,13
MÉXICO,15,SULTEPEC,080,MEXTEPEC,4,141,81,60,13
MÉXICO,15,SULTEPEC,080,PEPECHUCA,2,25,13,12,2
MÉXICO,15,SULTEPEC,080,POTZONTEPEC,4,199,107,92,28
MÉXICO,15,SULTEPEC,080,PUENTE MOCHO,2,21,8,13,3
MÉXICO,15,SULTEPEC,080,PUENTECILLAS,4,178,90,88,12
MÉXICO,15,SULTEPEC,080,PUERTO FRÍO,4,19,12,7,4
MÉXICO,15,SULTEPEC,080,RANCHO SALINAS,2,31,12,19,3
MÉXICO,15,SULTEPEC,080,RINCÓN DE LOS AGUILARES,3,49,24,25,8
MÉXICO,15,SULTEPEC,080,RINCÓN DE OCOTITLÁN,3,20,10,10,3
MÉXICO,15,SULTEPEC,080,SAN FRANCISCO DE ASÍS,3,22,7,15,6
MÉXICO,15,SULTEPEC,080,SAN HIPÓLITO ZACATALES,2,9,7,2,2
MÉXICO,15,SULTEPEC,080,SAN ISIDRO XOCHITLA,4,141,73,68,9
MÉXICO,15,SULTEPEC,080,SAN JOSÉ EL POTRERO,3,37,24,13,3
MÉXICO,15,SULTEPEC,080,SAN JOSÉ XOCHITLA,3,64,25,39,6
MÉXICO,15,SULTEPEC,080,SAN LUCAS,3,63,31,32,5
MÉXICO,15,SULTEPEC,080,SAN MARTÍN,1,35,14,21,3
MÉXICO,15,SULTEPEC,080,SAN MIGUEL TERRERO,2,68,32,36,6
MÉXICO,15,SULTEPEC,080,SAN MIGUEL TOTOLMALOYA,4,248,142,106,17
MÉXICO,15,SULTEPEC,080,SAN MIGUELITO,2,37,18,19,4
MÉXICO,15,SULTEPEC,080,SAN NICOLÁS DEL COBRE (SAN NICOLÁS),3,24,7,17,4
MÉXICO,15,SULTEPEC,080,SAN PEDRO HUEYAHUALCO,6,261,129,132,21
MÉXICO,15,SULTEPEC,080,SANTA ANITA,3,68,41,27,6
MÉXICO,15,SULTEPEC,080,SANTA CRUZ (SANTA CRUZ TEXCALAPA),10,664,343,321,40
MÉXICO,15,SULTEPEC,080,SANTO TOMÁS DE LAS FLORES (SANTO TOMÁS),5,174,94,80,14
MÉXICO,15,SULTEPEC,080,SEGUNDA MANZANA DE CUATRO CRUCES,3,28,10,18,4
MÉXICO,15,SULTEPEC,080,SULTEPEC DE PEDRO ASCENCIO DE ALQUISIRAS,10,1806,1015,791,121
MÉXICO,15,SULTEPEC,080,SULTEPEQUITO,8,539,269,270,56
MÉXICO,15,SULTEPEC,080,TEHUILOTEPEC,4,64,30,34,10
MÉXICO,15,SULTEPEC,080,TENANGUILLO DE LAS PEÑAS,6,84,41,43,12
MÉXICO,15,SULTEPEC,080,TROJES,3,94,43,51,6
MÉXICO,15,TECÁMAC,081,AMPLIACIÓN SAN JERÓNIMO,2,123,55,68,7
MÉXICO,15,TECÁMAC,081,COLONIA SAN ISIDRO CITLALCÓATL,1,40,25,15,2
MÉXICO,15,TECÁMAC,081,COLONIA TEZONTLA,1,31,15,16,2
MÉXICO,15,TECÁMAC,081,EJIDO SAN ANDRÉS OZUMBILLA,1,534,298,236,18
MÉXICO,15,TECÁMAC,081,FRACCIONAMIENTO HACIENDA DEL BOSQUE,5,1494,730,764,60
MÉXICO,15,TECÁMAC,081,FRACCIONAMIENTO SANTA CRUZ TECÁMAC,1,154,78,76,6
MÉXICO,15,TECÁMAC,081,FRACCIONAMIENTO SOCIAL PROGRESIVO SANTO TOMÁS CHICONAUTLA,10,2093,1027,1066,97
MÉXICO,15,TECÁMAC,081,LA NOPALERA (LA CAÑADA),2,98,47,51,9
MÉXICO,15,TECÁMAC,081,LOS HÉROES SAN PABLO,1,362,174,188,13
MÉXICO,15,TECÁMAC,081,LOS REYES ACOZAC,15,3215,1571,1644,145
MÉXICO,15,TECÁMAC,081,OJO DE AGUA,89,20593,10132,10461,1257
MÉXICO,15,TECÁMAC,081,RANCHO LA LUZ,1,136,71,65,6
MÉXICO,15,TECÁMAC,081,RANCHO SAN NICOLÁS LA REDONDA,3,501,268,233,19
MÉXICO,15,TECÁMAC,081,SAN JUAN PUEBLO NUEVO,4,583,276,307,25
MÉXICO,15,TECÁMAC,081,SAN MARTÍN AZCATEPEC,21,4532,2286,2246,257
MÉXICO,15,TECÁMAC,081,SAN PABLO TECALCO,6,1185,609,576,49
MÉXICO,15,TECÁMAC,081,SAN PEDRO (EL TERREMOTO),3,861,390,471,37
MÉXICO,15,TECÁMAC,081,SANTA MARÍA AJOLOAPAN,18,3690,1769,1921,147
MÉXICO,15,TECÁMAC,081,SANTO DOMINGO,2,213,112,101,7
MÉXICO,15,TECÁMAC,081,SIERRA HERMOSA [UNIDAD DEPORTIVA REGIONAL],1,428,206,222,16
MÉXICO,15,TECÁMAC,081,TECÁMAC DE FELIPE VILLANUEVA,327,87313,44298,43015,5465
MÉXICO,15,TEJUPILCO,082,ACAMUCHITLÁN,3,39,18,21,7
MÉXICO,15,TEJUPILCO,082,AGUA BENDITA,2,13,7,6,2
MÉXICO,15,TEJUPILCO,082,AGUA NEGRA,2,34,12,22,3
MÉXICO,15,TEJUPILCO,082,ALMOLOYA DE LAS GRANADAS,4,227,102,125,17
MÉXICO,15,TEJUPILCO,082,ANTIMONIO,1,7,5,2,1
MÉXICO,15,TEJUPILCO,082,ANTIMONIO PANTOJA,4,67,38,29,6
MÉXICO,15,TEJUPILCO,082,ARBALLO,3,98,49,49,8
MÉXICO,15,TEJUPILCO,082,BARRANCA DE IXTAPAN,5,46,18,28,7
MÉXICO,15,TEJUPILCO,082,BEJUCOS,6,867,441,426,51
MÉXICO,15,TEJUPILCO,082,CAMPANARIO DE IXTAPAN (EL CAMPANARIO),2,65,35,30,5
MÉXICO,15,TEJUPILCO,082,CAÑADAS DE SAN SIMÓN (CAÑADA DE CHIVAS),3,17,8,9,5
MÉXICO,15,TEJUPILCO,082,CERRO ALTO (MILPA VIEJA),1,3,0,3,2
MÉXICO,15,TEJUPILCO,082,CERRO DE CACALOTEPEC (CACALOTEPEC),3,84,43,41,8
MÉXICO,15,TEJUPILCO,082,CERRO DE MAZATEPEC,2,33,19,14,3
MÉXICO,15,TEJUPILCO,082,CERRO DEL DIVISADERO,3,13,5,8,3
MÉXICO,15,TEJUPILCO,082,CERRO GORDO,2,105,60,45,5
MÉXICO,15,TEJUPILCO,082,CUADRILLA DE LEONES,4,34,17,17,4
MÉXICO,15,TEJUPILCO,082,CUADRILLA DE LÓPEZ,3,66,36,30,10
MÉXICO,15,TEJUPILCO,082,CUADRILLA DE LOS MARTÍNEZ (LOS MARTÍNEZ),3,128,55,73,9
MÉXICO,15,TEJUPILCO,082,CUADRILLA DEL MOLINO,2,15,11,4,2
MÉXICO,15,TEJUPILCO,082,CUEVILLAS,1,5,4,1,1
MÉXICO,15,TEJUPILCO,082,EL AGUACATE DE MONTE DE DIOS,2,19,10,9,3
MÉXICO,15,TEJUPILCO,082,EL CAPIRE (COLONIA EL CAPIRE),2,43,20,23,5
MÉXICO,15,TEJUPILCO,082,EL CAPIRE DE PANTOJA,3,25,15,10,3
MÉXICO,15,TEJUPILCO,082,EL CARMEN DE IXTAPAN,2,12,7,5,3
MÉXICO,15,TEJUPILCO,082,EL CIRIÁN DE LA LAGUNA (EL CIRIÁN),4,234,125,109,15
MÉXICO,15,TEJUPILCO,082,EL CIRUELO,1,10,2,8,1
MÉXICO,15,TEJUPILCO,082,EL MAMEY DE SAN LUCAS,2,18,9,9,3
MÉXICO,15,TEJUPILCO,082,EL PLATANAL (EL PLATANAL DE SAN LUCAS),5,141,71,70,11
MÉXICO,15,TEJUPILCO,082,EL POTRERO DE IXTAPAN (EL POTRERO),3,43,19,24,3
MÉXICO,15,TEJUPILCO,082,EL RODEO,5,606,329,277,40
MÉXICO,15,TEJUPILCO,082,EL SALITRE SEGUNDA SECCCIÓN,2,24,13,11,2
MÉXICO,15,TEJUPILCO,082,EL SAUZ OCOTEPEC (EL SAUZ),4,169,85,84,13
MÉXICO,15,TEJUPILCO,082,EL ZAPOTE DE ACAMUCHITLÁN (EL ZAPOTE),4,46,19,27,9
MÉXICO,15,TEJUPILCO,082,EL ZAPOTE DE IXTAPAN (EL ZAPOTE),1,10,7,3,2
MÉXICO,15,TEJUPILCO,082,ENCINOS VERDES,3,61,36,25,6
MÉXICO,15,TEJUPILCO,082,EPAZOTES,3,58,32,26,8
MÉXICO,15,TEJUPILCO,082,FUNDADORA DE SAN LUCAS DEL MAÍZ,4,55,28,27,9
MÉXICO,15,TEJUPILCO,082,HACIENDA DE IXTAPAN,2,56,24,32,5
MÉXICO,15,TEJUPILCO,082,JACALILLOS,1,19,8,11,1
MÉXICO,15,TEJUPILCO,082,JALPAN,1,50,24,26,3
MÉXICO,15,TEJUPILCO,082,JALPAN (JALPAN SAN SIMÓN),2,7,5,2,2
MÉXICO,15,TEJUPILCO,082,JULUAPAN (JULOAPAN),6,105,41,64,15
MÉXICO,15,TEJUPILCO,082,JUMILTEPEC,3,45,20,25,7
MÉXICO,15,TEJUPILCO,082,JUNTAS DE ZACATEPEC (EL PEDREGAL SEGUNDA MANZANA),3,171,91,80,13
MÉXICO,15,TEJUPILCO,082,LA CABECERA (CABECERA DE LOS ARRAYANES),3,71,40,31,8
MÉXICO,15,TEJUPILCO,082,LA CAÑADA,2,19,13,6,3
MÉXICO,15,TEJUPILCO,082,LA ESTANCIA DE IXTAPAN,3,145,75,70,11
MÉXICO,15,TEJUPILCO,082,LA FLORIDA (KILÓMETRO 5),2,35,22,13,4
MÉXICO,15,TEJUPILCO,082,LA GUITARRA,3,31,19,12,4
MÉXICO,15,TEJUPILCO,082,LA JOYA DE SAN LUCAS,1,4,2,2,1
MÉXICO,15,TEJUPILCO,082,LA LABOR DE ZARAGOZA,8,363,179,184,21
MÉXICO,15,TEJUPILCO,082,LA LAGUNA DE MAZATEPEC,3,47,20,27,4
MÉXICO,15,TEJUPILCO,082,LAS ÁNIMAS,3,17,7,10,4
MÉXICO,15,TEJUPILCO,082,LAS ANONAS,4,101,54,47,11
MÉXICO,15,TEJUPILCO,082,LAS JUNTAS,4,57,27,30,8
MÉXICO,15,TEJUPILCO,082,LAS JUNTAS DE IXTAPAN,1,39,17,22,4
MÉXICO,15,TEJUPILCO,082,LAS MESAS DE IXTAPAN (LAS MESAS),3,140,55,85,7
MÉXICO,15,TEJUPILCO,082,LIMÓN DE SAN LUCAS DEL MAÍZ,4,130,77,53,23
MÉXICO,15,TEJUPILCO,082,LLANO GRANDE,5,136,72,64,11
MÉXICO,15,TEJUPILCO,082,LLANO GRANDE (LLANO GRANDE DE SAN LUCAS),4,205,107,98,16
MÉXICO,15,TEJUPILCO,082,LODO PRIETO,4,242,112,130,18
MÉXICO,15,TEJUPILCO,082,LOMAS DE TEJUPILCO,3,109,52,57,22
MÉXICO,15,TEJUPILCO,082,LOS CUERVOS,1,13,10,3,1
MÉXICO,15,TEJUPILCO,082,LOS MELCHORES DE SAN LUCAS (LOS MELCHORES),2,85,43,42,5
MÉXICO,15,TEJUPILCO,082,LOS NOPALES,1,9,6,3,2
MÉXICO,15,TEJUPILCO,082,LOS PERICONES,3,60,30,30,7
MÉXICO,15,TEJUPILCO,082,MAZATEPEC,11,143,76,67,18
MÉXICO,15,TEJUPILCO,082,MONTE DE DIOS,4,105,57,48,14
MÉXICO,15,TEJUPILCO,082,OCOYAPAN,5,470,281,189,32
MÉXICO,15,TEJUPILCO,082,OJO DE AGUA (RINCÓN DE UGARTE),1,25,12,13,3
MÉXICO,15,TEJUPILCO,082,PANTOJA,3,108,56,52,9
MÉXICO,15,TEJUPILCO,082,PASO DE SAN JUAN,1,4,1,3,1
MÉXICO,15,TEJUPILCO,082,PASO DE VIGAS,1,4,1,3,1
MÉXICO,15,TEJUPILCO,082,PASO DEL GUAYABAL (EL PASO),3,80,34,46,7
MÉXICO,15,TEJUPILCO,082,PIEDRA ANCHA,1,16,8,8,1
MÉXICO,15,TEJUPILCO,082,PINZÁN MORADO,3,54,32,22,5
MÉXICO,15,TEJUPILCO,082,PLAN DE MAGUEY,3,14,3,11,3
MÉXICO,15,TEJUPILCO,082,PLAZA DE GALLOS,2,12,6,6,3
MÉXICO,15,TEJUPILCO,082,POTRERO GRANDE,2,5,1,4,2
MÉXICO,15,TEJUPILCO,082,PUERTO DE JALPAN (JALPA),4,28,17,11,6
MÉXICO,15,TEJUPILCO,082,PUERTO DEL AIRE,4,206,112,94,24
MÉXICO,15,TEJUPILCO,082,PUERTO MADROÑO,2,54,26,28,5
MÉXICO,15,TEJUPILCO,082,RANCHO LAS MORAS (LAS MORAS),2,47,26,21,4
MÉXICO,15,TEJUPILCO,082,RINCÓN DE AGUIRRE,4,527,261,266,25
MÉXICO,15,TEJUPILCO,082,RINCÓN DE JAIMES,2,450,238,212,23
MÉXICO,15,TEJUPILCO,082,RINCÓN DE LÓPEZ,6,1028,556,472,48
MÉXICO,15,TEJUPILCO,082,RINCÓN DE SAN GABRIEL,4,95,49,46,12
MÉXICO,15,TEJUPILCO,082,RINCÓN DE UGARTE,3,240,111,129,13
MÉXICO,15,TEJUPILCO,082,RINCÓN DEL CARMEN,4,329,145,184,17
MÉXICO,15,TEJUPILCO,082,RINCÓN DEL GUAYABAL,4,82,39,43,10
MÉXICO,15,TEJUPILCO,082,RINCÓN DEL NARANJO (LA CABECERA),2,17,7,10,2
MÉXICO,15,TEJUPILCO,082,RINCÓN EL SAUZ OCOTEPEC,2,12,7,5,2
MÉXICO,15,TEJUPILCO,082,RINCONADA DE LA LABOR,1,48,27,21,3
MÉXICO,15,TEJUPILCO,082,RÍO DE AQUIAGUA (AQUIAGUA),2,40,22,18,4
MÉXICO,15,TEJUPILCO,082,RÍO GRANDE,2,34,11,23,4
MÉXICO,15,TEJUPILCO,082,SALITRE DE ACAMUCHITLÁN (EL SALITRE),2,15,9,6,3
MÉXICO,15,TEJUPILCO,082,SALITRE DE SAN LUCAS,2,48,26,22,3
MÉXICO,15,TEJUPILCO,082,SALTO GRANDE,1,45,21,24,3
MÉXICO,15,TEJUPILCO,082,SAN ANDRÉS OCOTEPEC,12,549,281,268,40
MÉXICO,15,TEJUPILCO,082,SAN FRANCISCO,3,45,22,23,4
MÉXICO,15,TEJUPILCO,082,SAN GABRIEL PANTOJA,2,75,36,39,4
MÉXICO,15,TEJUPILCO,082,SAN JOSÉ DE LA LAGUNA,6,312,143,169,24
MÉXICO,15,TEJUPILCO,082,SAN LUCAS DEL MAÍZ (SAN LUCAS),4,152,82,70,10
MÉXICO,15,TEJUPILCO,082,SAN MATEO (SAN MATEO IXTAPAN),3,24,12,12,4
MÉXICO,15,TEJUPILCO,082,SAN MIGUEL IXTAPAN,8,1751,903,848,186
MÉXICO,15,TEJUPILCO,082,SANTA MARÍA DE LAS FLORES,3,57,30,27,8
MÉXICO,15,TEJUPILCO,082,SANTA ROSA RINCÓN DE JAIMES,3,41,22,19,4
MÉXICO,15,TEJUPILCO,082,SANTIAGO ARIZMENDI (ARIZMENDI),3,11,6,5,4
MÉXICO,15,TEJUPILCO,082,SANTO DOMINGO-ZACATEPEC,13,2105,1068,1037,136
MÉXICO,15,TEJUPILCO,082,SAUZ DE SAN LUCAS (EL SAUZ),4,166,88,78,14
MÉXICO,15,TEJUPILCO,082,SUQUITILA,2,110,44,66,7
MÉXICO,15,TEJUPILCO,082,TEJAPAN LIMONES (TEJAPAN),4,53,22,31,9
MÉXICO,15,TEJUPILCO,082,TEJUPILCO DE HIDALGO,39,8658,4629,4029,550
MÉXICO,15,TEJUPILCO,082,TENERÍA (PUEBLO NUEVO),6,293,138,155,22
MÉXICO,15,TEJUPILCO,082,TIRADOS,1,9,2,7,1
MÉXICO,15,TEJUPILCO,082,ZAPOTE DEL ANCÓN,2,15,9,6,3
MÉXICO,15,TEMAMATLA,083,EL CABI,1,176,90,86,6
MÉXICO,15,TEMAMATLA,083,LOS REYES ACATLIXHUAYAN,2,229,108,121,9
MÉXICO,15,TEMAMATLA,083,PREDIO DE LOS ALBERTOCOS,2,125,54,71,5
MÉXICO,15,TEMAMATLA,083,SANTIAGO ZULA,3,825,420,405,30
MÉXICO,15,TEMAMATLA,083,TEMAMATLA,8,2158,1064,1094,108
MÉXICO,15,TEMASCALAPA,084,COLONIA ÁLVARO OBREGÓN,3,31,11,20,4
MÉXICO,15,TEMASCALAPA,084,COLONIA SAN LUIS,2,41,22,19,9
MÉXICO,15,TEMASCALAPA,084,EX HACIENDA DE PAULA [CONJUNTO URBANO],2,169,94,75,14
MÉXICO,15,TEMASCALAPA,084,IXTLAHUACA DE CUAUHTÉMOC,5,1067,547,520,55
MÉXICO,15,TEMASCALAPA,084,LAS PINTAS,4,455,204,251,21
MÉXICO,15,TEMASCALAPA,084,PRESA DEL REY,4,236,113,123,12
MÉXICO,15,TEMASCALAPA,084,RANCHO MIHUACÁN,2,59,32,27,4
MÉXICO,15,TEMASCALAPA,084,SAN BARTOLOMÉ ACTOPAN,6,853,422,431,40
MÉXICO,15,TEMASCALAPA,084,SAN CRISTÓBAL COLHUACÁN,4,235,95,140,14
MÉXICO,15,TEMASCALAPA,084,SAN JUAN TEACALCO,5,945,454,491,51
MÉXICO,15,TEMASCALAPA,084,SAN LUIS TECUAUTITLÁN,6,1464,755,709,85
MÉXICO,15,TEMASCALAPA,084,SAN MATEO TEOPANCALA,3,313,156,157,12
MÉXICO,15,TEMASCALAPA,084,SAN MIGUEL ATLAMAJAC,4,598,277,321,21
MÉXICO,15,TEMASCALAPA,084,SANTA ANA TLACHIHUALPA,7,1492,744,748,59
MÉXICO,15,TEMASCALAPA,084,SANTA MARÍA MAQUIXCO (EL ALTO),3,141,75,66,10
MÉXICO,15,TEMASCALAPA,084,TEMASCALAPA,10,2256,1181,1075,184
MÉXICO,15,TEMASCALCINGO,085,AHUACATITLÁN CENTRO,5,699,345,354,34
MÉXICO,15,TEMASCALCINGO,085,BARRIO DE CORONA,2,55,32,23,3
MÉXICO,15,TEMASCALCINGO,085,BARRIO DE SHELLE,2,14,8,6,2
MÉXICO,15,TEMASCALCINGO,085,BOSHESDÁ,3,75,38,37,8
MÉXICO,15,TEMASCALCINGO,085,CALDERAS,2,145,74,71,9
MÉXICO,15,TEMASCALCINGO,085,CERRITOS DE CÁRDENAS,3,220,113,107,13
MÉXICO,15,TEMASCALCINGO,085,EL GARAY,2,33,14,19,3
MÉXICO,15,TEMASCALCINGO,085,EL RODEO,2,145,65,80,8
MÉXICO,15,TEMASCALCINGO,085,EL TEJOCOTE (LA LOMA),3,169,84,85,11
MÉXICO,15,TEMASCALCINGO,085,ESTACIÓN SOLÍS (ESTACIÓN ALBERTO GARDUÑO),1,20,10,10,1
MÉXICO,15,TEMASCALCINGO,085,EX-HACIENDA DE SOLÍS,6,1210,633,577,95
MÉXICO,15,TEMASCALCINGO,085,GUADALUPE IXTAPA,2,64,35,29,5
MÉXICO,15,TEMASCALCINGO,085,JUANACATLÁN,4,174,97,77,12
MÉXICO,15,TEMASCALCINGO,085,LA ESTANZUELA,1,21,13,8,1
MÉXICO,15,TEMASCALCINGO,085,LA HUERTA,1,13,4,9,1
MÉXICO,15,TEMASCALCINGO,085,LA LOMA DE SAN MATEO,2,48,22,26,3
MÉXICO,15,TEMASCALCINGO,085,LA MAGDALENA,7,1203,599,604,76
MÉXICO,15,TEMASCALCINGO,085,LA MAGDALENA BOSHÁ,1,40,25,15,1
MÉXICO,15,TEMASCALCINGO,085,LA MAGDALENA CRUZ BLANCA,3,448,205,243,17
MÉXICO,15,TEMASCALCINGO,085,LOS CHAMACUEROS,1,14,9,5,2
MÉXICO,15,TEMASCALCINGO,085,LOS PASTORES (PASTORES SEGUNDO BARRIO),1,97,47,50,7
MÉXICO,15,TEMASCALCINGO,085,MESA DE BAÑI,2,79,28,51,6
MÉXICO,15,TEMASCALCINGO,085,MESA DE BOMBARO,1,16,8,8,1
MÉXICO,15,TEMASCALCINGO,085,MESA DE LOS GARNICA,1,5,3,2,1
MÉXICO,15,TEMASCALCINGO,085,MESA DE SANTIAGO (LA MESA),1,23,11,12,2
MÉXICO,15,TEMASCALCINGO,085,PASTORES PRIMER BARRIO,4,191,88,103,13
MÉXICO,15,TEMASCALCINGO,085,PUEBLO NUEVO SOLÍS (LA ESTANCIA),4,264,139,125,14
MÉXICO,15,TEMASCALCINGO,085,PURUAHUA,3,246,99,147,11
MÉXICO,15,TEMASCALCINGO,085,SAN ANTONIO SOLÍS,5,322,165,157,24
MÉXICO,15,TEMASCALCINGO,085,SAN FRANCISCO SOLÍS,3,225,115,110,13
MÉXICO,15,TEMASCALCINGO,085,SAN FRANCISCO TEPEOLULCO,14,1711,848,863,88
MÉXICO,15,TEMASCALCINGO,085,SAN FRANCISCO TEPEOLULCO TERCER BARRIO EJIDO,1,21,8,13,2
MÉXICO,15,TEMASCALCINGO,085,SAN FRANCISCO TEPEOLULCO TERCER BARRIO LA MESA,1,43,22,21,4
MÉXICO,15,TEMASCALCINGO,085,SAN JOSÉ IXTAPA,3,193,104,89,16
MÉXICO,15,TEMASCALCINGO,085,SAN JOSÉ LOS REYES,2,35,20,15,4
MÉXICO,15,TEMASCALCINGO,085,SAN JOSÉ SOLÍS,4,186,97,89,16
MÉXICO,15,TEMASCALCINGO,085,SAN JUANICO CENTRO,3,144,64,80,9
MÉXICO,15,TEMASCALCINGO,085,SAN JUANICO EL ALTO (SAN JUANICO),6,930,481,449,76
MÉXICO,15,TEMASCALCINGO,085,SAN MATEO EL VIEJO,7,472,229,243,30
MÉXICO,15,TEMASCALCINGO,085,SAN MIGUEL SOLÍS,2,79,39,40,7
MÉXICO,15,TEMASCALCINGO,085,SAN NICOLÁS SOLÍS,3,240,127,113,15
MÉXICO,15,TEMASCALCINGO,085,SAN PEDRO EL ALTO,8,537,252,285,31
MÉXICO,15,TEMASCALCINGO,085,SAN PEDRO POTLA CENTRO,4,94,42,52,6
MÉXICO,15,TEMASCALCINGO,085,SAN PEDRO POTLA PRIMER BARRIO EJIDO,2,148,72,76,11
MÉXICO,15,TEMASCALCINGO,085,SAN PEDRO POTLA SEGUNDO BARRIO,2,28,14,14,4
MÉXICO,15,TEMASCALCINGO,085,SAN PEDRO POTLA TERCER BARRIO,3,48,26,22,4
MÉXICO,15,TEMASCALCINGO,085,SAN VICENTE SOLÍS,2,45,16,29,3
MÉXICO,15,TEMASCALCINGO,085,SANTA ANA YENSHU CENTRO,3,59,29,30,6
MÉXICO,15,TEMASCALCINGO,085,SANTA ANA YENSHU EJIDO,2,59,34,25,4
MÉXICO,15,TEMASCALCINGO,085,SANTA ANA YENSHU LA MESA,2,63,30,33,10
MÉXICO,15,TEMASCALCINGO,085,SANTA MARÍA CANCHESDA,5,399,194,205,24
MÉXICO,15,TEMASCALCINGO,085,SANTA MARÍA SOLÍS,1,18,8,10,1
MÉXICO,15,TEMASCALCINGO,085,SANTA ROSA SOLÍS,3,181,87,94,17
MÉXICO,15,TEMASCALCINGO,085,SANTIAGO COACHOCHITLÁN,12,1032,485,547,57
MÉXICO,15,TEMASCALCINGO,085,SANTIAGO COACHOCHITLÁN BARRIO DEL RINCÓN,1,75,44,31,5
MÉXICO,15,TEMASCALCINGO,085,TEMASCALCINGO DE JOSÉ MARÍA VELASCO,35,5422,2923,2499,521
MÉXICO,15,TEMASCALTEPEC,086,CAJONES,3,46,21,25,5
MÉXICO,15,TEMASCALTEPEC,086,CARNICERÍA,2,49,20,29,3
MÉXICO,15,TEMASCALTEPEC,086,CIENEGUILLAS DE GONZÁLEZ (CIENEGUILLAS),1,39,20,19,2
MÉXICO,15,TEMASCALTEPEC,086,CIENEGUILLAS DE LABRA,4,65,32,33,10
MÉXICO,15,TEMASCALTEPEC,086,EJIDO REAL DE ARRIBA,1,13,8,5,1
MÉXICO,15,TEMASCALTEPEC,086,EL CERRO PELÓN,3,91,35,56,9
MÉXICO,15,TEMASCALTEPEC,086,EL PEÑÓN,4,176,84,92,14
MÉXICO,15,TEMASCALTEPEC,086,EL SALITRE,4,215,103,112,14
MÉXICO,15,TEMASCALTEPEC,086,EL TULE,2,16,7,9,3
MÉXICO,15,TEMASCALTEPEC,086,EL VARAL,2,3,1,2,2
MÉXICO,15,TEMASCALTEPEC,086,GRANJAS DE CIENEGUILLAS,1,9,4,5,1
MÉXICO,15,TEMASCALTEPEC,086,HOYOS DE VÁZQUEZ,2,7,4,3,2
MÉXICO,15,TEMASCALTEPEC,086,JESÚS DEL MONTE,3,119,53,66,7
MÉXICO,15,TEMASCALTEPEC,086,LA ALBARRADA (SAN FRANCISCO LA ALBARRADA),3,247,120,127,14
MÉXICO,15,TEMASCALTEPEC,086,LA COMUNIDAD,4,377,183,194,22
MÉXICO,15,TEMASCALTEPEC,086,LA CUMBRE,3,40,24,16,3
MÉXICO,15,TEMASCALTEPEC,086,LA ESTANCIA DE TEQUESQUIPAN,5,239,117,122,16
MÉXICO,15,TEMASCALTEPEC,086,LA FINCA,3,179,87,92,13
MÉXICO,15,TEMASCALTEPEC,086,LA GUACAMAYA,6,130,61,69,12
MÉXICO,15,TEMASCALTEPEC,086,LA LAGUNA,2,35,18,17,4
MÉXICO,15,TEMASCALTEPEC,086,LA OREJETA,3,49,26,23,5
MÉXICO,15,TEMASCALTEPEC,086,LABOR LAS CABRAS,4,122,51,71,11
MÉXICO,15,TEMASCALTEPEC,086,LAMPAZOS,2,70,31,39,4
MÉXICO,15,TEMASCALTEPEC,086,LAS MESAS DE REAL DE ARRIBA,1,4,1,3,1
MÉXICO,15,TEMASCALTEPEC,086,LAS TRANCAS,3,20,10,10,3
MÉXICO,15,TEMASCALTEPEC,086,LOS OCOTES,4,142,73,69,12
MÉXICO,15,TEMASCALTEPEC,086,LOS TIMBRES,3,52,23,29,6
MÉXICO,15,TEMASCALTEPEC,086,MANZANA DE TEQUESQUIPAN (LAS MANZANAS),4,87,43,44,9
MÉXICO,15,TEMASCALTEPEC,086,MANZANA DEL JABALÍ,2,14,5,9,2
MÉXICO,15,TEMASCALTEPEC,086,MESÓN VIEJO,4,91,55,36,10
MÉXICO,15,TEMASCALTEPEC,086,MILPAS VIEJAS,3,62,36,26,4
MÉXICO,15,TEMASCALTEPEC,086,MINA DEL RINCÓN,2,14,7,7,2
MÉXICO,15,TEMASCALTEPEC,086,PEDREGALES DE TEQUESQUIPAN,2,118,60,58,8
MÉXICO,15,TEMASCALTEPEC,086,PLAN DE VIGAS,4,73,42,31,9
MÉXICO,15,TEMASCALTEPEC,086,POTRERO DE SAN JOSÉ (LA RINCONADA),6,351,166,185,23
MÉXICO,15,TEMASCALTEPEC,086,POTRERO DE TENAYAC,3,233,109,124,14
MÉXICO,15,TEMASCALTEPEC,086,PUEBLO NUEVO,2,43,21,22,4
MÉXICO,15,TEMASCALTEPEC,086,REAL DE ARRIBA,5,229,109,120,13
MÉXICO,15,TEMASCALTEPEC,086,RINCÓN DE ATARASQUILLO,4,177,73,104,12
MÉXICO,15,TEMASCALTEPEC,086,RINCÓN DE SAN ANDRÉS,2,183,88,95,9
MÉXICO,15,TEMASCALTEPEC,086,RINCÓN DE TEQUESQUIPAN,4,68,30,38,6
MÉXICO,15,TEMASCALTEPEC,086,SAN ANDRÉS DE LOS GAMA,4,379,196,183,23
MÉXICO,15,TEMASCALTEPEC,086,SAN ANTONIO ALBARRANES,4,174,85,89,14
MÉXICO,15,TEMASCALTEPEC,086,SAN FRANCISCO OXTOTILPAN,5,508,269,239,25
MÉXICO,15,TEMASCALTEPEC,086,SAN JUAN,2,48,22,26,4
MÉXICO,15,TEMASCALTEPEC,086,SAN LUCAS DEL PULQUE,6,444,236,208,25
MÉXICO,15,TEMASCALTEPEC,086,SAN MARTÍN TEQUESQUIPAN (TEQUESQUIPAN),5,357,176,181,32
MÉXICO,15,TEMASCALTEPEC,086,SAN MATEO ALMOMOLOA,6,480,213,267,26
MÉXICO,15,TEMASCALTEPEC,086,SAN MIGUEL OXTOTILPAN,5,231,123,108,16
MÉXICO,15,TEMASCALTEPEC,086,SAN PEDRO TENAYAC,4,625,304,321,49
MÉXICO,15,TEMASCALTEPEC,086,SAN SEBASTIÁN CARBONERAS (CARBONERAS),4,324,160,164,18
MÉXICO,15,TEMASCALTEPEC,086,SANTANAS,2,84,35,49,4
MÉXICO,15,TEMASCALTEPEC,086,TELPINTLA,2,49,12,37,4
MÉXICO,15,TEMASCALTEPEC,086,TEMASCALTEPEC DE GONZÁLEZ,10,2398,1218,1180,197
MÉXICO,15,TEMOAYA,087,BARRIO DE LAUREL 1RA. SECCIÓN,3,574,293,281,32
MÉXICO,15,TEMOAYA,087,BARRIO DE LAUREL 2DA. SECCIÓN,1,36,21,15,3
MÉXICO,15,TEMOAYA,087,CALLE REAL,5,382,190,192,18
MÉXICO,15,TEMOAYA,087,CAMPAMENTO KILÓMETRO 48,3,37,12,25,4
MÉXICO,15,TEMOAYA,087,CERRITO DEL PANAL,4,252,130,122,11
MÉXICO,15,TEMOAYA,087,COLONIA ADOLFO LÓPEZ MATEOS,3,87,42,45,5
MÉXICO,15,TEMOAYA,087,COLONIA CENTRO CEREMONIAL OTOMÍ,2,81,43,38,4
MÉXICO,15,TEMOAYA,087,COLONIA MORELOS,2,258,123,135,8
MÉXICO,15,TEMOAYA,087,EJIDO DE ALLENDE,3,348,178,170,18
MÉXICO,15,TEMOAYA,087,EJIDO DE DOLORES,3,478,219,259,17
MÉXICO,15,TEMOAYA,087,EJIDO DE MIMBRES,2,170,83,87,7
MÉXICO,15,TEMOAYA,087,EJIDO DE TABORDA,3,669,326,343,32
MÉXICO,15,TEMOAYA,087,ENTHAVI,15,1378,714,664,79
MÉXICO,15,TEMOAYA,087,FRACCIONAMIENTO RINCONADA DEL VALLE,1,143,52,91,25
MÉXICO,15,TEMOAYA,087,HACIENDA LAS TROJES,3,314,157,157,21
MÉXICO,15,TEMOAYA,087,JIQUIPILCO EL VIEJO,8,1414,747,667,93
MÉXICO,15,TEMOAYA,087,LA CAÑADA,4,278,139,139,20
MÉXICO,15,TEMOAYA,087,LA MAGDALENA TENEXPAN,11,1094,543,551,69
MÉXICO,15,TEMOAYA,087,LLANO DE LA Y,2,483,255,228,19
MÉXICO,15,TEMOAYA,087,LOMA ALTA,2,75,37,38,5
MÉXICO,15,TEMOAYA,087,LOMA DE PROGRESO,2,56,23,33,3
MÉXICO,15,TEMOAYA,087,LOMA DE SAN NICOLÁS,2,343,171,172,12
MÉXICO,15,TEMOAYA,087,LUIS DONALDO COLOSIO MURRIETA,1,96,45,51,6
MÉXICO,15,TEMOAYA,087,MOLINO ABAJO,4,846,437,409,27
MÉXICO,15,TEMOAYA,087,POTHÉ,2,233,111,122,8
MÉXICO,15,TEMOAYA,087,RANCHERÍA DE TROJES (SAN ANTONIO DEL PUENTE),3,786,401,385,31
MÉXICO,15,TEMOAYA,087,RANCHERÍA LAS LOMAS,3,445,232,213,32
MÉXICO,15,TEMOAYA,087,SAN ANTONIO DEL PUENTE,4,1195,608,587,51
MÉXICO,15,TEMOAYA,087,SAN DIEGO ALCALÁ,9,1590,854,736,75
MÉXICO,15,TEMOAYA,087,SAN JOSÉ BUENAVISTA EL GRANDE,6,1341,661,680,51
MÉXICO,15,TEMOAYA,087,SAN JOSÉ COMALCO,4,477,251,226,24
MÉXICO,15,TEMOAYA,087,SAN JOSÉ LAS LOMAS,3,479,224,255,24
MÉXICO,15,TEMOAYA,087,SAN JOSÉ PATHÉ,3,243,108,135,16
MÉXICO,15,TEMOAYA,087,SAN LORENZO OYAMEL,7,1588,808,780,62
MÉXICO,15,TEMOAYA,087,SAN LUCAS,1,38,14,24,1
MÉXICO,15,TEMOAYA,087,SAN MATEO ALCALÁ,1,143,74,69,6
MÉXICO,15,TEMOAYA,087,SAN PEDRO ABAJO,4,936,458,478,39
MÉXICO,15,TEMOAYA,087,SAN PEDRO ABAJO 2DA. SECCIÓN (LOMA LARGA),3,626,322,304,31
MÉXICO,15,TEMOAYA,087,SAN PEDRO ARRIBA,8,1863,918,945,97
MÉXICO,15,TEMOAYA,087,SAN PEDRO ARRIBA 1RA. SECCIÓN,3,252,126,126,12
MÉXICO,15,TEMOAYA,087,SAN PEDRO ARRIBA 2DA. SECCIÓN,3,574,289,285,34
MÉXICO,15,TEMOAYA,087,SAN PEDRO ARRIBA 3RA. SECCIÓN,1,478,264,214,41
MÉXICO,15,TEMOAYA,087,SAN PEDRO ARRIBA 4TA. SECCIÓN (CINCO REALES),1,52,24,28,3
MÉXICO,15,TEMOAYA,087,SAN PEDRO ARRIBA 5TA. SECCIÓN (SAN LORENCITO),3,73,37,36,5
MÉXICO,15,TEMOAYA,087,SAN PEDRO ARRIBA 6TA. SECCIÓN,4,87,48,39,5
MÉXICO,15,TEMOAYA,087,SOLALPAN 1RA. SECCIÓN,3,305,150,155,20
MÉXICO,15,TEMOAYA,087,TEMOAYA,12,3657,2070,1587,273
MÉXICO,15,TEMOAYA,087,TIERRA BLANCA,1,181,87,94,6
MÉXICO,15,TEMOAYA,087,TLALTENANGO ARRIBA,4,2197,1165,1032,149
MÉXICO,15,TEMOAYA,087,TLALTENANGUITO,4,383,185,198,22
MÉXICO,15,TEMOAYA,087,VISTA HERMOSA,1,18,9,9,2
MÉXICO,15,TEMOAYA,087,ZANJA VIEJA,2,115,56,59,7
MÉXICO,15,TENANCINGO,088,ACATZINGO (ACATZINGO DE LA PIEDRA),3,406,197,209,21
MÉXICO,15,TENANCINGO,088,AGUA BENDITA,5,251,127,124,13
MÉXICO,15,TENANCINGO,088,AGUA DULCE,3,14,7,7,3
MÉXICO,15,TENANCINGO,088,BARRIO SANTA TERESA,1,268,133,135,11
MÉXICO,15,TENANCINGO,088,CHALCHIHUAPAN,4,268,135,133,13
MÉXICO,15,TENANCINGO,088,COLONIA EJÉRCITO DEL TRABAJO,2,141,68,73,8
MÉXICO,15,TENANCINGO,088,COLONIA EMILIANO ZAPATA EJIDO DE TENANCINGO,2,367,184,183,17
MÉXICO,15,TENANCINGO,088,COLONIA EMILIANO ZAPATA EJIDO TEPETZINGO,2,76,32,44,4
MÉXICO,15,TENANCINGO,088,COLONIA GUADALUPE VICTORIA,3,143,60,83,10
MÉXICO,15,TENANCINGO,088,COLONIA MORELOS,2,136,53,83,7
MÉXICO,15,TENANCINGO,088,COLONIA SAN FRANCISCO TEPETZINGO,1,63,34,29,8
MÉXICO,15,TENANCINGO,088,CRUZ VIDRIADA,2,179,87,92,8
MÉXICO,15,TENANCINGO,088,EL CARMEN (EL DESIERTO DEL CARMEN),4,265,132,133,13
MÉXICO,15,TENANCINGO,088,EL SALITRE,10,2370,1420,950,196
MÉXICO,15,TENANCINGO,088,FRANCISCO ZARCO,2,22,15,7,2
MÉXICO,15,TENANCINGO,088,GUALUPITA,1,36,19,17,2
MÉXICO,15,TENANCINGO,088,IXPUICHIAPAN,3,162,70,92,9
MÉXICO,15,TENANCINGO,088,LA CIÉNEGA,4,924,430,494,46
MÉXICO,15,TENANCINGO,088,LA COMPUERTA,4,244,113,131,15
MÉXICO,15,TENANCINGO,088,LA LAGUNILLA,4,271,135,136,14
MÉXICO,15,TENANCINGO,088,LA MESITA,2,30,18,12,3
MÉXICO,15,TENANCINGO,088,LA OCOTALERA,1,70,40,30,4
MÉXICO,15,TENANCINGO,088,LA TRINIDAD,4,2416,1341,1075,237
MÉXICO,15,TENANCINGO,088,LOS MORALES,2,61,33,28,4
MÉXICO,15,TENANCINGO,088,PLAN DE GUADALUPE,3,20,7,13,3
MÉXICO,15,TENANCINGO,088,PLAN DE SAN MARTÍN,1,9,6,3,1
MÉXICO,15,TENANCINGO,088,PUEBLO NUEVO,2,147,75,72,8
MÉXICO,15,TENANCINGO,088,QUETZALAPA,2,145,78,67,8
MÉXICO,15,TENANCINGO,088,RINCONADA DE ATOTONILCO,2,38,17,21,3
MÉXICO,15,TENANCINGO,088,RINCONADA DE SANTA TERESA,2,64,29,35,4
MÉXICO,15,TENANCINGO,088,SAN ANTONIO AGUA BENDITA,1,67,37,30,2
MÉXICO,15,TENANCINGO,088,SAN DIEGO,2,139,64,75,8
MÉXICO,15,TENANCINGO,088,SAN GABRIEL ZEPAYAUTLA,4,516,262,254,24
MÉXICO,15,TENANCINGO,088,SAN JOSÉ CHALMITA,3,225,110,115,11
MÉXICO,15,TENANCINGO,088,SAN JOSÉ EL CUARTEL,3,644,333,311,34
MÉXICO,15,TENANCINGO,088,SAN JOSÉ TENERÍA (TENERÍA),6,1215,353,862,100
MÉXICO,15,TENANCINGO,088,SAN JUAN TETITLÁN,2,155,83,72,7
MÉXICO,15,TENANCINGO,088,SAN JUAN XOCHIACA,4,812,386,426,57
MÉXICO,15,TENANCINGO,088,SAN MARTÍN COAPAXTONGO,5,745,380,365,35
MÉXICO,15,TENANCINGO,088,SAN MIGUEL TECOMATLÁN,5,1330,650,680,58
MÉXICO,15,TENANCINGO,088,SAN NICOLÁS,4,575,284,291,29
MÉXICO,15,TENANCINGO,088,SAN PEDRO EJIDO TECOMATLÁN,3,238,114,124,12
MÉXICO,15,TENANCINGO,088,SAN SIMONITO,4,333,168,165,19
MÉXICO,15,TENANCINGO,088,SANTA ANA IXTLAHUATZINGO (SANTA ANA),9,3336,1743,1593,283
MÉXICO,15,TENANCINGO,088,SANTA CRUZ XOCHIACA,2,18,10,8,4
MÉXICO,15,TENANCINGO,088,SANTA TERESITA ACATZINGO,2,219,102,117,8
MÉXICO,15,TENANCINGO,088,TENANCINGO DE DEGOLLADO,41,8188,4232,3956,467
MÉXICO,15,TENANCINGO,088,TEPALCATEPEC,3,651,310,341,28
MÉXICO,15,TENANCINGO,088,TEPETZINGO,5,957,481,476,117
MÉXICO,15,TENANCINGO,088,TEPOXTEPEC,5,704,352,352,34
MÉXICO,15,TENANCINGO,088,TERRENATE,2,99,47,52,4
MÉXICO,15,TENANCINGO,088,TIERRA BLANCA,2,189,82,107,9
MÉXICO,15,TENANGO DEL AIRE,089,SAN JUAN COXTOCAN,3,223,113,110,11
MÉXICO,15,TENANGO DEL AIRE,089,SANTIAGO TEPOPULA,4,495,220,275,25
MÉXICO,15,TENANGO DEL AIRE,089,TENANGO DEL AIRE,11,1962,955,1007,111
MÉXICO,15,TENANGO DEL VALLE,090,ACATZINGO,3,33,16,17,4
MÉXICO,15,TENANGO DEL VALLE,090,EL COLOSO,2,266,142,124,11
MÉXICO,15,TENANGO DEL VALLE,090,EL ZARZAL,1,77,39,38,3
MÉXICO,15,TENANGO DEL VALLE,090,LA AZTECA,1,113,69,44,5
MÉXICO,15,TENANGO DEL VALLE,090,LA COOPERATIVA,1,16,11,5,1
MÉXICO,15,TENANGO DEL VALLE,090,LA HACIENDITA,2,123,63,60,6
MÉXICO,15,TENANGO DEL VALLE,090,LA ISLETA,2,70,30,40,4
MÉXICO,15,TENANGO DEL VALLE,090,SAN BARTOLOMÉ ATLATLAHUCA,11,1998,1016,982,91
MÉXICO,15,TENANGO DEL VALLE,090,SAN FRANCISCO PUTLA,6,895,429,466,56
MÉXICO,15,TENANGO DEL VALLE,090,SAN FRANCISCO TEPEXOXUCA,6,921,459,462,49
MÉXICO,15,TENANGO DEL VALLE,090,SAN FRANCISCO TETETLA,4,683,354,329,26
MÉXICO,15,TENANGO DEL VALLE,090,SAN ISIDRO,4,107,53,54,8
MÉXICO,15,TENANGO DEL VALLE,090,SAN MIGUEL BALDERAS,8,1480,755,725,75
MÉXICO,15,TENANGO DEL VALLE,090,SAN PEDRO TLANIXCO,8,2465,1244,1221,116
MÉXICO,15,TENANGO DEL VALLE,090,SAN PEDRO ZICTEPEC,7,1637,814,823,99
MÉXICO,15,TENANGO DEL VALLE,090,SAN ROMÁN,2,42,20,22,2
MÉXICO,15,TENANGO DEL VALLE,090,SANTA CRUZ PUEBLO NUEVO,6,636,318,318,27
MÉXICO,15,TENANGO DEL VALLE,090,SANTA MARÍA JAJALPA,6,1297,648,649,62
MÉXICO,15,TENANGO DEL VALLE,090,SANTIAGUITO CUAXUSTENCO,6,1395,732,663,63
MÉXICO,15,TENANGO DEL VALLE,090,TENANGO DE ARISTA,47,9385,4587,4798,945
MÉXICO,15,TEOLOYUCAN,091,COLONIA SANTO TOMÁS,2,332,166,166,14
MÉXICO,15,TEOLOYUCAN,091,SAN BARTOLO,6,1145,568,577,39
MÉXICO,15,TEOLOYUCAN,091,SAN SEBASTIÁN,3,878,441,437,31
MÉXICO,15,TEOLOYUCAN,091,SANTA MARÍA CALIACAC,6,1167,596,571,59
MÉXICO,15,TEOLOYUCAN,091,TEOLOYUCAN,80,20997,10614,10383,1080
MÉXICO,15,TEOTIHUACÁN,092,ATLATONGO,7,1861,937,924,109
MÉXICO,15,TEOTIHUACÁN,092,EJIDO DE SANTA MARÍA COATLÁN,6,757,355,402,40
MÉXICO,15,TEOTIHUACÁN,092,EL POTRERO (EJIDO PURIFICACIÓN),1,130,77,53,18
MÉXICO,15,TEOTIHUACÁN,092,METEPEC (ESTACIÓN METEPEC),1,27,17,10,2
MÉXICO,15,TEOTIHUACÁN,092,SAN AGUSTÍN ACTIPAC,4,232,119,113,14
MÉXICO,15,TEOTIHUACÁN,092,SAN FRANCISCO MAZAPA,4,810,380,430,57
MÉXICO,15,TEOTIHUACÁN,092,SAN ISIDRO DEL PROGRESO,2,68,29,39,4
MÉXICO,15,TEOTIHUACÁN,092,SAN JUAN TEOTIHUACÁN,12,3704,1730,1974,236
MÉXICO,15,TEOTIHUACÁN,092,SAN LORENZO TLALMIMILOLPAN,7,1231,598,633,51
MÉXICO,15,TEOTIHUACÁN,092,SAN SEBASTIÁN XOLALPA,6,1370,726,644,102
MÉXICO,15,TEOTIHUACÁN,092,SANTA MARÍA COZOTLÁN,2,180,92,88,9
MÉXICO,15,TEOTIHUACÁN,092,SANTIAGO ZACUALUCA,4,547,275,272,21
MÉXICO,15,TEOTIHUACÁN,092,TEOTIHUACÁN DE ARISTA,45,8645,4476,4169,640
MÉXICO,15,TEPETLAOXTOC,093,COLONIA LA LOMA (LA LOMA SAN ISIDRO),2,52,23,29,4
MÉXICO,15,TEPETLAOXTOC,093,COLONIA SANTIAGO,1,28,16,12,2
MÉXICO,15,TEPETLAOXTOC,093,COLONIA TULTECA TEOPAN,4,277,134,143,14
MÉXICO,15,TEPETLAOXTOC,093,CONCEPCIÓN JOLALPAN,5,646,343,303,29
MÉXICO,15,TEPETLAOXTOC,093,LA VENTA (LA LOMA),3,32,15,17,4
MÉXICO,15,TEPETLAOXTOC,093,LOS REYES NOPALA,1,22,14,8,1
MÉXICO,15,TEPETLAOXTOC,093,SAN ANDRÉS DE LAS PERAS,2,287,135,152,10
MÉXICO,15,TEPETLAOXTOC,093,SAN BERNARDO TLALMIMILOLPAN,3,437,199,238,29
MÉXICO,15,TEPETLAOXTOC,093,SAN JOSÉ BELLAVISTA,1,11,5,6,1
MÉXICO,15,TEPETLAOXTOC,093,SAN JUAN TOTOLAPAN,4,375,186,189,15
MÉXICO,15,TEPETLAOXTOC,093,SAN PEDRO CHIAUTZINGO,5,575,277,298,29
MÉXICO,15,TEPETLAOXTOC,093,SANTO TOMÁS APIPILHUASCO (SANTO TOMÁS),5,877,421,456,39
MÉXICO,15,TEPETLAOXTOC,093,TEPETLAOXTOC DE HIDALGO,14,1601,795,806,216
MÉXICO,15,TEPETLIXPA,094,ALOTEPEC,2,39,19,20,3
MÉXICO,15,TEPETLIXPA,094,NEPANTLA DE SOR JUANA INÉS DE LA CRUZ,6,567,291,276,41
MÉXICO,15,TEPETLIXPA,094,SAN ESTEBAN CUECUECUAUTITLA,3,374,196,178,15
MÉXICO,15,TEPETLIXPA,094,TEPETLIXPA,18,3782,1957,1825,231
MÉXICO,15,TEPOTZOTLÁN,095,ARCOS DEL SITIO,3,54,29,25,4
MÉXICO,15,TEPOTZOTLÁN,095,BARRIO DE LA LUZ,1,165,78,87,6
MÉXICO,15,TEPOTZOTLÁN,095,CAÑADA DE CISNEROS,6,801,402,399,32
MÉXICO,15,TEPOTZOTLÁN,095,COLONIA LOS DOLORES (EX-HACIENDA LOS DOLORES),6,243,111,132,18
MÉXICO,15,TEPOTZOTLÁN,095,EJIDO DE COYOTEPEC,1,164,69,95,8
MÉXICO,15,TEPOTZOTLÁN,095,LA CONCEPCIÓN,4,273,135,138,15
MÉXICO,15,TEPOTZOTLÁN,095,LA ESTANCIA II,3,39,18,21,4
MÉXICO,15,TEPOTZOTLÁN,095,LA LUZ,1,87,46,41,4
MÉXICO,15,TEPOTZOTLÁN,095,LOMA DE SAN JOSÉ Y PARAJE EL CAPIRO,1,10,6,4,1
MÉXICO,15,TEPOTZOTLÁN,095,SAN MATEO XOLOC,8,1446,733,713,77
MÉXICO,15,TEPOTZOTLÁN,095,SAN MIGUEL CAÑADAS,4,497,235,262,21
MÉXICO,15,TEPOTZOTLÁN,095,SAN SEBASTIÁN,1,150,76,74,7
MÉXICO,15,TEPOTZOTLÁN,095,SANTA CRUZ,5,909,467,442,40
MÉXICO,15,TEPOTZOTLÁN,095,SANTA CRUZ DEL MONTE,4,725,350,375,33
MÉXICO,15,TEPOTZOTLÁN,095,SANTIAGO CUAUTLALPAN,14,3071,1608,1463,136
MÉXICO,15,TEPOTZOTLÁN,095,TEPOTZOTLÁN,69,12940,6586,6354,698
MÉXICO,15,TEPOTZOTLÁN,095,TIERRAS BLANCAS DEL SUR,3,81,35,46,7
MÉXICO,15,TEQUIXQUIAC,096,COLONIA EJIDAL GENERAL WENCESLAO LABRA,3,598,309,289,25
MÉXICO,15,TEQUIXQUIAC,096,SAN MIGUEL,3,418,204,214,18
MÉXICO,15,TEQUIXQUIAC,096,TEQUIXQUIAC,30,6681,3342,3339,437
MÉXICO,15,TEQUIXQUIAC,096,TLAPANALOYA,8,1589,759,830,94
MÉXICO,15,TEXCALTITLÁN,097,ACATITLÁN,3,400,210,190,24
MÉXICO,15,TEXCALTITLÁN,097,AGUA DEL TRÉBOL,3,14,7,7,3
MÉXICO,15,TEXCALTITLÁN,097,ARROYO SECO,2,110,51,59,6
MÉXICO,15,TEXCALTITLÁN,097,CARBAJAL,4,83,52,31,9
MÉXICO,15,TEXCALTITLÁN,097,CHIQUIUNTEPEC (CHIQUINTEPEC),4,120,65,55,10
MÉXICO,15,TEXCALTITLÁN,097,EJIDO VENTA MORALES (LA LAGUNA),3,102,48,54,6
MÉXICO,15,TEXCALTITLÁN,097,EL AGOSTADERO,4,105,54,51,10
MÉXICO,15,TEXCALTITLÁN,097,EL CHAPANEAL,4,197,94,103,13
MÉXICO,15,TEXCALTITLÁN,097,GAVIA CHICA (RINCÓN),3,104,50,54,6
MÉXICO,15,TEXCALTITLÁN,097,HUEYATENCO,6,243,135,108,31
MÉXICO,15,TEXCALTITLÁN,097,JESÚS DEL MONTE,2,69,36,33,4
MÉXICO,15,TEXCALTITLÁN,097,LAS LÁGRIMAS,4,140,66,74,10
MÉXICO,15,TEXCALTITLÁN,097,LAS TABLAS (LAS TABLAS SAN JOSÉ),2,56,21,35,4
MÉXICO,15,TEXCALTITLÁN,097,LLANO GRANDE,2,68,29,39,4
MÉXICO,15,TEXCALTITLÁN,097,LOS LIRIOS,3,60,28,32,5
MÉXICO,15,TEXCALTITLÁN,097,NOXTEPEC,2,40,11,29,2
MÉXICO,15,TEXCALTITLÁN,097,NUEVA SANTA MARÍA,4,141,72,69,11
MÉXICO,15,TEXCALTITLÁN,097,OJO DE AGUA,2,56,31,25,3
MÉXICO,15,TEXCALTITLÁN,097,PALMILLAS,4,194,93,101,13
MÉXICO,15,TEXCALTITLÁN,097,PALO AMARILLO,4,130,70,60,9
MÉXICO,15,TEXCALTITLÁN,097,RASTROJO LARGO,3,44,22,22,3
MÉXICO,15,TEXCALTITLÁN,097,SAN AGUSTÍN,3,531,247,284,26
MÉXICO,15,TEXCALTITLÁN,097,SAN FRANCISCO,4,233,130,103,16
MÉXICO,15,TEXCALTITLÁN,097,SAN JOSÉ,2,49,20,29,5
MÉXICO,15,TEXCALTITLÁN,097,SAN MIGUEL,3,707,385,322,84
MÉXICO,15,TEXCALTITLÁN,097,SANTA MARÍA,4,128,62,66,11
MÉXICO,15,TEXCALTITLÁN,097,TEXCALTITLÁN,2,519,239,280,26
MÉXICO,15,TEXCALTITLÁN,097,TEXCAPILLA,4,415,205,210,31
MÉXICO,15,TEXCALTITLÁN,097,TLACOTEPEC,2,71,31,40,4
MÉXICO,15,TEXCALTITLÁN,097,VENTA MORALES (EL PEDREGAL),6,248,114,134,23
MÉXICO,15,TEXCALTITLÁN,097,YUYTEPEC,3,61,29,32,5
MÉXICO,15,TEXCALYACAC,098,BARRIO MEXICAPAN,1,58,25,33,3
MÉXICO,15,TEXCALYACAC,098,BARRIO OTOMPA,1,87,50,37,6
MÉXICO,15,TEXCALYACAC,098,SAN MATEO TEXCALYACAC,4,1220,613,607,82
MÉXICO,15,TEXCOCO,099,COLONIA GUADALUPE VICTORIA,3,260,126,134,11
MÉXICO,15,TEXCOCO,099,COLONIA LÁZARO CÁRDENAS,1,53,26,27,3
MÉXICO,15,TEXCOCO,099,COLONIA LEYES DE REFORMA,2,145,66,79,10
MÉXICO,15,TEXCOCO,099,EJIDO SAN JUAN TEZONTLA,2,609,344,265,139
MÉXICO,15,TEXCOCO,099,GUADALUPE AMANALCO,4,190,101,89,10
MÉXICO,15,TEXCOCO,099,LA MAGDALENA PANOAYA,1,132,55,77,6
MÉXICO,15,TEXCOCO,099,LA PURIFICACIÓN TEPETITLA,3,638,317,321,29
MÉXICO,15,TEXCOCO,099,LA RESURRECCIÓN,1,67,35,32,3
MÉXICO,15,TEXCOCO,099,LA TRINIDAD,5,1116,562,554,67
MÉXICO,15,TEXCOCO,099,LOMAS DE CRISTO,4,1163,568,595,42
MÉXICO,15,TEXCOCO,099,LOMAS DE SAN ESTEBAN,5,232,109,123,29
MÉXICO,15,TEXCOCO,099,LOS REYES SAN SALVADOR,1,164,73,91,7
MÉXICO,15,TEXCOCO,099,MONTECILLO,13,2102,1080,1022,268
MÉXICO,15,TEXCOCO,099,PENTECOSTÉS,1,16,8,8,6
MÉXICO,15,TEXCOCO,099,SAN BERNARDINO,10,1077,499,578,64
MÉXICO,15,TEXCOCO,099,SAN DIEGO,5,820,410,410,46
MÉXICO,15,TEXCOCO,099,SAN DIEGUITO XOCHIMANCA,6,480,221,259,28
MÉXICO,15,TEXCOCO,099,SAN FELIPE DE JESÚS,2,320,155,165,13
MÉXICO,15,TEXCOCO,099,SAN JERÓNIMO AMANALCO,10,1836,928,908,97
MÉXICO,15,TEXCOCO,099,SAN JOAQUÍN COAPANGO,6,593,302,291,39
MÉXICO,15,TEXCOCO,099,SAN JOSÉ TEXOPA,2,231,104,127,11
MÉXICO,15,TEXCOCO,099,SAN JUAN TEZONTLA,2,211,107,104,9
MÉXICO,15,TEXCOCO,099,SAN MATEO HUEXOTLA,4,518,242,276,63
MÉXICO,15,TEXCOCO,099,SAN MIGUEL COATLINCHÁN,22,5248,2551,2697,286
MÉXICO,15,TEXCOCO,099,SAN MIGUEL TLAIXPAN,11,2873,1537,1336,167
MÉXICO,15,TEXCOCO,099,SAN MIGUEL TOCUILA,3,428,210,218,18
MÉXICO,15,TEXCOCO,099,SAN NICOLÁS TLAMINCA,2,194,106,88,8
MÉXICO,15,TEXCOCO,099,SAN PABLO IXAYOC,4,357,168,189,14
MÉXICO,15,TEXCOCO,099,SAN SEBASTIÁN,8,903,444,459,53
MÉXICO,15,TEXCOCO,099,SAN SIMÓN,3,471,240,231,31
MÉXICO,15,TEXCOCO,099,SANTA CATARINA DEL MONTE,8,982,470,512,52
MÉXICO,15,TEXCOCO,099,SANTA CRUZ DE ABAJO,2,534,253,281,18
MÉXICO,15,TEXCOCO,099,SANTA CRUZ DE ARRIBA,2,210,98,112,14
MÉXICO,15,TEXCOCO,099,SANTA INÉS,1,49,22,27,2
MÉXICO,15,TEXCOCO,099,SANTA MARÍA NATIVITAS,1,228,111,117,9
MÉXICO,15,TEXCOCO,099,SANTA MARÍA TECUANULCO,5,712,365,347,40
MÉXICO,15,TEXCOCO,099,SANTA MARÍA TULANTONGO,16,2826,1496,1330,189
MÉXICO,15,TEXCOCO,099,SANTA MARTHA,3,851,403,448,30
MÉXICO,15,TEXCOCO,099,SANTIAGUITO,1,31,11,20,2
MÉXICO,15,TEXCOCO,099,TEQUEXQUINÁHUAC,8,1010,471,539,72
MÉXICO,15,TEXCOCO,099,TEXCOCO DE MORA,174,54986,28460,26526,3792
MÉXICO,15,TEXCOCO,099,VICENTE RIVA PALACIO,2,610,313,297,19
MÉXICO,15,TEXCOCO,099,VILLA SANTIAGO CUAUTLALPAN,14,3310,1692,1618,271
MÉXICO,15,TEXCOCO,099,XOCOTLÁN,6,540,219,321,68
MÉXICO,15,TEZOYUCA,100,AMPLIACIÓN TEZOYUCA,2,634,315,319,21
MÉXICO,15,TEZOYUCA,100,EJIDO DE TEQUISISTLÁN PRIMERO,11,974,501,473,40
MÉXICO,15,TEZOYUCA,100,HACIENDA LA GRANDE,2,620,279,341,22
MÉXICO,15,TEZOYUCA,100,TEQUISISTLÁN,11,2306,1139,1167,111
MÉXICO,15,TEZOYUCA,100,TEZOYUCA,27,3840,1958,1882,261
MÉXICO,15,TIANGUISTENCO,101,AHUATENCO,3,360,180,180,19
MÉXICO,15,TIANGUISTENCO,101,ANTLANTLACPAC,1,43,20,23,3
MÉXICO,15,TIANGUISTENCO,101,CHIQUIXPAC SECCIÓN I,2,213,104,109,8
MÉXICO,15,TIANGUISTENCO,101,CHIQUIXPAC SECCIÓN II,2,86,56,30,4
MÉXICO,15,TIANGUISTENCO,101,COAMILPA DE JUÁREZ,6,389,188,201,25
MÉXICO,15,TIANGUISTENCO,101,EL BUEN SUCESO,3,789,393,396,28
MÉXICO,15,TIANGUISTENCO,101,EL MIRASOL,3,377,190,187,17
MÉXICO,15,TIANGUISTENCO,101,EX-HACIENDA DE ATENCO,2,177,85,92,7
MÉXICO,15,TIANGUISTENCO,101,GUADALUPE VICTORIA,1,67,32,35,4
MÉXICO,15,TIANGUISTENCO,101,GUADALUPE YANCUICTLALPAN (GUALUPITA),8,2139,1115,1024,134
MÉXICO,15,TIANGUISTENCO,101,LA MAGDALENA DE LOS REYES,2,299,144,155,12
MÉXICO,15,TIANGUISTENCO,101,MEZTITLA,1,40,16,24,1
MÉXICO,15,TIANGUISTENCO,101,OCOTENCO,4,483,253,230,21
MÉXICO,15,TIANGUISTENCO,101,SAN BARTOLO DEL PROGRESO (SAN BARTOLO),3,165,80,85,11
MÉXICO,15,TIANGUISTENCO,101,SAN JOSÉ MEZAPA SECCIÓN I,1,7,2,5,1
MÉXICO,15,TIANGUISTENCO,101,SAN JOSÉ MEZAPA SECCIÓN II,4,423,216,207,19
MÉXICO,15,TIANGUISTENCO,101,SAN LORENZO HUEHUETITLÁN,4,430,179,251,23
MÉXICO,15,TIANGUISTENCO,101,SAN PEDRO TLALTIZAPAN,11,4133,1727,2406,252
MÉXICO,15,TIANGUISTENCO,101,SANTA CRUZ DE BRAVO,2,110,57,53,5
MÉXICO,15,TIANGUISTENCO,101,SANTIAGO TIANGUISTENCO DE GALEANA,46,11152,5527,5625,818
MÉXICO,15,TIANGUISTENCO,101,SANTIAGO TILAPA,13,6274,2898,3376,340
MÉXICO,15,TIANGUISTENCO,101,TECHMANINALLI,1,48,20,28,3
MÉXICO,15,TIANGUISTENCO,101,TLACOMULCO,5,391,196,195,18
MÉXICO,15,TIANGUISTENCO,101,TLACUITLAPA,3,498,237,261,22
MÉXICO,15,TIANGUISTENCO,101,TZITZICAZAPA,3,35,18,17,3
MÉXICO,15,TIANGUISTENCO,101,VILLA DE SAN NICOLÁS COATEPEC DE LAS BATEAS,7,2097,1095,1002,104
MÉXICO,15,TIMILPAN,102,AGUA BENDITA,3,30,15,15,4
MÉXICO,15,TIMILPAN,102,BARRIO DE OCAMPO,2,147,84,63,8
MÉXICO,15,TIMILPAN,102,BARRIO ITURBIDE (LA CAMPESINA),2,72,34,38,4
MÉXICO,15,TIMILPAN,102,EL PALMITO (SAN JOSÉ EL PALMITO),6,316,155,161,21
MÉXICO,15,TIMILPAN,102,HUAPANGO,3,160,73,87,10
MÉXICO,15,TIMILPAN,102,LOMAS DE EMILIANO ZAPATA (LAS LOMAS),3,16,8,8,3
MÉXICO,15,TIMILPAN,102,PRIMERA MANZANA BARRIO DE HIDALGO,1,10,6,4,1
MÉXICO,15,TIMILPAN,102,PRIMERA MANZANA DE ZARAGOZA,1,20,8,12,1
MÉXICO,15,TIMILPAN,102,PRIMERA MANZANA DEL PUEBLO DE RINCÓN DE BUCIO,5,994,477,517,36
MÉXICO,15,TIMILPAN,102,QUINTO BARRIO SANTIAGUITO MAXDA (ENZDÁ),2,47,22,25,4
MÉXICO,15,TIMILPAN,102,SAN ANDRÉS TIMILPAN,5,1021,523,498,72
MÉXICO,15,TIMILPAN,102,SAN ANTONIO YONDEJÉ,4,305,145,160,14
MÉXICO,15,TIMILPAN,102,SANTIAGUITO MAXDA,7,621,303,318,45
MÉXICO,15,TIMILPAN,102,SEGUNDA MANZANA DE BARRIO MORELOS,2,57,30,27,5
MÉXICO,15,TIMILPAN,102,SEGUNDA MANZANA DE ZARAGOZA,2,60,25,35,4
MÉXICO,15,TIMILPAN,102,SEGUNDA MANZANA DEL PUEBLO DE RINCÓN DE BUCIO,1,38,13,25,3
MÉXICO,15,TIMILPAN,102,TERCERA MANZANA DE BARRIO ITURBIDE IXCAJA,2,89,44,45,5
MÉXICO,15,TIMILPAN,102,TERCERA MANZANA DE BARRIO MORELOS,1,12,8,4,1
MÉXICO,15,TIMILPAN,102,TERCERA MANZANA DE ZARAGOZA,4,464,226,238,32
MÉXICO,15,TIMILPAN,102,TERCERA MANZANA DEL PUEBLO DE RINCÓN DE BUCIO,2,50,17,33,5
MÉXICO,15,TLALMANALCO,103,PREDIOS EJIDALES SAN JUAN ATZACUALOYA,3,519,239,280,25
MÉXICO,15,TLALMANALCO,103,SAN ANTONIO TLALTECAHUACÁN,3,303,141,162,15
MÉXICO,15,TLALMANALCO,103,SAN LORENZO TLALMIMILOLPAN,6,556,253,303,27
MÉXICO,15,TLALMANALCO,103,SAN RAFAEL,17,2283,1175,1108,128
MÉXICO,15,TLALMANALCO,103,SANTA MARÍA,2,453,214,239,19
MÉXICO,15,TLALMANALCO,103,SANTO TOMÁS ATZINGO,3,355,181,174,17
MÉXICO,15,TLALMANALCO,103,TLALMANALCO DE VELÁZQUEZ,31,5148,2591,2557,303
MÉXICO,15,TLALNEPANTLA DE BAZ,104,PUERTO ESCONDIDO (TEPEOLULCO PUERTO ESCONDIDO),6,1394,693,701,59
MÉXICO,15,TLALNEPANTLA DE BAZ,104,TLALNEPANTLA,669,145008,76466,68542,12153
MÉXICO,15,TLATLAYA,105,ANCÓN DE LA PRESA,3,53,28,25,8
MÉXICO,15,TLATLAYA,105,ANCÓN DE LOS CURIELES,2,104,57,47,7
MÉXICO,15,TLATLAYA,105,AZÚCHIL,1,27,11,16,3
MÉXICO,15,TLATLAYA,105,BARRIALES,2,28,14,14,3
MÉXICO,15,TLATLAYA,105,CACAHUANANCHE,2,21,8,13,2
MÉXICO,15,TLATLAYA,105,CERRO DE AGUACATEPEC,2,14,7,7,2
MÉXICO,15,TLATLAYA,105,CERRO DEL MORADO,2,33,19,14,4
MÉXICO,15,TLATLAYA,105,CHACHALACATENCO,2,12,6,6,2
MÉXICO,15,TLATLAYA,105,CHARCO DEL LAGARTO,1,4,0,4,2
MÉXICO,15,TLATLAYA,105,CIRIÁN GRANDE,3,42,19,23,5
MÉXICO,15,TLATLAYA,105,COAHUILOTES (PUEBLO NUEVO),1,10,5,5,2
MÉXICO,15,TLATLAYA,105,COATEPEC (COATEPEQUITO),4,394,205,189,51
MÉXICO,15,TLATLAYA,105,COLONIA BENITO JUÁREZ,2,56,25,31,4
MÉXICO,15,TLATLAYA,105,CORRAL DE PIEDRA,2,49,19,30,6
MÉXICO,15,TLATLAYA,105,CORRAL DE PIEDRA DOS (CORRAL DE PIEDRA),2,26,16,10,2
MÉXICO,15,TLATLAYA,105,CORRAL PAROTA (TEPEHUASTITLÁN),2,27,16,11,3
MÉXICO,15,TLATLAYA,105,CRUZ DEL NORTE,3,97,45,52,8
MÉXICO,15,TLATLAYA,105,CUADRILLA DE FLORES,2,23,14,9,2
MÉXICO,15,TLATLAYA,105,CUADRILLA DE GUTIÉRREZ,1,4,0,4,1
MÉXICO,15,TLATLAYA,105,CUADRILLA DE LOS SOTERO,2,11,1,10,2
MÉXICO,15,TLATLAYA,105,CUADRILLA DEL CIRIÁN (CIRIÁN GRANDE),1,7,2,5,1
MÉXICO,15,TLATLAYA,105,CUADRILLA NUEVA,3,44,20,24,4
MÉXICO,15,TLATLAYA,105,DIECIOCHO DE MARZO,2,27,10,17,5
MÉXICO,15,TLATLAYA,105,EL ALAMBIQUE,3,22,10,12,4
MÉXICO,15,TLATLAYA,105,EL CASCALOTE,3,11,3,8,3
MÉXICO,15,TLATLAYA,105,EL COYOL,3,16,8,8,3
MÉXICO,15,TLATLAYA,105,EL DEVANADOR,1,3,1,2,1
MÉXICO,15,TLATLAYA,105,EL GAVILÁN,2,28,12,16,3
MÉXICO,15,TLATLAYA,105,EL GUAYABO,2,7,3,4,2
MÉXICO,15,TLATLAYA,105,EL GUITARRATEL,2,14,4,10,3
MÉXICO,15,TLATLAYA,105,EL HIGO PRIETO,2,27,14,13,2
MÉXICO,15,TLATLAYA,105,EL LIMO,2,26,11,15,3
MÉXICO,15,TLATLAYA,105,EL LIMÓN,3,73,38,35,7
MÉXICO,15,TLATLAYA,105,EL LLANO,1,18,12,6,3
MÉXICO,15,TLATLAYA,105,EL MANGO,2,14,8,6,3
MÉXICO,15,TLATLAYA,105,EL MONTÓN,2,20,11,9,4
MÉXICO,15,TLATLAYA,105,EL NARANJITO,4,44,18,26,5
MÉXICO,15,TLATLAYA,105,EL NARANJO,4,225,103,122,12
MÉXICO,15,TLATLAYA,105,EL PANAL,3,27,10,17,4
MÉXICO,15,TLATLAYA,105,EL POTRERO,2,46,24,22,4
MÉXICO,15,TLATLAYA,105,EL REVELADO,4,79,33,46,9
MÉXICO,15,TLATLAYA,105,EL SALITRE OJO DE AGUA,2,77,37,40,5
MÉXICO,15,TLATLAYA,105,EL SAUZ,2,27,12,15,3
MÉXICO,15,TLATLAYA,105,EL TAMARINDO,2,23,11,12,3
MÉXICO,15,TLATLAYA,105,EL TEMBLOR,2,57,28,29,7
MÉXICO,15,TLATLAYA,105,EL TERRONCILLO,3,22,13,9,4
MÉXICO,15,TLATLAYA,105,EL TIQUIMIL,1,12,7,5,1
MÉXICO,15,TLATLAYA,105,EL TOROAL,2,65,29,36,6
MÉXICO,15,TLATLAYA,105,EL ZAPOTE (EL ZAPOTE SAN ANTONIO DEL ROSARIO),2,19,12,7,2
MÉXICO,15,TLATLAYA,105,EL ZOPILOTE,4,55,23,32,9
MÉXICO,15,TLATLAYA,105,JUNTAS DE SANTA ANA ZICATECOYAN,3,18,6,12,3
MÉXICO,15,TLATLAYA,105,JUNTAS DEL PASO TOPILAR,2,7,5,2,2
MÉXICO,15,TLATLAYA,105,JUNTAS DEL RÍO LIMÓN,3,36,15,21,4
MÉXICO,15,TLATLAYA,105,LA ALCANTARILLA,2,14,10,4,2
MÉXICO,15,TLATLAYA,105,LA COFRADÍA,1,20,12,8,3
MÉXICO,15,TLATLAYA,105,LA CUEVA,3,36,10,26,3
MÉXICO,15,TLATLAYA,105,LA GUACAMAYA,3,39,23,16,3
MÉXICO,15,TLATLAYA,105,LA LAGUNILLA,3,53,26,27,6
MÉXICO,15,TLATLAYA,105,LA PAROTA,3,29,12,17,4
MÉXICO,15,TLATLAYA,105,LA UNIÓN,1,10,3,7,1
MÉXICO,15,TLATLAYA,105,LA VÍBORA,1,6,4,2,1
MÉXICO,15,TLATLAYA,105,LAS ESMERALDAS,4,163,78,85,13
MÉXICO,15,TLATLAYA,105,LAS JUNTAS (LAS JUNTAS DEL PASO),3,29,15,14,5
MÉXICO,15,TLATLAYA,105,LAS JUNTAS DE AZÚCHIL,3,56,26,30,6
MÉXICO,15,TLATLAYA,105,LAS PAROTAS,1,32,18,14,3
MÉXICO,15,TLATLAYA,105,LIMÓN TERRERO,4,86,44,42,10
MÉXICO,15,TLATLAYA,105,LOMA LARGA,3,52,29,23,5
MÉXICO,15,TLATLAYA,105,LOS OCOTES,2,89,44,45,8
MÉXICO,15,TLATLAYA,105,MAYALTEPEC,4,216,102,114,21
MÉXICO,15,TLATLAYA,105,MAZATITLA,2,15,9,6,3
MÉXICO,15,TLATLAYA,105,MIRAVELES,2,15,4,11,2
MÉXICO,15,TLATLAYA,105,MOCTEZUMA (COLONIA MOCTEZUMA),4,82,41,41,10
MÉXICO,15,TLATLAYA,105,NUEVO COPALTEPEC,3,187,95,92,14
MÉXICO,15,TLATLAYA,105,PALMA TORCIDA,3,53,22,31,7
MÉXICO,15,TLATLAYA,105,PALMAR GRANDE,3,138,70,68,14
MÉXICO,15,TLATLAYA,105,PALOS VERDES,3,40,18,22,4
MÉXICO,15,TLATLAYA,105,PASO DE JAQUINICUIL,4,96,50,46,12
MÉXICO,15,TLATLAYA,105,PEÑA BLANCA,2,8,2,6,2
MÉXICO,15,TLATLAYA,105,PEÑA DEL AGUA,2,32,13,19,3
MÉXICO,15,TLATLAYA,105,PEÑA DEL ÓRGANO,5,150,75,75,15
MÉXICO,15,TLATLAYA,105,PIE DEL CERRO,2,31,15,16,4
MÉXICO,15,TLATLAYA,105,PIEDRA ANCHA,4,142,72,70,12
MÉXICO,15,TLATLAYA,105,PINZÁN MORADO,2,9,4,5,2
MÉXICO,15,TLATLAYA,105,PLAN DE LA CUADRILLA,2,23,14,9,5
MÉXICO,15,TLATLAYA,105,PLAN DEL ALAMBIQUE,2,27,14,13,4
MÉXICO,15,TLATLAYA,105,PUEBLO NUEVO,3,49,25,24,7
MÉXICO,15,TLATLAYA,105,PUERTO DE LA ARENA,2,24,11,13,4
MÉXICO,15,TLATLAYA,105,PUERTO SECO,4,72,43,29,12
MÉXICO,15,TLATLAYA,105,RANCHO CUÁ,2,23,11,12,3
MÉXICO,15,TLATLAYA,105,RANCHO VIEJO,2,18,9,9,3
MÉXICO,15,TLATLAYA,105,RINCÓN DEL AGUACATE,4,109,58,51,12
MÉXICO,15,TLATLAYA,105,RINCÓN GRANDE,4,119,56,63,15
MÉXICO,15,TLATLAYA,105,RÍO TOPILAR (TOPILAR),1,9,4,5,1
MÉXICO,15,TLATLAYA,105,SALITRILLO,2,16,11,5,3
MÉXICO,15,TLATLAYA,105,SAN ANTONIO DEL ROSARIO,7,620,326,294,62
MÉXICO,15,TLATLAYA,105,SAN FELIPE TEPEHUASTITLÁN,2,83,34,49,7
MÉXICO,15,TLATLAYA,105,SAN FRANCISCO DE ASÍS (SAN FRANCISCO),4,187,98,89,18
MÉXICO,15,TLATLAYA,105,SAN JUAN CORRAL,2,30,16,14,4
MÉXICO,15,TLATLAYA,105,SAN JUAN TETITLÁN,4,146,62,84,13
MÉXICO,15,TLATLAYA,105,SAN LUCAS,2,21,10,11,4
MÉXICO,15,TLATLAYA,105,SAN MATEO (SAN MATEO GUAYATENCO),5,286,166,120,21
MÉXICO,15,TLATLAYA,105,SAN PEDRO LIMÓN,7,1098,586,512,90
MÉXICO,15,TLATLAYA,105,SANTA ANA ZICATECOYAN,6,1011,550,461,90
MÉXICO,15,TLATLAYA,105,SANTA CRUZ,4,104,50,54,14
MÉXICO,15,TLATLAYA,105,SANTA MARÍA,4,270,128,142,34
MÉXICO,15,TLATLAYA,105,TECOMATLÁN,3,61,35,26,6
MÉXICO,15,TLATLAYA,105,TEJUPILQUITO,4,156,70,86,19
MÉXICO,15,TLATLAYA,105,TEOPAZUL (TEOPAZUL EL ENCINAL),3,142,68,74,14
MÉXICO,15,TLATLAYA,105,TLACOCUSPAN (TLACOCUSPAN SANTA CRUZ),3,196,86,110,19
MÉXICO,15,TLATLAYA,105,TLATLAYA,3,139,64,75,15
MÉXICO,15,TLATLAYA,105,VUELTA DEL RÍO,2,37,19,18,3
MÉXICO,15,TOLUCA,106,AVIACIÓN AUTOPAN,6,1181,751,430,104
MÉXICO,15,TOLUCA,106,BALBUENA,1,21,8,13,1
MÉXICO,15,TOLUCA,106,BARRIO BORDO NUEVO,1,54,25,29,3
MÉXICO,15,TOLUCA,106,BARRIO DEL CAJÓN,1,102,52,50,3
MÉXICO,15,TOLUCA,106,CACALOMACÁN,16,2554,1253,1301,167
MÉXICO,15,TOLUCA,106,CALIXTLAHUACA,17,3804,1814,1990,296
MÉXICO,15,TOLUCA,106,CAPULTITLÁN,9,1602,755,847,125
MÉXICO,15,TOLUCA,106,CERRILLO PIEDRAS BLANCAS,9,3979,2007,1972,440
MÉXICO,15,TOLUCA,106,CRESPA FLORESTA,2,280,137,143,13
MÉXICO,15,TOLUCA,106,DE JESÚS 1RA. SECCIÓN,1,91,38,53,4
MÉXICO,15,TOLUCA,106,DE JESÚS 2DA. SECCIÓN,1,91,45,46,4
MÉXICO,15,TOLUCA,106,EJIDO DE LA Y SECCIÓN SIETE A REVOLUCIÓN,1,112,59,53,5
MÉXICO,15,TOLUCA,106,EJIDO DE XICALTEPEC OTZACATIPAN,1,14,4,10,1
MÉXICO,15,TOLUCA,106,EJIDO SANTA CRUZ ATZCAPOZALTONGO,8,1536,838,698,189
MÉXICO,15,TOLUCA,106,EL CERRILLO VISTA HERMOSA,3,857,434,423,40
MÉXICO,15,TOLUCA,106,EL REFUGIO,2,398,200,198,16
MÉXICO,15,TOLUCA,106,FRACCIONAMIENTO REAL DE SAN PABLO,1,79,44,35,4
MÉXICO,15,TOLUCA,106,FRACCIONAMIENTO SAN DIEGO,1,139,77,62,7
MÉXICO,15,TOLUCA,106,GUADALUPE TOTOLTEPEC,1,37,16,21,2
MÉXICO,15,TOLUCA,106,JICALTEPEC AUTOPAN,4,1348,673,675,66
MÉXICO,15,TOLUCA,106,LA CONSTITUCIÓN TOLTEPEC,3,826,394,432,27
MÉXICO,15,TOLUCA,106,LA MAGDALENA OTZACATIPAN,3,433,234,199,20
MÉXICO,15,TOLUCA,106,LA PALMA TOLTEPEC,2,222,111,111,9
MÉXICO,15,TOLUCA,106,OJO DE AGUA,2,190,104,86,9
MÉXICO,15,TOLUCA,106,PALMILLAS,1,65,35,30,2
MÉXICO,15,TOLUCA,106,SAN ANDRÉS CUEXCONTITLÁN,31,8488,4265,4223,378
MÉXICO,15,TOLUCA,106,SAN ANTONIO BUENAVISTA,13,6962,3607,3355,733
MÉXICO,15,TOLUCA,106,SAN BLAS OTZACATIPAN,4,355,243,112,49
MÉXICO,15,TOLUCA,106,SAN BLAS TOTOLTEPEC,1,48,30,18,2
MÉXICO,15,TOLUCA,106,SAN BUENAVENTURA,12,2782,1271,1511,240
MÉXICO,15,TOLUCA,106,SAN CARLOS AUTOPAN,3,221,122,99,15
MÉXICO,15,TOLUCA,106,SAN CAYETANO MORELOS,6,1407,709,698,84
MÉXICO,15,TOLUCA,106,SAN CRISTÓBAL HUICHOCHITLÁN,13,5235,2680,2555,200
MÉXICO,15,TOLUCA,106,SAN DIEGO DE LOS PADRES CUEXCONTITLÁN,3,624,319,305,31
MÉXICO,15,TOLUCA,106,SAN DIEGO DE LOS PADRES OTZACATIPAN,4,957,480,477,49
MÉXICO,15,TOLUCA,106,SAN DIEGO LINARES,2,519,264,255,19
MÉXICO,15,TOLUCA,106,SAN FELIPE TLALMIMILOLPAN,20,5211,2872,2339,551
MÉXICO,15,TOLUCA,106,SAN FRANCISCO TOTOLTEPEC,1,10,7,3,1
MÉXICO,15,TOLUCA,106,SAN JOSÉ BUENAVISTA,1,28,14,14,2
MÉXICO,15,TOLUCA,106,SAN JOSÉ GUADALUPE OTZACATIPAN,9,1436,739,697,61
MÉXICO,15,TOLUCA,106,SAN JOSÉ LA COSTA,1,108,43,65,6
MÉXICO,15,TOLUCA,106,SAN JUAN TILAPA,7,2127,1082,1045,120
MÉXICO,15,TOLUCA,106,SAN LORENZO TEPALTITLÁN,10,1917,965,952,120
MÉXICO,15,TOLUCA,106,SAN MARCOS YACHIHUACALTEPEC,5,1323,651,672,55
MÉXICO,15,TOLUCA,106,SAN MARTÍN TOLTEPEC,10,1922,985,937,87
MÉXICO,15,TOLUCA,106,SAN MATEO OTZACATIPAN,59,15434,7673,7761,893
MÉXICO,15,TOLUCA,106,SAN MATEO OXTOTITLÁN,14,2810,1370,1440,124
MÉXICO,15,TOLUCA,106,SAN MIGUEL TOTOLTEPEC,5,707,384,323,34
MÉXICO,15,TOLUCA,106,SAN NICOLÁS TOLENTINO,5,1426,689,737,53
MÉXICO,15,TOLUCA,106,SAN PABLO AUTOPAN,41,14654,7299,7355,667
MÉXICO,15,TOLUCA,106,SAN PEDRO TOTOLTEPEC,32,8587,4355,4232,358
MÉXICO,15,TOLUCA,106,SANTA ANA TLAPALTITLÁN,4,798,380,418,48
MÉXICO,15,TOLUCA,106,SANTA CRUZ ATZCAPOTZALTONGO,6,321,162,159,52
MÉXICO,15,TOLUCA,106,SANTA CRUZ OTZACATIPAN,2,295,146,149,10
MÉXICO,15,TOLUCA,106,SANTA MARÍA TOTOLTEPEC,8,1744,883,861,95
MÉXICO,15,TOLUCA,106,SANTIAGO MILTEPEC,5,372,182,190,31
MÉXICO,15,TOLUCA,106,SANTIAGO TLACOTEPEC,10,3192,1569,1623,129
MÉXICO,15,TOLUCA,106,SANTIAGO TLAXOMULCO,2,399,199,200,21
MÉXICO,15,TOLUCA,106,SAUCES,8,1920,977,943,83
MÉXICO,15,TOLUCA,106,SEBASTIÁN LERDO DE TEJADA,1,212,99,113,10
MÉXICO,15,TOLUCA,106,TECAXIC,2,416,198,218,20
MÉXICO,15,TOLUCA,106,TLACHALOYA,11,1342,651,691,64
MÉXICO,15,TOLUCA,106,TLACHALOYA SEGUNDA SECCIÓN,9,1411,721,690,67
MÉXICO,15,TOLUCA,106,TOLUCA DE LERDO,730,202831,107095,95736,15998
MÉXICO,15,TOLUCA,106,XICALTEPEC,12,2702,1317,1385,134
MÉXICO,15,TONATICO,107,EL RINCÓN,2,29,12,17,2
MÉXICO,15,TONATICO,107,EL TERRERO,4,371,190,181,16
MÉXICO,15,TONATICO,107,EL ZAPOTE,2,43,27,16,4
MÉXICO,15,TONATICO,107,LA AUDIENCIA,3,107,50,57,7
MÉXICO,15,TONATICO,107,LA PUERTA DE SANTIAGO,4,251,130,121,16
MÉXICO,15,TONATICO,107,LA VEGA,1,16,8,8,1
MÉXICO,15,TONATICO,107,LOS AMATES (SAN JOSÉ DE LOS AMATES),4,124,71,53,10
MÉXICO,15,TONATICO,107,SALINAS,3,30,21,9,4
MÉXICO,15,TONATICO,107,SAN BARTOLO,2,32,19,13,2
MÉXICO,15,TONATICO,107,TLACOPAN,2,43,18,25,3
MÉXICO,15,TONATICO,107,TONATICO,6,1729,815,914,90
MÉXICO,15,TULTEPEC,108,BARRIO DE SAN MARTÍN,15,2951,1465,1486,136
MÉXICO,15,TULTEPEC,108,FRACCIONAMIENTO PASEOS DE TULTEPEC II,1,58,30,28,4
MÉXICO,15,TULTEPEC,108,SAN ANTONIO XAHUENTO,6,2342,1156,1186,69
MÉXICO,15,TULTEPEC,108,SANTIAGO TEYAHUALCO,22,4735,2524,2211,211
MÉXICO,15,TULTEPEC,108,TULTEPEC,101,22086,11424,10662,1198
MÉXICO,15,TULTITLÁN,109,AMPLIACIÓN SAN MATEO (COLONIA SOLIDARIDAD),3,1438,738,700,45
MÉXICO,15,TULTITLÁN,109,BUENAVISTA,50,10893,5446,5447,470
MÉXICO,15,TULTITLÁN,109,COLONIA LÁZARO CÁRDENAS (LOS HORNOS),1,52,30,22,3
MÉXICO,15,TULTITLÁN,109,FUENTES DEL VALLE,31,7208,3628,3580,338
MÉXICO,15,TULTITLÁN,109,SAN PABLO DE LAS SALINAS,58,10841,5214,5627,534
MÉXICO,15,TULTITLÁN,109,SIERRA DE GUADALUPE,4,767,382,385,29
MÉXICO,15,TULTITLÁN,109,TULTITLÁN DE MARIANO ESCOBEDO,238,56012,27523,28489,2938
MÉXICO,15,VALLE DE BRAVO,110,ATESQUELITES (TRES QUELITES),2,51,21,30,3
MÉXICO,15,VALLE DE BRAVO,110,BARRIO DE GUADALUPE,1,38,15,23,1
MÉXICO,15,VALLE DE BRAVO,110,CASAS VIEJAS,4,407,202,205,16
MÉXICO,15,VALLE DE BRAVO,110,CERRO COLORADO,3,288,148,140,10
MÉXICO,15,VALLE DE BRAVO,110,CERRO GORDO,6,551,249,302,25
MÉXICO,15,VALLE DE BRAVO,110,COLONIA RINCÓN VILLA DEL VALLE,5,1280,653,627,54
MÉXICO,15,VALLE DE BRAVO,110,COLORINES,13,1475,746,729,91
MÉXICO,15,VALLE DE BRAVO,110,CUADRILLA DE DOLORES,4,687,351,336,35
MÉXICO,15,VALLE DE BRAVO,110,EL AGUACATE,3,29,15,14,3
MÉXICO,15,VALLE DE BRAVO,110,EL ARCO,7,1920,1105,815,123
MÉXICO,15,VALLE DE BRAVO,110,EL CASTELLANO,2,41,19,22,3
MÉXICO,15,VALLE DE BRAVO,110,EL CERRILLO (SAN JOSÉ EL CERRILLO),5,67,25,42,6
MÉXICO,15,VALLE DE BRAVO,110,EL DURAZNO,3,719,362,357,39
MÉXICO,15,VALLE DE BRAVO,110,EL FRESNO (EL FRESNO LA COMPAÑÍA),2,211,99,112,8
MÉXICO,15,VALLE DE BRAVO,110,EL MANZANO,3,83,43,40,6
MÉXICO,15,VALLE DE BRAVO,110,GODÍNEZ TEHUASTEPEC,5,228,120,108,13
MÉXICO,15,VALLE DE BRAVO,110,LA CANDELARIA,2,105,46,59,4
MÉXICO,15,VALLE DE BRAVO,110,LA COMPAÑÍA (TRES ESPIGAS),1,89,40,49,4
MÉXICO,15,VALLE DE BRAVO,110,LA HUERTA SAN AGUSTÍN,3,73,33,40,5
MÉXICO,15,VALLE DE BRAVO,110,LA LAGUNA,2,45,23,22,3
MÉXICO,15,VALLE DE BRAVO,110,LAS AHUJAS,1,4,1,3,1
MÉXICO,15,VALLE DE BRAVO,110,LAS JOYAS,4,94,44,50,9
MÉXICO,15,VALLE DE BRAVO,110,LOMA BONITA,1,28,9,19,1
MÉXICO,15,VALLE DE BRAVO,110,LOMA DE CHIHUAHUA,3,32,18,14,4
MÉXICO,15,VALLE DE BRAVO,110,LOS POZOS (PINAR DE OSORIOS),2,6,3,3,1
MÉXICO,15,VALLE DE BRAVO,110,LOS SAUCOS,7,606,311,295,34
MÉXICO,15,VALLE DE BRAVO,110,MESA DE DOLORES (MESA DE DOLORES SEGUNDA SECCIÓN),3,74,44,30,5
MÉXICO,15,VALLE DE BRAVO,110,MESA DE DOLORES PRIMERA SECCIÓN (MESA DEL RAYO),2,18,9,9,2
MÉXICO,15,VALLE DE BRAVO,110,MESA DE JAIMES,2,70,34,36,4
MÉXICO,15,VALLE DE BRAVO,110,MESA RICA (LA FINCA),4,193,91,102,10
MÉXICO,15,VALLE DE BRAVO,110,MONTE ALTO,2,60,32,28,3
MÉXICO,15,VALLE DE BRAVO,110,PEÑA BLANCA,2,63,35,28,4
MÉXICO,15,VALLE DE BRAVO,110,RANCHO AVÁNDARO COUNTRY CLUB,4,657,333,324,32
MÉXICO,15,VALLE DE BRAVO,110,RINCÓN DE ESTRADAS,2,117,62,55,6
MÉXICO,15,VALLE DE BRAVO,110,SAN ANTONIO,3,2370,1006,1364,112
MÉXICO,15,VALLE DE BRAVO,110,SAN GABRIEL IXTLA,3,500,222,278,17
MÉXICO,15,VALLE DE BRAVO,110,SAN GASPAR,2,193,98,95,8
MÉXICO,15,VALLE DE BRAVO,110,SAN JOSÉ POTRERILLOS (POTRERILLOS),2,11,3,8,2
MÉXICO,15,VALLE DE BRAVO,110,SAN JUAN ATEZCAPAN,5,486,239,247,31
MÉXICO,15,VALLE DE BRAVO,110,SAN MATEO ACATITLÁN,7,866,492,374,73
MÉXICO,15,VALLE DE BRAVO,110,SAN NICOLÁS TOLENTINO,3,323,169,154,15
MÉXICO,15,VALLE DE BRAVO,110,SAN RAMÓN,2,5,2,3,2
MÉXICO,15,VALLE DE BRAVO,110,SAN SIMÓN EL ALTO,4,178,91,87,10
MÉXICO,15,VALLE DE BRAVO,110,SANTA MAGDALENA TILOXTOC,2,89,42,47,5
MÉXICO,15,VALLE DE BRAVO,110,SANTA MARÍA PIPIOLTEPEC (PIPIOLTEPEC),6,823,422,401,77
MÉXICO,15,VALLE DE BRAVO,110,SANTA TERESA TILOXTOC,4,328,156,172,13
MÉXICO,15,VALLE DE BRAVO,110,SANTO TOMÁS EL PEDREGAL,3,82,39,43,5
MÉXICO,15,VALLE DE BRAVO,110,TENANTONGO,2,141,59,82,7
MÉXICO,15,VALLE DE BRAVO,110,VALLE DE BRAVO,33,6138,3046,3092,332
MÉXICO,15,VILLA DE ALLENDE,111,BARRIO CHIQUICHUCA,2,120,46,74,6
MÉXICO,15,VILLA DE ALLENDE,111,BARRIO DE SAN JUAN,2,108,56,52,4
MÉXICO,15,VILLA DE ALLENDE,111,BARRIO DE SAN MIGUEL,2,160,73,87,7
MÉXICO,15,VILLA DE ALLENDE,111,BARRIO DE SANTIAGO,2,117,65,52,8
MÉXICO,15,VILLA DE ALLENDE,111,BARRIO LA JOYA,2,56,35,21,3
MÉXICO,15,VILLA DE ALLENDE,111,BARRIO LOS POZOS,1,19,9,10,1
MÉXICO,15,VILLA DE ALLENDE,111,BARRIO LOS TULES,2,40,23,17,3
MÉXICO,15,VILLA DE ALLENDE,111,BARRIO SANTA CRUZ,3,198,91,107,13
MÉXICO,15,VILLA DE ALLENDE,111,BATÁN CHICO,2,48,25,23,3
MÉXICO,15,VILLA DE ALLENDE,111,BOSENCHEVE,3,398,187,211,23
MÉXICO,15,VILLA DE ALLENDE,111,BUENAVISTA 23,2,117,55,62,4
MÉXICO,15,VILLA DE ALLENDE,111,CABECERA DE INDÍGENAS,2,202,97,105,8
MÉXICO,15,VILLA DE ALLENDE,111,CASA BLANCA,2,129,60,69,7
MÉXICO,15,VILLA DE ALLENDE,111,CERRO DE GUADALUPE,2,35,16,19,3
MÉXICO,15,VILLA DE ALLENDE,111,CUESTA DEL CARMEN,4,174,77,97,10
MÉXICO,15,VILLA DE ALLENDE,111,EJIDO DE SAN MARTÍN,2,53,26,27,3
MÉXICO,15,VILLA DE ALLENDE,111,EJIDO SABANA DE SAN JERÓNIMO,1,14,8,6,1
MÉXICO,15,VILLA DE ALLENDE,111,EL AVENTURERO,2,107,57,50,4
MÉXICO,15,VILLA DE ALLENDE,111,EL CHIRIMOYO,2,102,43,59,6
MÉXICO,15,VILLA DE ALLENDE,111,EL CINCO,2,50,25,25,3
MÉXICO,15,VILLA DE ALLENDE,111,EL JACAL,3,896,436,460,40
MÉXICO,15,VILLA DE ALLENDE,111,EL POTRERO,2,63,29,34,3
MÉXICO,15,VILLA DE ALLENDE,111,EL PUERTO LENGUA DE VACA,3,48,23,25,4
MÉXICO,15,VILLA DE ALLENDE,111,FILIBERTO GÓMEZ,2,76,41,35,7
MÉXICO,15,VILLA DE ALLENDE,111,LA PEÑA,2,15,6,9,2
MÉXICO,15,VILLA DE ALLENDE,111,LA PIEDRA,4,158,71,87,12
MÉXICO,15,VILLA DE ALLENDE,111,LAS DALIAS,2,30,14,16,2
MÉXICO,15,VILLA DE ALLENDE,111,LOMA CHICA,2,32,18,14,3
MÉXICO,15,VILLA DE ALLENDE,111,LOMA DE JUÁREZ,10,1577,769,808,68
MÉXICO,15,VILLA DE ALLENDE,111,LOMA DE SAN PABLO,2,117,58,59,8
MÉXICO,15,VILLA DE ALLENDE,111,LOS BERROS,6,387,188,199,16
MÉXICO,15,VILLA DE ALLENDE,111,LOS HOYOS,2,61,28,33,3
MÉXICO,15,VILLA DE ALLENDE,111,MACIA,3,62,31,31,6
MÉXICO,15,VILLA DE ALLENDE,111,MANZANA DE CASHTE,2,78,39,39,4
MÉXICO,15,VILLA DE ALLENDE,111,MESAS DE SAN JERÓNIMO,2,149,80,69,6
MÉXICO,15,VILLA DE ALLENDE,111,MESAS DE SAN JUAN BUENAVISTA,3,71,36,35,5
MÉXICO,15,VILLA DE ALLENDE,111,MESAS DE SAN MARTÍN,2,45,22,23,3
MÉXICO,15,VILLA DE ALLENDE,111,MESAS DE ZACANGO,2,181,94,87,8
MÉXICO,15,VILLA DE ALLENDE,111,MESAS DEL CLARÍN,2,17,12,5,2
MÉXICO,15,VILLA DE ALLENDE,111,MONTE ALTO,3,42,19,23,4
MÉXICO,15,VILLA DE ALLENDE,111,SABANA DE LA PEÑA,4,369,198,171,33
MÉXICO,15,VILLA DE ALLENDE,111,SABANA DE SAN JERÓNIMO,3,131,69,62,7
MÉXICO,15,VILLA DE ALLENDE,111,SABANA DE TABORDA 1RA. SECCIÓN,4,190,102,88,10
MÉXICO,15,VILLA DE ALLENDE,111,SABANA DE TABORDA 2DA. SECCIÓN,1,29,15,14,2
MÉXICO,15,VILLA DE ALLENDE,111,SABANA DEL MADROÑO,2,173,103,70,8
MÉXICO,15,VILLA DE ALLENDE,111,SABANA DEL REFUGIO,3,46,22,24,4
MÉXICO,15,VILLA DE ALLENDE,111,SABANA DEL ROSARIO,3,405,231,174,28
MÉXICO,15,VILLA DE ALLENDE,111,SALITRE DEL CERRO,3,359,186,173,17
MÉXICO,15,VILLA DE ALLENDE,111,SAN CAYETANO,4,340,174,166,15
MÉXICO,15,VILLA DE ALLENDE,111,SAN FELIPE SANTIAGO,4,621,323,298,34
MÉXICO,15,VILLA DE ALLENDE,111,SAN FRANCISCO DE ASÍS,3,169,88,81,21
MÉXICO,15,VILLA DE ALLENDE,111,SAN ILDEFONSO,5,227,117,110,12
MÉXICO,15,VILLA DE ALLENDE,111,SAN ISIDRO,2,177,88,89,7
MÉXICO,15,VILLA DE ALLENDE,111,SAN JERÓNIMO TOTOLTEPEC,5,714,361,353,32
MÉXICO,15,VILLA DE ALLENDE,111,SAN JOSÉ VILLA DE ALLENDE,12,1934,994,940,105
MÉXICO,15,VILLA DE ALLENDE,111,SAN JUAN BUENAVISTA,4,235,118,117,13
MÉXICO,15,VILLA DE ALLENDE,111,SAN MIGUEL LA MÁQUINA,3,46,22,24,4
MÉXICO,15,VILLA DE ALLENDE,111,SAN PABLO MALACATEPEC,2,358,172,186,14
MÉXICO,15,VILLA DE ALLENDE,111,SANTA MARÍA DE LAS DELICIAS,2,97,39,58,7
MÉXICO,15,VILLA DE ALLENDE,111,SANTA TERESA,3,185,89,96,10
MÉXICO,15,VILLA DE ALLENDE,111,SOLEDAD DEL SALITRE,2,55,30,25,4
MÉXICO,15,VILLA DE ALLENDE,111,VARE CHIQUICHUCA,6,583,297,286,24
MÉXICO,15,VILLA DEL CARBÓN,112,EL ÁGUILA,3,57,29,28,5
MÉXICO,15,VILLA DEL CARBÓN,112,EL ARENAL,2,50,28,22,4
MÉXICO,15,VILLA DEL CARBÓN,112,EL CERRITO,2,109,51,58,7
MÉXICO,15,VILLA DEL CARBÓN,112,EL OCOTAL,4,359,174,185,17
MÉXICO,15,VILLA DEL CARBÓN,112,EL PALOMAR,2,32,17,15,3
MÉXICO,15,VILLA DEL CARBÓN,112,EL TEJOCOTE (RANCHO LOS PÉREZ),3,17,9,8,2
MÉXICO,15,VILLA DEL CARBÓN,112,EL VARAL,3,91,48,43,5
MÉXICO,15,VILLA DEL CARBÓN,112,GOLONDRINAS,2,78,34,44,5
MÉXICO,15,VILLA DEL CARBÓN,112,LA CAÑADA,4,168,67,101,10
MÉXICO,15,VILLA DEL CARBÓN,112,LA CAPILLA,4,186,85,101,13
MÉXICO,15,VILLA DEL CARBÓN,112,LA CENTINELA,3,60,32,28,3
MÉXICO,15,VILLA DEL CARBÓN,112,LA CIÉNEGA,2,19,4,15,2
MÉXICO,15,VILLA DEL CARBÓN,112,LA CRUZ DEL ARENAL,3,138,71,67,9
MÉXICO,15,VILLA DEL CARBÓN,112,LA CRUZ Y CARRIZAL,4,220,99,121,14
MÉXICO,15,VILLA DEL CARBÓN,112,LA ESPERANZA,10,435,216,219,26
MÉXICO,15,VILLA DEL CARBÓN,112,LAS MORAS,5,171,96,75,11
MÉXICO,15,VILLA DEL CARBÓN,112,LAS VIGAS,3,248,134,114,15
MÉXICO,15,VILLA DEL CARBÓN,112,LLANO DE ZACAPEXCO,8,1012,509,503,106
MÉXICO,15,VILLA DEL CARBÓN,112,LLANO GRANDE,3,26,16,10,4
MÉXICO,15,VILLA DEL CARBÓN,112,LOMA ALTA,9,1048,520,528,55
MÉXICO,15,VILLA DEL CARBÓN,112,LOMA ALTA TAXHIMAY,4,446,214,232,26
MÉXICO,15,VILLA DEL CARBÓN,112,LOMA DE DON JUAN,2,6,4,2,2
MÉXICO,15,VILLA DEL CARBÓN,112,"LOMA DE LA CRUZ, LAS VIGAS",2,16,7,9,2
MÉXICO,15,VILLA DEL CARBÓN,112,LOMA DE TROJES,2,19,12,7,2
MÉXICO,15,VILLA DEL CARBÓN,112,LOS ARANA,6,458,230,228,26
MÉXICO,15,VILLA DEL CARBÓN,112,LOS BARBECHOS,2,116,58,58,7
MÉXICO,15,VILLA DEL CARBÓN,112,LOS GUTIÉRREZ,1,24,12,12,1
MÉXICO,15,VILLA DEL CARBÓN,112,LOS ORATORIOS,3,62,32,30,4
MÉXICO,15,VILLA DEL CARBÓN,112,LOS PLATITOS (COLONIA LOS PLATITOS),1,5,1,4,1
MÉXICO,15,VILLA DEL CARBÓN,112,LOS RUEDA,1,18,12,6,1
MÉXICO,15,VILLA DEL CARBÓN,112,MOLINITOS (COMUNIDAD DE LOS MOLINITOS),3,122,62,60,7
MÉXICO,15,VILLA DEL CARBÓN,112,MONTE DE PEÑA,6,286,139,147,19
MÉXICO,15,VILLA DEL CARBÓN,112,PALO HUECO (KILÓMETRO 5),2,69,32,37,3
MÉXICO,15,VILLA DEL CARBÓN,112,PIEQUEXHIMO,3,89,37,52,5
MÉXICO,15,VILLA DEL CARBÓN,112,POTRERO LARGO (VILLA DEL POTRERO),2,25,15,10,2
MÉXICO,15,VILLA DEL CARBÓN,112,PUEBLO NUEVO,10,1019,502,517,54
MÉXICO,15,VILLA DEL CARBÓN,112,RANCHO LOS MADROÑOS,2,15,9,6,2
MÉXICO,15,VILLA DEL CARBÓN,112,RANCHO THARA (RANCHO EL MAGUEYAL),2,66,35,31,14
MÉXICO,15,VILLA DEL CARBÓN,112,SAN ISIDRO DEL BOSQUE,5,225,100,125,14
MÉXICO,15,VILLA DEL CARBÓN,112,SAN LUCAS,3,68,29,39,5
MÉXICO,15,VILLA DEL CARBÓN,112,SAN LUIS ANÁHUAC (TORILES),4,510,258,252,49
MÉXICO,15,VILLA DEL CARBÓN,112,SAN LUIS TAXHIMAY,6,959,471,488,67
MÉXICO,15,VILLA DEL CARBÓN,112,SAN MARTÍN CACHIHUAPAN,6,438,220,218,25
MÉXICO,15,VILLA DEL CARBÓN,112,SAN SALVADOR DE LA LAGUNA,2,88,42,46,4
MÉXICO,15,VILLA DEL CARBÓN,112,SANTA CATARINA,2,80,43,37,5
MÉXICO,15,VILLA DEL CARBÓN,112,SANTA MARÍA,2,38,21,17,3
MÉXICO,15,VILLA DEL CARBÓN,112,TEMANACOYA (BARRIO DE TEMANACOYA),2,28,9,19,2
MÉXICO,15,VILLA DEL CARBÓN,112,VILLA DEL CARBÓN,27,4115,2296,1819,204
MÉXICO,15,VILLA DEL CARBÓN,112,XAJAY (LOMA DEL XAJAY),2,75,33,42,4
MÉXICO,15,VILLA GUERRERO,113,BUENAVISTA,6,400,198,202,26
MÉXICO,15,VILLA GUERRERO,113,COXCACOACO,3,183,80,103,11
MÉXICO,15,VILLA GUERRERO,113,CRUZ VIDRIADA,2,157,70,87,6
MÉXICO,15,VILLA GUERRERO,113,EJIDO DE LA FINCA,4,568,275,293,24
MÉXICO,15,VILLA GUERRERO,113,EJIDO DE SAN MATEO COAPEXCO,3,578,287,291,36
MÉXICO,15,VILLA GUERRERO,113,EL CARMEN,3,236,114,122,16
MÉXICO,15,VILLA GUERRERO,113,EL ISLOTE,2,54,31,23,4
MÉXICO,15,VILLA GUERRERO,113,EL IZOTE,3,51,21,30,4
MÉXICO,15,VILLA GUERRERO,113,EL MORAL,4,203,108,95,10
MÉXICO,15,VILLA GUERRERO,113,EL PEÑÓN,3,37,17,20,4
MÉXICO,15,VILLA GUERRERO,113,EL PROGRESO HIDALGO,4,339,174,165,16
MÉXICO,15,VILLA GUERRERO,113,EL VENTURERO SANTA MARÍA ARANZAZÚ,2,199,110,89,9
MÉXICO,15,VILLA GUERRERO,113,JESÚS CARRANZA (RANCHO DE JESÚS),2,150,71,79,9
MÉXICO,15,VILLA GUERRERO,113,LA FINCA,11,2867,1383,1484,151
MÉXICO,15,VILLA GUERRERO,113,LA JOYA,2,90,49,41,5
MÉXICO,15,VILLA GUERRERO,113,LA LOMA DE LA CONCEPCIÓN (LA LOMA),3,201,100,101,13
MÉXICO,15,VILLA GUERRERO,113,LOS RANCHOS DE SAN JOSÉ,3,218,106,112,10
MÉXICO,15,VILLA GUERRERO,113,MATLAZINCA,3,94,49,45,7
MÉXICO,15,VILLA GUERRERO,113,PORFIRIO DÍAZ,4,329,155,174,20
MÉXICO,15,VILLA GUERRERO,113,POTRERILLOS SANTA MARÍA VILLA GUERRERO,1,15,5,10,1
MÉXICO,15,VILLA GUERRERO,113,POTRERO DE LA SIERRA,3,43,26,17,4
MÉXICO,15,VILLA GUERRERO,113,POTRERO DEL MORAL,2,17,6,11,2
MÉXICO,15,VILLA GUERRERO,113,POTRERO NUEVO,2,126,68,58,7
MÉXICO,15,VILLA GUERRERO,113,SAN BARTOLOMÉ (SAN BARTOLO),5,740,386,354,35
MÉXICO,15,VILLA GUERRERO,113,SAN DIEGO,4,462,252,210,22
MÉXICO,15,VILLA GUERRERO,113,SAN FELIPE,2,240,107,133,12
MÉXICO,15,VILLA GUERRERO,113,SAN FRANCISCO,4,845,401,444,40
MÉXICO,15,VILLA GUERRERO,113,SAN GASPAR,5,370,205,165,17
MÉXICO,15,VILLA GUERRERO,113,SAN JOSÉ,5,699,379,320,35
MÉXICO,15,VILLA GUERRERO,113,SAN LUCAS,7,609,304,305,30
MÉXICO,15,VILLA GUERRERO,113,SAN MATEO COAPEXCO,5,903,463,440,34
MÉXICO,15,VILLA GUERRERO,113,SAN MIGUEL,4,423,215,208,23
MÉXICO,15,VILLA GUERRERO,113,SAN PEDRO BUENOS AIRES (SAN PEDRO),2,32,14,18,3
MÉXICO,15,VILLA GUERRERO,113,SANTA MARÍA ARANZAZÚ (SANTA MARÍA),5,506,265,241,30
MÉXICO,15,VILLA GUERRERO,113,SANTIAGO OXTOTITLÁN,7,999,529,470,63
MÉXICO,15,VILLA GUERRERO,113,TEQUIMILPA,2,32,19,13,3
MÉXICO,15,VILLA GUERRERO,113,TOTOLMAJAC,4,454,241,213,22
MÉXICO,15,VILLA GUERRERO,113,VILLA GUERRERO,19,3296,1697,1599,232
MÉXICO,15,VILLA GUERRERO,113,ZACANGO,6,1076,546,530,60
MÉXICO,15,VILLA GUERRERO,113,ZANJILLAS SAN BARTOLOMÉ,2,219,115,104,10
MÉXICO,15,VILLA VICTORIA,114,AGUA ZARCA,3,202,93,109,12
MÉXICO,15,VILLA VICTORIA,114,BARRIO DE CENTRO DEL CERRILLO,3,448,217,231,26
MÉXICO,15,VILLA VICTORIA,114,BARRIO DE PUENTECILLAS,3,224,97,127,10
MÉXICO,15,VILLA VICTORIA,114,BARRIO DE SAN ISIDRO,5,279,125,154,17
MÉXICO,15,VILLA VICTORIA,114,BARRIO DE SAN MIGUEL,2,216,106,110,7
MÉXICO,15,VILLA VICTORIA,114,BARRIO EL CERRILLO,3,118,53,65,6
MÉXICO,15,VILLA VICTORIA,114,BARRIO EL OCOTE,1,15,6,9,1
MÉXICO,15,VILLA VICTORIA,114,BARRIO EL VIVERO,2,348,172,176,16
MÉXICO,15,VILLA VICTORIA,114,CAMPO NUEVO,2,45,23,22,3
MÉXICO,15,VILLA VICTORIA,114,CASAS COLORADAS,4,318,144,174,16
MÉXICO,15,VILLA VICTORIA,114,CENTRO DEL CERRILLO,4,760,378,382,27
MÉXICO,15,VILLA VICTORIA,114,CERRITOS DEL PILAR,3,265,135,130,13
MÉXICO,15,VILLA VICTORIA,114,COLONIA DOCTOR GUSTAVO BAZ,3,248,120,128,25
MÉXICO,15,VILLA VICTORIA,114,CUADRILLA VIEJA,6,867,452,415,43
MÉXICO,15,VILLA VICTORIA,114,DOLORES VAQUERÍAS,2,145,74,71,8
MÉXICO,15,VILLA VICTORIA,114,EJIDO DE VILLA VICTORIA,2,80,38,42,5
MÉXICO,15,VILLA VICTORIA,114,EJIDO EL HOSPITAL,7,528,254,274,39
MÉXICO,15,VILLA VICTORIA,114,EJIDO LAS PEÑAS,2,42,18,24,3
MÉXICO,15,VILLA VICTORIA,114,EL ATOLE,1,29,13,16,1
MÉXICO,15,VILLA VICTORIA,114,EL CAPULÍN,2,68,38,30,3
MÉXICO,15,VILLA VICTORIA,114,EL CATORCE,1,14,4,10,2
MÉXICO,15,VILLA VICTORIA,114,EL ESPINAL,3,507,251,256,21
MÉXICO,15,VILLA VICTORIA,114,EL FRESNO SAN AGUSTÍN,2,123,56,67,7
MÉXICO,15,VILLA VICTORIA,114,EL JACAL,3,67,38,29,4
MÉXICO,15,VILLA VICTORIA,114,EX-HACIENDA DE AYALA,2,107,57,50,5
MÉXICO,15,VILLA VICTORIA,114,"HOSPITAL PROPIEDAD, DOS ESTRELLAS",2,25,11,14,3
MÉXICO,15,VILLA VICTORIA,114,JESÚS MARÍA,2,409,190,219,18
MÉXICO,15,VILLA VICTORIA,114,JESÚS MARÍA MONTE ALTO,2,75,40,35,4
MÉXICO,15,VILLA VICTORIA,114,LA ALAMEDA,2,120,55,65,6
MÉXICO,15,VILLA VICTORIA,114,LA CAMPANILLA,2,334,175,159,16
MÉXICO,15,VILLA VICTORIA,114,LA PRESA,2,95,52,43,5
MÉXICO,15,VILLA VICTORIA,114,LA PUERTA DEL PILAR,3,524,277,247,23
MÉXICO,15,VILLA VICTORIA,114,LA UNIÓN BERROS,2,73,38,35,4
MÉXICO,15,VILLA VICTORIA,114,LAGUNA SECA 2DA. SECCIÓN,1,73,40,33,3
MÉXICO,15,VILLA VICTORIA,114,LAGUNA SECA EJIDO PRIMERA SECCIÓN,6,312,161,151,15
MÉXICO,15,VILLA VICTORIA,114,LAGUNA SECA PROPIEDAD,2,180,82,98,16
MÉXICO,15,VILLA VICTORIA,114,LAS MILPAS,2,63,28,35,5
MÉXICO,15,VILLA VICTORIA,114,LAS PEÑAS,2,200,114,86,9
MÉXICO,15,VILLA VICTORIA,114,LOMA DE GUADALUPE,2,78,33,45,4
MÉXICO,15,VILLA VICTORIA,114,LOMA DE LA ROSA,2,49,22,27,3
MÉXICO,15,VILLA VICTORIA,114,LOMA DE LIENZO,3,518,245,273,23
MÉXICO,15,VILLA VICTORIA,114,LOMA DE SAN JOSÉ,4,215,112,103,12
MÉXICO,15,VILLA VICTORIA,114,LOMA DEL BURRO,1,17,9,8,1
MÉXICO,15,VILLA VICTORIA,114,LOMA DEL MOLINO,3,73,45,28,6
MÉXICO,15,VILLA VICTORIA,114,LOS CEDROS,5,410,220,190,20
MÉXICO,15,VILLA VICTORIA,114,LOS MATORRALES,2,135,56,79,6
MÉXICO,15,VILLA VICTORIA,114,LOS PADRES EJIDO,1,111,57,54,6
MÉXICO,15,VILLA VICTORIA,114,LOS REMEDIOS SUCHITEPEC,2,269,125,144,12
MÉXICO,15,VILLA VICTORIA,114,MESA DE SUCHITÍMBER,4,179,75,104,12
MÉXICO,15,VILLA VICTORIA,114,MESA DEL ESPINAL,2,42,23,19,4
MÉXICO,15,VILLA VICTORIA,114,MINA VIEJA,6,479,246,233,23
MÉXICO,15,VILLA VICTORIA,114,NUEVO BOSQUE,3,446,218,228,22
MÉXICO,15,VILLA VICTORIA,114,OJO DE AGUA,2,56,33,23,4
MÉXICO,15,VILLA VICTORIA,114,PALIZADA,8,1046,548,498,69
MÉXICO,15,VILLA VICTORIA,114,PIEDRAS BLANCAS (PIEDRAS BLANCAS CENTRO),3,344,188,156,13
MÉXICO,15,VILLA VICTORIA,114,PIEDRAS BLANCAS SUR,1,60,26,34,3
MÉXICO,15,VILLA VICTORIA,114,POTRERO DE SAN DIEGO,5,235,112,123,12
MÉXICO,15,VILLA VICTORIA,114,PUENTE LOS VELÁZQUEZ,2,70,33,37,4
MÉXICO,15,VILLA VICTORIA,114,RAMEJÉ,1,64,29,35,4
MÉXICO,15,VILLA VICTORIA,114,RANCHO DE LOS PADRES PROPIEDAD,2,48,27,21,3
MÉXICO,15,VILLA VICTORIA,114,SAN AGUSTÍN ALTAMIRANO PRIMERA SECCIÓN,8,297,144,153,18
MÉXICO,15,VILLA VICTORIA,114,SAN AGUSTÍN ALTAMIRANO SEGUNDA SECCIÓN,4,158,82,76,8
MÉXICO,15,VILLA VICTORIA,114,SAN AGUSTÍN BERROS,3,875,544,331,43
MÉXICO,15,VILLA VICTORIA,114,SAN AGUSTÍN CANOHILLAS PRIMERA SECCIÓN,4,179,88,91,13
MÉXICO,15,VILLA VICTORIA,114,SAN AGUSTÍN CANOHILLAS SEGUNDA SECCIÓN,3,53,30,23,4
MÉXICO,15,VILLA VICTORIA,114,"SAN AGUSTÍN MONTE ALTO, LA TRAMPA",3,82,31,51,7
MÉXICO,15,VILLA VICTORIA,114,SAN ANTONIO DEL RINCÓN,6,498,257,241,23
MÉXICO,15,VILLA VICTORIA,114,SAN DIEGO DEL CERRITO,7,939,485,454,40
MÉXICO,15,VILLA VICTORIA,114,SAN DIEGO SUCHITEPEC,6,924,470,454,48
MÉXICO,15,VILLA VICTORIA,114,SAN FELIPE DE LA ROSA,6,581,273,308,41
MÉXICO,15,VILLA VICTORIA,114,SAN JOAQUÍN DEL MONTE,2,194,99,95,7
MÉXICO,15,VILLA VICTORIA,114,SAN LUIS EL ALTO,5,309,156,153,17
MÉXICO,15,VILLA VICTORIA,114,SAN LUIS LA GAVIA,4,319,146,173,14
MÉXICO,15,VILLA VICTORIA,114,SAN LUIS LA MANZANA,5,372,183,189,28
MÉXICO,15,VILLA VICTORIA,114,SAN MARCOS DE LA LOMA,4,924,457,467,50
MÉXICO,15,VILLA VICTORIA,114,SAN PEDRO DEL RINCÓN,5,1452,770,682,156
MÉXICO,15,VILLA VICTORIA,114,SAN ROQUE,3,343,171,172,23
MÉXICO,15,VILLA VICTORIA,114,SANSÓN,3,191,87,104,8
MÉXICO,15,VILLA VICTORIA,114,SANTA CRUZ DE LA ROSA,2,98,43,55,5
MÉXICO,15,VILLA VICTORIA,114,SANTA ISABEL DEL MONTE,5,839,443,396,54
MÉXICO,15,VILLA VICTORIA,114,SANTIAGO DEL MONTE,5,1219,627,592,47
MÉXICO,15,VILLA VICTORIA,114,SECCIÓN DE GUADALUPE,3,371,194,177,19
MÉXICO,15,VILLA VICTORIA,114,SITIO CENTRO,4,428,204,224,22
MÉXICO,15,VILLA VICTORIA,114,SITIO EJIDO,4,772,372,400,32
MÉXICO,15,VILLA VICTORIA,114,TURCIO LA LOMA,3,163,79,84,19
MÉXICO,15,VILLA VICTORIA,114,TURCIO PRIMERA SECCIÓN,4,253,129,124,15
MÉXICO,15,VILLA VICTORIA,114,TURCIO SEGUNDA SECCIÓN,3,284,137,147,15
MÉXICO,15,VILLA VICTORIA,114,TURCIO TERCERA SECCIÓN,2,42,23,19,3
MÉXICO,15,VILLA VICTORIA,114,VENTA DE OCOTILLOS,3,451,229,222,25
MÉXICO,15,VILLA VICTORIA,114,VILLA VICTORIA,7,2253,1104,1149,83
MÉXICO,15,XONACATLÁN,115,BARRIO EL RANCHO,2,48,28,20,3
MÉXICO,15,XONACATLÁN,115,BARRIO LA CUESTA,1,30,10,20,2
MÉXICO,15,XONACATLÁN,115,BARRIO LOS MESONES,1,15,6,9,1
MÉXICO,15,XONACATLÁN,115,BARRIO SANTA CRUZ,2,18,7,11,2
MÉXICO,15,XONACATLÁN,115,COLONIA ADOLFO LÓPEZ MATEOS,1,52,27,25,3
MÉXICO,15,XONACATLÁN,115,LA CAÑADA,1,6,4,2,1
MÉXICO,15,XONACATLÁN,115,LA HERRADURA,2,7,3,4,2
MÉXICO,15,XONACATLÁN,115,LA MANGA,6,914,527,387,75
MÉXICO,15,XONACATLÁN,115,LOMAS DE ZOLOTEPEC (LA LOMA),1,43,22,21,2
MÉXICO,15,XONACATLÁN,115,LOS LAURELES,3,98,45,53,6
MÉXICO,15,XONACATLÁN,115,SAN ANTONIO,8,2126,1061,1065,92
MÉXICO,15,XONACATLÁN,115,SAN JUAN EL POTRERO (EL POTRERO),3,95,51,44,7
MÉXICO,15,XONACATLÁN,115,SAN MIGUEL MIMIAPAN,9,1607,802,805,80
MÉXICO,15,XONACATLÁN,115,SANTA MARÍA ZOLOTEPEC,11,2517,1246,1271,143
MÉXICO,15,XONACATLÁN,115,SANTIAGO TEJOCOTILLOS,7,1040,531,509,41
MÉXICO,15,XONACATLÁN,115,XONACATLÁN,20,6205,3148,3057,320
MÉXICO,15,ZACAZONAPAN,116,ALCANTARILLA,1,26,15,11,2
MÉXICO,15,ZACAZONAPAN,116,ARRASTRADERO,1,34,15,19,2
MÉXICO,15,ZACAZONAPAN,116,EL PUERTO,1,62,31,31,3
MÉXICO,15,ZACAZONAPAN,116,LA CAÑADA,2,120,56,64,4
MÉXICO,15,ZACAZONAPAN,116,SANTA MARÍA,2,95,38,57,4
MÉXICO,15,ZACAZONAPAN,116,ZACAZONAPAN,6,1084,567,517,56
MÉXICO,15,ZACUALPAN,117,AGUA DULCE,2,13,6,7,2
MÉXICO,15,ZACUALPAN,117,APETLAHUACAN,3,115,64,51,9
MÉXICO,15,ZACUALPAN,117,AYOTUXCO,3,112,62,50,10
MÉXICO,15,ZACUALPAN,117,CALATEPEC,2,8,3,5,2
MÉXICO,15,ZACUALPAN,117,CERRO DE LA CAMPANA,3,38,16,22,4
MÉXICO,15,ZACUALPAN,117,CERROS CUATES,3,17,12,5,3
MÉXICO,15,ZACUALPAN,117,COLOXTITLÁN,3,132,68,64,10
MÉXICO,15,ZACUALPAN,117,CRUZ DE QUIOTE,4,75,32,43,10
MÉXICO,15,ZACUALPAN,117,EL COLORÍN,3,19,8,11,4
MÉXICO,15,ZACUALPAN,117,EL CORTIJO,2,27,14,13,3
MÉXICO,15,ZACUALPAN,117,EL COYOL,2,18,10,8,2
MÉXICO,15,ZACUALPAN,117,EL DESPOBLADO,3,44,15,29,8
MÉXICO,15,ZACUALPAN,117,EL DURAZNO,4,97,44,53,11
MÉXICO,15,ZACUALPAN,117,EL FRESNO,3,59,32,27,6
MÉXICO,15,ZACUALPAN,117,EL SALTO,2,23,10,13,3
MÉXICO,15,ZACUALPAN,117,EL SITIO,4,26,15,11,5
MÉXICO,15,ZACUALPAN,117,EL VERDECILLO,1,9,7,2,1
MÉXICO,15,ZACUALPAN,117,GAMA DE LA PAZ,3,108,46,62,7
MÉXICO,15,ZACUALPAN,117,HUAXTITLA,2,10,6,4,2
MÉXICO,15,ZACUALPAN,117,HUITZOLTEPEC,5,223,112,111,16
MÉXICO,15,ZACUALPAN,117,IXTAYOTLA,4,83,33,50,10
MÉXICO,15,ZACUALPAN,117,LA CANAL,2,32,17,15,3
MÉXICO,15,ZACUALPAN,117,LA COFRADÍA,4,60,29,31,10
MÉXICO,15,ZACUALPAN,117,LA HACIENDA,3,52,26,26,4
MÉXICO,15,ZACUALPAN,117,LA LUZ,2,38,20,18,3
MÉXICO,15,ZACUALPAN,117,LA MORA,3,57,21,36,4
MÉXICO,15,ZACUALPAN,117,LA TRINIDAD,6,34,18,16,6
MÉXICO,15,ZACUALPAN,117,LAS ARRASTRAS (EL GUAMÚCHIL),2,30,16,14,3
MÉXICO,15,ZACUALPAN,117,LAS HUERTAS,2,16,6,10,2
MÉXICO,15,ZACUALPAN,117,LOS EJIDOS,2,23,12,11,3
MÉXICO,15,ZACUALPAN,117,LOS PLANES VISTA HERMOSA,3,38,20,18,3
MÉXICO,15,ZACUALPAN,117,MAMATLA,4,120,59,61,12
MÉXICO,15,ZACUALPAN,117,PIEDRA PARADA,4,157,81,76,14
MÉXICO,15,ZACUALPAN,117,RÍO FLORIDO 1RA. SECCIÓN,2,30,13,17,4
MÉXICO,15,ZACUALPAN,117,RÍO FLORIDO 2DA. SECCIÓN,4,76,39,37,10
MÉXICO,15,ZACUALPAN,117,SAN ANTONIO AMEALCO,4,56,29,27,9
MÉXICO,15,ZACUALPAN,117,SAN JUAN,1,7,4,3,1
MÉXICO,15,ZACUALPAN,117,SANTIAGO,2,104,54,50,6
MÉXICO,15,ZACUALPAN,117,TEOCALTZINGO,8,150,74,76,16
MÉXICO,15,ZACUALPAN,117,TEPEXTITLÁN (TEPEXTITLÁN 1RA. SECCIÓN),4,114,55,59,9
MÉXICO,15,ZACUALPAN,117,TETZICAPAN (TEXICAPAN),2,99,50,49,7
MÉXICO,15,ZACUALPAN,117,TRES CRUCES,4,76,42,34,10
MÉXICO,15,ZACUALPAN,117,VALLE ENCANTADO,3,41,25,16,3
MÉXICO,15,ZACUALPAN,117,VELIXTLA,3,42,17,25,4
MÉXICO,15,ZACUALPAN,117,YOLOTEPEC,3,38,16,22,5
MÉXICO,15,ZACUALPAN,117,ZACUALPAN,6,968,495,473,64
MÉXICO,15,ZACUALPAN,117,ZACUALPILLA,2,25,13,12,2
MÉXICO,15,ZACUALPAN,117,ZOTZOCOLA,2,42,16,26,3
MÉXICO,15,ZINACANTEPEC,118,AGUA BLANCA EJIDO DE SANTA MARÍA DEL MONTE,2,18,6,12,2
MÉXICO,15,ZINACANTEPEC,118,BARRIO DE LA ROSA,1,22,14,8,2
MÉXICO,15,ZINACANTEPEC,118,BARRIO DE MÉXICO,6,1937,956,981,61
MÉXICO,15,ZINACANTEPEC,118,BUENAVISTA,5,763,366,397,130
MÉXICO,15,ZINACANTEPEC,118,CERRO DEL MURCIÉLAGO,4,415,207,208,50
MÉXICO,15,ZINACANTEPEC,118,COLONIA MORELOS (EJIDO SAN JUAN DE LAS HUERTAS),4,707,322,385,30
MÉXICO,15,ZINACANTEPEC,118,COLONIA RICARDO FLORES MAGÓN,2,233,96,137,8
MÉXICO,15,ZINACANTEPEC,118,EJIDO SAN LORENZO CUAUHTENCO,5,1013,472,541,56
MÉXICO,15,ZINACANTEPEC,118,EL CONTADERO DE MATAMOROS (SAN JOSÉ),4,451,234,217,23
MÉXICO,15,ZINACANTEPEC,118,EL CÓPORO,6,1304,606,698,69
MÉXICO,15,ZINACANTEPEC,118,EL CURTIDOR,1,408,217,191,14
MÉXICO,15,ZINACANTEPEC,118,EL PORVENIR I,1,74,35,39,4
MÉXICO,15,ZINACANTEPEC,118,LA JOYA,5,1567,986,581,110
MÉXICO,15,ZINACANTEPEC,118,LA PEÑUELA,3,177,77,100,12
MÉXICO,15,ZINACANTEPEC,118,LA PUERTA DEL MONTE,2,47,25,22,4
MÉXICO,15,ZINACANTEPEC,118,LOMA ALTA,3,166,84,82,10
MÉXICO,15,ZINACANTEPEC,118,LOMA DE SAN FRANCISCO,3,334,168,166,16
MÉXICO,15,ZINACANTEPEC,118,LOMA DE SAN LUIS MEXTEPEC,3,278,141,137,68
MÉXICO,15,ZINACANTEPEC,118,LOMA DEL KIOSCO,1,16,8,8,2
MÉXICO,15,ZINACANTEPEC,118,OJO DE AGUA,5,607,278,329,27
MÉXICO,15,ZINACANTEPEC,118,RAÍCES,3,165,77,88,11
MÉXICO,15,ZINACANTEPEC,118,RECIBITAS (EL REMOLINO),2,38,18,20,3
MÉXICO,15,ZINACANTEPEC,118,RINCONADA DE TECAXIC,5,389,204,185,32
MÉXICO,15,ZINACANTEPEC,118,SAN ANTONIO ACAHUALCO,17,5410,2675,2735,237
MÉXICO,15,ZINACANTEPEC,118,SAN BARTOLO DEL LLANO (SAN ISIDRO),3,816,414,402,29
MÉXICO,15,ZINACANTEPEC,118,SAN BARTOLO EL VIEJO,3,810,423,387,50
MÉXICO,15,ZINACANTEPEC,118,SAN CRISTÓBAL TECOLIT,11,3346,1670,1676,173
MÉXICO,15,ZINACANTEPEC,118,SAN JOSÉ BARBABOSA,2,96,42,54,13
MÉXICO,15,ZINACANTEPEC,118,SAN JUAN DE LAS HUERTAS,18,4902,2666,2236,278
MÉXICO,15,ZINACANTEPEC,118,SAN LUIS MEXTEPEC,29,6613,3284,3329,358
MÉXICO,15,ZINACANTEPEC,118,SAN MIGUEL ZINACANTEPEC,38,11955,6056,5899,671
MÉXICO,15,ZINACANTEPEC,118,SAN PEDRO TEJALPA,6,964,452,512,42
MÉXICO,15,ZINACANTEPEC,118,SANTA CRUZ CUAUHTENCO,6,1514,759,755,65
MÉXICO,15,ZINACANTEPEC,118,SANTA MARÍA DEL MONTE,13,4105,1965,2140,196
MÉXICO,15,ZINACANTEPEC,118,SANTA MARÍA NATIVITAS,1,36,17,19,3
MÉXICO,15,ZINACANTEPEC,118,TEJALPA,3,452,217,235,19
MÉXICO,15,ZUMPAHUACÁN,119,AHUATZINGO,4,111,60,51,11
MÉXICO,15,ZUMPAHUACÁN,119,BARRIO SAN MIGUEL,3,79,37,42,5
MÉXICO,15,ZUMPAHUACÁN,119,CHIAPA SAN ISIDRO,2,19,8,11,2
MÉXICO,15,ZUMPAHUACÁN,119,COLONIA GUADALUPE VICTORIA,3,148,80,68,9
MÉXICO,15,ZUMPAHUACÁN,119,COLONIA SAN NICOLÁS PALO DULCE,2,17,9,8,3
MÉXICO,15,ZUMPAHUACÁN,119,EL ZAPOTE,2,21,11,10,2
MÉXICO,15,ZUMPAHUACÁN,119,GUADALUPE AHUACATLÁN,4,101,52,49,7
MÉXICO,15,ZUMPAHUACÁN,119,GUADALUPE CHILTAMALCO,2,14,7,7,2
MÉXICO,15,ZUMPAHUACÁN,119,GUADALUPE TLAPIZALCO,3,272,147,125,12
MÉXICO,15,ZUMPAHUACÁN,119,LA ASCENSIÓN,5,600,292,308,34
MÉXICO,15,ZUMPAHUACÁN,119,LLANO DEL COPAL,2,47,17,30,4
MÉXICO,15,ZUMPAHUACÁN,119,SAN ANTONIO GUADALUPE,3,186,94,92,11
MÉXICO,15,ZUMPAHUACÁN,119,SAN GASPAR,5,686,339,347,37
MÉXICO,15,ZUMPAHUACÁN,119,SAN JUAN,1,50,20,30,2
MÉXICO,15,ZUMPAHUACÁN,119,SAN PABLO TEJALPA,3,379,189,190,22
MÉXICO,15,ZUMPAHUACÁN,119,SAN PEDRO GUADALUPE (DESPOBLADO),2,50,24,26,3
MÉXICO,15,ZUMPAHUACÁN,119,SANTA ANA DESPOBLADO,3,70,33,37,4
MÉXICO,15,ZUMPAHUACÁN,119,SANTA CATARINA,3,162,79,83,11
MÉXICO,15,ZUMPAHUACÁN,119,SANTA CRUZ ATEMPA,4,91,45,46,10
MÉXICO,15,ZUMPAHUACÁN,119,SANTA CRUZ DE LOS PILARES,2,60,33,27,4
MÉXICO,15,ZUMPAHUACÁN,119,SANTA MARÍA LA ASUNCIÓN,3,72,39,33,7
MÉXICO,15,ZUMPAHUACÁN,119,ZUMPAHUACÁN,6,1496,757,739,101
MÉXICO,15,ZUMPANGO,120,BARRIO DE ESPAÑA,3,274,120,154,12
MÉXICO,15,ZUMPANGO,120,BARRIO SAN MIGUEL (CAMINO A BATA),5,351,170,181,19
MÉXICO,15,ZUMPANGO,120,BUENAVISTA,17,4835,2418,2417,160
MÉXICO,15,ZUMPANGO,120,COLONIA LÁZARO CÁRDENAS DEL RÍO,3,567,289,278,22
MÉXICO,15,ZUMPANGO,120,COLONIA LOS HORNOS,2,339,165,174,14
MÉXICO,15,ZUMPANGO,120,CONJUNTO URBANO SANTA FE,1,395,193,202,23
MÉXICO,15,ZUMPANGO,120,EL RINCÓN,2,141,63,78,5
MÉXICO,15,ZUMPANGO,120,EX-HACIENDA DE GUADALUPE,1,103,48,55,4
MÉXICO,15,ZUMPANGO,120,HACIENDA LOS ENCINOS,3,1319,684,635,57
MÉXICO,15,ZUMPANGO,120,LA TRINIDAD [FRACCIONAMIENTO],4,906,457,449,32
MÉXICO,15,ZUMPANGO,120,LAS PLAZAS,3,1335,654,681,46
MÉXICO,15,ZUMPANGO,120,LOMA LARGA,2,206,96,110,9
MÉXICO,15,ZUMPANGO,120,LOS ALCANFORES,1,170,75,95,6
MÉXICO,15,ZUMPANGO,120,LOS ROMEROS,1,199,99,100,6
MÉXICO,15,ZUMPANGO,120,NUEVO PASEOS DE SAN JUAN [CONJUNTO URBANO],1,124,58,66,6
MÉXICO,15,ZUMPANGO,120,PASEOS DE SAN JUAN,2,212,99,113,8
MÉXICO,15,ZUMPANGO,120,PASEOS DEL LAGO [FRACCIONAMIENTO],4,554,292,262,32
MÉXICO,15,ZUMPANGO,120,PASEOS DEL LAGO II,3,1062,531,531,49
MÉXICO,15,ZUMPANGO,120,PUEBLO NUEVO DE MORELOS,4,523,263,260,18
MÉXICO,15,ZUMPANGO,120,SAN BARTOLO CUAUTLALPAN,29,7236,3618,3618,284
MÉXICO,15,ZUMPANGO,120,SAN JOSÉ DE LA LOMA,4,716,348,368,28
MÉXICO,15,ZUMPANGO,120,SAN JUAN ZITLALTEPEC,20,6295,3197,3098,337
MÉXICO,15,ZUMPANGO,120,SAN MARCOS DEL LLANO,5,358,171,187,20
MÉXICO,15,ZUMPANGO,120,SAN MIGUEL BOCANEGRA,2,189,89,100,8
MÉXICO,15,ZUMPANGO,120,SAN SEBASTIÁN,13,3212,1663,1549,147
MÉXICO,15,ZUMPANGO,120,SANTA LUCÍA,10,2474,1173,1301,131
MÉXICO,15,ZUMPANGO,120,SANTA MARÍA [UNIDAD HABITACIONAL CTC],4,329,164,165,22
MÉXICO,15,ZUMPANGO,120,SANTA MARÍA CUEVAS,6,907,412,495,55
MÉXICO,15,ZUMPANGO,120,SANTA MARÍA DE GUADALUPE,2,254,152,102,9
MÉXICO,15,ZUMPANGO,120,SANTA MARÍA I Y II,4,1259,671,588,55
MÉXICO,15,ZUMPANGO,120,VILLAS DE LA LAGUNA,10,3079,1531,1548,140
MÉXICO,15,ZUMPANGO,120,VILLAS DE ZUMPANGO [CONJUNTO URBANO],2,755,400,355,30
MÉXICO,15,ZUMPANGO,120,ZUMPANGO DE OCAMPO,129,28219,14993,13226,1833
MÉXICO,15,CUAUTITLÁN IZCALLI,121,AXOTLÁN,4,435,199,236,21
MÉXICO,15,CUAUTITLÁN IZCALLI,121,CUAUTITLÁN IZCALLI,516,140936,72604,68332,10492
MÉXICO,15,CUAUTITLÁN IZCALLI,121,EJIDO DE GUADALUPE,3,856,455,401,20
MÉXICO,15,CUAUTITLÁN IZCALLI,121,EJIDO SANTA MARÍA TIANGUISTENGO,4,1555,771,784,68
MÉXICO,15,CUAUTITLÁN IZCALLI,121,EL ROSARIO,6,678,326,352,32
MÉXICO,15,CUAUTITLÁN IZCALLI,121,SAN JOSÉ HUILANGO,4,710,360,350,32
MÉXICO,15,CUAUTITLÁN IZCALLI,121,TEPOJACO,1,224,109,115,12
MÉXICO,15,VALLE DE CHALCO SOLIDARIDAD,122,COLONIA SAN MIGUEL LAS TABLAS,3,210,100,110,22
MÉXICO,15,VALLE DE CHALCO SOLIDARIDAD,122,SANTA CRUZ,14,4179,2097,2082,190
MÉXICO,15,VALLE DE CHALCO SOLIDARIDAD,122,XICO,312,80863,40903,39960,4202
MÉXICO,15,LUVIANOS,123,ALBOREJO (PUERTO ALBOREJO),2,26,12,14,2
MÉXICO,15,LUVIANOS,123,CAJA DE AGUA,4,156,77,79,17
MÉXICO,15,LUVIANOS,123,CAÑADAS DE NANCHITITLA,4,201,101,100,15
MÉXICO,15,LUVIANOS,123,CARBAJALES,2,11,5,6,2
MÉXICO,15,LUVIANOS,123,CEIBA OBSCURA (PEÑA DEL ÁGUILA),2,4,2,2,2
MÉXICO,15,LUVIANOS,123,CERRO DE CASTELANES,2,56,24,32,3
MÉXICO,15,LUVIANOS,123,CERRO DEL AGUA,1,7,5,2,1
MÉXICO,15,LUVIANOS,123,CERRO DEL VENADO,3,102,44,58,9
MÉXICO,15,LUVIANOS,123,CIPRIANES,5,126,66,60,20
MÉXICO,15,LUVIANOS,123,COLCOMECA,3,9,2,7,3
MÉXICO,15,LUVIANOS,123,CORRAL DEL BARRO,2,12,5,7,2
MÉXICO,15,LUVIANOS,123,CORRAL NUEVO,2,4,2,2,2
MÉXICO,15,LUVIANOS,123,CRUZ DE CLAVOS,2,30,15,15,4
MÉXICO,15,LUVIANOS,123,CRUZ DE PIEDRA,1,4,2,2,1
MÉXICO,15,LUVIANOS,123,CUADRILLA DE BENÍTEZ,1,4,0,4,1
MÉXICO,15,LUVIANOS,123,CUADRILLA DE SÁNCHEZ,2,21,10,11,2
MÉXICO,15,LUVIANOS,123,CUAHUILOTES (CUAJILOTES),2,22,10,12,2
MÉXICO,15,LUVIANOS,123,EL AGUACATE,2,15,8,7,2
MÉXICO,15,LUVIANOS,123,EL CAMPANARIO,3,131,56,75,10
MÉXICO,15,LUVIANOS,123,EL CAPIRE,4,66,33,33,7
MÉXICO,15,LUVIANOS,123,EL CAPIRE DE ACATITLÁN,2,17,9,8,2
MÉXICO,15,LUVIANOS,123,EL CIRIÁN DE HERMILTEPEC,2,27,10,17,3
MÉXICO,15,LUVIANOS,123,EL CUAHUILOTE,1,14,9,5,1
MÉXICO,15,LUVIANOS,123,EL ESTANCO,4,272,132,140,35
MÉXICO,15,LUVIANOS,123,EL MAMEY ACATITLÁN,3,71,37,34,4
MÉXICO,15,LUVIANOS,123,EL MANGUITO,2,17,9,8,3
MÉXICO,15,LUVIANOS,123,EL NARANJO,1,36,16,20,3
MÉXICO,15,LUVIANOS,123,EL NARANJO DE SAN ISIDRO (EL NARANJO PRIMERO),2,49,24,25,6
MÉXICO,15,LUVIANOS,123,EL PUEBLITO,4,89,43,46,13
MÉXICO,15,LUVIANOS,123,EL PUERTO DE LA SOSA,3,7,4,3,3
MÉXICO,15,LUVIANOS,123,EL REPARO DE NANCHITITLA (EL REPARO),4,72,29,43,10
MÉXICO,15,LUVIANOS,123,EL RINCÓN PIEDRA GRANDE,2,41,19,22,4
MÉXICO,15,LUVIANOS,123,EL SALITRE ESTANCIA GRANDE,3,16,5,11,3
MÉXICO,15,LUVIANOS,123,EL SAUZ PALO GORDO,4,76,39,37,10
MÉXICO,15,LUVIANOS,123,EL TANQUE,1,6,2,4,1
MÉXICO,15,LUVIANOS,123,ESTANCIA GRANDE (SAN JOSÉ ESTANCIA GRANDE),5,118,58,60,13
MÉXICO,15,LUVIANOS,123,HERMILTEPEC (PEÑA BLANCA),4,182,95,87,15
MÉXICO,15,LUVIANOS,123,HILAMACHE,2,47,23,24,4
MÉXICO,15,LUVIANOS,123,HORMIGUEROS,3,13,7,6,3
MÉXICO,15,LUVIANOS,123,IGLESIA VIEJA,4,115,54,61,12
MÉXICO,15,LUVIANOS,123,JALPAN,1,18,15,3,1
MÉXICO,15,LUVIANOS,123,LA ESTANCIA DE NANCHITITLA (LA ESTANCIA),4,41,19,22,10
MÉXICO,15,LUVIANOS,123,LA LAGUNA,1,4,3,1,1
MÉXICO,15,LUVIANOS,123,LA MESA DEL POTRERO CHIQUITO,1,10,3,7,3
MÉXICO,15,LUVIANOS,123,LA PALMA,5,134,74,60,12
MÉXICO,15,LUVIANOS,123,LA PAROTA,2,9,5,4,1
MÉXICO,15,LUVIANOS,123,LA TOMA,2,10,5,5,2
MÉXICO,15,LUVIANOS,123,LA UNIDAD (LOS CIRUELOS),2,12,6,6,2
MÉXICO,15,LUVIANOS,123,LAS PALMAS,3,8,2,6,3
MÉXICO,15,LUVIANOS,123,LOS PERICONES (RANCHERÍA LOS PERICONES),1,2,1,1,1
MÉXICO,15,LUVIANOS,123,LOS PINZANES,4,46,24,22,9
MÉXICO,15,LUVIANOS,123,LOS TERREROS,2,5,3,2,2
MÉXICO,15,LUVIANOS,123,MAGADÁN,3,22,7,15,3
MÉXICO,15,LUVIANOS,123,MANGO SOLO,2,13,7,6,2
MÉXICO,15,LUVIANOS,123,MESA DE LOS ESPINOS (MESA DE LAS ESCOBAS),2,6,2,4,2
MÉXICO,15,LUVIANOS,123,MESA DE NIETOS,1,7,3,4,1
MÉXICO,15,LUVIANOS,123,OJO DE AGUA,3,23,12,11,4
MÉXICO,15,LUVIANOS,123,PALO GORDO,4,68,39,29,8
MÉXICO,15,LUVIANOS,123,PALOS PRIETOS,1,5,2,3,1
MÉXICO,15,LUVIANOS,123,PASO DE LA ARENA,2,26,17,9,3
MÉXICO,15,LUVIANOS,123,PASO DEL AGUA (CRISTO REY),3,36,15,21,8
MÉXICO,15,LUVIANOS,123,PEÑA CALVA,2,8,3,5,2
MÉXICO,15,LUVIANOS,123,PIEDRA COLORADA,3,25,10,15,6
MÉXICO,15,LUVIANOS,123,PIEDRA GRANDE,5,206,97,109,16
MÉXICO,15,LUVIANOS,123,POTRERO DE PALMARILLOS,1,8,5,3,1
MÉXICO,15,LUVIANOS,123,POTRERO VALLECITOS (EL POTRERO),2,38,18,20,3
MÉXICO,15,LUVIANOS,123,PUERTA DE GOLPE,2,30,10,20,3
MÉXICO,15,LUVIANOS,123,PUERTO DE LOS TERREROS,1,5,1,4,1
MÉXICO,15,LUVIANOS,123,PUERTO DEL HIGO,2,14,8,6,2
MÉXICO,15,LUVIANOS,123,PUERTO DEL SALITRE,2,27,14,13,3
MÉXICO,15,LUVIANOS,123,PUNGARANCHO,1,16,9,7,2
MÉXICO,15,LUVIANOS,123,RANCHO VIEJO,4,183,78,105,14
MÉXICO,15,LUVIANOS,123,RINCÓN CRUZ DE CLAVOS,2,21,10,11,3
MÉXICO,15,LUVIANOS,123,RINCÓN DE CIPRIANES,2,15,4,11,2
MÉXICO,15,LUVIANOS,123,RINCÓN DE RODRÍGUEZ,3,67,37,30,8
MÉXICO,15,LUVIANOS,123,RINCÓN DE SAN LUCAS,2,25,14,11,3
MÉXICO,15,LUVIANOS,123,RINCÓN DEL HILAMACHE,1,5,3,2,1
MÉXICO,15,LUVIANOS,123,RINCÓN DEL NARANJO LA PRESA,1,8,3,5,1
MÉXICO,15,LUVIANOS,123,SALITRE DEL PUENTE (PUENTE DEL SALITRE),2,32,17,15,3
MÉXICO,15,LUVIANOS,123,SALITRE PIEDRA GRANDE,1,17,5,12,2
MÉXICO,15,LUVIANOS,123,SAN ANTONIO LUVIANOS (SAN ANTONIO),2,19,12,7,2
MÉXICO,15,LUVIANOS,123,SAN JUAN ACATITLÁN (ACATITLÁN),4,390,197,193,37
MÉXICO,15,LUVIANOS,123,SAN SEBASTIÁN (RINCÓN DE SAN SEBASTIÁN),5,112,50,62,9
MÉXICO,15,LUVIANOS,123,SAN SIMÓN PIEDRA GRANDE (SAN SIMÓN),1,8,3,5,1
MÉXICO,15,LUVIANOS,123,SANTA CRUZ,4,76,41,35,8
MÉXICO,15,LUVIANOS,123,SANTA ROSA ESTANCIA GRANDE,2,56,34,22,7
MÉXICO,15,LUVIANOS,123,SANTA ROSA HERMILTEPEC,2,48,19,29,4
MÉXICO,15,LUVIANOS,123,TOMA DE AGUA,3,71,32,39,5
MÉXICO,15,LUVIANOS,123,TRES ENCINOS,2,11,4,7,2
MÉXICO,15,LUVIANOS,123,TROJES,4,134,69,65,13
MÉXICO,15,LUVIANOS,123,VALLECITOS DE HERMILTEPEC (VALLECITO),4,87,43,44,10
MÉXICO,15,LUVIANOS,123,VILLA LUVIANOS,19,2969,1497,1472,240
MÉXICO,15,SAN JOSÉ DEL RINCÓN,124,AGUA ZARCA PUEBLO NUEVO,3,267,136,131,14
MÉXICO,15,SAN JOSÉ DEL RINCÓN,124,BARRIO CANOAS GUARDA LA LAGUNITA,7,645,308,337,34
MÉXICO,15,SAN JOSÉ DEL RINCÓN,124,BARRIO CANOAS SAN FELIPE DE JESÚS,3,58,27,31,6
MÉXICO,15,SAN JOSÉ DEL RINCÓN,124,BARRIO CHIVATÍ LA MESA,2,133,67,66,7
MÉXICO,15,SAN JOSÉ DEL RINCÓN,124,BARRIO EL CALVARIO CONCEPCIÓN LA VENTA,1,16,7,9,1
MÉXICO,15,SAN JOSÉ DEL RINCÓN,124,BARRIO EL CERRITO PUEBLO NUEVO,2,7,3,4,2
MÉXICO,15,SAN JOSÉ DEL RINCÓN,124,BARRIO EL LIJADERO LA MESA,1,54,25,29,3
MÉXICO,15,SAN JOSÉ DEL RINCÓN,124,BARRIO EL LLANO DE LAS ROSAS,3,49,23,26,5
MÉXICO,15,SAN JOSÉ DEL RINCÓN,124,BARRIO EL LLANO SAN JUAN PALO SECO,2,75,45,30,4
MÉXICO,15,SAN JOSÉ DEL RINCÓN,124,BARRIO EL OCHO EL PINTAL,5,86,48,38,8
MÉXICO,15,SAN JOSÉ DEL RINCÓN,124,BARRIO EL PINTADO PUEBLO NUEVO,2,66,28,38,4
MÉXICO,15,SAN JOSÉ DEL RINCÓN,124,BARRIO EL PINTAL EL DEPÓSITO,5,587,312,275,31
MÉXICO,15,SAN JOSÉ DEL RINCÓN,124,BARRIO EL QUELITE PUEBLO NUEVO,4,140,64,76,8
MÉXICO,15,SAN JOSÉ DEL RINCÓN,124,BARRIO EL TEPETATE GUARDA DE SAN ANTONIO BUENAVISTA,2,69,35,34,4
MÉXICO,15,SAN JOSÉ DEL RINCÓN,124,BARRIO FUNDEREJE EL DEPÓSITO,2,54,31,23,6
MÉXICO,15,SAN JOSÉ DEL RINCÓN,124,BARRIO LA MAGDALENA SAN JUAN PALO SECO,3,84,38,46,5
MÉXICO,15,SAN JOSÉ DEL RINCÓN,124,BARRIO LA MESA LA LAGUNITA,1,10,4,6,1
MÉXICO,15,SAN JOSÉ DEL RINCÓN,124,BARRIO LA PALMA EL DEPÓSITO,1,75,39,36,3
MÉXICO,15,SAN JOSÉ DEL RINCÓN,124,BARRIO LOMA BONITA GUARDA LA LAGUNITA,2,120,57,63,19
MÉXICO,15,SAN JOSÉ DEL RINCÓN,124,BARRIO PUENTECILLAS EL DEPÓSITO,2,76,36,40,4
MÉXICO,15,SAN JOSÉ DEL RINCÓN,124,BARRIO ROSA SAN ANTONIO CONCEPCIÓN DEL MONTE,2,71,33,38,3
MÉXICO,15,SAN JOSÉ DEL RINCÓN,124,BARRIO SAN BARTOLO GUARDA LA LAGUNITA,3,37,18,19,3
MÉXICO,15,SAN JOSÉ DEL RINCÓN,124,BARRIO SAN DIEGO PUEBLO NUEVO,3,182,87,95,13
MÉXICO,15,SAN JOSÉ DEL RINCÓN,124,BARRIO SAN JOAQUÍN LAMILLAS,5,410,209,201,21
MÉXICO,15,SAN JOSÉ DEL RINCÓN,124,BARRIO SANTA JUANITA EL DEPÓSITO,5,145,60,85,11
MÉXICO,15,SAN JOSÉ DEL RINCÓN,124,BUENAVISTA CASA BLANCA,2,55,24,31,3
MÉXICO,15,SAN JOSÉ DEL RINCÓN,124,BUENAVISTA CASA BLANCA EJIDO,1,11,6,5,1
MÉXICO,15,SAN JOSÉ DEL RINCÓN,124,CAÑADA DEL SAUCO,2,82,43,39,4
MÉXICO,15,SAN JOSÉ DEL RINCÓN,124,CEDRO DE LA MANZANA,4,313,134,179,18
MÉXICO,15,SAN JOSÉ DEL RINCÓN,124,CEVATÍ,3,28,8,20,3
MÉXICO,15,SAN JOSÉ DEL RINCÓN,124,CIENEGUILLAS,2,40,20,20,3
MÉXICO,15,SAN JOSÉ DEL RINCÓN,124,CONCEPCIÓN DEL MONTE,5,177,82,95,13
MÉXICO,15,SAN JOSÉ DEL RINCÓN,124,CONCEPCIÓN LA VENTA,5,563,276,287,31
MÉXICO,15,SAN JOSÉ DEL RINCÓN,124,EJIDO EL CONSUELO,2,48,27,21,4
MÉXICO,15,SAN JOSÉ DEL RINCÓN,124,EJIDO LA SOLEDAD,5,668,335,333,31
MÉXICO,15,SAN JOSÉ DEL RINCÓN,124,EJIDO LOS PINTADOS,1,18,9,9,1
MÉXICO,15,SAN JOSÉ DEL RINCÓN,124,EL CABLE EJIDO EL DEPÓSITO,3,32,19,13,4
MÉXICO,15,SAN JOSÉ DEL RINCÓN,124,EL CAPULÍN SAN MIGUEL DEL CENTRO,1,24,14,10,2
MÉXICO,15,SAN JOSÉ DEL RINCÓN,124,EL HUIZACHE,3,207,116,91,14
MÉXICO,15,SAN JOSÉ DEL RINCÓN,124,EL LLANO SAN MIGUEL DEL CENTRO,1,5,2,3,1
MÉXICO,15,SAN JOSÉ DEL RINCÓN,124,EL PORVENIR,3,28,14,14,3
MÉXICO,15,SAN JOSÉ DEL RINCÓN,124,EL SALTO LA VENTA,3,410,204,206,28
MÉXICO,15,SAN JOSÉ DEL RINCÓN,124,EL VALERIO,4,346,170,176,18
MÉXICO,15,SAN JOSÉ DEL RINCÓN,124,ESTACIÓN LA TRINIDAD,3,55,26,29,5
MÉXICO,15,SAN JOSÉ DEL RINCÓN,124,FÁBRICA CONCEPCIÓN,6,396,218,178,25
MÉXICO,15,SAN JOSÉ DEL RINCÓN,124,FÁBRICA PUEBLO NUEVO,2,198,103,95,8
MÉXICO,15,SAN JOSÉ DEL RINCÓN,124,FÁBRICA PUEBLO NUEVO MONTE ALTO,2,56,30,26,4
MÉXICO,15,SAN JOSÉ DEL RINCÓN,124,FALDA LOMA,3,31,18,13,3
MÉXICO,15,SAN JOSÉ DEL RINCÓN,124,FUNDEREJE BARRIO EL REMBLAZO,4,45,20,25,5
MÉXICO,15,SAN JOSÉ DEL RINCÓN,124,GARATACHEA,1,24,10,14,2
MÉXICO,15,SAN JOSÉ DEL RINCÓN,124,GUADALUPE BUENAVISTA,3,182,92,90,12
MÉXICO,15,SAN JOSÉ DEL RINCÓN,124,GUADALUPE CHICO,2,278,142,136,11
MÉXICO,15,SAN JOSÉ DEL RINCÓN,124,GUADALUPE DEL PEDREGAL,2,50,25,25,4
MÉXICO,15,SAN JOSÉ DEL RINCÓN,124,GUADALUPE DEL PEDREGAL LA PALMA,2,46,17,29,3
MÉXICO,15,SAN JOSÉ DEL RINCÓN,124,GUADALUPE LAS CABRAS,1,20,12,8,1
MÉXICO,15,SAN JOSÉ DEL RINCÓN,124,GUARDA DE GUADALUPE,3,526,251,275,25
MÉXICO,15,SAN JOSÉ DEL RINCÓN,124,GUARDA DE SAN ANTONIO BUENAVISTA,2,179,97,82,7
MÉXICO,15,SAN JOSÉ DEL RINCÓN,124,GUARDA LA LAGUNITA EL POTRERO,2,75,32,43,6
MÉXICO,15,SAN JOSÉ DEL RINCÓN,124,GUARDA SAN ANTONIO PLAZA DE GALLOS,4,141,93,48,11
MÉXICO,15,SAN JOSÉ DEL RINCÓN,124,JALTEPEC CENTRO,4,592,328,264,43
MÉXICO,15,SAN JOSÉ DEL RINCÓN,124,JESÚS CARRANZA,2,81,44,37,4
MÉXICO,15,SAN JOSÉ DEL RINCÓN,124,LA CHISPA,2,126,63,63,7
MÉXICO,15,SAN JOSÉ DEL RINCÓN,124,LA ESPERANZA,4,207,105,102,17
MÉXICO,15,SAN JOSÉ DEL RINCÓN,124,LA MESA,9,767,383,384,41
MÉXICO,15,SAN JOSÉ DEL RINCÓN,124,LA SOLEDAD EL GUARDA,3,79,42,37,6
MÉXICO,15,SAN JOSÉ DEL RINCÓN,124,LA TRAMPA CHICA,1,17,7,10,1
MÉXICO,15,SAN JOSÉ DEL RINCÓN,124,LA TRAMPA GRANDE,3,217,112,105,10
MÉXICO,15,SAN JOSÉ DEL RINCÓN,124,LA TRINIDAD CONCEPCIÓN,4,433,214,219,22
MÉXICO,15,SAN JOSÉ DEL RINCÓN,124,LAS ROSAS,9,661,336,325,34
MÉXICO,15,SAN JOSÉ DEL RINCÓN,124,LOMA DEL CEDRO EL DEPÓSITO,3,160,85,75,11
MÉXICO,15,SAN JOSÉ DEL RINCÓN,124,LOMA DEL RANCHO,3,184,87,97,10
MÉXICO,15,SAN JOSÉ DEL RINCÓN,124,LOS LOBOS CENTRO,7,666,336,330,30
MÉXICO,15,SAN JOSÉ DEL RINCÓN,124,MINITA DEL CEDRO I,1,138,64,74,6
MÉXICO,15,SAN JOSÉ DEL RINCÓN,124,MINITA DEL CEDRO II,3,178,97,81,10
MÉXICO,15,SAN JOSÉ DEL RINCÓN,124,PALO AMARILLO,4,208,107,101,12
MÉXICO,15,SAN JOSÉ DEL RINCÓN,124,PANCHO MAYA,3,38,18,20,4
MÉXICO,15,SAN JOSÉ DEL RINCÓN,124,PATHE MULA DE LOS CEDROS,5,189,91,98,12
MÉXICO,15,SAN JOSÉ DEL RINCÓN,124,PROVIDENCIA EJIDO EL DEPÓSITO,3,1028,550,478,42
MÉXICO,15,SAN JOSÉ DEL RINCÓN,124,RAMEJÉ EJIDO EL DEPÓSITO,4,458,215,243,22
MÉXICO,15,SAN JOSÉ DEL RINCÓN,124,RANCHERÍA LAS ROSAS,1,32,14,18,2
MÉXICO,15,SAN JOSÉ DEL RINCÓN,124,RANCHERÍA LOS PINTADOS,3,85,37,48,5
MÉXICO,15,SAN JOSÉ DEL RINCÓN,124,ROSA DE LA PALMA,4,278,139,139,17
MÉXICO,15,SAN JOSÉ DEL RINCÓN,124,ROSA DE PALO AMARILLO,2,88,47,41,4
MÉXICO,15,SAN JOSÉ DEL RINCÓN,124,SABANETA QUINTANA,2,99,53,46,4
MÉXICO,15,SAN JOSÉ DEL RINCÓN,124,SAN ANTONIO PUEBLO NUEVO,9,872,459,413,72
MÉXICO,15,SAN JOSÉ DEL RINCÓN,124,SAN FELIPE DE JESÚS,3,156,71,85,18
MÉXICO,15,SAN JOSÉ DEL RINCÓN,124,SAN FRANCISCO DE LA LOMA,6,611,308,303,30
MÉXICO,15,SAN JOSÉ DEL RINCÓN,124,SAN FRANCISCO SOLO,2,120,61,59,7
MÉXICO,15,SAN JOSÉ DEL RINCÓN,124,SAN ISIDRO LA TRINIDAD,1,35,21,14,2
MÉXICO,15,SAN JOSÉ DEL RINCÓN,124,SAN JERÓNIMO DE LOS DOLORES,4,489,253,236,22
MÉXICO,15,SAN JOSÉ DEL RINCÓN,124,SAN JERÓNIMO PILITAS,4,52,25,27,7
MÉXICO,15,SAN JOSÉ DEL RINCÓN,124,SAN JOAQUÍN DEL MONTE,7,736,403,333,56
MÉXICO,15,SAN JOSÉ DEL RINCÓN,124,SAN JOAQUÍN LAMILLAS CENTRO,3,308,165,143,15
MÉXICO,15,SAN JOSÉ DEL RINCÓN,124,SAN JOSÉ DEL RINCÓN CENTRO,10,1590,787,803,79
MÉXICO,15,SAN JOSÉ DEL RINCÓN,124,SAN JOSÉ DEL RINCÓN EJIDO,2,453,238,215,17
MÉXICO,15,SAN JOSÉ DEL RINCÓN,124,SAN JUAN EVANGELISTA FRACCIÓN X,2,62,29,33,3
MÉXICO,15,SAN JOSÉ DEL RINCÓN,124,SAN JUAN PALO SECO CENTRO,8,878,468,410,42
MÉXICO,15,SAN JOSÉ DEL RINCÓN,124,SAN MIGUEL AGUA BENDITA,7,1001,506,495,62
MÉXICO,15,SAN JOSÉ DEL RINCÓN,124,SAN MIGUEL CHISDA,1,34,15,19,2
MÉXICO,15,SAN JOSÉ DEL RINCÓN,124,SAN MIGUEL DEL CENTRO,12,1148,581,567,55
MÉXICO,15,SAN JOSÉ DEL RINCÓN,124,SAN ONOFRE CENTRO,2,464,231,233,16
MÉXICO,15,SAN JOSÉ DEL RINCÓN,124,SAN ONOFRE EJIDO,1,202,96,106,10
MÉXICO,15,SAN JOSÉ DEL RINCÓN,124,SANACOCHE EJIDO,3,61,28,33,5
MÉXICO,15,SAN JOSÉ DEL RINCÓN,124,SANTA CRUZ DEL RINCÓN,2,82,38,44,5
MÉXICO,15,SAN JOSÉ DEL RINCÓN,124,SANTA CRUZ DEL TEJOCOTE,7,438,234,204,39
MÉXICO,15,SAN JOSÉ DEL RINCÓN,124,SANTIAGO GIGANTE JALTEPEC,7,1014,512,502,40
MÉXICO,15,SAN JOSÉ DEL RINCÓN,124,YONDECE DEL CEDRO,4,431,228,203,18
MÉXICO,15,SAN JOSÉ DEL RINCÓN,124,YONDECE EL GRANDE,1,83,48,35,7
MÉXICO,15,TONANITLA,125,SANTA MARÍA TONANITLA,8,2831,1479,1352,123
MÉXICO,15,TONANITLA,125,VILLAS DE TONANITLA,3,414,204,210,17
NAYARIT,18,ACAPONETA,001,ACAPONETA,41,6431,3385,3046,379
NAYARIT,18,ACAPONETA,001,AMADO NERVO,1,6,3,3,1
NAYARIT,18,ACAPONETA,001,BUENAVISTA (LAS PAREDES),3,70,37,33,4
NAYARIT,18,ACAPONETA,001,CAÑONES,2,7,2,5,1
NAYARIT,18,ACAPONETA,001,CASAS COLORADAS,3,61,24,37,4
NAYARIT,18,ACAPONETA,001,CERRO BOLA,3,59,29,30,4
NAYARIT,18,ACAPONETA,001,EL AGUAJE,3,84,41,43,5
NAYARIT,18,ACAPONETA,001,EL CARRIZAL,3,75,36,39,5
NAYARIT,18,ACAPONETA,001,EL CARRIZO,3,13,2,11,2
NAYARIT,18,ACAPONETA,001,EL CENTENARIO,3,280,135,145,16
NAYARIT,18,ACAPONETA,001,EL NARANJO,4,189,100,89,9
NAYARIT,18,ACAPONETA,001,EL ORO,2,7,1,6,1
NAYARIT,18,ACAPONETA,001,EL RECODO,4,303,160,143,23
NAYARIT,18,ACAPONETA,001,EL RESBALÓN,4,148,73,75,10
NAYARIT,18,ACAPONETA,001,EL TACOTE,1,18,6,12,1
NAYARIT,18,ACAPONETA,001,EL TECHALOTE,2,12,5,7,1
NAYARIT,18,ACAPONETA,001,EL TIGRE,4,196,102,94,13
NAYARIT,18,ACAPONETA,001,HACIENDA DE MARIQUITAS,2,16,7,9,2
NAYARIT,18,ACAPONETA,001,LA BAYONA,2,57,29,28,11
NAYARIT,18,ACAPONETA,001,LA GUÁSIMA,3,187,86,101,16
NAYARIT,18,ACAPONETA,001,LA HIGUERITA NUEVA (EL CARRIZO),2,5,2,3,2
NAYARIT,18,ACAPONETA,001,LA LAGUNITA,1,6,4,2,1
NAYARIT,18,ACAPONETA,001,LA PALOMA NUEVA REFORMA,2,29,13,16,2
NAYARIT,18,ACAPONETA,001,LA PALOMA PRIMERA,3,54,31,23,4
NAYARIT,18,ACAPONETA,001,LAS CASITAS,2,40,15,25,3
NAYARIT,18,ACAPONETA,001,LAS HIGUERAS,2,6,3,3,1
NAYARIT,18,ACAPONETA,001,LLANO DE LA CRUZ,3,107,44,63,8
NAYARIT,18,ACAPONETA,001,LOS SANDOVALES,2,25,14,11,2
NAYARIT,18,ACAPONETA,001,MESA DE LA LAGUNA,2,57,25,32,3
NAYARIT,18,ACAPONETA,001,MESA DE PEDRO PABLO,3,42,21,21,3
NAYARIT,18,ACAPONETA,001,OJO DE AGUA DEL TEJÓN,3,61,30,31,4
NAYARIT,18,ACAPONETA,001,PIEDRA ANCHA,2,15,6,9,2
NAYARIT,18,ACAPONETA,001,RANCHO EL ZAPOTE,3,70,29,41,4
NAYARIT,18,ACAPONETA,001,SAN BLASITO,3,53,29,24,4
NAYARIT,18,ACAPONETA,001,SAN DIEGO DE ALCALÁ,4,142,75,67,11
NAYARIT,18,ACAPONETA,001,SAN DIEGUITO DE ABAJO,3,70,30,40,6
NAYARIT,18,ACAPONETA,001,SAN DIEGUITO DE ARRIBA,2,36,15,21,3
NAYARIT,18,ACAPONETA,001,SAN JOSÉ DE GRACIA,3,158,76,82,10
NAYARIT,18,ACAPONETA,001,SAN JOSÉ DE MOTAJE,3,53,23,30,4
NAYARIT,18,ACAPONETA,001,SAN MIGUEL,3,93,39,54,12
NAYARIT,18,ACAPONETA,001,SAN PEDRO DE HONOR,3,45,24,21,3
NAYARIT,18,ACAPONETA,001,SANTA CRUZ,2,70,35,35,4
NAYARIT,18,ACAPONETA,001,SAYCOTA,3,41,25,16,3
NAYARIT,18,ACAPONETA,001,SAYULILLA,4,374,182,192,24
NAYARIT,18,ACAPONETA,001,VALLE DE LA URRACA (EL CABILDO),2,36,16,20,2
NAYARIT,18,ACAPONETA,001,ZACATECAS,2,6,3,3,1
NAYARIT,18,AHUACATLÁN,002,AHUACATLÁN,15,1846,935,911,131
NAYARIT,18,AHUACATLÁN,002,HERIBERTO JARA (LA HACIENDITA),4,253,122,131,16
NAYARIT,18,AHUACATLÁN,002,LA CAMPANA,3,30,11,19,3
NAYARIT,18,AHUACATLÁN,002,LA CIÉNEGA,2,24,14,10,2
NAYARIT,18,AHUACATLÁN,002,LA GLORIA,2,7,2,5,1
NAYARIT,18,AHUACATLÁN,002,LAS CEBOLLAS,3,35,17,18,3
NAYARIT,18,AHUACATLÁN,002,LAS PALMAS,3,37,14,23,3
NAYARIT,18,AHUACATLÁN,002,MARQUEZADO,4,163,73,90,13
NAYARIT,18,AHUACATLÁN,002,SANTA CRUZ DE CAMOTLÁN,4,116,51,65,10
NAYARIT,18,AHUACATLÁN,002,SANTA ISABEL,4,677,342,335,70
NAYARIT,18,AHUACATLÁN,002,TETITLÁN,3,243,112,131,20
NAYARIT,18,AHUACATLÁN,002,UZETA,3,315,159,156,19
NAYARIT,18,AHUACATLÁN,002,VALLE VERDE,2,70,41,29,5
NAYARIT,18,AHUACATLÁN,002,ZOATLÁN (SAN FRANCISCO DE ZOATLÁN),3,100,56,44,6
NAYARIT,18,AMATLÁN DE CAÑAS,003,AMATLÁN DE CAÑAS,6,635,311,324,37
NAYARIT,18,AMATLÁN DE CAÑAS,003,BARRANCA DEL ORO,2,49,26,23,4
NAYARIT,18,AMATLÁN DE CAÑAS,003,EL PILÓN,3,28,13,15,3
NAYARIT,18,AMATLÁN DE CAÑAS,003,EL ROSARIO,3,223,92,131,18
NAYARIT,18,AMATLÁN DE CAÑAS,003,ESTANCIA DE LOS LÓPEZ,6,877,434,443,69
NAYARIT,18,AMATLÁN DE CAÑAS,003,JESÚS MARÍA,4,119,57,62,7
NAYARIT,18,AMATLÁN DE CAÑAS,003,LA YERBABUENA,3,87,32,55,5
NAYARIT,18,AMATLÁN DE CAÑAS,003,LAS ANONAS,1,2,2,0,1
NAYARIT,18,AMATLÁN DE CAÑAS,003,LAS HEMBRILLAS,3,9,0,9,2
NAYARIT,18,AMATLÁN DE CAÑAS,003,LOS CERRITOS,3,40,15,25,3
NAYARIT,18,AMATLÁN DE CAÑAS,003,MEZQUITES,3,161,87,74,14
NAYARIT,18,AMATLÁN DE CAÑAS,003,SAN BLASITO,3,120,58,62,7
NAYARIT,18,AMATLÁN DE CAÑAS,003,TEPUZHUACÁN,4,311,145,166,19
NAYARIT,18,COMPOSTELA,004,ALTAVISTA,3,93,50,43,6
NAYARIT,18,COMPOSTELA,004,BUENAVISTA,2,15,9,6,2
NAYARIT,18,COMPOSTELA,004,CÁNDIDO SALAZAR,4,127,63,64,9
NAYARIT,18,COMPOSTELA,004,CHACALA,5,89,42,47,15
NAYARIT,18,COMPOSTELA,004,CHULAVISTA,1,48,23,25,3
NAYARIT,18,COMPOSTELA,004,COASTECOMATILLO,3,28,12,16,3
NAYARIT,18,COMPOSTELA,004,COMPOSTELA,33,5500,2788,2712,331
NAYARIT,18,COMPOSTELA,004,CUMBRES DE HUICICILA,5,120,59,61,11
NAYARIT,18,COMPOSTELA,004,EL CAPOMO,3,189,100,89,15
NAYARIT,18,COMPOSTELA,004,EL DIVISADERO,3,38,14,24,4
NAYARIT,18,COMPOSTELA,004,EL PARANAL (AROCHA),3,95,51,44,7
NAYARIT,18,COMPOSTELA,004,EL REFILIÓN,1,10,4,6,1
NAYARIT,18,COMPOSTELA,004,EL SALITRE,2,8,5,3,1
NAYARIT,18,COMPOSTELA,004,EL TAMARINDO,2,16,6,10,3
NAYARIT,18,COMPOSTELA,004,EL TONINO,2,26,9,17,2
NAYARIT,18,COMPOSTELA,004,EL TONINO [BLOQUERA],1,7,5,2,1
NAYARIT,18,COMPOSTELA,004,FELIPE CARRILLO PUERTO,3,195,93,102,16
NAYARIT,18,COMPOSTELA,004,IXTAPA DE LA CONCEPCIÓN,3,216,108,108,22
NAYARIT,18,COMPOSTELA,004,JUAN ESCUTIA (BORBOLLÓN),3,177,86,91,15
NAYARIT,18,COMPOSTELA,004,LA CUATA,2,24,13,11,2
NAYARIT,18,COMPOSTELA,004,LA JOYA,1,65,27,38,3
NAYARIT,18,COMPOSTELA,004,LA PEÑITA DE JALTEMBA,29,4513,2251,2262,238
NAYARIT,18,COMPOSTELA,004,LA PUERTA DE LA LIMA,2,92,41,51,6
NAYARIT,18,COMPOSTELA,004,LAS COLORADAS,2,8,3,5,1
NAYARIT,18,COMPOSTELA,004,LAS PIEDRAS,3,153,81,72,9
NAYARIT,18,COMPOSTELA,004,LAS VARAS,26,3985,2064,1921,276
NAYARIT,18,COMPOSTELA,004,LIMA DE ABAJO,4,267,133,134,17
NAYARIT,18,COMPOSTELA,004,LOS AYALA,2,149,63,86,6
NAYARIT,18,COMPOSTELA,004,MAZATÁN,4,235,107,128,16
NAYARIT,18,COMPOSTELA,004,MESILLAS,3,46,20,26,4
NAYARIT,18,COMPOSTELA,004,MIRAVALLES,3,160,80,80,10
NAYARIT,18,COMPOSTELA,004,MONTEÓN,3,502,251,251,29
NAYARIT,18,COMPOSTELA,004,NUEVO IXTLÁN (LAS CAÑADAS),3,32,14,18,3
NAYARIT,18,COMPOSTELA,004,OTATES Y CANTARRANAS,4,180,91,89,13
NAYARIT,18,COMPOSTELA,004,PASO DE LAS PALMAS,3,177,79,98,10
NAYARIT,18,COMPOSTELA,004,RESERVA NATURAL DEL PALMAR (EL SUSPIRO) [COLONIA],2,13,10,3,1
NAYARIT,18,COMPOSTELA,004,RINCÓN DE GUAYABITOS,3,362,201,161,15
NAYARIT,18,COMPOSTELA,004,SAN ISIDRO,2,20,13,7,2
NAYARIT,18,COMPOSTELA,004,TEPIQUEÑOS,2,21,10,11,2
NAYARIT,18,COMPOSTELA,004,ÚRSULO GALVÁN,3,147,60,87,9
NAYARIT,18,COMPOSTELA,004,VILLA MORELOS,3,127,62,65,7
NAYARIT,18,COMPOSTELA,004,VIZCARRA,2,37,17,20,3
NAYARIT,18,COMPOSTELA,004,ZACUALPAN,9,1096,544,552,82
NAYARIT,18,COMPOSTELA,004,ZAPOTÁN,4,267,138,129,16
NAYARIT,18,HUAJICORI,005,ACATITA,2,14,7,7,2
NAYARIT,18,HUAJICORI,005,AGUA CERRADA,2,20,9,11,2
NAYARIT,18,HUAJICORI,005,CONTADERO,4,67,35,32,6
NAYARIT,18,HUAJICORI,005,EL ARRAYÁN,2,44,20,24,2
NAYARIT,18,HUAJICORI,005,EL ASERRADERO,1,33,12,21,1
NAYARIT,18,HUAJICORI,005,EL CHAPULÍN,2,6,3,3,1
NAYARIT,18,HUAJICORI,005,EL CIRUELITO,1,1,1,0,0
NAYARIT,18,HUAJICORI,005,EL COLOMO,2,16,8,8,2
NAYARIT,18,HUAJICORI,005,EL COLORADO,2,30,16,14,3
NAYARIT,18,HUAJICORI,005,EL CORPO,1,9,3,6,1
NAYARIT,18,HUAJICORI,005,EL GUAYABO,3,25,15,10,3
NAYARIT,18,HUAJICORI,005,EL GUAYABO (LA PIEDRA RAJADA),2,5,2,3,1
NAYARIT,18,HUAJICORI,005,EL PANTANO,1,5,2,3,1
NAYARIT,18,HUAJICORI,005,EL RIÍTO,3,99,56,43,7
NAYARIT,18,HUAJICORI,005,EL RINCÓN,2,12,7,5,2
NAYARIT,18,HUAJICORI,005,EL RODEO DE ARRIBA,2,8,4,4,1
NAYARIT,18,HUAJICORI,005,EL SALTO,4,42,29,13,4
NAYARIT,18,HUAJICORI,005,EL TAISTE,2,8,2,6,1
NAYARIT,18,HUAJICORI,005,EL TEPEHUAJE,2,10,5,5,1
NAYARIT,18,HUAJICORI,005,EL TOMATE,2,14,6,8,2
NAYARIT,18,HUAJICORI,005,EL TORO,1,12,6,6,1
NAYARIT,18,HUAJICORI,005,GUADALAJARITA,1,13,5,8,1
NAYARIT,18,HUAJICORI,005,GUAMUCHILAR,3,81,28,53,5
NAYARIT,18,HUAJICORI,005,HUAJICORI,11,1279,654,625,78
NAYARIT,18,HUAJICORI,005,HUITALOTA,3,79,38,41,6
NAYARIT,18,HUAJICORI,005,LA CAMPANA (EL MIMBRE),3,72,32,40,4
NAYARIT,18,HUAJICORI,005,LA ESTANCIA,4,168,68,100,12
NAYARIT,18,HUAJICORI,005,LA MESA DEL COCO,3,29,14,15,3
NAYARIT,18,HUAJICORI,005,LA MURALLITA,3,77,35,42,4
NAYARIT,18,HUAJICORI,005,LA PEÑA COLORADA,1,11,5,6,1
NAYARIT,18,HUAJICORI,005,LA QUEBRADA,2,13,6,7,2
NAYARIT,18,HUAJICORI,005,LA VINATA,1,14,5,9,1
NAYARIT,18,HUAJICORI,005,LAS CEBOLLITAS,2,5,5,0,1
NAYARIT,18,HUAJICORI,005,LAS GUÁSIMAS (LOMA LARGA),3,19,6,13,3
NAYARIT,18,HUAJICORI,005,LAS JUNTITAS,2,5,2,3,1
NAYARIT,18,HUAJICORI,005,LAS QUEMADAS,2,7,4,3,1
NAYARIT,18,HUAJICORI,005,LAS SILLAS,2,9,4,5,1
NAYARIT,18,HUAJICORI,005,LLANO DE TENEPANTA,3,37,17,20,3
NAYARIT,18,HUAJICORI,005,LLANO GRANDE,3,92,44,48,6
NAYARIT,18,HUAJICORI,005,LOS CIMIENTOS,3,29,13,16,3
NAYARIT,18,HUAJICORI,005,LOS LLANITOS,2,23,11,12,2
NAYARIT,18,HUAJICORI,005,LOS TOBOS,2,12,10,2,2
NAYARIT,18,HUAJICORI,005,MESA DE LOS RICOS,4,124,55,69,7
NAYARIT,18,HUAJICORI,005,MINERAL DE CUCHARAS,4,142,62,80,9
NAYARIT,18,HUAJICORI,005,PACHECOS,2,65,27,38,3
NAYARIT,18,HUAJICORI,005,PROVIDENCIA,2,20,10,10,2
NAYARIT,18,HUAJICORI,005,QUIVIQUINTA,4,175,87,88,11
NAYARIT,18,HUAJICORI,005,SAN ANDRÉS MILPILLAS,4,275,131,144,14
NAYARIT,18,HUAJICORI,005,SAN FRANCISCO DEL CAIMÁN,2,56,25,31,5
NAYARIT,18,HUAJICORI,005,SANTA MARÍA DE PICACHOS,4,189,87,102,14
NAYARIT,18,HUAJICORI,005,TAMAZOLE,3,36,14,22,3
NAYARIT,18,HUAJICORI,005,TATEPOZCO,2,14,6,8,1
NAYARIT,18,HUAJICORI,005,TESCOMATITA (LAS TROJAS),3,20,12,8,3
NAYARIT,18,HUAJICORI,005,TIERRA BLANCA,1,4,3,1,1
NAYARIT,18,HUAJICORI,005,VALLE MORELOS (HIGUERA GACHA),2,11,6,5,2
NAYARIT,18,HUAJICORI,005,ZAPOTILLOS,2,20,7,13,2
NAYARIT,18,HUAJICORI,005,ZONTECO,3,74,44,30,5
NAYARIT,18,IXTLÁN DEL RÍO,006,CACALUTÁN,4,112,58,54,10
NAYARIT,18,IXTLÁN DEL RÍO,006,EL AGUACATE,3,33,10,23,3
NAYARIT,18,IXTLÁN DEL RÍO,006,EL TERRERO,3,90,36,54,6
NAYARIT,18,IXTLÁN DEL RÍO,006,IXTLÁN DEL RÍO,36,6961,3690,3271,475
NAYARIT,18,IXTLÁN DEL RÍO,006,LA HIGUERITA,4,89,51,38,7
NAYARIT,18,IXTLÁN DEL RÍO,006,LOS MEZQUITES,4,104,54,50,8
NAYARIT,18,IXTLÁN DEL RÍO,006,LOS SAUCES,2,6,1,5,1
NAYARIT,18,IXTLÁN DEL RÍO,006,MEXPAN,3,258,119,139,22
NAYARIT,18,IXTLÁN DEL RÍO,006,RANCHOS DE ARRIBA (SAN ANTONIO),3,52,25,27,4
NAYARIT,18,IXTLÁN DEL RÍO,006,SAN JOSÉ DE GRACIA (EL PUEBLITO),2,27,12,15,2
NAYARIT,18,IXTLÁN DEL RÍO,006,SAN MIGUEL,2,14,7,7,2
NAYARIT,18,IXTLÁN DEL RÍO,006,SAYULÁPAN,2,7,2,5,1
NAYARIT,18,JALA,007,COAPAN,3,99,60,39,6
NAYARIT,18,JALA,007,COFRADÍA DE JUANACATLÁN,3,390,201,189,29
NAYARIT,18,JALA,007,COLONIA LINDAVISTA,1,23,14,9,1
NAYARIT,18,JALA,007,COLONIA LOS RAMÍREZ,2,11,5,6,1
NAYARIT,18,JALA,007,COYONCA,2,5,2,3,2
NAYARIT,18,JALA,007,EL CHARRO,3,26,12,14,3
NAYARIT,18,JALA,007,EL CIRUELO,3,41,24,17,3
NAYARIT,18,JALA,007,EL DIVISADERO,1,4,2,2,1
NAYARIT,18,JALA,007,EL JARAL,3,25,8,17,3
NAYARIT,18,JALA,007,EL JARALITO,1,6,3,3,1
NAYARIT,18,JALA,007,FRANCISCO I. MADERO (LA BOLSA),2,178,82,96,9
NAYARIT,18,JALA,007,JALA,12,2184,1108,1076,150
NAYARIT,18,JALA,007,JALPA GRANDE,3,47,22,25,3
NAYARIT,18,JALA,007,JOMULCO,5,519,262,257,22
NAYARIT,18,JALA,007,LA COFRADÍA DE BUENOS AIRES,3,36,16,20,3
NAYARIT,18,JALA,007,LA CRUZ,2,23,13,10,3
NAYARIT,18,JALA,007,LA SABANA,3,12,6,6,2
NAYARIT,18,JALA,007,LOS AGUAJES,4,432,226,206,16
NAYARIT,18,JALA,007,PLAN DE BUENOS AIRES,2,4,2,2,1
NAYARIT,18,JALA,007,PUEBLO NUEVO,2,45,18,27,3
NAYARIT,18,JALA,007,ROSA BLANCA,8,1078,556,522,66
NAYARIT,18,JALA,007,SAN ANTONIO (RANCHO NUEVO),3,27,16,11,3
NAYARIT,18,JALA,007,SAN MIGUEL DE BUENAVISTA,2,123,67,56,7
NAYARIT,18,JALA,007,SANTA FE,3,30,18,12,3
NAYARIT,18,JALA,007,TAHUITOLPA,2,4,2,2,1
NAYARIT,18,JALA,007,TORRECILLAS,3,16,10,6,2
NAYARIT,18,XALISCO,008,ADOLFO LÓPEZ MATEOS (LAS VEREDAS),3,56,28,28,5
NAYARIT,18,XALISCO,008,AQUILES SERDÁN,3,215,99,116,17
NAYARIT,18,XALISCO,008,COFRADÍA DE CHOCOLÓN,4,210,107,103,15
NAYARIT,18,XALISCO,008,EL CARRIZAL,1,18,7,11,1
NAYARIT,18,XALISCO,008,EL CUARENTEÑO,4,218,116,102,16
NAYARIT,18,XALISCO,008,EL MALINAL,4,93,47,46,8
NAYARIT,18,XALISCO,008,EL TEPOZAL,3,47,18,29,5
NAYARIT,18,XALISCO,008,EMILIANO ZAPATA (MAJADAS),4,397,202,195,24
NAYARIT,18,XALISCO,008,JUAN ESCUTIA (GUAJOLOTES),2,11,7,4,2
NAYARIT,18,XALISCO,008,LA CURVA,5,288,156,132,15
NAYARIT,18,XALISCO,008,LOS FORTINES,2,9,5,4,1
NAYARIT,18,XALISCO,008,PALAPITA,3,51,22,29,4
NAYARIT,18,XALISCO,008,PANTANAL,10,1725,861,864,141
NAYARIT,18,XALISCO,008,SAN ANTONIO,3,34,17,17,3
NAYARIT,18,XALISCO,008,SAN JOSÉ DE COSTILLA (ESTACIÓN COSTILLA),2,55,31,24,4
NAYARIT,18,XALISCO,008,TESTERAZO,4,464,229,235,25
NAYARIT,18,XALISCO,008,TRIGOMIL,3,105,47,58,6
NAYARIT,18,XALISCO,008,XALISCO,61,14154,6659,7495,949
NAYARIT,18,DEL NAYAR,009,AGUAMILPA,3,67,30,37,4
NAYARIT,18,DEL NAYAR,009,ARROYO CAÑAVERAL,3,84,44,40,4
NAYARIT,18,DEL NAYAR,009,ARROYO CAPOMO,2,12,7,5,2
NAYARIT,18,DEL NAYAR,009,ARROYO DE CAMARONES,4,258,129,129,14
NAYARIT,18,DEL NAYAR,009,ARROYO DE SANTIAGO,2,40,20,20,2
NAYARIT,18,DEL NAYAR,009,ARROYO DEL FRAILE,1,13,7,6,1
NAYARIT,18,DEL NAYAR,009,ATONALISCO,3,66,35,31,5
NAYARIT,18,DEL NAYAR,009,BOCA DE ARROYO SANTIAGO,2,6,2,4,1
NAYARIT,18,DEL NAYAR,009,CAMPATEHUALA,1,2,0,2,0
NAYARIT,18,DEL NAYAR,009,CARRIZAL DE LAS VIGAS,3,107,61,46,6
NAYARIT,18,DEL NAYAR,009,CEBOLLITAS,1,86,43,43,3
NAYARIT,18,DEL NAYAR,009,CERRO DEL ÁGUILA,2,36,23,13,2
NAYARIT,18,DEL NAYAR,009,CERRO PELÓN,2,29,12,17,3
NAYARIT,18,DEL NAYAR,009,CHUPARROSA,2,15,6,9,1
NAYARIT,18,DEL NAYAR,009,CIÉNEGA DE SANTA ROSA,2,41,19,22,2
NAYARIT,18,DEL NAYAR,009,CIÉNEGA DEL MANGO,2,38,14,24,2
NAYARIT,18,DEL NAYAR,009,COFRADÍA DE PERICOS,3,92,41,51,5
NAYARIT,18,DEL NAYAR,009,COMAL DE PEÑITA,3,60,36,24,3
NAYARIT,18,DEL NAYAR,009,COYULTITA DE JAZMINES,3,78,31,47,7
NAYARIT,18,DEL NAYAR,009,COYUNQUE,3,107,54,53,6
NAYARIT,18,DEL NAYAR,009,CUAUHTÉMOC,3,60,35,25,4
NAYARIT,18,DEL NAYAR,009,DOLORES,3,215,108,107,10
NAYARIT,18,DEL NAYAR,009,EL AIRE,2,15,8,7,1
NAYARIT,18,DEL NAYAR,009,EL ALGODONAL,1,6,4,2,1
NAYARIT,18,DEL NAYAR,009,EL ARCO,2,5,3,2,1
NAYARIT,18,DEL NAYAR,009,EL CAMICHÍN,2,35,21,14,2
NAYARIT,18,DEL NAYAR,009,EL CANGREJO,3,48,18,30,3
NAYARIT,18,DEL NAYAR,009,EL CAPOMO,3,43,18,25,3
NAYARIT,18,DEL NAYAR,009,EL CARRIZAL,1,18,9,9,1
NAYARIT,18,DEL NAYAR,009,EL CARRIZO,2,25,14,11,2
NAYARIT,18,DEL NAYAR,009,EL CASCABEL,2,5,5,0,1
NAYARIT,18,DEL NAYAR,009,EL CHALATE,2,31,13,18,4
NAYARIT,18,DEL NAYAR,009,EL CIRUELAR,3,42,22,20,3
NAYARIT,18,DEL NAYAR,009,EL COLOMO,3,66,30,36,4
NAYARIT,18,DEL NAYAR,009,EL COLORÍN,3,41,22,19,4
NAYARIT,18,DEL NAYAR,009,EL CORDÓN,1,27,13,14,1
NAYARIT,18,DEL NAYAR,009,EL GUACO,2,63,30,33,3
NAYARIT,18,DEL NAYAR,009,EL LIMÓN,5,126,64,62,7
NAYARIT,18,DEL NAYAR,009,EL MAGUEY,2,161,88,73,7
NAYARIT,18,DEL NAYAR,009,EL MIRADOR,1,23,6,17,2
NAYARIT,18,DEL NAYAR,009,EL NARANJO,2,32,19,13,2
NAYARIT,18,DEL NAYAR,009,EL NOGAL,4,78,43,35,4
NAYARIT,18,DEL NAYAR,009,EL NOVILLERO,2,19,10,9,2
NAYARIT,18,DEL NAYAR,009,EL PASO CUATE,2,20,10,10,2
NAYARIT,18,DEL NAYAR,009,EL PINITO,2,62,30,32,3
NAYARIT,18,DEL NAYAR,009,EL PINITO NUEVO (LA MUÑECA),1,17,10,7,2
NAYARIT,18,DEL NAYAR,009,EL RINCÓN (LAS SILLAS),1,3,3,0,1
NAYARIT,18,DEL NAYAR,009,EL RISCO,2,57,33,24,3
NAYARIT,18,DEL NAYAR,009,EL ROBLE,3,149,72,77,8
NAYARIT,18,DEL NAYAR,009,EL ROBLITO,3,73,33,40,5
NAYARIT,18,DEL NAYAR,009,EL SABINO,4,94,47,47,6
NAYARIT,18,DEL NAYAR,009,EL SALITRE,3,25,14,11,4
NAYARIT,18,DEL NAYAR,009,EL SAUCITO,3,29,19,10,3
NAYARIT,18,DEL NAYAR,009,EL SAUCITO PEYOTÁN,3,168,89,79,8
NAYARIT,18,DEL NAYAR,009,EL SAUZ,2,33,15,18,2
NAYARIT,18,DEL NAYAR,009,EL SEGUNDO PASO,2,20,10,10,2
NAYARIT,18,DEL NAYAR,009,EL SORDO,2,20,12,8,2
NAYARIT,18,DEL NAYAR,009,EL TEMPISQUE,2,28,15,13,2
NAYARIT,18,DEL NAYAR,009,EL ZAPOTE,2,26,11,15,3
NAYARIT,18,DEL NAYAR,009,GAVILANES,3,197,91,106,12
NAYARIT,18,DEL NAYAR,009,GUÁSIMA DEL METATE,4,173,81,92,9
NAYARIT,18,DEL NAYAR,009,GUÁSIMAS DEL CAIMÁN,3,73,33,40,5
NAYARIT,18,DEL NAYAR,009,HIGUERA GORDA,3,114,57,57,6
NAYARIT,18,DEL NAYAR,009,HUAYNAMOTA,5,265,140,125,18
NAYARIT,18,DEL NAYAR,009,IXTALPA,3,56,23,33,3
NAYARIT,18,DEL NAYAR,009,JAZMÍN DEL COQUITO,4,269,136,133,16
NAYARIT,18,DEL NAYAR,009,JAZMINES DE COYULTITA,4,52,24,28,6
NAYARIT,18,DEL NAYAR,009,JESÚS MARÍA,21,1847,901,946,102
NAYARIT,18,DEL NAYAR,009,LA BONITA,1,14,9,5,1
NAYARIT,18,DEL NAYAR,009,LA CIÉNEGA,1,44,21,23,2
NAYARIT,18,DEL NAYAR,009,LA CIÉNEGA DE GERBACIO,2,13,11,2,2
NAYARIT,18,DEL NAYAR,009,LA CIÉNEGA DE SAN FELIPE,3,39,22,17,3
NAYARIT,18,DEL NAYAR,009,LA CIENEGUITA,3,58,28,30,5
NAYARIT,18,DEL NAYAR,009,LA COFRADÍA UNO,3,238,130,108,12
NAYARIT,18,DEL NAYAR,009,LA CUESTA,2,4,3,1,1
NAYARIT,18,DEL NAYAR,009,LA CUEVA PRIETA,1,17,8,9,1
NAYARIT,18,DEL NAYAR,009,LA CUMBRE DEL DURAZNITO,3,81,44,37,5
NAYARIT,18,DEL NAYAR,009,LA GUERRA,2,67,35,32,3
NAYARIT,18,DEL NAYAR,009,LA MESITA (EL LLANO GRANDE),2,4,4,0,2
NAYARIT,18,DEL NAYAR,009,LA MESITA (LA MESA DE ZEFERINO),2,12,4,8,1
NAYARIT,18,DEL NAYAR,009,LA MEZQUITERA,3,19,11,8,3
NAYARIT,18,DEL NAYAR,009,LA MOJARRA,3,36,23,13,3
NAYARIT,18,DEL NAYAR,009,LA NOPALERA,1,2,0,2,1
NAYARIT,18,DEL NAYAR,009,LA PALMITA,5,134,68,66,8
NAYARIT,18,DEL NAYAR,009,LA QUEMADA,2,26,12,14,4
NAYARIT,18,DEL NAYAR,009,LA SILLETA,3,70,35,35,5
NAYARIT,18,DEL NAYAR,009,LA TABERNA,2,31,18,13,2
NAYARIT,18,DEL NAYAR,009,LA TINAJA,2,9,4,5,1
NAYARIT,18,DEL NAYAR,009,LA TRAVESÍA,3,34,16,18,5
NAYARIT,18,DEL NAYAR,009,LA VENTANILLA,1,16,10,6,1
NAYARIT,18,DEL NAYAR,009,LAGUNA DE LAS VACAS,2,13,7,6,2
NAYARIT,18,DEL NAYAR,009,LAS AZUCENAS,2,12,5,7,1
NAYARIT,18,DEL NAYAR,009,LAS CUEVAS,2,17,8,9,2
NAYARIT,18,DEL NAYAR,009,LAS ESTRELLAS,2,78,37,41,4
NAYARIT,18,DEL NAYAR,009,LAS GUACAMAYAS,3,130,59,71,5
NAYARIT,18,DEL NAYAR,009,LAS GUAYABAS,2,17,5,12,2
NAYARIT,18,DEL NAYAR,009,LAS GUINEAS DE GUADALUPE,3,62,29,33,3
NAYARIT,18,DEL NAYAR,009,LAS HIGUERAS,4,159,75,84,10
NAYARIT,18,DEL NAYAR,009,LAS HORMIGAS,4,106,48,58,6
NAYARIT,18,DEL NAYAR,009,LAS HUERTITAS,3,132,68,64,7
NAYARIT,18,DEL NAYAR,009,LAS LECHUGUILLAS,2,16,10,6,2
NAYARIT,18,DEL NAYAR,009,LAS MINAS,2,44,21,23,3
NAYARIT,18,DEL NAYAR,009,LAS PALMAS,1,4,2,2,1
NAYARIT,18,DEL NAYAR,009,LAS PATILLAS,3,25,13,12,3
NAYARIT,18,DEL NAYAR,009,LAS URRACAS,3,37,16,21,3
NAYARIT,18,DEL NAYAR,009,LINDA VISTA,4,637,315,322,40
NAYARIT,18,DEL NAYAR,009,LOS AIRES,2,54,29,25,3
NAYARIT,18,DEL NAYAR,009,LOS ARRAYANES,2,12,6,6,1
NAYARIT,18,DEL NAYAR,009,LOS CHAPILES (HITACHI),3,34,15,19,2
NAYARIT,18,DEL NAYAR,009,LOS CIRUELOS,3,40,22,18,3
NAYARIT,18,DEL NAYAR,009,LOS CUEROS,2,15,8,7,1
NAYARIT,18,DEL NAYAR,009,LOS CUERVITOS,3,49,22,27,3
NAYARIT,18,DEL NAYAR,009,LOS ENCINOS,3,154,80,74,7
NAYARIT,18,DEL NAYAR,009,LOS FIERROS,2,88,48,40,4
NAYARIT,18,DEL NAYAR,009,LOS GRANOS,2,13,10,3,2
NAYARIT,18,DEL NAYAR,009,LOS HUIZACHES,3,104,59,45,5
NAYARIT,18,DEL NAYAR,009,LOS LIMONES,2,51,27,24,3
NAYARIT,18,DEL NAYAR,009,LOS LIRIOS,1,60,31,29,2
NAYARIT,18,DEL NAYAR,009,LOS LLANITOS,7,83,44,39,6
NAYARIT,18,DEL NAYAR,009,LOS MANGUITOS,2,58,31,27,3
NAYARIT,18,DEL NAYAR,009,LOS PAREJOS,1,6,2,4,1
NAYARIT,18,DEL NAYAR,009,LOS PINITOS (DOLORES VIEJO),1,25,10,15,1
NAYARIT,18,DEL NAYAR,009,LOS SABINOS,1,7,4,3,1
NAYARIT,18,DEL NAYAR,009,LOS TABACOS,2,17,9,8,3
NAYARIT,18,DEL NAYAR,009,LOS TACOS,1,10,3,7,1
NAYARIT,18,DEL NAYAR,009,LOS TIGRES (EL METATE),2,26,14,12,2
NAYARIT,18,DEL NAYAR,009,MESA DE COCOROCHAS,2,40,19,21,2
NAYARIT,18,DEL NAYAR,009,MESA DE LOS HUICHOLES,1,14,5,9,1
NAYARIT,18,DEL NAYAR,009,MESA DEL NAYAR,10,1999,1074,925,107
NAYARIT,18,DEL NAYAR,009,NARANJITO DE COPAL,4,238,108,130,14
NAYARIT,18,DEL NAYAR,009,NOCHECITA,1,4,0,4,1
NAYARIT,18,DEL NAYAR,009,OJO DE AGUA,1,32,19,13,2
NAYARIT,18,DEL NAYAR,009,PALOMAS,1,4,4,0,1
NAYARIT,18,DEL NAYAR,009,PASO DE ÁLICA (AGUA BUENA),3,75,37,38,5
NAYARIT,18,DEL NAYAR,009,PEÑA BLANCA,2,16,5,11,2
NAYARIT,18,DEL NAYAR,009,PEÑAS AMARILLAS,3,61,23,38,4
NAYARIT,18,DEL NAYAR,009,PICACHOS,1,9,3,6,1
NAYARIT,18,DEL NAYAR,009,PICO DEL ÁGUILA (TANKANINI),2,57,29,28,3
NAYARIT,18,DEL NAYAR,009,PIEDRA IGLESIA,1,28,15,13,1
NAYARIT,18,DEL NAYAR,009,PLAYA DE GOLONDRINAS,3,75,41,34,5
NAYARIT,18,DEL NAYAR,009,POTRERO DE LA PALMITA,3,194,109,85,12
NAYARIT,18,DEL NAYAR,009,PUEBLO NUEVO,2,37,16,21,2
NAYARIT,18,DEL NAYAR,009,PUEBLO NUEVO EL ALTO,2,51,28,23,3
NAYARIT,18,DEL NAYAR,009,PUENTE DE CARRIZAL,2,23,14,9,2
NAYARIT,18,DEL NAYAR,009,RANCHO DE IGNACIO (LOS FORTINES),3,28,17,11,4
NAYARIT,18,DEL NAYAR,009,RANCHO DOROTEO,3,34,14,20,3
NAYARIT,18,DEL NAYAR,009,RANCHO VIEJO,9,370,203,167,18
NAYARIT,18,DEL NAYAR,009,SAN FRANCISCO,4,205,109,96,14
NAYARIT,18,DEL NAYAR,009,SAN GREGORIO,3,126,76,50,7
NAYARIT,18,DEL NAYAR,009,SAN ISIDRO,4,114,53,61,7
NAYARIT,18,DEL NAYAR,009,SAN JUAN PEYOTÁN,3,183,88,95,11
NAYARIT,18,DEL NAYAR,009,SAN MIGUEL DEL ZAPOTE,2,27,15,12,2
NAYARIT,18,DEL NAYAR,009,SAN PABLO,3,84,42,42,5
NAYARIT,18,DEL NAYAR,009,SAN RAFAEL,1,15,7,8,1
NAYARIT,18,DEL NAYAR,009,SAN RAFAEL (SAN RAFAEL ALTO),5,196,90,106,11
NAYARIT,18,DEL NAYAR,009,SAN VICENTE,3,141,66,75,8
NAYARIT,18,DEL NAYAR,009,SAN VICTORIA,2,7,2,5,1
NAYARIT,18,DEL NAYAR,009,SANTA ANITA,3,30,16,14,4
NAYARIT,18,DEL NAYAR,009,SANTA BÁRBARA,4,190,86,104,11
NAYARIT,18,DEL NAYAR,009,SANTA CRUZ,2,27,13,14,2
NAYARIT,18,DEL NAYAR,009,SANTA CRUZ DE GUAYBEL,3,356,193,163,22
NAYARIT,18,DEL NAYAR,009,SANTA GERTRUDIS,2,42,25,17,3
NAYARIT,18,DEL NAYAR,009,SANTA ROSA,3,94,44,50,5
NAYARIT,18,DEL NAYAR,009,SANTA TERESA,13,864,452,412,43
NAYARIT,18,DEL NAYAR,009,TIERRA BLANCA DEL PICACHO,3,105,54,51,6
NAYARIT,18,DEL NAYAR,009,TIERRAS BLANCAS,3,19,11,8,3
NAYARIT,18,DEL NAYAR,009,ZOQUIPAN,4,209,105,104,15
NAYARIT,18,DEL NAYAR,009,ZOQUIPILLA,3,60,26,34,4
NAYARIT,18,ROSAMORADA,010,ABELARDO L. RODRÍGUEZ (AMAPA),2,36,16,20,2
NAYARIT,18,ROSAMORADA,010,AGUA ACEDA,3,76,30,46,5
NAYARIT,18,ROSAMORADA,010,BONITA,2,18,6,12,2
NAYARIT,18,ROSAMORADA,010,CHILAPA,4,342,174,168,20
NAYARIT,18,ROSAMORADA,010,COFRADÍA DE CUYUTLÁN,6,389,202,187,21
NAYARIT,18,ROSAMORADA,010,COLONIAS 18 DE MARZO,3,217,99,118,18
NAYARIT,18,ROSAMORADA,010,COYOTES,2,12,6,6,2
NAYARIT,18,ROSAMORADA,010,EL OCHENTA,2,6,4,2,1
NAYARIT,18,ROSAMORADA,010,EL TAMARINDO,4,296,131,165,20
NAYARIT,18,ROSAMORADA,010,FRANCISCO VILLA,3,169,73,96,12
NAYARIT,18,ROSAMORADA,010,LA BOQUITA,3,99,49,50,6
NAYARIT,18,ROSAMORADA,010,LA LOMA,2,23,7,16,2
NAYARIT,18,ROSAMORADA,010,LAS PILAS,3,160,73,87,8
NAYARIT,18,ROSAMORADA,010,LLANO DEL TIGRE,4,248,129,119,14
NAYARIT,18,ROSAMORADA,010,LOS ARRAYANES,3,74,31,43,5
NAYARIT,18,ROSAMORADA,010,LOS LEANDROS,3,80,35,45,5
NAYARIT,18,ROSAMORADA,010,LOS MEDINA,4,145,72,73,11
NAYARIT,18,ROSAMORADA,010,MINITAS,2,20,8,12,2
NAYARIT,18,ROSAMORADA,010,MOJOCUAUTLA (ADJUNTAS),4,194,112,82,13
NAYARIT,18,ROSAMORADA,010,PARAMITA,3,171,91,80,11
NAYARIT,18,ROSAMORADA,010,PASO REAL DEL BEJUCO,3,80,37,43,6
NAYARIT,18,ROSAMORADA,010,PERICOS,3,313,159,154,28
NAYARIT,18,ROSAMORADA,010,PESCADERO,5,263,128,135,17
NAYARIT,18,ROSAMORADA,010,PIMIENTILLO,4,344,152,192,23
NAYARIT,18,ROSAMORADA,010,PROVIDENCIA,3,79,37,42,5
NAYARIT,18,ROSAMORADA,010,PUENTE EL BEJUCO (EL CAPRICHO),2,22,16,6,2
NAYARIT,18,ROSAMORADA,010,ROSAMORADA,10,1237,627,610,100
NAYARIT,18,ROSAMORADA,010,ROSARITO,3,103,58,45,6
NAYARIT,18,ROSAMORADA,010,SAN DIEGO DEL NARANJO,4,202,101,101,13
NAYARIT,18,ROSAMORADA,010,SAN JUAN BAUTISTA,5,390,205,185,22
NAYARIT,18,ROSAMORADA,010,SAN JUAN CORAPAN,3,200,97,103,10
NAYARIT,18,ROSAMORADA,010,SAN MIGUELITO,3,134,62,72,8
NAYARIT,18,ROSAMORADA,010,SAN VICENTE,6,1240,660,580,99
NAYARIT,18,ROSAMORADA,010,SANTA FE,3,98,48,50,7
NAYARIT,18,ROSAMORADA,010,TEPONAHUAXTLA (HUAIXTA),4,240,124,116,14
NAYARIT,18,ROSAMORADA,010,VICENTE GUERRERO (EL MOGOTE),3,80,32,48,5
NAYARIT,18,ROSAMORADA,010,ZOMATLÁN DEL CAIMANERO,3,152,74,78,9
NAYARIT,18,RUÍZ,011,CHIMALTITA,3,65,29,36,4
NAYARIT,18,RUÍZ,011,CORDÓN DEL JILGUERO,4,101,46,55,10
NAYARIT,18,RUÍZ,011,EL CARRIZAL,2,6,3,3,2
NAYARIT,18,RUÍZ,011,EL CARRIZO,3,33,12,21,3
NAYARIT,18,RUÍZ,011,EL COQUITO,1,16,10,6,1
NAYARIT,18,RUÍZ,011,EL NARANJO,3,63,33,30,4
NAYARIT,18,RUÍZ,011,EL REFUGIO,3,48,25,23,4
NAYARIT,18,RUÍZ,011,EL TAIXTE,2,23,11,12,3
NAYARIT,18,RUÍZ,011,EL VENADO,3,294,140,154,18
NAYARIT,18,RUÍZ,011,EL VOLANTÍN,2,5,2,3,1
NAYARIT,18,RUÍZ,011,EL ZOPILOTE,3,77,34,43,6
NAYARIT,18,RUÍZ,011,HEROICO BATALLÓN DE SAN BLAS (LA NORIA),3,113,62,51,7
NAYARIT,18,RUÍZ,011,HUICOT (VILLA HERMOSA),3,95,37,58,4
NAYARIT,18,RUÍZ,011,IXCATÁN DEL POZOLILLO,2,6,4,2,2
NAYARIT,18,RUÍZ,011,JUAN ESCUTIA,3,115,49,66,7
NAYARIT,18,RUÍZ,011,LA BOLITA,3,66,31,35,5
NAYARIT,18,RUÍZ,011,LA JARRETADERA,2,19,10,9,2
NAYARIT,18,RUÍZ,011,LA MOJONERA,2,10,3,7,2
NAYARIT,18,RUÍZ,011,LA YERBABUENA,1,8,4,4,1
NAYARIT,18,RUÍZ,011,LAGUNA DEL MAR,3,92,54,38,6
NAYARIT,18,RUÍZ,011,LAS MAJADAS,2,14,9,5,2
NAYARIT,18,RUÍZ,011,LOS SAUCES,2,7,4,3,1
NAYARIT,18,RUÍZ,011,PRESIDIO DE LOS REYES,4,463,247,216,28
NAYARIT,18,RUÍZ,011,PUERTA DE PLATANARES,3,86,41,45,6
NAYARIT,18,RUÍZ,011,RUIZ,31,4335,2321,2014,268
NAYARIT,18,RUÍZ,011,SAN LORENZO,7,304,152,152,18
NAYARIT,18,RUÍZ,011,SAN PEDRO IXCATÁN,3,153,75,78,8
NAYARIT,18,RUÍZ,011,VADO DE SAN PEDRO,3,197,105,92,13
NAYARIT,18,SAN BLAS,012,ATICAMA,4,374,184,190,20
NAYARIT,18,SAN BLAS,012,AUTÁN,4,291,147,144,22
NAYARIT,18,SAN BLAS,012,BOCA DEL ASADERO,1,17,11,6,1
NAYARIT,18,SAN BLAS,012,CHACALILLA,3,127,61,66,9
NAYARIT,18,SAN BLAS,012,EL CAPOMO,2,28,17,11,2
NAYARIT,18,SAN BLAS,012,EL CARLEÑO,3,66,30,36,4
NAYARIT,18,SAN BLAS,012,EL CORA,3,81,30,51,5
NAYARIT,18,SAN BLAS,012,EL ESPINO,1,4,1,3,1
NAYARIT,18,SAN BLAS,012,EL LLANO,3,206,102,104,11
NAYARIT,18,SAN BLAS,012,EL MADRIGALEÑO,2,59,28,31,3
NAYARIT,18,SAN BLAS,012,GUADALUPE VICTORIA,8,1037,523,514,101
NAYARIT,18,SAN BLAS,012,HUARISTEMBA,4,165,73,92,11
NAYARIT,18,SAN BLAS,012,HUAYNAMOTA,2,28,11,17,2
NAYARIT,18,SAN BLAS,012,ISLA DEL CONDE,3,81,39,42,6
NAYARIT,18,SAN BLAS,012,JALCOCOTÁN,7,1076,547,529,69
NAYARIT,18,SAN BLAS,012,JOLOTEMBA,3,62,25,37,5
NAYARIT,18,SAN BLAS,012,JOSÉ MARÍA MERCADO,2,36,15,21,2
NAYARIT,18,SAN BLAS,012,LA BAJADA,3,64,33,31,4
NAYARIT,18,SAN BLAS,012,LA CHILTERA,2,22,12,10,2
NAYARIT,18,SAN BLAS,012,LA CHIRIPA,3,106,50,56,6
NAYARIT,18,SAN BLAS,012,LA CULEBRA,2,30,17,13,3
NAYARIT,18,SAN BLAS,012,LA GOMA,3,97,54,43,7
NAYARIT,18,SAN BLAS,012,LA LIBERTAD,4,413,196,217,19
NAYARIT,18,SAN BLAS,012,LA PALMA,4,269,118,151,14
NAYARIT,18,SAN BLAS,012,LAS PALMAS,3,33,18,15,3
NAYARIT,18,SAN BLAS,012,LAURELES Y GÓNGORA (EL CIRUELO),3,85,45,40,6
NAYARIT,18,SAN BLAS,012,LAURELES Y GÓNGORA (EL LIMÓN),3,80,45,35,5
NAYARIT,18,SAN BLAS,012,MATANCHÉN (LA AGUADA),1,82,29,53,28
NAYARIT,18,SAN BLAS,012,MECATÁN,5,653,313,340,51
NAYARIT,18,SAN BLAS,012,NAVARRETE,3,303,153,150,21
NAYARIT,18,SAN BLAS,012,PIMIENTILLO,3,68,28,40,5
NAYARIT,18,SAN BLAS,012,PINTADEÑO,3,84,39,45,6
NAYARIT,18,SAN BLAS,012,PLAYA DE LOS COCOS,1,12,6,6,1
NAYARIT,18,SAN BLAS,012,PLAYA DE RAMÍREZ,1,15,10,5,1
NAYARIT,18,SAN BLAS,012,PUERTO DE LINDAVISTA,2,13,6,7,1
NAYARIT,18,SAN BLAS,012,REFORMA AGRARIA (LA COLORADA),5,262,111,151,8
NAYARIT,18,SAN BLAS,012,SAN BLAS,18,2895,1442,1453,187
NAYARIT,18,SAN BLAS,012,SANTA CRUZ DE MIRAMAR,4,517,262,255,32
NAYARIT,18,SAN BLAS,012,SINGAITA,2,18,10,8,2
NAYARIT,18,SAN BLAS,012,TECUITATA,3,80,32,48,6
NAYARIT,18,SAN PEDRO LAGUNILLAS,013,AMADO NERVO (EL CONDE),4,233,117,116,20
NAYARIT,18,SAN PEDRO LAGUNILLAS,013,CERRO PELÓN,2,19,7,12,2
NAYARIT,18,SAN PEDRO LAGUNILLAS,013,CUASTECOMATE,3,152,75,77,20
NAYARIT,18,SAN PEDRO LAGUNILLAS,013,LAS GUÁSIMAS,3,30,20,10,3
NAYARIT,18,SAN PEDRO LAGUNILLAS,013,MILPILLAS BAJAS,3,49,18,31,5
NAYARIT,18,SAN PEDRO LAGUNILLAS,013,SAN PEDRO LAGUNILLAS,6,1104,570,534,128
NAYARIT,18,SAN PEDRO LAGUNILLAS,013,TEPETILTIC,3,33,14,19,3
NAYARIT,18,SAN PEDRO LAGUNILLAS,013,TEQUILITA,3,162,85,77,9
NAYARIT,18,SANTA MARÍA DEL ORO,014,BUCKINGHAM,3,117,51,66,7
NAYARIT,18,SANTA MARÍA DEL ORO,014,CERRO BLANCO,7,191,89,102,12
NAYARIT,18,SANTA MARÍA DEL ORO,014,CHAPALILLA,4,251,116,135,14
NAYARIT,18,SANTA MARÍA DEL ORO,014,COFRADÍA DE ACUITAPILCO,3,99,48,51,6
NAYARIT,18,SANTA MARÍA DEL ORO,014,COLONIA EL AHUALAMO,3,305,162,143,16
NAYARIT,18,SANTA MARÍA DEL ORO,014,COLONIA MODERNA,5,295,156,139,20
NAYARIT,18,SANTA MARÍA DEL ORO,014,EL BURUATO,4,135,65,70,8
NAYARIT,18,SANTA MARÍA DEL ORO,014,EL CARACOL,3,25,13,12,3
NAYARIT,18,SANTA MARÍA DEL ORO,014,EL ERMITAÑO,3,59,29,30,5
NAYARIT,18,SANTA MARÍA DEL ORO,014,EL GUANACASTE,3,49,22,27,4
NAYARIT,18,SANTA MARÍA DEL ORO,014,EL LIMÓN,3,130,55,75,8
NAYARIT,18,SANTA MARÍA DEL ORO,014,EL OCOTILLO,1,8,2,6,1
NAYARIT,18,SANTA MARÍA DEL ORO,014,LA ESTANZUELA,3,28,13,15,3
NAYARIT,18,SANTA MARÍA DEL ORO,014,LA GALINDA,3,32,11,21,3
NAYARIT,18,SANTA MARÍA DEL ORO,014,LA LABOR,6,692,327,365,66
NAYARIT,18,SANTA MARÍA DEL ORO,014,LA LAGUNA,3,46,21,25,5
NAYARIT,18,SANTA MARÍA DEL ORO,014,LA MESA DE LAS YEGUAS,3,48,20,28,3
NAYARIT,18,SANTA MARÍA DEL ORO,014,LAS CUEVAS,3,105,49,56,7
NAYARIT,18,SANTA MARÍA DEL ORO,014,LAS MESITAS,2,14,5,9,2
NAYARIT,18,SANTA MARÍA DEL ORO,014,LOS GUAJES,2,6,5,1,1
NAYARIT,18,SANTA MARÍA DEL ORO,014,MIGUEL HIDALGO,1,23,13,10,1
NAYARIT,18,SANTA MARÍA DEL ORO,014,PLATANITOS,1,22,11,11,1
NAYARIT,18,SANTA MARÍA DEL ORO,014,REAL DE ACUITAPILCO (ESTEBAN BACA CALDERÓN),4,141,70,71,11
NAYARIT,18,SANTA MARÍA DEL ORO,014,RINCÓN DE CALIMAYO,2,21,10,11,2
NAYARIT,18,SANTA MARÍA DEL ORO,014,SAN JOSÉ DE MOJARRAS,4,385,212,173,37
NAYARIT,18,SANTA MARÍA DEL ORO,014,SAN LEONEL,3,132,70,62,8
NAYARIT,18,SANTA MARÍA DEL ORO,014,SANTA MARÍA DEL ORO,11,1602,812,790,119
NAYARIT,18,SANTA MARÍA DEL ORO,014,TEQUEPEXPAN,4,345,178,167,18
NAYARIT,18,SANTA MARÍA DEL ORO,014,ZAPOTANITO,3,191,94,97,13
NAYARIT,18,SANTIAGO IXCUINTLA,015,ACAPONETILLA,3,104,52,52,7
NAYARIT,18,SANTIAGO IXCUINTLA,015,ACATÁN DE LAS PIÑAS,3,55,25,30,4
NAYARIT,18,SANTIAGO IXCUINTLA,015,AMAPA,4,1446,657,789,59
NAYARIT,18,SANTIAGO IXCUINTLA,015,AZTLÁN DE LAS GARZAS,2,39,22,17,3
NAYARIT,18,SANTIAGO IXCUINTLA,015,BOCA DE CAMICHÍN,4,368,193,175,21
NAYARIT,18,SANTIAGO IXCUINTLA,015,CAMPO DE LOS LIMONES,3,101,43,58,7
NAYARIT,18,SANTIAGO IXCUINTLA,015,CAÑADA DEL TABACO,4,345,171,174,20
NAYARIT,18,SANTIAGO IXCUINTLA,015,CAÑADA GRANDE,1,5,3,2,1
NAYARIT,18,SANTIAGO IXCUINTLA,015,CARAMOTA,1,20,9,11,1
NAYARIT,18,SANTIAGO IXCUINTLA,015,CERRITOS,3,95,53,42,6
NAYARIT,18,SANTIAGO IXCUINTLA,015,COLONIA EMILIANO ZAPATA,3,336,162,174,24
NAYARIT,18,SANTIAGO IXCUINTLA,015,COLONIA VADO DEL CORA,2,6,5,1,1
NAYARIT,18,SANTIAGO IXCUINTLA,015,CORRAL DE PIEDRA,3,37,23,14,3
NAYARIT,18,SANTIAGO IXCUINTLA,015,EL BOTADERO,3,180,83,97,15
NAYARIT,18,SANTIAGO IXCUINTLA,015,EL CANTÓN DE LOZADA,2,16,8,8,2
NAYARIT,18,SANTIAGO IXCUINTLA,015,EL CAPOMAL,3,330,163,167,20
NAYARIT,18,SANTIAGO IXCUINTLA,015,EL COLOMO,2,12,7,5,2
NAYARIT,18,SANTIAGO IXCUINTLA,015,EL CORTE (EL TUCHI),3,326,161,165,19
NAYARIT,18,SANTIAGO IXCUINTLA,015,EL LIMÓN,3,145,67,78,9
NAYARIT,18,SANTIAGO IXCUINTLA,015,EL MANGUITO,1,6,1,5,1
NAYARIT,18,SANTIAGO IXCUINTLA,015,EL MEZCAL,3,24,14,10,3
NAYARIT,18,SANTIAGO IXCUINTLA,015,EL NOVILLERO,2,24,10,14,2
NAYARIT,18,SANTIAGO IXCUINTLA,015,EL PAPALOTE,3,87,37,50,5
NAYARIT,18,SANTIAGO IXCUINTLA,015,EL PUENTE,3,138,67,71,8
NAYARIT,18,SANTIAGO IXCUINTLA,015,EL TAMBOR,3,138,81,57,8
NAYARIT,18,SANTIAGO IXCUINTLA,015,EL TIZATE,4,354,160,194,17
NAYARIT,18,SANTIAGO IXCUINTLA,015,EMERITA,3,22,12,10,3
NAYARIT,18,SANTIAGO IXCUINTLA,015,ESTACIÓN NANCHI (PEÑASQUILLO),3,130,69,61,7
NAYARIT,18,SANTIAGO IXCUINTLA,015,GAVILÁN CHICO,2,39,18,21,2
NAYARIT,18,SANTIAGO IXCUINTLA,015,GAVILÁN GRANDE,4,200,94,106,14
NAYARIT,18,SANTIAGO IXCUINTLA,015,HACIENDA VIEJA,1,4,1,3,1
NAYARIT,18,SANTIAGO IXCUINTLA,015,LA GUINEA,2,57,22,35,4
NAYARIT,18,SANTIAGO IXCUINTLA,015,LA HIGUERITA (LA ESCONDIDA),3,155,75,80,9
NAYARIT,18,SANTIAGO IXCUINTLA,015,LA PRESA,7,899,447,452,49
NAYARIT,18,SANTIAGO IXCUINTLA,015,LAS HIGUERAS,2,33,9,24,2
NAYARIT,18,SANTIAGO IXCUINTLA,015,LAS LABORES,2,57,31,26,3
NAYARIT,18,SANTIAGO IXCUINTLA,015,LAS PAREJAS,3,75,41,34,5
NAYARIT,18,SANTIAGO IXCUINTLA,015,LOS CORCHOS,3,186,92,94,10
NAYARIT,18,SANTIAGO IXCUINTLA,015,LOS OTATES,3,197,90,107,12
NAYARIT,18,SANTIAGO IXCUINTLA,015,MAYORQUÍN,3,125,63,62,7
NAYARIT,18,SANTIAGO IXCUINTLA,015,MEXCALTITÁN DE URIBE,4,189,102,87,11
NAYARIT,18,SANTIAGO IXCUINTLA,015,MOJARRITAS,3,152,71,81,10
NAYARIT,18,SANTIAGO IXCUINTLA,015,OJOS DE AGUA,2,43,14,29,3
NAYARIT,18,SANTIAGO IXCUINTLA,015,PALMAR DE CUAUTLA,4,237,107,130,15
NAYARIT,18,SANTIAGO IXCUINTLA,015,PANTANO GRANDE,3,90,53,37,5
NAYARIT,18,SANTIAGO IXCUINTLA,015,PAREDONES (LA PUNTA DE LA LAGUNA),3,116,52,64,7
NAYARIT,18,SANTIAGO IXCUINTLA,015,PASO REAL DE CAHUIPA,3,47,26,21,4
NAYARIT,18,SANTIAGO IXCUINTLA,015,PATRONEÑO I,3,116,54,62,8
NAYARIT,18,SANTIAGO IXCUINTLA,015,POZO DE IBARRA,6,1084,543,541,80
NAYARIT,18,SANTIAGO IXCUINTLA,015,POZO DE VILLA,3,142,62,80,8
NAYARIT,18,SANTIAGO IXCUINTLA,015,PUEBLO NUEVO,3,56,23,33,5
NAYARIT,18,SANTIAGO IXCUINTLA,015,PUERTA AZUL,3,175,88,87,11
NAYARIT,18,SANTIAGO IXCUINTLA,015,PUERTA DE MANGOS,5,296,138,158,22
NAYARIT,18,SANTIAGO IXCUINTLA,015,PUERTA DE PALAPARES,3,185,86,99,12
NAYARIT,18,SANTIAGO IXCUINTLA,015,RANCHO NUEVO,3,120,53,67,7
NAYARIT,18,SANTIAGO IXCUINTLA,015,REDENCIÓN,2,26,19,7,2
NAYARIT,18,SANTIAGO IXCUINTLA,015,REYNOSA,2,22,10,12,3
NAYARIT,18,SANTIAGO IXCUINTLA,015,SAN ANDRÉS,4,337,170,167,33
NAYARIT,18,SANTIAGO IXCUINTLA,015,SAN ISIDRO,3,70,31,39,4
NAYARIT,18,SANTIAGO IXCUINTLA,015,SAN MIGUEL NÚMERO DOS (EL QUEMADO),4,174,90,84,13
NAYARIT,18,SANTIAGO IXCUINTLA,015,SANTA CRUZ,4,294,139,155,18
NAYARIT,18,SANTIAGO IXCUINTLA,015,SANTA ROSA,1,17,3,14,1
NAYARIT,18,SANTIAGO IXCUINTLA,015,SANTIAGO IXCUINTLA,33,5937,3013,2924,393
NAYARIT,18,SANTIAGO IXCUINTLA,015,SAUTA,4,533,249,284,33
NAYARIT,18,SANTIAGO IXCUINTLA,015,SENTISPAC,5,613,321,292,35
NAYARIT,18,SANTIAGO IXCUINTLA,015,SINALOA,1,5,2,3,1
NAYARIT,18,SANTIAGO IXCUINTLA,015,TORO MOCHO,2,36,14,22,2
NAYARIT,18,SANTIAGO IXCUINTLA,015,VADO DEL CORA (ESTACIÓN PANI),4,209,104,105,13
NAYARIT,18,SANTIAGO IXCUINTLA,015,VALLE LERMA,3,200,93,107,11
NAYARIT,18,SANTIAGO IXCUINTLA,015,VALLE MORELOS,3,198,100,98,11
NAYARIT,18,SANTIAGO IXCUINTLA,015,VALLE ZARAGOZA,3,85,34,51,6
NAYARIT,18,SANTIAGO IXCUINTLA,015,VILLA HIDALGO,18,3015,1494,1521,189
NAYARIT,18,SANTIAGO IXCUINTLA,015,VILLA JUÁREZ,6,787,397,390,99
NAYARIT,18,SANTIAGO IXCUINTLA,015,YAGO,7,1005,526,479,67
NAYARIT,18,TECUALA,016,AGUA VERDE,2,58,32,26,4
NAYARIT,18,TECUALA,016,AGUA VERDE (EL SALTO),1,8,4,4,1
NAYARIT,18,TECUALA,016,ANTONIO R. LAURELES,3,94,54,40,6
NAYARIT,18,TECUALA,016,ARENITAS,2,35,22,13,3
NAYARIT,18,TECUALA,016,ATOTONILCO,3,113,47,66,8
NAYARIT,18,TECUALA,016,CAMALOTITA,4,260,108,152,15
NAYARIT,18,TECUALA,016,EL ARRAYÁN,4,226,106,120,13
NAYARIT,18,TECUALA,016,EL FILO,3,151,65,86,16
NAYARIT,18,TECUALA,016,EL LIMÓN,3,143,69,74,13
NAYARIT,18,TECUALA,016,EL MACHO (POZO DE HIGUERAS II),1,69,34,35,4
NAYARIT,18,TECUALA,016,EL MACHO VIEJO,3,174,84,90,11
NAYARIT,18,TECUALA,016,EL ROBLITO,3,47,23,24,3
NAYARIT,18,TECUALA,016,GUAMUCHILITO,2,27,10,17,2
NAYARIT,18,TECUALA,016,HUAJUQUILLA,3,73,35,38,5
NAYARIT,18,TECUALA,016,LA PRESA,3,224,104,120,17
NAYARIT,18,TECUALA,016,LA PUNTILLA,2,17,8,9,2
NAYARIT,18,TECUALA,016,LAS ANONAS,1,8,4,4,1
NAYARIT,18,TECUALA,016,LAS LUMBRES,3,74,41,33,5
NAYARIT,18,TECUALA,016,LOS MORILLOS,3,97,52,45,6
NAYARIT,18,TECUALA,016,MILPAS VIEJAS,3,255,126,129,18
NAYARIT,18,TECUALA,016,NOVILLERO,4,292,140,152,18
NAYARIT,18,TECUALA,016,PAJARITOS,4,188,91,97,12
NAYARIT,18,TECUALA,016,PALO BLANCO,1,13,8,5,1
NAYARIT,18,TECUALA,016,PASO HONDO,3,86,48,38,6
NAYARIT,18,TECUALA,016,PLAYA NOVILLERO,1,14,7,7,1
NAYARIT,18,TECUALA,016,QUIMICHIS,7,896,436,460,74
NAYARIT,18,TECUALA,016,RÍO VIEJO,3,173,81,92,11
NAYARIT,18,TECUALA,016,SAN CAYETANO,4,187,92,95,12
NAYARIT,18,TECUALA,016,SAN FELIPE AZTATÁN,8,1150,587,563,77
NAYARIT,18,TECUALA,016,TECUALA,18,3210,1600,1610,177
NAYARIT,18,TECUALA,016,TIERRA GENEROSA,3,56,24,32,3
NAYARIT,18,TEPIC,017,ATONALISCO,4,390,196,194,22
NAYARIT,18,TEPIC,017,BARRANCA BLANCA,2,31,13,18,3
NAYARIT,18,TEPIC,017,BELLAVISTA,3,364,174,190,26
NAYARIT,18,TEPIC,017,BENITO JUÁREZ (LAS CHIVAS),2,65,28,37,4
NAYARIT,18,TEPIC,017,CALERAS DE COFRADOS,3,68,22,46,5
NAYARIT,18,TEPIC,017,CAMICHÍN DE JAUJA,7,596,280,316,31
NAYARIT,18,TEPIC,017,CERRITO JUÁREZ,2,12,4,8,1
NAYARIT,18,TEPIC,017,CERRO DE LOS TIGRES,3,51,21,30,3
NAYARIT,18,TEPIC,017,CINCO DE MAYO (EL CIRUELO),3,111,62,49,7
NAYARIT,18,TEPIC,017,COLONIA CATORCE DE MARZO,2,61,28,33,4
NAYARIT,18,TEPIC,017,COLONIA SEIS DE ENERO,3,315,145,170,14
NAYARIT,18,TEPIC,017,COLORADO DE LA MORA,4,199,103,96,11
NAYARIT,18,TEPIC,017,CORA DE ABAJO,2,16,7,9,2
NAYARIT,18,TEPIC,017,EL AGUACATE,4,117,60,57,15
NAYARIT,18,TEPIC,017,EL AHUACATE,2,212,104,108,9
NAYARIT,18,TEPIC,017,EL CORRAL DE SORIA,1,5,4,1,1
NAYARIT,18,TEPIC,017,EL ESPINO,3,35,20,15,3
NAYARIT,18,TEPIC,017,EL FLOREÑO (EL CAPULÍN),3,33,16,17,3
NAYARIT,18,TEPIC,017,EL GAVILÁN,1,4,3,1,1
NAYARIT,18,TEPIC,017,EL IZOTE,2,45,24,21,3
NAYARIT,18,TEPIC,017,EL JICOTE,3,446,209,237,30
NAYARIT,18,TEPIC,017,EL LIMÓN,2,22,9,13,2
NAYARIT,18,TEPIC,017,EL PICHÓN,3,71,39,32,6
NAYARIT,18,TEPIC,017,EL REFUGIO,4,257,127,130,15
NAYARIT,18,TEPIC,017,EL RINCÓN,3,196,92,104,11
NAYARIT,18,TEPIC,017,EL TRAPICHILLO,4,357,176,181,19
NAYARIT,18,TEPIC,017,EL VERDE,2,40,18,22,3
NAYARIT,18,TEPIC,017,ESTACIÓN ROSETA,1,10,2,8,1
NAYARIT,18,TEPIC,017,FRANCISCO I. MADERO (PUGA),16,2475,1251,1224,246
NAYARIT,18,TEPIC,017,HEBRÓN,2,7,2,5,1
NAYARIT,18,TEPIC,017,JESÚS MARÍA CORTES,6,333,155,178,16
NAYARIT,18,TEPIC,017,JUMATÁN,2,52,17,35,3
NAYARIT,18,TEPIC,017,LA CANTERA,7,1324,654,670,57
NAYARIT,18,TEPIC,017,LA ESCONDIDA,2,65,33,32,3
NAYARIT,18,TEPIC,017,LA FORTUNA,3,290,148,142,19
NAYARIT,18,TEPIC,017,LA PALOMA,2,36,21,15,2
NAYARIT,18,TEPIC,017,LA RESOLANA,2,10,6,4,2
NAYARIT,18,TEPIC,017,LA YERBA,4,274,148,126,14
NAYARIT,18,TEPIC,017,LAS BLANCAS (CARRETONES DE CERRITOS),3,115,55,60,7
NAYARIT,18,TEPIC,017,LAS DELICIAS,2,267,141,126,11
NAYARIT,18,TEPIC,017,LAS NORIAS DEL MANANTIAL,2,13,9,4,2
NAYARIT,18,TEPIC,017,LAS PEÑITAS (LA REPISA),2,9,6,3,1
NAYARIT,18,TEPIC,017,LAS PILAS (EL TEPEGUAJE),3,53,21,32,4
NAYARIT,18,TEPIC,017,LO DE GARCÍA,2,31,14,17,2
NAYARIT,18,TEPIC,017,LO DE LAMEDO,3,265,120,145,21
NAYARIT,18,TEPIC,017,LOS SABINOS,2,12,10,2,2
NAYARIT,18,TEPIC,017,LOS SALAZARES,3,61,28,33,4
NAYARIT,18,TEPIC,017,MESA DE PICACHOS (EL CASCO),3,47,20,27,4
NAYARIT,18,TEPIC,017,MORA,3,165,79,86,9
NAYARIT,18,TEPIC,017,OTATISTE,2,17,8,9,2
NAYARIT,18,TEPIC,017,PLATANITOS,2,59,30,29,4
NAYARIT,18,TEPIC,017,ROSETA (LA TRISTEZA),2,28,10,18,2
NAYARIT,18,TEPIC,017,SALVADOR ALLENDE,3,141,69,72,12
NAYARIT,18,TEPIC,017,SAN ANDRÉS,4,154,77,77,10
NAYARIT,18,TEPIC,017,SAN CAYETANO,9,1387,653,734,68
NAYARIT,18,TEPIC,017,SAN FERNANDO,3,129,63,66,8
NAYARIT,18,TEPIC,017,SAN LUIS DE LOZADA,6,436,223,213,22
NAYARIT,18,TEPIC,017,SANTIAGO DE POCHOTITÁN,6,621,310,311,30
NAYARIT,18,TEPIC,017,TEPETILTE,1,15,8,7,1
NAYARIT,18,TEPIC,017,TEPIC,613,121087,64337,56750,9136
NAYARIT,18,TEPIC,017,VENUSTIANO CARRANZA,4,557,76,481,10
NAYARIT,18,TEPIC,017,ZAPOTE DE PICACHOS,4,158,88,70,10
NAYARIT,18,TUXPAN,018,COAMILES,4,400,187,213,29
NAYARIT,18,TUXPAN,018,EJIDO PEÑITAS [CENTRO RECEPTOR],1,38,18,20,5
NAYARIT,18,TUXPAN,018,PALMA GRANDE,4,500,236,264,34
NAYARIT,18,TUXPAN,018,PEÑAS,3,250,121,129,15
NAYARIT,18,TUXPAN,018,TUXPAN,29,6164,3157,3007,337
NAYARIT,18,TUXPAN,018,UNIÓN DE CORRIENTES,3,213,104,109,11
NAYARIT,18,LA YESCA,019,22 DE ENERO [COLONIA],1,12,7,5,1
NAYARIT,18,LA YESCA,019,AGUA CALIENTE,3,9,5,4,2
NAYARIT,18,LA YESCA,019,AMATLÁN DE JORA,4,90,43,47,7
NAYARIT,18,LA YESCA,019,APOZOLCO,4,269,140,129,16
NAYARIT,18,LA YESCA,019,ARROYO DEL CAPOMO,2,7,4,3,1
NAYARIT,18,LA YESCA,019,CORTAPICO,3,44,26,18,4
NAYARIT,18,LA YESCA,019,EL ÁLAMO,2,8,7,1,1
NAYARIT,18,LA YESCA,019,EL CARRIZAL,2,56,21,35,3
NAYARIT,18,LA YESCA,019,EL ENCINO,2,9,3,6,1
NAYARIT,18,LA YESCA,019,EL FORTÍN,1,8,2,6,1
NAYARIT,18,LA YESCA,019,EL IZOTE,3,21,15,6,2
NAYARIT,18,LA YESCA,019,EL MAJAGUAL,1,6,2,4,1
NAYARIT,18,LA YESCA,019,EL MEZQUITE,2,6,4,2,1
NAYARIT,18,LA YESCA,019,EL MIRADOR,1,6,2,4,1
NAYARIT,18,LA YESCA,019,EL PINABETE,2,8,3,5,1
NAYARIT,18,LA YESCA,019,EL PINAL,3,89,47,42,5
NAYARIT,18,LA YESCA,019,EL PINALILLO,2,16,5,11,2
NAYARIT,18,LA YESCA,019,EL PINITO (EL PINO),2,11,2,9,1
NAYARIT,18,LA YESCA,019,EL PINOLE,1,11,8,3,1
NAYARIT,18,LA YESCA,019,EL PLATANAR DE LOS HERRERA,2,9,8,1,1
NAYARIT,18,LA YESCA,019,EL RANCHITO,2,6,2,4,1
NAYARIT,18,LA YESCA,019,EL SAUZ DE LOS HERNÁNDEZ,1,3,3,0,1
NAYARIT,18,LA YESCA,019,EL TORO PRIETO,1,2,2,0,1
NAYARIT,18,LA YESCA,019,EL TRAPICHE,3,60,27,33,6
NAYARIT,18,LA YESCA,019,GUADALUPE OCOTÁN,6,516,259,257,36
NAYARIT,18,LA YESCA,019,GUANACASTE,1,12,6,6,1
NAYARIT,18,LA YESCA,019,HACIENDA DE AMBAS AGUAS,3,61,30,31,5
NAYARIT,18,LA YESCA,019,HUAJIMIC,4,290,160,130,15
NAYARIT,18,LA YESCA,019,LA AZALEA,3,6,5,1,2
NAYARIT,18,LA YESCA,019,LA CIÉNEGA,2,39,20,19,2
NAYARIT,18,LA YESCA,019,LA CUCHILLA,1,3,2,1,1
NAYARIT,18,LA YESCA,019,LA MANGA,2,18,9,9,2
NAYARIT,18,LA YESCA,019,LA MESA,2,5,2,3,1
NAYARIT,18,LA YESCA,019,LA MESA DEL HUANACAXTLE,2,15,8,7,2
NAYARIT,18,LA YESCA,019,LA MINITA,2,5,2,3,1
NAYARIT,18,LA YESCA,019,LA PLAYA,3,18,10,8,2
NAYARIT,18,LA YESCA,019,LA YESCA,4,158,78,80,12
NAYARIT,18,LA YESCA,019,LAS HIGUERAS,1,6,1,5,1
NAYARIT,18,LA YESCA,019,LAS JARAS,3,32,11,21,4
NAYARIT,18,LA YESCA,019,LAS LAJAS,2,5,3,2,1
NAYARIT,18,LA YESCA,019,LAS PALOMAS,1,18,11,7,1
NAYARIT,18,LA YESCA,019,LOS ENCANTOS,2,13,5,8,2
NAYARIT,18,LA YESCA,019,MESA DE CHAPALILLA,2,75,41,34,4
NAYARIT,18,LA YESCA,019,MESA DE GUANACASTE,2,10,6,4,2
NAYARIT,18,LA YESCA,019,MESA DE LOS SAUCEDOS,2,8,5,3,1
NAYARIT,18,LA YESCA,019,PALMILLAS,3,29,14,15,3
NAYARIT,18,LA YESCA,019,PASO DE SAN JUAN,2,4,2,2,1
NAYARIT,18,LA YESCA,019,PLATANAR DE LOS LÓPEZ,1,4,3,1,1
NAYARIT,18,LA YESCA,019,POPOTA,2,27,14,13,2
NAYARIT,18,LA YESCA,019,PUENTE DE CAMOTLÁN,7,728,361,367,41
NAYARIT,18,LA YESCA,019,SAN JUAN IXTAPALAPA,2,23,12,11,3
NAYARIT,18,LA YESCA,019,SAN PELAYO,3,30,16,14,4
NAYARIT,18,BAHÍA DE BANDERAS,020,AGUAMILPA,4,142,66,76,10
NAYARIT,18,BAHÍA DE BANDERAS,020,BUCERÍAS,29,4659,2375,2284,256
NAYARIT,18,BAHÍA DE BANDERAS,020,CORRAL DEL RISCO (PUNTA DE MITA),7,664,337,327,37
NAYARIT,18,BAHÍA DE BANDERAS,020,CRUZ DE HUANACAXTLE,9,2142,1096,1046,211
NAYARIT,18,BAHÍA DE BANDERAS,020,EL COATANTE,4,121,60,61,8
NAYARIT,18,BAHÍA DE BANDERAS,020,EL COLOMO,3,248,127,121,19
NAYARIT,18,BAHÍA DE BANDERAS,020,EL GUAMÚCHIL,3,174,85,89,8
NAYARIT,18,BAHÍA DE BANDERAS,020,EL PORVENIR,8,1911,964,947,73
NAYARIT,18,BAHÍA DE BANDERAS,020,FORTUNA DE VALLEJO (LA GLORIA),3,42,25,17,3
NAYARIT,18,BAHÍA DE BANDERAS,020,HIGUERA BLANCA,4,622,296,326,24
NAYARIT,18,BAHÍA DE BANDERAS,020,LA CEIBA,2,4,2,2,1
NAYARIT,18,BAHÍA DE BANDERAS,020,LAS JARRETADERAS,7,1176,591,585,72
NAYARIT,18,BAHÍA DE BANDERAS,020,LAS LOMAS,3,75,33,42,5
NAYARIT,18,BAHÍA DE BANDERAS,020,LO DE MARCOS,4,542,265,277,28
NAYARIT,18,BAHÍA DE BANDERAS,020,LOS SAUCES,3,67,37,30,4
NAYARIT,18,BAHÍA DE BANDERAS,020,MEZCALES,40,5938,2920,3018,329
NAYARIT,18,BAHÍA DE BANDERAS,020,MEZCALITOS,2,132,66,66,7
NAYARIT,18,BAHÍA DE BANDERAS,020,NUEVO NAYARIT,7,2156,1054,1102,167
NAYARIT,18,BAHÍA DE BANDERAS,020,SAN CLEMENTE DE LIMA,10,1772,873,899,87
NAYARIT,18,BAHÍA DE BANDERAS,020,SAN FRANCISCO,4,415,200,215,24
NAYARIT,18,BAHÍA DE BANDERAS,020,SAN IGNACIO,3,405,200,205,17
NAYARIT,18,BAHÍA DE BANDERAS,020,SAN JOSÉ DEL VALLE,36,7019,3463,3556,341
NAYARIT,18,BAHÍA DE BANDERAS,020,SAN JUAN DE ABAJO,13,3516,1756,1760,614
NAYARIT,18,BAHÍA DE BANDERAS,020,SAN QUINTÍN,3,25,10,15,3
NAYARIT,18,BAHÍA DE BANDERAS,020,SAN VICENTE,33,7343,3616,3727,326
NAYARIT,18,BAHÍA DE BANDERAS,020,SANTA ROSA TAPACHULA,2,204,85,119,8
NAYARIT,18,BAHÍA DE BANDERAS,020,SAYULITA,7,1071,529,542,50
NAYARIT,18,BAHÍA DE BANDERAS,020,TONDOROQUE,5,332,151,181,20
NAYARIT,18,BAHÍA DE BANDERAS,020,VALLE DE BANDERAS,17,3744,2112,1632,194
NUEVO LEÓN,19,ABASOLO,001,ABASOLO,4,620,336,284,29
NUEVO LEÓN,19,AGUALEGUAS,002,AGUALEGUAS,7,564,294,270,35
NUEVO LEÓN,19,AGUALEGUAS,002,LA ESCONDIDA,1,2,2,0,1
NUEVO LEÓN,19,AGUALEGUAS,002,LOS GARZA,2,33,19,14,3
NUEVO LEÓN,19,AGUALEGUAS,002,LOS NOGALES,2,28,13,15,3
NUEVO LEÓN,19,AGUALEGUAS,002,OJO DE AGUA,1,5,1,4,1
NUEVO LEÓN,19,AGUALEGUAS,002,RANCHO NUEVO,2,38,16,22,3
NUEVO LEÓN,19,AGUALEGUAS,002,TRES HERMANOS,1,5,2,3,1
NUEVO LEÓN,19,LOS ALDAMAS,003,ALDAMA [ESTACIÓN],1,39,18,21,3
NUEVO LEÓN,19,LOS ALDAMAS,003,LOS ALDAMAS,3,187,105,82,11
NUEVO LEÓN,19,ALLENDE,004,ATONGO DE ABAJO (ATONGO ALLENDE),2,32,20,12,2
NUEVO LEÓN,19,ALLENDE,004,CIUDAD DE ALLENDE,54,8031,4114,3917,471
NUEVO LEÓN,19,ALLENDE,004,EL CERRITO,2,52,25,27,4
NUEVO LEÓN,19,ALLENDE,004,EL PORVENIR,2,82,48,34,6
NUEVO LEÓN,19,ALLENDE,004,JÁUREGUI,1,12,4,8,1
NUEVO LEÓN,19,ALLENDE,004,LA COLMENA DE ABAJO,3,351,159,192,23
NUEVO LEÓN,19,ALLENDE,004,LA COLMENA DE ARRIBA,1,14,9,5,1
NUEVO LEÓN,19,ALLENDE,004,LAZARILLOS DE ABAJO,2,47,20,27,4
NUEVO LEÓN,19,ALLENDE,004,LOS GUZMÁN,1,25,10,15,2
NUEVO LEÓN,19,ALLENDE,004,LOS SABINOS (SABINOS DE ABAJO),3,428,177,251,70
NUEVO LEÓN,19,ALLENDE,004,LOS TERREROS,3,257,128,129,18
NUEVO LEÓN,19,ALLENDE,004,PASO HONDO,3,129,58,71,17
NUEVO LEÓN,19,ALLENDE,004,SAN ANTONIO (HACIENDA SAN ANTONIO),2,56,30,26,4
NUEVO LEÓN,19,ANÁHUAC,005,ANÁHUAC,21,3207,1587,1620,171
NUEVO LEÓN,19,ANÁHUAC,005,COLOMBIA,6,233,118,115,17
NUEVO LEÓN,19,ANÁHUAC,005,LA GLORIA,1,3,3,0,1
NUEVO LEÓN,19,ANÁHUAC,005,LA ZACATOSA,1,432,237,195,56
NUEVO LEÓN,19,ANÁHUAC,005,NUEVO ANÁHUAC,2,96,45,51,5
NUEVO LEÓN,19,ANÁHUAC,005,NUEVO RODRÍGUEZ,3,66,37,29,7
NUEVO LEÓN,19,ANÁHUAC,005,REGANTES NÚMERO CATORCE,1,8,4,4,1
NUEVO LEÓN,19,ANÁHUAC,005,REGANTES NÚMERO VEINTIDÓS,1,10,6,4,1
NUEVO LEÓN,19,ANÁHUAC,005,REGANTES NÚMERO VEINTIUNO,1,8,2,6,1
NUEVO LEÓN,19,ANÁHUAC,005,SALINILLAS,2,23,13,10,2
NUEVO LEÓN,19,APODACA,006,AGUA FRÍA,2,251,132,119,10
NUEVO LEÓN,19,APODACA,006,ARTEMIO TREVIÑO,5,1056,531,525,49
NUEVO LEÓN,19,APODACA,006,CIUDAD APODACA,502,116118,56483,59635,5625
NUEVO LEÓN,19,APODACA,006,CIUDAD NATURA,4,1272,607,665,41
NUEVO LEÓN,19,APODACA,006,EL CORRIENTÓN,3,382,193,189,23
NUEVO LEÓN,19,APODACA,006,EX-HACIENDA DE SANTA ROSA,5,259,126,133,25
NUEVO LEÓN,19,APODACA,006,EX-HACIENDA SANTA ROSA,4,691,315,376,25
NUEVO LEÓN,19,APODACA,006,FRACCIONAMIENTO COSMÓPOLIS OCTAVO SECTOR,4,557,282,275,24
NUEVO LEÓN,19,APODACA,006,FRACCIONAMIENTO MISIÓN DE SAN JAVIER,4,1072,541,531,34
NUEVO LEÓN,19,APODACA,006,LOMA LA PAZ,5,1428,710,718,54
NUEVO LEÓN,19,APODACA,006,LOS ÉBANOS,7,1601,799,802,102
NUEVO LEÓN,19,APODACA,006,MISIÓN SAN PABLO,6,2086,1036,1050,93
NUEVO LEÓN,19,APODACA,006,PRADOS DE SANTA ROSA,11,2188,1120,1068,133
NUEVO LEÓN,19,APODACA,006,SANTA ROSA,15,3260,1615,1645,134
NUEVO LEÓN,19,APODACA,006,TRIANA,2,218,111,107,10
NUEVO LEÓN,19,ARAMBERRI,007,AGUA DELGADA,3,52,19,33,7
NUEVO LEÓN,19,ARAMBERRI,007,AGUA FRÍA,3,7,3,4,2
NUEVO LEÓN,19,ARAMBERRI,007,ÁLAMOS,2,11,3,8,1
NUEVO LEÓN,19,ARAMBERRI,007,ARAMBERRI,10,591,308,283,48
NUEVO LEÓN,19,ARAMBERRI,007,ARAMBERRI (BROWNSVILLE),1,95,48,47,6
NUEVO LEÓN,19,ARAMBERRI,007,CALLEJÓN DE LOS VÁZQUEZ,1,6,5,1,1
NUEVO LEÓN,19,ARAMBERRI,007,CAÑÓN DE VACAS (EL JARDÍN),3,26,15,11,4
NUEVO LEÓN,19,ARAMBERRI,007,CEDRITOS,1,17,15,2,1
NUEVO LEÓN,19,ARAMBERRI,007,EL ALAMAR,1,4,4,0,1
NUEVO LEÓN,19,ARAMBERRI,007,EL CALICHAL,1,11,5,6,1
NUEVO LEÓN,19,ARAMBERRI,007,EL CARRIZALILLO,1,7,4,3,1
NUEVO LEÓN,19,ARAMBERRI,007,EL CUERVO UNO,2,4,1,3,1
NUEVO LEÓN,19,ARAMBERRI,007,EL MEZQUITAL,2,10,4,6,2
NUEVO LEÓN,19,ARAMBERRI,007,EL MONAL,1,11,6,5,1
NUEVO LEÓN,19,ARAMBERRI,007,EL MUERTO,1,6,3,3,1
NUEVO LEÓN,19,ARAMBERRI,007,EL NACIMIENTO,1,2,1,1,0
NUEVO LEÓN,19,ARAMBERRI,007,EL PINALITO,2,5,2,3,1
NUEVO LEÓN,19,ARAMBERRI,007,EL PUERTO,2,61,34,27,6
NUEVO LEÓN,19,ARAMBERRI,007,EL REALITO (LA PARRITA),3,56,28,28,5
NUEVO LEÓN,19,ARAMBERRI,007,EL REFUGIO (REFUGIO DE TEXAS),3,19,10,9,3
NUEVO LEÓN,19,ARAMBERRI,007,EL RUCIO,1,5,2,3,1
NUEVO LEÓN,19,ARAMBERRI,007,EL SACRAMENTO,1,5,2,3,1
NUEVO LEÓN,19,ARAMBERRI,007,EL YERBANIZ,3,20,16,4,3
NUEVO LEÓN,19,ARAMBERRI,007,ERASMO VÁZQUEZ,2,48,21,27,4
NUEVO LEÓN,19,ARAMBERRI,007,FRACCIONAMIENTO DEL RÍO (FRACCIÓN DEL RÍO),3,13,6,7,3
NUEVO LEÓN,19,ARAMBERRI,007,GUADALUPE DE LOS NAVARRO,2,11,4,7,2
NUEVO LEÓN,19,ARAMBERRI,007,GUADALUPE VICTORIA,1,10,6,4,1
NUEVO LEÓN,19,ARAMBERRI,007,IBARRILLA (RINCÓN DE IBARRILLA),3,15,8,7,3
NUEVO LEÓN,19,ARAMBERRI,007,IGNACIO ZARAGOZA,2,12,2,10,2
NUEVO LEÓN,19,ARAMBERRI,007,JOYAS DE BOCACELLY,2,5,2,3,1
NUEVO LEÓN,19,ARAMBERRI,007,JOYAS Y ANTEOJITOS,1,8,4,4,1
NUEVO LEÓN,19,ARAMBERRI,007,LA ALDEA,1,7,2,5,1
NUEVO LEÓN,19,ARAMBERRI,007,LA ASCENCIÓN,7,801,404,397,82
NUEVO LEÓN,19,ARAMBERRI,007,LA BOQUILLA,1,1,1,0,1
NUEVO LEÓN,19,ARAMBERRI,007,LA CABALLADA,2,13,3,10,2
NUEVO LEÓN,19,ARAMBERRI,007,LA CANOA,3,21,10,11,3
NUEVO LEÓN,19,ARAMBERRI,007,LA CARPINTERÍA,2,5,2,3,1
NUEVO LEÓN,19,ARAMBERRI,007,LA ESCONDIDA,2,36,19,17,3
NUEVO LEÓN,19,ARAMBERRI,007,LA ESPERANZA,1,131,72,59,12
NUEVO LEÓN,19,ARAMBERRI,007,LA FLORIDA,2,49,22,27,4
NUEVO LEÓN,19,ARAMBERRI,007,LA LAGUNITA (LAGUNITA DE LOS VÁZQUEZ),2,4,0,4,1
NUEVO LEÓN,19,ARAMBERRI,007,LA NORIA,1,25,13,12,1
NUEVO LEÓN,19,ARAMBERRI,007,LA PEÑA,4,92,46,46,10
NUEVO LEÓN,19,ARAMBERRI,007,LA REFORMA,1,5,3,2,1
NUEVO LEÓN,19,ARAMBERRI,007,LA ROSITA (LOS LLANITOS),2,23,12,11,2
NUEVO LEÓN,19,ARAMBERRI,007,LA SABANILLA,2,6,4,2,1
NUEVO LEÓN,19,ARAMBERRI,007,LA SOLEDAD (AGRÍCOLA),2,60,32,28,5
NUEVO LEÓN,19,ARAMBERRI,007,LA VICTORIA (LOS ÁNGELES),2,27,9,18,3
NUEVO LEÓN,19,ARAMBERRI,007,LAGUNA DE BOCACELLY,1,18,9,9,1
NUEVO LEÓN,19,ARAMBERRI,007,LAS ÁNIMAS,1,5,1,4,1
NUEVO LEÓN,19,ARAMBERRI,007,LAS ÁNIMAS (PRESA DE LAS ÁNIMAS),1,23,13,10,2
NUEVO LEÓN,19,ARAMBERRI,007,LAS JOYITAS,1,4,1,3,1
NUEVO LEÓN,19,ARAMBERRI,007,LAS JUANAS,2,6,6,0,1
NUEVO LEÓN,19,ARAMBERRI,007,LAS MANCUERNAS,2,15,6,9,2
NUEVO LEÓN,19,ARAMBERRI,007,LAS MULAS,2,15,6,9,2
NUEVO LEÓN,19,ARAMBERRI,007,LAS PRESAS,1,10,3,7,1
NUEVO LEÓN,19,ARAMBERRI,007,LOS NOGALES,2,23,13,10,3
NUEVO LEÓN,19,ARAMBERRI,007,MARMOLEJO,1,10,2,8,2
NUEVO LEÓN,19,ARAMBERRI,007,MILPILLAS,4,90,44,46,9
NUEVO LEÓN,19,ARAMBERRI,007,NINGUNO,4,215,113,102,14
NUEVO LEÓN,19,ARAMBERRI,007,NOYOLA,1,121,53,68,6
NUEVO LEÓN,19,ARAMBERRI,007,POTRERO DE ZAMORA,2,7,4,3,2
NUEVO LEÓN,19,ARAMBERRI,007,POTRERO DEL PADRE (LAGUNITA DE GONZÁLEZ),3,12,9,3,3
NUEVO LEÓN,19,ARAMBERRI,007,PUENTES (SAN JUAN Y PUENTES),1,6,2,4,1
NUEVO LEÓN,19,ARAMBERRI,007,PUERTO BAJO,2,17,6,11,3
NUEVO LEÓN,19,ARAMBERRI,007,PUERTO CARRETAS,1,3,2,1,1
NUEVO LEÓN,19,ARAMBERRI,007,PUERTO DE ANTEOJITOS,1,3,2,1,1
NUEVO LEÓN,19,ARAMBERRI,007,PUERTO PIÑONES,3,14,6,8,2
NUEVO LEÓN,19,ARAMBERRI,007,RANCHO NUEVO,5,104,54,50,9
NUEVO LEÓN,19,ARAMBERRI,007,RANCHO NUEVO (LAS HORNILLAS),1,16,4,12,1
NUEVO LEÓN,19,ARAMBERRI,007,ROJAS,1,7,3,4,1
NUEVO LEÓN,19,ARAMBERRI,007,SALITRILLO,2,24,19,5,2
NUEVO LEÓN,19,ARAMBERRI,007,SAN FRANCISCO DE LEOS,2,3,3,0,2
NUEVO LEÓN,19,ARAMBERRI,007,SAN ISIDRO,2,20,12,8,2
NUEVO LEÓN,19,ARAMBERRI,007,SAN JOAQUÍN DE SOTO,2,26,12,14,2
NUEVO LEÓN,19,ARAMBERRI,007,SAN JOSÉ DEL JILGUERO,2,9,5,4,2
NUEVO LEÓN,19,ARAMBERRI,007,SAN JUAN DE AVILÉS,3,46,32,14,3
NUEVO LEÓN,19,ARAMBERRI,007,SAN JUANITO DE RESÉNDIZ,2,17,10,7,2
NUEVO LEÓN,19,ARAMBERRI,007,SAN JUANITO DE SOLÍS,1,6,3,3,1
NUEVO LEÓN,19,ARAMBERRI,007,SAN RAFAEL DE LOS CORTEZ,1,4,3,1,1
NUEVO LEÓN,19,ARAMBERRI,007,SAN RAFAEL DE LOS CORTEZ (LAS CRUCES),2,32,17,15,3
NUEVO LEÓN,19,ARAMBERRI,007,SAN RAFAEL DEL LLANO,2,19,12,7,2
NUEVO LEÓN,19,ARAMBERRI,007,SANDIA (SANDIA EL GRANDE),3,174,89,85,11
NUEVO LEÓN,19,BUSTAMANTE,008,BUSTAMANTE,9,754,374,380,46
NUEVO LEÓN,19,CADEREYTA JIMÉNEZ,009,AMPLIACIÓN SAN JUAN,2,23,10,13,2
NUEVO LEÓN,19,CADEREYTA JIMÉNEZ,009,ATONGO DE ABAJO,3,395,212,183,22
NUEVO LEÓN,19,CADEREYTA JIMÉNEZ,009,CADEREYTA,2,687,274,413,102
NUEVO LEÓN,19,CADEREYTA JIMÉNEZ,009,CADEREYTA JIMÉNEZ,135,22195,10810,11385,1411
NUEVO LEÓN,19,CADEREYTA JIMÉNEZ,009,CAÑITAS,1,7,4,3,1
NUEVO LEÓN,19,CADEREYTA JIMÉNEZ,009,CASAS VIEJAS (LA FLORIDA),2,33,14,19,3
NUEVO LEÓN,19,CADEREYTA JIMÉNEZ,009,CHIHUAHUA,3,37,17,20,4
NUEVO LEÓN,19,CADEREYTA JIMÉNEZ,009,CIENEGUITA DEL RÍO,2,48,22,26,3
NUEVO LEÓN,19,CADEREYTA JIMÉNEZ,009,EL BARCO,1,6,1,5,1
NUEVO LEÓN,19,CADEREYTA JIMÉNEZ,009,EL BARRANQUITO,3,75,34,41,6
NUEVO LEÓN,19,CADEREYTA JIMÉNEZ,009,EL CASTILLO,1,10,6,4,1
NUEVO LEÓN,19,CADEREYTA JIMÉNEZ,009,EL EBANAL,2,58,29,29,4
NUEVO LEÓN,19,CADEREYTA JIMÉNEZ,009,EL MEZCAL,2,68,43,25,5
NUEVO LEÓN,19,CADEREYTA JIMÉNEZ,009,EL REFUGIO,1,10,7,3,1
NUEVO LEÓN,19,CADEREYTA JIMÉNEZ,009,EL REFUGIO (EL NOPALITO),2,31,14,17,3
NUEVO LEÓN,19,CADEREYTA JIMÉNEZ,009,EL TORDILLO,2,224,94,130,8
NUEVO LEÓN,19,CADEREYTA JIMÉNEZ,009,FRACCIONAMIENTO CAMPESTRE LA COLMENA,2,29,16,13,3
NUEVO LEÓN,19,CADEREYTA JIMÉNEZ,009,GENERAL TREVIÑO (ESCONDIDA),1,6,3,3,1
NUEVO LEÓN,19,CADEREYTA JIMÉNEZ,009,HACIENDA LAS TRANCAS,3,39,22,17,4
NUEVO LEÓN,19,CADEREYTA JIMÉNEZ,009,HIDALGO (LA PRESA),1,8,4,4,1
NUEVO LEÓN,19,CADEREYTA JIMÉNEZ,009,LA CHUECA,1,7,2,5,1
NUEVO LEÓN,19,CADEREYTA JIMÉNEZ,009,LA ESPERANZA,2,58,21,37,5
NUEVO LEÓN,19,CADEREYTA JIMÉNEZ,009,LA PRESA (LA PRESITA),1,8,4,4,1
NUEVO LEÓN,19,CADEREYTA JIMÉNEZ,009,LA PURÍSIMA,2,27,13,14,3
NUEVO LEÓN,19,CADEREYTA JIMÉNEZ,009,LA TRINIDAD,2,29,15,14,3
NUEVO LEÓN,19,CADEREYTA JIMÉNEZ,009,LA UNIÓN,5,154,79,75,13
NUEVO LEÓN,19,CADEREYTA JIMÉNEZ,009,LAJITAS DE ARRIBA,2,14,7,7,2
NUEVO LEÓN,19,CADEREYTA JIMÉNEZ,009,LAS ABRAS DE ABAJO,2,33,15,18,3
NUEVO LEÓN,19,CADEREYTA JIMÉNEZ,009,LAS ADJUNTAS,1,6,3,3,1
NUEVO LEÓN,19,CADEREYTA JIMÉNEZ,009,LAS LAJITAS,1,21,9,12,2
NUEVO LEÓN,19,CADEREYTA JIMÉNEZ,009,LAS PALOMITAS (LA FRAGUA),2,9,4,5,2
NUEVO LEÓN,19,CADEREYTA JIMÉNEZ,009,LAS SABINAS,2,21,10,11,2
NUEVO LEÓN,19,CADEREYTA JIMÉNEZ,009,LOMA BONITA,1,9,5,4,1
NUEVO LEÓN,19,CADEREYTA JIMÉNEZ,009,LOS CERRITOS,2,29,16,13,2
NUEVO LEÓN,19,CADEREYTA JIMÉNEZ,009,LOS COCUYOS,2,57,22,35,4
NUEVO LEÓN,19,CADEREYTA JIMÉNEZ,009,NINGUNO,8,519,262,257,31
NUEVO LEÓN,19,CADEREYTA JIMÉNEZ,009,PALMITOS,3,137,67,70,13
NUEVO LEÓN,19,CADEREYTA JIMÉNEZ,009,PALMITOS (HACIENDA PALMITOS),2,229,115,114,13
NUEVO LEÓN,19,CADEREYTA JIMÉNEZ,009,PUEBLO NUEVO (TEPEHUAJE),1,35,12,23,2
NUEVO LEÓN,19,CADEREYTA JIMÉNEZ,009,RANCHO VIEJO,2,46,19,27,4
NUEVO LEÓN,19,CADEREYTA JIMÉNEZ,009,RICARDO GONZÁLEZ RODRÍGUEZ,3,445,275,170,68
NUEVO LEÓN,19,CADEREYTA JIMÉNEZ,009,SAN DIEGO Y MOLINO VIEJO,2,29,13,16,3
NUEVO LEÓN,19,CADEREYTA JIMÉNEZ,009,SAN FELIPE,2,21,9,12,2
NUEVO LEÓN,19,CADEREYTA JIMÉNEZ,009,SAN ISIDRO,2,17,12,5,2
NUEVO LEÓN,19,CADEREYTA JIMÉNEZ,009,SAN JUAN DE LOS GARZA (SAN JUANITO),1,19,10,9,2
NUEVO LEÓN,19,CADEREYTA JIMÉNEZ,009,SAN LORENZO,2,49,24,25,4
NUEVO LEÓN,19,CADEREYTA JIMÉNEZ,009,SAN MIGUELITO,2,18,9,9,2
NUEVO LEÓN,19,CADEREYTA JIMÉNEZ,009,SAN RAFAEL,2,23,9,14,2
NUEVO LEÓN,19,CADEREYTA JIMÉNEZ,009,SANTA EFIGENIA,1,69,31,38,7
NUEVO LEÓN,19,CADEREYTA JIMÉNEZ,009,SANTA EFIGENIA (CAMPESTRE),2,23,11,12,2
NUEVO LEÓN,19,CADEREYTA JIMÉNEZ,009,SANTA FE,2,22,11,11,3
NUEVO LEÓN,19,CADEREYTA JIMÉNEZ,009,SANTA ISABEL,2,33,16,17,3
NUEVO LEÓN,19,CADEREYTA JIMÉNEZ,009,SANTA ISABEL Y DOLORES,3,202,127,75,11
NUEVO LEÓN,19,CADEREYTA JIMÉNEZ,009,SOLEDAD HERRERA,2,60,28,32,5
NUEVO LEÓN,19,CADEREYTA JIMÉNEZ,009,TEPEHUAJE,1,62,38,24,5
NUEVO LEÓN,19,CADEREYTA JIMÉNEZ,009,TRANCAS Y SABARADO,2,60,31,29,6
NUEVO LEÓN,19,CADEREYTA JIMÉNEZ,009,VALLE DEL ROBLE,12,6565,3276,3289,212
NUEVO LEÓN,19,CADEREYTA JIMÉNEZ,009,VALLE HIDALGO (EL QUEMADO),3,121,61,60,10
NUEVO LEÓN,19,CADEREYTA JIMÉNEZ,009,VAQUEROS [ESTACIÓN],3,41,14,27,4
NUEVO LEÓN,19,EL CARMEN,010,BUENA VISTA,17,8465,4239,4226,273
NUEVO LEÓN,19,EL CARMEN,010,CARMEN,28,9101,4434,4667,351
NUEVO LEÓN,19,EL CARMEN,010,EL JARAL,15,7069,3549,3520,204
NUEVO LEÓN,19,EL CARMEN,010,LOS ALGODONES,1,95,49,46,6
NUEVO LEÓN,19,CERRALVO,011,ARROYO DE PIEDRA,1,6,4,2,1
NUEVO LEÓN,19,CERRALVO,011,BOTELLOS DE ARRIBA,1,7,3,4,1
NUEVO LEÓN,19,CERRALVO,011,BUENOS AIRES,1,56,27,29,3
NUEVO LEÓN,19,CERRALVO,011,CIUDAD CERRALVO,12,1567,811,756,83
NUEVO LEÓN,19,CERRALVO,011,EL SOL (RANCHO VIEJO),1,9,3,6,1
NUEVO LEÓN,19,CERRALVO,011,JUÁREZ,1,4,2,2,1
NUEVO LEÓN,19,CIÉNEGA DE FLORES,012,CIÉNEGA DE FLORES,77,23324,11340,11984,897
NUEVO LEÓN,19,CIÉNEGA DE FLORES,012,LOS HÉROES MONTERREY,2,407,195,212,19
NUEVO LEÓN,19,CIÉNEGA DE FLORES,012,PORTAL DE LAS SALINAS,2,203,89,114,8
NUEVO LEÓN,19,CIÉNEGA DE FLORES,012,VILLAS CAMPESTRES,3,48,20,28,4
NUEVO LEÓN,19,CHINA,013,CHINA,13,878,449,429,54
NUEVO LEÓN,19,CHINA,013,DOCTOR IGNACIO MORONES PRIETO,1,6,3,3,1
NUEVO LEÓN,19,CHINA,013,FRANCISCO I. MADERO,2,19,10,9,2
NUEVO LEÓN,19,CHINA,013,LA BARRETA TRES (LA BARRETA Y ANEXOS),4,157,83,74,15
NUEVO LEÓN,19,CHINA,013,LA MORITA,1,29,11,18,2
NUEVO LEÓN,19,CHINA,013,LA PURÍSIMA,2,14,6,8,2
NUEVO LEÓN,19,CHINA,013,LAS LAJAS (EL ROSARIO),1,236,135,101,13
NUEVO LEÓN,19,CHINA,013,LOS LIRIOS,3,5,3,2,2
NUEVO LEÓN,19,CHINA,013,SAN FERNANDO,3,40,23,17,7
NUEVO LEÓN,19,CHINA,013,SAN ISIDRO UNO (SAN ISIDRO),2,278,148,130,11
NUEVO LEÓN,19,CHINA,013,VISTA HERMOSA,3,562,294,268,26
NUEVO LEÓN,19,DOCTOR ARROYO,014,ACUÑA,3,181,92,89,17
NUEVO LEÓN,19,DOCTOR ARROYO,014,AGUA NUEVA,3,58,28,30,4
NUEVO LEÓN,19,DOCTOR ARROYO,014,ALBERCONES,4,225,112,113,12
NUEVO LEÓN,19,DOCTOR ARROYO,014,ÁLVARO OBREGÓN (CRUZ DE COSTILLA),2,27,14,13,2
NUEVO LEÓN,19,DOCTOR ARROYO,014,AMARO,3,32,17,15,4
NUEVO LEÓN,19,DOCTOR ARROYO,014,BOQUILLAS,3,88,41,47,7
NUEVO LEÓN,19,DOCTOR ARROYO,014,CAPADERITO,2,26,15,11,3
NUEVO LEÓN,19,DOCTOR ARROYO,014,CARMEN DE CASTAÑO,4,129,76,53,11
NUEVO LEÓN,19,DOCTOR ARROYO,014,CARMEN DE LA LAJA,4,159,82,77,12
NUEVO LEÓN,19,DOCTOR ARROYO,014,CERRITO DE VACAS,2,40,17,23,4
NUEVO LEÓN,19,DOCTOR ARROYO,014,CHARCO DE LA GRANJA,2,19,7,12,2
NUEVO LEÓN,19,DOCTOR ARROYO,014,COLORADAS,4,89,42,47,8
NUEVO LEÓN,19,DOCTOR ARROYO,014,CRUZ DE ELORZA,4,194,114,80,12
NUEVO LEÓN,19,DOCTOR ARROYO,014,DOCTOR ARROYO,24,3457,1742,1715,231
NUEVO LEÓN,19,DOCTOR ARROYO,014,EL ÁLAMO,3,31,8,23,3
NUEVO LEÓN,19,DOCTOR ARROYO,014,EL CANELO,4,95,56,39,9
NUEVO LEÓN,19,DOCTOR ARROYO,014,EL CERRITO DEL AIRE,1,16,10,6,1
NUEVO LEÓN,19,DOCTOR ARROYO,014,EL CHARQUILLO,4,161,80,81,16
NUEVO LEÓN,19,DOCTOR ARROYO,014,EL CONSUELO,3,44,26,18,5
NUEVO LEÓN,19,DOCTOR ARROYO,014,EL CORAZÓN,2,198,96,102,9
NUEVO LEÓN,19,DOCTOR ARROYO,014,EL LLANO,2,9,2,7,2
NUEVO LEÓN,19,DOCTOR ARROYO,014,EL MILAGRO,2,16,7,9,2
NUEVO LEÓN,19,DOCTOR ARROYO,014,EL OJO DE AGUA,3,10,7,3,3
NUEVO LEÓN,19,DOCTOR ARROYO,014,EL PEQUEÑO,1,6,4,2,1
NUEVO LEÓN,19,DOCTOR ARROYO,014,EL POCITO,2,31,19,12,3
NUEVO LEÓN,19,DOCTOR ARROYO,014,EL PROGRESO (BRIONES),1,21,9,12,1
NUEVO LEÓN,19,DOCTOR ARROYO,014,EL REFUGIO DE APANICO,3,15,8,7,2
NUEVO LEÓN,19,DOCTOR ARROYO,014,EL REFUGIO DE CEDILLO,3,27,15,12,3
NUEVO LEÓN,19,DOCTOR ARROYO,014,EL REFUGIO Y EL REPARO,3,42,19,23,4
NUEVO LEÓN,19,DOCTOR ARROYO,014,EL REPRESADERO,3,17,9,8,2
NUEVO LEÓN,19,DOCTOR ARROYO,014,EL RUCIO,3,53,28,25,5
NUEVO LEÓN,19,DOCTOR ARROYO,014,EL TAJO,2,18,7,11,2
NUEVO LEÓN,19,DOCTOR ARROYO,014,EL TECOLOTE,2,31,15,16,3
NUEVO LEÓN,19,DOCTOR ARROYO,014,EL TEPETATE,1,36,17,19,2
NUEVO LEÓN,19,DOCTOR ARROYO,014,EL VENADITO,1,13,8,5,1
NUEVO LEÓN,19,DOCTOR ARROYO,014,ENTRONQUE LOS MEDINA (LA LOMA),2,31,15,16,3
NUEVO LEÓN,19,DOCTOR ARROYO,014,ESTANQUE NUEVO,3,18,12,6,2
NUEVO LEÓN,19,DOCTOR ARROYO,014,GUADALUPE DE SILVA,1,17,9,8,1
NUEVO LEÓN,19,DOCTOR ARROYO,014,JESÚS MARÍA DE BERRONES,2,38,20,18,3
NUEVO LEÓN,19,DOCTOR ARROYO,014,JESÚS MARÍA Y EL SALTO,3,67,35,32,5
NUEVO LEÓN,19,DOCTOR ARROYO,014,LA AGÜITA,2,33,13,20,3
NUEVO LEÓN,19,DOCTOR ARROYO,014,LA BOLSA,2,42,22,20,3
NUEVO LEÓN,19,DOCTOR ARROYO,014,LA CHIRIPA,3,36,16,20,4
NUEVO LEÓN,19,DOCTOR ARROYO,014,LA CONCEPCIÓN,3,49,24,25,5
NUEVO LEÓN,19,DOCTOR ARROYO,014,LA CONTRA DE LOS CHÁVEZ,2,7,3,4,1
NUEVO LEÓN,19,DOCTOR ARROYO,014,LA ESCONDIDA,1,4,2,2,1
NUEVO LEÓN,19,DOCTOR ARROYO,014,LA ESCONDIDA DE ARZOLA,1,21,11,10,2
NUEVO LEÓN,19,DOCTOR ARROYO,014,LA LAGUNA,1,4,3,1,1
NUEVO LEÓN,19,DOCTOR ARROYO,014,LA LAGUNITA,1,9,2,7,1
NUEVO LEÓN,19,DOCTOR ARROYO,014,LA LAJITA,2,23,14,9,2
NUEVO LEÓN,19,DOCTOR ARROYO,014,LA LOBERA DE PORTILLO,2,18,7,11,2
NUEVO LEÓN,19,DOCTOR ARROYO,014,LA MESA DE BERRONES,1,4,2,2,1
NUEVO LEÓN,19,DOCTOR ARROYO,014,LA PRESA DE QUINTERO,2,13,9,4,2
NUEVO LEÓN,19,DOCTOR ARROYO,014,LA PRESITA DE MACÍAS,2,10,7,3,1
NUEVO LEÓN,19,DOCTOR ARROYO,014,LA PRESITA DE RUEDA,3,36,20,16,3
NUEVO LEÓN,19,DOCTOR ARROYO,014,LA TAPONA DE CAMARILLO,3,63,29,34,6
NUEVO LEÓN,19,DOCTOR ARROYO,014,LA UNIÓN Y EL CARDONAL,2,62,28,34,5
NUEVO LEÓN,19,DOCTOR ARROYO,014,LA YERBA,4,246,135,111,18
NUEVO LEÓN,19,DOCTOR ARROYO,014,LAGUNITA DE CASTILLO,4,145,73,72,12
NUEVO LEÓN,19,DOCTOR ARROYO,014,LAGUNITA Y RANCHOS NUEVOS,3,25,12,13,3
NUEVO LEÓN,19,DOCTOR ARROYO,014,LAS CATORCE,3,109,65,44,9
NUEVO LEÓN,19,DOCTOR ARROYO,014,LAS HUERTAS DE QUIROGA,1,8,4,4,1
NUEVO LEÓN,19,DOCTOR ARROYO,014,LAS JARILLAS,2,17,9,8,2
NUEVO LEÓN,19,DOCTOR ARROYO,014,LAS VÍRGENES,2,27,13,14,3
NUEVO LEÓN,19,DOCTOR ARROYO,014,LOS ALTITOS,2,13,4,9,2
NUEVO LEÓN,19,DOCTOR ARROYO,014,LOS ARREOZOLA,3,36,24,12,4
NUEVO LEÓN,19,DOCTOR ARROYO,014,LOS CUARTOS,2,34,15,19,4
NUEVO LEÓN,19,DOCTOR ARROYO,014,LOS MEDINA,3,259,127,132,21
NUEVO LEÓN,19,DOCTOR ARROYO,014,LOS SEGOVIA,3,20,8,12,3
NUEVO LEÓN,19,DOCTOR ARROYO,014,LOS TERRENOS,2,13,6,7,2
NUEVO LEÓN,19,DOCTOR ARROYO,014,LOS TERREROS,1,12,5,7,1
NUEVO LEÓN,19,DOCTOR ARROYO,014,MESA DE GONZÁLEZ,1,10,4,6,1
NUEVO LEÓN,19,DOCTOR ARROYO,014,MESA DEL TRAIDOR,3,48,20,28,4
NUEVO LEÓN,19,DOCTOR ARROYO,014,PALMA GORDA,4,119,74,45,10
NUEVO LEÓN,19,DOCTOR ARROYO,014,PALMILLAS (AGUILILLAS),3,26,13,13,3
NUEVO LEÓN,19,DOCTOR ARROYO,014,PANALES DE ARRIBA,4,205,101,104,14
NUEVO LEÓN,19,DOCTOR ARROYO,014,PANALILLOS,2,8,6,2,1
NUEVO LEÓN,19,DOCTOR ARROYO,014,POMPEYA,3,52,26,26,5
NUEVO LEÓN,19,DOCTOR ARROYO,014,PRESA DE MALTOS,4,170,84,86,13
NUEVO LEÓN,19,DOCTOR ARROYO,014,PRESA DE SAN CARLOS,4,93,50,43,8
NUEVO LEÓN,19,DOCTOR ARROYO,014,PRESA SAN ANTONIO,3,4,3,1,2
NUEVO LEÓN,19,DOCTOR ARROYO,014,PUERTA DE AGUILAR,3,77,43,34,6
NUEVO LEÓN,19,DOCTOR ARROYO,014,PUERTO DE DOLORES,3,47,18,29,5
NUEVO LEÓN,19,DOCTOR ARROYO,014,PUERTO DEL AIRE,3,111,56,55,9
NUEVO LEÓN,19,DOCTOR ARROYO,014,RANCHO LARGO,1,8,5,3,1
NUEVO LEÓN,19,DOCTOR ARROYO,014,RINCONADA DE MARTÍNEZ (SAN JOSÉ DE RINCONADA),1,4,0,4,1
NUEVO LEÓN,19,DOCTOR ARROYO,014,SAN AGUSTÍN DE VALDEZ,2,17,11,6,2
NUEVO LEÓN,19,DOCTOR ARROYO,014,SAN ANTONIO DE BUENAVISTA (LOS COCHINITOS),3,36,15,21,3
NUEVO LEÓN,19,DOCTOR ARROYO,014,SAN ANTONIO DE PEÑA NEVADA,4,197,107,90,14
NUEVO LEÓN,19,DOCTOR ARROYO,014,SAN CAYETANO DE VACAS,3,260,119,141,40
NUEVO LEÓN,19,DOCTOR ARROYO,014,SAN DIEGO (SAN DIEGO DE VACAS),2,16,6,10,2
NUEVO LEÓN,19,DOCTOR ARROYO,014,SAN FELIPE,1,5,3,2,1
NUEVO LEÓN,19,DOCTOR ARROYO,014,SAN FELIPE DE MARTÍNEZ,4,28,12,16,4
NUEVO LEÓN,19,DOCTOR ARROYO,014,SAN FRANCISCO DE LOS DESMONTES,2,28,9,19,3
NUEVO LEÓN,19,DOCTOR ARROYO,014,SAN FRANCISCO DE ZÚÑIGA,1,7,3,4,1
NUEVO LEÓN,19,DOCTOR ARROYO,014,SAN FRANCISCO DEL YUGO,2,16,9,7,2
NUEVO LEÓN,19,DOCTOR ARROYO,014,SAN GREGORIO,1,5,3,2,1
NUEVO LEÓN,19,DOCTOR ARROYO,014,SAN IGNACIO DE TORRES,4,99,48,51,8
NUEVO LEÓN,19,DOCTOR ARROYO,014,SAN ISIDRO DE FERNÁNDEZ,4,233,113,120,15
NUEVO LEÓN,19,DOCTOR ARROYO,014,SAN ISIDRO DE MARTÍNEZ (LAS CUATAS),2,8,4,4,1
NUEVO LEÓN,19,DOCTOR ARROYO,014,SAN JOAQUÍN,1,12,6,6,1
NUEVO LEÓN,19,DOCTOR ARROYO,014,SAN JOSÉ DE FLORES,4,49,30,19,5
NUEVO LEÓN,19,DOCTOR ARROYO,014,SAN JOSÉ DE LA LUZ,2,10,1,9,2
NUEVO LEÓN,19,DOCTOR ARROYO,014,SAN JOSÉ DEL PUERTO,2,3,3,0,2
NUEVO LEÓN,19,DOCTOR ARROYO,014,SAN JUAN DE LA CRUZ,5,128,58,70,11
NUEVO LEÓN,19,DOCTOR ARROYO,014,SAN JUAN DEL PALMAR,4,115,54,61,10
NUEVO LEÓN,19,DOCTOR ARROYO,014,SAN JUANITO,1,4,2,2,1
NUEVO LEÓN,19,DOCTOR ARROYO,014,SAN MATEO,1,13,6,7,1
NUEVO LEÓN,19,DOCTOR ARROYO,014,SAN MIGUELITO,2,4,1,3,1
NUEVO LEÓN,19,DOCTOR ARROYO,014,SAN PABLO DE RUEDA,4,81,34,47,11
NUEVO LEÓN,19,DOCTOR ARROYO,014,SAN PEDRO DE GONZÁLEZ (SAN PEDRO DE RUEDA),5,115,67,48,12
NUEVO LEÓN,19,DOCTOR ARROYO,014,SAN RAMÓN DE LOS MARTÍNEZ,4,131,63,68,14
NUEVO LEÓN,19,DOCTOR ARROYO,014,SAN VICENTE DE GONZÁLEZ,2,13,8,5,2
NUEVO LEÓN,19,DOCTOR ARROYO,014,SAN VICENTE DE LA PUERTA,2,29,17,12,3
NUEVO LEÓN,19,DOCTOR ARROYO,014,SAN VICENTE DE RUEDA,1,5,2,3,1
NUEVO LEÓN,19,DOCTOR ARROYO,014,SANTA ANA,4,134,61,73,16
NUEVO LEÓN,19,DOCTOR ARROYO,014,SANTA GERTRUDIS,3,16,5,11,2
NUEVO LEÓN,19,DOCTOR ARROYO,014,SANTA ISABEL,3,31,16,15,2
NUEVO LEÓN,19,DOCTOR ARROYO,014,SANTA LUCÍA,3,23,7,16,3
NUEVO LEÓN,19,DOCTOR ARROYO,014,SANTA MARGARITA,2,12,8,4,2
NUEVO LEÓN,19,DOCTOR ARROYO,014,SANTA MARÍA,4,48,26,22,4
NUEVO LEÓN,19,DOCTOR ARROYO,014,SANTA RITA,4,132,72,60,13
NUEVO LEÓN,19,DOCTOR ARROYO,014,SANTA TERESA (DON JESÚS),3,5,4,1,2
NUEVO LEÓN,19,DOCTOR ARROYO,014,SANTA TERESA Y SAN JERÓNIMO,2,23,8,15,2
NUEVO LEÓN,19,DOCTOR ARROYO,014,TANQUECILLOS,2,37,15,22,4
NUEVO LEÓN,19,DOCTOR ARROYO,014,VALLECILLOS,2,11,2,9,1
NUEVO LEÓN,19,DOCTOR COSS,015,DOCTOR COSS,5,222,118,104,16
NUEVO LEÓN,19,DOCTOR COSS,015,EL BRASIL,2,20,10,10,2
NUEVO LEÓN,19,DOCTOR GONZÁLEZ,016,DOCTOR GONZÁLEZ,6,556,299,257,30
NUEVO LEÓN,19,DOCTOR GONZÁLEZ,016,LOS HUALICHES,1,54,22,32,3
NUEVO LEÓN,19,DOCTOR GONZÁLEZ,016,NUEVO REPUEBLO,2,69,28,41,5
NUEVO LEÓN,19,GALEANA,017,AGUA BLANCA,1,2,0,2,1
NUEVO LEÓN,19,GALEANA,017,AGUA NUEVA (SANTA FE),1,6,4,2,1
NUEVO LEÓN,19,GALEANA,017,ALFREDO V. BONFIL (LA LAGUNITA),2,8,1,7,2
NUEVO LEÓN,19,GALEANA,017,AQUILES SERDÁN (LA HEDIONDILLA),4,197,98,99,13
NUEVO LEÓN,19,GALEANA,017,BARRIO DE JALISCO (JALISCO),1,25,16,9,2
NUEVO LEÓN,19,GALEANA,017,BROWNSVILLE,2,7,4,3,2
NUEVO LEÓN,19,GALEANA,017,CATARINO RODRÍGUEZ (EL POTOSÍ),5,549,276,273,48
NUEVO LEÓN,19,GALEANA,017,CIÉNEGA DEL TORO,4,259,131,128,17
NUEVO LEÓN,19,GALEANA,017,CIENEGUILLAS Y CRUCITAS,2,7,3,4,2
NUEVO LEÓN,19,GALEANA,017,DIECIOCHO DE MARZO,2,89,47,42,7
NUEVO LEÓN,19,GALEANA,017,EL ANHELO,2,30,20,10,3
NUEVO LEÓN,19,GALEANA,017,EL BARROCITO,4,81,48,33,9
NUEVO LEÓN,19,GALEANA,017,EL CANELITO,2,15,5,10,2
NUEVO LEÓN,19,GALEANA,017,EL CARMEN,1,5,2,3,1
NUEVO LEÓN,19,GALEANA,017,EL CASTILLO,4,159,93,66,11
NUEVO LEÓN,19,GALEANA,017,EL CRISTAL,3,47,24,23,4
NUEVO LEÓN,19,GALEANA,017,EL CUIJE,2,41,19,22,3
NUEVO LEÓN,19,GALEANA,017,EL DERRAMADERO,4,149,69,80,12
NUEVO LEÓN,19,GALEANA,017,EL ENCINAL (PUERTO EL ENCINAL DE LA POZA),2,11,4,7,2
NUEVO LEÓN,19,GALEANA,017,EL ERIAL,2,45,19,26,3
NUEVO LEÓN,19,GALEANA,017,EL MILAGRO,3,76,40,36,5
NUEVO LEÓN,19,GALEANA,017,EL MOLINO,1,8,3,5,1
NUEVO LEÓN,19,GALEANA,017,EL PALMITO,2,7,5,2,2
NUEVO LEÓN,19,GALEANA,017,EL PEÑUELO,2,14,8,6,2
NUEVO LEÓN,19,GALEANA,017,EL PORVENIR DE SANTA CLARA (EL COYOTE),2,7,3,4,2
NUEVO LEÓN,19,GALEANA,017,EL POTRERO DE PRIETO,3,14,5,9,3
NUEVO LEÓN,19,GALEANA,017,EL POTRERO PRIETO DE ARRIBA,2,14,5,9,2
NUEVO LEÓN,19,GALEANA,017,EL PRADO (EL MEZQUITE),2,83,40,43,6
NUEVO LEÓN,19,GALEANA,017,EL REFUGIO (REFUGIO DE LOS RANCHOS),2,47,30,17,4
NUEVO LEÓN,19,GALEANA,017,EL REFUGIO DE LOS IBARRA (RANCHO CASTILLO),1,36,20,16,3
NUEVO LEÓN,19,GALEANA,017,EL RUCIO,2,11,2,9,2
NUEVO LEÓN,19,GALEANA,017,EL TEPOZÁN,4,98,56,42,9
NUEVO LEÓN,19,GALEANA,017,EL TOKIO,4,172,85,87,11
NUEVO LEÓN,19,GALEANA,017,ESTADOS UNIDOS,2,34,18,16,3
NUEVO LEÓN,19,GALEANA,017,FRANCISCO VILLA,2,29,16,13,3
NUEVO LEÓN,19,GALEANA,017,GALEANA,15,1816,961,855,95
NUEVO LEÓN,19,GALEANA,017,JESÚS MARÍA AGUIRRE (PUERTO DE NOPALILLOS),2,17,10,7,2
NUEVO LEÓN,19,GALEANA,017,JOYAS DE AGUA FRÍA,2,7,2,5,2
NUEVO LEÓN,19,GALEANA,017,LA BOCA DEL REFUGIO,2,61,23,38,5
NUEVO LEÓN,19,GALEANA,017,LA CARBONERA,1,8,2,6,1
NUEVO LEÓN,19,GALEANA,017,LA CASITA,2,47,20,27,4
NUEVO LEÓN,19,GALEANA,017,LA CONCHA,2,60,26,34,5
NUEVO LEÓN,19,GALEANA,017,LA CUESTA,1,7,5,2,1
NUEVO LEÓN,19,GALEANA,017,LA ESPERANZA,1,17,4,13,1
NUEVO LEÓN,19,GALEANA,017,LA ESPERANZA (EL COYOTE),2,21,10,11,2
NUEVO LEÓN,19,GALEANA,017,LA ESPERANZA (LOTE CINCO),2,35,17,18,3
NUEVO LEÓN,19,GALEANA,017,LA HUICHE [MINERAL],2,13,7,6,2
NUEVO LEÓN,19,GALEANA,017,LA LAGUNITA,1,8,4,4,1
NUEVO LEÓN,19,GALEANA,017,LA LAGUNITA (EL ORITO),1,3,1,2,1
NUEVO LEÓN,19,GALEANA,017,LA LEONA,2,41,17,24,3
NUEVO LEÓN,19,GALEANA,017,LA NUEVA ESMERALDA (NUEVO POBLADO DE LA ESMERALDA),2,24,14,10,2
NUEVO LEÓN,19,GALEANA,017,LA NUEVA PRIMAVERA,1,7,5,2,1
NUEVO LEÓN,19,GALEANA,017,LA PAZ,1,40,21,19,3
NUEVO LEÓN,19,GALEANA,017,LA PIEDRA,1,7,4,3,1
NUEVO LEÓN,19,GALEANA,017,LA POZA,2,39,18,21,3
NUEVO LEÓN,19,GALEANA,017,LA PRESITA DE BERLANGA,3,41,25,16,4
NUEVO LEÓN,19,GALEANA,017,LA PRIMAVERA (EL CHARCO),3,33,14,19,3
NUEVO LEÓN,19,GALEANA,017,LA PROVIDENCIA,4,200,94,106,13
NUEVO LEÓN,19,GALEANA,017,LA ROSA,2,32,18,14,2
NUEVO LEÓN,19,GALEANA,017,LA TRINIDAD,1,39,19,20,3
NUEVO LEÓN,19,GALEANA,017,LA TRINIDAD (EL CEDRITO),2,22,9,13,2
NUEVO LEÓN,19,GALEANA,017,LAGUNA DE LABRADORES,3,255,133,122,43
NUEVO LEÓN,19,GALEANA,017,LAJAS NEGRAS,1,14,7,7,1
NUEVO LEÓN,19,GALEANA,017,LAS CORDELADAS,4,401,198,203,38
NUEVO LEÓN,19,GALEANA,017,LAS DELICIAS,3,136,66,70,10
NUEVO LEÓN,19,GALEANA,017,LÁZARO CÁRDENAS (LA BIZNAGA),1,13,6,7,1
NUEVO LEÓN,19,GALEANA,017,LOBA CHICA,1,3,2,1,1
NUEVO LEÓN,19,GALEANA,017,LOS ADOBES,4,214,105,109,16
NUEVO LEÓN,19,GALEANA,017,LOS LLANITOS,2,37,18,19,4
NUEVO LEÓN,19,GALEANA,017,LOS MIMBRES,3,55,29,26,5
NUEVO LEÓN,19,GALEANA,017,LOS NOGALES,2,14,4,10,2
NUEVO LEÓN,19,GALEANA,017,LOS PINOS (MORALES),3,21,8,13,2
NUEVO LEÓN,19,GALEANA,017,LOS POCITOS,2,32,11,21,3
NUEVO LEÓN,19,GALEANA,017,LOTE UNO FRACCIÓN NAVIDAD (BENITO JUÁREZ),2,45,18,27,3
NUEVO LEÓN,19,GALEANA,017,LUCIO BLANCO,3,7,4,3,2
NUEVO LEÓN,19,GALEANA,017,MAGUEYES,2,25,12,13,2
NUEVO LEÓN,19,GALEANA,017,MARGARITAS,2,78,36,42,5
NUEVO LEÓN,19,GALEANA,017,MIGUEL HIDALGO,2,49,27,22,4
NUEVO LEÓN,19,GALEANA,017,NAVIDAD,2,175,77,98,10
NUEVO LEÓN,19,GALEANA,017,OJO DE AGUA (EL PASO),1,3,1,2,1
NUEVO LEÓN,19,GALEANA,017,PABLILLO,4,207,106,101,19
NUEVO LEÓN,19,GALEANA,017,PINAL ALTO,2,62,30,32,5
NUEVO LEÓN,19,GALEANA,017,PUERTO DE PASTORES,2,24,17,7,2
NUEVO LEÓN,19,GALEANA,017,PUERTO GRANDE,3,73,40,33,6
NUEVO LEÓN,19,GALEANA,017,PUERTO MÉXICO,4,198,89,109,12
NUEVO LEÓN,19,GALEANA,017,REFUGIO DE LOS IBARRA,2,21,10,11,2
NUEVO LEÓN,19,GALEANA,017,RÍO DE SAN JOSÉ,2,10,0,10,2
NUEVO LEÓN,19,GALEANA,017,SAMANIEGO Y LA BECERRA (MARIANO ESCOBEDO),3,26,7,19,3
NUEVO LEÓN,19,GALEANA,017,SAN ANTONIO DE GONZÁLEZ,1,4,3,1,1
NUEVO LEÓN,19,GALEANA,017,SAN ANTONIO DEL SALERO,2,33,15,18,3
NUEVO LEÓN,19,GALEANA,017,SAN FERNANDO,2,3,1,2,2
NUEVO LEÓN,19,GALEANA,017,SAN FRANCISCO DE BERLANGA,2,29,17,12,3
NUEVO LEÓN,19,GALEANA,017,SAN FRANCISCO DE LOS BLANCOS,2,29,17,12,3
NUEVO LEÓN,19,GALEANA,017,SAN FRANCISCO JAVIER,3,48,24,24,5
NUEVO LEÓN,19,GALEANA,017,SAN IGNACIO DE TEXAS,4,164,92,72,11
NUEVO LEÓN,19,GALEANA,017,SAN ILDEFONSO,2,57,29,28,4
NUEVO LEÓN,19,GALEANA,017,SAN ISIDRO DE CIÉNEGA DEL TORO,1,3,2,1,1
NUEVO LEÓN,19,GALEANA,017,SAN JOAQUÍN,2,84,38,46,7
NUEVO LEÓN,19,GALEANA,017,SAN JORGE,3,29,14,15,3
NUEVO LEÓN,19,GALEANA,017,SAN JOSÉ DE CONTRERAS,2,33,17,16,3
NUEVO LEÓN,19,GALEANA,017,SAN JOSÉ DE GONZÁLEZ,3,25,13,12,3
NUEVO LEÓN,19,GALEANA,017,SAN JOSÉ DE LA JOYA,3,44,25,19,4
NUEVO LEÓN,19,GALEANA,017,SAN JOSÉ DE LA MARTHA,2,29,15,14,3
NUEVO LEÓN,19,GALEANA,017,SAN JOSÉ DE RAÍCES,5,740,377,363,42
NUEVO LEÓN,19,GALEANA,017,SAN JUAN DE DIOS,1,7,4,3,1
NUEVO LEÓN,19,GALEANA,017,SAN JUAN DEL PRADO,4,142,75,67,11
NUEVO LEÓN,19,GALEANA,017,SAN LUCAS (LA MESA),3,37,15,22,4
NUEVO LEÓN,19,GALEANA,017,SAN MARCOS,2,35,17,18,3
NUEVO LEÓN,19,GALEANA,017,SAN PABLO (TRANQUITAS),1,2,2,0,1
NUEVO LEÓN,19,GALEANA,017,SAN PABLO DE RAÍCES,2,14,9,5,2
NUEVO LEÓN,19,GALEANA,017,SAN PEDRO SOTOLAR,2,19,13,6,2
NUEVO LEÓN,19,GALEANA,017,SAN RAFAEL,7,955,503,452,70
NUEVO LEÓN,19,GALEANA,017,SAN ROBERTO,2,110,50,60,8
NUEVO LEÓN,19,GALEANA,017,SAN URBET,2,28,13,15,3
NUEVO LEÓN,19,GALEANA,017,SANTA ANITA DEL PEÑASCO,2,14,4,10,2
NUEVO LEÓN,19,GALEANA,017,SANTA CLARA DE CIÉNEGA DEL TORO,4,142,75,67,12
NUEVO LEÓN,19,GALEANA,017,SANTA CLARA DE GONZÁLEZ,2,42,21,21,4
NUEVO LEÓN,19,GALEANA,017,SANTA CRUZ,3,34,13,21,4
NUEVO LEÓN,19,GALEANA,017,SANTA CRUZ CIÉNEGA DEL TORO,2,49,24,25,4
NUEVO LEÓN,19,GALEANA,017,SANTA CRUZ DE SAUCES,2,33,13,20,3
NUEVO LEÓN,19,GALEANA,017,SANTA FE,1,26,16,10,2
NUEVO LEÓN,19,GALEANA,017,SANTA FE EL POZO (EL POZO),1,4,2,2,1
NUEVO LEÓN,19,GALEANA,017,SANTA MARÍA DE RAMOS,4,313,158,155,15
NUEVO LEÓN,19,GALEANA,017,SANTA MARÍA DEL SOCORRO,2,4,2,2,1
NUEVO LEÓN,19,GALEANA,017,SANTA RITA (SANTA RITA DE CORDELADAS),2,154,76,78,9
NUEVO LEÓN,19,GALEANA,017,SANTO DOMINGO,2,28,15,13,3
NUEVO LEÓN,19,GALEANA,017,SEIS DE ENERO,3,20,9,11,2
NUEVO LEÓN,19,GALEANA,017,TANQUECILLOS,2,49,23,26,4
NUEVO LEÓN,19,GALEANA,017,TAPIAS (EL CHAPARRAL),1,7,4,3,1
NUEVO LEÓN,19,GALEANA,017,VENUSTIANO CARRANZA GRUPO B (LOS TARACOS),3,60,30,30,5
NUEVO LEÓN,19,GARCÍA,018,ÁLCALI,6,3740,1864,1876,123
NUEVO LEÓN,19,GARCÍA,018,ALTA VILLA,3,524,280,244,19
NUEVO LEÓN,19,GARCÍA,018,CHUPADEROS DEL INDIO,1,8,4,4,1
NUEVO LEÓN,19,GARCÍA,018,EL MILAGRO,3,16,11,5,3
NUEVO LEÓN,19,GARCÍA,018,GARCÍA,195,74598,36912,37686,3006
NUEVO LEÓN,19,GARCÍA,018,ICAMOLE,3,69,33,36,7
NUEVO LEÓN,19,GARCÍA,018,LA CRUZ,2,894,449,445,27
NUEVO LEÓN,19,GARCÍA,018,LOS ELOTES (VILLA DE GARCÍA),2,8,3,5,2
NUEVO LEÓN,19,GARCÍA,018,LOS FIERROS,3,36,17,19,4
NUEVO LEÓN,19,GARCÍA,018,LOS PARQUES,6,1990,959,1031,69
NUEVO LEÓN,19,GARCÍA,018,MARAVILLAS,2,125,53,72,9
NUEVO LEÓN,19,GARCÍA,018,MARAVILLAS Y ANEXAS,1,11,2,9,1
NUEVO LEÓN,19,GARCÍA,018,MITRAS PONIENTE,11,2491,1098,1393,81
NUEVO LEÓN,19,GARCÍA,018,PARQUE INDUSTRIAL CIUDAD MITRAS,4,796,372,424,32
NUEVO LEÓN,19,GARCÍA,018,PASO DE GUADALUPE Y MARIPOSA,3,61,30,31,5
NUEVO LEÓN,19,GARCÍA,018,RINCONADA,4,320,155,165,17
NUEVO LEÓN,19,GARCÍA,018,SABANILLAS,2,35,20,15,3
NUEVO LEÓN,19,GARCÍA,018,SAN JOSÉ,2,275,143,132,12
NUEVO LEÓN,19,GARCÍA,018,SANTA MARÍA,4,2139,1027,1112,76
NUEVO LEÓN,19,GARCÍA,018,UNIÓN EMILIANO ZAPATA,4,1004,500,504,40
NUEVO LEÓN,19,GARCÍA,018,VALLE DE LINCOLN,23,11426,5717,5709,359
NUEVO LEÓN,19,GARCÍA,018,XENPAL,3,255,129,126,13
NUEVO LEÓN,19,SAN PEDRO GARZA GARCÍA,019,SAN PEDRO GARZA GARCÍA,161,45009,24232,20777,3505
NUEVO LEÓN,19,GENERAL BRAVO,020,CONFERÍN ARIZPE,2,65,27,38,4
NUEVO LEÓN,19,GENERAL BRAVO,020,ESQUINA DEL POTRERO (EL CUERVITO),2,10,6,4,2
NUEVO LEÓN,19,GENERAL BRAVO,020,GENERAL BRAVO,7,564,280,284,31
NUEVO LEÓN,19,GENERAL BRAVO,020,GENERAL TAPIA (MARIANO ESCOBEDO),3,91,53,38,9
NUEVO LEÓN,19,GENERAL BRAVO,020,LA UNIÓN,3,23,13,10,2
NUEVO LEÓN,19,GENERAL BRAVO,020,LAS TRES CAÍDAS,1,182,85,97,14
NUEVO LEÓN,19,GENERAL BRAVO,020,LOS CANTÚ,2,289,142,147,12
NUEVO LEÓN,19,GENERAL ESCOBEDO,021,CIUDAD GENERAL ESCOBEDO,345,88179,43040,45139,4064
NUEVO LEÓN,19,GENERAL ESCOBEDO,021,MONCLOVA PRIMER SECTOR,4,574,285,289,32
NUEVO LEÓN,19,GENERAL ESCOBEDO,021,PALMIRAS,1,356,195,161,20
NUEVO LEÓN,19,GENERAL ESCOBEDO,021,PRADERAS DE SAN FRANCISCO,10,4722,2336,2386,174
NUEVO LEÓN,19,GENERAL ESCOBEDO,021,SAN MIGUEL DE LOS GARZA,7,2667,1299,1368,124
NUEVO LEÓN,19,GENERAL ESCOBEDO,021,UNIÓN AGROPECUARIOS LÁZARO CÁRDENAS DEL NORTE,8,3906,1893,2013,178
NUEVO LEÓN,19,GENERAL TERÁN,022,BUENAVISTA DE JIMÉNEZ,3,8,5,3,2
NUEVO LEÓN,19,GENERAL TERÁN,022,CALIFORNIA,2,59,35,24,5
NUEVO LEÓN,19,GENERAL TERÁN,022,EL ENCADENADO,1,16,9,7,1
NUEVO LEÓN,19,GENERAL TERÁN,022,EL ESPÍRITU,2,64,29,35,4
NUEVO LEÓN,19,GENERAL TERÁN,022,EL GRANJENAL,3,25,13,12,3
NUEVO LEÓN,19,GENERAL TERÁN,022,EL LLANO (SAN RAFAEL DEL LLANO),4,94,47,47,10
NUEVO LEÓN,19,GENERAL TERÁN,022,EL TORO,2,11,5,6,2
NUEVO LEÓN,19,GENERAL TERÁN,022,EMILIANO ZAPATA,3,8,5,3,2
NUEVO LEÓN,19,GENERAL TERÁN,022,GENERAL TERÁN,26,1796,911,885,152
NUEVO LEÓN,19,GENERAL TERÁN,022,GUADALUPE LA JOYA,3,16,10,6,3
NUEVO LEÓN,19,GENERAL TERÁN,022,LA BRISA,1,17,10,7,1
NUEVO LEÓN,19,GENERAL TERÁN,022,LA CORONA [HACIENDA],5,200,93,107,17
NUEVO LEÓN,19,GENERAL TERÁN,022,LA GRANJA,1,28,12,16,2
NUEVO LEÓN,19,GENERAL TERÁN,022,LA PURÍSIMA,4,58,30,28,5
NUEVO LEÓN,19,GENERAL TERÁN,022,LA UNIÓN,2,35,19,16,3
NUEVO LEÓN,19,GENERAL TERÁN,022,LAS ANACUAS,3,36,15,21,4
NUEVO LEÓN,19,GENERAL TERÁN,022,LAS ANACUITAS,2,101,46,55,9
NUEVO LEÓN,19,GENERAL TERÁN,022,LAS BRISAS,1,5,3,2,1
NUEVO LEÓN,19,GENERAL TERÁN,022,LAS TÓRTOLAS,2,28,8,20,3
NUEVO LEÓN,19,GENERAL TERÁN,022,LOS LIRIOS,2,11,8,3,2
NUEVO LEÓN,19,GENERAL TERÁN,022,NUEVO SANTA ANA,1,85,44,41,6
NUEVO LEÓN,19,GENERAL TERÁN,022,OJO DE AGUA,2,11,6,5,2
NUEVO LEÓN,19,GENERAL TERÁN,022,RAMÍREZ,2,39,18,21,3
NUEVO LEÓN,19,GENERAL TERÁN,022,SAN JOAQUÍN,1,23,7,16,2
NUEVO LEÓN,19,GENERAL TERÁN,022,SAN JUAN DE VAQUERÍAS,4,141,79,62,13
NUEVO LEÓN,19,GENERAL TERÁN,022,SAN JULIÁN,2,29,14,15,2
NUEVO LEÓN,19,GENERAL TERÁN,022,SANTA ANA VIEJO,1,6,1,5,1
NUEVO LEÓN,19,GENERAL TERÁN,022,SANTA ENGRACIA [HACIENDA],2,18,7,11,2
NUEVO LEÓN,19,GENERAL TERÁN,022,SANTA RITA,1,33,14,19,3
NUEVO LEÓN,19,GENERAL TREVIÑO,023,GENERAL TREVIÑO,5,258,134,124,15
NUEVO LEÓN,19,GENERAL TREVIÑO,023,SAN JAVIER,1,1,0,1,1
NUEVO LEÓN,19,GENERAL ZARAGOZA,024,BUENA VISTA,3,24,8,16,2
NUEVO LEÓN,19,GENERAL ZARAGOZA,024,CALABAZAS (AGUA DE BENINO),2,3,2,1,1
NUEVO LEÓN,19,GENERAL ZARAGOZA,024,CASAS REALES,1,3,1,2,1
NUEVO LEÓN,19,GENERAL ZARAGOZA,024,CUAUHTÉMOC,2,9,7,2,2
NUEVO LEÓN,19,GENERAL ZARAGOZA,024,EL AHUICHE,2,3,3,0,2
NUEVO LEÓN,19,GENERAL ZARAGOZA,024,EL ARROYO (EL GRANADILLO),1,15,5,10,1
NUEVO LEÓN,19,GENERAL ZARAGOZA,024,EL BARAL,1,1,0,1,1
NUEVO LEÓN,19,GENERAL ZARAGOZA,024,EL ENCINAL,1,2,1,1,1
NUEVO LEÓN,19,GENERAL ZARAGOZA,024,EL MELÓN DE ARRIBA,1,2,1,1,1
NUEVO LEÓN,19,GENERAL ZARAGOZA,024,EL MUERTO,3,11,2,9,2
NUEVO LEÓN,19,GENERAL ZARAGOZA,024,EL PAME,1,26,17,9,2
NUEVO LEÓN,19,GENERAL ZARAGOZA,024,EL PUERTECITO BARAL,2,26,11,15,2
NUEVO LEÓN,19,GENERAL ZARAGOZA,024,EL REFUGIO,3,36,14,22,5
NUEVO LEÓN,19,GENERAL ZARAGOZA,024,EL RINCÓN,2,2,1,1,1
NUEVO LEÓN,19,GENERAL ZARAGOZA,024,EL ROSILLO,3,11,6,5,2
NUEVO LEÓN,19,GENERAL ZARAGOZA,024,EL SALITRE,3,74,37,37,7
NUEVO LEÓN,19,GENERAL ZARAGOZA,024,GENERAL ZARAGOZA,6,498,264,234,29
NUEVO LEÓN,19,GENERAL ZARAGOZA,024,JOYA DE SAN DIEGO,3,44,20,24,5
NUEVO LEÓN,19,GENERAL ZARAGOZA,024,JOYA DE SAN LÁZARO,3,15,7,8,2
NUEVO LEÓN,19,GENERAL ZARAGOZA,024,LA CIENEGUITA,2,11,6,5,2
NUEVO LEÓN,19,GENERAL ZARAGOZA,024,LA ENCANTADA,3,28,16,12,4
NUEVO LEÓN,19,GENERAL ZARAGOZA,024,LA JOYA DE ALARDÍN,2,27,13,14,3
NUEVO LEÓN,19,GENERAL ZARAGOZA,024,LA LAGUNA,2,41,19,22,4
NUEVO LEÓN,19,GENERAL ZARAGOZA,024,LA LAGUNA (LA LAGUNA SECA),1,8,3,5,1
NUEVO LEÓN,19,GENERAL ZARAGOZA,024,LA LAGUNA Y JOYA DE ALARDÍN (EL LLANO),1,8,6,2,1
NUEVO LEÓN,19,GENERAL ZARAGOZA,024,LA MESILLA,1,19,10,9,1
NUEVO LEÓN,19,GENERAL ZARAGOZA,024,LAS JOYAS,1,183,80,103,9
NUEVO LEÓN,19,GENERAL ZARAGOZA,024,LOMA ATRAVESADA,2,3,1,2,2
NUEVO LEÓN,19,GENERAL ZARAGOZA,024,LOS CHIRRIONES,3,8,3,5,2
NUEVO LEÓN,19,GENERAL ZARAGOZA,024,LOS DIFUNTOS,1,5,3,2,1
NUEVO LEÓN,19,GENERAL ZARAGOZA,024,LOS MEMBRILLOS,2,2,0,2,1
NUEVO LEÓN,19,GENERAL ZARAGOZA,024,LOS TOROS,2,5,2,3,1
NUEVO LEÓN,19,GENERAL ZARAGOZA,024,LUIS DONALDO COLOSIO,1,10,8,2,1
NUEVO LEÓN,19,GENERAL ZARAGOZA,024,MAL PASO,2,3,1,2,1
NUEVO LEÓN,19,GENERAL ZARAGOZA,024,POTRERITOS,3,11,6,5,2
NUEVO LEÓN,19,GENERAL ZARAGOZA,024,PUERTO BAJO,3,11,2,9,3
NUEVO LEÓN,19,GENERAL ZARAGOZA,024,PUERTO DEL AIRE,3,15,9,6,4
NUEVO LEÓN,19,GENERAL ZARAGOZA,024,SAN FRANCISCO,3,45,17,28,4
NUEVO LEÓN,19,GENERAL ZARAGOZA,024,SAN JOSÉ DEL RÍO BLANCO,2,138,67,71,7
NUEVO LEÓN,19,GENERAL ZARAGOZA,024,SAN JOSECITO,3,30,18,12,3
NUEVO LEÓN,19,GENERAL ZARAGOZA,024,SAN PABLO,2,4,2,2,1
NUEVO LEÓN,19,GENERAL ZARAGOZA,024,SIBERIA,3,32,14,18,4
NUEVO LEÓN,19,GENERAL ZARAGOZA,024,TEPOZANES,3,24,12,12,3
NUEVO LEÓN,19,GENERAL ZARAGOZA,024,TINAJAS (LOS TANQUES),3,11,8,3,2
NUEVO LEÓN,19,GENERAL ZARAGOZA,024,TINAJITAS,2,9,5,4,2
NUEVO LEÓN,19,GENERAL ZARAGOZA,024,TORIBIO,2,6,3,3,2
NUEVO LEÓN,19,GENERAL ZUAZUA,025,FRACCIONAMIENTO REAL PALMAS,11,4782,2351,2431,200
NUEVO LEÓN,19,GENERAL ZUAZUA,025,GENERAL ZUAZUA,32,10387,5151,5236,443
NUEVO LEÓN,19,GENERAL ZUAZUA,025,PORTAL DEL NORTE,3,53,30,23,14
NUEVO LEÓN,19,GENERAL ZUAZUA,025,VALLE DE SANTA ELENA,19,7649,3738,3911,238
NUEVO LEÓN,19,GUADALUPE,026,GUADALUPE,681,132846,64647,68199,7813
NUEVO LEÓN,19,LOS HERRERAS,027,LOS HERRERAS,6,328,170,158,17
NUEVO LEÓN,19,LOS HERRERAS,027,SAN VICENTE,2,29,10,19,3
NUEVO LEÓN,19,HIGUERAS,028,HIGUERAS,4,275,132,143,17
NUEVO LEÓN,19,HUALAHUISES,029,CINCO SEÑORES (LOS ÁNGELES),2,16,8,8,2
NUEVO LEÓN,19,HUALAHUISES,029,EL PINTO,3,15,6,9,2
NUEVO LEÓN,19,HUALAHUISES,029,EL TRONCÓN,2,8,4,4,1
NUEVO LEÓN,19,HUALAHUISES,029,HUALAHUISES,10,1092,547,545,69
NUEVO LEÓN,19,HUALAHUISES,029,LA CRUZ,2,9,4,5,1
NUEVO LEÓN,19,HUALAHUISES,029,LA LAJA,2,18,7,11,2
NUEVO LEÓN,19,HUALAHUISES,029,MAGÜIRAS,3,39,25,14,4
NUEVO LEÓN,19,HUALAHUISES,029,PASO DE LAJAS (LA LAJA),2,6,1,5,1
NUEVO LEÓN,19,ITURBIDE,030,BENITO JUÁREZ (LAS ADJUNTAS),3,9,6,3,2
NUEVO LEÓN,19,ITURBIDE,030,BUENA VISTA,3,11,4,7,2
NUEVO LEÓN,19,ITURBIDE,030,CAMARONES,2,10,4,6,2
NUEVO LEÓN,19,ITURBIDE,030,CUEVAS,3,28,14,14,5
NUEVO LEÓN,19,ITURBIDE,030,EL MADROÑO,3,20,9,11,3
NUEVO LEÓN,19,ITURBIDE,030,EL SAUCILLO,1,1,1,0,1
NUEVO LEÓN,19,ITURBIDE,030,GACHUPINES,2,6,3,3,1
NUEVO LEÓN,19,ITURBIDE,030,ITURBIDE,6,427,207,220,30
NUEVO LEÓN,19,ITURBIDE,030,JAZMÍNES,2,4,4,0,2
NUEVO LEÓN,19,ITURBIDE,030,LA BOQUILLA,1,3,0,3,1
NUEVO LEÓN,19,ITURBIDE,030,LA COLORADA,1,3,2,1,1
NUEVO LEÓN,19,ITURBIDE,030,LA LUZ,2,12,5,7,2
NUEVO LEÓN,19,ITURBIDE,030,LA MENTIRA (LAS ANACUAS),1,3,1,2,1
NUEVO LEÓN,19,ITURBIDE,030,LA PURÍSIMA,4,89,50,39,9
NUEVO LEÓN,19,ITURBIDE,030,LAS DELICIAS,3,26,11,15,3
NUEVO LEÓN,19,ITURBIDE,030,LOS SAUCES,1,11,4,7,1
NUEVO LEÓN,19,ITURBIDE,030,SAN ANTONIO,2,13,7,6,2
NUEVO LEÓN,19,ITURBIDE,030,SAN ANTONIO DE PEÑITAS,3,23,13,10,3
NUEVO LEÓN,19,ITURBIDE,030,SAN FRANCISCO DE LAS ADJUNTAS,2,16,4,12,2
NUEVO LEÓN,19,ITURBIDE,030,SANTA INÉS,1,8,1,7,1
NUEVO LEÓN,19,JUÁREZ,031,AMPLIACIÓN CALDERÓN,3,118,45,73,5
NUEVO LEÓN,19,JUÁREZ,031,ANZURES,7,4182,2034,2148,113
NUEVO LEÓN,19,JUÁREZ,031,ARBOLEDAS DE SAN ROQUE,18,5602,2760,2842,197
NUEVO LEÓN,19,JUÁREZ,031,BOSQUES DE LA SILLA (SANTA ANA DE ABAJO),3,92,49,43,8
NUEVO LEÓN,19,JUÁREZ,031,BOSQUES DE SAN PEDRO,1,150,76,74,5
NUEVO LEÓN,19,JUÁREZ,031,CENTRO HABITACIONAL BURÓCRATAS DE GUADALUPE,4,772,408,364,30
NUEVO LEÓN,19,JUÁREZ,031,CIUDAD BENITO JUÁREZ,236,72086,35684,36402,2895
NUEVO LEÓN,19,JUÁREZ,031,FRESNILLO,1,15,7,8,1
NUEVO LEÓN,19,JUÁREZ,031,HÉCTOR CABALLERO,6,2263,1083,1180,82
NUEVO LEÓN,19,JUÁREZ,031,ISMAEL FLORES,1,76,45,31,3
NUEVO LEÓN,19,JUÁREZ,031,JARDINES DE LA SILLA (JARDINES),45,12791,6179,6612,489
NUEVO LEÓN,19,JUÁREZ,031,LA CIÉNEGA (LA CIENEGUITA),1,3,1,2,1
NUEVO LEÓN,19,JUÁREZ,031,LA CIUDADELA,15,3474,1759,1715,121
NUEVO LEÓN,19,JUÁREZ,031,LOS HUERTOS,4,1118,556,562,33
NUEVO LEÓN,19,JUÁREZ,031,LOS REHILETES,4,905,452,453,29
NUEVO LEÓN,19,JUÁREZ,031,MONTE KRISTAL,2,118,59,59,6
NUEVO LEÓN,19,JUÁREZ,031,SAN ANTONIO,3,360,157,203,19
NUEVO LEÓN,19,JUÁREZ,031,SAN FRANCISCO,8,3117,1470,1647,110
NUEVO LEÓN,19,JUÁREZ,031,SAN MATEO,1,4,3,1,1
NUEVO LEÓN,19,JUÁREZ,031,SAN PEDRO (DON PEDRO),1,260,118,142,8
NUEVO LEÓN,19,JUÁREZ,031,SAN ROQUE,1,40,27,13,2
NUEVO LEÓN,19,JUÁREZ,031,SANTA ANA DE ARRIBA,2,12,6,6,2
NUEVO LEÓN,19,JUÁREZ,031,VALLE DE JUÁREZ,4,457,223,234,16
NUEVO LEÓN,19,LAMPAZOS DE NARANJO,032,HORCONES,1,13,3,10,1
NUEVO LEÓN,19,LAMPAZOS DE NARANJO,032,LAMPAZOS DE NARANJO,8,1161,566,595,56
NUEVO LEÓN,19,LAMPAZOS DE NARANJO,032,RANAS,1,6,3,3,1
NUEVO LEÓN,19,LINARES,033,ALTAMIRA,1,16,8,8,1
NUEVO LEÓN,19,LINARES,033,AMPLIACIÓN EL ALAMAR (GUADALUPE),2,2,2,0,2
NUEVO LEÓN,19,LINARES,033,AMPLIACIÓN LOS HOYOS,2,14,9,5,2
NUEVO LEÓN,19,LINARES,033,AMPLIACIÓN ZAPATA,1,168,104,64,38
NUEVO LEÓN,19,LINARES,033,BENÍTEZ,3,23,9,14,3
NUEVO LEÓN,19,LINARES,033,CAJA PINTA,2,37,17,20,3
NUEVO LEÓN,19,LINARES,033,CERRO PRIETO,4,293,106,187,55
NUEVO LEÓN,19,LINARES,033,CHARAPE,1,23,6,17,2
NUEVO LEÓN,19,LINARES,033,CIÉNEGA DE CAMACHO,1,11,6,5,1
NUEVO LEÓN,19,LINARES,033,DOLORES DE SAN JULIÁN,3,32,15,17,5
NUEVO LEÓN,19,LINARES,033,EL BRASIL,3,32,20,12,4
NUEVO LEÓN,19,LINARES,033,EL CANELO,1,12,3,9,1
NUEVO LEÓN,19,LINARES,033,EL CARMEN DE LOS ELIZONDO,2,20,12,8,2
NUEVO LEÓN,19,LINARES,033,EL CASCAJOSO,2,23,10,13,2
NUEVO LEÓN,19,LINARES,033,EL CERRITO,1,5,2,3,1
NUEVO LEÓN,19,LINARES,033,EL CHAMIZAL,1,8,6,2,1
NUEVO LEÓN,19,LINARES,033,EL CONSUELO,2,7,2,5,2
NUEVO LEÓN,19,LINARES,033,EL DIEZ,3,74,32,42,6
NUEVO LEÓN,19,LINARES,033,EL FRESNO,2,27,19,8,3
NUEVO LEÓN,19,LINARES,033,EL GUAJOLOTE,2,13,9,4,2
NUEVO LEÓN,19,LINARES,033,EL POPOTE (EL POBLADO),2,22,13,9,2
NUEVO LEÓN,19,LINARES,033,EL PRETIL,2,11,3,8,2
NUEVO LEÓN,19,LINARES,033,EL REFUGIO,1,59,32,27,5
NUEVO LEÓN,19,LINARES,033,EL REFUGIO (VEREDAS),1,26,12,14,2
NUEVO LEÓN,19,LINARES,033,EL SALITRE (BERLANGA GARCÍA),3,37,19,18,4
NUEVO LEÓN,19,LINARES,033,EL TERRERO,2,3,1,2,1
NUEVO LEÓN,19,LINARES,033,EL TRONCÓN,1,9,6,3,1
NUEVO LEÓN,19,LINARES,033,EMILIANO ZAPATA,2,203,82,121,16
NUEVO LEÓN,19,LINARES,033,GATOS GÜEROS,3,78,41,37,6
NUEVO LEÓN,19,LINARES,033,GUADALUPE (LA HACIENDA DE GUADALUPE),5,277,145,132,16
NUEVO LEÓN,19,LINARES,033,HACIENDA DE MORAS,1,6,5,1,1
NUEVO LEÓN,19,LINARES,033,JESÚS MARÍA DEL PUERTO,3,35,19,16,4
NUEVO LEÓN,19,LINARES,033,LA CEBADILLA (LAS DELICIAS),3,32,15,17,3
NUEVO LEÓN,19,LINARES,033,LA CONCHA,1,1,0,1,1
NUEVO LEÓN,19,LINARES,033,LA ESCONDIDA (EL RANCHITO),2,120,59,61,8
NUEVO LEÓN,19,LINARES,033,LA ESTRELLA,2,15,4,11,2
NUEVO LEÓN,19,LINARES,033,LA ESTRELLA (EL CHARCO),1,40,26,14,3
NUEVO LEÓN,19,LINARES,033,LA GORGONIA,1,12,6,6,1
NUEVO LEÓN,19,LINARES,033,LA GRANJA,1,2,0,2,1
NUEVO LEÓN,19,LINARES,033,LA MESA,1,233,121,112,20
NUEVO LEÓN,19,LINARES,033,LA PAPA,1,2,1,1,1
NUEVO LEÓN,19,LINARES,033,LA PARRITA (LOS TERREROS),2,15,9,6,2
NUEVO LEÓN,19,LINARES,033,LA PETACA,9,1583,795,788,76
NUEVO LEÓN,19,LINARES,033,LA REFORMA,2,49,22,27,5
NUEVO LEÓN,19,LINARES,033,LA SOLEDAD,2,24,13,11,3
NUEVO LEÓN,19,LINARES,033,LA TIENDA,2,110,53,57,5
NUEVO LEÓN,19,LINARES,033,LAS BARRETAS,2,18,12,6,2
NUEVO LEÓN,19,LINARES,033,LAS BRISAS,1,315,154,161,20
NUEVO LEÓN,19,LINARES,033,LAS CRUCITAS,1,1,0,1,1
NUEVO LEÓN,19,LINARES,033,LAS CRUCITAS (OJO DE AGUA),1,2,1,1,1
NUEVO LEÓN,19,LINARES,033,LINARES,111,17185,8464,8721,1183
NUEVO LEÓN,19,LINARES,033,LOMA ALTA,2,37,18,19,3
NUEVO LEÓN,19,LINARES,033,LOMA ALTA (AMPLIACIÓN RANCHERÍAS),2,13,7,6,1
NUEVO LEÓN,19,LINARES,033,LOMA EL PERICO,2,39,16,23,3
NUEVO LEÓN,19,LINARES,033,LOS ÁLAMOS,2,23,15,8,3
NUEVO LEÓN,19,LINARES,033,LOS ÁNGELES,2,15,4,11,2
NUEVO LEÓN,19,LINARES,033,LOS LEONES,1,12,6,6,1
NUEVO LEÓN,19,LINARES,033,MEDEROS,4,80,42,38,8
NUEVO LEÓN,19,LINARES,033,NOGALILLOS (BELISARIO DOMÍNGUEZ),2,5,4,1,1
NUEVO LEÓN,19,LINARES,033,NUEVO CERRO PRIETO,1,5,2,3,1
NUEVO LEÓN,19,LINARES,033,NUEVO SAN ISIDRO,1,15,9,6,1
NUEVO LEÓN,19,LINARES,033,OJO DE AGUA,1,10,1,9,1
NUEVO LEÓN,19,LINARES,033,PARIENTES (LA CRUZ DE ABAJO),2,9,2,7,2
NUEVO LEÓN,19,LINARES,033,PONTEZUELAS,1,11,4,7,1
NUEVO LEÓN,19,LINARES,033,PURÍSIMA DE CONCHOS,2,10,5,5,2
NUEVO LEÓN,19,LINARES,033,RANCHERÍA,2,16,6,10,2
NUEVO LEÓN,19,LINARES,033,RANCHO VIEJO,2,12,6,6,2
NUEVO LEÓN,19,LINARES,033,RANCHO VIEJO Y LA PALMA,1,4,3,1,1
NUEVO LEÓN,19,LINARES,033,RÍO VERDE,1,109,56,53,6
NUEVO LEÓN,19,LINARES,033,RÍO VERDE (LAMPAZOS),1,41,18,23,2
NUEVO LEÓN,19,LINARES,033,SAN CRISTÓBAL,1,9,4,5,1
NUEVO LEÓN,19,LINARES,033,SAN FRANCISCO (LA HACIENDA),3,595,295,300,31
NUEVO LEÓN,19,LINARES,033,SAN FRANCISCO (SAN FRANCISCO TENAMAXTLE),1,19,10,9,1
NUEVO LEÓN,19,LINARES,033,SAN ISIDRO,2,39,10,29,4
NUEVO LEÓN,19,LINARES,033,SAN ISIDRO (SAN ANTONIO) [AGROINDUSTRIAS],1,127,64,63,7
NUEVO LEÓN,19,LINARES,033,SAN JACINTO (LA GARITA),2,13,7,6,2
NUEVO LEÓN,19,LINARES,033,SAN JOAQUÍN,3,687,378,309,76
NUEVO LEÓN,19,LINARES,033,SAN JOSÉ,1,4,1,3,1
NUEVO LEÓN,19,LINARES,033,SAN MIGUEL,2,11,7,4,2
NUEVO LEÓN,19,LINARES,033,SAN PEDRO GARZA GARCÍA (JESÚS MARÍA),1,5,2,3,1
NUEVO LEÓN,19,LINARES,033,SAN RAFAEL,3,177,85,92,16
NUEVO LEÓN,19,LINARES,033,SANTA ROSA (LA PITA),1,20,7,13,1
NUEVO LEÓN,19,LINARES,033,SANTO DOMINGO,5,38,20,18,5
NUEVO LEÓN,19,LINARES,033,VISTA HERMOSA,1,41,27,14,4
NUEVO LEÓN,19,MARÍN,034,MARÍN,9,1670,844,826,124
NUEVO LEÓN,19,MELCHOR OCAMPO,035,MELCHOR OCAMPO,4,290,143,147,18
NUEVO LEÓN,19,MIER Y NORIEGA,036,CERROS BLANCOS,4,228,115,113,15
NUEVO LEÓN,19,MIER Y NORIEGA,036,DOLORES,2,94,50,44,7
NUEVO LEÓN,19,MIER Y NORIEGA,036,EL GALLITO,3,51,17,34,4
NUEVO LEÓN,19,MIER Y NORIEGA,036,EL REFUGIO DE CERROS BLANCOS,4,196,101,95,14
NUEVO LEÓN,19,MIER Y NORIEGA,036,JESÚS MARÍA DEL TERRERO (EL LINDERO),2,40,19,21,4
NUEVO LEÓN,19,MIER Y NORIEGA,036,LA CARDONA,4,190,94,96,14
NUEVO LEÓN,19,MIER Y NORIEGA,036,LA JOYA DEL ZACATE,1,10,5,5,1
NUEVO LEÓN,19,MIER Y NORIEGA,036,LA PRESITA DE CERROS BLANCOS (LA PRESITA),2,89,40,49,6
NUEVO LEÓN,19,MIER Y NORIEGA,036,LAGUNITA DE TABERNA,3,58,28,30,6
NUEVO LEÓN,19,MIER Y NORIEGA,036,LAS MESAS DE SAN JUAN,3,36,14,22,4
NUEVO LEÓN,19,MIER Y NORIEGA,036,LAS PALOMAS (LAJILLAS),4,310,160,150,16
NUEVO LEÓN,19,MIER Y NORIEGA,036,MIER Y NORIEGA,5,521,287,234,21
NUEVO LEÓN,19,MIER Y NORIEGA,036,SAN ANTONIO DE ALAMITOS,2,52,26,26,4
NUEVO LEÓN,19,MIER Y NORIEGA,036,SAN ELÍAS,1,6,2,4,1
NUEVO LEÓN,19,MIER Y NORIEGA,036,SAN ISIDRO,4,141,74,67,11
NUEVO LEÓN,19,MIER Y NORIEGA,036,SAN JOSÉ DE CUATRO CAMINOS,1,7,3,4,1
NUEVO LEÓN,19,MIER Y NORIEGA,036,SAN JOSÉ DE MEDINA (RANCHO DE ABAJO),2,12,7,5,1
NUEVO LEÓN,19,MIER Y NORIEGA,036,SAN RAFAEL DE LOS MARTÍNEZ,4,277,156,121,20
NUEVO LEÓN,19,MIER Y NORIEGA,036,TAPONA MOREÑA,4,188,90,98,14
NUEVO LEÓN,19,MINA,037,CARRICITOS,2,13,4,9,2
NUEVO LEÓN,19,MINA,037,EL CHUPADERO,2,2,2,0,2
NUEVO LEÓN,19,MINA,037,ESPINAZO (ESPINAZO NUEVO LEÓN),1,37,13,24,3
NUEVO LEÓN,19,MINA,037,LOS ARCOS,1,3,1,2,1
NUEVO LEÓN,19,MINA,037,LOS REMOTOS,2,4,2,2,1
NUEVO LEÓN,19,MINA,037,MINA,9,1241,614,627,46
NUEVO LEÓN,19,MINA,037,PRESA DE LA MULA (LAS PRESAS),3,16,9,7,3
NUEVO LEÓN,19,MINA,037,SAN ANTONIO DE ARISTA (ARISTA),3,31,15,16,3
NUEVO LEÓN,19,MINA,037,SAN FRANCISCO Y ANEXOS,1,4,3,1,1
NUEVO LEÓN,19,MONTEMORELOS,038,CABEZONES,2,34,13,21,3
NUEVO LEÓN,19,MONTEMORELOS,038,CANOAS,2,91,43,48,9
NUEVO LEÓN,19,MONTEMORELOS,038,CHARCO DE LA ANACUA,1,6,4,2,1
NUEVO LEÓN,19,MONTEMORELOS,038,CHARCO LA ANACUA,1,1,1,0,1
NUEVO LEÓN,19,MONTEMORELOS,038,CHIHUAHUA,3,37,12,25,4
NUEVO LEÓN,19,MONTEMORELOS,038,CIENEGUILLAS,2,39,15,24,3
NUEVO LEÓN,19,MONTEMORELOS,038,CONGREGACIÓN CALLES,6,452,218,234,27
NUEVO LEÓN,19,MONTEMORELOS,038,COYONOXTLE,1,34,18,16,2
NUEVO LEÓN,19,MONTEMORELOS,038,EL ALTO,2,9,5,4,3
NUEVO LEÓN,19,MONTEMORELOS,038,EL BAJÍO,2,68,31,37,5
NUEVO LEÓN,19,MONTEMORELOS,038,EL CORONEL,1,5,1,4,1
NUEVO LEÓN,19,MONTEMORELOS,038,EL FRAILE,4,144,64,80,10
NUEVO LEÓN,19,MONTEMORELOS,038,EL FRAILE (EL FARO),1,7,4,3,1
NUEVO LEÓN,19,MONTEMORELOS,038,EL GALEME,2,49,27,22,4
NUEVO LEÓN,19,MONTEMORELOS,038,EL PASTOR,2,45,17,28,4
NUEVO LEÓN,19,MONTEMORELOS,038,EL PILÓN VIEJO (EL PILÓN),1,25,11,14,1
NUEVO LEÓN,19,MONTEMORELOS,038,EL RANCHITO,2,14,8,6,3
NUEVO LEÓN,19,MONTEMORELOS,038,EL SAUZ,2,41,21,20,3
NUEVO LEÓN,19,MONTEMORELOS,038,EL TERRERO,3,40,26,14,3
NUEVO LEÓN,19,MONTEMORELOS,038,EL TORO,2,34,10,24,3
NUEVO LEÓN,19,MONTEMORELOS,038,FUERA VACAS,1,11,5,6,1
NUEVO LEÓN,19,MONTEMORELOS,038,GENERAL ESCOBEDO,2,21,13,8,2
NUEVO LEÓN,19,MONTEMORELOS,038,GIL DE LEYVA (CAMINO A LAS PUENTES),1,120,53,67,8
NUEVO LEÓN,19,MONTEMORELOS,038,HACIENDA DE CAÑAS,1,13,7,6,1
NUEVO LEÓN,19,MONTEMORELOS,038,HACIENDA DE ENMEDIO,1,1,1,0,1
NUEVO LEÓN,19,MONTEMORELOS,038,HUERTAS [ESTACIÓN],2,36,15,21,3
NUEVO LEÓN,19,MONTEMORELOS,038,LA BARRANCA,2,63,33,30,4
NUEVO LEÓN,19,MONTEMORELOS,038,LA CARROZA,1,9,7,2,9
NUEVO LEÓN,19,MONTEMORELOS,038,LA CÁSCARA,4,183,83,100,15
NUEVO LEÓN,19,MONTEMORELOS,038,LA GARITA,1,7,5,2,1
NUEVO LEÓN,19,MONTEMORELOS,038,LA LAGUNA,2,43,19,24,3
NUEVO LEÓN,19,MONTEMORELOS,038,LA MORA,1,13,7,6,1
NUEVO LEÓN,19,MONTEMORELOS,038,LA PALMA,3,45,22,23,4
NUEVO LEÓN,19,MONTEMORELOS,038,LA TRINIDAD,2,20,4,16,3
NUEVO LEÓN,19,MONTEMORELOS,038,LA UNIÓN,1,12,6,6,1
NUEVO LEÓN,19,MONTEMORELOS,038,LA VENTURA,2,21,8,13,2
NUEVO LEÓN,19,MONTEMORELOS,038,LAMPACITOS,1,3,3,0,1
NUEVO LEÓN,19,MONTEMORELOS,038,LAS ADJUNTAS,1,312,168,144,10
NUEVO LEÓN,19,MONTEMORELOS,038,LAS BUGAMBILIAS,1,289,122,167,10
NUEVO LEÓN,19,MONTEMORELOS,038,LAS CALERAS,2,21,6,15,2
NUEVO LEÓN,19,MONTEMORELOS,038,LAS MARIANAS,2,26,13,13,2
NUEVO LEÓN,19,MONTEMORELOS,038,LAS OVEJAS,1,13,8,5,1
NUEVO LEÓN,19,MONTEMORELOS,038,LAS PALOMAS (LA CURVA),2,36,12,24,3
NUEVO LEÓN,19,MONTEMORELOS,038,LAS PUENTES,2,60,31,29,5
NUEVO LEÓN,19,MONTEMORELOS,038,LOMA PRIETA,1,30,15,15,2
NUEVO LEÓN,19,MONTEMORELOS,038,LOS ADOBES,1,34,13,21,3
NUEVO LEÓN,19,MONTEMORELOS,038,LOS ARROYOS (SECCIÓN JUÁREZ),1,13,3,10,1
NUEVO LEÓN,19,MONTEMORELOS,038,LOS LIRIOS (HACIENDA LOS LIRIOS),2,22,14,8,2
NUEVO LEÓN,19,MONTEMORELOS,038,LOS SABINOS,1,127,57,70,6
NUEVO LEÓN,19,MONTEMORELOS,038,MONTEMORELOS,114,16281,8148,8133,1181
NUEVO LEÓN,19,MONTEMORELOS,038,OJO DE AGUA,2,19,8,11,2
NUEVO LEÓN,19,MONTEMORELOS,038,PALO SECO,1,13,6,7,1
NUEVO LEÓN,19,MONTEMORELOS,038,PUERTA DE LA BOCA (LA BOCA),1,2,1,1,1
NUEVO LEÓN,19,MONTEMORELOS,038,PUERTO DE LAS FLORES,1,8,5,3,1
NUEVO LEÓN,19,MONTEMORELOS,038,PUERTO LA CANTERA,1,9,5,4,1
NUEVO LEÓN,19,MONTEMORELOS,038,RAÍCES,3,62,32,30,6
NUEVO LEÓN,19,MONTEMORELOS,038,RANCHO ESCONDIDO,1,24,11,13,1
NUEVO LEÓN,19,MONTEMORELOS,038,SAN AGUSTÍN DE LOS ARROYOS (PUEBLO NUEVO),1,4,2,2,1
NUEVO LEÓN,19,MONTEMORELOS,038,SAN MIGUEL,2,39,18,21,3
NUEVO LEÓN,19,MONTEMORELOS,038,TIERRAS COLORADAS,2,31,19,12,3
NUEVO LEÓN,19,MONTEMORELOS,038,VALLE HIDALGO (EL CUERAL),1,6,2,4,1
NUEVO LEÓN,19,MONTEMORELOS,038,VALLE HIDALGO (LA COTORRA),2,109,59,50,8
NUEVO LEÓN,19,MONTEMORELOS,038,YERBANIZ,1,13,6,7,1
NUEVO LEÓN,19,MONTERREY,039,LOS NOGALES,4,446,214,232,20
NUEVO LEÓN,19,MONTERREY,039,MONTERREY,1515,458569,239670,218899,26849
NUEVO LEÓN,19,PARÁS,040,CINCO DE MAYO,1,3,2,1,1
NUEVO LEÓN,19,PARÁS,040,EMILIANO ZAPATA,1,11,1,10,1
NUEVO LEÓN,19,PARÁS,040,PARÁS,4,168,88,80,16
NUEVO LEÓN,19,PESQUERÍA,041,COLINAS DEL AEROPUERTO,15,8235,4063,4172,256
NUEVO LEÓN,19,PESQUERÍA,041,DULCES NOMBRES,4,556,286,270,21
NUEVO LEÓN,19,PESQUERÍA,041,FRANCISCO VILLA,2,76,39,37,5
NUEVO LEÓN,19,PESQUERÍA,041,LA ARENA,2,77,31,46,5
NUEVO LEÓN,19,PESQUERÍA,041,LA PROVIDENCIA,2,68,27,41,6
NUEVO LEÓN,19,PESQUERÍA,041,LADRILLERA (ENTRONQUE PESQUERÍA),4,1394,691,703,86
NUEVO LEÓN,19,PESQUERÍA,041,LAS HACIENDAS,2,775,379,396,37
NUEVO LEÓN,19,PESQUERÍA,041,LAS PALMAS,2,27,13,14,2
NUEVO LEÓN,19,PESQUERÍA,041,PESQUERÍA,54,17248,8465,8783,630
NUEVO LEÓN,19,PESQUERÍA,041,REAL DE LORETO,4,566,309,257,17
NUEVO LEÓN,19,PESQUERÍA,041,SANTA MARÍA LA FLOREÑA,1,8,6,2,1
NUEVO LEÓN,19,PESQUERÍA,041,SANTA MARÍA PESQUERÍA,2,63,23,40,5
NUEVO LEÓN,19,PESQUERÍA,041,VALLE DE SANTA MARÍA,20,9187,4542,4645,327
NUEVO LEÓN,19,PESQUERÍA,041,ZACATECAS,2,352,167,185,13
NUEVO LEÓN,19,LOS RAMONES,042,EL CARRIZO,4,49,22,27,5
NUEVO LEÓN,19,LOS RAMONES,042,EL PORVENIR (PORVENIR RAMONES),1,16,7,9,2
NUEVO LEÓN,19,LOS RAMONES,042,GARZA GONZÁLEZ,2,37,16,21,2
NUEVO LEÓN,19,LOS RAMONES,042,LA CONQUISTA,2,62,27,35,6
NUEVO LEÓN,19,LOS RAMONES,042,LAS ENRAMADAS,1,4,1,3,1
NUEVO LEÓN,19,LOS RAMONES,042,LOMA,2,23,9,14,3
NUEVO LEÓN,19,LOS RAMONES,042,LOS RAMONES,7,668,335,333,35
NUEVO LEÓN,19,LOS RAMONES,042,REPUEBLO DE ORIENTE (EL RANCHITO),3,77,44,33,7
NUEVO LEÓN,19,LOS RAMONES,042,SAN BARTOLO,2,15,7,8,2
NUEVO LEÓN,19,LOS RAMONES,042,SAN BENITO,2,9,4,5,2
NUEVO LEÓN,19,LOS RAMONES,042,SAN ISIDRO,2,61,30,31,5
NUEVO LEÓN,19,RAYONES,043,EL GOCHE,2,35,17,18,3
NUEVO LEÓN,19,RAYONES,043,EL TULAR,2,16,3,13,2
NUEVO LEÓN,19,RAYONES,043,EMILIO CARRANZA,2,26,16,10,3
NUEVO LEÓN,19,RAYONES,043,JOSÉ MARÍA MORELOS (SANTA ROSA),2,25,10,15,2
NUEVO LEÓN,19,RAYONES,043,LA CEBOLLA,2,9,6,3,2
NUEVO LEÓN,19,RAYONES,043,LAS CAÑADAS,2,8,2,6,2
NUEVO LEÓN,19,RAYONES,043,LAS TRANCAS,2,4,1,3,1
NUEVO LEÓN,19,RAYONES,043,LOS ENCINOS,2,10,4,6,2
NUEVO LEÓN,19,RAYONES,043,LOS NOGALES,1,4,3,1,1
NUEVO LEÓN,19,RAYONES,043,PABLO L. SIDAR (CASILLAS),3,70,34,36,6
NUEVO LEÓN,19,RAYONES,043,PEDRO CARRIZALES,4,23,11,12,4
NUEVO LEÓN,19,RAYONES,043,RAYONES,4,235,117,118,16
NUEVO LEÓN,19,SABINAS HIDALGO,044,BUENA VISTA,1,4,1,3,1
NUEVO LEÓN,19,SABINAS HIDALGO,044,CARBONERAS,1,15,8,7,1
NUEVO LEÓN,19,SABINAS HIDALGO,044,CIUDAD SABINAS HIDALGO,66,8496,4446,4050,715
NUEVO LEÓN,19,SABINAS HIDALGO,044,CONSTITUCIÓN,2,26,11,15,2
NUEVO LEÓN,19,SABINAS HIDALGO,044,EL ÉBANO,1,7,6,1,1
NUEVO LEÓN,19,SABINAS HIDALGO,044,GARZA AYALA,3,89,38,51,10
NUEVO LEÓN,19,SABINAS HIDALGO,044,SERRATO CHAPA [KILÓMETRO TRES],1,89,45,44,3
NUEVO LEÓN,19,SABINAS HIDALGO,044,SOMBRERETILLO,1,4,4,0,1
NUEVO LEÓN,19,SALINAS VICTORIA,045,BOSQUES DE LOS NOGALES,3,448,207,241,16
NUEVO LEÓN,19,SALINAS VICTORIA,045,CIUDAD SATÉLITE DEL NORTE,6,2222,1099,1123,77
NUEVO LEÓN,19,SALINAS VICTORIA,045,EL LEAL (PREDIO ALFONSO MARTÍNEZ DOMÍNGUEZ),3,51,27,24,4
NUEVO LEÓN,19,SALINAS VICTORIA,045,EMILIANO ZAPATA,1,257,121,136,12
NUEVO LEÓN,19,SALINAS VICTORIA,045,EMILIANO ZAPATA (LA ZAPATITA),1,165,81,84,6
NUEVO LEÓN,19,SALINAS VICTORIA,045,LOS MORALES,1,67,37,30,3
NUEVO LEÓN,19,SALINAS VICTORIA,045,LOS PILARES,6,3084,1503,1581,102
NUEVO LEÓN,19,SALINAS VICTORIA,045,MISSION,6,1172,579,593,45
NUEVO LEÓN,19,SALINAS VICTORIA,045,NUEVO MAMULIQUE,1,23,13,10,1
NUEVO LEÓN,19,SALINAS VICTORIA,045,OJASÉ,2,67,32,35,6
NUEVO LEÓN,19,SALINAS VICTORIA,045,SALINAS VICTORIA,44,13522,6740,6782,505
NUEVO LEÓN,19,SALINAS VICTORIA,045,SIMEPRODESO (COLECTIVO NUEVO),6,1877,908,969,74
NUEVO LEÓN,19,SALINAS VICTORIA,045,UNIÓN SAN JAVIER,3,108,53,55,9
NUEVO LEÓN,19,SALINAS VICTORIA,045,VALLE DEL NORTE,8,2602,1322,1280,86
NUEVO LEÓN,19,SAN NICOLÁS DE LOS GARZA,046,SAN NICOLÁS DE LOS GARZA,490,197321,92671,104650,11592
NUEVO LEÓN,19,HIDALGO,047,HIDALGO,22,3973,2088,1885,252
NUEVO LEÓN,19,SANTA CATARINA,048,CIUDAD SANTA CATARINA,271,66787,32625,34162,3632
NUEVO LEÓN,19,SANTA CATARINA,048,LOS NOGALES,1,29,20,9,2
NUEVO LEÓN,19,SANTA CATARINA,048,PRIVADAS DEL PARQUE,3,368,180,188,17
NUEVO LEÓN,19,SANTA CATARINA,048,SAN ANTONIO DE LA OSAMENTA,1,6,1,5,1
NUEVO LEÓN,19,SANTIAGO,049,EL BARRIAL,2,177,89,88,7
NUEVO LEÓN,19,SANTIAGO,049,EL HONDABLE,2,4,2,2,2
NUEVO LEÓN,19,SANTIAGO,049,EL TEJOCOTE,2,30,13,17,3
NUEVO LEÓN,19,SANTIAGO,049,LA BOCA,2,62,29,33,5
NUEVO LEÓN,19,SANTIAGO,049,LA CIÉNEGA DE GONZÁLEZ,3,69,39,30,6
NUEVO LEÓN,19,SANTIAGO,049,LA CIENEGUILLA,4,398,204,194,19
NUEVO LEÓN,19,SANTIAGO,049,LA MESA GRANDE (VISTA HERMOSA),2,4,0,4,1
NUEVO LEÓN,19,SANTIAGO,049,LA TINAJA,4,274,137,137,16
NUEVO LEÓN,19,SANTIAGO,049,LABORCITAS,2,4,3,1,1
NUEVO LEÓN,19,SANTIAGO,049,LAGUNA DE SÁNCHEZ,3,115,55,60,11
NUEVO LEÓN,19,SANTIAGO,049,LAS ADJUNTAS,2,12,2,10,2
NUEVO LEÓN,19,SANTIAGO,049,LOS CANELOS,2,19,10,9,2
NUEVO LEÓN,19,SANTIAGO,049,OJOS DE AGUA,2,12,4,8,2
NUEVO LEÓN,19,SANTIAGO,049,POTRERO DE SERNA (LA NOGALERA),2,68,33,35,5
NUEVO LEÓN,19,SANTIAGO,049,POTRERO REDONDO,1,8,5,3,1
NUEVO LEÓN,19,SANTIAGO,049,SAN FRANCISCO,2,137,67,70,7
NUEVO LEÓN,19,SANTIAGO,049,SAN ISIDRO,2,13,6,7,2
NUEVO LEÓN,19,SANTIAGO,049,SAN JOSÉ,5,324,156,168,17
NUEVO LEÓN,19,SANTIAGO,049,SAN JOSÉ DE LAS BOQUILLAS,2,40,16,24,4
NUEVO LEÓN,19,SANTIAGO,049,SAN JUAN BAUTISTA,1,12,8,4,1
NUEVO LEÓN,19,SANTIAGO,049,SAN PEDRO,6,1251,631,620,69
NUEVO LEÓN,19,SANTIAGO,049,SAN SEBASTIÁN,2,11,5,6,1
NUEVO LEÓN,19,SANTIAGO,049,SANTIAGO,73,7419,3691,3728,562
NUEVO LEÓN,19,VALLECILLO,050,AQUILES SERDÁN (EL MATEÑO),1,4,1,3,1
NUEVO LEÓN,19,VALLECILLO,050,EL ÁLAMO (HACIENDA EL ÁLAMO),2,17,10,7,2
NUEVO LEÓN,19,VALLECILLO,050,LOS COLORADOS DE ABAJO,4,145,72,73,11
NUEVO LEÓN,19,VALLECILLO,050,LOS COLORADOS DE ARRIBA,1,1,0,1,1
NUEVO LEÓN,19,VALLECILLO,050,PALO ALTO (PALO ALTO Y AYALEÑO),3,26,14,12,3
NUEVO LEÓN,19,VALLECILLO,050,SAN CARLOS,1,5,2,3,1
NUEVO LEÓN,19,VALLECILLO,050,VALLECILLO,3,108,50,58,9
NUEVO LEÓN,19,VILLALDAMA,051,CIUDAD DE VILLALDAMA,7,481,222,259,38
NUEVO LEÓN,19,VILLALDAMA,051,EL ÁLAMO [ESTACIÓN],1,13,6,7,1
NUEVO LEÓN,19,VILLALDAMA,051,EL POTRERO,4,117,46,71,12
NUEVO LEÓN,19,VILLALDAMA,051,HACIENDA SANTA FE,1,28,15,13,2
NUEVO LEÓN,19,VILLALDAMA,051,SANTA ISABEL,1,13,6,7,1
OAXACA,20,ABEJONES,001,ABEJONES,5,237,121,116,20
OAXACA,20,ACATLÁN DE PÉREZ FIGUEROA,002,ACATLÁN DE PÉREZ FIGUEROA,13,2215,1196,1019,151
OAXACA,20,ACATLÁN DE PÉREZ FIGUEROA,002,ARROYO DE ENMEDIO,3,285,133,152,15
OAXACA,20,ACATLÁN DE PÉREZ FIGUEROA,002,ARROYO DE PITA,4,235,112,123,17
OAXACA,20,ACATLÁN DE PÉREZ FIGUEROA,002,ASERRADERO,3,43,23,20,10
OAXACA,20,ACATLÁN DE PÉREZ FIGUEROA,002,ASERRADERO SEGUNDO,1,16,7,9,6
OAXACA,20,ACATLÁN DE PÉREZ FIGUEROA,002,BARBASCO,4,202,103,99,16
OAXACA,20,ACATLÁN DE PÉREZ FIGUEROA,002,BUENAVISTA,1,5,1,4,1
OAXACA,20,ACATLÁN DE PÉREZ FIGUEROA,002,BUENOS AIRES,3,71,37,34,8
OAXACA,20,ACATLÁN DE PÉREZ FIGUEROA,002,CAÑADA SAN ANTONIO,3,179,98,81,12
OAXACA,20,ACATLÁN DE PÉREZ FIGUEROA,002,CAÑAMAZAL,3,120,62,58,12
OAXACA,20,ACATLÁN DE PÉREZ FIGUEROA,002,CERRO MOJARRA,5,622,359,263,38
OAXACA,20,ACATLÁN DE PÉREZ FIGUEROA,002,COLONIA JOSEFA ORTIZ DE DOMÍNGUEZ,3,37,16,21,8
OAXACA,20,ACATLÁN DE PÉREZ FIGUEROA,002,COSOLAPA SARMIENTO,3,135,68,67,7
OAXACA,20,ACATLÁN DE PÉREZ FIGUEROA,002,EL CEDRAL,3,113,56,57,7
OAXACA,20,ACATLÁN DE PÉREZ FIGUEROA,002,EL CONEJO,3,76,42,34,11
OAXACA,20,ACATLÁN DE PÉREZ FIGUEROA,002,EL PORVENIR,3,117,63,54,12
OAXACA,20,ACATLÁN DE PÉREZ FIGUEROA,002,EL SETENTA Y DOS,1,6,3,3,1
OAXACA,20,ACATLÁN DE PÉREZ FIGUEROA,002,EL ZAPOTE,2,28,14,14,2
OAXACA,20,ACATLÁN DE PÉREZ FIGUEROA,002,EMILIANO ZAPATA (COLONIA 21 DE MAYO),2,22,9,13,7
OAXACA,20,ACATLÁN DE PÉREZ FIGUEROA,002,ESPERANZA,2,27,12,15,8
OAXACA,20,ACATLÁN DE PÉREZ FIGUEROA,002,GUADALUPE DE LOS REYES,3,88,51,37,12
OAXACA,20,ACATLÁN DE PÉREZ FIGUEROA,002,JOLIETTE,3,169,84,85,12
OAXACA,20,ACATLÁN DE PÉREZ FIGUEROA,002,JOSEFA ORTIZ DE DOMÍNGUEZ (LA JOSEFITA),3,19,10,9,2
OAXACA,20,ACATLÁN DE PÉREZ FIGUEROA,002,LA CARBONERA,3,148,79,69,12
OAXACA,20,ACATLÁN DE PÉREZ FIGUEROA,002,LA CORAZA,2,48,31,17,4
OAXACA,20,ACATLÁN DE PÉREZ FIGUEROA,002,LA ESTRELLA,3,140,81,59,10
OAXACA,20,ACATLÁN DE PÉREZ FIGUEROA,002,LA GUADALUPE,3,57,27,30,9
OAXACA,20,ACATLÁN DE PÉREZ FIGUEROA,002,LA ISLETA,2,7,3,4,1
OAXACA,20,ACATLÁN DE PÉREZ FIGUEROA,002,LA JUNTA,3,206,115,91,14
OAXACA,20,ACATLÁN DE PÉREZ FIGUEROA,002,LA PALMA,3,107,53,54,12
OAXACA,20,ACATLÁN DE PÉREZ FIGUEROA,002,LA RAYA,3,91,43,48,11
OAXACA,20,ACATLÁN DE PÉREZ FIGUEROA,002,LA REFORMA,1,11,4,7,1
OAXACA,20,ACATLÁN DE PÉREZ FIGUEROA,002,LA TABAQUERA,5,418,194,224,22
OAXACA,20,ACATLÁN DE PÉREZ FIGUEROA,002,LAGUNA VERDE,2,10,3,7,2
OAXACA,20,ACATLÁN DE PÉREZ FIGUEROA,002,LAS MARAVILLAS,3,39,18,21,10
OAXACA,20,ACATLÁN DE PÉREZ FIGUEROA,002,LOS CORRALES,3,147,86,61,12
OAXACA,20,ACATLÁN DE PÉREZ FIGUEROA,002,LOS LIRIOS,3,45,21,24,4
OAXACA,20,ACATLÁN DE PÉREZ FIGUEROA,002,LOS REYES,1,5,1,4,1
OAXACA,20,ACATLÁN DE PÉREZ FIGUEROA,002,MIGUEL HIDALGO,3,69,41,28,12
OAXACA,20,ACATLÁN DE PÉREZ FIGUEROA,002,MONTE ALTO,1,22,5,17,2
OAXACA,20,ACATLÁN DE PÉREZ FIGUEROA,002,OJO DE AGUA O PALMA CUATA,3,83,41,42,12
OAXACA,20,ACATLÁN DE PÉREZ FIGUEROA,002,PEÑA BLANCA,3,63,30,33,11
OAXACA,20,ACATLÁN DE PÉREZ FIGUEROA,002,PLAN DE AYALA,2,18,6,12,7
OAXACA,20,ACATLÁN DE PÉREZ FIGUEROA,002,PRIMERA AMPLIACIÓN LA PALMA (EL VIEJO),2,5,2,3,1
OAXACA,20,ACATLÁN DE PÉREZ FIGUEROA,002,RANCHO GRANDE,3,194,96,98,11
OAXACA,20,ACATLÁN DE PÉREZ FIGUEROA,002,SAN EVARISTO,2,10,7,3,1
OAXACA,20,ACATLÁN DE PÉREZ FIGUEROA,002,SANTA CRUZ,3,66,30,36,6
OAXACA,20,ACATLÁN DE PÉREZ FIGUEROA,002,TEMBLADERA DE LA SELVA 1,3,148,81,67,11
OAXACA,20,ACATLÁN DE PÉREZ FIGUEROA,002,TEMBLADERA DE LA SELVA 2,2,55,26,29,6
OAXACA,20,ACATLÁN DE PÉREZ FIGUEROA,002,TEMBLADERA DEL CASTILLO,4,288,145,143,18
OAXACA,20,ACATLÁN DE PÉREZ FIGUEROA,002,TEMBLADERA VISTA HERMOSA,2,59,24,35,3
OAXACA,20,ACATLÁN DE PÉREZ FIGUEROA,002,TETELA,7,732,391,341,47
OAXACA,20,ACATLÁN DE PÉREZ FIGUEROA,002,TORREÓN,2,60,31,29,6
OAXACA,20,ACATLÁN DE PÉREZ FIGUEROA,002,VICENTE CAMALOTE,12,1817,910,907,95
OAXACA,20,ACATLÁN DE PÉREZ FIGUEROA,002,ZONA URBANA EJIDAL,5,387,233,154,43
OAXACA,20,ASUNCIÓN CACALOTEPEC,003,ASUNCIÓN CACALOTEPEC,5,262,124,138,14
OAXACA,20,ASUNCIÓN CACALOTEPEC,003,CERRO MONEDA,3,401,230,171,25
OAXACA,20,ASUNCIÓN CACALOTEPEC,003,ORILLA DEL LLANO,1,19,9,10,1
OAXACA,20,ASUNCIÓN CACALOTEPEC,003,SAN ANTONIO TLAXCALTEPEC,3,77,35,42,7
OAXACA,20,ASUNCIÓN CACALOTEPEC,003,SAN JORGE CASA GRANDE,2,21,13,8,2
OAXACA,20,ASUNCIÓN CACALOTEPEC,003,SANTA CRUZ AGUATLÁN,1,24,14,10,1
OAXACA,20,ASUNCIÓN CACALOTEPEC,003,ZOMPANTLE,2,29,15,14,2
OAXACA,20,ASUNCIÓN CUYOTEPEJI,004,ASUNCIÓN CUYOTEPEJI,4,245,127,118,16
OAXACA,20,ASUNCIÓN IXTALTEPEC,005,AGUAS CALIENTES LA MATA,4,146,71,75,12
OAXACA,20,ASUNCIÓN IXTALTEPEC,005,ASUNCIÓN IXTALTEPEC,21,1664,874,790,147
OAXACA,20,ASUNCIÓN IXTALTEPEC,005,CHIVELA,4,230,90,140,25
OAXACA,20,ASUNCIÓN IXTALTEPEC,005,CHIVIXHUYO,3,171,78,93,12
OAXACA,20,ASUNCIÓN IXTALTEPEC,005,CIENEGUILLA,3,74,37,37,9
OAXACA,20,ASUNCIÓN IXTALTEPEC,005,EL MEZQUITE,2,45,22,23,6
OAXACA,20,ASUNCIÓN IXTALTEPEC,005,EL MORRITO,2,56,28,28,4
OAXACA,20,ASUNCIÓN IXTALTEPEC,005,LÁZARO CÁRDENAS,5,356,185,171,29
OAXACA,20,ASUNCIÓN IXTALTEPEC,005,MAZAHUA,2,43,19,24,3
OAXACA,20,ASUNCIÓN IXTALTEPEC,005,MENA,1,16,10,6,1
OAXACA,20,ASUNCIÓN IXTALTEPEC,005,SANTA ROSA,1,21,11,10,3
OAXACA,20,ASUNCIÓN IXTALTEPEC,005,SANTIAGO IXTALTEPEC,4,342,180,162,21
OAXACA,20,ASUNCIÓN IXTALTEPEC,005,SITIO DE LAS FLORES,1,9,2,7,1
OAXACA,20,ASUNCIÓN NOCHIXTLÁN,006,20 DE NOVIEMBRE [COLONIA],3,57,33,24,5
OAXACA,20,ASUNCIÓN NOCHIXTLÁN,006,ASUNCIÓN NOCHIXTLÁN,31,6010,3253,2757,329
OAXACA,20,ASUNCIÓN NOCHIXTLÁN,006,EL CORTIJO,1,5,1,4,4
OAXACA,20,ASUNCIÓN NOCHIXTLÁN,006,LA CUMBRE,4,89,44,45,7
OAXACA,20,ASUNCIÓN NOCHIXTLÁN,006,LA UNIÓN LIBERTAD IXTALTEPEC,1,15,10,5,1
OAXACA,20,ASUNCIÓN NOCHIXTLÁN,006,LAS TRES CRUCES,2,59,28,31,4
OAXACA,20,ASUNCIÓN NOCHIXTLÁN,006,NUEVO MORELOS,1,10,5,5,3
OAXACA,20,ASUNCIÓN NOCHIXTLÁN,006,REFORMA ASUNCIÓN NOCHIXTLÁN,3,10,5,5,3
OAXACA,20,ASUNCIÓN NOCHIXTLÁN,006,SAN MIGUEL ADÉQUEZ (ADEQUÉS),1,12,5,7,1
OAXACA,20,ASUNCIÓN NOCHIXTLÁN,006,SAN PEDRO QUILITONGO,1,7,1,6,6
OAXACA,20,ASUNCIÓN NOCHIXTLÁN,006,SANTA CATARINA ADÉQUEZ (ADEQUÉS),3,96,52,44,13
OAXACA,20,ASUNCIÓN NOCHIXTLÁN,006,SANTA CRUZ RÍO SALINAS,1,9,3,6,5
OAXACA,20,ASUNCIÓN NOCHIXTLÁN,006,SANTA MARÍA TINÚ,4,86,38,48,9
OAXACA,20,ASUNCIÓN NOCHIXTLÁN,006,SANTIAGO AMATLÁN,3,81,45,36,9
OAXACA,20,ASUNCIÓN NOCHIXTLÁN,006,SANTIAGO BUENA VISTA (TICÚA),2,36,23,13,3
OAXACA,20,ASUNCIÓN NOCHIXTLÁN,006,SANTIAGO CAMOTLÁN,3,12,6,6,2
OAXACA,20,ASUNCIÓN NOCHIXTLÁN,006,SANTIAGO IXTALTEPEC,2,23,16,7,2
OAXACA,20,ASUNCIÓN NOCHIXTLÁN,006,SANTIAGO MITLATONGO,4,102,53,49,10
OAXACA,20,ASUNCIÓN NOCHIXTLÁN,006,YODONGUIO,4,95,41,54,7
OAXACA,20,ASUNCIÓN OCOTLÁN,007,ASUNCIÓN OCOTLÁN,4,381,207,174,29
OAXACA,20,ASUNCIÓN TLACOLULITA,008,ASUNCIÓN TLACOLULITA,4,88,42,46,12
OAXACA,20,ASUNCIÓN TLACOLULITA,008,SAN JUAN ALOTEPEC,3,59,31,28,11
OAXACA,20,AYOTZINTEPEC,009,AYOTZINTEPEC,7,1234,627,607,75
OAXACA,20,AYOTZINTEPEC,009,MONTE MARIO,2,28,14,14,3
OAXACA,20,AYOTZINTEPEC,009,MONTE TINTA,3,194,91,103,12
OAXACA,20,AYOTZINTEPEC,009,PLAN JUAN MARTÍNEZ,3,93,46,47,7
OAXACA,20,AYOTZINTEPEC,009,SAN JOSÉ MANO MARQUÉS,2,41,20,21,3
OAXACA,20,AYOTZINTEPEC,009,SAN PEDRO OZUMACÍN,3,392,185,207,23
OAXACA,20,EL BARRIO DE LA SOLEDAD,010,ALMOLOYA BAJO (ESTACIÓN ALMOLOYA),6,319,164,155,25
OAXACA,20,EL BARRIO DE LA SOLEDAD,010,CHIVANIZA,2,23,12,11,4
OAXACA,20,EL BARRIO DE LA SOLEDAD,010,COLONIA HIDALGO,1,11,5,6,3
OAXACA,20,EL BARRIO DE LA SOLEDAD,010,CUAJINICUIL,2,49,26,23,3
OAXACA,20,EL BARRIO DE LA SOLEDAD,010,EL BARRIO DE LA SOLEDAD,6,1192,623,569,96
OAXACA,20,EL BARRIO DE LA SOLEDAD,010,EL SARDINERO,1,11,7,4,1
OAXACA,20,EL BARRIO DE LA SOLEDAD,010,GUIGUBA',2,57,28,29,6
OAXACA,20,EL BARRIO DE LA SOLEDAD,010,LA CIRUELA,2,23,14,9,4
OAXACA,20,EL BARRIO DE LA SOLEDAD,010,LA JUNTA,1,13,7,6,2
OAXACA,20,EL BARRIO DE LA SOLEDAD,010,LACHIGOLÓ,3,87,42,45,9
OAXACA,20,EL BARRIO DE LA SOLEDAD,010,LAGUNAS,7,883,432,451,82
OAXACA,20,EL BARRIO DE LA SOLEDAD,010,LAS CRUCES,1,10,4,6,1
OAXACA,20,EL BARRIO DE LA SOLEDAD,010,LOMA LARGA (SANTA ROSA),1,10,6,4,2
OAXACA,20,EL BARRIO DE LA SOLEDAD,010,LOS NANCHES,1,16,6,10,1
OAXACA,20,EL BARRIO DE LA SOLEDAD,010,OCOTAL GRANDE,1,9,3,6,5
OAXACA,20,EL BARRIO DE LA SOLEDAD,010,RINCÓN VAQUERO,2,34,14,20,6
OAXACA,20,EL BARRIO DE LA SOLEDAD,010,RÍO GRANDE,3,43,21,22,8
OAXACA,20,EL BARRIO DE LA SOLEDAD,010,SAN ISIDRO,2,25,11,14,8
OAXACA,20,EL BARRIO DE LA SOLEDAD,010,SAN NICOLÁS BICHINGA,1,17,11,6,1
OAXACA,20,CALIHUALÁ,011,CALIHUALÁ,3,195,105,90,15
OAXACA,20,CALIHUALÁ,011,SAN ANTONIO O LAS MESAS,3,154,84,70,12
OAXACA,20,CALIHUALÁ,011,SAN JOSÉ SABINILLO,1,14,6,8,6
OAXACA,20,CANDELARIA LOXICHA,012,ARROYO PIEDRA AZULILLO,3,41,22,19,3
OAXACA,20,CANDELARIA LOXICHA,012,AZULILLO,2,52,22,30,3
OAXACA,20,CANDELARIA LOXICHA,012,CANDELARIA LOXICHA,8,1282,644,638,82
OAXACA,20,CANDELARIA LOXICHA,012,CERRO CRUZ,3,68,34,34,4
OAXACA,20,CANDELARIA LOXICHA,012,CERRO PERICO,1,20,10,10,1
OAXACA,20,CANDELARIA LOXICHA,012,COROZAL PACÍFICO,1,9,5,4,2
OAXACA,20,CANDELARIA LOXICHA,012,CUAJINICUIL,2,23,15,8,2
OAXACA,20,CANDELARIA LOXICHA,012,EL ALACRÁN,1,9,4,5,3
OAXACA,20,CANDELARIA LOXICHA,012,EL CAULOTE,2,72,33,39,4
OAXACA,20,CANDELARIA LOXICHA,012,EL CHILAR,3,94,46,48,5
OAXACA,20,CANDELARIA LOXICHA,012,EL MOLINO,5,68,37,31,5
OAXACA,20,CANDELARIA LOXICHA,012,EL TRAPICHE,2,22,7,15,2
OAXACA,20,CANDELARIA LOXICHA,012,EL ZACATAL,2,77,38,39,4
OAXACA,20,CANDELARIA LOXICHA,012,EL ZAPOTE,3,38,17,21,5
OAXACA,20,CANDELARIA LOXICHA,012,LA CIÉNEGA,3,62,28,34,8
OAXACA,20,CANDELARIA LOXICHA,012,LA GUADALUPE,1,14,8,6,1
OAXACA,20,CANDELARIA LOXICHA,012,LLANO FRÍO,2,14,7,7,2
OAXACA,20,CANDELARIA LOXICHA,012,LOS HORCONES,5,295,161,134,18
OAXACA,20,CANDELARIA LOXICHA,012,MIRAMAR,2,166,91,75,8
OAXACA,20,CANDELARIA LOXICHA,012,RÍO CANDELARIA,3,84,37,47,5
OAXACA,20,CANDELARIA LOXICHA,012,RÍO LOS PECES,2,33,18,15,2
OAXACA,20,CANDELARIA LOXICHA,012,SAN AGUSTÍN RÍO CULEBRA,1,24,11,13,2
OAXACA,20,CANDELARIA LOXICHA,012,SAN ISIDRO DEL CAMINO,3,37,17,20,6
OAXACA,20,CANDELARIA LOXICHA,012,SAN LUCAS,2,33,15,18,2
OAXACA,20,CANDELARIA LOXICHA,012,SAN MATEO,3,43,23,20,4
OAXACA,20,CANDELARIA LOXICHA,012,SAN SALVADOR,1,1,0,1,1
OAXACA,20,CANDELARIA LOXICHA,012,SANTA MARÍA TEPEJIPANA,4,208,100,108,13
OAXACA,20,CANDELARIA LOXICHA,012,SANTA RITA,3,95,46,49,4
OAXACA,20,CANDELARIA LOXICHA,012,SANTIAGO LA GALERA,3,58,34,24,6
OAXACA,20,CANDELARIA LOXICHA,012,SENDERO DE LUZ,1,31,16,15,2
OAXACA,20,CANDELARIA LOXICHA,012,TIERRA BLANCA (COROZAL),1,28,17,11,2
OAXACA,20,CANDELARIA LOXICHA,012,TIERRA COLORADA,1,8,4,4,1
OAXACA,20,CIÉNEGA DE ZIMATLÁN,013,CIÉNEGA DE ZIMATLÁN,5,814,438,376,40
OAXACA,20,CIUDAD IXTEPEC,014,CIUDAD IXTEPEC,59,8125,4510,3615,713
OAXACA,20,CIUDAD IXTEPEC,014,PICACHO CHEGUIGO,2,80,40,40,6
OAXACA,20,COATECAS ALTAS,015,AGUA DE GUAJE,1,9,3,6,5
OAXACA,20,COATECAS ALTAS,015,CHEPEGINIO,3,48,24,24,10
OAXACA,20,COATECAS ALTAS,015,COATECAS ALTAS,9,1142,653,489,65
OAXACA,20,COATECAS ALTAS,015,EL PORTILLO,2,20,8,12,7
OAXACA,20,COATECAS ALTAS,015,LAS SALINAS,3,44,22,22,12
OAXACA,20,COATECAS ALTAS,015,PEÑA LARGA,1,15,6,9,6
OAXACA,20,COATECAS ALTAS,015,POBLETE,3,103,56,47,12
OAXACA,20,COATECAS ALTAS,015,POCHOTLILLO,2,41,22,19,8
OAXACA,20,COATECAS ALTAS,015,TEPEHUAJE,4,106,57,49,13
OAXACA,20,COICOYÁN DE LAS FLORES,016,CERRO DE AIRE (YUCUTACHI),3,35,18,17,8
OAXACA,20,COICOYÁN DE LAS FLORES,016,CERRO HIDALGO,1,80,46,34,7
OAXACA,20,COICOYÁN DE LAS FLORES,016,COICOYÁN DE LAS FLORES,7,608,330,278,41
OAXACA,20,COICOYÁN DE LAS FLORES,016,COYUL,3,263,154,109,16
OAXACA,20,COICOYÁN DE LAS FLORES,016,EL JICARAL,7,360,208,152,35
OAXACA,20,COICOYÁN DE LAS FLORES,016,LA TRINIDAD,3,184,105,79,14
OAXACA,20,COICOYÁN DE LAS FLORES,016,LÁZARO CÁRDENAS,4,199,103,96,17
OAXACA,20,COICOYÁN DE LAS FLORES,016,LLANO ENCINO AMARILLO,3,133,74,59,12
OAXACA,20,COICOYÁN DE LAS FLORES,016,LOS ÁNGELES,2,66,36,30,9
OAXACA,20,COICOYÁN DE LAS FLORES,016,RANCHO PASTOR,3,159,78,81,11
OAXACA,20,COICOYÁN DE LAS FLORES,016,RÍO ALUMBRADO,2,81,45,36,9
OAXACA,20,COICOYÁN DE LAS FLORES,016,SANTIAGO TILAPA,3,372,217,155,23
OAXACA,20,COICOYÁN DE LAS FLORES,016,TIERRA COLORADA,7,333,185,148,33
OAXACA,20,COICOYÁN DE LAS FLORES,016,YUTIOTOSO,1,14,5,9,6
OAXACA,20,COICOYÁN DE LAS FLORES,016,ZARAGOZA,1,24,12,12,5
OAXACA,20,LA COMPAÑÍA,017,AGUA BLANCA,2,70,39,31,9
OAXACA,20,LA COMPAÑÍA,017,AGUA DEL ESPINO,3,281,155,126,21
OAXACA,20,LA COMPAÑÍA,017,EL VADO,3,45,22,23,12
OAXACA,20,LA COMPAÑÍA,017,LA CHOPA,1,1,0,1,1
OAXACA,20,LA COMPAÑÍA,017,LA COMPAÑÍA,3,158,73,85,11
OAXACA,20,LA COMPAÑÍA,017,LA LABOR,3,75,49,26,6
OAXACA,20,LA COMPAÑÍA,017,LA Y,2,23,9,14,9
OAXACA,20,LA COMPAÑÍA,017,LOS PITILLOS,1,11,4,7,6
OAXACA,20,LA COMPAÑÍA,017,RÍO DE EJUTLA,3,68,36,32,8
OAXACA,20,CONCEPCIÓN BUENAVISTA,018,CONCEPCIÓN BUENAVISTA,2,46,23,23,5
OAXACA,20,CONCEPCIÓN BUENAVISTA,018,EL ENEBRO,3,51,25,26,6
OAXACA,20,CONCEPCIÓN BUENAVISTA,018,RÍO DE LAS PALMAS,2,5,1,4,2
OAXACA,20,CONCEPCIÓN BUENAVISTA,018,SAN MIGUEL ASTATLA,3,55,26,29,8
OAXACA,20,CONCEPCIÓN BUENAVISTA,018,SANTA CRUZ CORUNDA,1,9,3,6,5
OAXACA,20,CONCEPCIÓN PÁPALO,019,ASERRADERO PÁPALO (TIERRA COLORADA),2,14,8,6,2
OAXACA,20,CONCEPCIÓN PÁPALO,019,COÁPAM DE GUERRERO,3,45,22,23,11
OAXACA,20,CONCEPCIÓN PÁPALO,019,CONCEPCIÓN PÁPALO,4,163,87,76,15
OAXACA,20,CONCEPCIÓN PÁPALO,019,PEÑA BLANCA,3,65,36,29,12
OAXACA,20,CONCEPCIÓN PÁPALO,019,SAN FRANCISCO DE ASÍS,1,5,3,2,1
OAXACA,20,CONCEPCIÓN PÁPALO,019,SAN FRANCISCO PUEBLO NUEVO,3,56,30,26,12
OAXACA,20,CONCEPCIÓN PÁPALO,019,SAN LORENZO PÁPALO,3,150,85,65,12
OAXACA,20,CONCEPCIÓN PÁPALO,019,TECOMALTIANGUISCO,3,40,19,21,3
OAXACA,20,CONSTANCIA DEL ROSARIO,020,CONSTANCIA DEL ROSARIO,6,771,405,366,47
OAXACA,20,CONSTANCIA DEL ROSARIO,020,RANCHO VIEJO,2,75,42,33,9
OAXACA,20,CONSTANCIA DEL ROSARIO,020,SAN JOSÉ YOSOCAÑÚ (YOSOCANÚ),4,270,157,113,18
OAXACA,20,CONSTANCIA DEL ROSARIO,020,SANTA ANA RAYÓN,1,57,26,31,6
OAXACA,20,CONSTANCIA DEL ROSARIO,020,SANTA CRUZ RÍO VENADO,3,363,199,164,22
OAXACA,20,CONSTANCIA DEL ROSARIO,020,SANTA MARÍA PUEBLO NUEVO,2,56,30,26,9
OAXACA,20,COSOLAPA,021,ALMOLONGA,3,261,140,121,18
OAXACA,20,COSOLAPA,021,BENITO JUÁREZ,1,15,7,8,5
OAXACA,20,COSOLAPA,021,CERRO ALTO,2,14,5,9,2
OAXACA,20,COSOLAPA,021,COLONIA AGRÍCOLA CACHALAPA,3,33,15,18,3
OAXACA,20,COSOLAPA,021,COLONIA AGRÍCOLA MIGUEL HIDALGO,1,5,1,4,1
OAXACA,20,COSOLAPA,021,COSOLAPA,14,1837,1020,817,121
OAXACA,20,COSOLAPA,021,EL REFUGIO VIEJO,2,54,28,26,8
OAXACA,20,COSOLAPA,021,ESTACIÓN REFUGIO,4,384,199,185,32
OAXACA,20,COSOLAPA,021,LA AURORA,2,16,7,9,2
OAXACA,20,COSOLAPA,021,MONTE OBSCURO,2,17,8,9,2
OAXACA,20,COSOLAPA,021,MORELOS,3,61,31,30,11
OAXACA,20,COSOLAPA,021,PALMA SOLA,3,166,85,81,10
OAXACA,20,COSOLAPA,021,RANCHO LOS LIMONES,1,5,1,4,1
OAXACA,20,COSOLAPA,021,RANCHO TABLAS DE REYES CARRIZAL (SAN MIGUEL),1,32,16,16,6
OAXACA,20,COSOLAPA,021,RANCHO TABLAS REYES,4,145,78,67,15
OAXACA,20,COSOLAPA,021,RINCÓN CERRO ALTO,1,5,0,5,1
OAXACA,20,COSOLTEPEC,022,COSOLTEPEC,3,89,49,40,12
OAXACA,20,COSOLTEPEC,022,JOLUXTLA,3,39,21,18,9
OAXACA,20,COSOLTEPEC,022,TULTITLÁN DE GUADALCÁZAR,1,26,13,13,6
OAXACA,20,CUILÁPAM DE GUERRERO,023,CARRIZAL,2,52,30,22,3
OAXACA,20,CUILÁPAM DE GUERRERO,023,CRUZ BLANCA,3,460,232,228,23
OAXACA,20,CUILÁPAM DE GUERRERO,023,CUILÁPAM DE GUERRERO,19,5432,2893,2539,207
OAXACA,20,CUILÁPAM DE GUERRERO,023,EL ROSARIO [BARRIO],1,72,42,30,4
OAXACA,20,CUILÁPAM DE GUERRERO,023,EL TEPEYAC (LOMAS DE SAN JUAN),2,285,160,125,14
OAXACA,20,CUILÁPAM DE GUERRERO,023,LOMAS DE SAN JUAN,2,109,47,62,5
OAXACA,20,CUILÁPAM DE GUERRERO,023,MANZANO,1,17,9,8,3
OAXACA,20,CUILÁPAM DE GUERRERO,023,OJO DE AGUA,2,46,23,23,5
OAXACA,20,CUILÁPAM DE GUERRERO,023,PRIMERA AMPLIACIÓN DE CRUZ BLANCA,1,54,30,24,3
OAXACA,20,CUILÁPAM DE GUERRERO,023,RANCHO QUEMADO,1,198,88,110,9
OAXACA,20,CUILÁPAM DE GUERRERO,023,TIRACOZ,3,313,168,145,17
OAXACA,20,CUYAMECALCO VILLA DE ZARAGOZA,024,AGUA TABACO,2,23,14,9,2
OAXACA,20,CUYAMECALCO VILLA DE ZARAGOZA,024,BUENOS AIRES,3,162,75,87,14
OAXACA,20,CUYAMECALCO VILLA DE ZARAGOZA,024,CUYAMECALCO VILLA DE ZARAGOZA,7,395,187,208,25
OAXACA,20,CUYAMECALCO VILLA DE ZARAGOZA,024,GUADALUPE LA CIÉNEGA,2,42,20,22,7
OAXACA,20,CUYAMECALCO VILLA DE ZARAGOZA,024,JOYA DURAZNO,2,29,12,17,2
OAXACA,20,CUYAMECALCO VILLA DE ZARAGOZA,024,LOMA DEL VIENTO,3,25,9,16,3
OAXACA,20,CUYAMECALCO VILLA DE ZARAGOZA,024,SAN FELIPE DE JESÚS,1,5,3,2,1
OAXACA,20,CUYAMECALCO VILLA DE ZARAGOZA,024,SANTA MARÍA BUENOS AIRES,3,32,14,18,4
OAXACA,20,CHAHUITES,025,CHAHUITES,17,2556,1339,1217,188
OAXACA,20,CHAHUITES,025,EL PORVENIR,1,34,16,18,2
OAXACA,20,CHAHUITES,025,LA CHICHARRA,2,305,149,156,18
OAXACA,20,CHAHUITES,025,LOS CONEJOS,2,86,35,51,6
OAXACA,20,CHALCATONGO DE HIDALGO,026,ABASOLO,3,80,42,38,11
OAXACA,20,CHALCATONGO DE HIDALGO,026,ALDAMA,3,103,50,53,8
OAXACA,20,CHALCATONGO DE HIDALGO,026,ALLENDE,3,35,21,14,3
OAXACA,20,CHALCATONGO DE HIDALGO,026,CAÑADA DE MORELOS,2,23,11,12,7
OAXACA,20,CHALCATONGO DE HIDALGO,026,CHALCATONGO DE HIDALGO,10,1700,1035,665,107
OAXACA,20,CHALCATONGO DE HIDALGO,026,CHAPULTEPEC,5,210,115,95,15
OAXACA,20,CHALCATONGO DE HIDALGO,026,"GUADALUPE VILLANUEVA, SANTA CATARINA YUXÍA",1,10,7,3,1
OAXACA,20,CHALCATONGO DE HIDALGO,026,GUERRERO,2,34,14,20,2
OAXACA,20,CHALCATONGO DE HIDALGO,026,HIDALGO,2,27,11,16,7
OAXACA,20,CHALCATONGO DE HIDALGO,026,INDEPENDENCIA,2,65,37,28,8
OAXACA,20,CHALCATONGO DE HIDALGO,026,ITURBIDE,1,19,8,11,6
OAXACA,20,CHALCATONGO DE HIDALGO,026,LA PAZ,3,36,16,20,4
OAXACA,20,CHALCATONGO DE HIDALGO,026,LA PROVIDENCIA,1,22,12,10,1
OAXACA,20,CHALCATONGO DE HIDALGO,026,LA UNIÓN,2,25,12,13,7
OAXACA,20,CHALCATONGO DE HIDALGO,026,PLAN DE AYALA,3,46,23,23,4
OAXACA,20,CHALCATONGO DE HIDALGO,026,PROGRESO,3,283,158,125,19
OAXACA,20,CHALCATONGO DE HIDALGO,026,REFORMA,3,65,32,33,11
OAXACA,20,CHALCATONGO DE HIDALGO,026,SANTA CATARINA YUXÍA,3,75,44,31,7
OAXACA,20,CHALCATONGO DE HIDALGO,026,ZARAGOZA,2,72,37,35,6
OAXACA,20,CHIQUIHUITLÁN DE BENITO JUÁREZ,027,AGUA TENDIDA,2,61,29,32,7
OAXACA,20,CHIQUIHUITLÁN DE BENITO JUÁREZ,027,AGUA TRAPO,2,7,5,2,1
OAXACA,20,CHIQUIHUITLÁN DE BENITO JUÁREZ,027,CHIQUIHUITLÁN DE BENITO JUÁREZ,4,335,181,154,21
OAXACA,20,CHIQUIHUITLÁN DE BENITO JUÁREZ,027,LA CONCEPCIÓN,2,24,10,14,8
OAXACA,20,HEROICA CIUDAD DE EJUTLA DE CRESPO,028,BARRANCA LARGA,3,173,99,74,12
OAXACA,20,HEROICA CIUDAD DE EJUTLA DE CRESPO,028,EL ARROGANTE JUSTO BENÍTEZ,3,123,66,57,12
OAXACA,20,HEROICA CIUDAD DE EJUTLA DE CRESPO,028,EL CERRO DE LAS HUERTAS,3,139,77,62,11
OAXACA,20,HEROICA CIUDAD DE EJUTLA DE CRESPO,028,EL SAÚZ,2,27,13,14,2
OAXACA,20,HEROICA CIUDAD DE EJUTLA DE CRESPO,028,EL VERGEL,4,178,88,90,15
OAXACA,20,HEROICA CIUDAD DE EJUTLA DE CRESPO,028,HACIENDA VIEJA,3,196,114,82,16
OAXACA,20,HEROICA CIUDAD DE EJUTLA DE CRESPO,028,HEROICA CIUDAD DE EJUTLA DE CRESPO,15,3128,1747,1381,139
OAXACA,20,HEROICA CIUDAD DE EJUTLA DE CRESPO,028,LA CIENEGUILLA,2,22,14,8,7
OAXACA,20,HEROICA CIUDAD DE EJUTLA DE CRESPO,028,LA ERMITA,3,100,55,45,10
OAXACA,20,HEROICA CIUDAD DE EJUTLA DE CRESPO,028,LA ESCALERA,3,79,44,35,12
OAXACA,20,HEROICA CIUDAD DE EJUTLA DE CRESPO,028,LA LOBERA,2,42,23,19,9
OAXACA,20,HEROICA CIUDAD DE EJUTLA DE CRESPO,028,LA NORIA,2,41,21,20,7
OAXACA,20,HEROICA CIUDAD DE EJUTLA DE CRESPO,028,LA NORIA DE ORTIZ,2,41,24,17,2
OAXACA,20,HEROICA CIUDAD DE EJUTLA DE CRESPO,028,LA PITIONA,3,22,14,8,3
OAXACA,20,HEROICA CIUDAD DE EJUTLA DE CRESPO,028,LOS OCOTES,3,120,66,54,12
OAXACA,20,HEROICA CIUDAD DE EJUTLA DE CRESPO,028,MONTE DEL TORO,2,82,40,42,8
OAXACA,20,HEROICA CIUDAD DE EJUTLA DE CRESPO,028,NUEVO VENUSTIANO CARRANZA,3,92,43,49,10
OAXACA,20,HEROICA CIUDAD DE EJUTLA DE CRESPO,028,SAN JOAQUÍN,1,22,10,12,6
OAXACA,20,HEROICA CIUDAD DE EJUTLA DE CRESPO,028,SAN JUAN COATECAS BAJAS,2,34,17,17,9
OAXACA,20,HEROICA CIUDAD DE EJUTLA DE CRESPO,028,SAN JUAN LOGOLAVA,2,32,12,20,4
OAXACA,20,HEROICA CIUDAD DE EJUTLA DE CRESPO,028,SAN MATÍAS CHILAZOA,2,35,17,18,7
OAXACA,20,HEROICA CIUDAD DE EJUTLA DE CRESPO,028,SANTA CRUZ NEXILA,3,198,109,89,14
OAXACA,20,HEROICA CIUDAD DE EJUTLA DE CRESPO,028,SANTA MARTA CHICHIHUALTEPEC,3,320,186,134,20
OAXACA,20,HEROICA CIUDAD DE EJUTLA DE CRESPO,028,YEGOSEVE,2,103,56,47,8
OAXACA,20,ELOXOCHITLÁN DE FLORES MAGÓN,029,AGUA ANCHA,1,7,4,3,1
OAXACA,20,ELOXOCHITLÁN DE FLORES MAGÓN,029,AGUA DE CUEVA,2,79,44,35,5
OAXACA,20,ELOXOCHITLÁN DE FLORES MAGÓN,029,AGUA IGLESIA,2,47,17,30,3
OAXACA,20,ELOXOCHITLÁN DE FLORES MAGÓN,029,AGUA TORCIDA,1,11,6,5,1
OAXACA,20,ELOXOCHITLÁN DE FLORES MAGÓN,029,ELOXOCHITLÁN DE FLORES MAGÓN,5,599,294,305,42
OAXACA,20,ELOXOCHITLÁN DE FLORES MAGÓN,029,LAS FLORES [COLONIA],2,117,47,70,8
OAXACA,20,ELOXOCHITLÁN DE FLORES MAGÓN,029,PEÑA COLORADA,2,52,21,31,3
OAXACA,20,ELOXOCHITLÁN DE FLORES MAGÓN,029,PLAN DE CEBOLLA (CEBOLLÍN),1,9,4,5,1
OAXACA,20,ELOXOCHITLÁN DE FLORES MAGÓN,029,SAN JOSÉ BUENAVISTA,3,106,57,49,8
OAXACA,20,EL ESPINAL,030,EL ESPINAL,17,3147,1640,1507,175
OAXACA,20,TAMAZULÁPAM DEL ESPÍRITU SANTO,031,CUATRO PALOS,4,94,46,48,7
OAXACA,20,TAMAZULÁPAM DEL ESPÍRITU SANTO,031,EL DURAZNAL,1,15,4,11,1
OAXACA,20,TAMAZULÁPAM DEL ESPÍRITU SANTO,031,LAS PEÑAS,3,105,52,53,7
OAXACA,20,TAMAZULÁPAM DEL ESPÍRITU SANTO,031,LINDA VISTA,4,188,97,91,11
OAXACA,20,TAMAZULÁPAM DEL ESPÍRITU SANTO,031,MAGUEY,3,77,35,42,5
OAXACA,20,TAMAZULÁPAM DEL ESPÍRITU SANTO,031,SAN JOSÉ KONKIXP,2,42,25,17,3
OAXACA,20,TAMAZULÁPAM DEL ESPÍRITU SANTO,031,TAMAZULÁPAM DEL ESPÍRITU SANTO,6,1039,531,508,50
OAXACA,20,TAMAZULÁPAM DEL ESPÍRITU SANTO,031,TIERRA BLANCA,2,137,87,50,7
OAXACA,20,TAMAZULÁPAM DEL ESPÍRITU SANTO,031,TIERRA CALIENTE,2,29,14,15,2
OAXACA,20,FRESNILLO DE TRUJANO,032,BARRANCA HONDA,2,19,8,11,2
OAXACA,20,FRESNILLO DE TRUJANO,032,CIRUELOS DE GUAPONCINGO,3,108,53,55,9
OAXACA,20,FRESNILLO DE TRUJANO,032,FRESNILLO DE TRUJANO,3,67,24,43,9
OAXACA,20,FRESNILLO DE TRUJANO,032,GUAMÚCHIL DE GUERRERO O SAN ISIDRO,1,17,10,7,1
OAXACA,20,GUADALUPE ETLA,033,GUADALUPE ETLA,4,398,233,165,31
OAXACA,20,GUADALUPE ETLA,033,LA CAPELLANÍA,2,138,78,60,10
OAXACA,20,GUADALUPE DE RAMÍREZ,034,GUADALUPE DE RAMÍREZ,4,215,120,95,17
OAXACA,20,GUADALUPE DE RAMÍREZ,034,SAN ILDEFONSO SALINAS,3,91,50,41,10
OAXACA,20,GUADALUPE DE RAMÍREZ,034,SANTA MARÍA SALINAS,2,7,4,3,1
OAXACA,20,GUELATAO DE JUÁREZ,035,GUELATAO DE JUÁREZ,5,368,197,171,36
OAXACA,20,GUEVEA DE HUMBOLDT,036,ARROYO SÁNCHEZ,2,20,8,12,2
OAXACA,20,GUEVEA DE HUMBOLDT,036,CORRAL DE PIEDRA,2,11,5,6,2
OAXACA,20,GUEVEA DE HUMBOLDT,036,CUAJINICUIL,3,60,32,28,8
OAXACA,20,GUEVEA DE HUMBOLDT,036,EL PORTILLO,2,51,23,28,3
OAXACA,20,GUEVEA DE HUMBOLDT,036,EL PORVENIR,1,11,4,7,5
OAXACA,20,GUEVEA DE HUMBOLDT,036,GUADALUPE,3,89,43,46,10
OAXACA,20,GUEVEA DE HUMBOLDT,036,GUEVEA DE HUMBOLDT,5,495,271,224,37
OAXACA,20,GUEVEA DE HUMBOLDT,036,LA CUMBRE,3,64,28,36,4
OAXACA,20,GUEVEA DE HUMBOLDT,036,LA REFORMA,1,8,5,3,2
OAXACA,20,GUEVEA DE HUMBOLDT,036,LAGUNAS,3,29,13,16,3
OAXACA,20,GUEVEA DE HUMBOLDT,036,LINDA VISTA,3,40,22,18,10
OAXACA,20,GUEVEA DE HUMBOLDT,036,LLANO DE LUMBRE,1,8,4,4,1
OAXACA,20,GUEVEA DE HUMBOLDT,036,NIZAVIA,1,6,2,4,1
OAXACA,20,GUEVEA DE HUMBOLDT,036,NUEVA ESPERANZA,3,122,74,48,12
OAXACA,20,GUEVEA DE HUMBOLDT,036,PROGRESO,2,50,27,23,9
OAXACA,20,GUEVEA DE HUMBOLDT,036,SANTA CRUZ OJO DE AGUA,2,79,47,32,4
OAXACA,20,GUEVEA DE HUMBOLDT,036,SITIO IGLESIAS,1,6,5,1,1
OAXACA,20,GUEVEA DE HUMBOLDT,036,XADANI,4,159,90,69,15
OAXACA,20,GUEVEA DE HUMBOLDT,036,XICALPEXTLE,2,20,12,8,2
OAXACA,20,MESONES HIDALGO,037,CONCEPCIÓN LAS MESAS,3,118,68,50,12
OAXACA,20,MESONES HIDALGO,037,COYUL LAS FLORES,3,32,10,22,7
OAXACA,20,MESONES HIDALGO,037,EL CAMALOTE,2,10,4,6,1
OAXACA,20,MESONES HIDALGO,037,EL CARMEN TUXTITLÁN,2,30,13,17,9
OAXACA,20,MESONES HIDALGO,037,LA SOLEDAD,1,10,3,7,5
OAXACA,20,MESONES HIDALGO,037,LLANO DE LA PLAZA,1,7,2,5,4
OAXACA,20,MESONES HIDALGO,037,MESONES HIDALGO,4,364,200,164,23
OAXACA,20,MESONES HIDALGO,037,PIEDRA DE CASA,3,66,35,31,10
OAXACA,20,MESONES HIDALGO,037,PLAN DE ZARAGOZA LAS FLORES,2,30,13,17,9
OAXACA,20,MESONES HIDALGO,037,SAN ISIDRO,1,8,3,5,5
OAXACA,20,MESONES HIDALGO,037,SAN JOSÉ DE LAS FLORES,3,160,89,71,13
OAXACA,20,MESONES HIDALGO,037,SAN JOSÉ PUEBLO NUEVO,3,39,19,20,12
OAXACA,20,MESONES HIDALGO,037,SAN JUAN LA LIMA,3,17,8,9,3
OAXACA,20,MESONES HIDALGO,037,SANTA MARÍA DE LA LIMA,3,89,50,39,12
OAXACA,20,MESONES HIDALGO,037,SANTA ROSA,2,11,8,3,2
OAXACA,20,VILLA HIDALGO YALÁLAG,038,POZO CONEJO,2,34,17,17,9
OAXACA,20,VILLA HIDALGO YALÁLAG,038,VILLA HIDALGO YALÁLAG,4,381,214,167,25
OAXACA,20,HEROICA CIUDAD DE HUAJUAPAN DE LEÓN,039,ACATLIMA,10,3581,1580,2001,288
OAXACA,20,HEROICA CIUDAD DE HUAJUAPAN DE LEÓN,039,AGUA DULCE,2,38,24,14,3
OAXACA,20,HEROICA CIUDAD DE HUAJUAPAN DE LEÓN,039,AHUEHUETITLÁN DE GONZÁLEZ,3,41,20,21,5
OAXACA,20,HEROICA CIUDAD DE HUAJUAPAN DE LEÓN,039,COLONIA DEL MAESTRO,1,34,14,20,3
OAXACA,20,HEROICA CIUDAD DE HUAJUAPAN DE LEÓN,039,DOLORES,3,120,68,52,14
OAXACA,20,HEROICA CIUDAD DE HUAJUAPAN DE LEÓN,039,EL CASTILLO,2,20,6,14,6
OAXACA,20,HEROICA CIUDAD DE HUAJUAPAN DE LEÓN,039,EL MOLINO,5,519,286,233,36
OAXACA,20,HEROICA CIUDAD DE HUAJUAPAN DE LEÓN,039,HACIENDA DEL CARMEN,2,159,79,80,9
OAXACA,20,HEROICA CIUDAD DE HUAJUAPAN DE LEÓN,039,HEROICA CIUDAD DE HUAJUAPAN DE LEÓN,98,15849,8590,7259,1027
OAXACA,20,HEROICA CIUDAD DE HUAJUAPAN DE LEÓN,039,LA ESTANCIA,3,260,150,110,18
OAXACA,20,HEROICA CIUDAD DE HUAJUAPAN DE LEÓN,039,LA JUNTA,3,184,106,78,15
OAXACA,20,HEROICA CIUDAD DE HUAJUAPAN DE LEÓN,039,LAS PALMAS,1,56,32,24,3
OAXACA,20,HEROICA CIUDAD DE HUAJUAPAN DE LEÓN,039,MAGDALENA TETALTEPEC,2,22,10,12,2
OAXACA,20,HEROICA CIUDAD DE HUAJUAPAN DE LEÓN,039,RANCHO JESÚS,2,48,26,22,9
OAXACA,20,HEROICA CIUDAD DE HUAJUAPAN DE LEÓN,039,RANCHO RAMÍREZ,2,20,9,11,7
OAXACA,20,HEROICA CIUDAD DE HUAJUAPAN DE LEÓN,039,RANCHO REYES,2,9,5,4,2
OAXACA,20,HEROICA CIUDAD DE HUAJUAPAN DE LEÓN,039,RANCHO SOLANO,2,104,58,46,7
OAXACA,20,HEROICA CIUDAD DE HUAJUAPAN DE LEÓN,039,SAN FRANCISCO YOSOCUTA,3,194,113,81,12
OAXACA,20,HEROICA CIUDAD DE HUAJUAPAN DE LEÓN,039,SAN PEDRO YODOYUXI,3,54,25,29,8
OAXACA,20,HEROICA CIUDAD DE HUAJUAPAN DE LEÓN,039,SAN SEBASTIÁN PROGRESO,3,105,53,52,12
OAXACA,20,HEROICA CIUDAD DE HUAJUAPAN DE LEÓN,039,SANTA MARÍA AYÚ,3,72,44,28,9
OAXACA,20,HEROICA CIUDAD DE HUAJUAPAN DE LEÓN,039,SANTA TERESA,2,411,243,168,26
OAXACA,20,HEROICA CIUDAD DE HUAJUAPAN DE LEÓN,039,SANTIAGO CHILIXTLAHUACA,4,173,86,87,12
OAXACA,20,HEROICA CIUDAD DE HUAJUAPAN DE LEÓN,039,SAUCITLÁN DE MORELOS,3,90,47,43,12
OAXACA,20,HEROICA CIUDAD DE HUAJUAPAN DE LEÓN,039,VISTA HERMOSA,8,933,548,385,48
OAXACA,20,HEROICA CIUDAD DE HUAJUAPAN DE LEÓN,039,YUXICHI,2,16,5,11,8
OAXACA,20,HUAUTEPEC,040,AGUA COLORADA,2,60,27,33,4
OAXACA,20,HUAUTEPEC,040,AGUA DE TINTA,2,64,34,30,4
OAXACA,20,HUAUTEPEC,040,AGUA EVANGELISTA,1,34,20,14,2
OAXACA,20,HUAUTEPEC,040,AGUA PAJARITO,2,55,27,28,3
OAXACA,20,HUAUTEPEC,040,BARRIO VELASCO,1,35,22,13,2
OAXACA,20,HUAUTEPEC,040,CUEVA DE LOS SERES,3,151,85,66,10
OAXACA,20,HUAUTEPEC,040,EL CAMARÓN,3,234,121,113,13
OAXACA,20,HUAUTEPEC,040,EL MIRADOR PEÑA BLANCA,1,17,8,9,1
OAXACA,20,HUAUTEPEC,040,HUAUTEPEC,6,679,339,340,34
OAXACA,20,HUAUTEPEC,040,LLANO AGUACATAL,2,68,39,29,4
OAXACA,20,HUAUTEPEC,040,LLANO PLATANAL,2,55,29,26,3
OAXACA,20,HUAUTEPEC,040,LOMA DE ABEJÓN,2,83,54,29,4
OAXACA,20,HUAUTLA DE JIMÉNEZ,041,5 DE MAYO,1,23,12,11,2
OAXACA,20,HUAUTLA DE JIMÉNEZ,041,AGUA ÁLAMO,1,33,16,17,2
OAXACA,20,HUAUTLA DE JIMÉNEZ,041,AGUA CABEZA DE LEÓN,2,43,23,20,5
OAXACA,20,HUAUTLA DE JIMÉNEZ,041,AGUA CANOA,1,16,8,8,1
OAXACA,20,HUAUTLA DE JIMÉNEZ,041,AGUA CATITLA,3,74,35,39,6
OAXACA,20,HUAUTLA DE JIMÉNEZ,041,AGUA DE CERRO,4,198,101,97,19
OAXACA,20,HUAUTLA DE JIMÉNEZ,041,AGUA DE LA ROSA,4,121,65,56,11
OAXACA,20,HUAUTLA DE JIMÉNEZ,041,AGUA DE LLUVIA,2,78,37,41,5
OAXACA,20,HUAUTLA DE JIMÉNEZ,041,AGUA DE POZOL (SAN RAMÓN),3,84,43,41,7
OAXACA,20,HUAUTLA DE JIMÉNEZ,041,AGUA DE TIERRA,1,37,19,18,2
OAXACA,20,HUAUTLA DE JIMÉNEZ,041,AGUA DE TINTA,1,39,21,18,2
OAXACA,20,HUAUTLA DE JIMÉNEZ,041,AGUA DE YERBA SANTA,1,9,3,6,6
OAXACA,20,HUAUTLA DE JIMÉNEZ,041,AGUA DEL MONTE,1,15,8,7,1
OAXACA,20,HUAUTLA DE JIMÉNEZ,041,AGUA TEMAZCAL,1,32,18,14,2
OAXACA,20,HUAUTLA DE JIMÉNEZ,041,BARRANCA SECA,3,141,71,70,11
OAXACA,20,HUAUTLA DE JIMÉNEZ,041,BARRIO LOMA FORTÍN,1,15,5,10,1
OAXACA,20,HUAUTLA DE JIMÉNEZ,041,CERRO IGLESIA,2,33,19,14,3
OAXACA,20,HUAUTLA DE JIMÉNEZ,041,CERRO OCOTE,1,7,3,4,1
OAXACA,20,HUAUTLA DE JIMÉNEZ,041,CERRO ZONGOLICA,2,24,12,12,6
OAXACA,20,HUAUTLA DE JIMÉNEZ,041,EL CARRIZAL,3,176,93,83,9
OAXACA,20,HUAUTLA DE JIMÉNEZ,041,ENCINAL HUAUTLA,2,45,23,22,3
OAXACA,20,HUAUTLA DE JIMÉNEZ,041,HUAUTLA DE JIMÉNEZ,28,3144,1589,1555,191
OAXACA,20,HUAUTLA DE JIMÉNEZ,041,LA FINCA,2,55,27,28,5
OAXACA,20,HUAUTLA DE JIMÉNEZ,041,LA PROVIDENCIA,2,43,21,22,9
OAXACA,20,HUAUTLA DE JIMÉNEZ,041,LLANO DE ÁGUILA,2,54,34,20,3
OAXACA,20,HUAUTLA DE JIMÉNEZ,041,LLANO VIEJO,1,32,11,21,2
OAXACA,20,HUAUTLA DE JIMÉNEZ,041,LOMA ALTA,1,30,14,16,2
OAXACA,20,HUAUTLA DE JIMÉNEZ,041,LOMA CHAPULTEPEC,3,259,113,146,16
OAXACA,20,HUAUTLA DE JIMÉNEZ,041,LOMA CHILAR,3,150,77,73,11
OAXACA,20,HUAUTLA DE JIMÉNEZ,041,LOMA MAGUEY,2,28,10,18,2
OAXACA,20,HUAUTLA DE JIMÉNEZ,041,LOMA NARANJO,1,28,14,14,2
OAXACA,20,HUAUTLA DE JIMÉNEZ,041,LOMA NAZARENO,2,9,5,4,1
OAXACA,20,HUAUTLA DE JIMÉNEZ,041,LOMA NOPAL,2,47,23,24,3
OAXACA,20,HUAUTLA DE JIMÉNEZ,041,LOS PINOS,1,41,23,18,4
OAXACA,20,HUAUTLA DE JIMÉNEZ,041,NETZAHUALCÓYOTL,2,54,29,25,8
OAXACA,20,HUAUTLA DE JIMÉNEZ,041,NUEVO PROGRESO,3,33,14,19,4
OAXACA,20,HUAUTLA DE JIMÉNEZ,041,PALO DE MARCA,3,164,90,74,7
OAXACA,20,HUAUTLA DE JIMÉNEZ,041,PATIO IGLESIA,2,149,64,85,11
OAXACA,20,HUAUTLA DE JIMÉNEZ,041,PEÑA CAMPANA,2,24,14,10,2
OAXACA,20,HUAUTLA DE JIMÉNEZ,041,PLAN CARLOTA,2,47,26,21,9
OAXACA,20,HUAUTLA DE JIMÉNEZ,041,PLAN DE ARENA,2,58,32,26,3
OAXACA,20,HUAUTLA DE JIMÉNEZ,041,PLAN DE BASURA,3,738,400,338,22
OAXACA,20,HUAUTLA DE JIMÉNEZ,041,PLAN DE ESCOBA,1,15,6,9,5
OAXACA,20,HUAUTLA DE JIMÉNEZ,041,PLAN DE OCOTE,1,15,7,8,1
OAXACA,20,HUAUTLA DE JIMÉNEZ,041,POZA RICA SAN ANDRÉS,1,16,9,7,1
OAXACA,20,HUAUTLA DE JIMÉNEZ,041,RÍO SANTIAGO,4,309,161,148,16
OAXACA,20,HUAUTLA DE JIMÉNEZ,041,SAN AGUSTÍN ZARAGOZA,2,41,19,22,3
OAXACA,20,HUAUTLA DE JIMÉNEZ,041,SAN ANDRÉS HIDALGO,11,735,378,357,40
OAXACA,20,HUAUTLA DE JIMÉNEZ,041,SAN FELIPE,3,130,71,59,12
OAXACA,20,HUAUTLA DE JIMÉNEZ,041,SANTA CATARINA BUENAVISTA,5,236,129,107,15
OAXACA,20,HUAUTLA DE JIMÉNEZ,041,SANTA CRUZ DE JUÁREZ,3,200,94,106,13
OAXACA,20,HUAUTLA DE JIMÉNEZ,041,XOCHITONALCO,4,232,116,116,14
OAXACA,20,IXTLÁN DE JUÁREZ,042,IXTLÁN DE JUÁREZ,6,1286,681,605,155
OAXACA,20,IXTLÁN DE JUÁREZ,042,LA JOSEFINA,4,283,145,138,15
OAXACA,20,IXTLÁN DE JUÁREZ,042,LA LUZ,2,47,21,26,4
OAXACA,20,IXTLÁN DE JUÁREZ,042,LA PALMA,4,67,33,34,5
OAXACA,20,IXTLÁN DE JUÁREZ,042,SAN GASPAR YAGALAXI,4,124,56,68,8
OAXACA,20,IXTLÁN DE JUÁREZ,042,SAN JUAN YAGILA,4,96,43,53,12
OAXACA,20,IXTLÁN DE JUÁREZ,042,SAN MIGUEL TILTEPEC,3,123,62,61,8
OAXACA,20,IXTLÁN DE JUÁREZ,042,SANTA CRUZ YAGAVILA,4,184,95,89,12
OAXACA,20,IXTLÁN DE JUÁREZ,042,SANTA MARÍA JOSAA,2,35,22,13,3
OAXACA,20,IXTLÁN DE JUÁREZ,042,SANTA MARÍA YAHUICHE,1,3,1,2,1
OAXACA,20,IXTLÁN DE JUÁREZ,042,SANTA MARÍA ZOOGOCHI,3,108,54,54,10
OAXACA,20,IXTLÁN DE JUÁREZ,042,SANTIAGO TEOTLASCO,2,75,36,39,4
OAXACA,20,IXTLÁN DE JUÁREZ,042,SANTO DOMINGO CACALOTEPEC,3,105,54,51,9
OAXACA,20,HEROICA CIUDAD DE JUCHITÁN DE ZARAGOZA,043,ÁLVARO OBREGÓN,8,1548,765,783,72
OAXACA,20,HEROICA CIUDAD DE JUCHITÁN DE ZARAGOZA,043,CAMOTEPEC,1,8,5,3,1
OAXACA,20,HEROICA CIUDAD DE JUCHITÁN DE ZARAGOZA,043,CHICAPA DE CASTRO,7,645,345,300,41
OAXACA,20,HEROICA CIUDAD DE JUCHITÁN DE ZARAGOZA,043,COLONIA 19 DE MARZO (COLONIA SAN JOSÉ),1,32,18,14,3
OAXACA,20,HEROICA CIUDAD DE JUCHITÁN DE ZARAGOZA,043,COLONIA 6 DE NOVIEMBRE,1,152,63,89,6
OAXACA,20,HEROICA CIUDAD DE JUCHITÁN DE ZARAGOZA,043,COLONIA DE LA AMISTAD,2,165,75,90,10
OAXACA,20,HEROICA CIUDAD DE JUCHITÁN DE ZARAGOZA,043,EMILIANO ZAPATA,5,416,226,190,24
OAXACA,20,HEROICA CIUDAD DE JUCHITÁN DE ZARAGOZA,043,HEROICA CIUDAD DE JUCHITÁN DE ZARAGOZA,118,24598,11848,12750,1556
OAXACA,20,HEROICA CIUDAD DE JUCHITÁN DE ZARAGOZA,043,JUQUILITA [COLONIA],1,28,10,18,2
OAXACA,20,HEROICA CIUDAD DE JUCHITÁN DE ZARAGOZA,043,LA VENTA,6,559,295,264,36
OAXACA,20,HEROICA CIUDAD DE JUCHITÁN DE ZARAGOZA,043,LA VENTOSA,14,1630,909,721,110
OAXACA,20,HEROICA CIUDAD DE JUCHITÁN DE ZARAGOZA,043,PARADA SAN VICENTE,2,224,118,106,9
OAXACA,20,HEROICA CIUDAD DE JUCHITÁN DE ZARAGOZA,043,PLAYA SAN VICENTE,1,560,270,290,4
OAXACA,20,HEROICA CIUDAD DE JUCHITÁN DE ZARAGOZA,043,RANCHO DE LOS VÁSQUEZ (COLONIA PALOMAR),2,25,11,14,3
OAXACA,20,HEROICA CIUDAD DE JUCHITÁN DE ZARAGOZA,043,RANCHO MARTÍN VICENTE,2,37,19,18,3
OAXACA,20,HEROICA CIUDAD DE JUCHITÁN DE ZARAGOZA,043,SANTA MARÍA DEL MAR,3,181,96,85,11
OAXACA,20,LOMA BONITA,044,10 DE ABRIL,1,5,4,1,1
OAXACA,20,LOMA BONITA,044,20 DE NOVIEMBRE,3,76,29,47,5
OAXACA,20,LOMA BONITA,044,27 DE FEBRERO,1,50,21,29,3
OAXACA,20,LOMA BONITA,044,ARROYO LA PALMA,3,38,23,15,4
OAXACA,20,LOMA BONITA,044,ARROYO METATE,3,164,85,79,12
OAXACA,20,LOMA BONITA,044,ARTÍCULO SESENTA Y CINCO REFORMA AGRARIA,2,21,13,8,2
OAXACA,20,LOMA BONITA,044,CELESTINO GASCA VILLASEÑOR,3,37,16,21,6
OAXACA,20,LOMA BONITA,044,COLONIA 7 DE SEPTIEMBRE,2,45,17,28,4
OAXACA,20,LOMA BONITA,044,DESPARRAMADERO,3,55,32,23,7
OAXACA,20,LOMA BONITA,044,DOÑA LUCHITA,3,15,8,7,3
OAXACA,20,LOMA BONITA,044,EL MIRADOR,3,55,26,29,6
OAXACA,20,LOMA BONITA,044,EL OBISPO,3,52,24,28,7
OAXACA,20,LOMA BONITA,044,EL PARAÍSO ZACATAL,3,83,44,39,7
OAXACA,20,LOMA BONITA,044,EL ROBLE,1,4,2,2,1
OAXACA,20,LOMA BONITA,044,EL SACRIFICIO,2,18,10,8,3
OAXACA,20,LOMA BONITA,044,EL TRIUNFO,2,27,13,14,2
OAXACA,20,LOMA BONITA,044,GENERAL FRANCISCO VILLA,3,80,38,42,9
OAXACA,20,LOMA BONITA,044,GUADALUPANO (LOS NEGRITOS),1,24,13,11,2
OAXACA,20,LOMA BONITA,044,GUADALUPE VICTORIA,3,71,44,27,7
OAXACA,20,LOMA BONITA,044,HERMANOS GUTIÉRREZ,2,13,5,8,2
OAXACA,20,LOMA BONITA,044,JOBAL NUEVO,2,53,25,28,5
OAXACA,20,LOMA BONITA,044,LA POCHOTA,2,15,9,6,1
OAXACA,20,LOMA BONITA,044,LA REFORMA SAN FELIPE,2,28,16,12,4
OAXACA,20,LOMA BONITA,044,LA SOLEDAD,4,210,103,107,14
OAXACA,20,LOMA BONITA,044,LAS TREMENTINAS,2,8,4,4,2
OAXACA,20,LOMA BONITA,044,LOMA BONITA,45,7793,4047,3746,547
OAXACA,20,LOMA BONITA,044,MIXTÁN,3,76,36,40,8
OAXACA,20,LOMA BONITA,044,MULATO VIEJO,3,34,19,15,4
OAXACA,20,LOMA BONITA,044,PALMILLA (EL OLVIDO UNO),1,6,2,4,1
OAXACA,20,LOMA BONITA,044,PARAÍSO,3,18,10,8,3
OAXACA,20,LOMA BONITA,044,SAN BENITO ENCINAL,4,317,160,157,21
OAXACA,20,LOMA BONITA,044,SAN JOSÉ,2,10,8,2,2
OAXACA,20,LOMA BONITA,044,SANTA RITA,1,28,19,9,3
OAXACA,20,LOMA BONITA,044,SANTA SOFÍA LOMA BONITA,3,57,22,35,4
OAXACA,20,LOMA BONITA,044,SANTA SOFÍA MONTE ROSA,2,41,18,23,4
OAXACA,20,LOMA BONITA,044,SANTA SOFÍA RÍO PLAYA,2,19,6,13,2
OAXACA,20,LOMA BONITA,044,TIERRA ALTA,3,81,38,43,9
OAXACA,20,LOMA BONITA,044,ZACATIXPAM,2,8,1,7,2
OAXACA,20,MAGDALENA APASCO,045,DE LACHE,2,28,13,15,9
OAXACA,20,MAGDALENA APASCO,045,MAGDALENA APASCO,6,772,442,330,41
OAXACA,20,MAGDALENA APASCO,045,SAN ISIDRO CATANO,2,160,91,69,12
OAXACA,20,MAGDALENA APASCO,045,SAN SEBASTIÁN XOCHIMILCO,2,63,33,30,7
OAXACA,20,MAGDALENA APASCO,045,SANTA MARTHA ETLA,2,86,48,38,8
OAXACA,20,MAGDALENA JALTEPEC,046,EL ROSARIO,2,15,6,9,2
OAXACA,20,MAGDALENA JALTEPEC,046,EL VENADO,2,23,12,11,6
OAXACA,20,MAGDALENA JALTEPEC,046,GUADALUPE VICTORIA,1,11,3,8,5
OAXACA,20,MAGDALENA JALTEPEC,046,HIDALGO,3,53,26,27,8
OAXACA,20,MAGDALENA JALTEPEC,046,LA UNIÓN,2,28,13,15,7
OAXACA,20,MAGDALENA JALTEPEC,046,LINDA VISTA,1,16,8,8,1
OAXACA,20,MAGDALENA JALTEPEC,046,MAGDALENA JALTEPEC,4,311,165,146,21
OAXACA,20,MAGDALENA JALTEPEC,046,MORELOS,2,30,17,13,3
OAXACA,20,MAGDALENA JALTEPEC,046,SAN MIGUEL,2,29,15,14,2
OAXACA,20,MAGDALENA JALTEPEC,046,SANTA CRUZ MITLATONGO,4,89,41,48,7
OAXACA,20,MAGDALENA JALTEPEC,046,SANTIAGO BUENAVISTA,3,60,29,31,12
OAXACA,20,SANTA MAGDALENA JICOTLÁN,047,SANTA MAGDALENA JICOTLÁN,1,15,7,8,2
OAXACA,20,MAGDALENA MIXTEPEC,048,MAGDALENA MIXTEPEC,3,192,103,89,12
OAXACA,20,MAGDALENA MIXTEPEC,048,SANTA CATALINA MIXTEPEC,4,272,144,128,18
OAXACA,20,MAGDALENA OCOTLÁN,049,MAGDALENA OCOTLÁN,4,232,129,103,20
OAXACA,20,MAGDALENA PEÑASCO,050,CABACÚA,2,32,19,13,3
OAXACA,20,MAGDALENA PEÑASCO,050,GUADALUPE PEÑASCO,2,45,24,21,6
OAXACA,20,MAGDALENA PEÑASCO,050,IGNACIO ZARAGOZA,2,59,31,28,4
OAXACA,20,MAGDALENA PEÑASCO,050,LA CUMBRE,2,45,20,25,3
OAXACA,20,MAGDALENA PEÑASCO,050,MAGDALENA PEÑASCO,5,409,215,194,26
OAXACA,20,MAGDALENA PEÑASCO,050,MIRASOL,1,4,1,3,1
OAXACA,20,MAGDALENA PEÑASCO,050,PUEBLO VIEJO,2,78,47,31,5
OAXACA,20,MAGDALENA PEÑASCO,050,SAN ISIDRO,4,148,75,73,10
OAXACA,20,MAGDALENA PEÑASCO,050,SAN JUAN DEL RÍO,2,42,23,19,3
OAXACA,20,MAGDALENA PEÑASCO,050,YOSOCAHUA,4,133,64,69,8
OAXACA,20,MAGDALENA TEITIPAC,051,MAGDALENA TEITIPAC,6,1085,584,501,59
OAXACA,20,MAGDALENA TEQUISISTLÁN,052,COLONIA MARILÚ,2,44,25,19,6
OAXACA,20,MAGDALENA TEQUISISTLÁN,052,EL CIPRÉS,1,7,3,4,1
OAXACA,20,MAGDALENA TEQUISISTLÁN,052,EL SAUCE,1,5,3,2,1
OAXACA,20,MAGDALENA TEQUISISTLÁN,052,LA PÁJIMA,2,22,10,12,5
OAXACA,20,MAGDALENA TEQUISISTLÁN,052,LAS MAJADAS,1,24,10,14,2
OAXACA,20,MAGDALENA TEQUISISTLÁN,052,MAGDALENA TEQUISISTLÁN,9,1052,527,525,88
OAXACA,20,MAGDALENA TEQUISISTLÁN,052,SAN JOSÉ,2,39,20,19,7
OAXACA,20,MAGDALENA TEQUISISTLÁN,052,SAN MIGUEL ECATEPEC,4,172,88,84,16
OAXACA,20,MAGDALENA TEQUISISTLÁN,052,SAN PEDRO JILOTEPEC,3,20,14,6,2
OAXACA,20,MAGDALENA TLACOTEPEC,053,MAGDALENA TLACOTEPEC,3,175,88,87,14
OAXACA,20,MAGDALENA ZAHUATLÁN,054,MAGDALENA ZAHUATLÁN,3,81,41,40,8
OAXACA,20,MARISCALA DE JUÁREZ,055,GUADALUPE COPALTEPEC,1,14,6,8,1
OAXACA,20,MARISCALA DE JUÁREZ,055,GUADALUPE LA HUERTILLA,3,59,25,34,8
OAXACA,20,MARISCALA DE JUÁREZ,055,MARISCALA DE JUÁREZ,6,807,432,375,42
OAXACA,20,MARISCALA DE JUÁREZ,055,SAN MIGUEL CARRIZAL,3,39,21,18,4
OAXACA,20,MARISCALA DE JUÁREZ,055,SAN PEDRO ATOYAC,3,108,59,49,9
OAXACA,20,MARISCALA DE JUÁREZ,055,SANTA CRUZ EL FRAILE,2,16,7,9,2
OAXACA,20,MÁRTIRES DE TACUBAYA,056,EL NARANJO,3,103,58,45,12
OAXACA,20,MÁRTIRES DE TACUBAYA,056,MÁRTIRES DE TACUBAYA,4,237,121,116,18
OAXACA,20,MATÍAS ROMERO AVENDAÑO,057,ARROYO AZUL,1,14,6,8,5
OAXACA,20,MATÍAS ROMERO AVENDAÑO,057,BARRANCONES,2,24,9,15,2
OAXACA,20,MATÍAS ROMERO AVENDAÑO,057,COLONIA GABRIEL RAMOS MILLÁN,3,51,29,22,5
OAXACA,20,MATÍAS ROMERO AVENDAÑO,057,CUAUHTÉMOC,7,639,348,291,43
OAXACA,20,MATÍAS ROMERO AVENDAÑO,057,DONAJÍ,5,829,434,395,44
OAXACA,20,MATÍAS ROMERO AVENDAÑO,057,EL ASERRADERO,1,79,38,41,3
OAXACA,20,MATÍAS ROMERO AVENDAÑO,057,EL MANANTIAL,2,14,8,6,1
OAXACA,20,MATÍAS ROMERO AVENDAÑO,057,EL PARAÍSO,4,81,45,36,11
OAXACA,20,MATÍAS ROMERO AVENDAÑO,057,EL PASO DE LAS MARAVILLAS,2,46,24,22,5
OAXACA,20,MATÍAS ROMERO AVENDAÑO,057,EL PORVENIR,1,5,3,2,1
OAXACA,20,MATÍAS ROMERO AVENDAÑO,057,FRANCISCO JAVIER JASSO,3,102,58,44,10
OAXACA,20,MATÍAS ROMERO AVENDAÑO,057,JUNO,2,29,15,14,5
OAXACA,20,MATÍAS ROMERO AVENDAÑO,057,LA CUMBRE,2,48,24,24,7
OAXACA,20,MATÍAS ROMERO AVENDAÑO,057,LA LAGUNITA,2,11,7,4,1
OAXACA,20,MATÍAS ROMERO AVENDAÑO,057,LA OAXAQUEÑA,3,283,162,121,23
OAXACA,20,MATÍAS ROMERO AVENDAÑO,057,LA VICTORIA,4,205,102,103,15
OAXACA,20,MATÍAS ROMERO AVENDAÑO,057,LAS FLORES,2,188,109,79,13
OAXACA,20,MATÍAS ROMERO AVENDAÑO,057,LOS ÁNGELES,4,345,180,165,30
OAXACA,20,MATÍAS ROMERO AVENDAÑO,057,MARTÍNEZ DE LA TORRE,2,43,21,22,5
OAXACA,20,MATÍAS ROMERO AVENDAÑO,057,MATÍAS ROMERO AVENDAÑO,44,5667,2944,2723,432
OAXACA,20,MATÍAS ROMERO AVENDAÑO,057,MONTE OSCURO,1,15,6,9,1
OAXACA,20,MATÍAS ROMERO AVENDAÑO,057,NUEVO PROGRESO,3,97,52,45,12
OAXACA,20,MATÍAS ROMERO AVENDAÑO,057,NUEVO UBERO,3,71,38,33,10
OAXACA,20,MATÍAS ROMERO AVENDAÑO,057,PALOMARES,11,1202,669,533,78
OAXACA,20,MATÍAS ROMERO AVENDAÑO,057,PASO GUAYABO,2,12,6,6,3
OAXACA,20,MATÍAS ROMERO AVENDAÑO,057,PROFESOR OTILIO MONTAÑO,3,113,65,48,12
OAXACA,20,MATÍAS ROMERO AVENDAÑO,057,RANCHO NUEVO,1,7,4,3,1
OAXACA,20,MATÍAS ROMERO AVENDAÑO,057,RÍO VERDE,2,6,4,2,1
OAXACA,20,MATÍAS ROMERO AVENDAÑO,057,SAN GABRIEL,2,29,16,13,5
OAXACA,20,MATÍAS ROMERO AVENDAÑO,057,SAN ISIDRO,2,157,84,73,12
OAXACA,20,MATÍAS ROMERO AVENDAÑO,057,SAN JUAN DEL RÍO,3,139,69,70,21
OAXACA,20,MATÍAS ROMERO AVENDAÑO,057,SAN PEDRO EVANGELISTA,3,165,79,86,11
OAXACA,20,MATÍAS ROMERO AVENDAÑO,057,TOLOSITA,3,157,77,80,18
OAXACA,20,MATÍAS ROMERO AVENDAÑO,057,UBERO,2,31,14,17,5
OAXACA,20,MAZATLÁN VILLA DE FLORES,058,AGUA DUENDE,2,42,22,20,9
OAXACA,20,MAZATLÁN VILLA DE FLORES,058,AGUA MOSQUITO,3,96,53,43,12
OAXACA,20,MAZATLÁN VILLA DE FLORES,058,AGUACATITLA,5,146,79,67,13
OAXACA,20,MAZATLÁN VILLA DE FLORES,058,ALMOLONGA,1,36,20,16,6
OAXACA,20,MAZATLÁN VILLA DE FLORES,058,ARROYO ZAPOTE,2,43,24,19,3
OAXACA,20,MAZATLÁN VILLA DE FLORES,058,BUENAVISTA,1,17,7,10,6
OAXACA,20,MAZATLÁN VILLA DE FLORES,058,CACAHUATLÁN,2,36,18,18,9
OAXACA,20,MAZATLÁN VILLA DE FLORES,058,CAPULÍN NARANJO,2,55,30,25,9
OAXACA,20,MAZATLÁN VILLA DE FLORES,058,CARACOL 1,1,5,2,3,1
OAXACA,20,MAZATLÁN VILLA DE FLORES,058,CRUZ DE PLATA,2,39,19,20,9
OAXACA,20,MAZATLÁN VILLA DE FLORES,058,EL CORRAL,2,55,30,25,9
OAXACA,20,MAZATLÁN VILLA DE FLORES,058,EL ENCINAL,1,17,7,10,6
OAXACA,20,MAZATLÁN VILLA DE FLORES,058,EL MALANGAR,2,35,18,17,9
OAXACA,20,MAZATLÁN VILLA DE FLORES,058,EL PROGRESO,2,78,44,34,9
OAXACA,20,MAZATLÁN VILLA DE FLORES,058,EL RELÁMPAGO,1,26,15,11,3
OAXACA,20,MAZATLÁN VILLA DE FLORES,058,EL SABINO,2,37,18,19,9
OAXACA,20,MAZATLÁN VILLA DE FLORES,058,EL TRAPICHE VIEJO,2,61,33,28,9
OAXACA,20,MAZATLÁN VILLA DE FLORES,058,LA IHUALEJA,4,259,145,114,18
OAXACA,20,MAZATLÁN VILLA DE FLORES,058,LA RAYA,3,60,33,27,11
OAXACA,20,MAZATLÁN VILLA DE FLORES,058,LA TOMA,4,239,122,117,17
OAXACA,20,MAZATLÁN VILLA DE FLORES,058,LLANO DE FRESNO,2,27,14,13,2
OAXACA,20,MAZATLÁN VILLA DE FLORES,058,LLANO GUADALUPE,2,11,5,6,1
OAXACA,20,MAZATLÁN VILLA DE FLORES,058,LLANO LARGO,2,25,10,15,9
OAXACA,20,MAZATLÁN VILLA DE FLORES,058,LOMA ALTA,2,22,10,12,9
OAXACA,20,MAZATLÁN VILLA DE FLORES,058,LOMA CELOSA,2,56,30,26,9
OAXACA,20,MAZATLÁN VILLA DE FLORES,058,LOMA COZAHUICO,2,25,10,15,9
OAXACA,20,MAZATLÁN VILLA DE FLORES,058,LOMA DELGADA,1,19,9,10,6
OAXACA,20,MAZATLÁN VILLA DE FLORES,058,LOMA GRANDE,2,48,24,24,7
OAXACA,20,MAZATLÁN VILLA DE FLORES,058,LOMA MEDIANA,1,4,2,2,1
OAXACA,20,MAZATLÁN VILLA DE FLORES,058,LOS REYES,2,33,17,16,9
OAXACA,20,MAZATLÁN VILLA DE FLORES,058,MAZATLÁN VILLA DE FLORES,11,528,272,256,47
OAXACA,20,MAZATLÁN VILLA DE FLORES,058,NARANJO POCHOTEPEC,1,8,3,5,1
OAXACA,20,MAZATLÁN VILLA DE FLORES,058,NOGALTEPEC,4,145,82,63,13
OAXACA,20,MAZATLÁN VILLA DE FLORES,058,PEÑA BLANCA,2,62,33,29,9
OAXACA,20,MAZATLÁN VILLA DE FLORES,058,PIEDRA ANCHA,2,107,64,43,9
OAXACA,20,MAZATLÁN VILLA DE FLORES,058,PIEDRA DE LEÓN,2,35,18,17,9
OAXACA,20,MAZATLÁN VILLA DE FLORES,058,PLATANILLO,2,46,24,22,9
OAXACA,20,MAZATLÁN VILLA DE FLORES,058,POCHOTEPEC,5,185,100,85,21
OAXACA,20,MAZATLÁN VILLA DE FLORES,058,SAN PEDRO,3,91,47,44,12
OAXACA,20,MAZATLÁN VILLA DE FLORES,058,SAN PEDRO DE LOS ENCINOS,1,18,10,8,1
OAXACA,20,MAZATLÁN VILLA DE FLORES,058,SAN SIMÓN COYOLTEPEC,3,74,41,33,12
OAXACA,20,MAZATLÁN VILLA DE FLORES,058,SAN VICENTE,2,14,7,7,5
OAXACA,20,MAZATLÁN VILLA DE FLORES,058,SANTIAGO MIRADOR,2,17,8,9,3
OAXACA,20,MAZATLÁN VILLA DE FLORES,058,SOYALTITLA,3,112,54,58,10
OAXACA,20,MIAHUATLÁN DE PORFIRIO DÍAZ,059,ABASOLO,1,17,8,9,1
OAXACA,20,MIAHUATLÁN DE PORFIRIO DÍAZ,059,AGUA BLANCA,2,66,35,31,9
OAXACA,20,MIAHUATLÁN DE PORFIRIO DÍAZ,059,AGUA DE SOL,3,161,92,69,11
OAXACA,20,MIAHUATLÁN DE PORFIRIO DÍAZ,059,ALFA (RANCHERÍA),3,14,9,5,2
OAXACA,20,MIAHUATLÁN DE PORFIRIO DÍAZ,059,BRAMADEROS,4,151,71,80,13
OAXACA,20,MIAHUATLÁN DE PORFIRIO DÍAZ,059,CERRO GORDO,2,19,9,10,2
OAXACA,20,MIAHUATLÁN DE PORFIRIO DÍAZ,059,COLONIA LA SOLEDAD,1,102,50,52,5
OAXACA,20,MIAHUATLÁN DE PORFIRIO DÍAZ,059,COLONIA LAS FLORES (YOGOBICHE),1,45,26,19,3
OAXACA,20,MIAHUATLÁN DE PORFIRIO DÍAZ,059,DOLORES [RANCHERÍA],2,20,9,11,2
OAXACA,20,MIAHUATLÁN DE PORFIRIO DÍAZ,059,EL BEJUCO,1,26,13,13,2
OAXACA,20,MIAHUATLÁN DE PORFIRIO DÍAZ,059,EL CHAMIZO,2,47,25,22,7
OAXACA,20,MIAHUATLÁN DE PORFIRIO DÍAZ,059,EL CHINO,1,19,11,8,1
OAXACA,20,MIAHUATLÁN DE PORFIRIO DÍAZ,059,EL GUAYABO TEPEHUAJE,2,21,11,10,4
OAXACA,20,MIAHUATLÁN DE PORFIRIO DÍAZ,059,EL NANCHE,3,27,14,13,2
OAXACA,20,MIAHUATLÁN DE PORFIRIO DÍAZ,059,EL OCOTE,3,85,45,40,8
OAXACA,20,MIAHUATLÁN DE PORFIRIO DÍAZ,059,EL RAMÓN,2,23,8,15,2
OAXACA,20,MIAHUATLÁN DE PORFIRIO DÍAZ,059,EL TECOLOTE,2,30,19,11,3
OAXACA,20,MIAHUATLÁN DE PORFIRIO DÍAZ,059,EL TEPEHUAJE,3,108,57,51,8
OAXACA,20,MIAHUATLÁN DE PORFIRIO DÍAZ,059,EL TUNILLO,3,68,33,35,10
OAXACA,20,MIAHUATLÁN DE PORFIRIO DÍAZ,059,EL VEINTE,1,1,0,1,1
OAXACA,20,MIAHUATLÁN DE PORFIRIO DÍAZ,059,EL ZAPOTE,2,10,6,4,2
OAXACA,20,MIAHUATLÁN DE PORFIRIO DÍAZ,059,EL ZOMPANTLE,3,118,64,54,12
OAXACA,20,MIAHUATLÁN DE PORFIRIO DÍAZ,059,GUIXE,3,232,132,100,16
OAXACA,20,MIAHUATLÁN DE PORFIRIO DÍAZ,059,LA CHAGA,1,4,2,2,1
OAXACA,20,MIAHUATLÁN DE PORFIRIO DÍAZ,059,LA ESPERANZA,2,102,51,51,9
OAXACA,20,MIAHUATLÁN DE PORFIRIO DÍAZ,059,LA PILA,4,75,40,35,10
OAXACA,20,MIAHUATLÁN DE PORFIRIO DÍAZ,059,LA SOLEDAD,3,146,84,62,12
OAXACA,20,MIAHUATLÁN DE PORFIRIO DÍAZ,059,LA TORTOLITA,3,16,8,8,3
OAXACA,20,MIAHUATLÁN DE PORFIRIO DÍAZ,059,LA UNIÓN,2,47,29,18,5
OAXACA,20,MIAHUATLÁN DE PORFIRIO DÍAZ,059,LOS ÁNGELES [COLONIA],2,86,48,38,9
OAXACA,20,MIAHUATLÁN DE PORFIRIO DÍAZ,059,LOS SABINOS,3,56,29,27,12
OAXACA,20,MIAHUATLÁN DE PORFIRIO DÍAZ,059,MENGOLÍ DE MORELOS,3,75,43,32,8
OAXACA,20,MIAHUATLÁN DE PORFIRIO DÍAZ,059,MIAHUATLÁN DE PORFIRIO DÍAZ,50,11835,6795,5040,639
OAXACA,20,MIAHUATLÁN DE PORFIRIO DÍAZ,059,PALO GRANDE,2,47,23,24,9
OAXACA,20,MIAHUATLÁN DE PORFIRIO DÍAZ,059,RÍO SECO,2,14,6,8,2
OAXACA,20,MIAHUATLÁN DE PORFIRIO DÍAZ,059,SAN FELIPE YEGACHÍN,3,125,52,73,9
OAXACA,20,MIAHUATLÁN DE PORFIRIO DÍAZ,059,SAN GUILLERMO,3,133,74,59,12
OAXACA,20,MIAHUATLÁN DE PORFIRIO DÍAZ,059,SAN ISIDRO,3,104,58,46,9
OAXACA,20,MIAHUATLÁN DE PORFIRIO DÍAZ,059,SAN JOSÉ LLANO GRANDE,3,107,53,54,8
OAXACA,20,MIAHUATLÁN DE PORFIRIO DÍAZ,059,SAN MIGUEL YOGOVANA,3,121,67,54,13
OAXACA,20,MIAHUATLÁN DE PORFIRIO DÍAZ,059,SAN PEDRO AMATLÁN,3,45,21,24,12
OAXACA,20,MIAHUATLÁN DE PORFIRIO DÍAZ,059,SAN PEDRO COATLÁN,3,212,122,90,15
OAXACA,20,MIAHUATLÁN DE PORFIRIO DÍAZ,059,SANTA CATARINA COATLÁN,3,137,78,59,12
OAXACA,20,MIAHUATLÁN DE PORFIRIO DÍAZ,059,SANTA CATARINA ROATINA,4,309,181,128,19
OAXACA,20,MIAHUATLÁN DE PORFIRIO DÍAZ,059,SANTA CRUZ MONJAS,3,92,45,47,9
OAXACA,20,MIAHUATLÁN DE PORFIRIO DÍAZ,059,SANTA MARÍA EL PALMAR,3,23,14,9,3
OAXACA,20,MIAHUATLÁN DE PORFIRIO DÍAZ,059,SITIO DE LACHIDOBLAS,3,77,41,36,12
OAXACA,20,MIAHUATLÁN DE PORFIRIO DÍAZ,059,YOGOVICHE,2,35,16,19,9
OAXACA,20,MIXISTLÁN DE LA REFORMA,060,MIXISTLÁN DE LA REFORMA,4,353,179,174,17
OAXACA,20,MIXISTLÁN DE LA REFORMA,060,SAN CRISTÓBAL CHICHICAXTEPEC,4,115,62,53,8
OAXACA,20,MIXISTLÁN DE LA REFORMA,060,SANTA MARÍA MIXISTLÁN,3,194,98,96,11
OAXACA,20,MONJAS,061,LA UNIÓN [BARRIO],2,56,32,24,5
OAXACA,20,MONJAS,061,MONJAS,4,286,156,130,15
OAXACA,20,MONJAS,061,SANTA MARÍA VELATÓ,7,269,155,114,23
OAXACA,20,NATIVIDAD,062,NATIVIDAD,2,47,28,19,7
OAXACA,20,NAZARENO ETLA,063,NAZARENO ETLA,7,1794,940,854,89
OAXACA,20,NEJAPA DE MADERO,064,AGUA BLANCA,3,43,19,24,8
OAXACA,20,NEJAPA DE MADERO,064,ARROYO HORMIGA,3,26,14,12,3
OAXACA,20,NEJAPA DE MADERO,064,CARRIZAL,2,21,6,15,2
OAXACA,20,NEJAPA DE MADERO,064,CORRAL DE PIEDRA,4,41,19,22,4
OAXACA,20,NEJAPA DE MADERO,064,EL CAMARÓN,6,742,384,358,59
OAXACA,20,NEJAPA DE MADERO,064,EL GRAMAL,2,52,24,28,8
OAXACA,20,NEJAPA DE MADERO,064,EL PADERÓN (CERRO LAS OLLAS),1,3,3,0,1
OAXACA,20,NEJAPA DE MADERO,064,LAS ÁNIMAS,3,148,87,61,11
OAXACA,20,NEJAPA DE MADERO,064,LINDA VISTA,3,23,10,13,2
OAXACA,20,NEJAPA DE MADERO,064,NEJAPA DE MADERO,5,492,261,231,35
OAXACA,20,NEJAPA DE MADERO,064,PARAÍSO DEL NARANJO,1,4,4,0,1
OAXACA,20,NEJAPA DE MADERO,064,SAN ISIDRO CHIHUIRO,3,138,76,62,12
OAXACA,20,NEJAPA DE MADERO,064,SAN JOSÉ LAS FLORES,2,60,32,28,7
OAXACA,20,NEJAPA DE MADERO,064,SAN JUAN LACHIXILA,3,108,61,47,10
OAXACA,20,NEJAPA DE MADERO,064,SAN SEBASTIÁN JILOTEPEC,3,29,15,14,10
OAXACA,20,IXPANTEPEC NIEVES,065,BARRIO DE GUADALUPE,2,49,27,22,8
OAXACA,20,IXPANTEPEC NIEVES,065,IXPANTEPEC NIEVES,3,131,67,64,11
OAXACA,20,IXPANTEPEC NIEVES,065,SANTA MARÍA ASUNCIÓN,1,15,9,6,1
OAXACA,20,IXPANTEPEC NIEVES,065,SANTA MARÍA NATIVIDAD,2,38,20,18,9
OAXACA,20,SANTIAGO NILTEPEC,066,CAZADERO ABAJO,4,82,37,45,9
OAXACA,20,SANTIAGO NILTEPEC,066,CAZADERO ARRIBA,1,38,17,21,3
OAXACA,20,SANTIAGO NILTEPEC,066,EL HUAMUL,2,12,4,8,4
OAXACA,20,SANTIAGO NILTEPEC,066,EL ZOPILOTE (TEOTEPEC),3,138,67,71,12
OAXACA,20,SANTIAGO NILTEPEC,066,LAGUNA DE HOJAS,1,10,7,3,2
OAXACA,20,SANTIAGO NILTEPEC,066,LAS PETACAS,2,19,8,11,2
OAXACA,20,SANTIAGO NILTEPEC,066,SAN JUAN VIEJO,1,5,1,4,1
OAXACA,20,SANTIAGO NILTEPEC,066,SANTIAGO NILTEPEC,8,978,495,483,56
OAXACA,20,SANTIAGO NILTEPEC,066,SANTO DOMINGO,2,45,20,25,5
OAXACA,20,OAXACA DE JUÁREZ,067,GUADALUPE VICTORIA,2,289,171,118,20
OAXACA,20,OAXACA DE JUÁREZ,067,LOS ÁNGELES,1,360,176,184,15
OAXACA,20,OAXACA DE JUÁREZ,067,OAXACA DE JUÁREZ,494,105388,56465,48923,8059
OAXACA,20,OAXACA DE JUÁREZ,067,PUEBLO NUEVO PARTE ALTA,3,280,140,140,18
OAXACA,20,OAXACA DE JUÁREZ,067,VIGUERA,9,1220,656,564,76
OAXACA,20,OCOTLÁN DE MORELOS,068,BUENAVISTA,3,68,36,32,18
OAXACA,20,OCOTLÁN DE MORELOS,068,EX-HACIENDA TOCUELA,2,34,16,18,7
OAXACA,20,OCOTLÁN DE MORELOS,068,LA CHILAÍTA,2,28,15,13,7
OAXACA,20,OCOTLÁN DE MORELOS,068,LA TORTOLITA,1,58,33,25,6
OAXACA,20,OCOTLÁN DE MORELOS,068,OCOTLÁN DE MORELOS,29,4929,2640,2289,415
OAXACA,20,OCOTLÁN DE MORELOS,068,PRAXEDIS DE GUERRERO,4,397,225,172,22
OAXACA,20,OCOTLÁN DE MORELOS,068,RANCHO GALEA,2,51,27,24,9
OAXACA,20,OCOTLÁN DE MORELOS,068,SAN FELIPE APÓSTOL,1,5,1,4,4
OAXACA,20,OCOTLÁN DE MORELOS,068,SAN JACINTO CHILATECA,2,50,25,25,7
OAXACA,20,OCOTLÁN DE MORELOS,068,SAN PEDRO GUEGOREXE,3,178,101,77,13
OAXACA,20,OCOTLÁN DE MORELOS,068,SANTA ROSA,2,30,16,14,6
OAXACA,20,OCOTLÁN DE MORELOS,068,SITIO DE SANTIAGO,3,37,16,21,4
OAXACA,20,OCOTLÁN DE MORELOS,068,TEJAS DE MORELOS,3,85,46,39,11
OAXACA,20,LA PE,069,GUADALUPE,3,83,45,38,12
OAXACA,20,LA PE,069,LA PE,3,549,325,224,32
OAXACA,20,PINOTEPA DE DON LUIS,070,ARROYO DEL POTE (YUTANDIUTU),1,24,14,10,1
OAXACA,20,PINOTEPA DE DON LUIS,070,CHIMINITIÓ,1,13,4,9,6
OAXACA,20,PINOTEPA DE DON LUIS,070,HIERBA SANTA,1,4,1,3,1
OAXACA,20,PINOTEPA DE DON LUIS,070,LA PALMA,1,10,4,6,5
OAXACA,20,PINOTEPA DE DON LUIS,070,PINOTEPA DE DON LUIS,14,1904,935,969,118
OAXACA,20,PINOTEPA DE DON LUIS,070,YUCUCHÁ,3,153,75,78,10
OAXACA,20,PLUMA HIDALGO,071,BARRIO NUEVO (CIMARRÓN),3,47,30,17,4
OAXACA,20,PLUMA HIDALGO,071,EL MANANTIAL,3,13,7,6,2
OAXACA,20,PLUMA HIDALGO,071,EL ROSARIO,2,17,6,11,2
OAXACA,20,PLUMA HIDALGO,071,EL TRIUNFO,2,11,4,7,1
OAXACA,20,PLUMA HIDALGO,071,FINCA VISTA HERMOSA,2,6,2,4,1
OAXACA,20,PLUMA HIDALGO,071,LA ENCINADA,2,9,6,3,2
OAXACA,20,PLUMA HIDALGO,071,LA PASIONARIA,2,37,18,19,4
OAXACA,20,PLUMA HIDALGO,071,LA PATRIA,2,11,6,5,2
OAXACA,20,PLUMA HIDALGO,071,MODELO ALTA LUZ,3,36,19,17,3
OAXACA,20,PLUMA HIDALGO,071,PLUMA HIDALGO,5,390,200,190,27
OAXACA,20,PLUMA HIDALGO,071,SAN JOSÉ PALO GRANDE,2,12,8,4,2
OAXACA,20,PLUMA HIDALGO,071,SANTA FE,2,6,5,1,1
OAXACA,20,PLUMA HIDALGO,071,SANTA MARÍA MAGDALENA PIÑAS,3,86,41,45,8
OAXACA,20,PLUMA HIDALGO,071,TRES DE MAYO,3,22,11,11,3
OAXACA,20,SAN JOSÉ DEL PROGRESO,072,EL CUAJILOTE,2,66,33,33,7
OAXACA,20,SAN JOSÉ DEL PROGRESO,072,EL JAGÜEY,1,5,2,3,1
OAXACA,20,SAN JOSÉ DEL PROGRESO,072,EL PORVENIR,3,104,57,47,8
OAXACA,20,SAN JOSÉ DEL PROGRESO,072,MAGUEY LARGO,3,185,105,80,13
OAXACA,20,SAN JOSÉ DEL PROGRESO,072,RANCHO DE LOS VÁSQUEZ,2,52,26,26,9
OAXACA,20,SAN JOSÉ DEL PROGRESO,072,SAN JOSÉ DEL PROGRESO,3,795,451,344,42
OAXACA,20,SAN JOSÉ DEL PROGRESO,072,SAN JOSÉ LA GARZONA,3,466,270,196,25
OAXACA,20,PUTLA VILLA DE GUERRERO,073,ASUNCIÓN ATOYAQUILLO,5,387,217,170,27
OAXACA,20,PUTLA VILLA DE GUERRERO,073,CHARLOCO,3,48,24,24,11
OAXACA,20,PUTLA VILLA DE GUERRERO,073,CONCEPCIÓN DE GUERRERO,3,132,66,66,12
OAXACA,20,PUTLA VILLA DE GUERRERO,073,CONCEPCIÓN DEL PROGRESO,4,164,81,83,18
OAXACA,20,PUTLA VILLA DE GUERRERO,073,EL CAMPANARIO,3,62,28,34,12
OAXACA,20,PUTLA VILLA DE GUERRERO,073,EL CARRIZAL DE GALEANA,2,20,10,10,6
OAXACA,20,PUTLA VILLA DE GUERRERO,073,EL SESTEADERO,3,86,47,39,12
OAXACA,20,PUTLA VILLA DE GUERRERO,073,GREGORIO ÁLVAREZ,2,45,24,21,9
OAXACA,20,PUTLA VILLA DE GUERRERO,073,GUADALUPE NUEVO TENOCHTITLÁN,2,51,26,25,9
OAXACA,20,PUTLA VILLA DE GUERRERO,073,HIDALGO,2,64,35,29,9
OAXACA,20,PUTLA VILLA DE GUERRERO,073,JICALTEPEC,3,32,14,18,7
OAXACA,20,PUTLA VILLA DE GUERRERO,073,LA LAGUNA GUADALUPE,3,106,56,50,12
OAXACA,20,PUTLA VILLA DE GUERRERO,073,LA MURALLA,2,40,20,20,9
OAXACA,20,PUTLA VILLA DE GUERRERO,073,LA PALIZADA,2,82,48,34,8
OAXACA,20,PUTLA VILLA DE GUERRERO,073,LA TORTOLITA,3,50,28,22,10
OAXACA,20,PUTLA VILLA DE GUERRERO,073,LLANO DE AGUACATE,1,38,20,18,6
OAXACA,20,PUTLA VILLA DE GUERRERO,073,LLANO DE SAN VICENTE,2,28,13,15,9
OAXACA,20,PUTLA VILLA DE GUERRERO,073,LLANO DE ZARAGOZA,2,23,11,12,8
OAXACA,20,PUTLA VILLA DE GUERRERO,073,MALPICA,2,183,107,76,13
OAXACA,20,PUTLA VILLA DE GUERRERO,073,MIGUEL HIDALGO CHICAHUAXTLA,2,38,21,17,2
OAXACA,20,PUTLA VILLA DE GUERRERO,073,PLAN DE AYALA,2,33,16,17,9
OAXACA,20,PUTLA VILLA DE GUERRERO,073,PUTLA VILLA DE GUERRERO,18,4435,2504,1931,247
OAXACA,20,PUTLA VILLA DE GUERRERO,073,SAN ANDRÉS CHICAHUAXTLA,4,384,208,176,28
OAXACA,20,PUTLA VILLA DE GUERRERO,073,SAN ANTONIO ACATLÁN,1,18,9,9,3
OAXACA,20,PUTLA VILLA DE GUERRERO,073,SAN ISIDRO DE MORELOS,2,42,21,21,9
OAXACA,20,PUTLA VILLA DE GUERRERO,073,SAN ISIDRO DEL ESTADO,3,123,72,51,12
OAXACA,20,PUTLA VILLA DE GUERRERO,073,SAN JORGE RÍO FRIJOL,3,73,37,36,12
OAXACA,20,PUTLA VILLA DE GUERRERO,073,SAN JUAN LAGUNAS,4,582,312,270,30
OAXACA,20,PUTLA VILLA DE GUERRERO,073,SAN JUAN LAS HUERTAS,3,96,50,46,12
OAXACA,20,PUTLA VILLA DE GUERRERO,073,SAN JUAN TEPONAXTLA,3,167,97,70,12
OAXACA,20,PUTLA VILLA DE GUERRERO,073,SAN MARCOS COYULITO,1,14,5,9,6
OAXACA,20,PUTLA VILLA DE GUERRERO,073,SAN MARCOS MESONCITO,2,29,14,15,9
OAXACA,20,PUTLA VILLA DE GUERRERO,073,SAN MIGUEL COPALA,6,398,216,182,30
OAXACA,20,PUTLA VILLA DE GUERRERO,073,SAN MIGUEL REYES,4,264,135,129,15
OAXACA,20,PUTLA VILLA DE GUERRERO,073,SAN PEDRO SINIYUVI,4,423,224,199,35
OAXACA,20,PUTLA VILLA DE GUERRERO,073,SANTA CRUZ PROGRESO,2,34,18,16,9
OAXACA,20,PUTLA VILLA DE GUERRERO,073,SANTA ROSA,1,7,2,5,1
OAXACA,20,PUTLA VILLA DE GUERRERO,073,SANTIAGO AMATE COLORADO,2,64,34,30,9
OAXACA,20,PUTLA VILLA DE GUERRERO,073,SANTIAGO YOSOTICHE,3,78,42,36,12
OAXACA,20,PUTLA VILLA DE GUERRERO,073,SANTO DOMINGO DEL ESTADO,3,75,40,35,12
OAXACA,20,PUTLA VILLA DE GUERRERO,073,TIERRA COLORADA,2,29,13,16,9
OAXACA,20,PUTLA VILLA DE GUERRERO,073,UNIÓN NACIONAL,1,11,5,6,3
OAXACA,20,PUTLA VILLA DE GUERRERO,073,YOSONDUCHI,2,18,6,12,8
OAXACA,20,PUTLA VILLA DE GUERRERO,073,ZAFRA,3,152,84,68,13
OAXACA,20,PUTLA VILLA DE GUERRERO,073,ZIMATLÁN,3,103,52,51,12
OAXACA,20,SANTA CATARINA QUIOQUITANI,074,SANTA CATARINA QUIOQUITANI,3,98,56,42,10
OAXACA,20,REFORMA DE PINEDA,075,REFORMA DE PINEDA,6,566,308,258,45
OAXACA,20,LA REFORMA,076,EL PORVENIR,3,94,53,41,12
OAXACA,20,LA REFORMA,076,ESTANZUELA GRANDE,3,136,77,59,12
OAXACA,20,LA REFORMA,076,LA NUEVA ESPERANZA,4,127,70,57,15
OAXACA,20,LA REFORMA,076,LA REFORMA,5,450,234,216,24
OAXACA,20,LA REFORMA,076,RÍO TIGRE,3,64,32,32,12
OAXACA,20,REYES ETLA,077,BARRIO DE SAN JUAN DE DIOS,2,52,27,25,9
OAXACA,20,REYES ETLA,077,REYES ETLA,3,780,394,386,38
OAXACA,20,REYES ETLA,077,SAN LÁZARO ETLA,2,189,110,79,15
OAXACA,20,ROJAS DE CUAUHTÉMOC,078,ROJAS DE CUAUHTÉMOC,3,183,104,79,13
OAXACA,20,SALINA CRUZ,079,BOCA DEL RÍO,3,131,63,68,12
OAXACA,20,SALINA CRUZ,079,ENSENADA DE LA VENTOSA,3,206,106,100,13
OAXACA,20,SALINA CRUZ,079,LA HACIENDA (PALO GRANDE),2,51,24,27,3
OAXACA,20,SALINA CRUZ,079,PLAYA BRASIL,3,119,66,53,10
OAXACA,20,SALINA CRUZ,079,SALINA CRUZ,133,21489,10788,10701,1730
OAXACA,20,SALINA CRUZ,079,SALINAS DEL MARQUÉS,4,459,241,218,27
OAXACA,20,SALINA CRUZ,079,SAN ANTONIO MONTERREY,1,112,43,69,6
OAXACA,20,SALINA CRUZ,079,SAN JOSÉ DEL PALMAR,2,35,18,17,4
OAXACA,20,SAN AGUSTÍN AMATENGO,080,SAN AGUSTÍN AMATENGO,5,230,129,101,22
OAXACA,20,SAN AGUSTÍN ATENANGO,081,LOMA LOS PÉREZ,2,12,6,6,2
OAXACA,20,SAN AGUSTÍN ATENANGO,081,SAN AGUSTÍN ATENANGO,4,261,141,120,21
OAXACA,20,SAN AGUSTÍN ATENANGO,081,SAN FRANCISCO PAXTLAHUACA,2,34,18,16,7
OAXACA,20,SAN AGUSTÍN ATENANGO,081,SAN MATEO DE LIBRES,1,10,2,8,6
OAXACA,20,SAN AGUSTÍN CHAYUCO,082,COLONIA SAN FELIPE,2,31,13,18,3
OAXACA,20,SAN AGUSTÍN CHAYUCO,082,DOS CAMINOS,2,44,17,27,3
OAXACA,20,SAN AGUSTÍN CHAYUCO,082,LA UNIÓN CHAYUCO,3,65,33,32,7
OAXACA,20,SAN AGUSTÍN CHAYUCO,082,SAN AGUSTÍN CHAYUCO,6,588,274,314,37
OAXACA,20,SAN AGUSTÍN CHAYUCO,082,SAN CRISTÓBAL,4,231,117,114,23
OAXACA,20,SAN AGUSTÍN CHAYUCO,082,YUCUTACO,4,126,60,66,11
OAXACA,20,SAN AGUSTÍN DE LAS JUNTAS,083,LOMAS DEL SANTO,2,402,199,203,21
OAXACA,20,SAN AGUSTÍN DE LAS JUNTAS,083,SAN AGUSTÍN DE LAS JUNTAS,5,1683,866,817,98
OAXACA,20,SAN AGUSTÍN ETLA,084,SAN AGUSTÍN ETLA,9,821,430,391,54
OAXACA,20,SAN AGUSTÍN LOXICHA,085,AMPLIACIÓN TRES CRUCES,1,32,16,16,6
OAXACA,20,SAN AGUSTÍN LOXICHA,085,BARRIO SAN PEDRO,2,45,24,21,8
OAXACA,20,SAN AGUSTÍN LOXICHA,085,BUENAVISTA LOXICHA,5,406,198,208,27
OAXACA,20,SAN AGUSTÍN LOXICHA,085,CERRO CANTOR,3,150,79,71,10
OAXACA,20,SAN AGUSTÍN LOXICHA,085,CERRO CIEGO,1,15,8,7,1
OAXACA,20,SAN AGUSTÍN LOXICHA,085,CERRO CIEGO SEGUNDA SECCIÓN,2,17,9,8,2
OAXACA,20,SAN AGUSTÍN LOXICHA,085,CERRO CLANES MAGDALENA,3,64,38,26,6
OAXACA,20,SAN AGUSTÍN LOXICHA,085,CHILAPA,3,152,86,66,11
OAXACA,20,SAN AGUSTÍN LOXICHA,085,EL AGUACATE,3,104,54,50,11
OAXACA,20,SAN AGUSTÍN LOXICHA,085,EL CAMALOTE,1,19,10,9,1
OAXACA,20,SAN AGUSTÍN LOXICHA,085,EL COROZAL,3,94,44,50,7
OAXACA,20,SAN AGUSTÍN LOXICHA,085,EL GUAPINOL,1,41,20,21,2
OAXACA,20,SAN AGUSTÍN LOXICHA,085,EL MANANTIAL,1,40,15,25,2
OAXACA,20,SAN AGUSTÍN LOXICHA,085,EL PARAÍSO [BARRIO],2,105,44,61,4
OAXACA,20,SAN AGUSTÍN LOXICHA,085,EL PORTILLO,2,68,32,36,3
OAXACA,20,SAN AGUSTÍN LOXICHA,085,EL PORTILLO [BARRIO],2,45,22,23,2
OAXACA,20,SAN AGUSTÍN LOXICHA,085,EL RECUERDO,2,42,14,28,3
OAXACA,20,SAN AGUSTÍN LOXICHA,085,JUQUILITA,3,68,40,28,8
OAXACA,20,SAN AGUSTÍN LOXICHA,085,LA CONCHUDA,3,176,90,86,12
OAXACA,20,SAN AGUSTÍN LOXICHA,085,LA GLORIA,1,7,2,5,1
OAXACA,20,SAN AGUSTÍN LOXICHA,085,LA PAZ OBISPO,1,15,6,9,6
OAXACA,20,SAN AGUSTÍN LOXICHA,085,LA PRIMAVERA,1,24,13,11,1
OAXACA,20,SAN AGUSTÍN LOXICHA,085,LA SIRENA,3,266,154,112,19
OAXACA,20,SAN AGUSTÍN LOXICHA,085,LA SOLEDAD,1,21,8,13,1
OAXACA,20,SAN AGUSTÍN LOXICHA,085,LA SOLEDAD [BARRIO],3,34,13,21,3
OAXACA,20,SAN AGUSTÍN LOXICHA,085,LLANO MAMEY,2,61,31,30,3
OAXACA,20,SAN AGUSTÍN LOXICHA,085,LLANO PALMAR,1,23,14,9,1
OAXACA,20,SAN AGUSTÍN LOXICHA,085,LLANO PARAJE,1,33,18,15,6
OAXACA,20,SAN AGUSTÍN LOXICHA,085,LOMA BONITA LOXICHA,2,76,41,35,3
OAXACA,20,SAN AGUSTÍN LOXICHA,085,MAGDALENA LOXICHA,6,444,217,227,25
OAXACA,20,SAN AGUSTÍN LOXICHA,085,PASO LIMÓN,2,67,38,29,4
OAXACA,20,SAN AGUSTÍN LOXICHA,085,PIEDRA CUACHE,1,12,8,4,1
OAXACA,20,SAN AGUSTÍN LOXICHA,085,PIEDRA VIRGEN,3,171,79,92,9
OAXACA,20,SAN AGUSTÍN LOXICHA,085,QUELOVÉ,3,301,169,132,20
OAXACA,20,SAN AGUSTÍN LOXICHA,085,RÍO GRANADA,3,128,58,70,7
OAXACA,20,SAN AGUSTÍN LOXICHA,085,RÍO GRANDE,3,53,33,20,4
OAXACA,20,SAN AGUSTÍN LOXICHA,085,RÍO GUAYABAL,2,67,26,41,3
OAXACA,20,SAN AGUSTÍN LOXICHA,085,RÍO LINDA VISTA,1,25,11,14,1
OAXACA,20,SAN AGUSTÍN LOXICHA,085,SAN AGUSTÍN LOXICHA,11,1447,789,658,78
OAXACA,20,SAN AGUSTÍN LOXICHA,085,SAN FRANCISCO LOXICHA,11,588,294,294,33
OAXACA,20,SAN AGUSTÍN LOXICHA,085,SAN ISIDRO CAMALOTE,1,42,20,22,2
OAXACA,20,SAN AGUSTÍN LOXICHA,085,SAN ISIDRO MIRAMAR,3,98,37,61,10
OAXACA,20,SAN AGUSTÍN LOXICHA,085,SAN JOSÉ DE LA UNIÓN,4,336,184,152,26
OAXACA,20,SAN AGUSTÍN LOXICHA,085,SAN MARTÍN,1,16,6,10,1
OAXACA,20,SAN AGUSTÍN LOXICHA,085,SAN VICENTE YOGODOY,3,160,88,72,10
OAXACA,20,SAN AGUSTÍN LOXICHA,085,SANTA CRUZ,3,81,41,40,10
OAXACA,20,SAN AGUSTÍN LOXICHA,085,SANTA CRUZ DE LAS FLORES,2,49,28,21,9
OAXACA,20,SAN AGUSTÍN LOXICHA,085,SANTA CRUZ LOXICHA,3,265,152,113,19
OAXACA,20,SAN AGUSTÍN LOXICHA,085,SANTA MARÍA [BARRIO],2,98,53,45,7
OAXACA,20,SAN AGUSTÍN LOXICHA,085,SANTA MARÍA BELLA VISTA,1,16,8,8,3
OAXACA,20,SAN AGUSTÍN LOXICHA,085,SANTA MARÍA EL PLATANAR,1,7,2,5,1
OAXACA,20,SAN AGUSTÍN LOXICHA,085,TIERRA BLANCA,3,323,155,168,21
OAXACA,20,SAN AGUSTÍN LOXICHA,085,TIERRA BLANCA SAN VICENTE,3,113,59,54,12
OAXACA,20,SAN AGUSTÍN LOXICHA,085,TOMA DE AGUA,2,52,27,25,7
OAXACA,20,SAN AGUSTÍN LOXICHA,085,TOVALÁ COPALITA,2,93,53,40,9
OAXACA,20,SAN AGUSTÍN LOXICHA,085,TRES RÍOS,2,29,16,13,3
OAXACA,20,SAN AGUSTÍN TLACOTEPEC,086,SAN AGUSTÍN TLACOTEPEC,5,297,160,137,27
OAXACA,20,SAN AGUSTÍN TLACOTEPEC,086,SAN JOSÉ YOSOJICA,1,8,3,5,1
OAXACA,20,SAN AGUSTÍN YATARENI,087,SAN AGUSTÍN YATARENI,4,690,394,296,42
OAXACA,20,SAN ANDRÉS CABECERA NUEVA,088,DOLORES HIDALGO,3,27,10,17,7
OAXACA,20,SAN ANDRÉS CABECERA NUEVA,088,EL CIRUELO,3,27,11,16,7
OAXACA,20,SAN ANDRÉS CABECERA NUEVA,088,EL LIMÓN,3,8,5,3,2
OAXACA,20,SAN ANDRÉS CABECERA NUEVA,088,GUADALUPE RÍO GRANDE,2,5,3,2,1
OAXACA,20,SAN ANDRÉS CABECERA NUEVA,088,GUADALUPE VICTORIA,2,29,14,15,7
OAXACA,20,SAN ANDRÉS CABECERA NUEVA,088,GUADALUPE VILLA ALTA,3,38,18,20,10
OAXACA,20,SAN ANDRÉS CABECERA NUEVA,088,SAN ANDRÉS CABECERA NUEVA,4,281,156,125,18
OAXACA,20,SAN ANDRÉS CABECERA NUEVA,088,SAN COSME DE LA PAZ,2,22,10,12,9
OAXACA,20,SAN ANDRÉS CABECERA NUEVA,088,SAN JUAN YUTACUIÑE,1,5,1,4,1
OAXACA,20,SAN ANDRÉS CABECERA NUEVA,088,SAN MIGUEL DE GUERRERO,2,43,22,21,9
OAXACA,20,SAN ANDRÉS CABECERA NUEVA,088,SAN SEBASTIÁN VALFRÉ,2,27,14,13,7
OAXACA,20,SAN ANDRÉS CABECERA NUEVA,088,SANTA ANA PROGRESO,3,24,10,14,8
OAXACA,20,SAN ANDRÉS CABECERA NUEVA,088,SANTIAGO EL MESÓN,3,41,18,23,10
OAXACA,20,SAN ANDRÉS CABECERA NUEVA,088,SANTOS REYES ALDAMA,2,70,40,30,8
OAXACA,20,SAN ANDRÉS DINICUITI,089,REFORMA,1,10,6,4,2
OAXACA,20,SAN ANDRÉS DINICUITI,089,SAN ANDRÉS DINICUITI,4,240,135,105,18
OAXACA,20,SAN ANDRÉS DINICUITI,089,SAN ANTONIO DE LEÓN,3,134,73,61,12
OAXACA,20,SAN ANDRÉS DINICUITI,089,SANTA MARÍA TUTLA,2,20,9,11,4
OAXACA,20,SAN ANDRÉS DINICUITI,089,SANTIAGO DEL RÍO,1,6,6,0,1
OAXACA,20,SAN ANDRÉS HUAXPALTEPEC,090,CUBITÁN DE DOLORES,3,108,62,46,11
OAXACA,20,SAN ANDRÉS HUAXPALTEPEC,090,RANCHO VIEJO,3,161,77,84,18
OAXACA,20,SAN ANDRÉS HUAXPALTEPEC,090,SAN ANDRÉS HUAXPALTEPEC,12,1508,789,719,97
OAXACA,20,SAN ANDRÉS HUAYÁPAM,091,SAN ANDRÉS HUAYÁPAM,7,786,374,412,34
OAXACA,20,SAN ANDRÉS IXTLAHUACA,092,CIENEGUILLA,3,44,19,25,10
OAXACA,20,SAN ANDRÉS IXTLAHUACA,092,SAN ANDRÉS IXTLAHUACA,3,235,136,99,18
OAXACA,20,SAN ANDRÉS LAGUNAS,093,SAN ANDRÉS LAGUNAS,2,27,9,18,5
OAXACA,20,SAN ANDRÉS LAGUNAS,093,SAN ISIDRO LAGUNAS,2,47,26,21,5
OAXACA,20,SAN ANDRÉS NUXIÑO,094,LA JOYA,1,15,7,8,1
OAXACA,20,SAN ANDRÉS NUXIÑO,094,LINDA VISTA HERRADURA,3,67,33,34,10
OAXACA,20,SAN ANDRÉS NUXIÑO,094,MONTE FRÍO,3,111,56,55,10
OAXACA,20,SAN ANDRÉS NUXIÑO,094,SAN ANDRÉS NUXIÑO,4,312,160,152,19
OAXACA,20,SAN ANDRÉS PAXTLÁN,095,BARRANCA LARGA (LA CIÉNEGA),3,19,8,11,3
OAXACA,20,SAN ANDRÉS PAXTLÁN,095,EL CARRIZAL,4,119,65,54,14
OAXACA,20,SAN ANDRÉS PAXTLÁN,095,EL PORTILLO PAXTLÁN (SAN ANDRÉS),3,182,91,91,12
OAXACA,20,SAN ANDRÉS PAXTLÁN,095,LA CIÉNEGA,3,114,63,51,12
OAXACA,20,SAN ANDRÉS PAXTLÁN,095,LA CONCEPCIÓN,2,50,27,23,7
OAXACA,20,SAN ANDRÉS PAXTLÁN,095,LA VENTA,3,180,103,77,12
OAXACA,20,SAN ANDRÉS PAXTLÁN,095,RANCHO CEREZAL,2,17,8,9,2
OAXACA,20,SAN ANDRÉS PAXTLÁN,095,SAN ANDRÉS PAXTLÁN,5,402,212,190,26
OAXACA,20,SAN ANDRÉS PAXTLÁN,095,SAN PEDRO LOMA LARGA,3,50,23,27,3
OAXACA,20,SAN ANDRÉS SINAXTLA,096,SAN ANDRÉS SINAXTLA,3,212,113,99,18
OAXACA,20,SAN ANDRÉS SINAXTLA,096,SANTA MARÍA SUCHIXTLÁN,1,9,3,6,5
OAXACA,20,SAN ANDRÉS SOLAGA,097,SAN ANDRÉS SOLAGA,5,230,131,99,23
OAXACA,20,SAN ANDRÉS SOLAGA,097,SANTA MARÍA TAVEHUA,2,43,21,22,7
OAXACA,20,SAN ANDRÉS SOLAGA,097,SANTO DOMINGO YOJOVI,3,169,76,93,9
OAXACA,20,SAN ANDRÉS TEOTILÁLPAM,098,CHORRO DE AGUA,2,16,10,6,2
OAXACA,20,SAN ANDRÉS TEOTILÁLPAM,098,COLONIA CONSTITUCIÓN,3,54,28,26,8
OAXACA,20,SAN ANDRÉS TEOTILÁLPAM,098,FLOR BATAVIA,4,294,133,161,19
OAXACA,20,SAN ANDRÉS TEOTILÁLPAM,098,LINDA VISTA,1,56,27,29,6
OAXACA,20,SAN ANDRÉS TEOTILÁLPAM,098,LUCRECIA DE MATAMOROS,3,54,27,27,15
OAXACA,20,SAN ANDRÉS TEOTILÁLPAM,098,PIEDRA COLORADA,2,9,3,6,2
OAXACA,20,SAN ANDRÉS TEOTILÁLPAM,098,RÍO HONDO,2,21,12,9,2
OAXACA,20,SAN ANDRÉS TEOTILÁLPAM,098,SAN ANDRÉS TEOTILÁLPAM,4,451,247,204,26
OAXACA,20,SAN ANDRÉS TEOTILÁLPAM,098,SANTA CRUZ TEOTILÁLPAM,3,106,58,48,10
OAXACA,20,SAN ANDRÉS TEOTILÁLPAM,098,SANTIAGO MAYOLTIANGUIS,2,19,12,7,2
OAXACA,20,SAN ANDRÉS TEPETLAPA,099,SAN ANDRÉS TEPETLAPA,3,79,38,41,11
OAXACA,20,SAN ANDRÉS YAÁ,100,SAN ANDRÉS YAÁ,2,29,15,14,3
OAXACA,20,SAN ANDRÉS ZABACHE,101,SAN ANDRÉS ZABACHE,4,140,78,62,10
OAXACA,20,SAN ANDRÉS ZAUTLA,102,ALEMÁN,2,158,91,67,13
OAXACA,20,SAN ANDRÉS ZAUTLA,102,SAN ANDRÉS ZAUTLA,3,318,179,139,18
OAXACA,20,SAN ANDRÉS ZAUTLA,102,SAN ISIDRO,2,62,33,29,9
OAXACA,20,SAN ANTONINO CASTILLO VELASCO,103,LACHICUVICA,2,31,13,18,2
OAXACA,20,SAN ANTONINO CASTILLO VELASCO,103,SAN ANTONINO CASTILLO VELASCO,6,1895,1054,841,81
OAXACA,20,SAN ANTONINO EL ALTO,104,EL PERAL,2,19,7,12,6
OAXACA,20,SAN ANTONINO EL ALTO,104,EL RÍO HILO,2,32,17,15,7
OAXACA,20,SAN ANTONINO EL ALTO,104,LA MINA,2,7,4,3,1
OAXACA,20,SAN ANTONINO EL ALTO,104,SAN ANDRÉS EL ALTO,3,139,69,70,11
OAXACA,20,SAN ANTONINO EL ALTO,104,SAN ANTONINO EL ALTO,4,472,259,213,27
OAXACA,20,SAN ANTONINO EL ALTO,104,SAN FERNANDO DE MATAMOROS,2,44,25,19,7
OAXACA,20,SAN ANTONINO MONTE VERDE,105,GUADALUPE DE LAS FLORES MONTEVERDE,3,78,37,41,11
OAXACA,20,SAN ANTONINO MONTE VERDE,105,GUADALUPE MONTEVERDE,3,250,146,104,21
OAXACA,20,SAN ANTONINO MONTE VERDE,105,SAN ANTONINO MONTE VERDE,4,380,205,175,20
OAXACA,20,SAN ANTONINO MONTE VERDE,105,SAN ANTONIO YODONDUZA MONTEVERDE,4,273,157,116,16
OAXACA,20,SAN ANTONINO MONTE VERDE,105,SAN FRANCISCO CABALLÚA,3,194,113,81,12
OAXACA,20,SAN ANTONINO MONTE VERDE,105,SAN ISIDRO MONTEVERDE,2,46,28,18,3
OAXACA,20,SAN ANTONINO MONTE VERDE,105,SAN JOSÉ MONTEVERDE,4,357,203,154,25
OAXACA,20,SAN ANTONINO MONTE VERDE,105,SAN MIGUEL MONTEVERDE,4,529,273,256,30
OAXACA,20,SAN ANTONINO MONTE VERDE,105,SANTA MARÍA DE LAS NIEVES MONTEVERDE,2,50,28,22,7
OAXACA,20,SAN ANTONIO ACUTLA,106,SAN ANTONIO ACUTLA,2,28,11,17,4
OAXACA,20,SAN ANTONIO DE LA CAL,107,PRIMERA SECCIÓN SAN ANTONIO DE LA CAL,1,268,132,136,12
OAXACA,20,SAN ANTONIO DE LA CAL,107,SAN ANTONIO DE LA CAL,21,5449,2774,2675,454
OAXACA,20,SAN ANTONIO HUITEPEC,108,CAÑADA AGUACATE,1,10,8,2,1
OAXACA,20,SAN ANTONIO HUITEPEC,108,EL PORTILLO,2,8,4,4,2
OAXACA,20,SAN ANTONIO HUITEPEC,108,INFIERNILLO,4,160,79,81,12
OAXACA,20,SAN ANTONIO HUITEPEC,108,LOMA DE MIEL,1,13,6,7,5
OAXACA,20,SAN ANTONIO HUITEPEC,108,MIGUEL HIDALGO,2,78,41,37,7
OAXACA,20,SAN ANTONIO HUITEPEC,108,SAN ANTONIO HUITEPEC,6,531,293,238,33
OAXACA,20,SAN ANTONIO HUITEPEC,108,SAN FRANCISCO YOCUCUNDO,3,72,34,38,8
OAXACA,20,SAN ANTONIO HUITEPEC,108,SAN JUAN XOCHILTEPEC,2,40,19,21,2
OAXACA,20,SAN ANTONIO HUITEPEC,108,SANTIAGO HUAXOLOTIPAC,1,69,39,30,3
OAXACA,20,SAN ANTONIO NANAHUATÍPAM,109,SAN ANTONIO NANAHUATÍPAM,3,165,88,77,19
OAXACA,20,SAN ANTONIO NANAHUATÍPAM,109,SAN GABRIEL CASA BLANCA,3,70,32,38,8
OAXACA,20,SAN ANTONIO SINICAHUA,110,BUENAVISTA,3,74,46,28,5
OAXACA,20,SAN ANTONIO SINICAHUA,110,JAYUCUNINO,2,61,33,28,3
OAXACA,20,SAN ANTONIO SINICAHUA,110,LA UNIÓN,2,39,19,20,3
OAXACA,20,SAN ANTONIO SINICAHUA,110,SAN ANTONIO SINICAHUA,4,262,119,143,18
OAXACA,20,SAN ANTONIO SINICAHUA,110,SAN ISIDRO SINIYUCO,1,16,5,11,1
OAXACA,20,SAN ANTONIO SINICAHUA,110,SAN JOSÉ,2,40,16,24,3
OAXACA,20,SAN ANTONIO SINICAHUA,110,YOSOCAHUA,2,28,16,12,2
OAXACA,20,SAN ANTONIO TEPETLAPA,111,SAN ANTONIO TEPETLAPA,6,792,455,337,48
OAXACA,20,SAN ANTONIO TEPETLAPA,111,SAN PEDRO TULIXTLAHUACA,4,497,278,219,34
OAXACA,20,SAN BALTAZAR CHICHICÁPAM,112,SAN BALTAZAR CHICHICÁPAM,6,513,287,226,33
OAXACA,20,SAN BALTAZAR LOXICHA,113,RÍO JORDÁN,3,16,8,8,3
OAXACA,20,SAN BALTAZAR LOXICHA,113,SAN BALTAZAR LOXICHA,6,588,314,274,37
OAXACA,20,SAN BALTAZAR LOXICHA,113,SANTA MARTHA LOXICHA,3,114,45,69,7
OAXACA,20,SAN BALTAZAR LOXICHA,113,UNIÓN DEL SUR,2,104,59,45,9
OAXACA,20,SAN BALTAZAR YATZACHI EL BAJO,114,SAN BALTAZAR YATZACHI EL BAJO,2,31,14,17,7
OAXACA,20,SAN BALTAZAR YATZACHI EL BAJO,114,SAN JERÓNIMO ZOOCHINA,2,13,3,10,2
OAXACA,20,SAN BALTAZAR YATZACHI EL BAJO,114,SANTA MARÍA YOHUECHE,2,35,14,21,7
OAXACA,20,SAN BARTOLO COYOTEPEC,115,REYES MANTECÓN,8,1207,625,582,133
OAXACA,20,SAN BARTOLO COYOTEPEC,115,SAN BARTOLO COYOTEPEC,9,2444,1398,1046,90
OAXACA,20,SAN BARTOLOMÉ AYAUTLA,116,CAFETAL CARLOTA,1,19,7,12,1
OAXACA,20,SAN BARTOLOMÉ AYAUTLA,116,LA PROVIDENCIA,2,14,6,8,2
OAXACA,20,SAN BARTOLOMÉ AYAUTLA,116,LA SOLEDAD PIEDRA ANCHA,5,208,119,89,13
OAXACA,20,SAN BARTOLOMÉ AYAUTLA,116,SAN BARTOLOMÉ AYAUTLA,7,803,424,379,41
OAXACA,20,SAN BARTOLOMÉ AYAUTLA,116,SAN MARTÍN PIEDRA ANCHA,1,10,4,6,1
OAXACA,20,SAN BARTOLOMÉ LOXICHA,117,EL TAMARINDO,1,9,4,5,1
OAXACA,20,SAN BARTOLOMÉ LOXICHA,117,PASO ANCHO,4,167,78,89,11
OAXACA,20,SAN BARTOLOMÉ LOXICHA,117,PIEDRA ANCHA,2,55,23,32,3
OAXACA,20,SAN BARTOLOMÉ LOXICHA,117,SAN BARTOLOMÉ LOXICHA,5,379,200,179,22
OAXACA,20,SAN BARTOLOMÉ QUIALANA,118,SAN BARTOLOMÉ QUIALANA,5,402,214,188,25
OAXACA,20,SAN BARTOLOMÉ YUCUAÑE,119,SAN BARTOLOMÉ YUCUAÑE,4,81,46,35,8
OAXACA,20,SAN BARTOLOMÉ ZOOGOCHO,120,SAN BARTOLOMÉ ZOOGOCHO,4,302,110,192,22
OAXACA,20,SAN BARTOLO SOYALTEPEC,121,GUADALUPE GAVILLERA,2,20,12,8,2
OAXACA,20,SAN BARTOLO SOYALTEPEC,121,RÍO VERDE,2,12,5,7,1
OAXACA,20,SAN BARTOLO SOYALTEPEC,121,SAN BARTOLO SOYALTEPEC,2,7,4,3,2
OAXACA,20,SAN BARTOLO SOYALTEPEC,121,SAN PEDRO AÑAÑÉ (AÑAÑE),2,16,6,10,6
OAXACA,20,SAN BARTOLO YAUTEPEC,122,SAN BARTOLO YAUTEPEC,4,157,80,77,15
OAXACA,20,SAN BERNARDO MIXTEPEC,123,ASUNCIÓN MIXTEPEC,3,113,66,47,12
OAXACA,20,SAN BERNARDO MIXTEPEC,123,BARRIO DEL CARMEN,2,69,38,31,9
OAXACA,20,SAN BERNARDO MIXTEPEC,123,BARRIO DEL ROSARIO,1,7,2,5,3
OAXACA,20,SAN BERNARDO MIXTEPEC,123,SAN BERNARDO MIXTEPEC,6,396,225,171,26
OAXACA,20,SAN BERNARDO MIXTEPEC,123,SAN JERÓNIMO TITITLÁN,3,132,69,63,12
OAXACA,20,HEROICA VILLA DE SAN BLAS ATEMPA,124,CAJA VIEJA (GIUGO VIEJO),2,29,13,16,3
OAXACA,20,HEROICA VILLA DE SAN BLAS ATEMPA,124,CRUCERO DE SAN BLAS,1,31,12,19,1
OAXACA,20,HEROICA VILLA DE SAN BLAS ATEMPA,124,EL HUAMUCHAL (LOS VEGAS),1,6,1,5,1
OAXACA,20,HEROICA VILLA DE SAN BLAS ATEMPA,124,HEROICA VILLA DE SAN BLAS ATEMPA,10,3074,1538,1536,136
OAXACA,20,HEROICA VILLA DE SAN BLAS ATEMPA,124,LOMA BONITA,2,18,9,9,3
OAXACA,20,HEROICA VILLA DE SAN BLAS ATEMPA,124,MONTE GRANDE,3,85,37,48,5
OAXACA,20,HEROICA VILLA DE SAN BLAS ATEMPA,124,NIZARINDANI,1,4,2,2,1
OAXACA,20,HEROICA VILLA DE SAN BLAS ATEMPA,124,PUENTE MADERA,3,222,104,118,10
OAXACA,20,HEROICA VILLA DE SAN BLAS ATEMPA,124,RANCHO EL LLANO,4,240,118,122,14
OAXACA,20,HEROICA VILLA DE SAN BLAS ATEMPA,124,SANTA ROSA,5,650,310,340,33
OAXACA,20,HEROICA VILLA DE SAN BLAS ATEMPA,124,SHABACONDE,1,8,3,5,1
OAXACA,20,HEROICA VILLA DE SAN BLAS ATEMPA,124,TIERRA BLANCA,3,118,49,69,9
OAXACA,20,SAN CARLOS YAUTEPEC,125,ASUNCIÓN LACHIXONASE,3,48,23,25,11
OAXACA,20,SAN CARLOS YAUTEPEC,125,GUADALUPE VICTORIA,5,340,178,162,19
OAXACA,20,SAN CARLOS YAUTEPEC,125,LA BAEZA,2,15,7,8,6
OAXACA,20,SAN CARLOS YAUTEPEC,125,LA MAGDALENA,2,10,6,4,2
OAXACA,20,SAN CARLOS YAUTEPEC,125,RANCHO CANDELARIA,1,4,1,3,1
OAXACA,20,SAN CARLOS YAUTEPEC,125,SAN BALTAZAR CHIVAGUELA (LAGUNAS),3,123,65,58,12
OAXACA,20,SAN CARLOS YAUTEPEC,125,SAN CARLOS YAUTEPEC,4,325,174,151,26
OAXACA,20,SAN CARLOS YAUTEPEC,125,SAN FRANCISCO GUICHINA,3,118,69,49,11
OAXACA,20,SAN CARLOS YAUTEPEC,125,SAN ISIDRO MANTECA,2,33,16,17,9
OAXACA,20,SAN CARLOS YAUTEPEC,125,SAN ISIDRO TAPANALÁ,2,6,1,5,1
OAXACA,20,SAN CARLOS YAUTEPEC,125,SAN JOSÉ CHILTEPEC,3,112,66,46,11
OAXACA,20,SAN CARLOS YAUTEPEC,125,SAN LUCAS IXCOTEPEC,2,16,5,11,2
OAXACA,20,SAN CARLOS YAUTEPEC,125,SAN MATÍAS PETACALTEPEC,3,127,68,59,12
OAXACA,20,SAN CARLOS YAUTEPEC,125,SAN MIGUEL CHONGOS,4,145,78,67,12
OAXACA,20,SAN CARLOS YAUTEPEC,125,SAN MIGUEL NITZAVIGUITI,1,5,2,3,1
OAXACA,20,SAN CARLOS YAUTEPEC,125,SAN MIGUEL SUCHILTEPEC,2,46,24,22,9
OAXACA,20,SAN CARLOS YAUTEPEC,125,SAN PABLO TOPILTEPEC,3,174,100,74,13
OAXACA,20,SAN CARLOS YAUTEPEC,125,SAN PEDRO LACHIGOBA,1,5,1,4,1
OAXACA,20,SAN CARLOS YAUTEPEC,125,SAN PEDRO LEAPI,3,96,52,44,12
OAXACA,20,SAN CARLOS YAUTEPEC,125,SAN PEDRO TEPALCATEPEC,3,69,32,37,12
OAXACA,20,SAN CARLOS YAUTEPEC,125,SANTA LUCÍA MECALTEPEC,2,31,15,16,8
OAXACA,20,SAN CARLOS YAUTEPEC,125,SANTA MARÍA CANDELARIA,4,165,82,83,15
OAXACA,20,SAN CARLOS YAUTEPEC,125,SANTA MARÍA NIZAVIGUITI,3,59,30,29,12
OAXACA,20,SAN CARLOS YAUTEPEC,125,SANTIAGO LACHIVÍA,4,267,147,120,16
OAXACA,20,SAN CARLOS YAUTEPEC,125,SANTIAGO QUIAVICUZAS,5,582,250,332,31
OAXACA,20,SAN CARLOS YAUTEPEC,125,SANTIAGO VARGAS (LLANO SANTIAGO),3,25,10,15,3
OAXACA,20,SAN CARLOS YAUTEPEC,125,SANTO DOMINGO LACHIVITÓ,2,4,3,1,1
OAXACA,20,SAN CARLOS YAUTEPEC,125,SANTO TOMÁS QUIERÍ,4,211,105,106,15
OAXACA,20,SAN CRISTÓBAL AMATLÁN,126,LOS SABINOS [RANCHO],2,132,75,57,10
OAXACA,20,SAN CRISTÓBAL AMATLÁN,126,SAN AGUSTÍN MIXTEPEC,3,87,44,43,6
OAXACA,20,SAN CRISTÓBAL AMATLÁN,126,SAN ANDRÉS MIXTEPEC,3,54,28,26,8
OAXACA,20,SAN CRISTÓBAL AMATLÁN,126,SAN CRISTÓBAL AMATLÁN,10,1340,761,579,77
OAXACA,20,SAN CRISTÓBAL AMATLÁN,126,SAN LORENZO MIXTEPEC,1,12,8,4,1
OAXACA,20,SAN CRISTÓBAL AMOLTEPEC,127,BUENA VISTA,2,12,6,6,2
OAXACA,20,SAN CRISTÓBAL AMOLTEPEC,127,CABEZA DEL RÍO,4,113,56,57,9
OAXACA,20,SAN CRISTÓBAL AMOLTEPEC,127,SAN CRISTÓBAL AMOLTEPEC,4,144,77,67,9
OAXACA,20,SAN CRISTÓBAL AMOLTEPEC,127,TIERRA BLANCA,2,28,19,9,2
OAXACA,20,SAN CRISTÓBAL AMOLTEPEC,127,UNIÓN Y PROGRESO,2,26,13,13,2
OAXACA,20,SAN CRISTÓBAL LACHIRIOAG,128,SAN CRISTÓBAL LACHIRIOAG,5,372,199,173,36
OAXACA,20,SAN CRISTÓBAL SUCHIXTLAHUACA,129,SAN CRISTÓBAL SUCHIXTLAHUACA,2,59,29,30,7
OAXACA,20,SAN DIONISIO DEL MAR,130,HUAMÚCHIL,6,517,245,272,27
OAXACA,20,SAN DIONISIO DEL MAR,130,SAN DIONISIO DEL MAR,14,1054,500,554,83
OAXACA,20,SAN DIONISIO DEL MAR,130,SAN DIONISIO PUEBLO VIEJO,2,21,11,10,2
OAXACA,20,SAN DIONISIO OCOTEPEC,131,AGUA SANTA,1,12,5,7,1
OAXACA,20,SAN DIONISIO OCOTEPEC,131,BARRIO 3 DE MAYO,2,293,142,151,16
OAXACA,20,SAN DIONISIO OCOTEPEC,131,BUENAVISTA,2,10,4,6,2
OAXACA,20,SAN DIONISIO OCOTEPEC,131,LAS MILPAS (ZAPOTECA NIZAYUL),2,14,8,6,4
OAXACA,20,SAN DIONISIO OCOTEPEC,131,SAN BALTAZAR GUELAVILA,9,857,477,380,51
OAXACA,20,SAN DIONISIO OCOTEPEC,131,SAN DIONISIO OCOTEPEC,12,1179,607,572,74
OAXACA,20,SAN DIONISIO OCOTEPEC,131,SANTO TOMÁS DE ARRIBA,3,127,67,60,11
OAXACA,20,SAN DIONISIO OCOTLÁN,132,GUELAVICHIGANA LA LABOR,2,23,10,13,6
OAXACA,20,SAN DIONISIO OCOTLÁN,132,SAN DIONISIO OCOTLÁN,2,100,56,44,9
OAXACA,20,SAN ESTEBAN ATATLAHUCA,133,BUENAVISTA TOTOHI,2,18,10,8,2
OAXACA,20,SAN ESTEBAN ATATLAHUCA,133,GUERRERO GRANDE,2,53,27,26,4
OAXACA,20,SAN ESTEBAN ATATLAHUCA,133,INDEPENDENCIA,3,109,54,55,8
OAXACA,20,SAN ESTEBAN ATATLAHUCA,133,MIER Y TERÁN,4,106,47,59,9
OAXACA,20,SAN ESTEBAN ATATLAHUCA,133,MORELOS,3,105,46,59,6
OAXACA,20,SAN ESTEBAN ATATLAHUCA,133,NDOYOCOYO (CIÉNEGA DE TULE),3,121,62,59,11
OAXACA,20,SAN ESTEBAN ATATLAHUCA,133,NDOYONOYUJI (CIÉNEGA DE FLORES AMARILLAS),2,42,18,24,3
OAXACA,20,SAN ESTEBAN ATATLAHUCA,133,PROGRESO,2,42,21,21,3
OAXACA,20,SAN ESTEBAN ATATLAHUCA,133,SAN ESTEBAN ATATLAHUCA,4,324,158,166,29
OAXACA,20,SAN ESTEBAN ATATLAHUCA,133,VICENTE GUERRERO,2,33,14,19,3
OAXACA,20,SAN ESTEBAN ATATLAHUCA,133,YUCUIJI,3,53,28,25,4
OAXACA,20,SAN FELIPE JALAPA DE DÍAZ,134,AGUA DE OLLA,2,21,8,13,2
OAXACA,20,SAN FELIPE JALAPA DE DÍAZ,134,AGUA DE TIERRA (SECCIÓN LA MONTAÑA),4,296,161,135,17
OAXACA,20,SAN FELIPE JALAPA DE DÍAZ,134,ARROYO CULEBRA,2,93,41,52,5
OAXACA,20,SAN FELIPE JALAPA DE DÍAZ,134,ARROYO ESPUMA,3,209,109,100,11
OAXACA,20,SAN FELIPE JALAPA DE DÍAZ,134,ARROYO GRANDE,2,83,34,49,4
OAXACA,20,SAN FELIPE JALAPA DE DÍAZ,134,ARROYO GUAJE,2,10,6,4,2
OAXACA,20,SAN FELIPE JALAPA DE DÍAZ,134,ARROYO VENADO (SECCIÓN TERCERA),1,77,33,44,4
OAXACA,20,SAN FELIPE JALAPA DE DÍAZ,134,ARROYO ZAPOTILLO,3,277,150,127,15
OAXACA,20,SAN FELIPE JALAPA DE DÍAZ,134,CAMINO DE IXCATLÁN,3,254,119,135,15
OAXACA,20,SAN FELIPE JALAPA DE DÍAZ,134,CAMINO ZACATAL,3,142,80,62,10
OAXACA,20,SAN FELIPE JALAPA DE DÍAZ,134,COLONIA LA CENTRAL,2,142,71,71,8
OAXACA,20,SAN FELIPE JALAPA DE DÍAZ,134,LA CHUPARROSA,3,274,137,137,17
OAXACA,20,SAN FELIPE JALAPA DE DÍAZ,134,LA CONCHA,3,56,28,28,5
OAXACA,20,SAN FELIPE JALAPA DE DÍAZ,134,LA PERMUTA,3,139,74,65,10
OAXACA,20,SAN FELIPE JALAPA DE DÍAZ,134,LA SOLEDAD,1,4,0,4,1
OAXACA,20,SAN FELIPE JALAPA DE DÍAZ,134,LA SORPRESA,7,560,282,278,31
OAXACA,20,SAN FELIPE JALAPA DE DÍAZ,134,LLANO GRANDE ULUÁPAM,3,47,20,27,3
OAXACA,20,SAN FELIPE JALAPA DE DÍAZ,134,LOMA CAFETAL,1,29,16,13,1
OAXACA,20,SAN FELIPE JALAPA DE DÍAZ,134,LOMA DE SAN JUAN,3,313,159,154,18
OAXACA,20,SAN FELIPE JALAPA DE DÍAZ,134,LOMA NARANJA,3,153,68,85,10
OAXACA,20,SAN FELIPE JALAPA DE DÍAZ,134,LOS BIBIANO [SECCIÓN],1,8,5,3,1
OAXACA,20,SAN FELIPE JALAPA DE DÍAZ,134,LOS HERNÁNDEZ [SECCIÓN],2,11,4,7,2
OAXACA,20,SAN FELIPE JALAPA DE DÍAZ,134,LOS PALACIOS [SECCIÓN],2,53,24,29,3
OAXACA,20,SAN FELIPE JALAPA DE DÍAZ,134,LOS ROQUES [SECCIÓN],2,110,54,56,7
OAXACA,20,SAN FELIPE JALAPA DE DÍAZ,134,LOS ZARATES,2,89,43,46,5
OAXACA,20,SAN FELIPE JALAPA DE DÍAZ,134,PASO CARRETERO,3,136,73,63,7
OAXACA,20,SAN FELIPE JALAPA DE DÍAZ,134,PASO DEL TORO,2,304,170,134,16
OAXACA,20,SAN FELIPE JALAPA DE DÍAZ,134,PLAYA CHICA,3,272,140,132,14
OAXACA,20,SAN FELIPE JALAPA DE DÍAZ,134,SAN FELIPE JALAPA DE DÍAZ,13,2397,1226,1171,120
OAXACA,20,SAN FELIPE JALAPA DE DÍAZ,134,SANTO TOMÁS,3,352,170,182,20
OAXACA,20,SAN FELIPE JALAPA DE DÍAZ,134,SECCIÓN ARROYO CRECIDO,3,38,18,20,3
OAXACA,20,SAN FELIPE JALAPA DE DÍAZ,134,SECCIÓN CALIXTO,3,41,22,19,4
OAXACA,20,SAN FELIPE JALAPA DE DÍAZ,134,SECCIÓN FABIÁN,3,36,13,23,4
OAXACA,20,SAN FELIPE JALAPA DE DÍAZ,134,SECCIÓN LAVIDA,3,24,7,17,4
OAXACA,20,SAN FELIPE TEJALÁPAM,135,EL CHILAR,1,59,34,25,4
OAXACA,20,SAN FELIPE TEJALÁPAM,135,EL PAREDÓN,1,51,29,22,3
OAXACA,20,SAN FELIPE TEJALÁPAM,135,JALAPA DEL VALLE,3,318,165,153,18
OAXACA,20,SAN FELIPE TEJALÁPAM,135,LA AURORA,1,36,19,17,6
OAXACA,20,SAN FELIPE TEJALÁPAM,135,LA UNIÓN,3,280,149,131,17
OAXACA,20,SAN FELIPE TEJALÁPAM,135,SAN FELIPE TEJALÁPAM,5,1133,668,465,55
OAXACA,20,SAN FELIPE USILA,136,ARROYO AGUACATE,3,60,30,30,4
OAXACA,20,SAN FELIPE USILA,136,ARROYO IGUANA,5,164,77,87,10
OAXACA,20,SAN FELIPE USILA,136,ARROYO TAMBOR,4,141,70,71,9
OAXACA,20,SAN FELIPE USILA,136,ARROYO TIGRE,2,52,31,21,3
OAXACA,20,SAN FELIPE USILA,136,BENITO JUÁREZ [COLONIA],1,6,3,3,1
OAXACA,20,SAN FELIPE USILA,136,CARACOLES ESTRELLA,2,27,15,12,2
OAXACA,20,SAN FELIPE USILA,136,CERRO CARACOL,2,47,24,23,3
OAXACA,20,SAN FELIPE USILA,136,CERRO DE HOJAS,2,30,19,11,2
OAXACA,20,SAN FELIPE USILA,136,CERRO VERDE,1,31,14,17,2
OAXACA,20,SAN FELIPE USILA,136,LÁZARO CÁRDENAS,3,62,22,40,5
OAXACA,20,SAN FELIPE USILA,136,NUEVO ARROYO TAMBOR EL CARACOL,1,15,7,8,1
OAXACA,20,SAN FELIPE USILA,136,NUEVO SANTA FLORA,3,33,17,16,3
OAXACA,20,SAN FELIPE USILA,136,PASO ESCALERAS,3,128,60,68,8
OAXACA,20,SAN FELIPE USILA,136,PEÑA BLANCA,2,69,30,39,4
OAXACA,20,SAN FELIPE USILA,136,PEÑA BLANCA (COLONIA SAN MARTÍN PEÑA BLANCA),1,5,2,3,1
OAXACA,20,SAN FELIPE USILA,136,PIEDRA DE AZÚCAR,2,52,25,27,3
OAXACA,20,SAN FELIPE USILA,136,SAN ANTONIO ANALCO,1,30,14,16,2
OAXACA,20,SAN FELIPE USILA,136,SAN ANTONIO DEL BARRIO,2,35,15,20,3
OAXACA,20,SAN FELIPE USILA,136,SAN FELIPE USILA,10,1932,952,980,93
OAXACA,20,SAN FELIPE USILA,136,SAN PEDRO TLATEPUSCO,2,43,22,21,3
OAXACA,20,SAN FELIPE USILA,136,SANTA CRUZ TEPETOTUTLA,3,113,61,52,9
OAXACA,20,SAN FELIPE USILA,136,SANTA FLORA,4,148,67,81,9
OAXACA,20,SAN FELIPE USILA,136,SANTIAGO TLATEPUSCO,3,173,78,95,10
OAXACA,20,SAN FELIPE USILA,136,SANTO TOMÁS TEXAS,3,88,37,51,6
OAXACA,20,SAN FRANCISCO CAHUACUÁ,137,EL ALAZÁN,3,30,12,18,3
OAXACA,20,SAN FRANCISCO CAHUACUÁ,137,LA CIÉNEGA,2,8,5,3,2
OAXACA,20,SAN FRANCISCO CAHUACUÁ,137,LLANO DE AGUA,3,153,80,73,11
OAXACA,20,SAN FRANCISCO CAHUACUÁ,137,SAN FRANCISCO CAHUACUÁ,4,264,136,128,15
OAXACA,20,SAN FRANCISCO CAHUACUÁ,137,SAN ISIDRO EL POTRERO,3,138,70,68,11
OAXACA,20,SAN FRANCISCO CAHUACUÁ,137,SAN SEBASTIÁN YUTANINO,4,274,136,138,17
OAXACA,20,SAN FRANCISCO CAHUACUÁ,137,UNIÓN Y PROGRESO,2,58,24,34,5
OAXACA,20,SAN FRANCISCO CAJONOS,138,SAN FRANCISCO CAJONOS,2,28,16,12,2
OAXACA,20,SAN FRANCISCO CAJONOS,138,SAN MIGUEL CAJONOS,2,24,13,11,5
OAXACA,20,SAN FRANCISCO CHAPULAPA,139,EL OCOTAL,3,40,19,21,8
OAXACA,20,SAN FRANCISCO CHAPULAPA,139,GUADALUPE SIETE CERROS,3,103,57,46,10
OAXACA,20,SAN FRANCISCO CHAPULAPA,139,HIERBA BUENA,2,39,21,18,8
OAXACA,20,SAN FRANCISCO CHAPULAPA,139,LA REFORMA,3,36,20,16,4
OAXACA,20,SAN FRANCISCO CHAPULAPA,139,RANCHO PINABETE,1,7,4,3,1
OAXACA,20,SAN FRANCISCO CHAPULAPA,139,SAN ALEJO EL PROGRESO,3,148,85,63,12
OAXACA,20,SAN FRANCISCO CHAPULAPA,139,SAN FRANCISCO CHAPULAPA,4,162,94,68,15
OAXACA,20,SAN FRANCISCO CHAPULAPA,139,SANTO TOMÁS,3,35,22,13,3
OAXACA,20,SAN FRANCISCO CHINDÚA,140,SAN FRANCISCO CHINDÚA,4,101,48,53,11
OAXACA,20,SAN FRANCISCO DEL MAR,141,COLONIA VILLANUEVA,3,70,41,29,4
OAXACA,20,SAN FRANCISCO DEL MAR,141,EL VERGEL DEL MAÍZ,2,53,26,27,4
OAXACA,20,SAN FRANCISCO DEL MAR,141,PUERTO ESTERO,2,25,9,16,2
OAXACA,20,SAN FRANCISCO DEL MAR,141,PUERTO GRANDE,1,39,21,18,6
OAXACA,20,SAN FRANCISCO DEL MAR,141,SAN FRANCISCO DEL MAR,2,148,71,77,9
OAXACA,20,SAN FRANCISCO DEL MAR,141,SAN FRANCISCO DEL MAR PUEBLO VIEJO,16,1925,1002,923,108
OAXACA,20,SAN FRANCISCO DEL MAR,141,SANTA CRUZ,4,93,53,40,11
OAXACA,20,SAN FRANCISCO DEL MAR,141,SANTA RITA,4,250,109,141,14
OAXACA,20,SAN FRANCISCO HUEHUETLÁN,142,PAPALOCUATLA,1,9,3,6,1
OAXACA,20,SAN FRANCISCO HUEHUETLÁN,142,SAN FRANCISCO HUEHUETLÁN,5,139,66,73,13
OAXACA,20,SAN FRANCISCO IXHUATÁN,143,20 DE NOVIEMBRE,3,206,117,89,14
OAXACA,20,SAN FRANCISCO IXHUATÁN,143,CERRO CHICO (CERRITOS),2,128,73,55,9
OAXACA,20,SAN FRANCISCO IXHUATÁN,143,CERRO GRANDE,2,71,36,35,8
OAXACA,20,SAN FRANCISCO IXHUATÁN,143,CHAHUITES LAS CONCHAS,2,58,32,26,9
OAXACA,20,SAN FRANCISCO IXHUATÁN,143,LAS PALMAS,3,93,47,46,9
OAXACA,20,SAN FRANCISCO IXHUATÁN,143,REFORMA AGRARIA INTEGRAL,2,48,25,23,9
OAXACA,20,SAN FRANCISCO IXHUATÁN,143,RÍO VIEJO,2,45,25,20,9
OAXACA,20,SAN FRANCISCO IXHUATÁN,143,SAN FRANCISCO IXHUATÁN,17,1838,962,876,159
OAXACA,20,SAN FRANCISCO JALTEPETONGO,144,SAN FRANCISCO JALTEPETONGO,5,176,96,80,15
OAXACA,20,SAN FRANCISCO JALTEPETONGO,144,SAN ISIDRO JALTEPETONGO,2,39,16,23,3
OAXACA,20,SAN FRANCISCO LACHIGOLÓ,145,SAN FRANCISCO LACHIGOLÓ,3,346,175,171,21
OAXACA,20,SAN FRANCISCO LOGUECHE,146,BRAMADERO,3,175,99,76,13
OAXACA,20,SAN FRANCISCO LOGUECHE,146,EL COSTOCHE,3,202,117,85,14
OAXACA,20,SAN FRANCISCO LOGUECHE,146,EL GUAYABO,2,48,25,23,9
OAXACA,20,SAN FRANCISCO LOGUECHE,146,SAN FRANCISCO LOGUECHE,4,288,150,138,20
OAXACA,20,SAN FRANCISCO NUXAÑO,147,SAN FRANCISCO NUXAÑO,2,46,24,22,8
OAXACA,20,SAN FRANCISCO OZOLOTEPEC,148,SAN FRANCISCO OZOLOTEPEC,4,386,213,173,21
OAXACA,20,SAN FRANCISCO OZOLOTEPEC,148,SAN JOSÉ OZOLOTEPEC,3,122,68,54,11
OAXACA,20,SAN FRANCISCO OZOLOTEPEC,148,SAN JUAN GUIVINI,3,189,107,82,13
OAXACA,20,SAN FRANCISCO SOLA,149,EL OBISPO,2,7,3,4,1
OAXACA,20,SAN FRANCISCO SOLA,149,GOTZENGO,2,16,10,6,2
OAXACA,20,SAN FRANCISCO SOLA,149,PIE DE GUITILLETE,1,73,36,37,3
OAXACA,20,SAN FRANCISCO SOLA,149,QUIALELÁ,2,25,7,18,3
OAXACA,20,SAN FRANCISCO SOLA,149,SAN FRANCISCO SOLA,2,369,183,186,17
OAXACA,20,SAN FRANCISCO SOLA,149,SHILEGUA,2,18,8,10,2
OAXACA,20,SAN FRANCISCO TELIXTLAHUACA,150,EL NUEVO MANZANITO,3,24,10,14,3
OAXACA,20,SAN FRANCISCO TELIXTLAHUACA,150,LAS TRANCAS,2,6,5,1,1
OAXACA,20,SAN FRANCISCO TELIXTLAHUACA,150,PLAN SECO,3,27,17,10,3
OAXACA,20,SAN FRANCISCO TELIXTLAHUACA,150,SAN FRANCISCO TELIXTLAHUACA,14,2878,1639,1239,193
OAXACA,20,SAN FRANCISCO TELIXTLAHUACA,150,SAN ISIDRO OJO DE AGUA,3,72,38,34,12
OAXACA,20,SAN FRANCISCO TELIXTLAHUACA,150,SAN SEBASTIÁN SEDAS,3,89,46,43,12
OAXACA,20,SAN FRANCISCO TELIXTLAHUACA,150,SANTA CRUZ EL SALTO,2,22,13,9,3
OAXACA,20,SAN FRANCISCO TELIXTLAHUACA,150,TIERRA COLORADA,1,7,4,3,1
OAXACA,20,SAN FRANCISCO TEOPAN,151,LLANO GRANDE,2,10,6,4,2
OAXACA,20,SAN FRANCISCO TEOPAN,151,SAN FRANCISCO TEOPAN,3,52,27,25,10
OAXACA,20,SAN FRANCISCO TLAPANCINGO,152,BARRIO DEL CARMEN,2,25,13,12,7
OAXACA,20,SAN FRANCISCO TLAPANCINGO,152,GUADALUPE NOGALES,3,186,109,77,17
OAXACA,20,SAN FRANCISCO TLAPANCINGO,152,SAN FRANCISCO TLAPANCINGO,4,333,204,129,24
OAXACA,20,SAN FRANCISCO TLAPANCINGO,152,SAN MARCOS NATIVIDAD,3,165,96,69,13
OAXACA,20,SAN GABRIEL MIXTEPEC,153,ARROYO TIGRE,2,16,7,9,2
OAXACA,20,SAN GABRIEL MIXTEPEC,153,CACALOTE,1,4,2,2,1
OAXACA,20,SAN GABRIEL MIXTEPEC,153,EL CAMARÓN,2,7,3,4,1
OAXACA,20,SAN GABRIEL MIXTEPEC,153,LA CAÑADA SAN MIGUELITO,1,2,0,2,1
OAXACA,20,SAN GABRIEL MIXTEPEC,153,LA CRUZ,2,21,11,10,1
OAXACA,20,SAN GABRIEL MIXTEPEC,153,SAN GABRIEL MIXTEPEC,6,1186,626,560,67
OAXACA,20,SAN GABRIEL MIXTEPEC,153,SAN ISIDRO EL CUIL,3,72,35,37,6
OAXACA,20,SAN GABRIEL MIXTEPEC,153,SANTA MARÍA,3,67,28,39,7
OAXACA,20,SAN GABRIEL MIXTEPEC,153,SANTO NIÑO,1,7,2,5,4
OAXACA,20,SAN ILDEFONSO AMATLÁN,154,EL EXTEBE,2,34,20,14,3
OAXACA,20,SAN ILDEFONSO AMATLÁN,154,LA PAZ XANAGUÍA,3,35,17,18,4
OAXACA,20,SAN ILDEFONSO AMATLÁN,154,LA REFORMA,3,91,50,41,12
OAXACA,20,SAN ILDEFONSO AMATLÁN,154,SAN ILDEFONSO AMATLÁN,3,220,104,116,15
OAXACA,20,SAN ILDEFONSO AMATLÁN,154,SANTO DOMINGO AMATLÁN,3,45,28,17,8
OAXACA,20,SAN ILDEFONSO AMATLÁN,154,YOJUELA,4,127,71,56,15
OAXACA,20,SAN ILDEFONSO SOLA,155,BARRIO ZANIZA,3,45,18,27,6
OAXACA,20,SAN ILDEFONSO SOLA,155,PEÑA DEL CHIVO,2,14,6,8,1
OAXACA,20,SAN ILDEFONSO SOLA,155,SAN ILDEFONSO SOLA,2,55,29,26,9
OAXACA,20,SAN ILDEFONSO SOLA,155,SAN ILDEFONSO VIEJO,2,64,34,30,4
OAXACA,20,SAN ILDEFONSO SOLA,155,YOCUÁ,2,16,10,6,3
OAXACA,20,SAN ILDEFONSO VILLA ALTA,156,SAN FRANCISCO YATEE,3,63,31,32,6
OAXACA,20,SAN ILDEFONSO VILLA ALTA,156,SAN ILDEFONSO VILLA ALTA,4,391,173,218,27
OAXACA,20,SAN ILDEFONSO VILLA ALTA,156,SAN JUAN TAGUI,2,58,27,31,3
OAXACA,20,SAN ILDEFONSO VILLA ALTA,156,SAN JUAN YALAHUI,3,102,54,48,7
OAXACA,20,SAN ILDEFONSO VILLA ALTA,156,SAN JUAN YETZECOVI,2,29,13,16,3
OAXACA,20,SAN ILDEFONSO VILLA ALTA,156,SANTA CATARINA YETZELALAG,2,56,26,30,4
OAXACA,20,SAN JACINTO AMILPAS,157,SAN JACINTO AMILPAS,30,4797,2532,2265,313
OAXACA,20,SAN JACINTO TLACOTEPEC,158,CUAJINICUIL,3,166,94,72,11
OAXACA,20,SAN JACINTO TLACOTEPEC,158,EL OBSCURO,3,22,8,14,9
OAXACA,20,SAN JACINTO TLACOTEPEC,158,EL VENADO,3,86,47,39,11
OAXACA,20,SAN JACINTO TLACOTEPEC,158,RÍO TRAPICHE,3,37,17,20,4
OAXACA,20,SAN JACINTO TLACOTEPEC,158,SAN ISIDRO EL VIEJO (LA ZONGA),3,12,5,7,2
OAXACA,20,SAN JACINTO TLACOTEPEC,158,SAN JACINTO TLACOTEPEC,5,289,145,144,16
OAXACA,20,SAN JERÓNIMO COATLÁN,159,BUENA VISTA,2,10,5,5,2
OAXACA,20,SAN JERÓNIMO COATLÁN,159,BUGAMBILIAS,3,36,16,20,4
OAXACA,20,SAN JERÓNIMO COATLÁN,159,CERRO SOL,2,5,5,0,1
OAXACA,20,SAN JERÓNIMO COATLÁN,159,EL MIRADOR,2,57,26,31,4
OAXACA,20,SAN JERÓNIMO COATLÁN,159,EL PROGRESO,3,37,18,19,8
OAXACA,20,SAN JERÓNIMO COATLÁN,159,JUNTA DE LOS RÍOS,2,7,5,2,1
OAXACA,20,SAN JERÓNIMO COATLÁN,159,LA JUQUILITA,3,30,16,14,3
OAXACA,20,SAN JERÓNIMO COATLÁN,159,LAS PALMAS,3,175,81,94,11
OAXACA,20,SAN JERÓNIMO COATLÁN,159,LLANO DE LEÓN,3,146,67,79,9
OAXACA,20,SAN JERÓNIMO COATLÁN,159,RÍO PIEDRA,3,42,27,15,6
OAXACA,20,SAN JERÓNIMO COATLÁN,159,RÍO VÍBORA (TRES RÍOS),1,6,5,1,1
OAXACA,20,SAN JERÓNIMO COATLÁN,159,SAN CRISTÓBAL HONDURAS,3,212,117,95,13
OAXACA,20,SAN JERÓNIMO COATLÁN,159,SAN JERÓNIMO COATLÁN,4,271,158,113,15
OAXACA,20,SAN JERÓNIMO COATLÁN,159,SAN LUCAS,3,28,18,10,3
OAXACA,20,SAN JERÓNIMO COATLÁN,159,SANTO DOMINGO COATLÁN,3,85,45,40,12
OAXACA,20,SAN JERÓNIMO COATLÁN,159,SOLEDAD PIEDRA LARGA,3,168,75,93,12
OAXACA,20,SAN JERÓNIMO COATLÁN,159,TIERRA BLANCA,1,7,4,3,1
OAXACA,20,SAN JERÓNIMO SILACAYOAPILLA,160,EL SABINO,2,23,10,13,9
OAXACA,20,SAN JERÓNIMO SILACAYOAPILLA,160,SAN JERÓNIMO SILACAYOAPILLA,3,230,126,104,15
OAXACA,20,SAN JERÓNIMO SILACAYOAPILLA,160,TEJALTITLÁN,2,23,10,13,4
OAXACA,20,SAN JERÓNIMO SOSOLA,161,CIENEGUILLA,2,23,8,15,3
OAXACA,20,SAN JERÓNIMO SOSOLA,161,CRUZ DE PIEDRA,2,20,10,10,6
OAXACA,20,SAN JERÓNIMO SOSOLA,161,MINAS DE LLANO VERDE,2,47,25,22,9
OAXACA,20,SAN JERÓNIMO SOSOLA,161,OJO DE AGUA,1,10,4,6,1
OAXACA,20,SAN JERÓNIMO SOSOLA,161,RÍO FLORIDO SOSOLA,2,9,4,5,2
OAXACA,20,SAN JERÓNIMO SOSOLA,161,SAN JERÓNIMO SOSOLA,3,64,34,30,12
OAXACA,20,SAN JERÓNIMO SOSOLA,161,SAN JOSÉ SOSOLA,3,27,10,17,10
OAXACA,20,SAN JERÓNIMO SOSOLA,161,SAN JUAN SOSOLA,2,10,5,5,1
OAXACA,20,SAN JERÓNIMO SOSOLA,161,SAN MATEO SOSOLA,4,152,82,70,16
OAXACA,20,SAN JERÓNIMO SOSOLA,161,SANTA LUCÍA SOSOLA,3,88,45,43,12
OAXACA,20,SAN JERÓNIMO SOSOLA,161,SANTA MARÍA TEJOTEPEC,2,14,7,7,6
OAXACA,20,SAN JERÓNIMO TAVICHE,162,SAN JERÓNIMO TAVICHE,5,492,268,224,27
OAXACA,20,SAN JERÓNIMO TECÓATL,163,LOS NARANJOS,3,91,44,47,9
OAXACA,20,SAN JERÓNIMO TECÓATL,163,PLAN DE GUADALUPE,3,116,59,57,10
OAXACA,20,SAN JERÓNIMO TECÓATL,163,SAN JERÓNIMO TECÓATL,3,140,63,77,11
OAXACA,20,SAN JORGE NUCHITA,164,GUADALUPE DE MORELOS,3,101,57,44,11
OAXACA,20,SAN JORGE NUCHITA,164,SAN JORGE NUCHITA,4,465,266,199,28
OAXACA,20,SAN JORGE NUCHITA,164,SAN MIGUEL ALLENDE,2,38,19,19,8
OAXACA,20,SAN JOSÉ AYUQUILA,165,EL CENTENARIO,2,46,25,21,9
OAXACA,20,SAN JOSÉ AYUQUILA,165,SAN JOSÉ AYUQUILA,4,615,332,283,44
OAXACA,20,SAN JOSÉ AYUQUILA,165,SAN RAFAEL,2,40,21,19,8
OAXACA,20,SAN JOSÉ CHILTEPEC,166,ARROYO CHOÁPAM,5,269,130,139,21
OAXACA,20,SAN JOSÉ CHILTEPEC,166,ARROYO FRIJOL,3,158,75,83,11
OAXACA,20,SAN JOSÉ CHILTEPEC,166,CERRO FLORES,2,57,27,30,5
OAXACA,20,SAN JOSÉ CHILTEPEC,166,EL FORTÍN,4,47,20,27,5
OAXACA,20,SAN JOSÉ CHILTEPEC,166,EL TABLERO,2,12,8,4,1
OAXACA,20,SAN JOSÉ CHILTEPEC,166,FORTINO J. PINACHO,3,115,55,60,12
OAXACA,20,SAN JOSÉ CHILTEPEC,166,LA GUADALUPE,3,45,21,24,3
OAXACA,20,SAN JOSÉ CHILTEPEC,166,LA JOYA MANANTIAL,3,29,15,14,3
OAXACA,20,SAN JOSÉ CHILTEPEC,166,LEYES DE REFORMA,2,53,20,33,4
OAXACA,20,SAN JOSÉ CHILTEPEC,166,PLAN DE ÁGUILA,2,19,13,6,2
OAXACA,20,SAN JOSÉ CHILTEPEC,166,PUEBLO VIEJO,4,323,169,154,19
OAXACA,20,SAN JOSÉ CHILTEPEC,166,ROBERTO OLIVARES ARELLANO,1,16,6,10,1
OAXACA,20,SAN JOSÉ CHILTEPEC,166,SAN FELIPE,2,129,64,65,9
OAXACA,20,SAN JOSÉ CHILTEPEC,166,SAN ISIDRO NARANJAL,3,132,62,70,11
OAXACA,20,SAN JOSÉ CHILTEPEC,166,SAN JOSÉ CHILTEPEC,10,1076,531,545,63
OAXACA,20,SAN JOSÉ CHILTEPEC,166,TIERRA NEGRA,1,41,24,17,3
OAXACA,20,SAN JOSÉ DEL PEÑASCO,167,EL TABAJE,3,117,61,56,10
OAXACA,20,SAN JOSÉ DEL PEÑASCO,167,EL YAGALÁN,3,118,66,52,13
OAXACA,20,SAN JOSÉ DEL PEÑASCO,167,LA LABOR,2,52,29,23,5
OAXACA,20,SAN JOSÉ DEL PEÑASCO,167,LA OCOTERA,2,30,11,19,2
OAXACA,20,SAN JOSÉ DEL PEÑASCO,167,LOMA GRANDE,2,15,9,6,2
OAXACA,20,SAN JOSÉ DEL PEÑASCO,167,SAN JOSÉ DEL PEÑASCO,4,180,98,82,14
OAXACA,20,SAN JOSÉ ESTANCIA GRANDE,168,SAN JOSÉ ESTANCIA GRANDE,4,232,108,124,16
OAXACA,20,SAN JOSÉ INDEPENDENCIA,169,BUENOS AIRES,4,230,96,134,13
OAXACA,20,SAN JOSÉ INDEPENDENCIA,169,CERRO CHAPULTEPEC,3,97,45,52,7
OAXACA,20,SAN JOSÉ INDEPENDENCIA,169,CERRO CLARÍN,5,259,136,123,19
OAXACA,20,SAN JOSÉ INDEPENDENCIA,169,CERRO LAGUNA,2,49,24,25,4
OAXACA,20,SAN JOSÉ INDEPENDENCIA,169,CERRO TORITO,2,44,20,24,4
OAXACA,20,SAN JOSÉ INDEPENDENCIA,169,EL TEPEYAC,2,42,23,19,4
OAXACA,20,SAN JOSÉ INDEPENDENCIA,169,SAN JOSÉ INDEPENDENCIA,5,367,165,202,17
OAXACA,20,SAN JOSÉ LACHIGUIRI,170,NIZAGOCHE,3,184,101,83,13
OAXACA,20,SAN JOSÉ LACHIGUIRI,170,NUESTRA SEÑORA INMACULADA DE JUQUILA EL CARRIZAL,2,19,9,10,7
OAXACA,20,SAN JOSÉ LACHIGUIRI,170,RANCHO MIJANGOS,1,15,6,9,6
OAXACA,20,SAN JOSÉ LACHIGUIRI,170,SAN JOSÉ LACHIGUIRI,4,338,189,149,31
OAXACA,20,SAN JOSÉ LACHIGUIRI,170,SANTA MARÍA LACHIVIGOZA,3,182,88,94,11
OAXACA,20,SAN JOSÉ TENANGO,171,AGUA CABALLERO,2,45,23,22,8
OAXACA,20,SAN JOSÉ TENANGO,171,AGUA CAMARÓN (SAN MARTÍN),3,25,13,12,3
OAXACA,20,SAN JOSÉ TENANGO,171,AGUA CIÉNEGA,3,116,64,52,12
OAXACA,20,SAN JOSÉ TENANGO,171,AGUA COLORADA,3,112,58,54,12
OAXACA,20,SAN JOSÉ TENANGO,171,AGUA DE ACEITE,1,18,8,10,6
OAXACA,20,SAN JOSÉ TENANGO,171,AGUA DE CEDRO,3,53,27,26,10
OAXACA,20,SAN JOSÉ TENANGO,171,AGUA DE GOLONDRINA,3,61,33,28,10
OAXACA,20,SAN JOSÉ TENANGO,171,AGUA DE GRILLO,2,57,31,26,9
OAXACA,20,SAN JOSÉ TENANGO,171,AGUA DE RAYO,2,24,11,13,8
OAXACA,20,SAN JOSÉ TENANGO,171,AGUA GOLONDRINA SECCIÓN II,2,17,9,8,2
OAXACA,20,SAN JOSÉ TENANGO,171,AGUA PARED,1,29,15,14,6
OAXACA,20,SAN JOSÉ TENANGO,171,AGUA PESCADO,2,78,43,35,9
OAXACA,20,SAN JOSÉ TENANGO,171,AGUA PLATANILLO,1,9,3,6,1
OAXACA,20,SAN JOSÉ TENANGO,171,AGUA SAN JOSÉ,2,13,7,6,2
OAXACA,20,SAN JOSÉ TENANGO,171,AGUA VERDE,1,25,14,11,2
OAXACA,20,SAN JOSÉ TENANGO,171,AGUACATITLA,3,88,47,41,11
OAXACA,20,SAN JOSÉ TENANGO,171,ALTAMIRA,3,110,56,54,11
OAXACA,20,SAN JOSÉ TENANGO,171,BARRIO SAN JERÓNIMO,1,16,8,8,1
OAXACA,20,SAN JOSÉ TENANGO,171,CAMINO DE YESO,2,24,12,12,8
OAXACA,20,SAN JOSÉ TENANGO,171,CAÑADA DE MAMEY,3,67,35,32,10
OAXACA,20,SAN JOSÉ TENANGO,171,CAÑADA GRANDE,1,20,10,10,1
OAXACA,20,SAN JOSÉ TENANGO,171,CERRO ÁLAMO,2,20,6,14,7
OAXACA,20,SAN JOSÉ TENANGO,171,CERRO ALTO,1,9,5,4,1
OAXACA,20,SAN JOSÉ TENANGO,171,CERRO CABALLERO,2,81,44,37,9
OAXACA,20,SAN JOSÉ TENANGO,171,CERRO CENTRAL,5,174,93,81,12
OAXACA,20,SAN JOSÉ TENANGO,171,CERRO LIQUIDÁMBAR,2,38,0,38,7
OAXACA,20,SAN JOSÉ TENANGO,171,CERRO NEGRO,2,7,5,2,1
OAXACA,20,SAN JOSÉ TENANGO,171,CERRO OTATE,3,114,62,52,10
OAXACA,20,SAN JOSÉ TENANGO,171,CERRO PALMERA,3,128,63,65,12
OAXACA,20,SAN JOSÉ TENANGO,171,CERRO RABÓN,3,33,18,15,4
OAXACA,20,SAN JOSÉ TENANGO,171,CERRO TOTOMOXTLE,2,12,6,6,1
OAXACA,20,SAN JOSÉ TENANGO,171,CERRO TRUENO,2,62,32,30,4
OAXACA,20,SAN JOSÉ TENANGO,171,CERRO VERDE [RANCHO],2,15,7,8,2
OAXACA,20,SAN JOSÉ TENANGO,171,GÉNOVA NUEVO PROGRESO,1,18,8,10,1
OAXACA,20,SAN JOSÉ TENANGO,171,LAS MARAVILLAS,2,12,2,10,1
OAXACA,20,SAN JOSÉ TENANGO,171,LAS RUINAS,3,86,50,36,10
OAXACA,20,SAN JOSÉ TENANGO,171,LLANO DE ÁRNICA,3,176,94,82,12
OAXACA,20,SAN JOSÉ TENANGO,171,LLANO NUEVO DE LA CRUZ,2,34,19,15,7
OAXACA,20,SAN JOSÉ TENANGO,171,LOMA ALTA CERRO CENTRAL,1,15,9,6,1
OAXACA,20,SAN JOSÉ TENANGO,171,LOMA ALTA TIERRA COLORADA,2,15,8,7,2
OAXACA,20,SAN JOSÉ TENANGO,171,MINA DE ARENA,2,50,27,23,8
OAXACA,20,SAN JOSÉ TENANGO,171,PALO GORDO,1,4,0,4,1
OAXACA,20,SAN JOSÉ TENANGO,171,PIEDRA ANCHA,3,27,9,18,4
OAXACA,20,SAN JOSÉ TENANGO,171,PIEDRA DEL SOL,2,64,35,29,8
OAXACA,20,SAN JOSÉ TENANGO,171,PIEDRAS NEGRAS,2,45,22,23,8
OAXACA,20,SAN JOSÉ TENANGO,171,PLAN DE LAGUNA,2,27,11,16,8
OAXACA,20,SAN JOSÉ TENANGO,171,POZO DE ÁGUILA,3,90,50,40,11
OAXACA,20,SAN JOSÉ TENANGO,171,PUERTO BUENAVISTA,4,191,93,98,12
OAXACA,20,SAN JOSÉ TENANGO,171,RANCHO CERQUEDA,1,9,5,4,1
OAXACA,20,SAN JOSÉ TENANGO,171,RANCHO GUADALUPE,3,89,49,40,10
OAXACA,20,SAN JOSÉ TENANGO,171,RANCHO HERNÁNDEZ,2,46,25,21,9
OAXACA,20,SAN JOSÉ TENANGO,171,RANCHO MARTÍNEZ CENTRAL,3,16,7,9,3
OAXACA,20,SAN JOSÉ TENANGO,171,RANCHO MORELOS,2,11,4,7,1
OAXACA,20,SAN JOSÉ TENANGO,171,RANCHO PEINECILLO,2,15,5,10,2
OAXACA,20,SAN JOSÉ TENANGO,171,RANCHO PINEDA,3,30,15,15,4
OAXACA,20,SAN JOSÉ TENANGO,171,SAN ISIDRO,1,5,2,3,1
OAXACA,20,SAN JOSÉ TENANGO,171,SAN JOSÉ TENANGO,6,876,502,374,52
OAXACA,20,SAN JOSÉ TENANGO,171,SAN MARTÍN CABALLERO,3,88,43,45,12
OAXACA,20,SAN JOSÉ TENANGO,171,SANTA CATARINA,3,44,24,20,4
OAXACA,20,SAN JOSÉ TENANGO,171,SITIO CABALLERO,1,30,15,15,6
OAXACA,20,SAN JOSÉ TENANGO,171,SITIO IGLESIA,3,106,59,47,10
OAXACA,20,SAN JOSÉ TENANGO,171,TEOCUATLÁN,3,278,155,123,20
OAXACA,20,SAN JOSÉ TENANGO,171,TIERRA COLORADA (AGUA COLORADA),1,40,22,18,3
OAXACA,20,SAN JOSÉ TENANGO,171,UNIÓN DE HIDALGO,3,101,47,54,6
OAXACA,20,SAN JOSÉ TENANGO,171,VISTA HERMOSA,1,14,6,8,6
OAXACA,20,SAN JUAN ACHIUTLA,172,SAN JUAN ACHIUTLA,4,96,48,48,13
OAXACA,20,SAN JUAN ATEPEC,173,AMPLIACIÓN BARRIO DE SAN MIGUEL,1,133,61,72,9
OAXACA,20,SAN JUAN ATEPEC,173,SAN JUAN ATEPEC,3,201,109,92,13
OAXACA,20,ÁNIMAS TRUJANO,174,ÁNIMAS TRUJANO,6,1487,760,727,72
OAXACA,20,SAN JUAN BAUTISTA ATATLAHUCA,175,EL PORVENIR,3,112,50,62,8
OAXACA,20,SAN JUAN BAUTISTA ATATLAHUCA,175,SAN JUAN BAUTISTA ATATLAHUCA,4,147,81,66,15
OAXACA,20,SAN JUAN BAUTISTA ATATLAHUCA,175,ZOQUIÁPAM BOCA DE LOS RÍOS,3,82,44,38,11
OAXACA,20,SAN JUAN BAUTISTA COIXTLAHUACA,176,ESTANCIA,2,32,16,16,4
OAXACA,20,SAN JUAN BAUTISTA COIXTLAHUACA,176,LA CIÉNEGA,1,88,40,48,5
OAXACA,20,SAN JUAN BAUTISTA COIXTLAHUACA,176,RÍO BLANCO,3,129,58,71,9
OAXACA,20,SAN JUAN BAUTISTA COIXTLAHUACA,176,RÍO POBLANO,3,73,26,47,7
OAXACA,20,SAN JUAN BAUTISTA COIXTLAHUACA,176,SAN JERÓNIMO OTLA,1,8,4,4,1
OAXACA,20,SAN JUAN BAUTISTA COIXTLAHUACA,176,SAN JUAN BAUTISTA COIXTLAHUACA,4,439,227,212,27
OAXACA,20,SAN JUAN BAUTISTA COIXTLAHUACA,176,SANTA CATARINA OCOTLÁN,3,84,35,49,7
OAXACA,20,SAN JUAN BAUTISTA CUICATLÁN,177,EL ÁGUILA ALMOLOYAS,2,4,0,4,2
OAXACA,20,SAN JUAN BAUTISTA CUICATLÁN,177,EL CACIQUE,2,29,11,18,2
OAXACA,20,SAN JUAN BAUTISTA CUICATLÁN,177,GUADALUPE DE LOS OBOS,2,45,23,22,9
OAXACA,20,SAN JUAN BAUTISTA CUICATLÁN,177,LA CRUZ,2,9,3,6,2
OAXACA,20,SAN JUAN BAUTISTA CUICATLÁN,177,LA GARITA,1,34,20,14,3
OAXACA,20,SAN JUAN BAUTISTA CUICATLÁN,177,SAN FRANCISCO TUTEPETONGO,3,150,85,65,13
OAXACA,20,SAN JUAN BAUTISTA CUICATLÁN,177,SAN GABRIEL ALMOLOYA,2,36,15,21,7
OAXACA,20,SAN JUAN BAUTISTA CUICATLÁN,177,SAN JOSÉ DEL CHILAR,4,226,125,101,18
OAXACA,20,SAN JUAN BAUTISTA CUICATLÁN,177,SAN JUAN BAUTISTA CUICATLÁN,13,1499,783,716,116
OAXACA,20,SAN JUAN BAUTISTA CUICATLÁN,177,SAN JUAN COYULA,3,147,71,76,12
OAXACA,20,SAN JUAN BAUTISTA CUICATLÁN,177,SAN PEDRO CHICOZAPOTES,2,104,58,46,9
OAXACA,20,SAN JUAN BAUTISTA CUICATLÁN,177,SAN PEDRO NODÓN,4,59,31,28,9
OAXACA,20,SAN JUAN BAUTISTA CUICATLÁN,177,SANTA CATARINA TLAXILA,1,4,0,4,1
OAXACA,20,SAN JUAN BAUTISTA CUICATLÁN,177,SANTA MARÍA ALMOLOYAS,2,20,10,10,6
OAXACA,20,SAN JUAN BAUTISTA CUICATLÁN,177,SANTIAGO DOMINGUILLO,3,45,21,24,18
OAXACA,20,SAN JUAN BAUTISTA CUICATLÁN,177,SANTIAGO QUIOTEPEC,3,47,20,27,3
OAXACA,20,SAN JUAN BAUTISTA GUELACHE,178,ASUNCIÓN ETLA,2,71,41,30,9
OAXACA,20,SAN JUAN BAUTISTA GUELACHE,178,EL VERGEL,2,74,42,32,27
OAXACA,20,SAN JUAN BAUTISTA GUELACHE,178,SAN GABRIEL ETLA,2,52,28,24,9
OAXACA,20,SAN JUAN BAUTISTA GUELACHE,178,SAN JUAN BAUTISTA GUELACHE,4,196,101,95,14
OAXACA,20,SAN JUAN BAUTISTA GUELACHE,178,SAN MIGUEL ETLA,3,266,155,111,21
OAXACA,20,SAN JUAN BAUTISTA GUELACHE,178,SANTOS DEGOLLADO,2,35,19,16,7
OAXACA,20,SAN JUAN BAUTISTA JAYACATLÁN,179,SAN JUAN BAUTISTA JAYACATLÁN,4,323,189,134,19
OAXACA,20,SAN JUAN BAUTISTA LO DE SOTO,180,SAN JUAN BAUTISTA LO DE SOTO,6,598,285,313,38
OAXACA,20,SAN JUAN BAUTISTA LO DE SOTO,180,SAN PEDRO ORIZABA,3,118,55,63,12
OAXACA,20,SAN JUAN BAUTISTA SUCHITEPEC,181,GUADALUPE CUAUTEPEC,1,90,51,39,6
OAXACA,20,SAN JUAN BAUTISTA SUCHITEPEC,181,SAN JUAN BAUTISTA SUCHITEPEC,4,94,46,48,12
OAXACA,20,SAN JUAN BAUTISTA TLACOATZINTEPEC,182,ARROYO PLATANAL,3,46,20,26,4
OAXACA,20,SAN JUAN BAUTISTA TLACOATZINTEPEC,182,CERRO ESCOPETA,1,13,7,6,1
OAXACA,20,SAN JUAN BAUTISTA TLACOATZINTEPEC,182,LA SOLEDAD,3,79,40,39,6
OAXACA,20,SAN JUAN BAUTISTA TLACOATZINTEPEC,182,SAN ESTEBAN TECTITLÁN,3,80,40,40,5
OAXACA,20,SAN JUAN BAUTISTA TLACOATZINTEPEC,182,SAN JUAN BAUTISTA TLACOATZINTEPEC,5,294,157,137,16
OAXACA,20,SAN JUAN BAUTISTA TLACOATZINTEPEC,182,SAN PEDRO LA ALIANZA,3,98,54,44,11
OAXACA,20,SAN JUAN BAUTISTA TLACHICHILCO,183,AGUA ESCONDIDA,2,14,6,8,2
OAXACA,20,SAN JUAN BAUTISTA TLACHICHILCO,183,GUADALUPE LA LIBERTAD,2,18,6,12,6
OAXACA,20,SAN JUAN BAUTISTA TLACHICHILCO,183,SAN JUAN BAUTISTA TLACHICHILCO,4,207,111,96,15
OAXACA,20,SAN JUAN BAUTISTA TLACHICHILCO,183,SANTA BÁRBARA HUACAPA,2,36,17,19,9
OAXACA,20,SAN JUAN BAUTISTA TLACHICHILCO,183,SANTIAGO GUADALUPE,3,104,56,48,12
OAXACA,20,SAN JUAN BAUTISTA TUXTEPEC,184,AGUA FRÍA PAPALOAPAN,3,226,110,116,16
OAXACA,20,SAN JUAN BAUTISTA TUXTEPEC,184,AGUA FRÍA PIEDRA DEL SOL,1,34,11,23,2
OAXACA,20,SAN JUAN BAUTISTA TUXTEPEC,184,ALTAMIRA,1,19,9,10,1
OAXACA,20,SAN JUAN BAUTISTA TUXTEPEC,184,AMAPA,2,38,17,21,5
OAXACA,20,SAN JUAN BAUTISTA TUXTEPEC,184,ARROYO CHIQUITO,3,68,26,42,6
OAXACA,20,SAN JUAN BAUTISTA TUXTEPEC,184,ARROYO LIMÓN,3,322,157,165,19
OAXACA,20,SAN JUAN BAUTISTA TUXTEPEC,184,ARROYO ZUZULE,3,47,20,27,8
OAXACA,20,SAN JUAN BAUTISTA TUXTEPEC,184,BENEMÉRITO JUÁREZ,5,686,346,340,57
OAXACA,20,SAN JUAN BAUTISTA TUXTEPEC,184,BETHANIA,4,632,317,315,38
OAXACA,20,SAN JUAN BAUTISTA TUXTEPEC,184,BUENAVISTA GALLARDO,2,22,11,11,3
OAXACA,20,SAN JUAN BAUTISTA TUXTEPEC,184,BUENAVISTA RÍO TONTO,3,30,15,15,3
OAXACA,20,SAN JUAN BAUTISTA TUXTEPEC,184,BUENOS AIRES EL APOMPO,4,115,44,71,11
OAXACA,20,SAN JUAN BAUTISTA TUXTEPEC,184,CAMALOTAL,3,239,119,120,12
OAXACA,20,SAN JUAN BAUTISTA TUXTEPEC,184,CAMARÓN SALSIPUEDES,3,141,75,66,13
OAXACA,20,SAN JUAN BAUTISTA TUXTEPEC,184,CAMELIA ROJA,5,541,285,256,25
OAXACA,20,SAN JUAN BAUTISTA TUXTEPEC,184,COLONIA GUADALUPE,1,7,4,3,1
OAXACA,20,SAN JUAN BAUTISTA TUXTEPEC,184,COLONIA OBRERA BENITO JUÁREZ,4,573,303,270,68
OAXACA,20,SAN JUAN BAUTISTA TUXTEPEC,184,COLONIA ORTEGA,2,111,39,72,6
OAXACA,20,SAN JUAN BAUTISTA TUXTEPEC,184,COLONIA ROSALINDA,2,13,7,6,2
OAXACA,20,SAN JUAN BAUTISTA TUXTEPEC,184,COLONIA VÍCTOR BRAVO AHUJA (SEGUNDA ETAPA),1,4,1,3,1
OAXACA,20,SAN JUAN BAUTISTA TUXTEPEC,184,CURVA LAS CONSUEGRAS (EJIDO LAS ÁNIMAS),3,10,7,3,2
OAXACA,20,SAN JUAN BAUTISTA TUXTEPEC,184,EL CEDRAL,4,199,100,99,12
OAXACA,20,SAN JUAN BAUTISTA TUXTEPEC,184,EL CRUCERO,1,54,29,25,3
OAXACA,20,SAN JUAN BAUTISTA TUXTEPEC,184,EL DESENGAÑO,3,63,25,38,5
OAXACA,20,SAN JUAN BAUTISTA TUXTEPEC,184,EL ESCOBILLAL,2,152,70,82,8
OAXACA,20,SAN JUAN BAUTISTA TUXTEPEC,184,EL ESFUERZO,2,59,27,32,4
OAXACA,20,SAN JUAN BAUTISTA TUXTEPEC,184,EL JIMBAL,2,65,33,32,5
OAXACA,20,SAN JUAN BAUTISTA TUXTEPEC,184,EL MANGAL,3,83,35,48,7
OAXACA,20,SAN JUAN BAUTISTA TUXTEPEC,184,EL PARAÍSO ZACATAL,3,67,35,32,6
OAXACA,20,SAN JUAN BAUTISTA TUXTEPEC,184,EL PORVENIR,3,156,83,73,12
OAXACA,20,SAN JUAN BAUTISTA TUXTEPEC,184,EL PROGRESO,2,448,205,243,22
OAXACA,20,SAN JUAN BAUTISTA TUXTEPEC,184,EL PROGRESO (SAN BARTOLO) [RANCHO],2,6,2,4,1
OAXACA,20,SAN JUAN BAUTISTA TUXTEPEC,184,EL YAGUAL,2,42,19,23,4
OAXACA,20,SAN JUAN BAUTISTA TUXTEPEC,184,ESPERANZA ARROYO LA GLORIA,3,106,50,56,6
OAXACA,20,SAN JUAN BAUTISTA TUXTEPEC,184,FRANCISCO I. MADERO (LOS CERRITOS),1,7,4,3,1
OAXACA,20,SAN JUAN BAUTISTA TUXTEPEC,184,FRANCISCO I. MADERO DE LOS CERRITOS RÍO TONTO,1,11,5,6,1
OAXACA,20,SAN JUAN BAUTISTA TUXTEPEC,184,FUENTE MISTERIOSA,3,160,76,84,12
OAXACA,20,SAN JUAN BAUTISTA TUXTEPEC,184,FUENTE VILLA,2,39,25,14,4
OAXACA,20,SAN JUAN BAUTISTA TUXTEPEC,184,GENERAL LÁZARO CÁRDENAS,2,207,120,87,11
OAXACA,20,SAN JUAN BAUTISTA TUXTEPEC,184,IGNACIO ZARAGOZA,2,21,9,12,2
OAXACA,20,SAN JUAN BAUTISTA TUXTEPEC,184,LA CARLOTA,3,53,28,25,6
OAXACA,20,SAN JUAN BAUTISTA TUXTEPEC,184,LA ESMALTA,2,57,29,28,5
OAXACA,20,SAN JUAN BAUTISTA TUXTEPEC,184,LA ESPERANZA,4,121,55,66,9
OAXACA,20,SAN JUAN BAUTISTA TUXTEPEC,184,LA FLORIDA,1,14,4,10,1
OAXACA,20,SAN JUAN BAUTISTA TUXTEPEC,184,LA GLORIA,1,8,4,4,1
OAXACA,20,SAN JUAN BAUTISTA TUXTEPEC,184,LA MINA,3,163,90,73,11
OAXACA,20,SAN JUAN BAUTISTA TUXTEPEC,184,LA REDONDA (BOCA DE COAPA),3,9,4,5,2
OAXACA,20,SAN JUAN BAUTISTA TUXTEPEC,184,LA REFORMA,3,177,89,88,12
OAXACA,20,SAN JUAN BAUTISTA TUXTEPEC,184,LAS DELICIAS,2,37,18,19,6
OAXACA,20,SAN JUAN BAUTISTA TUXTEPEC,184,LIC. IGNACIO MARTÍNEZ BAUTISTA,2,8,8,0,1
OAXACA,20,SAN JUAN BAUTISTA TUXTEPEC,184,LOS GIRASOLES (EJIDO TUXTEPEC) [COLONIA],1,34,11,23,3
OAXACA,20,SAN JUAN BAUTISTA TUXTEPEC,184,LOS MANGALES (LA ESTOPA),2,43,21,22,4
OAXACA,20,SAN JUAN BAUTISTA TUXTEPEC,184,LOS REYES (AMPLIACIÓN SANTA ÚRSULA),2,55,30,25,4
OAXACA,20,SAN JUAN BAUTISTA TUXTEPEC,184,MACÍN CHICO,3,227,108,119,13
OAXACA,20,SAN JUAN BAUTISTA TUXTEPEC,184,MATA DE CAÑA,3,94,52,42,8
OAXACA,20,SAN JUAN BAUTISTA TUXTEPEC,184,MUNDO NUEVO,3,96,56,40,5
OAXACA,20,SAN JUAN BAUTISTA TUXTEPEC,184,OJO DE AGUA,3,117,58,59,7
OAXACA,20,SAN JUAN BAUTISTA TUXTEPEC,184,PAPALOAPAN,5,370,197,173,25
OAXACA,20,SAN JUAN BAUTISTA TUXTEPEC,184,PASO CANOA,4,263,133,130,16
OAXACA,20,SAN JUAN BAUTISTA TUXTEPEC,184,PASO RINCÓN,3,123,62,61,11
OAXACA,20,SAN JUAN BAUTISTA TUXTEPEC,184,PIEDRA QUEMADA,2,46,26,20,5
OAXACA,20,SAN JUAN BAUTISTA TUXTEPEC,184,PIO V BECERRA BALLESTEROS,3,126,58,68,6
OAXACA,20,SAN JUAN BAUTISTA TUXTEPEC,184,PUEBLO NUEVO OJO DE AGUA,3,74,33,41,7
OAXACA,20,SAN JUAN BAUTISTA TUXTEPEC,184,PUEBLO NUEVO PAPALOAPAN,3,380,187,193,24
OAXACA,20,SAN JUAN BAUTISTA TUXTEPEC,184,RANCHO NUEVO JONOTAL,2,54,31,23,6
OAXACA,20,SAN JUAN BAUTISTA TUXTEPEC,184,RODEO ARROYO PEPESCA,3,183,92,91,12
OAXACA,20,SAN JUAN BAUTISTA TUXTEPEC,184,ROSARIO IBARRA DE PIEDRA [CENTRO DE POBLACIÓN],2,38,17,21,3
OAXACA,20,SAN JUAN BAUTISTA TUXTEPEC,184,SAN ANTONIO,1,55,21,34,3
OAXACA,20,SAN JUAN BAUTISTA TUXTEPEC,184,SAN BARTOLO,7,2108,949,1159,162
OAXACA,20,SAN JUAN BAUTISTA TUXTEPEC,184,SAN FELIPE DE LA PEÑA,4,232,120,112,16
OAXACA,20,SAN JUAN BAUTISTA TUXTEPEC,184,SAN FRANCISCO SALSIPUEDES,4,309,160,149,21
OAXACA,20,SAN JUAN BAUTISTA TUXTEPEC,184,SAN ISIDRO LAS PIÑAS,3,45,20,25,9
OAXACA,20,SAN JUAN BAUTISTA TUXTEPEC,184,SAN JOSÉ (EL PORVENIR),1,12,8,4,1
OAXACA,20,SAN JUAN BAUTISTA TUXTEPEC,184,SAN JUAN BAUTISTA DE MATAMOROS,3,183,91,92,12
OAXACA,20,SAN JUAN BAUTISTA TUXTEPEC,184,SAN JUAN BAUTISTA TUXTEPEC,172,28948,15118,13830,1921
OAXACA,20,SAN JUAN BAUTISTA TUXTEPEC,184,SAN MIGUEL OBISPO,2,45,25,20,5
OAXACA,20,SAN JUAN BAUTISTA TUXTEPEC,184,SAN RAFAEL,2,33,15,18,3
OAXACA,20,SAN JUAN BAUTISTA TUXTEPEC,184,SAN SILVERIO EL CEDRAL,4,50,28,22,7
OAXACA,20,SAN JUAN BAUTISTA TUXTEPEC,184,SANTA CATARINA,3,62,29,33,6
OAXACA,20,SAN JUAN BAUTISTA TUXTEPEC,184,SANTA MARÍA AMAPA,1,16,10,6,1
OAXACA,20,SAN JUAN BAUTISTA TUXTEPEC,184,SANTA MARÍA OBISPO,3,134,70,64,11
OAXACA,20,SAN JUAN BAUTISTA TUXTEPEC,184,SANTA ROSA PAPALOAPAN,2,44,19,25,3
OAXACA,20,SAN JUAN BAUTISTA TUXTEPEC,184,SANTA TERESA PAPALOAPAN,3,153,62,91,9
OAXACA,20,SAN JUAN BAUTISTA TUXTEPEC,184,SANTA ÚRSULA,3,97,48,49,9
OAXACA,20,SAN JUAN BAUTISTA TUXTEPEC,184,SEBASTOPOL,3,136,64,72,12
OAXACA,20,SAN JUAN BAUTISTA TUXTEPEC,184,SOLEDAD MACÍN CHICO,3,186,88,98,11
OAXACA,20,SAN JUAN BAUTISTA TUXTEPEC,184,TECOTENO EL TULAR,2,42,17,25,3
OAXACA,20,SAN JUAN BAUTISTA TUXTEPEC,184,ZACATE COLORADO,4,133,70,63,11
OAXACA,20,SAN JUAN CACAHUATEPEC,185,ALTO DE LAS MESAS,2,27,12,15,9
OAXACA,20,SAN JUAN CACAHUATEPEC,185,BUENAVISTA,4,205,108,97,16
OAXACA,20,SAN JUAN CACAHUATEPEC,185,CHICAPILLA,2,26,10,16,9
OAXACA,20,SAN JUAN CACAHUATEPEC,185,LA CULEBRA,3,96,54,42,12
OAXACA,20,SAN JUAN CACAHUATEPEC,185,OCOTLÁN,3,115,56,59,12
OAXACA,20,SAN JUAN CACAHUATEPEC,185,PIE DE LA CUESTA,3,174,90,84,13
OAXACA,20,SAN JUAN CACAHUATEPEC,185,SAN ANTONIO OCOTLÁN,3,253,144,109,20
OAXACA,20,SAN JUAN CACAHUATEPEC,185,SAN FRANCISCO SAYULTEPEC,3,148,90,58,13
OAXACA,20,SAN JUAN CACAHUATEPEC,185,SAN JUAN CACAHUATEPEC,12,1627,888,739,131
OAXACA,20,SAN JUAN CIENEGUILLA,186,SAN JUAN CIENEGUILLA,3,105,58,47,13
OAXACA,20,SAN JUAN COATZÓSPAM,187,AGUA ESPAÑOL,2,50,21,29,3
OAXACA,20,SAN JUAN COATZÓSPAM,187,SAN ISIDRO,2,73,33,40,4
OAXACA,20,SAN JUAN COATZÓSPAM,187,SAN JUAN COATZÓSPAM,6,243,132,111,17
OAXACA,20,SAN JUAN COLORADO,188,AGUA FRÍA,3,188,113,75,12
OAXACA,20,SAN JUAN COLORADO,188,EL TERRERO,2,25,10,15,7
OAXACA,20,SAN JUAN COLORADO,188,LA SOLEDAD,2,77,43,34,9
OAXACA,20,SAN JUAN COLORADO,188,NUEVO PROGRESO,3,206,122,84,15
OAXACA,20,SAN JUAN COLORADO,188,PEÑAS NEGRAS,3,113,64,49,12
OAXACA,20,SAN JUAN COLORADO,188,SAN JUAN COLORADO,10,1695,921,774,96
OAXACA,20,SAN JUAN COLORADO,188,SAN PEDRO SINIYUVI,3,154,86,68,12
OAXACA,20,SAN JUAN COLORADO,188,SANTA MARÍA NUTÍO,4,314,163,151,27
OAXACA,20,SAN JUAN COMALTEPEC,189,HONDURA LUCERO,2,50,24,26,3
OAXACA,20,SAN JUAN COMALTEPEC,189,SAN BARTOLO LACHIXOVA,3,158,78,80,12
OAXACA,20,SAN JUAN COMALTEPEC,189,SAN ISIDRO TRES ARROYOS,2,118,66,52,7
OAXACA,20,SAN JUAN COMALTEPEC,189,SAN JUAN COMALTEPEC,4,170,74,96,11
OAXACA,20,SAN JUAN COMALTEPEC,189,SAN JUAN LEALAO,3,235,114,121,12
OAXACA,20,SAN JUAN COTZOCÓN,190,ARROYO CARRIZAL,3,127,66,61,8
OAXACA,20,SAN JUAN COTZOCÓN,190,ARROYO ENCINO,3,162,76,86,9
OAXACA,20,SAN JUAN COTZOCÓN,190,ARROYO PEÑA AMARILLA,3,104,59,45,13
OAXACA,20,SAN JUAN COTZOCÓN,190,ARROYO VENADO,3,46,21,25,3
OAXACA,20,SAN JUAN COTZOCÓN,190,BENITO JUÁREZ,3,115,59,56,10
OAXACA,20,SAN JUAN COTZOCÓN,190,DESVIACIÓN A SAN FELIPE (LA GASOLINERA),1,3,3,0,1
OAXACA,20,SAN JUAN COTZOCÓN,190,EL PARAÍSO,3,224,122,102,17
OAXACA,20,SAN JUAN COTZOCÓN,190,EL PORVENIR,4,397,205,192,31
OAXACA,20,SAN JUAN COTZOCÓN,190,EL TESORO,3,87,39,48,9
OAXACA,20,SAN JUAN COTZOCÓN,190,EMILIANO ZAPATA,4,175,98,77,15
OAXACA,20,SAN JUAN COTZOCÓN,190,EVA SÁMANO DE LÓPEZ MATEOS,1,4,2,2,1
OAXACA,20,SAN JUAN COTZOCÓN,190,JALTEPEC DE CANDOYOC,8,768,395,373,50
OAXACA,20,SAN JUAN COTZOCÓN,190,LA ESTRELLA,2,33,19,14,5
OAXACA,20,SAN JUAN COTZOCÓN,190,LA LIBERTAD,3,100,54,46,11
OAXACA,20,SAN JUAN COTZOCÓN,190,LA NUEVA RAZA,3,124,64,60,12
OAXACA,20,SAN JUAN COTZOCÓN,190,MARÍA LOMBARDO DE CASO,14,1538,797,741,107
OAXACA,20,SAN JUAN COTZOCÓN,190,NUEVO CERRO MOJARRA,3,158,74,84,11
OAXACA,20,SAN JUAN COTZOCÓN,190,PROFESOR JULIO DE LA FUENTE,3,99,47,52,5
OAXACA,20,SAN JUAN COTZOCÓN,190,SAN FELIPE ZIHUALTEPEC,5,477,252,225,33
OAXACA,20,SAN JUAN COTZOCÓN,190,SAN JUAN COTZOCÓN,5,840,404,436,45
OAXACA,20,SAN JUAN COTZOCÓN,190,SAN JUAN OTZOLOTEPEC,4,218,109,109,14
OAXACA,20,SAN JUAN COTZOCÓN,190,SANTA MARÍA MATAMOROS,3,63,28,35,4
OAXACA,20,SAN JUAN COTZOCÓN,190,SANTA MARÍA PUXMETACÁN,4,265,158,107,17
OAXACA,20,SAN JUAN COTZOCÓN,190,SANTA ROSA ZIHUALTEPEC,2,85,45,40,3
OAXACA,20,SAN JUAN CHICOMEZÚCHIL,191,SAN JUAN CHICOMEZÚCHIL,3,46,23,23,7
OAXACA,20,SAN JUAN CHILATECA,192,SAN JUAN CHILATECA,4,255,143,112,17
OAXACA,20,SAN JUAN DEL ESTADO,193,SAN JUAN DEL ESTADO,4,468,247,221,29
OAXACA,20,SAN JUAN DEL RÍO,194,SAN JUAN DEL RÍO,4,250,148,102,21
OAXACA,20,SAN JUAN DIUXI,195,SAN JOSÉ LOS LAURELES,1,15,7,8,1
OAXACA,20,SAN JUAN DIUXI,195,SAN JUAN DIUXI,4,189,102,87,14
OAXACA,20,SAN JUAN EVANGELISTA ANALCO,196,SAN JUAN EVANGELISTA ANALCO,3,76,40,36,6
OAXACA,20,SAN JUAN GUELAVÍA,197,SAN JUAN GUELAVÍA,5,822,412,410,60
OAXACA,20,SAN JUAN GUICHICOVI,198,ARROYO CUCHARA,1,15,7,8,1
OAXACA,20,SAN JUAN GUICHICOVI,198,ARROYO LIMÓN,2,59,31,28,9
OAXACA,20,SAN JUAN GUICHICOVI,198,ARROYO LIRIO,4,157,67,90,13
OAXACA,20,SAN JUAN GUICHICOVI,198,BENITO JUÁREZ,2,22,10,12,9
OAXACA,20,SAN JUAN GUICHICOVI,198,BOCA DEL MONTE,3,203,117,86,14
OAXACA,20,SAN JUAN GUICHICOVI,198,BRENA TORRES,2,32,17,15,3
OAXACA,20,SAN JUAN GUICHICOVI,198,BUENAVISTA,3,157,87,70,12
OAXACA,20,SAN JUAN GUICHICOVI,198,CHOCOLATE,3,263,153,110,22
OAXACA,20,SAN JUAN GUICHICOVI,198,COLONIA ISTMEÑA (SECCIÓN EL ZAPOTE),3,67,38,29,12
OAXACA,20,SAN JUAN GUICHICOVI,198,COYOL SECO,1,13,6,7,6
OAXACA,20,SAN JUAN GUICHICOVI,198,EJIDO LA REVOLUCIÓN,4,213,100,113,17
OAXACA,20,SAN JUAN GUICHICOVI,198,EL OCOTALITO,2,50,26,24,9
OAXACA,20,SAN JUAN GUICHICOVI,198,EL SACRIFICIO,2,37,19,18,9
OAXACA,20,SAN JUAN GUICHICOVI,198,EL TRIUNFO,3,71,36,35,11
OAXACA,20,SAN JUAN GUICHICOVI,198,EL ZACATAL,6,322,152,170,21
OAXACA,20,SAN JUAN GUICHICOVI,198,EL ZARZAL,5,266,148,118,22
OAXACA,20,SAN JUAN GUICHICOVI,198,ENCINAL COLORADO,3,331,186,145,25
OAXACA,20,SAN JUAN GUICHICOVI,198,ESTACIÓN MOGOÑÉ,4,415,203,212,32
OAXACA,20,SAN JUAN GUICHICOVI,198,ESTACIÓN SARABIA,3,233,128,105,14
OAXACA,20,SAN JUAN GUICHICOVI,198,HIERBA SANTA,3,54,27,27,4
OAXACA,20,SAN JUAN GUICHICOVI,198,HUISICIL,2,33,17,16,9
OAXACA,20,SAN JUAN GUICHICOVI,198,JOSÉ MARÍA MORELOS,3,113,54,59,12
OAXACA,20,SAN JUAN GUICHICOVI,198,LA ZACATERA,1,9,4,5,3
OAXACA,20,SAN JUAN GUICHICOVI,198,LOMERÍA,1,13,5,8,5
OAXACA,20,SAN JUAN GUICHICOVI,198,MALUCO,3,90,47,43,12
OAXACA,20,SAN JUAN GUICHICOVI,198,MOGOÑÉ VIEJO,2,125,72,53,9
OAXACA,20,SAN JUAN GUICHICOVI,198,NUEVO BRENA TORRES,3,68,34,34,8
OAXACA,20,SAN JUAN GUICHICOVI,198,OCOTAL,3,263,137,126,18
OAXACA,20,SAN JUAN GUICHICOVI,198,PACHIÑE ENCINAL,1,15,5,10,6
OAXACA,20,SAN JUAN GUICHICOVI,198,PASO REAL DE SARABIA,4,338,185,153,23
OAXACA,20,SAN JUAN GUICHICOVI,198,PIEDRA BLANCA,3,280,146,134,16
OAXACA,20,SAN JUAN GUICHICOVI,198,PLAN DE SAN LUIS,4,175,99,76,15
OAXACA,20,SAN JUAN GUICHICOVI,198,RAMOS MILLÁN,2,59,32,27,9
OAXACA,20,SAN JUAN GUICHICOVI,198,RÍO DE GUASAMANDO,1,5,0,5,1
OAXACA,20,SAN JUAN GUICHICOVI,198,RÍO PACHIÑE,3,313,178,135,22
OAXACA,20,SAN JUAN GUICHICOVI,198,SAN ANTONIO [BARRIO],2,47,24,23,9
OAXACA,20,SAN JUAN GUICHICOVI,198,SAN JUAN GUICHICOVI,6,1293,683,610,58
OAXACA,20,SAN JUAN GUICHICOVI,198,SAN JUAN VIEJO,2,55,28,27,9
OAXACA,20,SAN JUAN GUICHICOVI,198,SAN JUANITO,2,57,30,27,9
OAXACA,20,SAN JUAN GUICHICOVI,198,SANTA ANA,3,297,150,147,16
OAXACA,20,SAN JUAN GUICHICOVI,198,THE REAL,2,51,28,23,9
OAXACA,20,SAN JUAN GUICHICOVI,198,VICENTE GUERRERO,3,105,56,49,9
OAXACA,20,SAN JUAN IHUALTEPEC,199,SAN JOSÉ CHEPETLÁN,3,21,9,12,7
OAXACA,20,SAN JUAN IHUALTEPEC,199,SAN JUAN IHUALTEPEC,3,30,16,14,4
OAXACA,20,SAN JUAN JUQUILA MIXES,200,ASUNCIÓN ACATLÁN,4,114,64,50,8
OAXACA,20,SAN JUAN JUQUILA MIXES,200,GUADALUPE VICTORIA,3,140,73,67,10
OAXACA,20,SAN JUAN JUQUILA MIXES,200,SAN JUAN JUQUILA MIXES,4,405,198,207,27
OAXACA,20,SAN JUAN JUQUILA MIXES,200,SANTO DOMINGO NARRO,3,116,61,55,9
OAXACA,20,SAN JUAN JUQUILA VIJANOS,201,COLONIA REFORMA,2,16,7,9,7
OAXACA,20,SAN JUAN JUQUILA VIJANOS,201,LACHI-RAGUI (LLANO LUMBRE),2,12,5,7,2
OAXACA,20,SAN JUAN JUQUILA VIJANOS,201,LAS DELICIAS,2,99,53,46,8
OAXACA,20,SAN JUAN JUQUILA VIJANOS,201,SAN FELIPE EL PORVENIR,3,154,75,79,11
OAXACA,20,SAN JUAN JUQUILA VIJANOS,201,SAN JUAN JUQUILA VIJANOS,3,132,67,65,11
OAXACA,20,SAN JUAN LACHAO,202,ARMENIA,2,6,2,4,2
OAXACA,20,SAN JUAN LACHAO,202,EL OCOTE,3,117,54,63,7
OAXACA,20,SAN JUAN LACHAO,202,LA ASUNCIÓN,1,6,0,6,1
OAXACA,20,SAN JUAN LACHAO,202,LA CIÉNEGA,3,21,16,5,3
OAXACA,20,SAN JUAN LACHAO,202,LA ESPERANZA,2,11,5,6,2
OAXACA,20,SAN JUAN LACHAO,202,SAN JOSÉ,3,19,6,13,3
OAXACA,20,SAN JUAN LACHAO,202,SAN JOSÉ EL COROZAL,3,15,9,6,3
OAXACA,20,SAN JUAN LACHAO,202,SAN JUAN LACHAO,4,678,349,329,33
OAXACA,20,SAN JUAN LACHAO,202,SAN JUAN LACHAO PUEBLO VIEJO,4,231,121,110,15
OAXACA,20,SAN JUAN LACHAO,202,SAN MIGUEL,2,11,5,6,1
OAXACA,20,SAN JUAN LACHAO,202,SANTA CATARINA,2,19,11,8,2
OAXACA,20,SAN JUAN LACHAO,202,SANTA CATARINA CERRO DEL VIDRIO,2,58,26,32,3
OAXACA,20,SAN JUAN LACHAO,202,SANTA LUCÍA TIERRA BLANCA,1,7,2,5,1
OAXACA,20,SAN JUAN LACHAO,202,SANTA MARÍA RANCHO NUEVO,3,32,12,20,4
OAXACA,20,SAN JUAN LACHAO,202,SANTA ROSA DE LIMA,3,145,78,67,12
OAXACA,20,SAN JUAN LACHIGALLA,203,EL RINCÓN,2,47,25,22,9
OAXACA,20,SAN JUAN LACHIGALLA,203,PROGRESO,3,89,51,38,12
OAXACA,20,SAN JUAN LACHIGALLA,203,SAN ANDRÉS NIÑO,3,176,98,78,12
OAXACA,20,SAN JUAN LACHIGALLA,203,SAN JUAN LACHIGALLA,5,327,171,156,25
OAXACA,20,SAN JUAN LACHIGALLA,203,SANTIAGO LA LIBERTAD,3,123,66,57,10
OAXACA,20,SAN JUAN LACHIGALLA,203,XAGUÍA,2,54,29,25,9
OAXACA,20,SAN JUAN LAJARCIA,204,EL COYUL,2,23,11,12,7
OAXACA,20,SAN JUAN LAJARCIA,204,SAN JUAN LAJARCIA,3,71,40,31,10
OAXACA,20,SAN JUAN LALANA,205,ARROYO BLANCO,4,195,84,111,14
OAXACA,20,SAN JUAN LALANA,205,ARROYO CACAO (ARROYO LODO),1,16,8,8,1
OAXACA,20,SAN JUAN LALANA,205,ARROYO CONCHA,3,60,24,36,3
OAXACA,20,SAN JUAN LALANA,205,ARROYO DE PIEDRA,3,93,49,44,6
OAXACA,20,SAN JUAN LALANA,205,ARROYO LUMBRE,1,42,25,17,2
OAXACA,20,SAN JUAN LALANA,205,ARROYO MÉXICO,3,16,4,12,2
OAXACA,20,SAN JUAN LALANA,205,ARROYO PLÁTANO,3,53,25,28,4
OAXACA,20,SAN JUAN LALANA,205,ARROYO TOMATE,3,158,73,85,9
OAXACA,20,SAN JUAN LALANA,205,ASUNCIÓN LACOVA,3,59,26,33,3
OAXACA,20,SAN JUAN LALANA,205,BOCA DE ARROYO CHIVO,2,14,8,6,1
OAXACA,20,SAN JUAN LALANA,205,BOCA DE PIEDRA,2,26,14,12,2
OAXACA,20,SAN JUAN LALANA,205,CERRO COQUITO,3,34,16,18,3
OAXACA,20,SAN JUAN LALANA,205,CERRO PROGRESO,3,63,31,32,5
OAXACA,20,SAN JUAN LALANA,205,COLONIA MORELOS,3,87,42,45,6
OAXACA,20,SAN JUAN LALANA,205,IGNACIO ZARAGOZA,3,236,106,130,12
OAXACA,20,SAN JUAN LALANA,205,JOSÉ LÓPEZ PORTILLO,3,38,19,19,3
OAXACA,20,SAN JUAN LALANA,205,LA AURORA (RANCHO VIEJO),2,11,6,5,2
OAXACA,20,SAN JUAN LALANA,205,LA ESPERANZA,3,154,84,70,11
OAXACA,20,SAN JUAN LALANA,205,LA PALMA [RANCHO],3,25,12,13,3
OAXACA,20,SAN JUAN LALANA,205,LA SOLEDAD,3,22,11,11,3
OAXACA,20,SAN JUAN LALANA,205,LINDA VISTA,2,5,4,1,1
OAXACA,20,SAN JUAN LALANA,205,MONTE NEGRO,3,295,154,141,14
OAXACA,20,SAN JUAN LALANA,205,NUEVO SAN ANTONIO,3,61,26,35,4
OAXACA,20,SAN JUAN LALANA,205,PASO DE HIDALGO,2,49,22,27,3
OAXACA,20,SAN JUAN LALANA,205,PASO DEL ÁGUILA,3,160,81,79,11
OAXACA,20,SAN JUAN LALANA,205,SAN ISIDRO ARENAL,3,87,36,51,7
OAXACA,20,SAN JUAN LALANA,205,SAN JORGE EL PORVENIR,1,36,20,16,2
OAXACA,20,SAN JUAN LALANA,205,SAN JOSÉ ARROYO CACAO,2,18,9,9,2
OAXACA,20,SAN JUAN LALANA,205,SAN JOSÉ ARROYO COPETE,3,12,7,5,2
OAXACA,20,SAN JUAN LALANA,205,SAN JOSÉ RÍO MANZO,4,434,213,221,25
OAXACA,20,SAN JUAN LALANA,205,SAN JUAN EVANGELISTA,3,100,55,45,7
OAXACA,20,SAN JUAN LALANA,205,SAN JUAN LALANA,3,133,65,68,6
OAXACA,20,SAN JUAN LALANA,205,SAN LORENZO,4,339,174,165,16
OAXACA,20,SAN JUAN LALANA,205,SAN MIGUEL (LA PAZ),3,52,25,27,4
OAXACA,20,SAN JUAN LALANA,205,SAN PEDRO TRES ARROYOS,2,29,13,16,3
OAXACA,20,SAN JUAN LALANA,205,SANTA CECILIA DE MADERO,3,92,39,53,7
OAXACA,20,SAN JUAN LALANA,205,SANTA MARÍA LA NOPALERA,3,115,63,52,6
OAXACA,20,SAN JUAN LALANA,205,SANTIAGO JALAHUI,3,171,84,87,11
OAXACA,20,SAN JUAN LALANA,205,VILLA NUEVA,3,113,60,53,8
OAXACA,20,SAN JUAN LALANA,205,YOGOPE,3,98,47,51,8
OAXACA,20,SAN JUAN DE LOS CUÉS,206,CONTLALCO,3,56,26,30,4
OAXACA,20,SAN JUAN DE LOS CUÉS,206,SAN ANTONIO NOPALERA,3,191,115,76,12
OAXACA,20,SAN JUAN DE LOS CUÉS,206,SAN JUAN DE LOS CUÉS,3,278,135,143,16
OAXACA,20,SAN JUAN MAZATLÁN,207,CONSTITUCIÓN MEXICANA,4,348,195,153,24
OAXACA,20,SAN JUAN MAZATLÁN,207,EL TORTUGUERO,3,118,63,55,7
OAXACA,20,SAN JUAN MAZATLÁN,207,GENERAL FELIPE ÁNGELES,5,1278,641,637,79
OAXACA,20,SAN JUAN MAZATLÁN,207,GUSTAVO DÍAZ ORDAZ,2,44,22,22,9
OAXACA,20,SAN JUAN MAZATLÁN,207,LA ESPERANZA,2,28,13,15,4
OAXACA,20,SAN JUAN MAZATLÁN,207,LA MIXTEQUITA,5,420,225,195,40
OAXACA,20,SAN JUAN MAZATLÁN,207,LA NUEVA ESPERANZA,2,49,26,23,3
OAXACA,20,SAN JUAN MAZATLÁN,207,LA PALESTINA,2,28,14,14,5
OAXACA,20,SAN JUAN MAZATLÁN,207,LA SOLEDAD,2,58,30,28,7
OAXACA,20,SAN JUAN MAZATLÁN,207,LOMA SANTA CRUZ,3,53,28,25,7
OAXACA,20,SAN JUAN MAZATLÁN,207,LOS FRESNOS,3,250,139,111,16
OAXACA,20,SAN JUAN MAZATLÁN,207,LOS RAUDALES,3,90,48,42,7
OAXACA,20,SAN JUAN MAZATLÁN,207,LOS VALLES,1,26,14,12,5
OAXACA,20,SAN JUAN MAZATLÁN,207,MADERO [EJIDO],3,74,36,38,6
OAXACA,20,SAN JUAN MAZATLÁN,207,MONTE ÁGUILA,3,197,101,96,13
OAXACA,20,SAN JUAN MAZATLÁN,207,NUEVO CENTRO,1,40,21,19,6
OAXACA,20,SAN JUAN MAZATLÁN,207,NUEVO PROGRESO,2,42,22,20,9
OAXACA,20,SAN JUAN MAZATLÁN,207,RANCHO JUÁREZ,3,138,74,64,9
OAXACA,20,SAN JUAN MAZATLÁN,207,SAN ANTONIO DEL VALLE,1,12,6,6,1
OAXACA,20,SAN JUAN MAZATLÁN,207,SAN ANTONIO TUTLA,2,56,34,22,3
OAXACA,20,SAN JUAN MAZATLÁN,207,SAN JOSÉ DE LAS FLORES,3,263,148,115,17
OAXACA,20,SAN JUAN MAZATLÁN,207,SAN JOSÉ DE LOS REYES EL PÍPILA,2,82,41,41,4
OAXACA,20,SAN JUAN MAZATLÁN,207,SAN JUAN MAZATLÁN,6,551,303,248,32
OAXACA,20,SAN JUAN MAZATLÁN,207,SAN PEDRO ACATLÁN GRANDE,3,188,103,85,12
OAXACA,20,SAN JUAN MAZATLÁN,207,SAN PEDRO CHIMALTEPEC,3,258,149,109,18
OAXACA,20,SAN JUAN MAZATLÁN,207,SANTIAGO MALACATEPEC,3,341,193,148,19
OAXACA,20,SAN JUAN MAZATLÁN,207,SANTIAGO TUTLA,4,309,160,149,24
OAXACA,20,SAN JUAN MAZATLÁN,207,TIERRA NEGRA,3,170,86,84,12
OAXACA,20,SAN JUAN MAZATLÁN,207,TIERRA NUEVA,3,107,56,51,7
OAXACA,20,SAN JUAN MAZATLÁN,207,VILLA NUEVA,4,193,106,87,13
OAXACA,20,SAN JUAN MIXTEPEC,208,28 DE MAYO,1,17,7,10,1
OAXACA,20,SAN JUAN MIXTEPEC,208,CABAYUA,1,15,6,9,1
OAXACA,20,SAN JUAN MIXTEPEC,208,CANAMÁ,1,47,20,27,3
OAXACA,20,SAN JUAN MIXTEPEC,208,EL LLANO,1,10,4,6,1
OAXACA,20,SAN JUAN MIXTEPEC,208,INDEPENDENCIA,3,160,83,77,21
OAXACA,20,SAN JUAN MIXTEPEC,208,LA BATEA,1,16,11,5,1
OAXACA,20,SAN JUAN MIXTEPEC,208,LOMA REDONDA,1,13,5,8,1
OAXACA,20,SAN JUAN MIXTEPEC,208,LOS TEJOCOTES,3,81,36,45,8
OAXACA,20,SAN JUAN MIXTEPEC,208,MESÓN DE GUADALUPE PRIMERA SECCIÓN,5,151,72,79,21
OAXACA,20,SAN JUAN MIXTEPEC,208,OJO DE AGUA ARENAL,1,34,17,17,2
OAXACA,20,SAN JUAN MIXTEPEC,208,PEÑA BLANCA,1,30,14,16,2
OAXACA,20,SAN JUAN MIXTEPEC,208,RÍO TIMBRE,1,15,8,7,1
OAXACA,20,SAN JUAN MIXTEPEC,208,SAN JUAN CAHUAYAXI,2,32,21,11,3
OAXACA,20,SAN JUAN MIXTEPEC,208,SAN JUAN MIXTEPEC DISTRITO 08,10,401,196,205,32
OAXACA,20,SAN JUAN MIXTEPEC,208,SAN LUCAS,2,57,31,26,4
OAXACA,20,SAN JUAN MIXTEPEC,208,SAN PEDRO YOSOSCUÁ,3,66,38,28,5
OAXACA,20,SAN JUAN MIXTEPEC,208,SANTA CRUZ,3,90,43,47,6
OAXACA,20,SAN JUAN MIXTEPEC,208,SANTA MARÍA TEPOSLANTONGO,4,114,57,57,8
OAXACA,20,SAN JUAN MIXTEPEC,208,SANTIAGO TIÑÓ,2,18,9,9,2
OAXACA,20,SAN JUAN MIXTEPEC,208,SANTO DOMINGO VIEJO,1,14,6,8,5
OAXACA,20,SAN JUAN MIXTEPEC,208,TIERRA BLANCA (BARRIO SAN PEDRO),1,21,8,13,1
OAXACA,20,SAN JUAN MIXTEPEC,208,YERBA BUENA,2,54,23,31,3
OAXACA,20,SAN JUAN MIXTEPEC,208,YOSOBA,1,18,10,8,1
OAXACA,20,SAN JUAN MIXTEPEC,208,YOSONDUU,2,56,26,30,3
OAXACA,20,SAN JUAN MIXTEPEC,208,YUCUMÍ,1,16,6,10,1
OAXACA,20,SAN JUAN MIXTEPEC,208,YUCUNANI,1,31,11,20,2
OAXACA,20,SAN JUAN MIXTEPEC,209,SAN JUAN MIXTEPEC DISTRITO 26,4,176,93,83,13
OAXACA,20,SAN JUAN ÑUMÍ,210,BUENAVISTA,4,78,32,46,6
OAXACA,20,SAN JUAN ÑUMÍ,210,GUADALUPE MIRASOL ÑUMÍ,2,34,18,16,3
OAXACA,20,SAN JUAN ÑUMÍ,210,LA PAZ YOSOÑAMA,3,49,25,24,3
OAXACA,20,SAN JUAN ÑUMÍ,210,MONTE NEGRO,1,11,8,3,1
OAXACA,20,SAN JUAN ÑUMÍ,210,PEÑA COLORADA,3,104,51,53,8
OAXACA,20,SAN JUAN ÑUMÍ,210,RÍO CENTRO ÑUMÍ,2,28,13,15,2
OAXACA,20,SAN JUAN ÑUMÍ,210,RÍO SAN JUAN,4,92,51,41,7
OAXACA,20,SAN JUAN ÑUMÍ,210,SABINILLO,3,142,70,72,10
OAXACA,20,SAN JUAN ÑUMÍ,210,SAN ANTONIO NDUASICO (NDUAXICO),4,125,64,61,9
OAXACA,20,SAN JUAN ÑUMÍ,210,SAN ISIDRO ÑUMÍ,4,140,76,64,9
OAXACA,20,SAN JUAN ÑUMÍ,210,SAN ISIDRO YOSOÑAMA,3,73,35,38,4
OAXACA,20,SAN JUAN ÑUMÍ,210,SAN JOSÉ ÑUMÍ,4,142,74,68,8
OAXACA,20,SAN JUAN ÑUMÍ,210,SAN JUAN ÑUMÍ,4,144,81,63,11
OAXACA,20,SAN JUAN ÑUMÍ,210,SAN PEDRO ÑUMÍ,5,280,153,127,18
OAXACA,20,SAN JUAN ÑUMÍ,210,SAN PEDRO YOSOÑAMA,3,57,28,29,5
OAXACA,20,SAN JUAN ÑUMÍ,210,SANTA ROSA,4,131,64,67,9
OAXACA,20,SAN JUAN ÑUMÍ,210,SANTO DOMINGO YOSOÑAMA,5,179,93,86,15
OAXACA,20,SAN JUAN ÑUMÍ,210,UNIÓN HIDALGO,2,32,14,18,2
OAXACA,20,SAN JUAN OZOLOTEPEC,211,SAN ANDRÉS LOVENE,3,362,179,183,14
OAXACA,20,SAN JUAN OZOLOTEPEC,211,SAN BARTOLO LAPAGUÍA,1,25,12,13,6
OAXACA,20,SAN JUAN OZOLOTEPEC,211,SAN JUAN OZOLOTEPEC,3,107,61,46,12
OAXACA,20,SAN JUAN OZOLOTEPEC,211,SANTA CATARINA XANAGUÍA,3,186,107,79,13
OAXACA,20,SAN JUAN OZOLOTEPEC,211,SANTIAGO LAPAGUÍA,3,217,126,91,12
OAXACA,20,SAN JUAN PETLAPA,212,ARROYO BLANCO,3,46,24,22,3
OAXACA,20,SAN JUAN PETLAPA,212,SAN FELIPE EL MIRADOR,3,56,28,28,5
OAXACA,20,SAN JUAN PETLAPA,212,SAN JUAN PETLAPA,5,300,156,144,17
OAXACA,20,SAN JUAN PETLAPA,212,SAN JUAN TOAVELA,3,200,102,98,12
OAXACA,20,SAN JUAN PETLAPA,212,SANTA ISABEL CAJONOS,3,60,30,30,6
OAXACA,20,SAN JUAN PETLAPA,212,SANTA MARÍA LOVANI,3,232,116,116,12
OAXACA,20,SAN JUAN QUIAHIJE,213,CIENEGUILLA,4,370,193,177,19
OAXACA,20,SAN JUAN QUIAHIJE,213,SAN JUAN QUIAHIJE,8,965,505,460,46
OAXACA,20,SAN JUAN QUIOTEPEC,214,MANINALTEPEC,2,36,18,18,7
OAXACA,20,SAN JUAN QUIOTEPEC,214,SAN JUAN QUIOTEPEC,4,330,171,159,19
OAXACA,20,SAN JUAN QUIOTEPEC,214,SANTA MARÍA NIEVES,1,8,6,2,1
OAXACA,20,SAN JUAN QUIOTEPEC,214,SANTA MARÍA TOTOMOXTLA,2,49,24,25,3
OAXACA,20,SAN JUAN QUIOTEPEC,214,SANTIAGO CUASIMULCO,1,11,6,5,1
OAXACA,20,SAN JUAN SAYULTEPEC,215,SAN ANDRÉS ANDÚA,2,36,17,19,3
OAXACA,20,SAN JUAN SAYULTEPEC,215,SAN JUAN SAYULTEPEC,2,65,34,31,7
OAXACA,20,SAN JUAN TABAÁ,216,SAN JUAN TABAÁ,4,339,157,182,35
OAXACA,20,SAN JUAN TAMAZOLA,217,LLANO DE LA CANOA,4,188,99,89,12
OAXACA,20,SAN JUAN TAMAZOLA,217,LLANO DEL PAR,1,15,9,6,1
OAXACA,20,SAN JUAN TAMAZOLA,217,MONTE FRÍO,3,83,44,39,12
OAXACA,20,SAN JUAN TAMAZOLA,217,SAN ISIDRO TREMENTINA,1,23,12,11,1
OAXACA,20,SAN JUAN TAMAZOLA,217,SAN JOSÉ OJO DE AGUA,1,6,4,2,1
OAXACA,20,SAN JUAN TAMAZOLA,217,SAN JUAN MONTE FLOR,4,205,119,86,13
OAXACA,20,SAN JUAN TAMAZOLA,217,SAN JUAN TAMAZOLA,4,136,64,72,13
OAXACA,20,SAN JUAN TAMAZOLA,217,SAN JUAN YUTA,3,95,54,41,6
OAXACA,20,SAN JUAN TAMAZOLA,217,YUCUXINA,3,106,63,43,10
OAXACA,20,SAN JUAN TEITA,218,SAN JUAN TEITA,4,118,51,67,10
OAXACA,20,SAN JUAN TEITIPAC,219,SAN JUAN TEITIPAC,4,651,364,287,37
OAXACA,20,SAN JUAN TEPEUXILA,220,SAN ANDRÉS PÁPALO,4,115,56,59,13
OAXACA,20,SAN JUAN TEPEUXILA,220,SAN JUAN TEPEUXILA,4,155,74,81,11
OAXACA,20,SAN JUAN TEPEUXILA,220,SAN JUAN TEPONAXTLA,4,162,89,73,13
OAXACA,20,SAN JUAN TEPEUXILA,220,SAN PEDRO CUYALTEPEC,3,152,88,64,12
OAXACA,20,SAN JUAN TEPEUXILA,220,SAN SEBASTIÁN TLACOLULA,3,77,44,33,10
OAXACA,20,SAN JUAN TEPOSCOLULA,221,LA ROSA,1,16,5,11,1
OAXACA,20,SAN JUAN TEPOSCOLULA,221,REFUGIO DE MORELOS,3,56,29,27,8
OAXACA,20,SAN JUAN TEPOSCOLULA,221,SAN JUAN TEPOSCOLULA,3,135,72,63,17
OAXACA,20,SAN JUAN TEPOSCOLULA,221,SAN MIGUEL MARCOS PÉREZ,3,54,29,25,9
OAXACA,20,SAN JUAN YAEÉ,222,SAN JUAN YAEÉ,4,181,104,77,13
OAXACA,20,SAN JUAN YAEÉ,222,SANTA MARÍA LACHICHINA,2,33,18,15,7
OAXACA,20,SAN JUAN YAEÉ,222,SANTIAGO YAGALLO,2,49,26,23,7
OAXACA,20,SAN JUAN YATZONA,223,SAN JUAN YATZONA,4,99,57,42,9
OAXACA,20,SAN JUAN YUCUITA,224,SAN JUAN YUCUITA,3,76,40,36,8
OAXACA,20,SAN JUAN YUCUITA,224,SAN MATEO COYOTEPEC,1,9,5,4,1
OAXACA,20,SAN LORENZO,225,GUADALUPE YOSOCANI,4,92,40,52,8
OAXACA,20,SAN LORENZO,225,SAN ANTONIO YOSOCANI,3,76,39,37,10
OAXACA,20,SAN LORENZO,225,SAN JOSÉ TETEPELCINGO,1,24,15,9,2
OAXACA,20,SAN LORENZO,225,SAN JUAN YOSOCANI,2,156,92,64,11
OAXACA,20,SAN LORENZO,225,SAN LORENZO,4,493,243,250,29
OAXACA,20,SAN LORENZO,225,SAN MIGUEL TETEPELCINGO,4,389,187,202,27
OAXACA,20,SAN LORENZO,225,SANTA MARÍA YOSOCANI,3,167,87,80,13
OAXACA,20,SAN LORENZO ALBARRADAS,226,ROAGUÍA,3,108,59,49,12
OAXACA,20,SAN LORENZO ALBARRADAS,226,SAN BARTOLO,2,24,10,14,9
OAXACA,20,SAN LORENZO ALBARRADAS,226,SAN LORENZO ALBARRADAS,5,271,154,117,22
OAXACA,20,SAN LORENZO ALBARRADAS,226,SANTA ANA DEL RÍO,3,97,48,49,6
OAXACA,20,SAN LORENZO CACAOTEPEC,227,GUADALUPE HIDALGO,2,194,112,82,14
OAXACA,20,SAN LORENZO CACAOTEPEC,227,SAN ISIDRO (COLONIA SAN ISIDRO),1,411,195,216,23
OAXACA,20,SAN LORENZO CACAOTEPEC,227,SAN LORENZO CACAOTEPEC,11,2280,1224,1056,149
OAXACA,20,SAN LORENZO CACAOTEPEC,227,SANTIAGO ETLA,3,882,471,411,45
OAXACA,20,SAN LORENZO CUAUNECUILTITLA,228,SAN LORENZO CUAUNECUILTITLA,4,291,146,145,19
OAXACA,20,SAN LORENZO TEXMELÚCAN,229,EL ARADOR,4,486,281,205,28
OAXACA,20,SAN LORENZO TEXMELÚCAN,229,EL CARRIZAL,3,469,283,186,27
OAXACA,20,SAN LORENZO TEXMELÚCAN,229,EL PALO DE LIMA,3,245,137,108,16
OAXACA,20,SAN LORENZO TEXMELÚCAN,229,EL SÚCHIL,3,258,149,109,19
OAXACA,20,SAN LORENZO TEXMELÚCAN,229,RÍO DE TALEA,3,216,109,107,16
OAXACA,20,SAN LORENZO TEXMELÚCAN,229,RÍO NUBE,3,307,174,133,19
OAXACA,20,SAN LORENZO TEXMELÚCAN,229,SAN LORENZO TEXMELÚCAN,4,489,280,209,29
OAXACA,20,SAN LORENZO VICTORIA,230,SAN JERÓNIMO NUCHITA,4,196,103,93,18
OAXACA,20,SAN LORENZO VICTORIA,230,SAN LORENZO VICTORIA,3,107,47,60,13
OAXACA,20,SAN LUCAS CAMOTLÁN,231,SAN LUCAS CAMOTLÁN,7,692,381,311,41
OAXACA,20,SAN LUCAS OJITLÁN,232,ALFREDO VLADIMIR BONFIL,1,32,17,15,2
OAXACA,20,SAN LUCAS OJITLÁN,232,AMADO NERVO,1,17,7,10,2
OAXACA,20,SAN LUCAS OJITLÁN,232,ARROYO CAMALOTE,2,85,43,42,6
OAXACA,20,SAN LUCAS OJITLÁN,232,ARROYO CAMARÓN,3,172,92,80,11
OAXACA,20,SAN LUCAS OJITLÁN,232,ARROYO CARACOL ARRIBA,2,25,11,14,2
OAXACA,20,SAN LUCAS OJITLÁN,232,ARROYO CARACOL IDEAL,2,58,33,25,3
OAXACA,20,SAN LUCAS OJITLÁN,232,ARROYO CULEBRA,3,19,9,10,2
OAXACA,20,SAN LUCAS OJITLÁN,232,ARROYO MANANTIAL,1,30,13,17,2
OAXACA,20,SAN LUCAS OJITLÁN,232,BENITO JUÁREZ,3,27,16,11,3
OAXACA,20,SAN LUCAS OJITLÁN,232,BUENAVISTA,2,46,22,24,3
OAXACA,20,SAN LUCAS OJITLÁN,232,CACAHUATAL,3,58,26,32,5
OAXACA,20,SAN LUCAS OJITLÁN,232,CAFETAL SEGUNDO,1,23,13,10,1
OAXACA,20,SAN LUCAS OJITLÁN,232,CERRO DE ORO,4,105,56,49,8
OAXACA,20,SAN LUCAS OJITLÁN,232,COLONIA 20 DE NOVIEMBRE (VISTA HERMOSA),1,21,5,16,1
OAXACA,20,SAN LUCAS OJITLÁN,232,COLONIA FRANCISCO I. MADERO,2,6,3,3,1
OAXACA,20,SAN LUCAS OJITLÁN,232,EL IDEAL,3,145,72,73,13
OAXACA,20,SAN LUCAS OJITLÁN,232,EL MIRADOR,3,105,50,55,7
OAXACA,20,SAN LUCAS OJITLÁN,232,EL NANCHE,3,44,19,25,4
OAXACA,20,SAN LUCAS OJITLÁN,232,EL PLATANAR,1,17,6,11,1
OAXACA,20,SAN LUCAS OJITLÁN,232,EL PORVENIR,2,52,28,24,4
OAXACA,20,SAN LUCAS OJITLÁN,232,HELADIO RAMÍREZ LÓPEZ,3,30,10,20,3
OAXACA,20,SAN LUCAS OJITLÁN,232,ISLA LA ASUNCIÓN,1,5,2,3,1
OAXACA,20,SAN LUCAS OJITLÁN,232,JOSÉ LÓPEZ PORTILLO,1,22,12,10,1
OAXACA,20,SAN LUCAS OJITLÁN,232,LA LAGUNA ESCONDIDA,2,60,29,31,3
OAXACA,20,SAN LUCAS OJITLÁN,232,LAGUNA ARROYO GRANDE,2,114,53,61,8
OAXACA,20,SAN LUCAS OJITLÁN,232,LOMA ALTA,2,57,32,25,3
OAXACA,20,SAN LUCAS OJITLÁN,232,LOMA DE CEDRO,4,318,153,165,19
OAXACA,20,SAN LUCAS OJITLÁN,232,LOMA DE PIEDRA,3,146,75,71,14
OAXACA,20,SAN LUCAS OJITLÁN,232,LOMA SAN BERNABÉ,2,69,42,27,4
OAXACA,20,SAN LUCAS OJITLÁN,232,MACÍN GRANDE,4,360,183,177,21
OAXACA,20,SAN LUCAS OJITLÁN,232,MONTE BELLO,4,36,16,20,3
OAXACA,20,SAN LUCAS OJITLÁN,232,MONTE LIBERAL,3,31,13,18,3
OAXACA,20,SAN LUCAS OJITLÁN,232,NUEVA COLONIA JOSÉ LÓPEZ PORTILLO,1,10,4,6,1
OAXACA,20,SAN LUCAS OJITLÁN,232,NUEVO AGUACATE,3,33,18,15,3
OAXACA,20,SAN LUCAS OJITLÁN,232,NUEVO ARROYO CAMARÓN,1,50,25,25,3
OAXACA,20,SAN LUCAS OJITLÁN,232,PASO LIMÓN,2,24,11,13,2
OAXACA,20,SAN LUCAS OJITLÁN,232,PIEDRAS BLANCAS,2,16,10,6,2
OAXACA,20,SAN LUCAS OJITLÁN,232,PLAYA CARRIZO,2,7,4,3,1
OAXACA,20,SAN LUCAS OJITLÁN,232,PLAYA DE SOYALTEPEC,3,161,81,80,12
OAXACA,20,SAN LUCAS OJITLÁN,232,POTRERO VIEJO,2,34,21,13,2
OAXACA,20,SAN LUCAS OJITLÁN,232,PROFESOR FLORENTINO TERÁN SÁNCHEZ,1,6,1,5,5
OAXACA,20,SAN LUCAS OJITLÁN,232,PUEBLO NUEVO,2,7,6,1,1
OAXACA,20,SAN LUCAS OJITLÁN,232,PUERTO ÁNGEL,1,6,4,2,1
OAXACA,20,SAN LUCAS OJITLÁN,232,SAN JOSÉ LAGUNAS,3,182,82,100,12
OAXACA,20,SAN LUCAS OJITLÁN,232,SAN LUCAS OJITLÁN,22,2288,1165,1123,117
OAXACA,20,SAN LUCAS OJITLÁN,232,SANTA ROSA DE LIMA,3,26,9,17,3
OAXACA,20,SAN LUCAS OJITLÁN,232,SANTO DOMINGO,1,5,2,3,1
OAXACA,20,SAN LUCAS OJITLÁN,232,VICENTE GUERRERO,5,121,67,54,9
OAXACA,20,SAN LUCAS OJITLÁN,232,VILLA DE GUADALUPE,1,20,9,11,1
OAXACA,20,SAN LUCAS OJITLÁN,232,VISTA HERMOSA,3,143,86,57,9
OAXACA,20,SAN LUCAS OJITLÁN,232,YUCATÁN,3,176,88,88,12
OAXACA,20,SAN LUCAS QUIAVINÍ,233,SAN LUCAS QUIAVINÍ,3,234,125,109,16
OAXACA,20,SAN LUCAS ZOQUIÁPAM,234,AGUA DE NIÑO,3,98,54,44,13
OAXACA,20,SAN LUCAS ZOQUIÁPAM,234,AGUA NEGRA,3,29,16,13,4
OAXACA,20,SAN LUCAS ZOQUIÁPAM,234,BUENA VISTA,1,21,11,10,3
OAXACA,20,SAN LUCAS ZOQUIÁPAM,234,CERRO DE ARENA,1,13,6,7,1
OAXACA,20,SAN LUCAS ZOQUIÁPAM,234,EL PAXTLE,2,58,31,27,4
OAXACA,20,SAN LUCAS ZOQUIÁPAM,234,EL VIZAJE,2,28,15,13,2
OAXACA,20,SAN LUCAS ZOQUIÁPAM,234,GUADALUPE,2,65,34,31,4
OAXACA,20,SAN LUCAS ZOQUIÁPAM,234,LINDA VISTA,2,24,14,10,2
OAXACA,20,SAN LUCAS ZOQUIÁPAM,234,LLANO DE ÁLAMO,1,15,8,7,1
OAXACA,20,SAN LUCAS ZOQUIÁPAM,234,LOMA DE ÁGUILA,2,6,3,3,1
OAXACA,20,SAN LUCAS ZOQUIÁPAM,234,LOMA IZOTE,2,19,9,10,2
OAXACA,20,SAN LUCAS ZOQUIÁPAM,234,LOMA OCOTITLÁN,2,34,13,21,2
OAXACA,20,SAN LUCAS ZOQUIÁPAM,234,LOS FRAILES,3,139,72,67,11
OAXACA,20,SAN LUCAS ZOQUIÁPAM,234,PEÑA BLANCA,3,119,63,56,12
OAXACA,20,SAN LUCAS ZOQUIÁPAM,234,PEÑA COLORADA,3,88,37,51,9
OAXACA,20,SAN LUCAS ZOQUIÁPAM,234,SAN ISIDRO ZOQUIÁPAM,4,336,165,171,21
OAXACA,20,SAN LUCAS ZOQUIÁPAM,234,SAN JOSÉ VISTA HERMOSA,4,215,120,95,13
OAXACA,20,SAN LUCAS ZOQUIÁPAM,234,SAN JUAN LA UNIÓN,3,64,25,39,5
OAXACA,20,SAN LUCAS ZOQUIÁPAM,234,SAN LUCAS ZOQUIÁPAM,4,282,136,146,20
OAXACA,20,SAN LUCAS ZOQUIÁPAM,234,SAN MARCOS LIQUIDÁMBAR,2,61,37,24,4
OAXACA,20,SAN LUCAS ZOQUIÁPAM,234,SAN MARTÍN,2,58,24,34,4
OAXACA,20,SAN LUIS AMATLÁN,235,ANTIGUAL,1,29,15,14,2
OAXACA,20,SAN LUIS AMATLÁN,235,LACHIGUÍ,1,10,3,7,1
OAXACA,20,SAN LUIS AMATLÁN,235,LACHIGUIZO,3,29,19,10,5
OAXACA,20,SAN LUIS AMATLÁN,235,LOGOCHE,2,13,7,6,2
OAXACA,20,SAN LUIS AMATLÁN,235,NOPALERA (GUELAXÓCHITL),3,47,20,27,4
OAXACA,20,SAN LUIS AMATLÁN,235,SAN ANTONIO CHIGUIVANA,2,4,2,2,2
OAXACA,20,SAN LUIS AMATLÁN,235,SAN ESTEBAN AMATLÁN,4,283,159,124,18
OAXACA,20,SAN LUIS AMATLÁN,235,SAN FERNANDO EL AGUACATE,2,41,28,13,2
OAXACA,20,SAN LUIS AMATLÁN,235,SAN ISIDRO GUISHE,2,28,15,13,2
OAXACA,20,SAN LUIS AMATLÁN,235,SAN LUIS AMATLÁN,3,185,84,101,11
OAXACA,20,SAN LUIS AMATLÁN,235,SITIO DEL PALMAR,4,222,117,105,16
OAXACA,20,SAN LUIS AMATLÁN,235,YEGOSÉ,1,4,3,1,1
OAXACA,20,SAN LUIS AMATLÁN,235,YEGOVEO,1,4,2,2,1
OAXACA,20,SAN LUIS AMATLÁN,235,ZAGALÁ,2,2,1,1,2
OAXACA,20,SAN MARCIAL OZOLOTEPEC,236,LA LUZ DEL ORIENTE,2,36,14,22,2
OAXACA,20,SAN MARCIAL OZOLOTEPEC,236,SAN MARCIAL OZOLOTEPEC,4,358,188,170,18
OAXACA,20,SAN MARCOS ARTEAGA,237,CERRO DE AGUA,1,10,4,6,1
OAXACA,20,SAN MARCOS ARTEAGA,237,SAN MARCOS ARTEAGA,4,229,130,99,17
OAXACA,20,SAN MARCOS ARTEAGA,237,VISTA HERMOSA LÁZARO CÁRDENAS,3,100,61,39,12
OAXACA,20,HEROICO SAN MARTÍN DE LOS CANSECOS,238,HEROICO SAN MARTÍN DE LOS CANSECOS,3,263,126,137,12
OAXACA,20,SAN MARTÍN HUAMELÚLPAM,239,SAN MARTÍN HUAMELÚLPAM,3,85,45,40,8
OAXACA,20,SAN MARTÍN HUAMELÚLPAM,239,TOTONUNDOO,2,35,18,17,3
OAXACA,20,SAN MARTÍN ITUNYOSO,240,LA CONCEPCIÓN,3,89,50,39,11
OAXACA,20,SAN MARTÍN ITUNYOSO,240,LOMA BUENOS AIRES,2,28,12,16,9
OAXACA,20,SAN MARTÍN ITUNYOSO,240,SAN JOSÉ XOCHIXTLÁN,4,161,95,66,15
OAXACA,20,SAN MARTÍN ITUNYOSO,240,SAN MARTÍN ITUNYOSO,5,434,194,240,25
OAXACA,20,SAN MARTÍN LACHILÁ,241,SAN MARTÍN LACHILÁ,6,293,172,121,23
OAXACA,20,SAN MARTÍN PERAS,242,AHUEJUTLA,4,297,148,149,10
OAXACA,20,SAN MARTÍN PERAS,242,BARRIO DEL CARMEN,1,11,6,5,4
OAXACA,20,SAN MARTÍN PERAS,242,BARRIO GUADALUPE SAN MIGUEL,1,38,19,19,6
OAXACA,20,SAN MARTÍN PERAS,242,BARRIO SAN ANTONIO,1,9,6,3,1
OAXACA,20,SAN MARTÍN PERAS,242,BARRIO SAN ANTONIO LOS PINOS,1,6,1,5,4
OAXACA,20,SAN MARTÍN PERAS,242,CHIÑÓN,3,149,80,69,10
OAXACA,20,SAN MARTÍN PERAS,242,EL ESPINAL,2,71,38,33,9
OAXACA,20,SAN MARTÍN PERAS,242,GUADALUPE,3,64,34,30,10
OAXACA,20,SAN MARTÍN PERAS,242,LA DIVINA PROVIDENCIA,2,33,18,15,7
OAXACA,20,SAN MARTÍN PERAS,242,LA ESCOPETA,3,124,67,57,12
OAXACA,20,SAN MARTÍN PERAS,242,LA JOYA PERAS (TIVAÁ),1,7,5,2,1
OAXACA,20,SAN MARTÍN PERAS,242,LA TRINIDAD ESCOPETA,1,5,1,4,1
OAXACA,20,SAN MARTÍN PERAS,242,LA TRINIDAD PERAS,3,136,77,59,15
OAXACA,20,SAN MARTÍN PERAS,242,LAS HUERTAS,2,47,24,23,9
OAXACA,20,SAN MARTÍN PERAS,242,LAS MINAS,3,77,40,37,11
OAXACA,20,SAN MARTÍN PERAS,242,LLANO DE ADOBE,2,10,5,5,1
OAXACA,20,SAN MARTÍN PERAS,242,LLANO GRANDE,2,13,5,8,1
OAXACA,20,SAN MARTÍN PERAS,242,PIEDRA AZUL,3,64,30,34,4
OAXACA,20,SAN MARTÍN PERAS,242,SABINILLO PERAS,1,9,6,3,1
OAXACA,20,SAN MARTÍN PERAS,242,SAN ISIDRO EL CHIÑÓN,1,5,3,2,1
OAXACA,20,SAN MARTÍN PERAS,242,SAN ISIDRO LA RAYA,2,48,27,21,4
OAXACA,20,SAN MARTÍN PERAS,242,SAN JUAN DEL RÍO,3,66,31,35,9
OAXACA,20,SAN MARTÍN PERAS,242,SAN MARCOS,3,58,30,28,11
OAXACA,20,SAN MARTÍN PERAS,242,SAN MARCOS DE LA FLOR,1,3,1,2,1
OAXACA,20,SAN MARTÍN PERAS,242,SAN MARTÍN PERAS,13,1091,622,469,84
OAXACA,20,SAN MARTÍN PERAS,242,SAN MIGUEL PERAS,3,200,116,84,13
OAXACA,20,SAN MARTÍN PERAS,242,SANTA CRUZ,1,16,4,12,1
OAXACA,20,SAN MARTÍN PERAS,242,SANTA CRUZ PAREDÓN,3,85,37,48,7
OAXACA,20,SAN MARTÍN PERAS,242,SANTIAGO PETLACALA,3,421,230,191,19
OAXACA,20,SAN MARTÍN PERAS,242,TIERRA COLORADA,1,36,19,17,6
OAXACA,20,SAN MARTÍN PERAS,242,VALLE SAN DIEGO,1,3,2,1,1
OAXACA,20,SAN MARTÍN TILCAJETE,243,SAN MARTÍN TILCAJETE,3,366,208,158,24
OAXACA,20,SAN MARTÍN TOXPALAN,244,CAPULTITLA,3,109,52,57,7
OAXACA,20,SAN MARTÍN TOXPALAN,244,CUIXTEPEC,2,27,14,13,3
OAXACA,20,SAN MARTÍN TOXPALAN,244,EL DURAZNILLO,4,250,128,122,16
OAXACA,20,SAN MARTÍN TOXPALAN,244,IGNACIO ZARAGOZA,2,51,19,32,6
OAXACA,20,SAN MARTÍN TOXPALAN,244,LAGUNILLAS,2,26,13,13,7
OAXACA,20,SAN MARTÍN TOXPALAN,244,SAN MARTÍN TOXPALAN,5,409,215,194,31
OAXACA,20,SAN MARTÍN TOXPALAN,244,VISTA HERMOSA,3,41,20,21,4
OAXACA,20,SAN MARTÍN ZACATEPEC,245,PLAN DEL VERGEL,3,116,64,52,12
OAXACA,20,SAN MARTÍN ZACATEPEC,245,SAN MARTÍN ZACATEPEC,3,175,100,75,13
OAXACA,20,SAN MATEO CAJONOS,246,SAN MATEO CAJONOS,4,165,83,82,12
OAXACA,20,CAPULÁLPAM DE MÉNDEZ,247,CAPULÁLPAM DE MÉNDEZ,4,605,311,294,97
OAXACA,20,SAN MATEO DEL MAR,248,BARRIO NUEVO,2,200,88,112,9
OAXACA,20,SAN MATEO DEL MAR,248,COLONIA CUAUHTÉMOC,4,218,101,117,13
OAXACA,20,SAN MATEO DEL MAR,248,COLONIA JUÁREZ,7,740,379,361,34
OAXACA,20,SAN MATEO DEL MAR,248,COSTA RICA,2,154,64,90,8
OAXACA,20,SAN MATEO DEL MAR,248,EL PACÍFICO,1,50,27,23,3
OAXACA,20,SAN MATEO DEL MAR,248,HUAZANTLÁN DEL RÍO,5,565,285,280,29
OAXACA,20,SAN MATEO DEL MAR,248,LA REFORMA,2,57,24,33,4
OAXACA,20,SAN MATEO DEL MAR,248,LAGUNA SANTA CRUZ,2,97,42,55,6
OAXACA,20,SAN MATEO DEL MAR,248,SAN MARTÍN,1,12,6,6,1
OAXACA,20,SAN MATEO DEL MAR,248,SAN MATEO DEL MAR,10,1369,638,731,75
OAXACA,20,SAN MATEO DEL MAR,248,SAN PABLO,3,195,102,93,10
OAXACA,20,SAN MATEO DEL MAR,248,VILLA HERMOSA,3,116,56,60,8
OAXACA,20,SAN MATEO YOLOXOCHITLÁN,249,BOCA DEL RÍO SAN MATEO,2,37,15,22,3
OAXACA,20,SAN MATEO YOLOXOCHITLÁN,249,LA REFORMA SAN MATEO,3,131,60,71,9
OAXACA,20,SAN MATEO YOLOXOCHITLÁN,249,SAN MATEO YOLOXOCHITLÁN,7,925,467,458,52
OAXACA,20,SAN MATEO ETLATONGO,250,LA LUZ,2,42,19,23,5
OAXACA,20,SAN MATEO ETLATONGO,250,SAN MATEO ETLATONGO,3,144,75,69,12
OAXACA,20,SAN MATEO NEJÁPAM,251,SAN MATEO NEJÁPAM,3,263,151,112,17
OAXACA,20,SAN MATEO NEJÁPAM,251,SANTO DOMINGO HIDALGO,1,10,4,6,4
OAXACA,20,SAN MATEO PEÑASCO,252,EL VERGEL,2,9,5,4,2
OAXACA,20,SAN MATEO PEÑASCO,252,SAN MATEO PEÑASCO,5,341,165,176,23
OAXACA,20,SAN MATEO PEÑASCO,252,SAN PEDRO EL ALTO,5,254,132,122,25
OAXACA,20,SAN MATEO PIÑAS,253,BUENAVISTA,1,11,4,7,5
OAXACA,20,SAN MATEO PIÑAS,253,CERRO LEÓN,1,55,30,25,6
OAXACA,20,SAN MATEO PIÑAS,253,COPALITA DE CERRO LEÓN,3,12,4,8,3
OAXACA,20,SAN MATEO PIÑAS,253,EL GAVILÁN,1,15,6,9,5
OAXACA,20,SAN MATEO PIÑAS,253,EL PERDIZ,2,35,15,20,7
OAXACA,20,SAN MATEO PIÑAS,253,LOMA LIMÓN,1,11,4,7,6
OAXACA,20,SAN MATEO PIÑAS,253,PIEDRA HUECA,2,8,5,3,1
OAXACA,20,SAN MATEO PIÑAS,253,RANCHO CAÑADA DE MINAS,2,8,4,4,2
OAXACA,20,SAN MATEO PIÑAS,253,RÍO CULEBRA,1,10,2,8,6
OAXACA,20,SAN MATEO PIÑAS,253,RÍO GIJÓN,1,12,3,9,6
OAXACA,20,SAN MATEO PIÑAS,253,SAN CRISTÓBAL,3,18,6,12,2
OAXACA,20,SAN MATEO PIÑAS,253,SAN MATEO PIÑAS,3,103,56,47,13
OAXACA,20,SAN MATEO PIÑAS,253,SULFATO,1,9,2,7,6
OAXACA,20,SAN MATEO PIÑAS,253,TÉ LIMÓN,1,6,2,4,1
OAXACA,20,SAN MATEO RÍO HONDO,254,BARRANCA GRANDE,1,6,4,2,1
OAXACA,20,SAN MATEO RÍO HONDO,254,EL NARANJAL,2,4,2,2,1
OAXACA,20,SAN MATEO RÍO HONDO,254,EL PROGRESO,2,8,4,4,1
OAXACA,20,SAN MATEO RÍO HONDO,254,JALATENGO,2,37,16,21,7
OAXACA,20,SAN MATEO RÍO HONDO,254,LA CONCEPCIÓN,2,5,3,2,2
OAXACA,20,SAN MATEO RÍO HONDO,254,LA DONCELLA,1,14,6,8,6
OAXACA,20,SAN MATEO RÍO HONDO,254,LA VICTORIA,2,18,12,6,2
OAXACA,20,SAN MATEO RÍO HONDO,254,LOMA SAN MARCIAL,2,4,3,1,2
OAXACA,20,SAN MATEO RÍO HONDO,254,MIRAMAR,2,10,4,6,2
OAXACA,20,SAN MATEO RÍO HONDO,254,PIEDRA GENTIL,1,5,3,2,1
OAXACA,20,SAN MATEO RÍO HONDO,254,RANCHERÍA YOGOLÓ (PIEDRA MANCHADA),1,6,1,5,1
OAXACA,20,SAN MATEO RÍO HONDO,254,RANCHO CAÑAS,2,11,5,6,2
OAXACA,20,SAN MATEO RÍO HONDO,254,RÍO CUAPINOL,1,12,6,6,1
OAXACA,20,SAN MATEO RÍO HONDO,254,RÍO MOLINO,2,10,6,4,1
OAXACA,20,SAN MATEO RÍO HONDO,254,SAN ANTONIO,2,18,9,9,2
OAXACA,20,SAN MATEO RÍO HONDO,254,SAN ILDEFONSO OZOLOTEPEC,3,137,77,60,12
OAXACA,20,SAN MATEO RÍO HONDO,254,SAN JOSÉ DEL PACÍFICO,4,252,143,109,17
OAXACA,20,SAN MATEO RÍO HONDO,254,SAN MATEO RÍO HONDO,4,212,111,101,15
OAXACA,20,SAN MATEO RÍO HONDO,254,SAN PABLO,2,5,4,1,1
OAXACA,20,SAN MATEO RÍO HONDO,254,YOGOLÓ,2,9,5,4,2
OAXACA,20,SAN MATEO SINDIHUI,255,SAN MATEO SINDIHUI,5,665,382,283,37
OAXACA,20,SAN MATEO TLAPILTEPEC,256,SAN MATEO TLAPILTEPEC,2,28,13,15,5
OAXACA,20,SAN MELCHOR BETAZA,257,SAN MELCHOR BETAZA,5,117,56,61,12
OAXACA,20,SAN MELCHOR BETAZA,257,SANTO TOMÁS LACHITÁ,3,122,54,68,7
OAXACA,20,SAN MIGUEL ACHIUTLA,258,SAN MIGUEL ACHIUTLA,3,116,50,66,13
OAXACA,20,SAN MIGUEL ACHIUTLA,258,SAN SEBASTIÁN ATOYAQUILLO,1,15,4,11,1
OAXACA,20,SAN MIGUEL AHUEHUETITLÁN,259,LA LUZ TENEXCALCO,3,85,43,42,11
OAXACA,20,SAN MIGUEL AHUEHUETITLÁN,259,SAN MIGUEL AHUEHUETITLÁN,5,491,284,207,31
OAXACA,20,SAN MIGUEL ALOÁPAM,260,SAN ISIDRO ALOÁPAM,4,125,70,55,9
OAXACA,20,SAN MIGUEL ALOÁPAM,260,SAN MIGUEL ALOÁPAM,4,357,209,148,25
OAXACA,20,SAN MIGUEL AMATITLÁN,261,CONCEPCIÓN PORFIRIO DÍAZ,3,73,34,39,12
OAXACA,20,SAN MIGUEL AMATITLÁN,261,EL CAJÓN DE PIEDRA,1,2,1,1,1
OAXACA,20,SAN MIGUEL AMATITLÁN,261,GUADALUPE LLANO GRANDE,3,29,10,19,3
OAXACA,20,SAN MIGUEL AMATITLÁN,261,GUADALUPE VILLAHERMOSA,3,20,7,13,8
OAXACA,20,SAN MIGUEL AMATITLÁN,261,LA LAGUNA,1,19,11,8,3
OAXACA,20,SAN MIGUEL AMATITLÁN,261,LA NUEVA TENOCHTITLÁN,1,8,2,6,5
OAXACA,20,SAN MIGUEL AMATITLÁN,261,SAN ANTONIO ZAHUATLÁN,3,155,86,69,12
OAXACA,20,SAN MIGUEL AMATITLÁN,261,SAN JORGE EL ZAPOTE,3,198,114,84,14
OAXACA,20,SAN MIGUEL AMATITLÁN,261,SAN JOSÉ TENERÍA,2,39,18,21,9
OAXACA,20,SAN MIGUEL AMATITLÁN,261,SAN LORENZO VISTA HERMOSA,5,365,207,158,27
OAXACA,20,SAN MIGUEL AMATITLÁN,261,SAN MIGUEL AMATITLÁN,5,427,244,183,29
OAXACA,20,SAN MIGUEL AMATITLÁN,261,SANTA CRUZ EL LIMÓN,3,119,65,54,8
OAXACA,20,SAN MIGUEL AMATITLÁN,261,SANTO DOMINGO YOLOTEPEC,4,428,214,214,30
OAXACA,20,SAN MIGUEL AMATITLÁN,261,VENTA URIBE DE JUÁREZ,3,141,79,62,16
OAXACA,20,SAN MIGUEL AMATITLÁN,261,XOCONOXTLE,3,120,63,57,12
OAXACA,20,SAN MIGUEL AMATLÁN,262,CUAJIMOLOYAS,4,174,96,78,13
OAXACA,20,SAN MIGUEL AMATLÁN,262,LLANO GRANDE,2,27,11,16,2
OAXACA,20,SAN MIGUEL AMATLÁN,262,SAN MIGUEL AMATLÁN,3,53,26,27,5
OAXACA,20,SAN MIGUEL COATLÁN,263,ALTA FLORIDA DEL SUR,1,5,4,1,1
OAXACA,20,SAN MIGUEL COATLÁN,263,CAMPO NUEVO,2,18,11,7,2
OAXACA,20,SAN MIGUEL COATLÁN,263,EL PROGRESO,3,20,8,12,2
OAXACA,20,SAN MIGUEL COATLÁN,263,LA SIERRA,3,64,36,28,10
OAXACA,20,SAN MIGUEL COATLÁN,263,LINDA VISTA,3,12,5,7,3
OAXACA,20,SAN MIGUEL COATLÁN,263,LLANO DE OCOTE,3,26,15,11,3
OAXACA,20,SAN MIGUEL COATLÁN,263,LLANO GRANDE,1,21,10,11,6
OAXACA,20,SAN MIGUEL COATLÁN,263,LLANO LA LUNA,2,8,4,4,2
OAXACA,20,SAN MIGUEL COATLÁN,263,LOMA LARGA (CERRO LARGO),1,4,3,1,1
OAXACA,20,SAN MIGUEL COATLÁN,263,RANCHERÍA DE LOS PÉREZ (NUEVA ESPERANZA),1,4,3,1,1
OAXACA,20,SAN MIGUEL COATLÁN,263,RÍO SAN JUAN,3,53,30,23,4
OAXACA,20,SAN MIGUEL COATLÁN,263,SAN MIGUEL COATLÁN,5,471,259,212,27
OAXACA,20,SAN MIGUEL CHICAHUA,264,EL FORTÍN ALTO,4,319,163,156,24
OAXACA,20,SAN MIGUEL CHICAHUA,264,LA CORREGIDORA TIERRA COLORADA,4,58,25,33,10
OAXACA,20,SAN MIGUEL CHICAHUA,264,SAN MIGUEL CHICAHUA,5,308,158,150,21
OAXACA,20,SAN MIGUEL CHIMALAPA,265,5 DE NOVIEMBRE (LA CRISTALINA),1,6,1,5,1
OAXACA,20,SAN MIGUEL CHIMALAPA,265,BENITO JUÁREZ (EL TRÉBOL),4,156,79,77,17
OAXACA,20,SAN MIGUEL CHIMALAPA,265,CIENEGUILLA,2,64,34,30,9
OAXACA,20,SAN MIGUEL CHIMALAPA,265,CUAUHTÉMOC GUADALUPE,3,102,62,40,12
OAXACA,20,SAN MIGUEL CHIMALAPA,265,EL PALMAR,1,15,6,9,6
OAXACA,20,SAN MIGUEL CHIMALAPA,265,EL PORVENIR,3,105,53,52,8
OAXACA,20,SAN MIGUEL CHIMALAPA,265,EL QUEBRACHAL,2,31,9,22,2
OAXACA,20,SAN MIGUEL CHIMALAPA,265,LA COMPUERTA,2,14,7,7,2
OAXACA,20,SAN MIGUEL CHIMALAPA,265,LAS ANONAS,2,51,27,24,9
OAXACA,20,SAN MIGUEL CHIMALAPA,265,LAS CONCHAS,4,330,158,172,22
OAXACA,20,SAN MIGUEL CHIMALAPA,265,LAS CRUCES,3,27,12,15,3
OAXACA,20,SAN MIGUEL CHIMALAPA,265,LOS LIMONES,3,84,43,41,8
OAXACA,20,SAN MIGUEL CHIMALAPA,265,PALO COLORADO,3,78,45,33,12
OAXACA,20,SAN MIGUEL CHIMALAPA,265,SAN ANTONIO,3,133,71,62,11
OAXACA,20,SAN MIGUEL CHIMALAPA,265,SAN MIGUEL CHIMALAPA,4,331,154,177,26
OAXACA,20,SAN MIGUEL CHIMALAPA,265,VISTA HERMOSA,4,182,97,85,13
OAXACA,20,SAN MIGUEL DEL PUERTO,266,ARROYO PIEDRA,1,4,1,3,1
OAXACA,20,SAN MIGUEL DEL PUERTO,266,BARRA COPALITA,5,450,227,223,37
OAXACA,20,SAN MIGUEL DEL PUERTO,266,BARRIO NUEVO,2,11,6,5,2
OAXACA,20,SAN MIGUEL DEL PUERTO,266,COPALITA LA HAMACA,3,25,12,13,4
OAXACA,20,SAN MIGUEL DEL PUERTO,266,EL GRANADILLO,3,23,12,11,2
OAXACA,20,SAN MIGUEL DEL PUERTO,266,EL TAMARINDO,3,5,1,4,2
OAXACA,20,SAN MIGUEL DEL PUERTO,266,EL ZAPOTE,1,8,3,5,1
OAXACA,20,SAN MIGUEL DEL PUERTO,266,LA BLAS XADANI,2,6,4,2,1
OAXACA,20,SAN MIGUEL DEL PUERTO,266,LA MERCED DEL POTRERO,6,358,173,185,30
OAXACA,20,SAN MIGUEL DEL PUERTO,266,LA REJA,2,5,2,3,2
OAXACA,20,SAN MIGUEL DEL PUERTO,266,LAS MUELLES,1,15,6,9,5
OAXACA,20,SAN MIGUEL DEL PUERTO,266,LLANO GRANDE,2,15,9,6,2
OAXACA,20,SAN MIGUEL DEL PUERTO,266,LLANO JÍCARA,2,11,7,4,2
OAXACA,20,SAN MIGUEL DEL PUERTO,266,LLANO PALACIO,3,18,9,9,3
OAXACA,20,SAN MIGUEL DEL PUERTO,266,LOMA LARGA O SAN ISIDRO,2,6,2,4,1
OAXACA,20,SAN MIGUEL DEL PUERTO,266,SAN MIGUEL DEL PUERTO,4,369,168,201,23
OAXACA,20,SAN MIGUEL DEL PUERTO,266,SANTA CATARINA JAMIXTEPEC,4,96,37,59,5
OAXACA,20,SAN MIGUEL DEL PUERTO,266,SANTA MARÍA PETATENGO,3,113,66,47,12
OAXACA,20,SAN MIGUEL DEL PUERTO,266,SANTA MARÍA XADANI,4,213,125,88,15
OAXACA,20,SAN MIGUEL DEL RÍO,267,SAN MIGUEL DEL RÍO,3,34,19,15,3
OAXACA,20,SAN MIGUEL EJUTLA,268,SAN MIGUEL EJUTLA,3,338,196,142,16
OAXACA,20,SAN MIGUEL EL GRANDE,269,BENITO JUÁREZ,2,23,12,11,2
OAXACA,20,SAN MIGUEL EL GRANDE,269,IGNACIO ZARAGOZA,3,128,66,62,8
OAXACA,20,SAN MIGUEL EL GRANDE,269,ITURBIDE,4,129,65,64,9
OAXACA,20,SAN MIGUEL EL GRANDE,269,MADERO,2,19,8,11,2
OAXACA,20,SAN MIGUEL EL GRANDE,269,MIGUEL HIDALGO,3,39,15,24,3
OAXACA,20,SAN MIGUEL EL GRANDE,269,MORELOS,1,14,5,9,1
OAXACA,20,SAN MIGUEL EL GRANDE,269,SAN MIGUEL EL GRANDE,5,1041,534,507,91
OAXACA,20,SAN MIGUEL EL GRANDE,269,VICENTE GUERRERO,3,72,34,38,4
OAXACA,20,SAN MIGUEL EL GRANDE,269,VILLA DE GUADALUPE VICTORIA,4,167,82,85,14
OAXACA,20,SAN MIGUEL HUAUTLA,270,CERRO VERDE,3,29,17,12,3
OAXACA,20,SAN MIGUEL HUAUTLA,270,SAN MIGUEL HUAUTLA,5,334,173,161,18
OAXACA,20,SAN MIGUEL HUAUTLA,270,TIERRA BLANCA,3,68,33,35,5
OAXACA,20,SAN MIGUEL MIXTEPEC,271,AGUA FRÍA CAMPANARIO,6,209,110,99,13
OAXACA,20,SAN MIGUEL MIXTEPEC,271,BARRANCA FIERRO,2,46,20,26,2
OAXACA,20,SAN MIGUEL MIXTEPEC,271,EL CAMPANARIO,1,9,3,6,1
OAXACA,20,SAN MIGUEL MIXTEPEC,271,LLANO VERDE,2,33,15,18,2
OAXACA,20,SAN MIGUEL MIXTEPEC,271,RANCHO FRUTAL,1,16,6,10,3
OAXACA,20,SAN MIGUEL MIXTEPEC,271,RÍO LIMA,2,42,21,21,9
OAXACA,20,SAN MIGUEL MIXTEPEC,271,SAN ISIDRO,3,117,59,58,6
OAXACA,20,SAN MIGUEL MIXTEPEC,271,SAN MIGUEL MIXTEPEC,5,326,150,176,17
OAXACA,20,SAN MIGUEL MIXTEPEC,271,TIERRA COLORADA,1,16,7,9,1
OAXACA,20,SAN MIGUEL PANIXTLAHUACA,272,EL PROGRESO,3,34,26,8,4
OAXACA,20,SAN MIGUEL PANIXTLAHUACA,272,EL TIZNE,1,4,2,2,1
OAXACA,20,SAN MIGUEL PANIXTLAHUACA,272,MAZAQUEZTLA,2,13,7,6,2
OAXACA,20,SAN MIGUEL PANIXTLAHUACA,272,SAN MIGUEL PANIXTLAHUACA,12,1814,889,925,87
OAXACA,20,SAN MIGUEL PERAS,273,BARRIO RÍO MORALES,2,44,16,28,3
OAXACA,20,SAN MIGUEL PERAS,273,EL MANZANITO,2,24,12,12,3
OAXACA,20,SAN MIGUEL PERAS,273,EL TECOLOTE,1,57,32,25,6
OAXACA,20,SAN MIGUEL PERAS,273,EL TEMASCAL,3,96,45,51,6
OAXACA,20,SAN MIGUEL PERAS,273,LA BRUJERÍA,2,59,24,35,3
OAXACA,20,SAN MIGUEL PERAS,273,PENSAMIENTO LIBERAL MEXICANO,3,194,106,88,13
OAXACA,20,SAN MIGUEL PERAS,273,SAN MIGUEL PERAS,5,427,223,204,28
OAXACA,20,SAN MIGUEL PERAS,273,SOLEDAD PERAS,5,231,123,108,14
OAXACA,20,SAN MIGUEL PIEDRAS,274,CHIDOCO,2,62,30,32,5
OAXACA,20,SAN MIGUEL PIEDRAS,274,GUADALUPE VICTORIA,1,6,1,5,2
OAXACA,20,SAN MIGUEL PIEDRAS,274,RÍO MINAS,2,49,25,24,2
OAXACA,20,SAN MIGUEL PIEDRAS,274,SAN MIGUEL PIEDRAS,4,255,139,116,14
OAXACA,20,SAN MIGUEL QUETZALTEPEC,275,CHUXNABÁN,5,269,129,140,16
OAXACA,20,SAN MIGUEL QUETZALTEPEC,275,DIVINAS FLORES,1,10,4,6,1
OAXACA,20,SAN MIGUEL QUETZALTEPEC,275,EL ARMADILLO,2,83,42,41,5
OAXACA,20,SAN MIGUEL QUETZALTEPEC,275,MARGARITA HUITEPEC,3,327,156,171,14
OAXACA,20,SAN MIGUEL QUETZALTEPEC,275,SAN MIGUEL QUETZALTEPEC,11,1100,558,542,63
OAXACA,20,SAN MIGUEL QUETZALTEPEC,275,SANTA CRUZ CONDOY,3,126,62,64,8
OAXACA,20,SAN MIGUEL SANTA FLOR,276,PEÑA ARDILLA,1,19,9,10,2
OAXACA,20,SAN MIGUEL SANTA FLOR,276,SAN MIGUEL SANTA FLOR,3,112,61,51,12
OAXACA,20,VILLA SOLA DE VEGA,277,AGUA DEL SABINO,2,5,2,3,1
OAXACA,20,VILLA SOLA DE VEGA,277,ARROYO DE LA ROSA (CUARTA SECCIÓN),1,8,4,4,1
OAXACA,20,VILLA SOLA DE VEGA,277,BARRIO LAS PEÑAS,3,20,11,9,2
OAXACA,20,VILLA SOLA DE VEGA,277,CANDELARIA LA ESTANCIA,3,55,32,23,7
OAXACA,20,VILLA SOLA DE VEGA,277,EL ANÍS,2,19,8,11,7
OAXACA,20,VILLA SOLA DE VEGA,277,EL CARRIZAL,3,46,22,24,7
OAXACA,20,VILLA SOLA DE VEGA,277,EL COMÚN,3,110,51,59,10
OAXACA,20,VILLA SOLA DE VEGA,277,EL GARABATO,1,5,4,1,1
OAXACA,20,VILLA SOLA DE VEGA,277,EL HUAZÁN,1,6,4,2,1
OAXACA,20,VILLA SOLA DE VEGA,277,EL PROGRESO (SAN JUAN ELOTEPEC),2,49,17,32,3
OAXACA,20,VILLA SOLA DE VEGA,277,EL SITIO,3,39,19,20,8
OAXACA,20,VILLA SOLA DE VEGA,277,GUAYABO,1,4,0,4,1
OAXACA,20,VILLA SOLA DE VEGA,277,GUICHILA (CUARTA SECCIÓN),2,10,5,5,2
OAXACA,20,VILLA SOLA DE VEGA,277,GULERA,2,49,21,28,6
OAXACA,20,VILLA SOLA DE VEGA,277,LA DIVINA CONCEPCIÓN [BARRIO],2,9,4,5,1
OAXACA,20,VILLA SOLA DE VEGA,277,LA NOPALERA (SAN JUAN ELOTEPEC),3,19,10,9,3
OAXACA,20,VILLA SOLA DE VEGA,277,LA SOLEDAD,2,7,3,4,1
OAXACA,20,VILLA SOLA DE VEGA,277,LA SOLEDAD SANTA ANA [BARRIO],2,4,1,3,1
OAXACA,20,VILLA SOLA DE VEGA,277,LA V,1,6,2,4,3
OAXACA,20,VILLA SOLA DE VEGA,277,LA YERBA SANTA,2,19,11,8,2
OAXACA,20,VILLA SOLA DE VEGA,277,LAGUNA SECA (CUARTA SECCIÓN),3,18,11,7,2
OAXACA,20,VILLA SOLA DE VEGA,277,LAS JUNTAS (SAN JUAN ELOTEPEC),2,8,2,6,1
OAXACA,20,VILLA SOLA DE VEGA,277,LAZO,1,16,7,9,1
OAXACA,20,VILLA SOLA DE VEGA,277,LLANO MONTE (SAN JUAN ELOTEPEC),2,51,27,24,3
OAXACA,20,VILLA SOLA DE VEGA,277,LOS LIMONES,2,14,8,6,2
OAXACA,20,VILLA SOLA DE VEGA,277,LOS MORALES,2,11,4,7,1
OAXACA,20,VILLA SOLA DE VEGA,277,NACHIHUÍ,1,4,3,1,1
OAXACA,20,VILLA SOLA DE VEGA,277,PIEDRA COLORADA,3,9,4,5,2
OAXACA,20,VILLA SOLA DE VEGA,277,POTRERILLO,3,30,13,17,3
OAXACA,20,VILLA SOLA DE VEGA,277,POTRERO,3,79,45,34,8
OAXACA,20,VILLA SOLA DE VEGA,277,RANCHO VIEJO,3,81,40,41,8
OAXACA,20,VILLA SOLA DE VEGA,277,RÍO ESPEJO (SAN JUAN ELOTEPEC),2,9,6,3,1
OAXACA,20,VILLA SOLA DE VEGA,277,RÍO MANTECA (SAN JUAN ELOTEPEC),3,30,16,14,8
OAXACA,20,VILLA SOLA DE VEGA,277,SAN AGUSTÍN,2,28,16,12,2
OAXACA,20,VILLA SOLA DE VEGA,277,SAN ANTONIO,1,18,8,10,6
OAXACA,20,VILLA SOLA DE VEGA,277,SAN CRISTÓBAL,3,125,66,59,9
OAXACA,20,VILLA SOLA DE VEGA,277,SAN FELIPE ZAPOTITLÁN,3,96,56,40,10
OAXACA,20,VILLA SOLA DE VEGA,277,SAN ISIDRO OJO DE AGUA,3,64,25,39,6
OAXACA,20,VILLA SOLA DE VEGA,277,SAN JUAN BAUTISTA,2,75,41,34,9
OAXACA,20,VILLA SOLA DE VEGA,277,SAN JUAN ELOTEPEC,3,136,68,68,11
OAXACA,20,VILLA SOLA DE VEGA,277,SAN JUAN VIEJO ( SAN JUAN ELOTEPEC),2,9,4,5,2
OAXACA,20,VILLA SOLA DE VEGA,277,SAN MARTÍN SIEMPRE VIVA,3,25,9,16,6
OAXACA,20,VILLA SOLA DE VEGA,277,SAN SEBASTIÁN DE LAS GRUTAS,3,224,121,103,16
OAXACA,20,VILLA SOLA DE VEGA,277,SANTA ANA,2,30,16,14,5
OAXACA,20,VILLA SOLA DE VEGA,277,SANTA CATARINA LA CAÑADA,1,3,3,0,1
OAXACA,20,VILLA SOLA DE VEGA,277,SANTA INÉS SOLA,2,43,22,21,5
OAXACA,20,VILLA SOLA DE VEGA,277,SANTOS REYES SOLA,3,59,33,26,6
OAXACA,20,VILLA SOLA DE VEGA,277,VILLA SOLA DE VEGA,8,1058,593,465,89
OAXACA,20,VILLA SOLA DE VEGA,277,YOGANITA,2,17,8,9,6
OAXACA,20,VILLA SOLA DE VEGA,277,YOGORENTE,2,43,26,17,3
OAXACA,20,VILLA SOLA DE VEGA,277,ZETA,3,33,20,13,4
OAXACA,20,SAN MIGUEL SOYALTEPEC,278,AGUA ESCONDIDA,3,56,32,24,4
OAXACA,20,SAN MIGUEL SOYALTEPEC,278,ARROYO CARACOL,3,54,28,26,4
OAXACA,20,SAN MIGUEL SOYALTEPEC,278,ARROYO CHICAL,5,510,225,285,29
OAXACA,20,SAN MIGUEL SOYALTEPEC,278,ARROYO DE ENMEDIO,2,50,32,18,3
OAXACA,20,SAN MIGUEL SOYALTEPEC,278,ARROYO TIGRE,4,131,74,57,9
OAXACA,20,SAN MIGUEL SOYALTEPEC,278,BENITO JUÁREZ II,5,359,179,180,20
OAXACA,20,SAN MIGUEL SOYALTEPEC,278,CABEZA DE TIGRE,4,253,109,144,17
OAXACA,20,SAN MIGUEL SOYALTEPEC,278,CERRO DE AGUA PLATANAR,4,179,84,95,10
OAXACA,20,SAN MIGUEL SOYALTEPEC,278,CERRO TEPEXCUINTLE,5,269,136,133,18
OAXACA,20,SAN MIGUEL SOYALTEPEC,278,CERRO VERDE,2,6,5,1,1
OAXACA,20,SAN MIGUEL SOYALTEPEC,278,COLONIA COSOLTEPEC,2,43,19,24,4
OAXACA,20,SAN MIGUEL SOYALTEPEC,278,COLONIA INGENIERO RAÚL SANDOVAL LANDÁZURI,2,44,24,20,3
OAXACA,20,SAN MIGUEL SOYALTEPEC,278,CORRAL DE PIEDRA,5,205,104,101,12
OAXACA,20,SAN MIGUEL SOYALTEPEC,278,CORRIENTE ANCHA O MIGUEL HIDALGO,3,94,41,53,6
OAXACA,20,SAN MIGUEL SOYALTEPEC,278,COSOLAPA CARACOL,3,61,31,30,4
OAXACA,20,SAN MIGUEL SOYALTEPEC,278,EL CAPULÍN,4,252,130,122,18
OAXACA,20,SAN MIGUEL SOYALTEPEC,278,EL CARMEN,2,58,25,33,6
OAXACA,20,SAN MIGUEL SOYALTEPEC,278,EL ENCAJONADO,1,253,125,128,10
OAXACA,20,SAN MIGUEL SOYALTEPEC,278,ISLA DE MÁLZAGA,4,143,73,70,11
OAXACA,20,SAN MIGUEL SOYALTEPEC,278,ISLA DEL VIEJO SOYALTEPEC,4,236,119,117,12
OAXACA,20,SAN MIGUEL SOYALTEPEC,278,LA CANDELARIA,3,111,55,56,10
OAXACA,20,SAN MIGUEL SOYALTEPEC,278,LA REFORMA,3,232,122,110,12
OAXACA,20,SAN MIGUEL SOYALTEPEC,278,LA REFORMA (LA REFORMITA),5,147,70,77,12
OAXACA,20,SAN MIGUEL SOYALTEPEC,278,LAS MARGARITAS,5,642,327,315,34
OAXACA,20,SAN MIGUEL SOYALTEPEC,278,LOMA BONITA,3,58,21,37,4
OAXACA,20,SAN MIGUEL SOYALTEPEC,278,NUEVA CALERÍA,3,78,40,38,6
OAXACA,20,SAN MIGUEL SOYALTEPEC,278,NUEVA PATRIA,4,214,96,118,12
OAXACA,20,SAN MIGUEL SOYALTEPEC,278,NUEVO BUENAVISTA,3,78,44,34,7
OAXACA,20,SAN MIGUEL SOYALTEPEC,278,NUEVO PASO NAZARENO,5,527,275,252,29
OAXACA,20,SAN MIGUEL SOYALTEPEC,278,NUEVO PESCADITO DE ABAJO,5,315,143,172,20
OAXACA,20,SAN MIGUEL SOYALTEPEC,278,NUEVO PESCADITO DE ABAJO DOS,3,166,86,80,9
OAXACA,20,SAN MIGUEL SOYALTEPEC,278,NUEVO PESCADITO DE ENMEDIO,4,304,141,163,16
OAXACA,20,SAN MIGUEL SOYALTEPEC,278,NUEVO PESCADITO DE MÁLZAGA (LA BREÑA),4,206,109,97,13
OAXACA,20,SAN MIGUEL SOYALTEPEC,278,NUEVO SOYALTEPEC,3,89,40,49,7
OAXACA,20,SAN MIGUEL SOYALTEPEC,278,PESCADITO DE ARRIBA,3,131,68,63,9
OAXACA,20,SAN MIGUEL SOYALTEPEC,278,PIEDRA DE AMOLAR,5,485,243,242,26
OAXACA,20,SAN MIGUEL SOYALTEPEC,278,PLAYA DE JÍCAMA,2,33,19,14,4
OAXACA,20,SAN MIGUEL SOYALTEPEC,278,PLAYA LECUONA,3,383,204,179,24
OAXACA,20,SAN MIGUEL SOYALTEPEC,278,RINCÓN BONITO,3,55,28,27,4
OAXACA,20,SAN MIGUEL SOYALTEPEC,278,SAN ANTONIO ABAD,2,22,10,12,2
OAXACA,20,SAN MIGUEL SOYALTEPEC,278,SAN ANTONIO COSOLAPA,4,123,60,63,8
OAXACA,20,SAN MIGUEL SOYALTEPEC,278,TEMASCAL,26,2643,1378,1265,159
OAXACA,20,SAN MIGUEL SUCHIXTEPEC,279,LOMA MORILLO,2,145,65,80,8
OAXACA,20,SAN MIGUEL SUCHIXTEPEC,279,SAN MIGUEL SUCHIXTEPEC,4,581,329,252,32
OAXACA,20,VILLA TALEA DE CASTRO,280,OTATITLÁN DE MORELOS,1,12,5,7,6
OAXACA,20,VILLA TALEA DE CASTRO,280,SAN BARTOLOMÉ YATONI,2,37,17,20,7
OAXACA,20,VILLA TALEA DE CASTRO,280,SANTA GERTRUDIS,1,10,4,6,5
OAXACA,20,VILLA TALEA DE CASTRO,280,VILLA TALEA DE CASTRO,5,359,188,171,29
OAXACA,20,SAN MIGUEL TECOMATLÁN,281,SAN MIGUEL TECOMATLÁN,2,48,24,24,6
OAXACA,20,SAN MIGUEL TENANGO,282,SAN MIGUEL TENANGO,3,123,61,62,12
OAXACA,20,SAN MIGUEL TEQUIXTEPEC,283,NATA,2,22,11,11,3
OAXACA,20,SAN MIGUEL TEQUIXTEPEC,283,PALO SOLO,2,34,16,18,5
OAXACA,20,SAN MIGUEL TEQUIXTEPEC,283,SAN MIGUEL TEQUIXTEPEC,3,105,50,55,12
OAXACA,20,SAN MIGUEL TEQUIXTEPEC,283,SANTA CRUZ CAPULÁLPAM,1,18,10,8,2
OAXACA,20,SAN MIGUEL TILQUIÁPAM,284,SAN MIGUEL TILQUIÁPAM,5,613,349,264,36
OAXACA,20,SAN MIGUEL TLACAMAMA,285,EL TERRERO,2,42,22,20,9
OAXACA,20,SAN MIGUEL TLACAMAMA,285,EL ZAPOTE,3,87,47,40,9
OAXACA,20,SAN MIGUEL TLACAMAMA,285,LA CAÑADA DEL MARQUÉS,3,78,41,37,7
OAXACA,20,SAN MIGUEL TLACAMAMA,285,LA ESPERANZA,2,60,31,29,9
OAXACA,20,SAN MIGUEL TLACAMAMA,285,SAN MIGUEL TLACAMAMA,5,538,304,234,33
OAXACA,20,SAN MIGUEL TLACOTEPEC,286,GUADALUPE NUCATE,2,23,11,12,2
OAXACA,20,SAN MIGUEL TLACOTEPEC,286,SAN MARTÍN SABINILLO,2,55,30,25,9
OAXACA,20,SAN MIGUEL TLACOTEPEC,286,SAN MIGUEL TLACOTEPEC,5,455,239,216,29
OAXACA,20,SAN MIGUEL TLACOTEPEC,286,SANTIAGO NUXAÑO,3,78,35,43,12
OAXACA,20,SAN MIGUEL TLACOTEPEC,286,XINITIOCO,1,23,12,11,2
OAXACA,20,SAN MIGUEL TLACOTEPEC,286,YOSONDALLA,1,16,7,9,6
OAXACA,20,SAN MIGUEL TULANCINGO,287,SAN MIGUEL TULANCINGO,3,39,23,16,8
OAXACA,20,SAN MIGUEL YOTAO,288,SAN MIGUEL YOTAO,3,134,72,62,10
OAXACA,20,SAN NICOLÁS,289,BRAMADEROS SAN NICOLÁS,2,46,23,23,9
OAXACA,20,SAN NICOLÁS,289,SAN NICOLÁS,3,198,115,83,15
OAXACA,20,SAN NICOLÁS HIDALGO,290,SAN NICOLÁS HIDALGO,3,185,98,87,12
OAXACA,20,SAN PABLO COATLÁN,291,COMITLÁN,3,124,68,56,7
OAXACA,20,SAN PABLO COATLÁN,291,LA SOLEDAD EL TAMARINDO,3,50,26,24,3
OAXACA,20,SAN PABLO COATLÁN,291,SAN ANTONIO LALANA,4,254,132,122,15
OAXACA,20,SAN PABLO COATLÁN,291,SAN FRANCISCO COATLÁN,4,477,257,220,28
OAXACA,20,SAN PABLO COATLÁN,291,SAN PABLO COATLÁN,4,196,115,81,19
OAXACA,20,SAN PABLO COATLÁN,291,SANTA MARÍA COATLÁN,3,73,35,38,11
OAXACA,20,SAN PABLO CUATRO VENADOS,292,EL ESPONJADO,2,5,3,2,1
OAXACA,20,SAN PABLO CUATRO VENADOS,292,EL ZACATÓN,2,28,14,14,3
OAXACA,20,SAN PABLO CUATRO VENADOS,292,RÍO JALAPILLA,3,109,62,47,10
OAXACA,20,SAN PABLO CUATRO VENADOS,292,RÍO MINAS,1,91,39,52,6
OAXACA,20,SAN PABLO CUATRO VENADOS,292,SAN CRISTÓBAL,2,19,10,9,5
OAXACA,20,SAN PABLO CUATRO VENADOS,292,SAN PABLO CUATRO VENADOS,4,445,223,222,26
OAXACA,20,SAN PABLO ETLA,293,BARRIO MORELOS,1,40,22,18,3
OAXACA,20,SAN PABLO ETLA,293,HACIENDA BLANCA,8,1059,583,476,66
OAXACA,20,SAN PABLO ETLA,293,POBLADO MORELOS,2,125,69,56,9
OAXACA,20,SAN PABLO ETLA,293,SAN PABLO ETLA,9,1184,664,520,75
OAXACA,20,SAN PABLO ETLA,293,SAN SEBASTIÁN,9,1014,469,545,85
OAXACA,20,SAN PABLO HUITZO,294,SAN PABLO HUITZO,9,1843,1027,816,88
OAXACA,20,SAN PABLO HUITZO,294,SANTA MARÍA TENÉXPAM,3,124,71,53,10
OAXACA,20,SAN PABLO HUIXTEPEC,295,BARRIO SAN ANTONIO,3,468,276,192,31
OAXACA,20,SAN PABLO HUIXTEPEC,295,SAN PABLO HUIXTEPEC,8,3516,1883,1633,253
OAXACA,20,SAN PABLO MACUILTIANGUIS,296,SAN JUAN LUVINA,3,78,41,37,8
OAXACA,20,SAN PABLO MACUILTIANGUIS,296,SAN PABLO MACUILTIANGUIS,3,74,41,33,22
OAXACA,20,SAN PABLO TIJALTEPEC,297,BUENA VISTA LA PAZ,4,70,35,35,7
OAXACA,20,SAN PABLO TIJALTEPEC,297,CANDELARIA LA UNIÓN,4,121,53,68,9
OAXACA,20,SAN PABLO TIJALTEPEC,297,EL PORVENIR,4,119,64,55,9
OAXACA,20,SAN PABLO TIJALTEPEC,297,GUADALUPE VICTORIA,1,14,7,7,1
OAXACA,20,SAN PABLO TIJALTEPEC,297,JUQUILA INDEPENDENCIA,1,4,2,2,1
OAXACA,20,SAN PABLO TIJALTEPEC,297,SAN CRISTÓBAL LINDA VISTA,2,13,3,10,2
OAXACA,20,SAN PABLO TIJALTEPEC,297,SAN LUCAS REDENCIÓN,3,33,18,15,3
OAXACA,20,SAN PABLO TIJALTEPEC,297,SAN PABLO TIJALTEPEC,5,256,128,128,15
OAXACA,20,SAN PABLO TIJALTEPEC,297,SANTO DOMINGO DEL PROGRESO,3,46,20,26,4
OAXACA,20,SAN PABLO TIJALTEPEC,297,VISTA HERMOSA,3,69,35,34,5
OAXACA,20,SAN PABLO VILLA DE MITLA,298,SAN JOSÉ DEL PASO,2,20,7,13,9
OAXACA,20,SAN PABLO VILLA DE MITLA,298,SAN MIGUEL ALBARRADAS,3,51,26,25,12
OAXACA,20,SAN PABLO VILLA DE MITLA,298,SAN PABLO VILLA DE MITLA,13,2446,1249,1197,144
OAXACA,20,SAN PABLO VILLA DE MITLA,298,SANTA MARÍA ALBARRADAS,3,128,68,60,13
OAXACA,20,SAN PABLO VILLA DE MITLA,298,UNIÓN ZAPATA (LOMA LARGA),3,134,75,59,12
OAXACA,20,SAN PABLO VILLA DE MITLA,298,XAAGÁ,3,254,147,107,18
OAXACA,20,SAN PABLO YAGANIZA,299,SAN PABLO YAGANIZA,4,276,139,137,13
OAXACA,20,SAN PEDRO AMUZGOS,300,LA GUADALUPE,2,196,100,96,14
OAXACA,20,SAN PEDRO AMUZGOS,300,LLANO DE AMUZGOS,2,45,23,22,9
OAXACA,20,SAN PEDRO AMUZGOS,300,SAN JUAN,1,20,11,9,5
OAXACA,20,SAN PEDRO AMUZGOS,300,SAN MARTÍN,1,32,17,15,6
OAXACA,20,SAN PEDRO AMUZGOS,300,SAN PEDRO AMUZGOS,12,1266,710,556,94
OAXACA,20,SAN PEDRO AMUZGOS,300,SAN PEDRO APÓSTOL,1,37,21,16,6
OAXACA,20,SAN PEDRO APÓSTOL,301,SAN PEDRO APÓSTOL,3,339,183,156,25
OAXACA,20,SAN PEDRO ATOYAC,302,CRUZ COLORADA,1,38,22,16,3
OAXACA,20,SAN PEDRO ATOYAC,302,EL NARANJO,1,16,6,10,1
OAXACA,20,SAN PEDRO ATOYAC,302,LA GUADALUPE,1,19,8,11,1
OAXACA,20,SAN PEDRO ATOYAC,302,LA PALMA,2,48,24,24,3
OAXACA,20,SAN PEDRO ATOYAC,302,SAN ANTONIO CARRIZO,1,13,4,9,6
OAXACA,20,SAN PEDRO ATOYAC,302,SAN MARTÍN RANCHO NUEVO,2,16,11,5,2
OAXACA,20,SAN PEDRO ATOYAC,302,SAN PEDRO ATOYAC,6,935,477,458,51
OAXACA,20,SAN PEDRO ATOYAC,302,ZAPOTE BLANCO,2,114,56,58,6
OAXACA,20,SAN PEDRO CAJONOS,303,SAN PEDRO CAJONOS,4,376,185,191,21
OAXACA,20,SAN PEDRO COXCALTEPEC CÁNTAROS,304,SAN JUAN IXTALTEPEC,2,39,17,22,3
OAXACA,20,SAN PEDRO COXCALTEPEC CÁNTAROS,304,SAN PEDRO COXCALTEPEC CÁNTAROS,3,41,21,20,11
OAXACA,20,SAN PEDRO COXCALTEPEC CÁNTAROS,304,YODODEÑE,4,79,35,44,8
OAXACA,20,SAN PEDRO COMITANCILLO,305,SAN PEDRO COMITANCILLO,11,2139,1068,1071,153
OAXACA,20,SAN PEDRO EL ALTO,306,2 DE MAYO,2,11,5,6,2
OAXACA,20,SAN PEDRO EL ALTO,306,CERRO DE LAS NUBES,2,28,11,17,2
OAXACA,20,SAN PEDRO EL ALTO,306,EL PORVENIR,3,119,59,60,7
OAXACA,20,SAN PEDRO EL ALTO,306,EL POTRERO JAZMÍN,3,117,63,54,22
OAXACA,20,SAN PEDRO EL ALTO,306,LAGUNILLA,3,98,52,46,7
OAXACA,20,SAN PEDRO EL ALTO,306,LLANO FLOR,2,70,33,37,3
OAXACA,20,SAN PEDRO EL ALTO,306,LOMA CANELA,2,60,24,36,3
OAXACA,20,SAN PEDRO EL ALTO,306,LOS PINOS,2,32,15,17,3
OAXACA,20,SAN PEDRO EL ALTO,306,MALVARISCO,2,47,25,22,4
OAXACA,20,SAN PEDRO EL ALTO,306,MONTEVIDEO,2,22,10,12,2
OAXACA,20,SAN PEDRO EL ALTO,306,SAN PEDRO EL ALTO,4,329,172,157,15
OAXACA,20,SAN PEDRO EL ALTO,306,TIERRA BLANCA,2,96,44,52,5
OAXACA,20,SAN PEDRO HUAMELULA,307,EL COYUL,8,805,407,398,62
OAXACA,20,SAN PEDRO HUAMELULA,307,EL GAVILÁN,1,12,6,6,1
OAXACA,20,SAN PEDRO HUAMELULA,307,EL LIMÓN,1,12,4,8,1
OAXACA,20,SAN PEDRO HUAMELULA,307,GUAYACÁN,3,84,41,43,5
OAXACA,20,SAN PEDRO HUAMELULA,307,MORRO AYUTA,4,100,45,55,9
OAXACA,20,SAN PEDRO HUAMELULA,307,PLAYA GRANDE,3,49,23,26,4
OAXACA,20,SAN PEDRO HUAMELULA,307,RÍO SECO,5,128,56,72,13
OAXACA,20,SAN PEDRO HUAMELULA,307,SAN FRANCISCO DE ASÍS,1,12,5,7,4
OAXACA,20,SAN PEDRO HUAMELULA,307,SAN ISIDRO CHACALAPA,4,93,52,41,11
OAXACA,20,SAN PEDRO HUAMELULA,307,SAN PEDRO HUAMELULA,7,619,329,290,47
OAXACA,20,SAN PEDRO HUAMELULA,307,SANTA MARÍA,4,349,154,195,22
OAXACA,20,SAN PEDRO HUAMELULA,307,TAPANALÁ,4,253,132,121,16
OAXACA,20,SAN PEDRO HUILOTEPEC,308,SAN PEDRO HUILOTEPEC,7,839,412,427,42
OAXACA,20,SAN PEDRO IXCATLÁN,309,ARROYO MURCIÉLAGO,3,140,59,81,10
OAXACA,20,SAN PEDRO IXCATLÁN,309,ARROYO ZONTLE,2,51,23,28,3
OAXACA,20,SAN PEDRO IXCATLÁN,309,CAMINO SACRISTÁN,3,150,80,70,8
OAXACA,20,SAN PEDRO IXCATLÁN,309,CERRO BENITO JUÁREZ,3,31,16,15,3
OAXACA,20,SAN PEDRO IXCATLÁN,309,CERRO CAMARÓN,2,13,7,6,2
OAXACA,20,SAN PEDRO IXCATLÁN,309,CERRO QUEMADO,5,483,236,247,45
OAXACA,20,SAN PEDRO IXCATLÁN,309,EL PROGRESO,3,149,69,80,11
OAXACA,20,SAN PEDRO IXCATLÁN,309,EMILIANO ZAPATA,4,97,47,50,6
OAXACA,20,SAN PEDRO IXCATLÁN,309,LA CABEZA DE TÍLPAM,4,220,116,104,13
OAXACA,20,SAN PEDRO IXCATLÁN,309,LA LAGUNA,2,53,23,30,3
OAXACA,20,SAN PEDRO IXCATLÁN,309,LA LUNA,2,13,7,6,2
OAXACA,20,SAN PEDRO IXCATLÁN,309,LA POCHOTA,2,24,13,11,2
OAXACA,20,SAN PEDRO IXCATLÁN,309,LA RAYA DE IXCATLÁN,3,90,39,51,6
OAXACA,20,SAN PEDRO IXCATLÁN,309,LOMA COYOL SAN MARTÍN,2,93,48,45,8
OAXACA,20,SAN PEDRO IXCATLÁN,309,LOMA SAN JUAN,1,30,16,14,3
OAXACA,20,SAN PEDRO IXCATLÁN,309,SAN FELIPE TÍLPAM,5,336,168,168,19
OAXACA,20,SAN PEDRO IXCATLÁN,309,SAN PEDRO IXCATLÁN,8,1000,523,477,52
OAXACA,20,SAN PEDRO IXTLAHUACA,310,BUENA VISTA,2,148,81,67,11
OAXACA,20,SAN PEDRO IXTLAHUACA,310,EL LLANO [PARAJE],1,221,109,112,12
OAXACA,20,SAN PEDRO IXTLAHUACA,310,JARDINES DEL TEPEYAC,1,100,58,42,7
OAXACA,20,SAN PEDRO IXTLAHUACA,310,LA CONCEPCIÓN,2,72,39,33,8
OAXACA,20,SAN PEDRO IXTLAHUACA,310,LAS RAZAS,2,157,90,67,13
OAXACA,20,SAN PEDRO IXTLAHUACA,310,PIEDRAS NEGRAS [COLONIA],2,32,21,11,3
OAXACA,20,SAN PEDRO IXTLAHUACA,310,RANCHO DE LOS AUDELO,2,204,120,84,15
OAXACA,20,SAN PEDRO IXTLAHUACA,310,SAN PEDRO IXTLAHUACA,11,1910,1082,828,87
OAXACA,20,SAN PEDRO JALTEPETONGO,311,SAN PEDRO JALTEPETONGO,3,113,63,50,14
OAXACA,20,SAN PEDRO JICAYÁN,312,AGUA DULCE,3,99,56,43,12
OAXACA,20,SAN PEDRO JICAYÁN,312,CHUPARROSA,3,228,133,95,21
OAXACA,20,SAN PEDRO JICAYÁN,312,EL LIMÓN REAL,2,31,16,15,9
OAXACA,20,SAN PEDRO JICAYÁN,312,LA HIERBA SANTA,2,50,26,24,3
OAXACA,20,SAN PEDRO JICAYÁN,312,LOS MARCELO [COLONIA],2,33,16,17,9
OAXACA,20,SAN PEDRO JICAYÁN,312,RÍO YUTANDUA,1,40,19,21,2
OAXACA,20,SAN PEDRO JICAYÁN,312,SAN JOSÉ YUTATUYAA,3,184,104,80,14
OAXACA,20,SAN PEDRO JICAYÁN,312,SAN JUAN JICAYÁN,6,586,319,267,40
OAXACA,20,SAN PEDRO JICAYÁN,312,SAN PEDRO JICAYÁN,16,1602,857,745,117
OAXACA,20,SAN PEDRO JICAYÁN,312,SANTIAGO JICAYÁN,3,261,146,115,18
OAXACA,20,SAN PEDRO JICAYÁN,312,YUTANDAYOO,4,325,180,145,20
OAXACA,20,SAN PEDRO JOCOTIPAC,313,SAN PEDRO JOCOTIPAC,5,174,81,93,15
OAXACA,20,SAN PEDRO JUCHATENGO,314,SAN PEDRO JUCHATENGO,4,439,225,214,24
OAXACA,20,SAN PEDRO MÁRTIR,315,SAN PEDRO MÁRTIR,5,612,280,332,30
OAXACA,20,SAN PEDRO MÁRTIR QUIECHAPA,316,SAN PEDRO MÁRTIR QUIECHAPA,4,148,86,62,15
OAXACA,20,SAN PEDRO MÁRTIR YUCUXACO,317,CAÑADA MARÍA,3,65,34,31,9
OAXACA,20,SAN PEDRO MÁRTIR YUCUXACO,317,GUADALUPE HIDALGO,2,27,14,13,2
OAXACA,20,SAN PEDRO MÁRTIR YUCUXACO,317,LAS PEÑAS,2,14,4,10,2
OAXACA,20,SAN PEDRO MÁRTIR YUCUXACO,317,RÍO ARENA,2,11,5,6,2
OAXACA,20,SAN PEDRO MÁRTIR YUCUXACO,317,SAN PEDRO MÁRTIR YUCUXACO,3,105,57,48,10
OAXACA,20,SAN PEDRO MIXTEPEC,318,AGUAJE DEL ZAPOTE,2,75,40,35,6
OAXACA,20,SAN PEDRO MIXTEPEC,318,BAJOS DE CHILA,8,1888,997,891,85
OAXACA,20,SAN PEDRO MIXTEPEC,318,COMUNCITO,3,30,13,17,4
OAXACA,20,SAN PEDRO MIXTEPEC,318,EL HUARUMBO,2,100,47,53,6
OAXACA,20,SAN PEDRO MIXTEPEC,318,EL JÍCARO,2,11,6,5,2
OAXACA,20,SAN PEDRO MIXTEPEC,318,EL PESCADITO,2,10,5,5,2
OAXACA,20,SAN PEDRO MIXTEPEC,318,EL SALITRE,3,99,48,51,9
OAXACA,20,SAN PEDRO MIXTEPEC,318,EL TOLEDO,3,89,49,40,6
OAXACA,20,SAN PEDRO MIXTEPEC,318,LA LUCERNA,1,50,25,25,3
OAXACA,20,SAN PEDRO MIXTEPEC,318,LA REFORMA,3,158,78,80,10
OAXACA,20,SAN PEDRO MIXTEPEC,318,LA UNIÓN (MIXTEPEC),3,78,37,41,5
OAXACA,20,SAN PEDRO MIXTEPEC,318,LA YERBA SANTA,3,9,3,6,3
OAXACA,20,SAN PEDRO MIXTEPEC,318,LAS NEGRAS,2,34,19,15,5
OAXACA,20,SAN PEDRO MIXTEPEC,318,LAS TRES PALMAS,1,14,4,10,1
OAXACA,20,SAN PEDRO MIXTEPEC,318,LOS LIMONES,2,43,23,20,5
OAXACA,20,SAN PEDRO MIXTEPEC,318,LOS NANCHES,3,20,10,10,3
OAXACA,20,SAN PEDRO MIXTEPEC,318,MANDINGAS,1,9,6,3,1
OAXACA,20,SAN PEDRO MIXTEPEC,318,PLAN DE MINAS,2,11,7,4,1
OAXACA,20,SAN PEDRO MIXTEPEC,318,PORTILLO EL MALUCO,2,10,6,4,2
OAXACA,20,SAN PEDRO MIXTEPEC,318,PUEBLO VIEJO,2,14,6,8,2
OAXACA,20,SAN PEDRO MIXTEPEC,318,PUENTE SAN JOSÉ,1,45,23,22,3
OAXACA,20,SAN PEDRO MIXTEPEC,318,PUERTO ESCONDIDO,74,12693,6817,5876,853
OAXACA,20,SAN PEDRO MIXTEPEC,318,REGADÍO,2,19,12,7,1
OAXACA,20,SAN PEDRO MIXTEPEC,318,SAN ANDRÉS COPALA,3,181,104,77,14
OAXACA,20,SAN PEDRO MIXTEPEC,318,SAN MIGUEL [COLONIA],1,126,61,65,7
OAXACA,20,SAN PEDRO MIXTEPEC,318,SAN PEDRO MIXTEPEC DISTRITO 22,8,1410,761,649,69
OAXACA,20,SAN PEDRO MIXTEPEC,319,SAN PEDRO MIXTEPEC DISTRITO 26,4,210,108,102,18
OAXACA,20,SAN PEDRO MOLINOS,320,ASUNCIÓN BUENAVISTA,3,35,17,18,4
OAXACA,20,SAN PEDRO MOLINOS,320,SAN PEDRO MOLINOS,4,96,46,50,9
OAXACA,20,SAN PEDRO NOPALA,321,SAN PEDRO NOPALA,3,124,62,62,12
OAXACA,20,SAN PEDRO NOPALA,321,YOSOCUNO,3,47,27,20,11
OAXACA,20,SAN PEDRO OCOPETATILLO,322,SAN PEDRO OCOPETATILLO,3,129,72,57,12
OAXACA,20,SAN PEDRO OCOTEPEC,323,EL POLVO,1,8,7,1,1
OAXACA,20,SAN PEDRO OCOTEPEC,323,SAN PEDRO OCOTEPEC,5,339,175,164,16
OAXACA,20,SAN PEDRO OCOTEPEC,323,SANTA CRUZ OCOTAL,4,175,95,80,12
OAXACA,20,SAN PEDRO OCOTEPEC,323,UNIÓN Y PROGRESO,1,10,5,5,1
OAXACA,20,SAN PEDRO POCHUTLA,324,AGUACATE,2,12,7,5,2
OAXACA,20,SAN PEDRO POCHUTLA,324,ARROYO CRUZ,2,65,36,29,9
OAXACA,20,SAN PEDRO POCHUTLA,324,ARROYO DEL INQUENTE,1,6,5,1,1
OAXACA,20,SAN PEDRO POCHUTLA,324,ARROYO RICO,2,15,4,11,2
OAXACA,20,SAN PEDRO POCHUTLA,324,ARROYO ZAPOTE,2,44,23,21,9
OAXACA,20,SAN PEDRO POCHUTLA,324,BARRA DE CUATUNALCO,3,87,43,44,6
OAXACA,20,SAN PEDRO POCHUTLA,324,BARRIO ANCLERO,2,9,7,2,2
OAXACA,20,SAN PEDRO POCHUTLA,324,BARRIO MENDILLO,2,96,53,43,7
OAXACA,20,SAN PEDRO POCHUTLA,324,BARRIO NUEVO CHAPINGO,2,18,8,10,6
OAXACA,20,SAN PEDRO POCHUTLA,324,BARRIO NUEVO TOLTEPEC,4,59,33,26,7
OAXACA,20,SAN PEDRO POCHUTLA,324,BENITO JUÁREZ,3,199,106,93,30
OAXACA,20,SAN PEDRO POCHUTLA,324,CARNIZUELO,2,10,7,3,1
OAXACA,20,SAN PEDRO POCHUTLA,324,CHEPILME,2,67,36,31,9
OAXACA,20,SAN PEDRO POCHUTLA,324,COFRADÍA,2,10,4,6,3
OAXACA,20,SAN PEDRO POCHUTLA,324,COLONIA LA MINA,2,40,19,21,3
OAXACA,20,SAN PEDRO POCHUTLA,324,COMALA,2,77,41,36,9
OAXACA,20,SAN PEDRO POCHUTLA,324,CORCOVADO PETACA,2,49,25,24,8
OAXACA,20,SAN PEDRO POCHUTLA,324,CUAJINICUIL (CUAJINICUIL ALTO),2,12,5,7,1
OAXACA,20,SAN PEDRO POCHUTLA,324,EL COLORADO,3,731,300,431,11
OAXACA,20,SAN PEDRO POCHUTLA,324,EL COROZAL,2,18,9,9,2
OAXACA,20,SAN PEDRO POCHUTLA,324,EL COYOTE,1,17,9,8,1
OAXACA,20,SAN PEDRO POCHUTLA,324,EL ENCIERRO,3,33,13,20,3
OAXACA,20,SAN PEDRO POCHUTLA,324,EL MANANTIAL,1,4,3,1,1
OAXACA,20,SAN PEDRO POCHUTLA,324,EL PARAÍSO,3,32,14,18,4
OAXACA,20,SAN PEDRO POCHUTLA,324,EL PISTE,3,44,19,25,3
OAXACA,20,SAN PEDRO POCHUTLA,324,EL PORVENIR,2,12,5,7,2
OAXACA,20,SAN PEDRO POCHUTLA,324,EL SITIO,2,28,13,15,6
OAXACA,20,SAN PEDRO POCHUTLA,324,EL TOLOLOTE,3,35,18,17,3
OAXACA,20,SAN PEDRO POCHUTLA,324,EL VIGÍA,3,207,81,126,12
OAXACA,20,SAN PEDRO POCHUTLA,324,GALILEA,2,19,8,11,2
OAXACA,20,SAN PEDRO POCHUTLA,324,GUZMÁN,2,41,20,21,7
OAXACA,20,SAN PEDRO POCHUTLA,324,JUAN DIEGAL,1,8,2,6,1
OAXACA,20,SAN PEDRO POCHUTLA,324,JUANA CASTILLO,2,20,5,15,2
OAXACA,20,SAN PEDRO POCHUTLA,324,LA CIÉNEGA II,1,38,16,22,2
OAXACA,20,SAN PEDRO POCHUTLA,324,LA CIÉNEGA III,2,9,5,4,2
OAXACA,20,SAN PEDRO POCHUTLA,324,LA GUADALUPE,2,15,8,7,2
OAXACA,20,SAN PEDRO POCHUTLA,324,LA LAGARTIJA,1,5,2,3,1
OAXACA,20,SAN PEDRO POCHUTLA,324,LA NARANJA (LA CAMARONADA),3,23,9,14,3
OAXACA,20,SAN PEDRO POCHUTLA,324,LA ROSADÍA,1,16,9,7,1
OAXACA,20,SAN PEDRO POCHUTLA,324,LA SEGUNDA [BARRIO],1,4,2,2,1
OAXACA,20,SAN PEDRO POCHUTLA,324,LA SOLEDAD [BARRIO],2,11,5,6,1
OAXACA,20,SAN PEDRO POCHUTLA,324,LAGUNILLA,2,84,48,36,7
OAXACA,20,SAN PEDRO POCHUTLA,324,LAS JUNTAS (JUNTA LA SEGUNDA),2,8,3,5,1
OAXACA,20,SAN PEDRO POCHUTLA,324,LAS PALMAS,2,32,14,18,2
OAXACA,20,SAN PEDRO POCHUTLA,324,LOS CIRUELOS,3,87,47,40,11
OAXACA,20,SAN PEDRO POCHUTLA,324,LOS NARANJOS ESQUIPULAS,3,384,187,197,23
OAXACA,20,SAN PEDRO POCHUTLA,324,NOPALERA,2,5,3,2,1
OAXACA,20,SAN PEDRO POCHUTLA,324,NUEVA CHAPINGO [COLONIA],1,5,1,4,1
OAXACA,20,SAN PEDRO POCHUTLA,324,PALMARILLO (PALMARILLO SAN MARTÍN),1,47,25,22,6
OAXACA,20,SAN PEDRO POCHUTLA,324,PALOTADA (SAN JUAN PALOTADA),2,70,38,32,9
OAXACA,20,SAN PEDRO POCHUTLA,324,PASO LOS INDIOS,1,12,4,8,1
OAXACA,20,SAN PEDRO POCHUTLA,324,PLAYA ZIPOLITE,3,212,120,92,15
OAXACA,20,SAN PEDRO POCHUTLA,324,PUENTE TOLTEPEC,2,14,9,5,2
OAXACA,20,SAN PEDRO POCHUTLA,324,PUERTO ÁNGEL,7,1176,639,537,154
OAXACA,20,SAN PEDRO POCHUTLA,324,RANCHO PINA [BARRIO],2,23,12,11,3
OAXACA,20,SAN PEDRO POCHUTLA,324,REYES,3,147,82,65,11
OAXACA,20,SAN PEDRO POCHUTLA,324,RÍO GRANDE PASO XONENE,2,13,5,8,2
OAXACA,20,SAN PEDRO POCHUTLA,324,RÍO SAL,2,26,13,13,2
OAXACA,20,SAN PEDRO POCHUTLA,324,ROQUE,3,406,240,166,22
OAXACA,20,SAN PEDRO POCHUTLA,324,SAMARITÁN,1,6,1,5,5
OAXACA,20,SAN PEDRO POCHUTLA,324,SAN ISIDRO APANGO,3,228,121,107,13
OAXACA,20,SAN PEDRO POCHUTLA,324,SAN ISIDRO LIMÓN,2,46,25,21,9
OAXACA,20,SAN PEDRO POCHUTLA,324,SAN JOSÉ CHACALAPA,4,667,354,313,45
OAXACA,20,SAN PEDRO POCHUTLA,324,SAN MIGUEL FIGUEROA,5,256,137,119,24
OAXACA,20,SAN PEDRO POCHUTLA,324,SAN PEDRO CAFETITLÁN,3,44,26,18,6
OAXACA,20,SAN PEDRO POCHUTLA,324,SAN PEDRO POCHUTLA,35,6178,3489,2689,445
OAXACA,20,SAN PEDRO POCHUTLA,324,SANTA MARÍA LIMÓN,3,135,79,56,11
OAXACA,20,SAN PEDRO POCHUTLA,324,TACHICUNO,4,100,53,47,11
OAXACA,20,SAN PEDRO POCHUTLA,324,TAHUECA,2,52,27,25,3
OAXACA,20,SAN PEDRO POCHUTLA,324,TOLTEPEC,3,52,27,25,12
OAXACA,20,SAN PEDRO POCHUTLA,324,UNIÓN DE GUERRERO,3,18,12,6,2
OAXACA,20,SAN PEDRO POCHUTLA,324,XONENE,2,60,34,26,7
OAXACA,20,SAN PEDRO POCHUTLA,324,ZAPOTAL,2,42,23,19,5
OAXACA,20,SAN PEDRO POCHUTLA,324,ZAPOTENGO,2,19,7,12,7
OAXACA,20,SAN PEDRO QUIATONI,325,AGUA BLANCA,1,21,10,11,1
OAXACA,20,SAN PEDRO QUIATONI,325,AGUA COLORADA,2,6,3,3,1
OAXACA,20,SAN PEDRO QUIATONI,325,CERRO COSTOCHE,1,26,14,12,1
OAXACA,20,SAN PEDRO QUIATONI,325,CERRO CULEBRA,2,60,30,30,3
OAXACA,20,SAN PEDRO QUIATONI,325,CERRO LEÓN,3,66,33,33,4
OAXACA,20,SAN PEDRO QUIATONI,325,EL PORVENIR,3,136,74,62,8
OAXACA,20,SAN PEDRO QUIATONI,325,EL ROMADITO,1,23,13,10,1
OAXACA,20,SAN PEDRO QUIATONI,325,LA MANCORNADA,2,89,49,40,4
OAXACA,20,SAN PEDRO QUIATONI,325,LA REFORMA,1,30,20,10,1
OAXACA,20,SAN PEDRO QUIATONI,325,LA SOLEDAD SALINAS,5,990,503,487,44
OAXACA,20,SAN PEDRO QUIATONI,325,RÍO LANA,2,8,3,5,2
OAXACA,20,SAN PEDRO QUIATONI,325,RÍO LANA II,2,14,6,8,2
OAXACA,20,SAN PEDRO QUIATONI,325,SAN PABLO LACHIRIEGA,4,187,94,93,10
OAXACA,20,SAN PEDRO QUIATONI,325,SAN PEDRO QUIATONI,5,1174,618,556,50
OAXACA,20,SAN PEDRO QUIATONI,325,UNIÓN JUÁREZ,2,44,23,21,9
OAXACA,20,SAN PEDRO SOCHIÁPAM,326,EL RETUMBADERO,3,44,20,24,3
OAXACA,20,SAN PEDRO SOCHIÁPAM,326,SAN JUAN ZAPOTITLÁN,3,399,197,202,21
OAXACA,20,SAN PEDRO SOCHIÁPAM,326,SAN JUAN ZAUTLA,4,410,218,192,19
OAXACA,20,SAN PEDRO SOCHIÁPAM,326,SAN PEDRO SOCHIÁPAM,4,559,310,249,35
OAXACA,20,SAN PEDRO SOCHIÁPAM,326,SANTIAGO QUETZALAPA,3,109,50,59,7
OAXACA,20,SAN PEDRO TAPANATEPEC,327,BARRIO GALEANA,1,64,37,27,5
OAXACA,20,SAN PEDRO TAPANATEPEC,327,BENITO JUÁREZ [CONGREGACIÓN],2,12,7,5,3
OAXACA,20,SAN PEDRO TAPANATEPEC,327,BERNAL,3,88,52,36,9
OAXACA,20,SAN PEDRO TAPANATEPEC,327,CONCHALITO,2,52,27,25,6
OAXACA,20,SAN PEDRO TAPANATEPEC,327,LAS ANONAS,1,12,8,4,1
OAXACA,20,SAN PEDRO TAPANATEPEC,327,LOS CORAZONES,4,281,152,129,19
OAXACA,20,SAN PEDRO TAPANATEPEC,327,PESQUERÍA GUADALUPE,3,94,46,48,8
OAXACA,20,SAN PEDRO TAPANATEPEC,327,PESQUERÍA PUERTO PALOMA,3,84,48,36,10
OAXACA,20,SAN PEDRO TAPANATEPEC,327,PESQUERÍA RANCHO SALINAS,3,96,48,48,14
OAXACA,20,SAN PEDRO TAPANATEPEC,327,REVOLUCIÓN 20 DE NOVIEMBRE,3,78,46,32,8
OAXACA,20,SAN PEDRO TAPANATEPEC,327,RINCÓN JUÁREZ,4,237,121,116,16
OAXACA,20,SAN PEDRO TAPANATEPEC,327,SAN JOSÉ DE LOS PORTILLOS,2,35,20,15,6
OAXACA,20,SAN PEDRO TAPANATEPEC,327,SAN PEDRO TAPANATEPEC,15,2037,1086,951,114
OAXACA,20,SAN PEDRO TAPANATEPEC,327,TREJO,3,149,63,86,10
OAXACA,20,SAN PEDRO TAVICHE,328,SAN PEDRO TAVICHE,3,308,180,128,22
OAXACA,20,SAN PEDRO TEOZACOALCO,329,SAN ANTONIO EL PROGRESO,1,19,10,9,1
OAXACA,20,SAN PEDRO TEOZACOALCO,329,SAN JOSÉ RÍO MINAS,3,88,42,46,10
OAXACA,20,SAN PEDRO TEOZACOALCO,329,SAN PEDRO TEOZACOALCO,4,222,119,103,17
OAXACA,20,SAN PEDRO TEUTILA,330,ARROYO ESCONDIDO,2,14,8,6,2
OAXACA,20,SAN PEDRO TEUTILA,330,EL FARO,3,92,42,50,12
OAXACA,20,SAN PEDRO TEUTILA,330,PIEDRA ANCHA O LA RAYA,5,107,50,57,11
OAXACA,20,SAN PEDRO TEUTILA,330,PLAYA CHICA,1,9,4,5,1
OAXACA,20,SAN PEDRO TEUTILA,330,SAN JOSÉ DESPOBLADO,2,14,8,6,2
OAXACA,20,SAN PEDRO TEUTILA,330,SAN JUAN NUEVO,1,16,9,7,2
OAXACA,20,SAN PEDRO TEUTILA,330,SAN PEDRO TEUTILA,5,434,244,190,29
OAXACA,20,SAN PEDRO TEUTILA,330,SANTO DOMINGO DEL RÍO,4,326,162,164,20
OAXACA,20,SAN PEDRO TIDAÁ,331,SAN PEDRO TIDAÁ,5,275,153,122,16
OAXACA,20,SAN PEDRO TOPILTEPEC,332,SAN PEDRO TOPILTEPEC,2,16,5,11,6
OAXACA,20,SAN PEDRO TOPILTEPEC,332,SANTA MARÍA TILTEPEC,2,27,12,15,8
OAXACA,20,SAN PEDRO TOTOLÁPAM,333,EL TRAPICHITO,1,15,6,9,1
OAXACA,20,SAN PEDRO TOTOLÁPAM,333,LAS MARGARITAS,2,27,15,12,7
OAXACA,20,SAN PEDRO TOTOLÁPAM,333,SAN JOSÉ DE GRACIA,3,159,82,77,13
OAXACA,20,SAN PEDRO TOTOLÁPAM,333,SAN JUAN GUEGOYACHI,2,40,18,22,7
OAXACA,20,SAN PEDRO TOTOLÁPAM,333,SAN PEDRO TOTOLÁPAM,4,335,150,185,19
OAXACA,20,VILLA DE TUTUTEPEC,334,AGUA ZARCA,2,56,27,29,6
OAXACA,20,VILLA DE TUTUTEPEC,334,ALEJO PERALTA [COLONIA],1,12,6,6,3
OAXACA,20,VILLA DE TUTUTEPEC,334,BENITO JUÁREZ,2,132,70,62,9
OAXACA,20,VILLA DE TUTUTEPEC,334,CAMALOTILLO,2,40,20,20,5
OAXACA,20,VILLA DE TUTUTEPEC,334,CERRO HERMOSO,4,71,37,34,8
OAXACA,20,VILLA DE TUTUTEPEC,334,CHACAHUA,5,149,77,72,15
OAXACA,20,VILLA DE TUTUTEPEC,334,CHACALAPA,3,131,69,62,11
OAXACA,20,VILLA DE TUTUTEPEC,334,CHARCO REDONDO,3,72,36,36,11
OAXACA,20,VILLA DE TUTUTEPEC,334,DUVA-YOO,3,46,27,19,4
OAXACA,20,VILLA DE TUTUTEPEC,334,EL AZUFRE,3,97,50,47,13
OAXACA,20,VILLA DE TUTUTEPEC,334,EL CACALOTE,4,183,88,95,18
OAXACA,20,VILLA DE TUTUTEPEC,334,EL CIRUELITO,1,16,10,6,2
OAXACA,20,VILLA DE TUTUTEPEC,334,EL FAISÁN,3,112,64,48,9
OAXACA,20,VILLA DE TUTUTEPEC,334,EL GACHUPÍN,1,32,15,17,2
OAXACA,20,VILLA DE TUTUTEPEC,334,EL LAGARTERO,2,23,11,12,2
OAXACA,20,VILLA DE TUTUTEPEC,334,EL MAMEY,3,66,35,31,4
OAXACA,20,VILLA DE TUTUTEPEC,334,EL TLACUACHE,1,10,5,5,1
OAXACA,20,VILLA DE TUTUTEPEC,334,EL VENADO,3,70,35,35,8
OAXACA,20,VILLA DE TUTUTEPEC,334,EL ZANJÓN,1,16,6,10,1
OAXACA,20,VILLA DE TUTUTEPEC,334,EL ZAPOTALITO,3,270,130,140,13
OAXACA,20,VILLA DE TUTUTEPEC,334,HIDALGO,3,110,56,54,8
OAXACA,20,VILLA DE TUTUTEPEC,334,LA CAÑADA,2,64,36,28,6
OAXACA,20,VILLA DE TUTUTEPEC,334,LA LUZ,7,669,309,360,39
OAXACA,20,VILLA DE TUTUTEPEC,334,LA PASTORÍA,2,57,26,31,6
OAXACA,20,VILLA DE TUTUTEPEC,334,LA SOLEDAD,3,76,36,40,8
OAXACA,20,VILLA DE TUTUTEPEC,334,LA TEJA,1,25,13,12,6
OAXACA,20,VILLA DE TUTUTEPEC,334,LA TONA CHACALAPA,2,8,2,6,1
OAXACA,20,VILLA DE TUTUTEPEC,334,LOS LLANOS DEL ESPINAL,1,32,11,21,2
OAXACA,20,VILLA DE TUTUTEPEC,334,PALMA SOLA,2,32,9,23,5
OAXACA,20,VILLA DE TUTUTEPEC,334,PEÑAS NEGRAS,3,95,51,44,8
OAXACA,20,VILLA DE TUTUTEPEC,334,PLAN DE REFORMA,1,15,1,14,1
OAXACA,20,VILLA DE TUTUTEPEC,334,RÍO GRANDE O PIEDRA PARADA,24,4750,2521,2229,259
OAXACA,20,VILLA DE TUTUTEPEC,334,SAN ANTONIO RÍO VERDE,2,20,10,10,4
OAXACA,20,VILLA DE TUTUTEPEC,334,SAN FELIPE,2,60,33,27,5
OAXACA,20,VILLA DE TUTUTEPEC,334,SAN FRANCISCO DE ABAJO,2,90,47,43,9
OAXACA,20,VILLA DE TUTUTEPEC,334,SAN FRANCISCO DE ARRIBA,2,48,23,25,6
OAXACA,20,VILLA DE TUTUTEPEC,334,SAN ISIDRO LLANO GRANDE,3,96,49,47,8
OAXACA,20,VILLA DE TUTUTEPEC,334,SAN JOSÉ DEL PROGRESO,10,1783,910,873,93
OAXACA,20,VILLA DE TUTUTEPEC,334,SAN JOSÉ MANIALTEPEC,3,345,175,170,22
OAXACA,20,VILLA DE TUTUTEPEC,334,SAN MARTÍN CABALLERO,3,94,37,57,9
OAXACA,20,VILLA DE TUTUTEPEC,334,SAN MIGUEL,2,84,38,46,7
OAXACA,20,VILLA DE TUTUTEPEC,334,SAN VICENTE,2,10,6,4,3
OAXACA,20,VILLA DE TUTUTEPEC,334,SANTA ANA TUTUTEPEC,3,172,102,70,12
OAXACA,20,VILLA DE TUTUTEPEC,334,SANTA CRUZ TUTUTEPEC,4,294,165,129,17
OAXACA,20,VILLA DE TUTUTEPEC,334,SANTA MARÍA ACATEPEC,4,188,89,99,16
OAXACA,20,VILLA DE TUTUTEPEC,334,SANTA ROSA DE LIMA,4,661,347,314,35
OAXACA,20,VILLA DE TUTUTEPEC,334,SANTIAGO JOCOTEPEC,4,427,224,203,25
OAXACA,20,VILLA DE TUTUTEPEC,334,VILLA DE TUTUTEPEC,5,539,270,269,52
OAXACA,20,SAN PEDRO YANERI,335,SAN JUAN TEPANZACOALCO,3,70,40,30,5
OAXACA,20,SAN PEDRO YANERI,335,SAN PEDRO YANERI,4,103,53,50,8
OAXACA,20,SAN PEDRO YÓLOX,336,NUEVO ROSARIO TEMEXTITLÁN,3,30,11,19,8
OAXACA,20,SAN PEDRO YÓLOX,336,ROSARIO TEMEXTITLÁN,2,27,15,12,7
OAXACA,20,SAN PEDRO YÓLOX,336,SAN FRANCISCO LA REFORMA,3,72,35,37,9
OAXACA,20,SAN PEDRO YÓLOX,336,SAN MARTÍN BUENAVISTA,3,99,55,44,10
OAXACA,20,SAN PEDRO YÓLOX,336,SAN PEDRO YÓLOX,4,155,74,81,15
OAXACA,20,SAN PEDRO Y SAN PABLO AYUTLA,337,CERRO DEL AMOLE,3,95,48,47,7
OAXACA,20,SAN PEDRO Y SAN PABLO AYUTLA,337,CERRO PELÓN,3,95,55,40,6
OAXACA,20,SAN PEDRO Y SAN PABLO AYUTLA,337,EL DURAZNAL,3,188,102,86,11
OAXACA,20,SAN PEDRO Y SAN PABLO AYUTLA,337,EL PORTILLO MATAGALLINA,6,217,116,101,19
OAXACA,20,SAN PEDRO Y SAN PABLO AYUTLA,337,LA LAGUNA,1,34,17,17,2
OAXACA,20,SAN PEDRO Y SAN PABLO AYUTLA,337,LACHICOCANA,4,127,52,75,12
OAXACA,20,SAN PEDRO Y SAN PABLO AYUTLA,337,MONTE ROSA,3,63,30,33,6
OAXACA,20,SAN PEDRO Y SAN PABLO AYUTLA,337,SAN PEDRO Y SAN PABLO AYUTLA,8,705,353,352,52
OAXACA,20,SAN PEDRO Y SAN PABLO AYUTLA,337,TIERRA CALIENTE,2,48,24,24,3
OAXACA,20,VILLA DE ETLA,338,SANTO DOMINGO BARRIO ALTO,9,610,355,255,74
OAXACA,20,VILLA DE ETLA,338,VILLA DE ETLA,20,3625,1986,1639,262
OAXACA,20,SAN PEDRO Y SAN PABLO TEPOSCOLULA,339,EL MOLINO,2,4,1,3,1
OAXACA,20,SAN PEDRO Y SAN PABLO TEPOSCOLULA,339,GUADALUPE VISTA HERMOSA,3,51,23,28,7
OAXACA,20,SAN PEDRO Y SAN PABLO TEPOSCOLULA,339,SAN FELIPE IXTAPA,1,6,3,3,1
OAXACA,20,SAN PEDRO Y SAN PABLO TEPOSCOLULA,339,SAN MIGUEL TIXÁ,1,30,17,13,2
OAXACA,20,SAN PEDRO Y SAN PABLO TEPOSCOLULA,339,SAN PEDRO Y SAN PABLO TEPOSCOLULA,7,2027,1154,873,121
OAXACA,20,SAN PEDRO Y SAN PABLO TEPOSCOLULA,339,SANTO DOMINGO TLACHITONGO,2,9,4,5,6
OAXACA,20,SAN PEDRO Y SAN PABLO TEPOSCOLULA,339,SANTO TOMÁS TECOLOTITLÁN,1,16,8,8,1
OAXACA,20,SAN PEDRO Y SAN PABLO TEPOSCOLULA,339,YODONOCUITO,1,16,11,5,1
OAXACA,20,SAN PEDRO Y SAN PABLO TEPOSCOLULA,339,YUCUMESA,2,61,29,32,6
OAXACA,20,SAN PEDRO Y SAN PABLO TEPOSCOLULA,339,YUCUNINDE,2,15,6,9,4
OAXACA,20,SAN PEDRO Y SAN PABLO TEQUIXTEPEC,340,GUADALUPE MEZQUITAL,1,29,15,14,6
OAXACA,20,SAN PEDRO Y SAN PABLO TEQUIXTEPEC,340,SAN FRANCISCO HUAPANAPAN,2,11,4,7,2
OAXACA,20,SAN PEDRO Y SAN PABLO TEQUIXTEPEC,340,SAN JOSÉ TRUJÁPAM,2,19,9,10,3
OAXACA,20,SAN PEDRO Y SAN PABLO TEQUIXTEPEC,340,SAN MIGUEL IXTÁPAM,3,75,41,34,12
OAXACA,20,SAN PEDRO Y SAN PABLO TEQUIXTEPEC,340,SAN PEDRO Y SAN PABLO TEQUIXTEPEC,3,77,42,35,13
OAXACA,20,SAN PEDRO Y SAN PABLO TEQUIXTEPEC,340,SANTA CATALINA CHINANGO,2,35,18,17,8
OAXACA,20,SAN PEDRO Y SAN PABLO TEQUIXTEPEC,340,SANTA MARÍA MIXQUIXTLAHUACA,1,5,3,2,1
OAXACA,20,SAN PEDRO YUCUNAMA,341,SAN PEDRO YUCUNAMA,2,26,14,12,5
OAXACA,20,SAN RAYMUNDO JALPAN,342,SAN RAYMUNDO JALPAN,5,2008,1098,910,248
OAXACA,20,SAN SEBASTIÁN ABASOLO,343,SAN SEBASTIÁN ABASOLO,3,362,176,186,22
OAXACA,20,SAN SEBASTIÁN ABASOLO,343,SANTA ROSA BUENA VISTA,2,51,29,22,9
OAXACA,20,SAN SEBASTIÁN COATLÁN,344,EL GAVILÁN,2,10,6,4,1
OAXACA,20,SAN SEBASTIÁN COATLÁN,344,EL PORVENIR BALLESTEROS,3,70,27,43,9
OAXACA,20,SAN SEBASTIÁN COATLÁN,344,PIEDRA CAMPANA,2,26,14,12,2
OAXACA,20,SAN SEBASTIÁN COATLÁN,344,SAN JOSÉ CIENEGUILLA,4,452,207,245,18
OAXACA,20,SAN SEBASTIÁN COATLÁN,344,SAN SEBASTIÁN COATLÁN,4,335,189,146,23
OAXACA,20,SAN SEBASTIÁN IXCAPA,345,CAMOTINCHÁN,4,274,149,125,19
OAXACA,20,SAN SEBASTIÁN IXCAPA,345,CAÑADA DEL TOTOMOXTLE,3,127,70,57,12
OAXACA,20,SAN SEBASTIÁN IXCAPA,345,COSTATITLÁN,4,153,79,74,15
OAXACA,20,SAN SEBASTIÁN IXCAPA,345,LLANO DE LA VACA,1,17,7,10,6
OAXACA,20,SAN SEBASTIÁN IXCAPA,345,SAN SEBASTIÁN IXCAPA,4,383,205,178,35
OAXACA,20,SAN SEBASTIÁN IXCAPA,345,VISTA HERMOSA,3,151,82,69,13
OAXACA,20,SAN SEBASTIÁN NICANANDUTA,346,SAN SEBASTIÁN NICANANDUTA,4,429,216,213,26
OAXACA,20,SAN SEBASTIÁN RÍO HONDO,347,AMPLIACIÓN SAN SEBASTIÁN,3,14,9,5,3
OAXACA,20,SAN SEBASTIÁN RÍO HONDO,347,CIENEGUILLA,5,386,224,162,28
OAXACA,20,SAN SEBASTIÁN RÍO HONDO,347,EL JEFE,2,15,7,8,2
OAXACA,20,SAN SEBASTIÁN RÍO HONDO,347,LA FÁBRICA,2,18,9,9,2
OAXACA,20,SAN SEBASTIÁN RÍO HONDO,347,LAS PALMAS,2,19,7,12,2
OAXACA,20,SAN SEBASTIÁN RÍO HONDO,347,PIEDRA NEGRA,2,20,8,12,2
OAXACA,20,SAN SEBASTIÁN RÍO HONDO,347,PUEBLO VIEJO,1,5,2,3,1
OAXACA,20,SAN SEBASTIÁN RÍO HONDO,347,RÍO MOLINO,2,11,5,6,6
OAXACA,20,SAN SEBASTIÁN RÍO HONDO,347,RÍO SAN JOSÉ,2,13,9,4,2
OAXACA,20,SAN SEBASTIÁN RÍO HONDO,347,SAN BERNARDO,3,86,48,38,12
OAXACA,20,SAN SEBASTIÁN RÍO HONDO,347,SAN FELIPE CIENEGUILLA,2,48,27,21,6
OAXACA,20,SAN SEBASTIÁN RÍO HONDO,347,SAN SEBASTIÁN RÍO HONDO,4,365,211,154,26
OAXACA,20,SAN SEBASTIÁN RÍO HONDO,347,TRES OCOTES,3,68,35,33,5
OAXACA,20,SAN SEBASTIÁN TECOMAXTLAHUACA,348,AGUA BUENA,2,38,21,17,5
OAXACA,20,SAN SEBASTIÁN TECOMAXTLAHUACA,348,ÁNIMAS YUCUNICIASI O YUCUNICANI,1,11,4,7,1
OAXACA,20,SAN SEBASTIÁN TECOMAXTLAHUACA,348,BUENAVISTA,2,20,9,11,6
OAXACA,20,SAN SEBASTIÁN TECOMAXTLAHUACA,348,CAHUAYÁ,2,6,1,5,2
OAXACA,20,SAN SEBASTIÁN TECOMAXTLAHUACA,348,EL PORTEZUELO,2,30,19,11,3
OAXACA,20,SAN SEBASTIÁN TECOMAXTLAHUACA,348,EL TEMAZCAL,3,9,5,4,2
OAXACA,20,SAN SEBASTIÁN TECOMAXTLAHUACA,348,GUADALUPE CAÑADA DE LOBO,3,136,74,62,11
OAXACA,20,SAN SEBASTIÁN TECOMAXTLAHUACA,348,GUADALUPE NUNDACA,3,219,104,115,10
OAXACA,20,SAN SEBASTIÁN TECOMAXTLAHUACA,348,LOS LUENGAS [RANCHO],2,5,2,3,1
OAXACA,20,SAN SEBASTIÁN TECOMAXTLAHUACA,348,LOS RENDÓN,2,4,1,3,1
OAXACA,20,SAN SEBASTIÁN TECOMAXTLAHUACA,348,LOS SILVA (LA SABINERA LOS SILVA),1,4,3,1,1
OAXACA,20,SAN SEBASTIÁN TECOMAXTLAHUACA,348,RANCHO DEL CARMEN,1,32,17,15,1
OAXACA,20,SAN SEBASTIÁN TECOMAXTLAHUACA,348,RÍO DE HIELO JUÁREZ,2,74,40,34,5
OAXACA,20,SAN SEBASTIÁN TECOMAXTLAHUACA,348,SABINO SOLO,2,31,14,17,6
OAXACA,20,SAN SEBASTIÁN TECOMAXTLAHUACA,348,SAN ANTONIO EL MOGOTE (EL MOGOTE),2,9,4,5,1
OAXACA,20,SAN SEBASTIÁN TECOMAXTLAHUACA,348,SAN ISIDRO ZARAGOZA ALACRÁN,1,21,10,11,1
OAXACA,20,SAN SEBASTIÁN TECOMAXTLAHUACA,348,SAN JOSÉ DURAZNOS,1,39,20,19,1
OAXACA,20,SAN SEBASTIÁN TECOMAXTLAHUACA,348,SAN JOSÉ EL ESPINAL,2,25,11,14,7
OAXACA,20,SAN SEBASTIÁN TECOMAXTLAHUACA,348,SAN JOSÉ PEÑA PRIETA,2,5,3,2,1
OAXACA,20,SAN SEBASTIÁN TECOMAXTLAHUACA,348,SAN MARCOS XINICUESTA,3,184,80,104,4
OAXACA,20,SAN SEBASTIÁN TECOMAXTLAHUACA,348,SAN MARTÍN DURAZNOS,3,130,72,58,10
OAXACA,20,SAN SEBASTIÁN TECOMAXTLAHUACA,348,SAN MATEO TUNUCHI,3,55,27,28,7
OAXACA,20,SAN SEBASTIÁN TECOMAXTLAHUACA,348,SAN SEBASTIÁN LOS CHOLULA,4,101,59,42,8
OAXACA,20,SAN SEBASTIÁN TECOMAXTLAHUACA,348,SAN SEBASTIÁN TECOMAXTLAHUACA,6,761,383,378,46
OAXACA,20,SAN SEBASTIÁN TECOMAXTLAHUACA,348,SANTA CRUZ RANCHO VIEJO,2,16,6,10,4
OAXACA,20,SAN SEBASTIÁN TECOMAXTLAHUACA,348,SANTA CRUZ VERDE,1,81,40,41,4
OAXACA,20,SAN SEBASTIÁN TECOMAXTLAHUACA,348,SANTA CRUZ YOSONDICA,2,21,10,11,2
OAXACA,20,SAN SEBASTIÁN TECOMAXTLAHUACA,348,SANTO NIÑO JESÚS YUCUYI,2,71,37,34,7
OAXACA,20,SAN SEBASTIÁN TECOMAXTLAHUACA,348,TECOMAXTLAHUACA EL VIEJO,1,13,5,8,1
OAXACA,20,SAN SEBASTIÁN TECOMAXTLAHUACA,348,YOSOYÚ,1,9,1,8,1
OAXACA,20,SAN SEBASTIÁN TEITIPAC,349,SAN ANTONIO BUENAVISTA,1,15,7,8,1
OAXACA,20,SAN SEBASTIÁN TEITIPAC,349,SAN SEBASTIÁN TEITIPAC,3,284,165,119,22
OAXACA,20,SAN SEBASTIÁN TUTLA,350,EL ROSARIO,18,4683,2692,1991,518
OAXACA,20,SAN SEBASTIÁN TUTLA,350,SAN SEBASTIÁN TUTLA,10,1536,837,699,92
OAXACA,20,SAN SIMÓN ALMOLONGAS,351,HACIENDA VIEJA-SAN GUILLERMO,1,5,3,2,1
OAXACA,20,SAN SIMÓN ALMOLONGAS,351,RÍO ANONA,6,314,153,161,23
OAXACA,20,SAN SIMÓN ALMOLONGAS,351,SAN SIMÓN ALMOLONGAS,5,329,190,139,24
OAXACA,20,SAN SIMÓN ZAHUATLÁN,352,CAÑADA DEL TECOLOTE,1,48,27,21,4
OAXACA,20,SAN SIMÓN ZAHUATLÁN,352,LA COLMENA,1,44,16,28,2
OAXACA,20,SAN SIMÓN ZAHUATLÁN,352,LAS TRES CRUCES,1,53,28,25,3
OAXACA,20,SAN SIMÓN ZAHUATLÁN,352,SAN MIGUEL,3,90,47,43,11
OAXACA,20,SAN SIMÓN ZAHUATLÁN,352,SAN SIMÓN ZAHUATLÁN,5,705,370,335,37
OAXACA,20,SAN SIMÓN ZAHUATLÁN,352,TIERRA COLORADA,1,46,26,20,6
OAXACA,20,SANTA ANA,353,SANTA ANA,5,609,349,260,34
OAXACA,20,SANTA ANA ATEIXTLAHUACA,354,LA CORNETA,1,13,6,7,1
OAXACA,20,SANTA ANA ATEIXTLAHUACA,354,SANTA ANA ATEIXTLAHUACA,3,69,36,33,6
OAXACA,20,SANTA ANA CUAUHTÉMOC,355,SAN MARTÍN CABALLERO,1,7,3,4,1
OAXACA,20,SANTA ANA CUAUHTÉMOC,355,SANTA ANA CUAUHTÉMOC,3,96,51,45,10
OAXACA,20,SANTA ANA DEL VALLE,356,SANTA ANA DEL VALLE,4,684,345,339,33
OAXACA,20,SANTA ANA TAVELA,357,SANTA ANA TAVELA,3,102,51,51,11
OAXACA,20,SANTA ANA TLAPACOYAN,358,AGUA BLANCA,2,16,5,11,8
OAXACA,20,SANTA ANA TLAPACOYAN,358,GUEGOVELDA,1,7,2,5,1
OAXACA,20,SANTA ANA TLAPACOYAN,358,RINCÓN DE TLAPACOYAN,2,60,32,28,9
OAXACA,20,SANTA ANA TLAPACOYAN,358,SANTA ANA TLAPACOYAN,4,294,165,129,20
OAXACA,20,SANTA ANA YARENI,359,SANTA ANA YARENI,4,104,49,55,9
OAXACA,20,SANTA ANA ZEGACHE,360,SAN ISIDRO ZEGACHE,2,74,40,34,9
OAXACA,20,SANTA ANA ZEGACHE,360,SAN JERÓNIMO ZEGACHE,2,61,32,29,9
OAXACA,20,SANTA ANA ZEGACHE,360,SANTA ANA ZEGACHE,6,721,400,321,41
OAXACA,20,SANTA CATALINA QUIERÍ,361,SANTA CATALINA QUIERÍ,3,146,78,68,8
OAXACA,20,SANTA CATARINA CUIXTLA,362,SANTA CATARINA CUIXTLA,3,201,107,94,13
OAXACA,20,SANTA CATARINA IXTEPEJI,363,EL PUNTO,3,159,91,68,13
OAXACA,20,SANTA CATARINA IXTEPEJI,363,SAN PEDRO NEXICHO,2,22,10,12,2
OAXACA,20,SANTA CATARINA IXTEPEJI,363,SANTA CATARINA IXTEPEJI,3,128,64,64,13
OAXACA,20,SANTA CATARINA IXTEPEJI,363,TIERRA COLORADA,3,142,70,72,12
OAXACA,20,SANTA CATARINA IXTEPEJI,363,YUVILA,3,425,224,201,20
OAXACA,20,SANTA CATARINA JUQUILA,364,ARROYO TRISTE,2,9,6,3,1
OAXACA,20,SANTA CATARINA JUQUILA,364,CERRO IGLESIA,3,17,12,5,3
OAXACA,20,SANTA CATARINA JUQUILA,364,CINCO NEGRITOS,3,34,18,16,3
OAXACA,20,SANTA CATARINA JUQUILA,364,EL CAMALOTE,4,135,75,60,10
OAXACA,20,SANTA CATARINA JUQUILA,364,EL CARRIZO,2,5,3,2,1
OAXACA,20,SANTA CATARINA JUQUILA,364,EL COROZAL GRANDE,3,21,11,10,3
OAXACA,20,SANTA CATARINA JUQUILA,364,EL DESTINO,2,5,1,4,1
OAXACA,20,SANTA CATARINA JUQUILA,364,EL MAMEY,3,13,8,5,2
OAXACA,20,SANTA CATARINA JUQUILA,364,EL MOSQUITO,2,15,6,9,2
OAXACA,20,SANTA CATARINA JUQUILA,364,EL OBISPO,2,5,1,4,1
OAXACA,20,SANTA CATARINA JUQUILA,364,EL SALAR,2,10,4,6,3
OAXACA,20,SANTA CATARINA JUQUILA,364,JUNTA DE LOS RÍOS,2,26,14,12,3
OAXACA,20,SANTA CATARINA JUQUILA,364,LA ESMERALDA,1,4,1,3,1
OAXACA,20,SANTA CATARINA JUQUILA,364,LA ESPERANZA,2,6,3,3,1
OAXACA,20,SANTA CATARINA JUQUILA,364,LA GUADALUPE,2,15,9,6,3
OAXACA,20,SANTA CATARINA JUQUILA,364,LA JÍCARA,2,9,5,4,2
OAXACA,20,SANTA CATARINA JUQUILA,364,LA JUQUILITA,1,6,2,4,1
OAXACA,20,SANTA CATARINA JUQUILA,364,LA SANGUIJUELA,2,22,13,9,2
OAXACA,20,SANTA CATARINA JUQUILA,364,LA SOLEDAD,1,4,2,2,1
OAXACA,20,SANTA CATARINA JUQUILA,364,LA SOLEDAD EL MAPACHE,3,65,28,37,6
OAXACA,20,SANTA CATARINA JUQUILA,364,LAS TRANCAS,3,40,20,20,4
OAXACA,20,SANTA CATARINA JUQUILA,364,MONTE OBSCURO,3,14,5,9,3
OAXACA,20,SANTA CATARINA JUQUILA,364,PASO HONDO,1,4,4,0,1
OAXACA,20,SANTA CATARINA JUQUILA,364,PIE DEL CERRO,1,15,8,7,1
OAXACA,20,SANTA CATARINA JUQUILA,364,RÍO BAJO (LA REFORMA),3,13,8,5,2
OAXACA,20,SANTA CATARINA JUQUILA,364,SAN FELIPE DE JESÚS,1,7,3,4,1
OAXACA,20,SANTA CATARINA JUQUILA,364,SAN FRANCISCO IXPANTEPEC,3,169,80,89,10
OAXACA,20,SANTA CATARINA JUQUILA,364,SAN JOSÉ IXTÁPAM,4,548,268,280,23
OAXACA,20,SANTA CATARINA JUQUILA,364,SAN JOSÉ VISTA HERMOSA (AGUACATAL GRANDE),3,52,30,22,5
OAXACA,20,SANTA CATARINA JUQUILA,364,SAN LUCAS,1,9,4,5,1
OAXACA,20,SANTA CATARINA JUQUILA,364,SAN MARCOS ZACATEPEC,3,172,84,88,11
OAXACA,20,SANTA CATARINA JUQUILA,364,SANTA CATARINA JUQUILA,14,2600,1312,1288,127
OAXACA,20,SANTA CATARINA JUQUILA,364,SANTA MARÍA AMIALTEPEC,3,148,81,67,8
OAXACA,20,SANTA CATARINA JUQUILA,364,SANTA MARÍA YOLOTEPEC,3,554,278,276,25
OAXACA,20,SANTA CATARINA JUQUILA,364,SANTIAGO MIRAMAR,1,3,1,2,1
OAXACA,20,SANTA CATARINA JUQUILA,364,VISTA AL MAR (AGUA PODRIDA),2,8,4,4,1
OAXACA,20,SANTA CATARINA LACHATAO,365,BENITO JUÁREZ,3,65,33,32,8
OAXACA,20,SANTA CATARINA LACHATAO,365,LATUVI,3,91,47,44,11
OAXACA,20,SANTA CATARINA LACHATAO,365,SANTA CATARINA LACHATAO,2,9,4,5,2
OAXACA,20,SANTA CATARINA LOXICHA,366,LA LUZ,1,13,8,5,1
OAXACA,20,SANTA CATARINA LOXICHA,366,SAN JOSÉ PEÑASCO,1,4,1,3,1
OAXACA,20,SANTA CATARINA LOXICHA,366,SANTA CATARINA LOXICHA,8,932,492,440,43
OAXACA,20,SANTA CATARINA LOXICHA,366,SANTO TOMÁS,1,10,6,4,1
OAXACA,20,SANTA CATARINA MECHOACÁN,367,SANTA CATARINA MECHOACÁN,7,1141,574,567,65
OAXACA,20,SANTA CATARINA MINAS,368,SANTA CATARINA MINAS,3,374,207,167,24
OAXACA,20,SANTA CATARINA QUIANÉ,369,SANTA CATARINA QUIANÉ,4,396,229,167,28
OAXACA,20,SANTA CATARINA TAYATA,370,CUAUHTÉMOC,2,24,13,11,3
OAXACA,20,SANTA CATARINA TAYATA,370,SANTA CATARINA TAYATA,4,181,89,92,19
OAXACA,20,SANTA CATARINA TICUÁ,371,SANTA CATARINA TICUÁ,4,225,119,106,14
OAXACA,20,SANTA CATARINA YOSONOTÚ,372,JOYA DE SAN NICOLÁS (YUÑUÚ),1,6,6,0,1
OAXACA,20,SANTA CATARINA YOSONOTÚ,372,LAGUNILLA DE CÁRDENAS,3,31,15,16,3
OAXACA,20,SANTA CATARINA YOSONOTÚ,372,MORELOS,4,51,22,29,5
OAXACA,20,SANTA CATARINA YOSONOTÚ,372,SANTA CATARINA YOSONOTÚ,5,233,130,103,15
OAXACA,20,SANTA CATARINA YOSONOTÚ,372,VISTA HERMOSA,1,12,5,7,5
OAXACA,20,SANTA CATARINA YOSONOTÚ,372,YUCUNICUCA DE HIDALGO,2,25,18,7,2
OAXACA,20,SANTA CATARINA ZAPOQUILA,373,MEMBRILLOS,2,8,2,6,1
OAXACA,20,SANTA CATARINA ZAPOQUILA,373,RÍO GRANDE,1,1,1,0,1
OAXACA,20,SANTA CATARINA ZAPOQUILA,373,SANTA CATARINA ZAPOQUILA,3,72,32,40,7
OAXACA,20,SANTA CRUZ ACATEPEC,374,PIEDRA TENDIDA,1,37,18,19,2
OAXACA,20,SANTA CRUZ ACATEPEC,374,SANTA CRUZ ACATEPEC,4,337,191,146,23
OAXACA,20,SANTA CRUZ AMILPAS,375,SANTA CRUZ AMILPAS,9,1552,847,705,88
OAXACA,20,SANTA CRUZ DE BRAVO,376,SANTA CRUZ DE BRAVO,3,61,32,29,10
OAXACA,20,SANTA CRUZ ITUNDUJIA,377,AGUA DEL PLATANAR,2,22,13,9,2
OAXACA,20,SANTA CRUZ ITUNDUJIA,377,BUENAVISTA DE JUÁREZ,3,119,55,64,9
OAXACA,20,SANTA CRUZ ITUNDUJIA,377,CABATIAHUA HIDALGO,2,11,4,7,2
OAXACA,20,SANTA CRUZ ITUNDUJIA,377,EL CHAMIZAL,2,72,41,31,6
OAXACA,20,SANTA CRUZ ITUNDUJIA,377,EL PARAÍSO,3,42,22,20,5
OAXACA,20,SANTA CRUZ ITUNDUJIA,377,EL ZAPOTE,2,17,9,8,2
OAXACA,20,SANTA CRUZ ITUNDUJIA,377,ESCALERILLA HIDALGO,3,11,4,7,2
OAXACA,20,SANTA CRUZ ITUNDUJIA,377,GUERRERO,5,477,241,236,27
OAXACA,20,SANTA CRUZ ITUNDUJIA,377,HIDALGO,4,213,108,105,14
OAXACA,20,SANTA CRUZ ITUNDUJIA,377,INDEPENDENCIA,4,221,115,106,13
OAXACA,20,SANTA CRUZ ITUNDUJIA,377,ITURBIDE,3,54,29,25,5
OAXACA,20,SANTA CRUZ ITUNDUJIA,377,LA LAGUNA,2,34,16,18,9
OAXACA,20,SANTA CRUZ ITUNDUJIA,377,LA PAZ,1,16,7,9,1
OAXACA,20,SANTA CRUZ ITUNDUJIA,377,LA UNIÓN ZARAGOZA,2,19,13,6,2
OAXACA,20,SANTA CRUZ ITUNDUJIA,377,LA VICTORIA,3,102,54,48,10
OAXACA,20,SANTA CRUZ ITUNDUJIA,377,LAS FLORES,1,4,3,1,1
OAXACA,20,SANTA CRUZ ITUNDUJIA,377,LLANO RUIN,2,6,1,5,1
OAXACA,20,SANTA CRUZ ITUNDUJIA,377,MORELOS,3,146,72,74,11
OAXACA,20,SANTA CRUZ ITUNDUJIA,377,NUEVO ALLENDE,3,117,56,61,10
OAXACA,20,SANTA CRUZ ITUNDUJIA,377,PIE DE LA PEÑA,3,20,11,9,3
OAXACA,20,SANTA CRUZ ITUNDUJIA,377,PRIMAVERA MORELOS,3,48,22,26,5
OAXACA,20,SANTA CRUZ ITUNDUJIA,377,PROVIDENCIA,1,32,15,17,2
OAXACA,20,SANTA CRUZ ITUNDUJIA,377,SAN JOSÉ HIDALGO,3,23,12,11,3
OAXACA,20,SANTA CRUZ ITUNDUJIA,377,SANTA CRUZ ITUNDUJIA,5,411,213,198,26
OAXACA,20,SANTA CRUZ ITUNDUJIA,377,SEGUNDA MANZANA,1,5,2,3,2
OAXACA,20,SANTA CRUZ ITUNDUJIA,377,TINAMA,1,3,2,1,1
OAXACA,20,SANTA CRUZ ITUNDUJIA,377,UNIÓN DE GALEANA,2,97,52,45,8
OAXACA,20,SANTA CRUZ ITUNDUJIA,377,YUCUQUETZAHUE BUENA VISTA,3,25,12,13,3
OAXACA,20,SANTA CRUZ ITUNDUJIA,377,ZARAGOZA,4,405,236,169,25
OAXACA,20,SANTA CRUZ MIXTEPEC,378,EMILIANO ZAPATA,2,79,44,35,9
OAXACA,20,SANTA CRUZ MIXTEPEC,378,SAN JUAN VIEJO,1,8,4,4,1
OAXACA,20,SANTA CRUZ MIXTEPEC,378,SAN MATEO MIXTEPEC,4,232,124,108,13
OAXACA,20,SANTA CRUZ MIXTEPEC,378,SANTA CRUZ MIXTEPEC,5,372,204,168,27
OAXACA,20,SANTA CRUZ MIXTEPEC,378,TRAPICHE SANTA CRUZ,3,106,56,50,11
OAXACA,20,SANTA CRUZ NUNDACO,379,CHALMA YUTACUÁN,3,27,16,11,3
OAXACA,20,SANTA CRUZ NUNDACO,379,LOMA ÑUHU-CUA,3,60,31,29,4
OAXACA,20,SANTA CRUZ NUNDACO,379,NDOSTAYI,2,12,6,6,2
OAXACA,20,SANTA CRUZ NUNDACO,379,OJO DE AGUA,4,150,68,82,10
OAXACA,20,SANTA CRUZ NUNDACO,379,PLAN DE SAN ANTONIO,1,5,4,1,1
OAXACA,20,SANTA CRUZ NUNDACO,379,SAN ISIDRO VISTA HERMOSA,3,134,63,71,10
OAXACA,20,SANTA CRUZ NUNDACO,379,SAN JOSÉ YATANDOYO,4,132,59,73,10
OAXACA,20,SANTA CRUZ NUNDACO,379,SANTA CRUZ NUNDACO,5,218,113,105,18
OAXACA,20,SANTA CRUZ PAPALUTLA,380,SANTA CRUZ PAPALUTLA,3,389,202,187,24
OAXACA,20,SANTA CRUZ TACACHE DE MINA,381,SAN JOSÉ DE LA PRADERA,2,97,52,45,7
OAXACA,20,SANTA CRUZ TACACHE DE MINA,381,SANTA CRUZ TACACHE DE MINA,5,651,360,291,35
OAXACA,20,SANTA CRUZ TACAHUA,382,CERRO PRIETO,3,47,22,25,11
OAXACA,20,SANTA CRUZ TACAHUA,382,SANTA CRUZ TACAHUA,4,198,112,86,14
OAXACA,20,SANTA CRUZ TAYATA,383,LA ESTANCIA,2,46,20,26,4
OAXACA,20,SANTA CRUZ TAYATA,383,SANTA CRUZ TAYATA,2,27,14,13,4
OAXACA,20,SANTA CRUZ XITLA,384,SAN BERNARDO MIAHUATLÁN,3,120,59,61,12
OAXACA,20,SANTA CRUZ XITLA,384,SANTA CRUZ XITLA,7,823,478,345,50
OAXACA,20,SANTA CRUZ XOXOCOTLÁN,385,ARRAZOLA,4,1357,652,705,51
OAXACA,20,SANTA CRUZ XOXOCOTLÁN,385,JARDINES DEL SUR [FRACCIONAMIENTO],1,43,25,18,4
OAXACA,20,SANTA CRUZ XOXOCOTLÁN,385,LOMAS DE SAN JAVIER,2,218,118,100,11
OAXACA,20,SANTA CRUZ XOXOCOTLÁN,385,LOS ÁNGELES,2,71,30,41,5
OAXACA,20,SANTA CRUZ XOXOCOTLÁN,385,SAN FRANCISCO JAVIER,3,982,522,460,41
OAXACA,20,SANTA CRUZ XOXOCOTLÁN,385,SAN ISIDRO MONJAS,4,994,531,463,39
OAXACA,20,SANTA CRUZ XOXOCOTLÁN,385,SAN JUAN BAUTISTA LA RAYA,3,319,159,160,18
OAXACA,20,SANTA CRUZ XOXOCOTLÁN,385,SANTA CRUZ XOXOCOTLÁN,106,19283,10086,9197,1272
OAXACA,20,SANTA CRUZ ZENZONTEPEC,386,AGUA CENIZA,2,33,15,18,9
OAXACA,20,SANTA CRUZ ZENZONTEPEC,386,CERRO CENIZA,2,49,26,23,9
OAXACA,20,SANTA CRUZ ZENZONTEPEC,386,CERRO LUNA,2,29,12,17,7
OAXACA,20,SANTA CRUZ ZENZONTEPEC,386,CINCO CERROS,3,35,17,18,8
OAXACA,20,SANTA CRUZ ZENZONTEPEC,386,EL CANGREJERO,1,4,3,1,1
OAXACA,20,SANTA CRUZ ZENZONTEPEC,386,EL CARRIZAL,4,300,159,141,23
OAXACA,20,SANTA CRUZ ZENZONTEPEC,386,EL CUCHARAL,3,106,59,47,10
OAXACA,20,SANTA CRUZ ZENZONTEPEC,386,EL LIMONCILLO,3,141,74,67,11
OAXACA,20,SANTA CRUZ ZENZONTEPEC,386,EL PORTILLO,3,108,59,49,10
OAXACA,20,SANTA CRUZ ZENZONTEPEC,386,EL VIDRIO,2,13,10,3,1
OAXACA,20,SANTA CRUZ ZENZONTEPEC,386,LA AURORA,3,90,46,44,10
OAXACA,20,SANTA CRUZ ZENZONTEPEC,386,LA CONCHA,3,178,104,74,11
OAXACA,20,SANTA CRUZ ZENZONTEPEC,386,LA CONCHITA,2,112,63,49,9
OAXACA,20,SANTA CRUZ ZENZONTEPEC,386,LA HUICHICATA,3,108,58,50,10
OAXACA,20,SANTA CRUZ ZENZONTEPEC,386,LA PALMA,2,48,26,22,9
OAXACA,20,SANTA CRUZ ZENZONTEPEC,386,LA PALMITA,1,12,4,8,6
OAXACA,20,SANTA CRUZ ZENZONTEPEC,386,LA PAZ,3,97,50,47,9
OAXACA,20,SANTA CRUZ ZENZONTEPEC,386,LA SOLEDAD,1,13,8,5,1
OAXACA,20,SANTA CRUZ ZENZONTEPEC,386,LA SOLEDAD COFRADÍA,3,201,109,92,13
OAXACA,20,SANTA CRUZ ZENZONTEPEC,386,LAS PILAS,1,11,5,6,3
OAXACA,20,SANTA CRUZ ZENZONTEPEC,386,LLANO DEL TEMBLOR,2,19,9,10,8
OAXACA,20,SANTA CRUZ ZENZONTEPEC,386,LLANO VERDE,3,65,35,30,4
OAXACA,20,SANTA CRUZ ZENZONTEPEC,386,LLANO VÍBORA,4,240,133,107,17
OAXACA,20,SANTA CRUZ ZENZONTEPEC,386,LOS POZUELOS,4,66,34,32,14
OAXACA,20,SANTA CRUZ ZENZONTEPEC,386,MANO DEL SEÑOR,3,170,91,79,11
OAXACA,20,SANTA CRUZ ZENZONTEPEC,386,PIEDRA AMARILLA,3,130,69,61,7
OAXACA,20,SANTA CRUZ ZENZONTEPEC,386,PIEDRA DE LETRA,3,36,17,19,8
OAXACA,20,SANTA CRUZ ZENZONTEPEC,386,PIEDRA GRANDE,8,323,181,142,34
OAXACA,20,SANTA CRUZ ZENZONTEPEC,386,PIEDRA QUE MENEA,3,87,47,40,6
OAXACA,20,SANTA CRUZ ZENZONTEPEC,386,QUINICUENA,3,289,169,120,22
OAXACA,20,SANTA CRUZ ZENZONTEPEC,386,RANCHO VIEJO,2,155,89,66,11
OAXACA,20,SANTA CRUZ ZENZONTEPEC,386,SAN ISIDRO CALABAZO,3,244,124,120,15
OAXACA,20,SANTA CRUZ ZENZONTEPEC,386,SAN JOSÉ,3,122,69,53,12
OAXACA,20,SANTA CRUZ ZENZONTEPEC,386,SAN JOSÉ COFRADÍA,3,169,84,85,10
OAXACA,20,SANTA CRUZ ZENZONTEPEC,386,SAN MIGUEL,2,21,10,11,2
OAXACA,20,SANTA CRUZ ZENZONTEPEC,386,SAN PEDRO DEL RÍO,4,277,163,114,18
OAXACA,20,SANTA CRUZ ZENZONTEPEC,386,SANTA CRUZ ZENZONTEPEC,11,662,342,320,45
OAXACA,20,SANTA CRUZ ZENZONTEPEC,386,SANTA MARÍA SIEMPREVIVA,3,31,15,16,10
OAXACA,20,SANTA CRUZ ZENZONTEPEC,386,SANTA MARÍA TLAPANALQUIAHUITL,5,146,77,69,14
OAXACA,20,SANTA CRUZ ZENZONTEPEC,386,TEMPLO VIEJO,1,31,15,16,6
OAXACA,20,SANTA GERTRUDIS,387,LA BARDA PASO DE PIEDRAS,2,36,21,15,7
OAXACA,20,SANTA GERTRUDIS,387,SANTA GERTRUDIS,6,598,299,299,36
OAXACA,20,SANTA INÉS DEL MONTE,388,EL CARMEN,3,146,83,63,11
OAXACA,20,SANTA INÉS DEL MONTE,388,LA CAÑADA,3,70,31,39,9
OAXACA,20,SANTA INÉS DEL MONTE,388,LA GUADALUPE,4,101,50,51,7
OAXACA,20,SANTA INÉS DEL MONTE,388,LA LOBERA,3,104,58,46,10
OAXACA,20,SANTA INÉS DEL MONTE,388,LA SOLEDAD,3,49,25,24,12
OAXACA,20,SANTA INÉS DEL MONTE,388,SANTA INÉS DEL MONTE,4,274,155,119,19
OAXACA,20,SANTA INÉS YATZECHE,389,SANTA INÉS YATZECHE,3,110,46,64,6
OAXACA,20,SANTA LUCÍA DEL CAMINO,390,SAN FRANCISCO TUTLA,10,701,354,347,80
OAXACA,20,SANTA LUCÍA DEL CAMINO,390,SANTA LUCÍA DEL CAMINO,48,7938,4012,3926,547
OAXACA,20,SANTA LUCÍA MIAHUATLÁN,391,EL SUMIDERO,2,34,16,18,9
OAXACA,20,SANTA LUCÍA MIAHUATLÁN,391,LA CHINILLA,3,162,89,73,12
OAXACA,20,SANTA LUCÍA MIAHUATLÁN,391,LA COFRADÍA,2,47,24,23,9
OAXACA,20,SANTA LUCÍA MIAHUATLÁN,391,RÍO COMAL,2,9,4,5,1
OAXACA,20,SANTA LUCÍA MIAHUATLÁN,391,SANTA LUCÍA MIAHUATLÁN,6,576,341,235,43
OAXACA,20,SANTA LUCÍA MIAHUATLÁN,391,SIERRA LLANO GRANDE,1,19,9,10,1
OAXACA,20,SANTA LUCÍA MONTEVERDE,392,AGUA DEL TORO,4,185,88,97,12
OAXACA,20,SANTA LUCÍA MONTEVERDE,392,BUENAVISTA EL NARANJO,2,12,9,3,2
OAXACA,20,SANTA LUCÍA MONTEVERDE,392,COLONIA VILLANUEVA,2,40,22,18,2
OAXACA,20,SANTA LUCÍA MONTEVERDE,392,EL GUAYABO (NOPALERA),1,12,0,12,1
OAXACA,20,SANTA LUCÍA MONTEVERDE,392,EL PROGRESO YUCUBEY,2,42,17,25,3
OAXACA,20,SANTA LUCÍA MONTEVERDE,392,LA PAZ,3,105,53,52,7
OAXACA,20,SANTA LUCÍA MONTEVERDE,392,LA UNIÓN ALTAMIRA,1,11,6,5,1
OAXACA,20,SANTA LUCÍA MONTEVERDE,392,MOCTEZUMA,1,12,5,7,1
OAXACA,20,SANTA LUCÍA MONTEVERDE,392,PEÑA COLORADA,3,6,4,2,2
OAXACA,20,SANTA LUCÍA MONTEVERDE,392,PEÑA NEGRA NOPALERA,2,70,40,30,9
OAXACA,20,SANTA LUCÍA MONTEVERDE,392,SAN JOSÉ EL PORVENIR,4,77,45,32,5
OAXACA,20,SANTA LUCÍA MONTEVERDE,392,SAN SEBASTIÁN NOPALERA,5,382,204,178,28
OAXACA,20,SANTA LUCÍA MONTEVERDE,392,SANTA LUCÍA MONTEVERDE,5,298,144,154,18
OAXACA,20,SANTA LUCÍA MONTEVERDE,392,SANTA MARÍA OCOTLÁN,4,173,85,88,12
OAXACA,20,SANTA LUCÍA MONTEVERDE,392,TORRALBA DE JUÁREZ,2,27,13,14,7
OAXACA,20,SANTA LUCÍA MONTEVERDE,392,YUTECOSO CUAUHTÉMOC,4,166,70,96,10
OAXACA,20,SANTA LUCÍA OCOTLÁN,393,SANTA LUCÍA OCOTLÁN,4,866,468,398,47
OAXACA,20,SANTA MARÍA ALOTEPEC,394,SAN ISIDRO HUAYÁPAM,3,163,75,88,11
OAXACA,20,SANTA MARÍA ALOTEPEC,394,SAN PEDRO AYACAXTEPEC,4,180,101,79,12
OAXACA,20,SANTA MARÍA ALOTEPEC,394,SANTA MARÍA ALOTEPEC,6,395,209,186,26
OAXACA,20,SANTA MARÍA APAZCO,395,EL ALMACÉN,1,10,5,5,1
OAXACA,20,SANTA MARÍA APAZCO,395,LLANO DEL SABINO,1,16,8,8,1
OAXACA,20,SANTA MARÍA APAZCO,395,PERICÓN,3,74,34,40,5
OAXACA,20,SANTA MARÍA APAZCO,395,SANTA MARÍA APAZCO,5,203,95,108,16
OAXACA,20,SANTA MARÍA APAZCO,395,TIERRA COLORADA,5,153,73,80,13
OAXACA,20,SANTA MARÍA LA ASUNCIÓN,396,LLANO DE AGUA,6,393,222,171,24
OAXACA,20,SANTA MARÍA LA ASUNCIÓN,396,SAN AGUSTÍN NUEVO,3,90,45,45,5
OAXACA,20,SANTA MARÍA LA ASUNCIÓN,396,SANTA MARÍA LA ASUNCIÓN,4,313,148,165,22
OAXACA,20,HEROICA CIUDAD DE TLAXIACO,397,AGUA ZARCA CUQUILA,4,132,72,60,11
OAXACA,20,HEROICA CIUDAD DE TLAXIACO,397,BARRIO DE SAN DIEGO,8,1081,568,513,78
OAXACA,20,HEROICA CIUDAD DE TLAXIACO,397,BARRIO DE SAN PEDRO,3,588,308,280,32
OAXACA,20,HEROICA CIUDAD DE TLAXIACO,397,BARRIO SAN BARTOLO,2,235,109,126,13
OAXACA,20,HEROICA CIUDAD DE TLAXIACO,397,BARRIO SAN MIGUEL,2,53,34,19,37
OAXACA,20,HEROICA CIUDAD DE TLAXIACO,397,BARRIO SAN NICOLÁS,4,184,92,92,10
OAXACA,20,HEROICA CIUDAD DE TLAXIACO,397,BARRIO SAN SEBASTIÁN,3,1993,1036,957,308
OAXACA,20,HEROICA CIUDAD DE TLAXIACO,397,BENITO JUÁREZ CUQUILA,2,45,26,19,3
OAXACA,20,HEROICA CIUDAD DE TLAXIACO,397,CAMPO DE AVIACIÓN,2,61,31,30,6
OAXACA,20,HEROICA CIUDAD DE TLAXIACO,397,CAÑADA ALEJANDRO,2,22,9,13,3
OAXACA,20,HEROICA CIUDAD DE TLAXIACO,397,CAÑADA CANDELARIA,3,111,54,57,5
OAXACA,20,HEROICA CIUDAD DE TLAXIACO,397,CAÑADA EL CURTIDOR,1,10,5,5,2
OAXACA,20,HEROICA CIUDAD DE TLAXIACO,397,CAÑADA MARÍA (PRIMERA SECCIÓN),3,117,58,59,10
OAXACA,20,HEROICA CIUDAD DE TLAXIACO,397,CAÑADA MARÍA (SEGUNDA SECCIÓN),2,29,12,17,4
OAXACA,20,HEROICA CIUDAD DE TLAXIACO,397,CAPILLA DEL CARRIZAL,3,107,65,42,10
OAXACA,20,HEROICA CIUDAD DE TLAXIACO,397,EJIDO CAÑADA SANTA MARÍA,2,11,6,5,2
OAXACA,20,HEROICA CIUDAD DE TLAXIACO,397,EJIDO OJO DE AGUA (EL VERGELITO),1,28,18,10,2
OAXACA,20,HEROICA CIUDAD DE TLAXIACO,397,EL OJITE CUAUHTÉMOC,2,60,31,29,6
OAXACA,20,HEROICA CIUDAD DE TLAXIACO,397,EL TERRERO VENUSTIANO CARRANZA,2,14,10,4,2
OAXACA,20,HEROICA CIUDAD DE TLAXIACO,397,EL VERGEL,2,46,17,29,5
OAXACA,20,HEROICA CIUDAD DE TLAXIACO,397,ESCANDABA CUQUILA,2,25,11,14,2
OAXACA,20,HEROICA CIUDAD DE TLAXIACO,397,GUADALUPE HIDALGO,1,15,8,7,1
OAXACA,20,HEROICA CIUDAD DE TLAXIACO,397,HEROICA CIUDAD DE TLAXIACO,31,5950,3088,2862,397
OAXACA,20,HEROICA CIUDAD DE TLAXIACO,397,IGNACIO MANUEL ALTAMIRANO,1,3,0,3,1
OAXACA,20,HEROICA CIUDAD DE TLAXIACO,397,JOYA GRANDE,2,38,21,17,3
OAXACA,20,HEROICA CIUDAD DE TLAXIACO,397,JUAN ESCUTIA,4,85,43,42,7
OAXACA,20,HEROICA CIUDAD DE TLAXIACO,397,LA LOBERA,3,227,119,108,22
OAXACA,20,HEROICA CIUDAD DE TLAXIACO,397,LA PURÍSIMA CONCEPCIÓN,3,30,19,11,5
OAXACA,20,HEROICA CIUDAD DE TLAXIACO,397,LICENCIADO ADOLFO LÓPEZ MATEOS,3,192,89,103,12
OAXACA,20,HEROICA CIUDAD DE TLAXIACO,397,LINDA VISTA,2,118,61,57,8
OAXACA,20,HEROICA CIUDAD DE TLAXIACO,397,LLANO DE GUADALUPE,3,76,35,41,7
OAXACA,20,HEROICA CIUDAD DE TLAXIACO,397,LOS ÁNGELES,2,66,34,32,5
OAXACA,20,HEROICA CIUDAD DE TLAXIACO,397,MEXICALCINGO DE LOS GRANADOS,2,11,4,7,2
OAXACA,20,HEROICA CIUDAD DE TLAXIACO,397,NUEVA REFORMA,1,24,11,13,2
OAXACA,20,HEROICA CIUDAD DE TLAXIACO,397,OJO DE AGUA,4,173,83,90,13
OAXACA,20,HEROICA CIUDAD DE TLAXIACO,397,PALO DE LETRA,1,62,27,35,6
OAXACA,20,HEROICA CIUDAD DE TLAXIACO,397,PLAN DE GUADALUPE,3,121,52,69,9
OAXACA,20,HEROICA CIUDAD DE TLAXIACO,397,RANCHO VIEJO,1,45,20,25,3
OAXACA,20,HEROICA CIUDAD DE TLAXIACO,397,RÍO DELGADO,2,54,23,31,6
OAXACA,20,HEROICA CIUDAD DE TLAXIACO,397,SAN FELIPE TINDACO,3,44,23,21,11
OAXACA,20,HEROICA CIUDAD DE TLAXIACO,397,SAN ISIDRO,3,63,32,31,5
OAXACA,20,HEROICA CIUDAD DE TLAXIACO,397,SAN JUAN LAS HUERTAS,1,12,6,6,1
OAXACA,20,HEROICA CIUDAD DE TLAXIACO,397,SAN MIGUEL PROGRESO,5,274,142,132,22
OAXACA,20,HEROICA CIUDAD DE TLAXIACO,397,SAN PEDRO LLANO GRANDE,1,25,13,12,1
OAXACA,20,HEROICA CIUDAD DE TLAXIACO,397,SAN PEDRO YOSOTATU,3,82,43,39,10
OAXACA,20,HEROICA CIUDAD DE TLAXIACO,397,SANTA LUCRECIA,1,6,3,3,1
OAXACA,20,HEROICA CIUDAD DE TLAXIACO,397,SANTA MARÍA CUQUILA,5,392,196,196,24
OAXACA,20,HEROICA CIUDAD DE TLAXIACO,397,SANTO DOMINGO HUENDÍO,1,10,7,3,1
OAXACA,20,HEROICA CIUDAD DE TLAXIACO,397,TEE UJIA PROGRESO,2,74,36,38,4
OAXACA,20,HEROICA CIUDAD DE TLAXIACO,397,VILLA DE LAS FLORES,1,33,22,11,2
OAXACA,20,HEROICA CIUDAD DE TLAXIACO,397,YOSOTIUN YOSOSTATU YUCUHILLO SAN MIGUEL PROGRESO,1,15,5,10,1
OAXACA,20,AYOQUEZCO DE ALDAMA,398,AYOQUEZCO DE ALDAMA,9,904,527,377,66
OAXACA,20,AYOQUEZCO DE ALDAMA,398,GUEGOVELA,2,44,24,20,9
OAXACA,20,AYOQUEZCO DE ALDAMA,398,GUEVARA,1,5,1,4,1
OAXACA,20,SANTA MARÍA ATZOMPA,399,LA CAÑADA,3,433,232,201,27
OAXACA,20,SANTA MARÍA ATZOMPA,399,LA MESITA [PARAJE],1,72,37,35,3
OAXACA,20,SANTA MARÍA ATZOMPA,399,MONTEALBÁN,2,125,71,54,7
OAXACA,20,SANTA MARÍA ATZOMPA,399,SAN JERÓNIMO YAHUICHE,2,304,178,126,20
OAXACA,20,SANTA MARÍA ATZOMPA,399,SAN JOSÉ HIDALGO,3,112,61,51,12
OAXACA,20,SANTA MARÍA ATZOMPA,399,SANTA CATARINA MONTAÑO,2,62,35,27,9
OAXACA,20,SANTA MARÍA ATZOMPA,399,SANTA MARÍA ATZOMPA,30,5043,2865,2178,335
OAXACA,20,SANTA MARÍA CAMOTLÁN,400,SANTA MARÍA CAMOTLÁN,6,385,217,168,29
OAXACA,20,SANTA MARÍA COLOTEPEC,401,AGUAJE DE LA DANTA,2,7,5,2,2
OAXACA,20,SANTA MARÍA COLOTEPEC,401,AGUAJE RAMÍREZ,2,26,14,12,2
OAXACA,20,SANTA MARÍA COLOTEPEC,401,ARROYO DEL BAJO,3,19,11,8,3
OAXACA,20,SANTA MARÍA COLOTEPEC,401,ARROYO DEL ZAPOTE,2,6,5,1,1
OAXACA,20,SANTA MARÍA COLOTEPEC,401,BARRA DE NAVIDAD,2,255,121,134,13
OAXACA,20,SANTA MARÍA COLOTEPEC,401,BRISAS DE ZICATELA,4,354,198,156,20
OAXACA,20,SANTA MARÍA COLOTEPEC,401,CERRO DE LA OLLA,1,5,2,3,1
OAXACA,20,SANTA MARÍA COLOTEPEC,401,CERRO DEL CABALLO,2,6,4,2,2
OAXACA,20,SANTA MARÍA COLOTEPEC,401,CHARCO SECO,2,27,15,12,2
OAXACA,20,SANTA MARÍA COLOTEPEC,401,COROZALITO,3,30,11,19,3
OAXACA,20,SANTA MARÍA COLOTEPEC,401,EL BAJO,2,11,5,6,2
OAXACA,20,SANTA MARÍA COLOTEPEC,401,EL BANCO,1,6,4,2,1
OAXACA,20,SANTA MARÍA COLOTEPEC,401,EL CAMALOTE,3,63,40,23,5
OAXACA,20,SANTA MARÍA COLOTEPEC,401,EL CAMARÓN,2,25,13,12,2
OAXACA,20,SANTA MARÍA COLOTEPEC,401,EL COLUMPIO,2,6,3,3,1
OAXACA,20,SANTA MARÍA COLOTEPEC,401,EL COROZAL,3,40,20,20,3
OAXACA,20,SANTA MARÍA COLOTEPEC,401,EL MALUCANO,2,48,26,22,6
OAXACA,20,SANTA MARÍA COLOTEPEC,401,EL PORVENIR,1,21,14,7,1
OAXACA,20,SANTA MARÍA COLOTEPEC,401,EL POTRERO,2,18,5,13,2
OAXACA,20,SANTA MARÍA COLOTEPEC,401,EL ROSEDAL,2,7,3,4,2
OAXACA,20,SANTA MARÍA COLOTEPEC,401,EL ROSEDALITO,1,1,0,1,0
OAXACA,20,SANTA MARÍA COLOTEPEC,401,EL SALITRERO,3,64,34,30,10
OAXACA,20,SANTA MARÍA COLOTEPEC,401,EL TECOMATE,2,12,6,6,2
OAXACA,20,SANTA MARÍA COLOTEPEC,401,EL TOMATAL,4,197,103,94,15
OAXACA,20,SANTA MARÍA COLOTEPEC,401,EL VITONCHINO,2,11,7,4,2
OAXACA,20,SANTA MARÍA COLOTEPEC,401,JUAN DIEGO,4,290,161,129,53
OAXACA,20,SANTA MARÍA COLOTEPEC,401,JUNTA DE CORRIENTES,2,8,1,7,1
OAXACA,20,SANTA MARÍA COLOTEPEC,401,JUNTA DEL POTRERO,2,23,11,12,2
OAXACA,20,SANTA MARÍA COLOTEPEC,401,LA BARRA DE COLOTEPEC,3,276,141,135,20
OAXACA,20,SANTA MARÍA COLOTEPEC,401,LA CEIBA,1,15,6,9,1
OAXACA,20,SANTA MARÍA COLOTEPEC,401,LA NOPALERA,1,7,4,3,1
OAXACA,20,SANTA MARÍA COLOTEPEC,401,LA NUEVA ESPERANZA,3,31,17,14,4
OAXACA,20,SANTA MARÍA COLOTEPEC,401,LA OBSCURANA,2,23,14,9,2
OAXACA,20,SANTA MARÍA COLOTEPEC,401,LA TOMA,2,17,12,5,2
OAXACA,20,SANTA MARÍA COLOTEPEC,401,LAS CARRETAS,2,8,4,4,1
OAXACA,20,SANTA MARÍA COLOTEPEC,401,LOMA BONITA,2,64,33,31,3
OAXACA,20,SANTA MARÍA COLOTEPEC,401,LOS FIGUEROA,1,2,2,0,1
OAXACA,20,SANTA MARÍA COLOTEPEC,401,LOS NARANJOS,3,63,34,29,6
OAXACA,20,SANTA MARÍA COLOTEPEC,401,LOS REYES,2,30,20,10,2
OAXACA,20,SANTA MARÍA COLOTEPEC,401,LOS SARMIENTOS,3,18,8,10,3
OAXACA,20,SANTA MARÍA COLOTEPEC,401,MATA DE BULE,3,122,63,59,8
OAXACA,20,SANTA MARÍA COLOTEPEC,401,NUEVO AMANECER SAN JACINTO [COLONIA],2,57,22,35,4
OAXACA,20,SANTA MARÍA COLOTEPEC,401,PALMA SOLA,2,11,9,2,2
OAXACA,20,SANTA MARÍA COLOTEPEC,401,PASO LAGARTO,1,14,8,6,1
OAXACA,20,SANTA MARÍA COLOTEPEC,401,PIEDRAS NEGRAS,2,5,2,3,1
OAXACA,20,SANTA MARÍA COLOTEPEC,401,RÍO VALDEFLORES,1,60,27,33,4
OAXACA,20,SANTA MARÍA COLOTEPEC,401,SAN JOSÉ EL QUEQUESTLE,3,95,47,48,8
OAXACA,20,SANTA MARÍA COLOTEPEC,401,SANTA MARÍA COLOTEPEC,11,877,477,400,87
OAXACA,20,SANTA MARÍA COLOTEPEC,401,VALDEFLORES,5,118,66,52,13
OAXACA,20,SANTA MARÍA COLOTEPEC,401,VALDEFLORES SEGUNDA SECCIÓN,1,13,7,6,1
OAXACA,20,SANTA MARÍA COLOTEPEC,401,VENTANILLA,3,273,130,143,15
OAXACA,20,SANTA MARÍA CORTIJO,402,SANTA MARÍA CORTIJO,4,290,173,117,22
OAXACA,20,SANTA MARÍA COYOTEPEC,403,SANTA MARÍA COYOTEPEC,7,1332,638,694,54
OAXACA,20,SANTA MARÍA CHACHOÁPAM,404,SAN AGUSTÍN MONTELOBOS,2,5,3,2,1
OAXACA,20,SANTA MARÍA CHACHOÁPAM,404,SAN ANTONIO PERALES,1,14,9,5,2
OAXACA,20,SANTA MARÍA CHACHOÁPAM,404,SANTA MARÍA CHACHOÁPAM,2,46,23,23,6
OAXACA,20,VILLA DE CHILAPA DE DÍAZ,405,SAN MARCOS MONTE DE LEÓN,1,5,1,4,1
OAXACA,20,VILLA DE CHILAPA DE DÍAZ,405,SANTO DOMINGO NUNDÓ,2,34,16,18,6
OAXACA,20,VILLA DE CHILAPA DE DÍAZ,405,VILLA DE CHILAPA DE DÍAZ,4,379,183,196,22
OAXACA,20,SANTA MARÍA CHILCHOTLA,406,AGUA DE GANCHO,3,59,30,29,6
OAXACA,20,SANTA MARÍA CHILCHOTLA,406,AGUA DE NIÑO,1,8,3,5,1
OAXACA,20,SANTA MARÍA CHILCHOTLA,406,AGUA DE PAXTLE,3,150,77,73,8
OAXACA,20,SANTA MARÍA CHILCHOTLA,406,AMATLÁN DE LOS REYES,1,15,6,9,1
OAXACA,20,SANTA MARÍA CHILCHOTLA,406,BARRANCA SECA,3,171,85,86,9
OAXACA,20,SANTA MARÍA CHILCHOTLA,406,BENITO JUÁREZ,4,128,55,73,7
OAXACA,20,SANTA MARÍA CHILCHOTLA,406,CERRO OCOTE,1,15,7,8,1
OAXACA,20,SANTA MARÍA CHILCHOTLA,406,CERRO PALMA,1,15,8,7,1
OAXACA,20,SANTA MARÍA CHILCHOTLA,406,CLEMENCIA,3,65,31,34,5
OAXACA,20,SANTA MARÍA CHILCHOTLA,406,COLONIA SAN MIGUEL (LA COLONIA),1,11,5,6,4
OAXACA,20,SANTA MARÍA CHILCHOTLA,406,CUAUHTÉMOC,3,79,42,37,6
OAXACA,20,SANTA MARÍA CHILCHOTLA,406,CUEVA BLANCA,3,37,18,19,3
OAXACA,20,SANTA MARÍA CHILCHOTLA,406,EL EDÉN,2,42,16,26,3
OAXACA,20,SANTA MARÍA CHILCHOTLA,406,EL MIRADOR,2,37,18,19,2
OAXACA,20,SANTA MARÍA CHILCHOTLA,406,EL VERGEL,2,20,6,14,2
OAXACA,20,SANTA MARÍA CHILCHOTLA,406,EMILIANO ZAPATA,1,16,10,6,1
OAXACA,20,SANTA MARÍA CHILCHOTLA,406,GUADALUPE,4,198,106,92,12
OAXACA,20,SANTA MARÍA CHILCHOTLA,406,JOYA MARÍA,2,59,25,34,3
OAXACA,20,SANTA MARÍA CHILCHOTLA,406,LA CHICHARRA,1,4,0,4,1
OAXACA,20,SANTA MARÍA CHILCHOTLA,406,LA LUZ,3,41,18,23,5
OAXACA,20,SANTA MARÍA CHILCHOTLA,406,LA REFORMA,2,27,14,13,2
OAXACA,20,SANTA MARÍA CHILCHOTLA,406,LA REVOLUCIÓN,2,46,28,18,3
OAXACA,20,SANTA MARÍA CHILCHOTLA,406,LA SOLEDAD,3,49,26,23,4
OAXACA,20,SANTA MARÍA CHILCHOTLA,406,LA TRINIDAD,3,49,26,23,5
OAXACA,20,SANTA MARÍA CHILCHOTLA,406,LOMA ALTA,3,84,40,44,6
OAXACA,20,SANTA MARÍA CHILCHOTLA,406,LOMA BONITA,2,26,13,13,3
OAXACA,20,SANTA MARÍA CHILCHOTLA,406,LOMA MANGO,1,29,13,16,1
OAXACA,20,SANTA MARÍA CHILCHOTLA,406,LOTE 31,1,36,18,18,2
OAXACA,20,SANTA MARÍA CHILCHOTLA,406,MARÍA LUISA,3,71,39,32,6
OAXACA,20,SANTA MARÍA CHILCHOTLA,406,MONTE CARMELO,3,34,21,13,3
OAXACA,20,SANTA MARÍA CHILCHOTLA,406,MONTE CRISTO,4,90,42,48,11
OAXACA,20,SANTA MARÍA CHILCHOTLA,406,MONTE DE LOS OLIVOS,3,88,48,40,5
OAXACA,20,SANTA MARÍA CHILCHOTLA,406,MONTE HOREB,3,57,28,29,6
OAXACA,20,SANTA MARÍA CHILCHOTLA,406,MONTE SINAÍ,1,14,9,5,1
OAXACA,20,SANTA MARÍA CHILCHOTLA,406,PASO COCUYO,3,121,61,60,8
OAXACA,20,SANTA MARÍA CHILCHOTLA,406,PATIO IGLESIA,2,60,34,26,4
OAXACA,20,SANTA MARÍA CHILCHOTLA,406,PEÑA QUEMADA,2,56,32,24,3
OAXACA,20,SANTA MARÍA CHILCHOTLA,406,PIEDRA ANCHA,1,23,8,15,1
OAXACA,20,SANTA MARÍA CHILCHOTLA,406,PIEDRA DE FIERRO,1,18,9,9,2
OAXACA,20,SANTA MARÍA CHILCHOTLA,406,PUEBLO NUEVO,2,9,1,8,1
OAXACA,20,SANTA MARÍA CHILCHOTLA,406,RANCHO ALEGRE,1,31,15,16,6
OAXACA,20,SANTA MARÍA CHILCHOTLA,406,RANCHO CACAO,1,28,15,13,2
OAXACA,20,SANTA MARÍA CHILCHOTLA,406,RANCHO DE ORO,1,15,8,7,1
OAXACA,20,SANTA MARÍA CHILCHOTLA,406,RANCHO NUEVO,3,107,57,50,10
OAXACA,20,SANTA MARÍA CHILCHOTLA,406,RICARDO FLORES MAGÓN,1,25,12,13,2
OAXACA,20,SANTA MARÍA CHILCHOTLA,406,RÍO LODO,3,214,101,113,12
OAXACA,20,SANTA MARÍA CHILCHOTLA,406,RÍO SAPO,6,601,320,281,23
OAXACA,20,SANTA MARÍA CHILCHOTLA,406,RÍO SECO,3,65,38,27,6
OAXACA,20,SANTA MARÍA CHILCHOTLA,406,SAN AGUSTÍN,2,38,18,20,2
OAXACA,20,SANTA MARÍA CHILCHOTLA,406,SAN FRANCISCO,6,233,116,117,16
OAXACA,20,SANTA MARÍA CHILCHOTLA,406,SAN JOSÉ CAÑALTEPEC,2,49,23,26,3
OAXACA,20,SANTA MARÍA CHILCHOTLA,406,SAN JOSÉ LINDAVISTA,2,38,19,19,5
OAXACA,20,SANTA MARÍA CHILCHOTLA,406,SAN JUAN,2,26,8,18,2
OAXACA,20,SANTA MARÍA CHILCHOTLA,406,SAN JULIO,2,40,22,18,3
OAXACA,20,SANTA MARÍA CHILCHOTLA,406,SAN MARTÍN DE PORRES,4,188,90,98,15
OAXACA,20,SANTA MARÍA CHILCHOTLA,406,SAN MARTÍN RÍO PETLAPA,3,48,23,25,4
OAXACA,20,SANTA MARÍA CHILCHOTLA,406,SAN MIGUEL NUEVO,5,239,129,110,24
OAXACA,20,SANTA MARÍA CHILCHOTLA,406,SAN RAFAEL,3,196,96,100,12
OAXACA,20,SANTA MARÍA CHILCHOTLA,406,SANTA ELENA,3,78,44,34,7
OAXACA,20,SANTA MARÍA CHILCHOTLA,406,SANTA EUSTOLIA,2,70,37,33,4
OAXACA,20,SANTA MARÍA CHILCHOTLA,406,SANTA HERMINIA,1,16,10,6,1
OAXACA,20,SANTA MARÍA CHILCHOTLA,406,SANTA MARÍA CHILCHOTLA,12,993,493,500,55
OAXACA,20,SANTA MARÍA CHILCHOTLA,406,SANTA ROSA,2,64,28,36,4
OAXACA,20,SANTA MARÍA CHILCHOTLA,406,TIERRA COLORADA,1,35,24,11,2
OAXACA,20,SANTA MARÍA CHILCHOTLA,406,VILLA AZUETA,1,16,8,8,1
OAXACA,20,SANTA MARÍA CHILCHOTLA,406,VILLA HERMOSA,2,13,9,4,2
OAXACA,20,SANTA MARÍA CHILCHOTLA,406,VISTA HERMOSA,2,41,25,16,2
OAXACA,20,SANTA MARÍA CHILCHOTLA,406,VOLADERO,2,34,22,12,3
OAXACA,20,SANTA MARÍA CHILCHOTLA,406,ZONGOLICA,3,72,39,33,5
OAXACA,20,SANTA MARÍA CHIMALAPA,407,ARROYO CHICHIHUA,2,27,14,13,8
OAXACA,20,SANTA MARÍA CHIMALAPA,407,CHALCHIJAPA,3,67,32,35,4
OAXACA,20,SANTA MARÍA CHIMALAPA,407,COFRADÍA CHIMALAPA,3,53,27,26,9
OAXACA,20,SANTA MARÍA CHIMALAPA,407,ESCOLAPA,3,62,30,32,6
OAXACA,20,SANTA MARÍA CHIMALAPA,407,JOSÉ LÓPEZ PORTILLO (CHOCOMANATLÁN),3,60,24,36,8
OAXACA,20,SANTA MARÍA CHIMALAPA,407,LA ESMERALDA,4,172,76,96,15
OAXACA,20,SANTA MARÍA CHIMALAPA,407,LA ESPERANZA,3,318,185,133,19
OAXACA,20,SANTA MARÍA CHIMALAPA,407,LA FORTALEZA,2,47,20,27,3
OAXACA,20,SANTA MARÍA CHIMALAPA,407,LA LIBERTAD [RANCHO],1,10,4,6,1
OAXACA,20,SANTA MARÍA CHIMALAPA,407,NICOLÁS BRAVO,1,10,4,6,1
OAXACA,20,SANTA MARÍA CHIMALAPA,407,NUEVO SAN JUAN,3,37,20,17,3
OAXACA,20,SANTA MARÍA CHIMALAPA,407,PILAR ESPINOSA DE LEÓN,2,14,8,6,2
OAXACA,20,SANTA MARÍA CHIMALAPA,407,RÍO FRÍO,2,17,5,12,2
OAXACA,20,SANTA MARÍA CHIMALAPA,407,RÍO HAMACA,3,47,29,18,4
OAXACA,20,SANTA MARÍA CHIMALAPA,407,RÍO MODELO,1,5,3,2,1
OAXACA,20,SANTA MARÍA CHIMALAPA,407,SAN ANTONIO NUEVO PARAÍSO,2,26,9,17,6
OAXACA,20,SANTA MARÍA CHIMALAPA,407,SAN FRANCISCO EL VADO,1,14,7,7,1
OAXACA,20,SANTA MARÍA CHIMALAPA,407,SAN FRANCISCO LA PAZ,3,260,122,138,12
OAXACA,20,SANTA MARÍA CHIMALAPA,407,SANTA INÉS,3,96,54,42,8
OAXACA,20,SANTA MARÍA CHIMALAPA,407,SANTA MARÍA CHIMALAPA,5,739,354,385,50
OAXACA,20,SANTA MARÍA CHIMALAPA,407,TIERRA BLANCA,4,108,54,54,7
OAXACA,20,SANTA MARÍA DEL ROSARIO,408,SAN ISIDRO EL ROSARIO,2,16,4,12,2
OAXACA,20,SANTA MARÍA DEL ROSARIO,408,SANTA MARÍA DEL ROSARIO,2,31,17,14,3
OAXACA,20,SANTA MARÍA DEL TULE,409,GÜENDULAIN,2,88,50,38,9
OAXACA,20,SANTA MARÍA DEL TULE,409,SANTA MARÍA DEL TULE,10,3149,1707,1442,140
OAXACA,20,SANTA MARÍA ECATEPEC,410,LA REFORMA,2,32,16,16,9
OAXACA,20,SANTA MARÍA ECATEPEC,410,SAN JUAN ACALTEPEC,2,29,13,16,9
OAXACA,20,SANTA MARÍA ECATEPEC,410,SAN LORENZO JILOTEPEQUILLO,3,138,78,60,12
OAXACA,20,SANTA MARÍA ECATEPEC,410,SAN PEDRO SOSOLTEPEC,1,6,1,5,5
OAXACA,20,SANTA MARÍA ECATEPEC,410,SANTA MARÍA ECATEPEC,4,184,91,93,19
OAXACA,20,SANTA MARÍA ECATEPEC,410,SANTA MARÍA ZAPOTITLÁN,4,355,182,173,27
OAXACA,20,SANTA MARÍA ECATEPEC,410,SANTO DOMINGO CHONTECOMATLÁN,3,141,70,71,12
OAXACA,20,SANTA MARÍA ECATEPEC,410,SANTO TOMÁS TEIPAN,2,25,11,14,8
OAXACA,20,SANTA MARÍA GUELACÉ,411,SANTA MARÍA GUELACÉ,2,119,68,51,10
OAXACA,20,SANTA MARÍA GUIENAGATI,412,ALGODÓN,1,11,3,8,6
OAXACA,20,SANTA MARÍA GUIENAGATI,412,CHAYOTEPEC,2,11,5,6,2
OAXACA,20,SANTA MARÍA GUIENAGATI,412,CIENEGUILLA,2,14,8,6,2
OAXACA,20,SANTA MARÍA GUIENAGATI,412,EL TRAPICHE GUIENAGATI,1,6,1,5,1
OAXACA,20,SANTA MARÍA GUIENAGATI,412,LACHIGUXÉ,5,99,50,49,10
OAXACA,20,SANTA MARÍA GUIENAGATI,412,LACHIVIXÁ,3,109,45,64,7
OAXACA,20,SANTA MARÍA GUIENAGATI,412,LOMA DE TIERRA,3,8,6,2,2
OAXACA,20,SANTA MARÍA GUIENAGATI,412,NIZAVIGANA,3,67,38,29,10
OAXACA,20,SANTA MARÍA GUIENAGATI,412,PEÑA BLANCA,2,35,17,18,7
OAXACA,20,SANTA MARÍA GUIENAGATI,412,SANTA MARÍA GUIENAGATI,6,563,287,276,31
OAXACA,20,SANTA MARÍA HUATULCO,413,AGUA HEDIONDA,2,8,4,4,2
OAXACA,20,SANTA MARÍA HUATULCO,413,AGUAJE EL ZAPOTE,3,173,96,77,14
OAXACA,20,SANTA MARÍA HUATULCO,413,ARROYO GONZÁLEZ,3,186,89,97,12
OAXACA,20,SANTA MARÍA HUATULCO,413,ARROYO LIMÓN,1,7,2,5,1
OAXACA,20,SANTA MARÍA HUATULCO,413,ARROYO SÚCHIL,4,277,138,139,20
OAXACA,20,SANTA MARÍA HUATULCO,413,BAHÍA DE SANTA CRUZ HUATULCO,33,6261,3281,2980,420
OAXACA,20,SANTA MARÍA HUATULCO,413,BAJOS DE COYULA,4,218,121,97,21
OAXACA,20,SANTA MARÍA HUATULCO,413,BAJOS DEL ARENAL,3,157,89,68,14
OAXACA,20,SANTA MARÍA HUATULCO,413,CRUCECITA,9,999,611,388,131
OAXACA,20,SANTA MARÍA HUATULCO,413,CUAJINICUIL,2,91,44,47,6
OAXACA,20,SANTA MARÍA HUATULCO,413,DERRAMADERO,3,19,12,7,3
OAXACA,20,SANTA MARÍA HUATULCO,413,EL CRUCERO [FRACCIONAMIENTO],1,97,46,51,11
OAXACA,20,SANTA MARÍA HUATULCO,413,EL CRUCERO DE HUATULCO,1,63,36,27,5
OAXACA,20,SANTA MARÍA HUATULCO,413,EL FAISÁN [FRACCIONAMIENTO],2,5,2,3,1
OAXACA,20,SANTA MARÍA HUATULCO,413,GUARUMBO,1,36,19,17,2
OAXACA,20,SANTA MARÍA HUATULCO,413,HACIENDA VIEJA,2,44,23,21,5
OAXACA,20,SANTA MARÍA HUATULCO,413,LA ERRADURA,3,279,148,131,19
OAXACA,20,SANTA MARÍA HUATULCO,413,LA MINA [BARRIO],2,18,8,10,2
OAXACA,20,SANTA MARÍA HUATULCO,413,LA UNIÓN 1 [KILÓMETRO 2],2,17,7,10,2
OAXACA,20,SANTA MARÍA HUATULCO,413,LAS POZAS (SAN ANTONIO LAS POZAS),2,23,13,10,5
OAXACA,20,SANTA MARÍA HUATULCO,413,PASO ANCHO,2,196,100,96,11
OAXACA,20,SANTA MARÍA HUATULCO,413,PIEDRA DE MOROS,1,16,7,9,6
OAXACA,20,SANTA MARÍA HUATULCO,413,PUEBLO VIEJO,2,59,31,28,7
OAXACA,20,SANTA MARÍA HUATULCO,413,PUENTE COPALITA,1,7,3,4,1
OAXACA,20,SANTA MARÍA HUATULCO,413,PUENTE DE COYULA,3,121,57,64,10
OAXACA,20,SANTA MARÍA HUATULCO,413,PUENTE DE CUAJINICUIL,2,19,6,13,2
OAXACA,20,SANTA MARÍA HUATULCO,413,PUENTE TODOS SANTOS,1,5,3,2,1
OAXACA,20,SANTA MARÍA HUATULCO,413,RÍO TANGOLUNDA (LA JABALINA),2,16,6,10,2
OAXACA,20,SANTA MARÍA HUATULCO,413,SAN AGUSTÍN,1,18,5,13,1
OAXACA,20,SANTA MARÍA HUATULCO,413,SAN FRANCISCO LIMONCITO,2,26,12,14,7
OAXACA,20,SANTA MARÍA HUATULCO,413,SANTA MARÍA HUATULCO,16,3745,1949,1796,226
OAXACA,20,SANTA MARÍA HUATULCO,413,TODOS SANTOS,3,129,72,57,12
OAXACA,20,SANTA MARÍA HUATULCO,413,XÚCHIL EL ALTO,1,13,6,7,1
OAXACA,20,SANTA MARÍA HUAZOLOTITLÁN,414,CERRO BLANCO,2,49,19,30,6
OAXACA,20,SANTA MARÍA HUAZOLOTITLÁN,414,CERRO EL CHIVO,1,26,15,11,2
OAXACA,20,SANTA MARÍA HUAZOLOTITLÁN,414,EL POTRERO,2,75,37,38,6
OAXACA,20,SANTA MARÍA HUAZOLOTITLÁN,414,JOSÉ MARÍA MORELOS,5,649,328,321,39
OAXACA,20,SANTA MARÍA HUAZOLOTITLÁN,414,LA COBRANZA,2,26,8,18,4
OAXACA,20,SANTA MARÍA HUAZOLOTITLÁN,414,PASO DEL JIOTE,3,159,74,85,12
OAXACA,20,SANTA MARÍA HUAZOLOTITLÁN,414,SANTA MARÍA CHICOMETEPEC,5,431,224,207,28
OAXACA,20,SANTA MARÍA HUAZOLOTITLÁN,414,SANTA MARÍA HUAZOLOTITLÁN,11,1325,690,635,67
OAXACA,20,SANTA MARÍA HUAZOLOTITLÁN,414,YUTANICANI,3,55,26,29,8
OAXACA,20,SANTA MARÍA IPALAPA,415,SAN ANDRÉS EL BAJO,1,5,1,4,1
OAXACA,20,SANTA MARÍA IPALAPA,415,SANTA MARÍA EL RINCÓN,3,382,202,180,28
OAXACA,20,SANTA MARÍA IPALAPA,415,SANTA MARÍA IPALAPA,6,550,298,252,39
OAXACA,20,SANTA MARÍA IPALAPA,415,SANTIAGO EL LIMÓN,1,29,15,14,2
OAXACA,20,SANTA MARÍA IPALAPA,415,ZOCOTEACA DE LEÓN,3,247,137,110,18
OAXACA,20,SANTA MARÍA IXCATLÁN,416,SANTA MARÍA IXCATLÁN,3,72,31,41,8
OAXACA,20,SANTA MARÍA JACATEPEC,417,CERRO CABALLO,2,6,2,4,1
OAXACA,20,SANTA MARÍA JACATEPEC,417,CERRO CONCHA,5,273,144,129,16
OAXACA,20,SANTA MARÍA JACATEPEC,417,CINCO DE ORO,1,20,9,11,1
OAXACA,20,SANTA MARÍA JACATEPEC,417,COLONIA EMILIANO ZAPATA,1,69,29,40,3
OAXACA,20,SANTA MARÍA JACATEPEC,417,EL FORTÍN II,2,20,9,11,2
OAXACA,20,SANTA MARÍA JACATEPEC,417,EL GUAYABO,1,15,7,8,1
OAXACA,20,SANTA MARÍA JACATEPEC,417,EL PORVENIR,3,17,6,11,3
OAXACA,20,SANTA MARÍA JACATEPEC,417,EMILIANO ZAPATA,3,69,34,35,6
OAXACA,20,SANTA MARÍA JACATEPEC,417,LA FLORIDA,3,69,28,41,5
OAXACA,20,SANTA MARÍA JACATEPEC,417,LA JOYA DE SANTA MARÍA JACATEPEC,8,362,180,182,22
OAXACA,20,SANTA MARÍA JACATEPEC,417,LA SOLEDAD,2,81,40,41,5
OAXACA,20,SANTA MARÍA JACATEPEC,417,LOMA DEL CARMEN,2,53,27,26,6
OAXACA,20,SANTA MARÍA JACATEPEC,417,MACEDONIO ALCALÁ,2,54,27,27,4
OAXACA,20,SANTA MARÍA JACATEPEC,417,NUEVO FAISÁN,2,47,20,27,3
OAXACA,20,SANTA MARÍA JACATEPEC,417,NUEVO MÁLZAGA,4,224,110,114,14
OAXACA,20,SANTA MARÍA JACATEPEC,417,RANCHO ALEGRE,2,65,31,34,4
OAXACA,20,SANTA MARÍA JACATEPEC,417,RANCHO FAISÁN,1,6,5,1,1
OAXACA,20,SANTA MARÍA JACATEPEC,417,RANCHO GAVILÁN,2,26,12,14,7
OAXACA,20,SANTA MARÍA JACATEPEC,417,RANCHO MANANTIAL,1,15,4,11,1
OAXACA,20,SANTA MARÍA JACATEPEC,417,SAN AGUSTÍN,2,25,12,13,2
OAXACA,20,SANTA MARÍA JACATEPEC,417,SAN MARTÍN,2,58,27,31,4
OAXACA,20,SANTA MARÍA JACATEPEC,417,SANTA MARÍA JACATEPEC,7,492,254,238,37
OAXACA,20,SANTA MARÍA JACATEPEC,417,SANTA SOFÍA,2,15,6,9,2
OAXACA,20,SANTA MARÍA JACATEPEC,417,VEGA DEL SOL,5,428,232,196,25
OAXACA,20,SANTA MARÍA JALAPA DEL MARQUÉS,418,BENITO JUÁREZ CHICA,1,5,1,4,1
OAXACA,20,SANTA MARÍA JALAPA DEL MARQUÉS,418,CERRO DEL CHIVO,2,7,2,5,1
OAXACA,20,SANTA MARÍA JALAPA DEL MARQUÉS,418,COLONIA PRESIDENTE JUÁREZ,2,58,33,25,6
OAXACA,20,SANTA MARÍA JALAPA DEL MARQUÉS,418,EL REPARO,1,15,8,7,1
OAXACA,20,SANTA MARÍA JALAPA DEL MARQUÉS,418,GUADALUPE VICTORIA,1,32,13,19,2
OAXACA,20,SANTA MARÍA JALAPA DEL MARQUÉS,418,GUICHIQUERO,3,49,20,29,7
OAXACA,20,SANTA MARÍA JALAPA DEL MARQUÉS,418,LLANO GRANDE,3,93,45,48,11
OAXACA,20,SANTA MARÍA JALAPA DEL MARQUÉS,418,LLANO VERÍA,4,127,63,64,9
OAXACA,20,SANTA MARÍA JALAPA DEL MARQUÉS,418,MAGDALENA GUELAVENCE,1,31,19,12,2
OAXACA,20,SANTA MARÍA JALAPA DEL MARQUÉS,418,POCHOTILLO,2,38,22,16,5
OAXACA,20,SANTA MARÍA JALAPA DEL MARQUÉS,418,SAN CRISTÓBAL,3,165,75,90,12
OAXACA,20,SANTA MARÍA JALAPA DEL MARQUÉS,418,SANTA MARÍA JALAPA DEL MARQUÉS,18,2296,1158,1138,149
OAXACA,20,SANTA MARÍA JALTIANGUIS,419,SANTA MARÍA JALTIANGUIS,3,128,62,66,11
OAXACA,20,SANTA MARÍA LACHIXÍO,420,LOMA LARGA,2,13,8,5,2
OAXACA,20,SANTA MARÍA LACHIXÍO,420,RINCÓN HACIENDA VIEJA,3,89,43,46,6
OAXACA,20,SANTA MARÍA LACHIXÍO,420,SANTA MARÍA LACHIXÍO,5,421,234,187,23
OAXACA,20,SANTA MARÍA MIXTEQUILLA,421,KILÓMETRO 10 NIZZAPIPI (SAN ANTONIO),1,25,12,13,2
OAXACA,20,SANTA MARÍA MIXTEQUILLA,421,LA CANTERA,1,14,8,6,2
OAXACA,20,SANTA MARÍA MIXTEQUILLA,421,NIZABIGUIDI,2,18,9,9,2
OAXACA,20,SANTA MARÍA MIXTEQUILLA,421,SANTA MARÍA MIXTEQUILLA,5,864,428,436,54
OAXACA,20,SANTA MARÍA NATIVITAS,422,SAN JOSÉ MONTE VERDE,4,64,32,32,11
OAXACA,20,SANTA MARÍA NATIVITAS,422,SAN PEDRO BUENAVISTA,3,530,256,274,31
OAXACA,20,SANTA MARÍA NATIVITAS,422,SANTA MARÍA NATIVITAS,2,27,12,15,7
OAXACA,20,SANTA MARÍA NDUAYACO,423,SAN JOSÉ DE GRACIA,2,7,3,4,1
OAXACA,20,SANTA MARÍA NDUAYACO,423,SANTA MARÍA NDUAYACO,2,21,8,13,4
OAXACA,20,SANTA MARÍA NDUAYACO,423,SANTO DOMINGO TICÚ,1,10,0,10,1
OAXACA,20,SANTA MARÍA OZOLOTEPEC,424,LLANO DEL MAÍZ,2,17,6,11,7
OAXACA,20,SANTA MARÍA OZOLOTEPEC,424,RÍO SAN CRISTÓBAL,2,20,5,15,2
OAXACA,20,SANTA MARÍA OZOLOTEPEC,424,SAN ESTEBAN OZOLOTEPEC,3,126,70,56,12
OAXACA,20,SANTA MARÍA OZOLOTEPEC,424,SAN GREGORIO OZOLOTEPEC,3,139,79,60,12
OAXACA,20,SANTA MARÍA OZOLOTEPEC,424,SAN MIGUEL OZOLOTEPEC,1,2,0,2,1
OAXACA,20,SANTA MARÍA OZOLOTEPEC,424,SAN PABLO OZOLOTEPEC,3,88,43,45,11
OAXACA,20,SANTA MARÍA OZOLOTEPEC,424,SANTA CRUZ OZOLOTEPEC,3,210,118,92,16
OAXACA,20,SANTA MARÍA OZOLOTEPEC,424,SANTA MARÍA OZOLOTEPEC,4,292,163,129,21
OAXACA,20,SANTA MARÍA PÁPALO,425,PEÑA VERDE,4,117,61,56,8
OAXACA,20,SANTA MARÍA PÁPALO,425,SANTA MARÍA PÁPALO,4,337,175,162,20
OAXACA,20,SANTA MARÍA PÁPALO,425,TEPONAPA,3,49,27,22,4
OAXACA,20,SANTA MARÍA PEÑOLES,426,BUENA VISTA ESTETLA,2,6,3,3,1
OAXACA,20,SANTA MARÍA PEÑOLES,426,CAÑADA DE ESPINA,3,29,14,15,3
OAXACA,20,SANTA MARÍA PEÑOLES,426,CAÑADA DE HIELO,2,86,39,47,5
OAXACA,20,SANTA MARÍA PEÑOLES,426,CERRO DE ÁGUILA TEPANTEPEC,1,14,6,8,1
OAXACA,20,SANTA MARÍA PEÑOLES,426,CORRAL DE PIEDRA,2,36,17,19,3
OAXACA,20,SANTA MARÍA PEÑOLES,426,DURAZNAL,3,94,36,58,5
OAXACA,20,SANTA MARÍA PEÑOLES,426,EL CARRIZAL,1,23,12,11,1
OAXACA,20,SANTA MARÍA PEÑOLES,426,EL CARRIZAL TEPANTEPEC,3,105,49,56,7
OAXACA,20,SANTA MARÍA PEÑOLES,426,EL MANZANITO,3,204,96,108,11
OAXACA,20,SANTA MARÍA PEÑOLES,426,LLANO VERDE,2,43,14,29,2
OAXACA,20,SANTA MARÍA PEÑOLES,426,LOS SABINOS,2,28,11,17,2
OAXACA,20,SANTA MARÍA PEÑOLES,426,PEÑA DE LETRA TEPANTEPEC,1,9,6,3,1
OAXACA,20,SANTA MARÍA PEÑOLES,426,RECIBIMIENTO,2,100,50,50,5
OAXACA,20,SANTA MARÍA PEÑOLES,426,RÍO CACHO,2,69,36,33,4
OAXACA,20,SANTA MARÍA PEÑOLES,426,RÍO CONTRERAS,2,54,31,23,3
OAXACA,20,SANTA MARÍA PEÑOLES,426,RÍO DE MANZANITA,2,49,25,24,3
OAXACA,20,SANTA MARÍA PEÑOLES,426,RÍO HONDO,1,16,6,10,1
OAXACA,20,SANTA MARÍA PEÑOLES,426,SAN ISIDRO BUENAVISTA,3,101,56,45,6
OAXACA,20,SANTA MARÍA PEÑOLES,426,SAN JOSÉ CONTRERAS,1,15,8,7,1
OAXACA,20,SANTA MARÍA PEÑOLES,426,SAN JUAN AYLLU TEPANTEPEC,2,81,40,41,4
OAXACA,20,SANTA MARÍA PEÑOLES,426,SAN MATEO TEPANTEPEC,5,300,157,143,20
OAXACA,20,SANTA MARÍA PEÑOLES,426,SAN PEDRO CHOLULA,2,29,15,14,2
OAXACA,20,SANTA MARÍA PEÑOLES,426,SANTA CATARINA ESTETLA,3,170,92,78,14
OAXACA,20,SANTA MARÍA PEÑOLES,426,SANTA MARÍA PEÑOLES,4,621,302,319,34
OAXACA,20,SANTA MARÍA PEÑOLES,426,TIERRA CALIENTE TEPANTEPEC,2,29,17,12,2
OAXACA,20,SANTA MARÍA PETAPA,427,BARREÑA,3,135,74,61,13
OAXACA,20,SANTA MARÍA PETAPA,427,BUENAVISTA,2,59,23,36,3
OAXACA,20,SANTA MARÍA PETAPA,427,EL PARAÍSO,3,68,29,39,10
OAXACA,20,SANTA MARÍA PETAPA,427,GUIVISÍA,4,289,162,127,17
OAXACA,20,SANTA MARÍA PETAPA,427,LA PAZ,2,59,28,31,4
OAXACA,20,SANTA MARÍA PETAPA,427,LA PRINCESA (EL POLVORÍN),2,24,13,11,2
OAXACA,20,SANTA MARÍA PETAPA,427,RINCÓN VIEJO,10,959,495,464,71
OAXACA,20,SANTA MARÍA PETAPA,427,SANTA MARÍA PETAPA,21,1924,1029,895,112
OAXACA,20,SANTA MARÍA PETAPA,427,SEPTUNE,2,41,21,20,9
OAXACA,20,SANTA MARÍA QUIEGOLANI,428,SAN ANDRÉS TLAHUILOTEPEC,2,43,23,20,9
OAXACA,20,SANTA MARÍA QUIEGOLANI,428,SAN JOSÉ QUIANITAS,2,101,57,44,8
OAXACA,20,SANTA MARÍA QUIEGOLANI,428,SANTA MARÍA QUIEGOLANI,4,288,152,136,19
OAXACA,20,SANTA MARÍA QUIEGOLANI,428,SANTIAGO QUIAVIGOLÓ,3,208,120,88,15
OAXACA,20,SANTA MARÍA SOLA,429,SANTA MARÍA SOLA,4,193,97,96,17
OAXACA,20,SANTA MARÍA SOLA,429,SANTA ROSA MATAGALLINAS,3,115,59,56,10
OAXACA,20,SANTA MARÍA SOLA,429,TEXCOCO,2,17,6,11,2
OAXACA,20,SANTA MARÍA TATALTEPEC,430,SANTA MARÍA TATALTEPEC,4,43,18,25,5
OAXACA,20,SANTA MARÍA TECOMAVACA,431,BUENA VISTA,1,31,19,12,2
OAXACA,20,SANTA MARÍA TECOMAVACA,431,SANTA MARÍA TECOMAVACA,5,411,212,199,43
OAXACA,20,SANTA MARÍA TEMAXCALAPA,432,SANTA MARÍA TEMAXCALAPA,5,205,95,110,18
OAXACA,20,SANTA MARÍA TEMAXCALTEPEC,433,CAÑADA DE GUADALUPE,3,180,90,90,10
OAXACA,20,SANTA MARÍA TEMAXCALTEPEC,433,LA SOLEDAD (LA ARENA),1,21,4,17,1
OAXACA,20,SANTA MARÍA TEMAXCALTEPEC,433,LAS DELICIAS,1,8,3,5,1
OAXACA,20,SANTA MARÍA TEMAXCALTEPEC,433,SAN JOSÉ PIE DEL CERRO,3,105,53,52,6
OAXACA,20,SANTA MARÍA TEMAXCALTEPEC,433,SANTA MARÍA TEMAXCALTEPEC,6,433,225,208,21
OAXACA,20,SANTA MARÍA TEOPOXCO,434,ALTAMIRA,1,19,9,10,1
OAXACA,20,SANTA MARÍA TEOPOXCO,434,BUENA VISTA,1,57,25,32,3
OAXACA,20,SANTA MARÍA TEOPOXCO,434,CINCO FLORES,1,16,8,8,1
OAXACA,20,SANTA MARÍA TEOPOXCO,434,LOS DURAZNOS,2,35,18,17,2
OAXACA,20,SANTA MARÍA TEOPOXCO,434,SAN JOSÉ CHIAPAS,2,60,35,25,4
OAXACA,20,SANTA MARÍA TEOPOXCO,434,SAN NICOLÁS,1,21,9,12,1
OAXACA,20,SANTA MARÍA TEOPOXCO,434,SANTA MARÍA TEOPOXCO,4,374,197,177,25
OAXACA,20,SANTA MARÍA TEOPOXCO,434,TECUANAPAM,3,108,52,56,7
OAXACA,20,SANTA MARÍA TEOPOXCO,434,TEPETITLÁN,3,118,55,63,8
OAXACA,20,SANTA MARÍA TEOPOXCO,434,VILLA NUEVA,4,309,172,137,18
OAXACA,20,SANTA MARÍA TEPANTLALI,435,CERRO CAMPANA,1,9,3,6,1
OAXACA,20,SANTA MARÍA TEPANTLALI,435,CERRO COSTOCHE,3,258,125,133,12
OAXACA,20,SANTA MARÍA TEPANTLALI,435,LLANO QUIOTAL,1,17,8,9,1
OAXACA,20,SANTA MARÍA TEPANTLALI,435,MOSQUITO BLANCO,3,189,93,96,11
OAXACA,20,SANTA MARÍA TEPANTLALI,435,ORILLA DEL MAR,2,31,16,15,2
OAXACA,20,SANTA MARÍA TEPANTLALI,435,SANTA MARÍA TEPANTLALI,4,376,181,195,17
OAXACA,20,SANTA MARÍA TEXCATITLÁN,436,SANTA MARÍA TEXCATITLÁN,4,255,122,133,14
OAXACA,20,SANTA MARÍA TLAHUITOLTEPEC,437,EL FRIJOL,2,49,23,26,3
OAXACA,20,SANTA MARÍA TLAHUITOLTEPEC,437,FLORES,4,186,90,96,12
OAXACA,20,SANTA MARÍA TLAHUITOLTEPEC,437,GUADALUPE VICTORIA,4,142,62,80,9
OAXACA,20,SANTA MARÍA TLAHUITOLTEPEC,437,LAGUNA,2,9,6,3,2
OAXACA,20,SANTA MARÍA TLAHUITOLTEPEC,437,MAGUEYAL,3,38,16,22,3
OAXACA,20,SANTA MARÍA TLAHUITOLTEPEC,437,METATE,2,25,11,14,2
OAXACA,20,SANTA MARÍA TLAHUITOLTEPEC,437,NEJAPA,3,90,50,40,7
OAXACA,20,SANTA MARÍA TLAHUITOLTEPEC,437,SANTA ANA NË'ÄM,2,63,33,30,4
OAXACA,20,SANTA MARÍA TLAHUITOLTEPEC,437,SANTA CRUZ,3,238,111,127,12
OAXACA,20,SANTA MARÍA TLAHUITOLTEPEC,437,SANTA MARÍA TLAHUITOLTEPEC,11,1345,689,656,93
OAXACA,20,SANTA MARÍA TLAHUITOLTEPEC,437,SANTA MARÍA YACOCHI,5,302,154,148,16
OAXACA,20,SANTA MARÍA TLAHUITOLTEPEC,437,TEJAS,4,199,91,108,11
OAXACA,20,SANTA MARÍA TLALIXTAC,438,EL PALMAR,3,40,19,21,10
OAXACA,20,SANTA MARÍA TLALIXTAC,438,PEÑA PRIETA,2,21,9,12,2
OAXACA,20,SANTA MARÍA TLALIXTAC,438,SANTA MARÍA TLALIXTAC,4,323,166,157,15
OAXACA,20,SANTA MARÍA TLALIXTAC,438,TIANGUISCO,3,10,4,6,2
OAXACA,20,SANTA MARÍA TLALIXTAC,438,TLALIXTAC VIEJO,3,137,78,59,11
OAXACA,20,SANTA MARÍA TONAMECA,439,AGOSTADERO,1,20,10,10,6
OAXACA,20,SANTA MARÍA TONAMECA,439,AGUA BLANCA,1,4,2,2,1
OAXACA,20,SANTA MARÍA TONAMECA,439,AGUA DULCE,1,25,15,10,1
OAXACA,20,SANTA MARÍA TONAMECA,439,ARROYO ARENA,1,15,6,9,1
OAXACA,20,SANTA MARÍA TONAMECA,439,ARROYO CHELIA,2,13,6,7,1
OAXACA,20,SANTA MARÍA TONAMECA,439,ARROYO TRES,2,76,29,47,4
OAXACA,20,SANTA MARÍA TONAMECA,439,BARRANCA HONDA,2,9,6,3,2
OAXACA,20,SANTA MARÍA TONAMECA,439,BARRIO DE LA CRUZ,1,36,20,16,2
OAXACA,20,SANTA MARÍA TONAMECA,439,CERRO GORDO,4,232,132,100,17
OAXACA,20,SANTA MARÍA TONAMECA,439,CERRO LA CRUZ,3,46,22,24,7
OAXACA,20,SANTA MARÍA TONAMECA,439,CHACAHUA,1,16,7,9,6
OAXACA,20,SANTA MARÍA TONAMECA,439,CHARCO DE AGUA,1,55,25,30,3
OAXACA,20,SANTA MARÍA TONAMECA,439,CUARTO,3,61,35,26,8
OAXACA,20,SANTA MARÍA TONAMECA,439,CUATODE,2,103,57,46,9
OAXACA,20,SANTA MARÍA TONAMECA,439,EL CARNERO,1,9,4,5,1
OAXACA,20,SANTA MARÍA TONAMECA,439,EL CHILAR,1,18,6,12,1
OAXACA,20,SANTA MARÍA TONAMECA,439,EL COCO,3,281,156,125,21
OAXACA,20,SANTA MARÍA TONAMECA,439,EL HUIZACHE,1,12,8,4,1
OAXACA,20,SANTA MARÍA TONAMECA,439,EL LIMÓN,1,22,8,14,1
OAXACA,20,SANTA MARÍA TONAMECA,439,EL MANANTIAL,2,14,8,6,2
OAXACA,20,SANTA MARÍA TONAMECA,439,EL MANZANO,2,13,8,5,2
OAXACA,20,SANTA MARÍA TONAMECA,439,EL NANCHAL (SAN JOSÉ EL NANCHAL),2,36,16,20,2
OAXACA,20,SANTA MARÍA TONAMECA,439,EL PARAÍSO,3,80,36,44,5
OAXACA,20,SANTA MARÍA TONAMECA,439,EL POPOYOTE,2,42,22,20,7
OAXACA,20,SANTA MARÍA TONAMECA,439,EL REGADILLO,2,31,11,20,3
OAXACA,20,SANTA MARÍA TONAMECA,439,EL SAMARITAN TONAMECA,1,16,6,10,1
OAXACA,20,SANTA MARÍA TONAMECA,439,EL TECOMATE,1,17,5,12,1
OAXACA,20,SANTA MARÍA TONAMECA,439,EL TIGRERO,2,83,36,47,4
OAXACA,20,SANTA MARÍA TONAMECA,439,EL TULE,2,15,7,8,2
OAXACA,20,SANTA MARÍA TONAMECA,439,EL VENADO,3,143,80,63,12
OAXACA,20,SANTA MARÍA TONAMECA,439,EL ZAPOTAL,2,42,20,22,6
OAXACA,20,SANTA MARÍA TONAMECA,439,ESCOBILLA,2,138,72,66,9
OAXACA,20,SANTA MARÍA TONAMECA,439,GUAPINOLE,1,35,18,17,6
OAXACA,20,SANTA MARÍA TONAMECA,439,JUANA BOQUITA,1,38,20,18,2
OAXACA,20,SANTA MARÍA TONAMECA,439,LA ANONA,1,20,8,12,1
OAXACA,20,SANTA MARÍA TONAMECA,439,LA BARRA DEL POTRERO,2,51,28,23,5
OAXACA,20,SANTA MARÍA TONAMECA,439,LA CRUCECITA,1,23,10,13,1
OAXACA,20,SANTA MARÍA TONAMECA,439,LA FLORIDA,2,9,5,4,1
OAXACA,20,SANTA MARÍA TONAMECA,439,LA LAGUNA DEL PALMAR,2,17,8,9,7
OAXACA,20,SANTA MARÍA TONAMECA,439,LA OSCURANA,2,30,12,18,2
OAXACA,20,SANTA MARÍA TONAMECA,439,LA REFORMA,1,8,4,4,1
OAXACA,20,SANTA MARÍA TONAMECA,439,LA RIVERA,2,57,22,35,5
OAXACA,20,SANTA MARÍA TONAMECA,439,LA SOLEDAD LOS GARCÍA,3,7,2,5,3
OAXACA,20,SANTA MARÍA TONAMECA,439,LA UNIÓN,1,5,3,2,1
OAXACA,20,SANTA MARÍA TONAMECA,439,LAS PILAS,3,20,11,9,2
OAXACA,20,SANTA MARÍA TONAMECA,439,LLANO GRANDE,2,107,55,52,8
OAXACA,20,SANTA MARÍA TONAMECA,439,LOS CIRUELOS,1,15,6,9,1
OAXACA,20,SANTA MARÍA TONAMECA,439,MACAHUITE,3,121,65,56,15
OAXACA,20,SANTA MARÍA TONAMECA,439,MAZUNTE,3,224,116,108,14
OAXACA,20,SANTA MARÍA TONAMECA,439,PALMA LARGA,2,141,68,73,7
OAXACA,20,SANTA MARÍA TONAMECA,439,PASO LAS GARZAS,2,35,13,22,3
OAXACA,20,SANTA MARÍA TONAMECA,439,PASO OCOTE,2,60,30,30,4
OAXACA,20,SANTA MARÍA TONAMECA,439,PASO ZANATE,2,32,18,14,2
OAXACA,20,SANTA MARÍA TONAMECA,439,PIEDRA ANCHA,2,23,12,11,2
OAXACA,20,SANTA MARÍA TONAMECA,439,PIEDRA SEPULTURA MIRAMAR,1,37,22,15,2
OAXACA,20,SANTA MARÍA TONAMECA,439,PUEBLO VIEJO,2,75,35,40,4
OAXACA,20,SANTA MARÍA TONAMECA,439,RINCÓN BONITO,2,71,30,41,6
OAXACA,20,SANTA MARÍA TONAMECA,439,SAN AGUSTINILLO,2,39,19,20,9
OAXACA,20,SANTA MARÍA TONAMECA,439,SAN ANTONIO,2,112,64,48,9
OAXACA,20,SANTA MARÍA TONAMECA,439,SAN BERNARDINO,3,175,89,86,10
OAXACA,20,SANTA MARÍA TONAMECA,439,SAN FRANCISCO COZOALTEPEC,9,1030,536,494,54
OAXACA,20,SANTA MARÍA TONAMECA,439,SAN ISIDRO (INFIERNILLO),2,52,27,25,3
OAXACA,20,SANTA MARÍA TONAMECA,439,SAN ISIDRO DEL PALMAR,4,301,163,138,23
OAXACA,20,SANTA MARÍA TONAMECA,439,SAN JUAN PIEDRAS NEGRAS,2,43,23,20,8
OAXACA,20,SANTA MARÍA TONAMECA,439,SAN JUANITO O LA BOTIJA,4,252,126,126,13
OAXACA,20,SANTA MARÍA TONAMECA,439,SAN MARTÍN,2,21,9,12,2
OAXACA,20,SANTA MARÍA TONAMECA,439,SANTA ELENA EL TULE,4,655,338,317,42
OAXACA,20,SANTA MARÍA TONAMECA,439,SANTA MARÍA TONAMECA,8,1016,552,464,73
OAXACA,20,SANTA MARÍA TONAMECA,439,SOLUCHE,2,49,27,22,3
OAXACA,20,SANTA MARÍA TONAMECA,439,SOLUTA,3,25,13,12,3
OAXACA,20,SANTA MARÍA TONAMECA,439,TIERRA NUEVA,1,7,4,3,1
OAXACA,20,SANTA MARÍA TONAMECA,439,TILZAPOTE,2,28,14,14,5
OAXACA,20,SANTA MARÍA TONAMECA,439,VALDEFLORES,3,165,77,88,11
OAXACA,20,SANTA MARÍA TONAMECA,439,VILLA NUEVA,2,18,8,10,2
OAXACA,20,SANTA MARÍA TONAMECA,439,VILLA UNIÓN,1,6,4,2,1
OAXACA,20,SANTA MARÍA TONAMECA,439,YERBA SANTA,2,59,29,30,3
OAXACA,20,SANTA MARÍA TONAMECA,439,YONGUINA,1,23,12,11,1
OAXACA,20,SANTA MARÍA TOTOLAPILLA,440,SANTA MARÍA TOTOLAPILLA,5,199,97,102,16
OAXACA,20,SANTA MARÍA XADANI,441,SANTA MARÍA XADANI,17,2567,1325,1242,127
OAXACA,20,SANTA MARÍA YALINA,442,SANTA MARÍA YALINA,2,39,21,18,3
OAXACA,20,SANTA MARÍA YAVESÍA,443,SANTA MARÍA YAVESÍA,3,70,32,38,5
OAXACA,20,SANTA MARÍA YOLOTEPEC,444,CERRO NEGRO,3,53,30,23,4
OAXACA,20,SANTA MARÍA YOLOTEPEC,444,SANTA MARÍA YOLOTEPEC,5,146,78,68,11
OAXACA,20,SANTA MARÍA YOSOYÚA,445,BUENAVISTA,4,124,67,57,9
OAXACA,20,SANTA MARÍA YOSOYÚA,445,GUADALUPE YOSOYÚA,4,107,57,50,9
OAXACA,20,SANTA MARÍA YOSOYÚA,445,SANTA CRUZ,3,61,28,33,4
OAXACA,20,SANTA MARÍA YOSOYÚA,445,SANTA MARÍA YOSOYÚA,5,152,73,79,11
OAXACA,20,SANTA MARÍA YUCUHITI,446,GUADALUPE BUENAVISTA,4,219,102,117,22
OAXACA,20,SANTA MARÍA YUCUHITI,446,LA SOLEDAD CABALLO RUCIO,3,81,38,43,5
OAXACA,20,SANTA MARÍA YUCUHITI,446,MIRAMAR,4,225,123,102,15
OAXACA,20,SANTA MARÍA YUCUHITI,446,REYES LLANO GRANDE,3,134,74,60,9
OAXACA,20,SANTA MARÍA YUCUHITI,446,SAN FELIPE DE JESÚS PUEBLO VIEJO,4,191,94,97,14
OAXACA,20,SANTA MARÍA YUCUHITI,446,SAN ISIDRO PAZ Y PROGRESO,3,120,65,55,8
OAXACA,20,SANTA MARÍA YUCUHITI,446,SANTA MARÍA YUCUHITI,5,203,98,105,11
OAXACA,20,SANTA MARÍA YUCUHITI,446,YOSONICAJE,5,152,77,75,10
OAXACA,20,SANTA MARÍA YUCUHITI,446,YUTEYUBI,1,15,7,8,1
OAXACA,20,SANTA MARÍA YUCUHITI,446,ZARAGOZA,4,124,61,63,9
OAXACA,20,SANTA MARÍA ZACATEPEC,447,AQUILES SERDÁN,4,343,202,141,20
OAXACA,20,SANTA MARÍA ZACATEPEC,447,COYUL GRANDE,3,75,39,36,15
OAXACA,20,SANTA MARÍA ZACATEPEC,447,EL COYULITO,3,78,40,38,12
OAXACA,20,SANTA MARÍA ZACATEPEC,447,EL CUETE,2,45,24,21,9
OAXACA,20,SANTA MARÍA ZACATEPEC,447,EL ROSARIO,3,134,77,57,12
OAXACA,20,SANTA MARÍA ZACATEPEC,447,EL TAPANCO,3,165,94,71,12
OAXACA,20,SANTA MARÍA ZACATEPEC,447,GUADALUPE,4,98,53,45,17
OAXACA,20,SANTA MARÍA ZACATEPEC,447,GUADALUPE NUEVO CENTRO,2,39,21,18,6
OAXACA,20,SANTA MARÍA ZACATEPEC,447,LA CULEBRA,3,123,59,64,10
OAXACA,20,SANTA MARÍA ZACATEPEC,447,LA VIRGEN,2,35,22,13,7
OAXACA,20,SANTA MARÍA ZACATEPEC,447,LAS PALMAS,2,10,4,6,2
OAXACA,20,SANTA MARÍA ZACATEPEC,447,LLANO CHAPULTEPEC,2,37,19,18,9
OAXACA,20,SANTA MARÍA ZACATEPEC,447,RANCHO SAN PEDRO,2,25,11,14,9
OAXACA,20,SANTA MARÍA ZACATEPEC,447,SAN ANTONIO ZARAGOZA,3,74,40,34,12
OAXACA,20,SANTA MARÍA ZACATEPEC,447,SAN FELIPE ATOTONILCO,3,131,75,56,12
OAXACA,20,SANTA MARÍA ZACATEPEC,447,SAN ISIDRO AMATITLÁN,3,85,45,40,12
OAXACA,20,SANTA MARÍA ZACATEPEC,447,SAN JUAN CABEZA DEL RÍO,4,386,223,163,25
OAXACA,20,SANTA MARÍA ZACATEPEC,447,SAN JUAN VIEJO,2,35,17,18,9
OAXACA,20,SANTA MARÍA ZACATEPEC,447,SAN MARCOS NEJAPA,2,44,24,20,9
OAXACA,20,SANTA MARÍA ZACATEPEC,447,SAN MIGUEL,1,4,1,3,1
OAXACA,20,SANTA MARÍA ZACATEPEC,447,SAN VICENTE PIÑAS,3,226,117,109,17
OAXACA,20,SANTA MARÍA ZACATEPEC,447,SANTA CRUZ DE RUFINO TAMAYO,1,18,8,10,6
OAXACA,20,SANTA MARÍA ZACATEPEC,447,SANTA CRUZ TUTIAHUA,3,128,74,54,12
OAXACA,20,SANTA MARÍA ZACATEPEC,447,SANTA MARÍA ZACATEPEC,14,1904,1053,851,114
OAXACA,20,SANTA MARÍA ZACATEPEC,447,SANTIAGO LLANO GRANDE,3,202,118,84,14
OAXACA,20,SANTA MARÍA ZANIZA,448,ATOTONILCO,2,18,10,8,2
OAXACA,20,SANTA MARÍA ZANIZA,448,SAN RAMÓN,1,7,5,2,1
OAXACA,20,SANTA MARÍA ZANIZA,448,SANTA MARÍA ZANIZA,4,828,467,361,40
OAXACA,20,SANTA MARÍA ZOQUITLÁN,449,AGUA DEL GUAJE,2,15,8,7,3
OAXACA,20,SANTA MARÍA ZOQUITLÁN,449,BUENA VISTA,1,2,1,1,1
OAXACA,20,SANTA MARÍA ZOQUITLÁN,449,CANDELARIA YEGOLÉ,3,26,11,15,9
OAXACA,20,SANTA MARÍA ZOQUITLÁN,449,CAÑADA GUICHÁ,2,11,4,7,2
OAXACA,20,SANTA MARÍA ZOQUITLÁN,449,EL RÍO CABRITO,1,5,2,3,1
OAXACA,20,SANTA MARÍA ZOQUITLÁN,449,EORAGUÍA,1,4,0,4,1
OAXACA,20,SANTA MARÍA ZOQUITLÁN,449,LA CHIVIGUU,1,4,2,2,1
OAXACA,20,SANTA MARÍA ZOQUITLÁN,449,LAS CASAS,3,44,25,19,8
OAXACA,20,SANTA MARÍA ZOQUITLÁN,449,RÍO POTRERO,3,72,35,37,9
OAXACA,20,SANTA MARÍA ZOQUITLÁN,449,RÍO SECO,3,104,55,49,11
OAXACA,20,SANTA MARÍA ZOQUITLÁN,449,SANTA MARÍA ZOQUITLÁN,4,463,252,211,24
OAXACA,20,SANTIAGO AMOLTEPEC,450,BARRANCA COCIDA,2,85,48,37,4
OAXACA,20,SANTIAGO AMOLTEPEC,450,BARRANCA HONDA,2,34,15,19,3
OAXACA,20,SANTIAGO AMOLTEPEC,450,BARRANCA NUEVA,2,24,12,12,3
OAXACA,20,SANTIAGO AMOLTEPEC,450,BARRANCA OBSCURA,2,120,50,70,5
OAXACA,20,SANTIAGO AMOLTEPEC,450,BARRANCA RICA,2,69,35,34,4
OAXACA,20,SANTIAGO AMOLTEPEC,450,COLONIA DE JESÚS (LA CUCARACHA),2,152,68,84,5
OAXACA,20,SANTIAGO AMOLTEPEC,450,EL AGUACATE,2,11,3,8,2
OAXACA,20,SANTIAGO AMOLTEPEC,450,EL COCAL,3,287,141,146,10
OAXACA,20,SANTIAGO AMOLTEPEC,450,EL HUAMÚCHIL,3,108,49,59,3
OAXACA,20,SANTIAGO AMOLTEPEC,450,EL LAUREL,2,82,36,46,3
OAXACA,20,SANTIAGO AMOLTEPEC,450,EL LIMONCILLO,2,69,35,34,3
OAXACA,20,SANTIAGO AMOLTEPEC,450,EL MAMEY,5,288,153,135,20
OAXACA,20,SANTIAGO AMOLTEPEC,450,EL NARANJO,3,32,16,16,4
OAXACA,20,SANTIAGO AMOLTEPEC,450,EL PLATANAR,2,20,11,9,2
OAXACA,20,SANTIAGO AMOLTEPEC,450,LA COFRADÍA,2,47,27,20,7
OAXACA,20,SANTIAGO AMOLTEPEC,450,LA INDEPENDENCIA,2,81,33,48,3
OAXACA,20,SANTIAGO AMOLTEPEC,450,LA MESILLA,3,145,72,73,7
OAXACA,20,SANTIAGO AMOLTEPEC,450,LA SOLEDAD,2,65,35,30,3
OAXACA,20,SANTIAGO AMOLTEPEC,450,LAS CUEVAS,4,261,137,124,17
OAXACA,20,SANTIAGO AMOLTEPEC,450,LLANO METATE,2,30,9,21,2
OAXACA,20,SANTIAGO AMOLTEPEC,450,LLANO NUEVO,3,235,109,126,11
OAXACA,20,SANTIAGO AMOLTEPEC,450,LLANO TIGRE,2,82,44,38,5
OAXACA,20,SANTIAGO AMOLTEPEC,450,LLANO VERDE,2,14,8,6,2
OAXACA,20,SANTIAGO AMOLTEPEC,450,PIEDRA DEL TAMBOR,3,391,204,187,15
OAXACA,20,SANTIAGO AMOLTEPEC,450,PIEDRA LIZA,2,42,25,17,2
OAXACA,20,SANTIAGO AMOLTEPEC,450,PUEBLO VIEJO,3,167,89,78,9
OAXACA,20,SANTIAGO AMOLTEPEC,450,RÍO CIRUELO,3,140,77,63,11
OAXACA,20,SANTIAGO AMOLTEPEC,450,SAN ANTONIO,2,24,14,10,3
OAXACA,20,SANTIAGO AMOLTEPEC,450,SAN ISIDRO,2,62,27,35,3
OAXACA,20,SANTIAGO AMOLTEPEC,450,SAN JOSÉ DE LAS FLORES,2,84,41,43,3
OAXACA,20,SANTIAGO AMOLTEPEC,450,SAN LORENZO EL ZAPOTE,2,68,27,41,3
OAXACA,20,SANTIAGO AMOLTEPEC,450,SAN MIGUEL RÍO VERDE (LA TORTUGA),3,19,10,9,2
OAXACA,20,SANTIAGO AMOLTEPEC,450,SANTIAGO AMOLTEPEC,6,634,327,307,31
OAXACA,20,SANTIAGO AMOLTEPEC,450,TIERRA COLORADA,2,34,20,14,2
OAXACA,20,SANTIAGO AMOLTEPEC,450,UNIÓN LINDA VISTA,2,55,27,28,3
OAXACA,20,SANTIAGO APOALA,451,JAZMÍN MORELOS,3,54,24,30,3
OAXACA,20,SANTIAGO APOALA,451,SAN ANTONIO NDUAYACO,3,48,25,23,8
OAXACA,20,SANTIAGO APOALA,451,SANTIAGO APOALA,3,49,31,18,6
OAXACA,20,SANTIAGO APOALA,451,TIERRA COLORADA,1,7,1,6,1
OAXACA,20,SANTIAGO APOALA,451,UNIÓN BUENA VISTA (YODOCANIT O YODOCANI),1,19,9,10,1
OAXACA,20,SANTIAGO APÓSTOL,452,SAN SEBASTIÁN OCOTLÁN,2,72,35,37,7
OAXACA,20,SANTIAGO APÓSTOL,452,SANTIAGO APÓSTOL,4,476,256,220,27
OAXACA,20,SANTIAGO ASTATA,453,BARRA DE LA CRUZ,3,119,64,55,10
OAXACA,20,SANTIAGO ASTATA,453,SANTIAGO ASTATA,8,798,416,382,75
OAXACA,20,SANTIAGO ASTATA,453,ZAACHILAC,2,58,31,27,6
OAXACA,20,SANTIAGO ASTATA,453,ZIMATÁN,3,90,46,44,10
OAXACA,20,SANTIAGO ATITLÁN,454,EL POTRERO,2,29,14,15,2
OAXACA,20,SANTIAGO ATITLÁN,454,EL RODEO,4,221,112,109,13
OAXACA,20,SANTIAGO ATITLÁN,454,ESTANCIA DE MORELOS,5,207,111,96,16
OAXACA,20,SANTIAGO ATITLÁN,454,SAN SEBASTIÁN ATITLÁN,3,38,15,23,3
OAXACA,20,SANTIAGO ATITLÁN,454,SANTIAGO ATITLÁN,5,258,129,129,15
OAXACA,20,SANTIAGO AYUQUILILLA,455,GUADALUPE DE BENITO JUÁREZ,1,11,5,6,5
OAXACA,20,SANTIAGO AYUQUILILLA,455,MOGOTE COLORADO (SAN ISIDRO),1,36,21,15,3
OAXACA,20,SANTIAGO AYUQUILILLA,455,SANTA CATARINA ESTANCIA,3,186,106,80,13
OAXACA,20,SANTIAGO AYUQUILILLA,455,SANTIAGO AYUQUILILLA,4,444,255,189,25
OAXACA,20,SANTIAGO CACALOXTEPEC,456,CORRAL DE PIEDRA,3,191,111,80,13
OAXACA,20,SANTIAGO CACALOXTEPEC,456,SANTIAGO CACALOXTEPEC,3,134,70,64,11
OAXACA,20,SANTIAGO CAMOTLÁN,457,ARROYO MACHO,1,15,8,7,1
OAXACA,20,SANTIAGO CAMOTLÁN,457,ASUNCIÓN LACHIXILA,3,91,57,34,6
OAXACA,20,SANTIAGO CAMOTLÁN,457,CRISTO REY LA SELVA,1,15,12,3,1
OAXACA,20,SANTIAGO CAMOTLÁN,457,LA CHACHALACA,2,61,23,38,3
OAXACA,20,SANTIAGO CAMOTLÁN,457,SAN FRANCISCO YOVEGO,4,166,89,77,12
OAXACA,20,SANTIAGO CAMOTLÁN,457,SAN MATEO ÉXODO,1,11,5,6,1
OAXACA,20,SANTIAGO CAMOTLÁN,457,SAN MIGUEL REAGUÍ,4,169,81,88,10
OAXACA,20,SANTIAGO CAMOTLÁN,457,SANTIAGO CAMOTLÁN,4,190,105,85,15
OAXACA,20,SANTIAGO COMALTEPEC,458,LA ESPERANZA,3,35,18,17,9
OAXACA,20,SANTIAGO COMALTEPEC,458,SAN MARTÍN ZOYOLÁPAM,2,24,12,12,2
OAXACA,20,SANTIAGO COMALTEPEC,458,SANTIAGO COMALTEPEC,4,268,134,134,20
OAXACA,20,SANTIAGO COMALTEPEC,458,SOLEDAD TECTITLÁN,2,24,13,11,6
OAXACA,20,VILLA DE SANTIAGO CHAZUMBA,459,ACAQUIZÁPAM,2,17,11,6,3
OAXACA,20,VILLA DE SANTIAGO CHAZUMBA,459,BARRIO SANTA LUCÍA,1,8,3,5,1
OAXACA,20,VILLA DE SANTIAGO CHAZUMBA,459,LUNATITLÁN DEL PROGRESO,2,18,5,13,2
OAXACA,20,VILLA DE SANTIAGO CHAZUMBA,459,MANINALTEPEC,1,26,13,13,6
OAXACA,20,VILLA DE SANTIAGO CHAZUMBA,459,OLLERAS DE BUSTAMANTE,3,37,21,16,9
OAXACA,20,VILLA DE SANTIAGO CHAZUMBA,459,RÍO LIMÓN (SAN ISIDRO RÍO LIMÓN),1,5,2,3,1
OAXACA,20,VILLA DE SANTIAGO CHAZUMBA,459,SAN JOSÉ CHICHIHUALTEPEC,3,22,14,8,4
OAXACA,20,VILLA DE SANTIAGO CHAZUMBA,459,SAN JUAN NOCHIXTLÁN,2,22,9,13,5
OAXACA,20,VILLA DE SANTIAGO CHAZUMBA,459,SAN SEBASTIÁN DE LA FRONTERA,2,14,5,9,3
OAXACA,20,VILLA DE SANTIAGO CHAZUMBA,459,SANTO DOMINGO TIANGUISTENGO,3,42,24,18,7
OAXACA,20,VILLA DE SANTIAGO CHAZUMBA,459,TRINIDAD HUAXTEPEC,1,4,1,3,1
OAXACA,20,VILLA DE SANTIAGO CHAZUMBA,459,VILLA DE SANTIAGO CHAZUMBA,4,814,401,413,39
OAXACA,20,SANTIAGO CHOÁPAM,460,ARROYO BLANCO,1,6,1,5,1
OAXACA,20,SANTIAGO CHOÁPAM,460,ARROYO CHANCARRO,2,12,3,9,1
OAXACA,20,SANTIAGO CHOÁPAM,460,LA CARMELITA,1,11,8,3,2
OAXACA,20,SANTIAGO CHOÁPAM,460,SAN JACINTO YAVELOXI,2,72,40,32,6
OAXACA,20,SANTIAGO CHOÁPAM,460,SAN JUAN DEL RÍO,4,269,130,139,15
OAXACA,20,SANTIAGO CHOÁPAM,460,SAN JUAN MANINALTEPEC,3,33,15,18,3
OAXACA,20,SANTIAGO CHOÁPAM,460,SAN JUAN TEOTALCINGO,3,263,132,131,15
OAXACA,20,SANTIAGO CHOÁPAM,460,SANTA MARÍA YAHUIVÉ,3,204,111,93,13
OAXACA,20,SANTIAGO CHOÁPAM,460,SANTIAGO CHOÁPAM,4,259,137,122,23
OAXACA,20,SANTIAGO CHOÁPAM,460,SANTO DOMINGO LATANI,3,117,60,57,8
OAXACA,20,SANTIAGO DEL RÍO,461,SAN FRANCISCO HIGOS,1,30,13,17,2
OAXACA,20,SANTIAGO DEL RÍO,461,SANTIAGO DEL RÍO,3,89,42,47,9
OAXACA,20,SANTIAGO HUAJOLOTITLÁN,462,EL ESPINAL,2,34,16,18,9
OAXACA,20,SANTIAGO HUAJOLOTITLÁN,462,EL ZAPOTE,3,69,38,31,12
OAXACA,20,SANTIAGO HUAJOLOTITLÁN,462,GUADALUPE DE CÁRDENAS,2,62,33,29,9
OAXACA,20,SANTIAGO HUAJOLOTITLÁN,462,LÁZARO CÁRDENAS,2,16,6,10,8
OAXACA,20,SANTIAGO HUAJOLOTITLÁN,462,PALO DE FLOR,2,12,9,3,2
OAXACA,20,SANTIAGO HUAJOLOTITLÁN,462,SAN FRANCISCO EL CHICO,2,29,15,14,7
OAXACA,20,SANTIAGO HUAJOLOTITLÁN,462,SAN FRANCISCO EL GRANDE,3,57,30,27,8
OAXACA,20,SANTIAGO HUAJOLOTITLÁN,462,SANTIAGO HUAJOLOTITLÁN,8,1485,794,691,178
OAXACA,20,SANTIAGO HUAUCLILLA,463,SANTIAGO HUAUCLILLA,3,59,23,36,4
OAXACA,20,SANTIAGO HUAUCLILLA,463,SANTIAGO IXTLAHUACA,2,7,2,5,2
OAXACA,20,SANTIAGO IHUITLÁN PLUMAS,464,LA MEXICANA,2,8,5,3,2
OAXACA,20,SANTIAGO IHUITLÁN PLUMAS,464,SAN ANTONIO ABAD,1,10,6,4,1
OAXACA,20,SANTIAGO IHUITLÁN PLUMAS,464,SANTIAGO IHUITLÁN PLUMAS,3,102,48,54,11
OAXACA,20,SANTIAGO IXCUINTEPEC,465,SANTIAGO IXCUINTEPEC,4,423,246,177,29
OAXACA,20,SANTIAGO IXTAYUTLA,466,BUENAVISTA,3,104,59,45,12
OAXACA,20,SANTIAGO IXTAYUTLA,466,CORRAL DE PIEDRA,3,63,36,27,6
OAXACA,20,SANTIAGO IXTAYUTLA,466,EL CARASOL,3,234,119,115,11
OAXACA,20,SANTIAGO IXTAYUTLA,466,EL DURAZNAL,2,3,2,1,1
OAXACA,20,SANTIAGO IXTAYUTLA,466,EL FRUTILLO,4,168,81,87,10
OAXACA,20,SANTIAGO IXTAYUTLA,466,EL HUAMUCHE,3,208,109,99,12
OAXACA,20,SANTIAGO IXTAYUTLA,466,EL MOSCO,3,214,107,107,9
OAXACA,20,SANTIAGO IXTAYUTLA,466,EL NARANJO,2,16,9,7,2
OAXACA,20,SANTIAGO IXTAYUTLA,466,EL OCOTE,2,51,26,25,3
OAXACA,20,SANTIAGO IXTAYUTLA,466,EL TETLATE,3,25,11,14,2
OAXACA,20,SANTIAGO IXTAYUTLA,466,LA CUCHARA,2,77,40,37,4
OAXACA,20,SANTIAGO IXTAYUTLA,466,LA HUMEDAD,2,348,183,165,15
OAXACA,20,SANTIAGO IXTAYUTLA,466,LA MURALLA,3,120,62,58,13
OAXACA,20,SANTIAGO IXTAYUTLA,466,LAS LIMAS,2,9,4,5,2
OAXACA,20,SANTIAGO IXTAYUTLA,466,LAS TROJES,3,72,20,52,4
OAXACA,20,SANTIAGO IXTAYUTLA,466,LLANO ESCONDIDO,1,47,22,25,2
OAXACA,20,SANTIAGO IXTAYUTLA,466,LLANO VERDE,2,138,66,72,7
OAXACA,20,SANTIAGO IXTAYUTLA,466,MACAHUITE,3,22,10,12,2
OAXACA,20,SANTIAGO IXTAYUTLA,466,PUEBLO VIEJO,3,210,108,102,11
OAXACA,20,SANTIAGO IXTAYUTLA,466,SAN LUCAS ATOYAQUILLO,3,54,29,25,3
OAXACA,20,SANTIAGO IXTAYUTLA,466,SANTIAGO IXTAYUTLA,4,796,390,406,47
OAXACA,20,SANTIAGO IXTAYUTLA,466,TIERRA BLANCA,3,14,9,5,3
OAXACA,20,SANTIAGO IXTAYUTLA,466,TIERRA COLORADA,1,37,17,20,2
OAXACA,20,SANTIAGO IXTAYUTLA,466,VILLA NUEVA,4,110,49,61,10
OAXACA,20,SANTIAGO IXTAYUTLA,466,XINIYUBA,2,291,146,145,12
OAXACA,20,SANTIAGO IXTAYUTLA,466,YUCUYÁ,2,96,49,47,4
OAXACA,20,SANTIAGO JAMILTEPEC,467,ATOTONILQUILLO,2,15,6,9,5
OAXACA,20,SANTIAGO JAMILTEPEC,467,CHARCO NDUAYOO,2,113,63,50,9
OAXACA,20,SANTIAGO JAMILTEPEC,467,CUYUCHE,2,112,55,57,9
OAXACA,20,SANTIAGO JAMILTEPEC,467,EL GUAYABO,2,30,16,14,7
OAXACA,20,SANTIAGO JAMILTEPEC,467,EL SANTO,2,59,32,27,9
OAXACA,20,SANTIAGO JAMILTEPEC,467,EL ZARZAL,1,15,7,8,1
OAXACA,20,SANTIAGO JAMILTEPEC,467,EMILIANO ZAPATA (CHIAPAS),2,27,12,15,9
OAXACA,20,SANTIAGO JAMILTEPEC,467,FINCA LA NATIVIDAD,2,13,5,8,2
OAXACA,20,SANTIAGO JAMILTEPEC,467,LA ESPERANZA,1,9,4,5,3
OAXACA,20,SANTIAGO JAMILTEPEC,467,LA HUICHICATA,1,6,1,5,1
OAXACA,20,SANTIAGO JAMILTEPEC,467,LA HUMEDAD,2,28,13,15,9
OAXACA,20,SANTIAGO JAMILTEPEC,467,LA TUZA,3,66,37,29,6
OAXACA,20,SANTIAGO JAMILTEPEC,467,PASO DE LA REINA,3,89,49,40,12
OAXACA,20,SANTIAGO JAMILTEPEC,467,PATRIA NUEVA,3,207,107,100,14
OAXACA,20,SANTIAGO JAMILTEPEC,467,PIEDRA ANCHA,3,103,58,45,12
OAXACA,20,SANTIAGO JAMILTEPEC,467,PIEDRA BLANCA,2,15,11,4,2
OAXACA,20,SANTIAGO JAMILTEPEC,467,RÍO VIEJO,2,70,39,31,9
OAXACA,20,SANTIAGO JAMILTEPEC,467,SAN JOSÉ DE LAS FLORES,4,403,223,180,25
OAXACA,20,SANTIAGO JAMILTEPEC,467,SAN JOSÉ RÍO VERDE (LA BOQUILLA),4,244,119,125,21
OAXACA,20,SANTIAGO JAMILTEPEC,467,SAN MIGUEL DE LOS PINOS,1,7,3,4,4
OAXACA,20,SANTIAGO JAMILTEPEC,467,SANTA CRUZ FLORES MAGÓN,3,87,47,40,11
OAXACA,20,SANTIAGO JAMILTEPEC,467,SANTA ELENA COMALTEPEC,3,203,100,103,14
OAXACA,20,SANTIAGO JAMILTEPEC,467,SANTIAGO JAMILTEPEC,26,2644,1392,1252,202
OAXACA,20,SANTIAGO JAMILTEPEC,467,UNIÓN LINDA VISTA,2,34,20,14,4
OAXACA,20,SANTIAGO JOCOTEPEC,468,ARROYO BOBO,3,160,81,79,11
OAXACA,20,SANTIAGO JOCOTEPEC,468,ARROYO TINTA,2,35,20,15,4
OAXACA,20,SANTIAGO JOCOTEPEC,468,CERRO CALIENTE,3,79,38,41,5
OAXACA,20,SANTIAGO JOCOTEPEC,468,EL OJO DE AGUA,2,10,8,2,1
OAXACA,20,SANTIAGO JOCOTEPEC,468,EL PORVENIR,1,20,8,12,2
OAXACA,20,SANTIAGO JOCOTEPEC,468,LA ALICIA,4,254,130,124,13
OAXACA,20,SANTIAGO JOCOTEPEC,468,LA ESPERANZA,4,100,46,54,9
OAXACA,20,SANTIAGO JOCOTEPEC,468,LA ISLA,1,12,9,3,1
OAXACA,20,SANTIAGO JOCOTEPEC,468,LINDA VISTA,2,31,14,17,2
OAXACA,20,SANTIAGO JOCOTEPEC,468,LUIS ECHEVERRÍA,3,86,40,46,5
OAXACA,20,SANTIAGO JOCOTEPEC,468,MONTE NEGRO,4,521,261,260,25
OAXACA,20,SANTIAGO JOCOTEPEC,468,PASO DE SAN JACOBO,3,190,92,98,12
OAXACA,20,SANTIAGO JOCOTEPEC,468,PLAN DE SAN LUIS,3,78,37,41,5
OAXACA,20,SANTIAGO JOCOTEPEC,468,PLAN MARTÍN CHINO,3,100,49,51,8
OAXACA,20,SANTIAGO JOCOTEPEC,468,PLAN MATA DE CAÑA,2,45,23,22,3
OAXACA,20,SANTIAGO JOCOTEPEC,468,PLAYA LIMÓN,3,99,59,40,7
OAXACA,20,SANTIAGO JOCOTEPEC,468,RANCHO PALMAR,3,31,17,14,4
OAXACA,20,SANTIAGO JOCOTEPEC,468,RÍO CHIQUITO,3,504,264,240,25
OAXACA,20,SANTIAGO JOCOTEPEC,468,SAN ANTONIO LAS PALMAS,3,398,207,191,23
OAXACA,20,SANTIAGO JOCOTEPEC,468,SAN JOSÉ RÍO MANSO (NUEVO RÍO MANSO),2,13,9,4,2
OAXACA,20,SANTIAGO JOCOTEPEC,468,SAN MIGUEL ECATEPEC,1,4,3,1,1
OAXACA,20,SANTIAGO JOCOTEPEC,468,SAN MIGUEL LACHIXOLA,4,413,227,186,27
OAXACA,20,SANTIAGO JOCOTEPEC,468,SAN PEDRO TEPINAPA,3,126,66,60,8
OAXACA,20,SANTIAGO JOCOTEPEC,468,SAN PEDRO TEPINAPA COMUNAL,2,46,26,20,3
OAXACA,20,SANTIAGO JOCOTEPEC,468,SAN VICENTE ARROYO JABALÍ,2,74,37,37,4
OAXACA,20,SANTIAGO JOCOTEPEC,468,SANTIAGO JOCOTEPEC,4,217,103,114,14
OAXACA,20,SANTIAGO JOCOTEPEC,468,SOLEDAD VISTA HERMOSA,2,18,13,5,2
OAXACA,20,SANTIAGO JUXTLAHUACA,469,AGUA FRÍA,2,45,25,20,5
OAXACA,20,SANTIAGO JUXTLAHUACA,469,AGUA FRÍA COPALA,2,60,31,29,9
OAXACA,20,SANTIAGO JUXTLAHUACA,469,BARRIO VISTA HERMOSA,2,49,34,15,3
OAXACA,20,SANTIAGO JUXTLAHUACA,469,BENITO JUÁREZ YUCUNICOCO,2,61,32,29,4
OAXACA,20,SANTIAGO JUXTLAHUACA,469,CERRO CABEZA,2,87,47,40,9
OAXACA,20,SANTIAGO JUXTLAHUACA,469,CERRO DEL PÁJARO,3,127,67,60,12
OAXACA,20,SANTIAGO JUXTLAHUACA,469,CERRO VIEJO (PINO SUÁREZ),1,25,12,13,6
OAXACA,20,SANTIAGO JUXTLAHUACA,469,CIENEGUILLA,1,9,3,6,1
OAXACA,20,SANTIAGO JUXTLAHUACA,469,COLONIA SANTA CECILIA ITAYUYU,2,82,38,44,2
OAXACA,20,SANTIAGO JUXTLAHUACA,469,CONCEPCIÓN CARRIZAL,3,219,126,93,17
OAXACA,20,SANTIAGO JUXTLAHUACA,469,COYUCHI,2,139,79,60,9
OAXACA,20,SANTIAGO JUXTLAHUACA,469,CRUZ CHIQUITA,3,86,46,40,12
OAXACA,20,SANTIAGO JUXTLAHUACA,469,CUAUHTÉMOC YUCUNICOCO,3,72,31,41,4
OAXACA,20,SANTIAGO JUXTLAHUACA,469,EL DIAMANTE JUXTLAHUACA,1,13,6,7,3
OAXACA,20,SANTIAGO JUXTLAHUACA,469,EL RASTROJO,4,553,324,229,30
OAXACA,20,SANTIAGO JUXTLAHUACA,469,GUADALUPE YUCHÍO,4,32,14,18,3
OAXACA,20,SANTIAGO JUXTLAHUACA,469,INFIERNILLO,2,5,0,5,1
OAXACA,20,SANTIAGO JUXTLAHUACA,469,LA BRAMA PARAJE PÉREZ,1,12,5,7,6
OAXACA,20,SANTIAGO JUXTLAHUACA,469,LA CUMBRE YERBA SANTA,2,9,5,4,1
OAXACA,20,SANTIAGO JUXTLAHUACA,469,LA LUZ LLANO DE NOPAL,2,149,88,61,10
OAXACA,20,SANTIAGO JUXTLAHUACA,469,LA REFORMA JUQUILA,2,45,26,19,5
OAXACA,20,SANTIAGO JUXTLAHUACA,469,LA SABANA,5,310,159,151,19
OAXACA,20,SANTIAGO JUXTLAHUACA,469,LAGUNA GUADALUPE YUCUNICOCO,1,13,8,5,1
OAXACA,20,SANTIAGO JUXTLAHUACA,469,LÁZARO CÁRDENAS COPALA,2,93,53,40,9
OAXACA,20,SANTIAGO JUXTLAHUACA,469,LÁZARO CÁRDENAS YUCUNICOCO,4,237,112,125,14
OAXACA,20,SANTIAGO JUXTLAHUACA,469,LLANO DE JUÁREZ COPALA,2,41,21,20,9
OAXACA,20,SANTIAGO JUXTLAHUACA,469,NICÁN,1,15,9,6,1
OAXACA,20,SANTIAGO JUXTLAHUACA,469,OJO DE AGUA COPALA,1,18,9,9,5
OAXACA,20,SANTIAGO JUXTLAHUACA,469,PASO DE ÁGUILA COPALA,2,126,72,54,9
OAXACA,20,SANTIAGO JUXTLAHUACA,469,PUEBLO NUEVO DEL NIÑO JESÚS,2,5,0,5,1
OAXACA,20,SANTIAGO JUXTLAHUACA,469,RÍO HUMO,1,12,6,6,3
OAXACA,20,SANTIAGO JUXTLAHUACA,469,RÍO LAGARTO,2,71,38,33,9
OAXACA,20,SANTIAGO JUXTLAHUACA,469,RÍO METATES,3,169,103,66,13
OAXACA,20,SANTIAGO JUXTLAHUACA,469,SAN ANTONIO DEL PROGRESO,1,15,6,9,6
OAXACA,20,SANTIAGO JUXTLAHUACA,469,SAN JUAN COPALA,6,213,114,99,26
OAXACA,20,SANTIAGO JUXTLAHUACA,469,SAN JUAN PIÑAS,4,199,111,88,15
OAXACA,20,SANTIAGO JUXTLAHUACA,469,SAN MARCOS ZOCHIQUILAZALA,3,20,13,7,2
OAXACA,20,SANTIAGO JUXTLAHUACA,469,SAN MIGUEL CUEVAS,3,78,38,40,12
OAXACA,20,SANTIAGO JUXTLAHUACA,469,SAN MIGUEL DE CÁRDENAS,1,15,6,9,1
OAXACA,20,SANTIAGO JUXTLAHUACA,469,SAN PEDRO CHAYUCO,4,212,117,95,15
OAXACA,20,SANTIAGO JUXTLAHUACA,469,SANTA CATARINA NOLTEPEC,3,119,64,55,9
OAXACA,20,SANTIAGO JUXTLAHUACA,469,SANTA CRUZ TILAPA,3,107,60,47,11
OAXACA,20,SANTIAGO JUXTLAHUACA,469,SANTA MARÍA ASUNCIÓN,4,257,132,125,13
OAXACA,20,SANTIAGO JUXTLAHUACA,469,SANTA MARÍA YUCUNICOCO,6,644,315,329,29
OAXACA,20,SANTIAGO JUXTLAHUACA,469,SANTA ROSA CAXTLAHUACA,3,210,112,98,12
OAXACA,20,SANTIAGO JUXTLAHUACA,469,SANTIAGO JUXTLAHUACA,27,4199,2145,2054,256
OAXACA,20,SANTIAGO JUXTLAHUACA,469,SANTIAGO NARANJAS,3,268,125,143,13
OAXACA,20,SANTIAGO JUXTLAHUACA,469,SANTO DOMINGO,1,81,47,34,6
OAXACA,20,SANTIAGO JUXTLAHUACA,469,SANTO DOMINGO DEL PROGRESO,2,49,22,27,3
OAXACA,20,SANTIAGO JUXTLAHUACA,469,SANTOS REYES ZOCHIQUILAZOLA,3,256,148,108,19
OAXACA,20,SANTIAGO JUXTLAHUACA,469,TACUYÁ,2,64,34,30,3
OAXACA,20,SANTIAGO JUXTLAHUACA,469,TIERRA BLANCA,3,27,11,16,10
OAXACA,20,SANTIAGO JUXTLAHUACA,469,TILAPA,3,257,148,109,16
OAXACA,20,SANTIAGO JUXTLAHUACA,469,TINUMA DE ZARAGOZA,1,24,11,13,6
OAXACA,20,SANTIAGO JUXTLAHUACA,469,UNIÓN DE CÁRDENAS,2,101,50,51,5
OAXACA,20,SANTIAGO JUXTLAHUACA,469,UNIÓN DE LOS ÁNGELES,2,76,41,35,9
OAXACA,20,SANTIAGO JUXTLAHUACA,469,YOSOYUXI COPALA,3,217,114,103,14
OAXACA,20,SANTIAGO JUXTLAHUACA,469,YUTUSANÍ,3,26,19,7,2
OAXACA,20,SANTIAGO JUXTLAHUACA,469,ZARAGOZA YUCUNICOCO,3,66,35,31,5
OAXACA,20,SANTIAGO LACHIGUIRI,470,ARROYO MAGUEY,2,8,5,3,2
OAXACA,20,SANTIAGO LACHIGUIRI,470,ARROYO OBSCURO,1,4,2,2,1
OAXACA,20,SANTIAGO LACHIGUIRI,470,EL PAJARITO,2,11,7,4,2
OAXACA,20,SANTIAGO LACHIGUIRI,470,EL PERICÓN,1,6,4,2,2
OAXACA,20,SANTIAGO LACHIGUIRI,470,GUIGOVELAGA,4,237,128,109,19
OAXACA,20,SANTIAGO LACHIGUIRI,470,LAGUNAS (LAGUNERAS),3,29,14,15,3
OAXACA,20,SANTIAGO LACHIGUIRI,470,LLANO COYUL,2,13,9,4,2
OAXACA,20,SANTIAGO LACHIGUIRI,470,MAÍZ QUEMADO,2,13,6,7,1
OAXACA,20,SANTIAGO LACHIGUIRI,470,PEÑA BLANCA,1,6,2,4,1
OAXACA,20,SANTIAGO LACHIGUIRI,470,SAN MIGUEL,4,138,73,65,13
OAXACA,20,SANTIAGO LACHIGUIRI,470,SANTIAGO LACHIGUIRI,4,408,212,196,23
OAXACA,20,SANTIAGO LACHIGUIRI,470,SANTO DOMINGO LA REFORMA,3,43,20,23,5
OAXACA,20,SANTIAGO LACHIGUIRI,470,TIERRA BAJA,1,7,0,7,1
OAXACA,20,SANTIAGO LACHIGUIRI,470,VILLA LA ESPERANZA,3,78,39,39,11
OAXACA,20,SANTIAGO LALOPA,471,SANTIAGO LALOPA,4,165,98,67,14
OAXACA,20,SANTIAGO LAOLLAGA,472,BARRIO CALVARIO,1,94,45,49,7
OAXACA,20,SANTIAGO LAOLLAGA,472,GUICHIXÚ,3,84,43,41,7
OAXACA,20,SANTIAGO LAOLLAGA,472,SANTIAGO LAOLLAGA,8,463,223,240,47
OAXACA,20,SANTIAGO LAXOPA,473,SAN SEBASTIÁN GUILOXÍ,3,38,22,16,4
OAXACA,20,SANTIAGO LAXOPA,473,SANTA CATARINA YAHUÍO,3,115,56,59,8
OAXACA,20,SANTIAGO LAXOPA,473,SANTIAGO LAXOPA,4,117,56,61,12
OAXACA,20,SANTIAGO LLANO GRANDE,474,RANCHO NUEVO,4,182,96,86,15
OAXACA,20,SANTIAGO LLANO GRANDE,474,SAN FRANCISCO EL MAGUEY,3,209,91,118,15
OAXACA,20,SANTIAGO LLANO GRANDE,474,SANTIAGO LLANO GRANDE,5,484,250,234,30
OAXACA,20,SANTIAGO MATATLÁN,475,EL PORTILLO,2,31,11,20,2
OAXACA,20,SANTIAGO MATATLÁN,475,RANCHO BLANCO,2,66,34,32,7
OAXACA,20,SANTIAGO MATATLÁN,475,RANCHO COLORADO,2,75,44,31,7
OAXACA,20,SANTIAGO MATATLÁN,475,RANCHO SAN FELIPE,3,284,161,123,18
OAXACA,20,SANTIAGO MATATLÁN,475,RÍO GRANDE,1,11,4,7,1
OAXACA,20,SANTIAGO MATATLÁN,475,SAN PABLO GUILÁ,8,1195,615,580,62
OAXACA,20,SANTIAGO MATATLÁN,475,SANTIAGO MATATLÁN,8,860,406,454,52
OAXACA,20,SANTIAGO MATATLÁN,475,TIERRA BLANCA,1,12,6,6,4
OAXACA,20,SANTIAGO MILTEPEC,476,SANTIAGO MILTEPEC,2,67,36,31,9
OAXACA,20,SANTIAGO MINAS,477,CACALOTE,3,39,21,18,4
OAXACA,20,SANTIAGO MINAS,477,COQUITO,3,53,29,24,4
OAXACA,20,SANTIAGO MINAS,477,CORRAL DE PIEDRA,2,27,14,13,2
OAXACA,20,SANTIAGO MINAS,477,PIEDRA LISA,2,22,14,8,4
OAXACA,20,SANTIAGO MINAS,477,SANTIAGO MINAS,4,112,56,56,13
OAXACA,20,SANTIAGO MINAS,477,TOBALÁ,3,21,13,8,3
OAXACA,20,SANTIAGO NACALTEPEC,478,EL CHAMIZAL,2,12,7,5,2
OAXACA,20,SANTIAGO NACALTEPEC,478,EL MORAL,3,48,25,23,12
OAXACA,20,SANTIAGO NACALTEPEC,478,LA UNIÓN,2,24,12,12,7
OAXACA,20,SANTIAGO NACALTEPEC,478,SAN FRANCISCO COTAHUIXTLA,3,56,28,28,12
OAXACA,20,SANTIAGO NACALTEPEC,478,SAN JOSÉ ARAGÓN,3,39,23,16,5
OAXACA,20,SANTIAGO NACALTEPEC,478,SAN JUAN TONALTEPEC,3,31,13,18,12
OAXACA,20,SANTIAGO NACALTEPEC,478,SANTIAGO NACALTEPEC,4,118,64,54,24
OAXACA,20,SANTIAGO NEJAPILLA,479,SANTIAGO NEJAPILLA,2,15,7,8,5
OAXACA,20,SANTIAGO NUNDICHE,480,HIDALGO,2,11,4,7,2
OAXACA,20,SANTIAGO NUNDICHE,480,IGNACIO ALLENDE LAS HUERTAS,2,31,15,16,2
OAXACA,20,SANTIAGO NUNDICHE,480,MORELOS,1,5,1,4,1
OAXACA,20,SANTIAGO NUNDICHE,480,SANTIAGO NUNDICHE,3,104,52,52,7
OAXACA,20,SANTIAGO NUYOÓ,481,LOMA BONITA DE JUÁREZ,3,49,29,20,4
OAXACA,20,SANTIAGO NUYOÓ,481,PLAN DE ZARAGOZA,3,40,16,24,4
OAXACA,20,SANTIAGO NUYOÓ,481,SANTIAGO NUYOÓ,5,257,133,124,19
OAXACA,20,SANTIAGO NUYOÓ,481,TIERRA AZUL,3,42,16,26,3
OAXACA,20,SANTIAGO NUYOÓ,481,UNIÓN Y PROGRESO,3,47,31,16,4
OAXACA,20,SANTIAGO NUYOÓ,481,YUCUBEY DE CUITLÁHUAC,1,14,8,6,1
OAXACA,20,SANTIAGO NUYOÓ,481,YUCUNINO DE GUERRERO,3,54,31,23,4
OAXACA,20,SANTIAGO PINOTEPA NACIONAL,482,ACUAUTEPEC O AGUA DE LA CAÑA,3,62,33,29,8
OAXACA,20,SANTIAGO PINOTEPA NACIONAL,482,ARROYO SECO,1,9,3,6,1
OAXACA,20,SANTIAGO PINOTEPA NACIONAL,482,CERRO DE LA ESPERANZA,3,199,101,98,16
OAXACA,20,SANTIAGO PINOTEPA NACIONAL,482,COLLANTES,6,620,345,275,42
OAXACA,20,SANTIAGO PINOTEPA NACIONAL,482,CORRALERO,4,493,281,212,29
OAXACA,20,SANTIAGO PINOTEPA NACIONAL,482,CRUZ DEL ITACUÁN,3,116,56,60,9
OAXACA,20,SANTIAGO PINOTEPA NACIONAL,482,EL ALACRÁN,3,73,41,32,11
OAXACA,20,SANTIAGO PINOTEPA NACIONAL,482,EL AÑIL,1,15,9,6,1
OAXACA,20,SANTIAGO PINOTEPA NACIONAL,482,EL CARRIZO,5,418,201,217,23
OAXACA,20,SANTIAGO PINOTEPA NACIONAL,482,EL CIRUELO,5,581,328,253,37
OAXACA,20,SANTIAGO PINOTEPA NACIONAL,482,EL CONEJO,2,10,6,4,1
OAXACA,20,SANTIAGO PINOTEPA NACIONAL,482,EL PALOMAR,1,1,1,0,1
OAXACA,20,SANTIAGO PINOTEPA NACIONAL,482,EL RANCHITO,2,36,15,21,5
OAXACA,20,SANTIAGO PINOTEPA NACIONAL,482,EL TAMAL,3,49,22,27,10
OAXACA,20,SANTIAGO PINOTEPA NACIONAL,482,EL TAMARINDO,2,27,16,11,4
OAXACA,20,SANTIAGO PINOTEPA NACIONAL,482,EL VIZCAÍNO,2,14,5,9,2
OAXACA,20,SANTIAGO PINOTEPA NACIONAL,482,GUADALUPE VICTORIA,3,73,34,39,8
OAXACA,20,SANTIAGO PINOTEPA NACIONAL,482,LA NORIA Y MININDACA,3,88,45,43,8
OAXACA,20,SANTIAGO PINOTEPA NACIONAL,482,LA PALMA,2,21,6,15,3
OAXACA,20,SANTIAGO PINOTEPA NACIONAL,482,LA RAYA,2,21,14,7,2
OAXACA,20,SANTIAGO PINOTEPA NACIONAL,482,LAGUNILLAS,3,134,74,60,13
OAXACA,20,SANTIAGO PINOTEPA NACIONAL,482,LAS PALMAS,1,47,27,20,6
OAXACA,20,SANTIAGO PINOTEPA NACIONAL,482,LO DE CANDELA,3,97,55,42,12
OAXACA,20,SANTIAGO PINOTEPA NACIONAL,482,LO DE MEJÍA,3,90,42,48,9
OAXACA,20,SANTIAGO PINOTEPA NACIONAL,482,LOMA LARGA,1,17,12,5,1
OAXACA,20,SANTIAGO PINOTEPA NACIONAL,482,LOS HORCONES,1,15,9,6,1
OAXACA,20,SANTIAGO PINOTEPA NACIONAL,482,LOS POCITOS,3,120,54,66,12
OAXACA,20,SANTIAGO PINOTEPA NACIONAL,482,MANCUERNAS,4,533,277,256,30
OAXACA,20,SANTIAGO PINOTEPA NACIONAL,482,MARIANO MATAMOROS,1,9,4,5,1
OAXACA,20,SANTIAGO PINOTEPA NACIONAL,482,MINITÁN,2,41,21,20,5
OAXACA,20,SANTIAGO PINOTEPA NACIONAL,482,MOTILLAS,3,52,21,31,6
OAXACA,20,SANTIAGO PINOTEPA NACIONAL,482,PASO DE LA GARROCHA,2,38,20,18,5
OAXACA,20,SANTIAGO PINOTEPA NACIONAL,482,PIE DEL CERRO,3,42,20,22,4
OAXACA,20,SANTIAGO PINOTEPA NACIONAL,482,PIEDRA BLANCA,3,187,94,93,14
OAXACA,20,SANTIAGO PINOTEPA NACIONAL,482,PLAYA BANCO DE ORO,1,30,13,17,2
OAXACA,20,SANTIAGO PINOTEPA NACIONAL,482,SANTA MARÍA JICALTEPEC,5,508,261,247,30
OAXACA,20,SANTIAGO PINOTEPA NACIONAL,482,SANTIAGO PINOTEPA NACIONAL,58,10903,5702,5201,632
OAXACA,20,SANTIAGO PINOTEPA NACIONAL,482,YUYAQUITA,1,17,7,10,1
OAXACA,20,SANTIAGO SUCHILQUITONGO,483,COLONIA DEL SOL,2,223,115,108,14
OAXACA,20,SANTIAGO SUCHILQUITONGO,483,SANTA CRUZ LACHIXOLANA,4,301,164,137,24
OAXACA,20,SANTIAGO SUCHILQUITONGO,483,SANTIAGO SUCHILQUITONGO,16,2666,1380,1286,188
OAXACA,20,SANTIAGO SUCHILQUITONGO,483,SANTO DOMINGO TLALTINANGO,2,133,72,61,10
OAXACA,20,SANTIAGO TAMAZOLA,484,SAN BARTOLO SALINAS,3,100,49,51,10
OAXACA,20,SANTIAGO TAMAZOLA,484,SAN JOSÉ ZOCOTEACA DE BRAVO,3,99,53,46,9
OAXACA,20,SANTIAGO TAMAZOLA,484,SAN LUIS MORELIA,3,210,100,110,13
OAXACA,20,SANTIAGO TAMAZOLA,484,SANTA ANA RAYÓN,4,142,72,70,12
OAXACA,20,SANTIAGO TAMAZOLA,484,SANTIAGO TAMAZOLA,5,589,332,257,37
OAXACA,20,SANTIAGO TAPEXTLA,485,CAHUITÁN,1,16,10,6,1
OAXACA,20,SANTIAGO TAPEXTLA,485,LA CULEBRA,3,79,41,38,8
OAXACA,20,SANTIAGO TAPEXTLA,485,LLANO GRANDE,3,265,135,130,18
OAXACA,20,SANTIAGO TAPEXTLA,485,SAN ISIDRO,3,71,35,36,7
OAXACA,20,SANTIAGO TAPEXTLA,485,SANTIAGO TAPEXTLA,5,466,244,222,28
OAXACA,20,SANTIAGO TAPEXTLA,485,TECOYAME,3,73,35,38,8
OAXACA,20,VILLA TEJÚPAM DE LA UNIÓN,486,CHOCANI,1,17,9,8,2
OAXACA,20,VILLA TEJÚPAM DE LA UNIÓN,486,MONTEVERDE,1,15,6,9,2
OAXACA,20,VILLA TEJÚPAM DE LA UNIÓN,486,SANTA CATARINA,1,15,11,4,2
OAXACA,20,VILLA TEJÚPAM DE LA UNIÓN,486,TIERRA BLANCA,1,11,2,9,1
OAXACA,20,VILLA TEJÚPAM DE LA UNIÓN,486,VILLA TEJÚPAM DE LA UNIÓN,4,369,198,171,22
OAXACA,20,VILLA TEJÚPAM DE LA UNIÓN,486,YODOBADA,1,14,10,4,2
OAXACA,20,VILLA TEJÚPAM DE LA UNIÓN,486,YUYUSA (YUYUZA),1,25,14,11,2
OAXACA,20,SANTIAGO TENANGO,487,BUENAVISTA,2,14,6,8,2
OAXACA,20,SANTIAGO TENANGO,487,EL CORREO,3,81,45,36,11
OAXACA,20,SANTIAGO TENANGO,487,EL MOGOTE DEL SOL,2,24,12,12,6
OAXACA,20,SANTIAGO TENANGO,487,EL TEJOCOTE,2,44,22,22,7
OAXACA,20,SANTIAGO TENANGO,487,LA CARBONERA,3,62,34,28,8
OAXACA,20,SANTIAGO TENANGO,487,LA CIENEGUILLA,2,34,18,16,7
OAXACA,20,SANTIAGO TENANGO,487,LOMA LARGA,3,21,7,14,2
OAXACA,20,SANTIAGO TENANGO,487,SANTIAGO TENANGO,4,139,75,64,16
OAXACA,20,SANTIAGO TEPETLAPA,488,SANTIAGO TEPETLAPA,1,14,2,12,2
OAXACA,20,SANTIAGO TETEPEC,489,EL OCOTE,3,89,49,40,12
OAXACA,20,SANTIAGO TETEPEC,489,EL OCOTILLO,2,12,6,6,1
OAXACA,20,SANTIAGO TETEPEC,489,EL ROSARIO,2,49,25,24,9
OAXACA,20,SANTIAGO TETEPEC,489,GUADALUPE DEL TAMBOR,3,100,27,73,10
OAXACA,20,SANTIAGO TETEPEC,489,LA CUMBRE,3,108,60,48,12
OAXACA,20,SANTIAGO TETEPEC,489,LA SOLEDAD CARRIZO,3,66,35,31,10
OAXACA,20,SANTIAGO TETEPEC,489,OCOTLÁN DE JUÁREZ,4,173,92,81,13
OAXACA,20,SANTIAGO TETEPEC,489,SAN ISIDRO DEL PARRAL,3,97,52,45,10
OAXACA,20,SANTIAGO TETEPEC,489,SAN LUIS CHATAÑÚ,3,65,35,30,12
OAXACA,20,SANTIAGO TETEPEC,489,SANTA CRUZ TIHUIXTE,4,174,100,74,15
OAXACA,20,SANTIAGO TETEPEC,489,SANTIAGO TETEPEC,5,432,231,201,28
OAXACA,20,SANTIAGO TETEPEC,489,TIERRA COLORADA,3,23,11,12,3
OAXACA,20,SANTIAGO TEXCALCINGO,490,ATEMPA,2,58,31,27,4
OAXACA,20,SANTIAGO TEXCALCINGO,490,BUENA VISTA,2,47,23,24,5
OAXACA,20,SANTIAGO TEXCALCINGO,490,HUASHINTLÁN,2,135,63,72,6
OAXACA,20,SANTIAGO TEXCALCINGO,490,LOMA BONITA,3,118,59,59,9
OAXACA,20,SANTIAGO TEXCALCINGO,490,PELIXTITLAN,1,24,12,12,1
OAXACA,20,SANTIAGO TEXCALCINGO,490,SANTIAGO TEXCALCINGO,6,317,154,163,19
OAXACA,20,SANTIAGO TEXCALCINGO,490,TEPANTITLÁN,2,110,55,55,9
OAXACA,20,SANTIAGO TEXTITLÁN,491,BUENA VISTA,3,165,88,77,11
OAXACA,20,SANTIAGO TEXTITLÁN,491,EL FRIJOL,3,69,37,32,9
OAXACA,20,SANTIAGO TEXTITLÁN,491,FERRERÍA DE LA PROVIDENCIA,2,16,8,8,2
OAXACA,20,SANTIAGO TEXTITLÁN,491,LA CIÉNEGA,2,11,5,6,2
OAXACA,20,SANTIAGO TEXTITLÁN,491,LACHIXAO,3,90,46,44,10
OAXACA,20,SANTIAGO TEXTITLÁN,491,RECIBIMIENTO DE CUAUHTÉMOC,3,198,104,94,11
OAXACA,20,SANTIAGO TEXTITLÁN,491,RÍO HUMO,4,229,108,121,12
OAXACA,20,SANTIAGO TEXTITLÁN,491,RÍO SANTIAGO,2,22,10,12,4
OAXACA,20,SANTIAGO TEXTITLÁN,491,SAN ISIDRO LLANO YERBA,2,44,20,24,7
OAXACA,20,SANTIAGO TEXTITLÁN,491,SANTIAGO SOCHILTEPEC,4,397,217,180,25
OAXACA,20,SANTIAGO TEXTITLÁN,491,SANTIAGO TEXTITLÁN,4,435,230,205,24
OAXACA,20,SANTIAGO TILANTONGO,492,BUENAVISTA,1,5,3,2,1
OAXACA,20,SANTIAGO TILANTONGO,492,EL PROGRESO,3,39,23,16,7
OAXACA,20,SANTIAGO TILANTONGO,492,EL SOCORRO,1,7,2,5,5
OAXACA,20,SANTIAGO TILANTONGO,492,GALEANA,1,17,8,9,6
OAXACA,20,SANTIAGO TILANTONGO,492,GENERAL VICENTE GUERRERO,2,27,12,15,7
OAXACA,20,SANTIAGO TILANTONGO,492,GUADALUPE HIDALGO,3,35,16,19,5
OAXACA,20,SANTIAGO TILANTONGO,492,LA PAZ,1,13,6,7,6
OAXACA,20,SANTIAGO TILANTONGO,492,LA PROVIDENCIA,2,40,16,24,3
OAXACA,20,SANTIAGO TILANTONGO,492,LAGUNA GRANDE TILANTONGO,1,15,5,10,1
OAXACA,20,SANTIAGO TILANTONGO,492,LAS FLORES TILANTONGO,3,60,29,31,10
OAXACA,20,SANTIAGO TILANTONGO,492,NARCISO MENDOZA,1,10,3,7,5
OAXACA,20,SANTIAGO TILANTONGO,492,SAN ISIDRO,1,8,1,7,1
OAXACA,20,SANTIAGO TILANTONGO,492,SAN JOSÉ TRES LAGUNAS,2,9,5,4,1
OAXACA,20,SANTIAGO TILANTONGO,492,SAN MARTÍN DE LAS PALMAS,2,23,13,10,6
OAXACA,20,SANTIAGO TILANTONGO,492,SANTIAGO TILANTONGO,5,288,162,126,18
OAXACA,20,SANTIAGO TILANTONGO,492,ZARAGOZA,1,15,10,5,1
OAXACA,20,SANTIAGO TILLO,493,SAN MATEO YUCUCUY,1,4,3,1,1
OAXACA,20,SANTIAGO TILLO,493,SANTIAGO TILLO,2,49,26,23,9
OAXACA,20,SANTIAGO TLAZOYALTEPEC,494,BUENAVISTA,3,187,99,88,9
OAXACA,20,SANTIAGO TLAZOYALTEPEC,494,CERRO DE ÁGUILA (TIERRA CALIENTE),1,11,6,5,1
OAXACA,20,SANTIAGO TLAZOYALTEPEC,494,EL GACHUPÍN,4,298,163,135,19
OAXACA,20,SANTIAGO TLAZOYALTEPEC,494,EL PORTEZUELO,3,165,73,92,10
OAXACA,20,SANTIAGO TLAZOYALTEPEC,494,LA PLAZUELA,2,25,11,14,2
OAXACA,20,SANTIAGO TLAZOYALTEPEC,494,SANTIAGO HUAXOLOTIPAC,4,491,255,236,23
OAXACA,20,SANTIAGO TLAZOYALTEPEC,494,SANTIAGO TLAZOYALTEPEC,3,216,119,97,12
OAXACA,20,SANTIAGO TLAZOYALTEPEC,494,TIERRA CALIENTE,5,411,203,208,27
OAXACA,20,SANTIAGO XANICA,495,EL GAVILÁN,2,13,6,7,2
OAXACA,20,SANTIAGO XANICA,495,EL POCHOTLE,3,39,17,22,4
OAXACA,20,SANTIAGO XANICA,495,OJO DE VENADO,2,8,2,6,1
OAXACA,20,SANTIAGO XANICA,495,RÍO CAJÓN (SAN ISIDRO RÍO CAJÓN),1,11,1,10,1
OAXACA,20,SANTIAGO XANICA,495,SAN ANTONIO OZOLOTEPEC,3,111,59,52,10
OAXACA,20,SANTIAGO XANICA,495,SAN FELIPE LACHILLÓ,4,261,135,126,14
OAXACA,20,SANTIAGO XANICA,495,SAN JERÓNIMO,3,21,14,7,3
OAXACA,20,SANTIAGO XANICA,495,SANTA MARÍA COIXTEPEC,3,101,55,46,12
OAXACA,20,SANTIAGO XANICA,495,SANTIAGO XANICA,4,239,126,113,20
OAXACA,20,SANTIAGO XIACUÍ,496,FRANCISCO I. MADERO,2,50,28,22,5
OAXACA,20,SANTIAGO XIACUÍ,496,SAN ANDRÉS YATUNI,2,34,17,17,3
OAXACA,20,SANTIAGO XIACUÍ,496,SANTIAGO XIACUÍ,4,319,186,133,21
OAXACA,20,SANTIAGO XIACUÍ,496,TRINIDAD IXTLÁN,3,144,76,68,15
OAXACA,20,SANTIAGO YAITEPEC,497,SANTIAGO YAITEPEC,8,894,449,445,46
OAXACA,20,SANTIAGO YAVEO,498,ARROYO CHANCARRO,1,2,2,0,1
OAXACA,20,SANTIAGO YAVEO,498,BELLA VISTA,2,24,11,13,2
OAXACA,20,SANTIAGO YAVEO,498,CAMPO NUEVO,3,45,23,22,4
OAXACA,20,SANTIAGO YAVEO,498,CAMPO QUEMADO,3,19,9,10,3
OAXACA,20,SANTIAGO YAVEO,498,DOLORES HIDALGO,4,216,117,99,12
OAXACA,20,SANTIAGO YAVEO,498,EL COYOLITO,1,4,1,3,1
OAXACA,20,SANTIAGO YAVEO,498,EL NARANJAL,2,9,5,4,2
OAXACA,20,SANTIAGO YAVEO,498,FRANCISCO VILLA,3,337,185,152,19
OAXACA,20,SANTIAGO YAVEO,498,LA PROVIDENCIA,1,5,2,3,1
OAXACA,20,SANTIAGO YAVEO,498,LA TRINIDAD,3,168,78,90,11
OAXACA,20,SANTIAGO YAVEO,498,LLANO GRANDE,2,44,22,22,3
OAXACA,20,SANTIAGO YAVEO,498,NUEVO OCOTLÁN,3,127,64,63,10
OAXACA,20,SANTIAGO YAVEO,498,SAN JUAN JALTEPEC,3,292,145,147,12
OAXACA,20,SANTIAGO YAVEO,498,SANTA MARÍA YAVEO,3,134,73,61,8
OAXACA,20,SANTIAGO YAVEO,498,SANTIAGO YAVEO,4,209,103,106,15
OAXACA,20,SANTIAGO YAVEO,498,VILLA DE TORRES,2,13,5,8,3
OAXACA,20,SANTIAGO YAVEO,498,ZAPOTITANCILLO DE JUÁREZ,3,122,67,55,7
OAXACA,20,SANTIAGO YOLOMÉCATL,499,SANTIAGO YOLOMÉCATL,4,730,415,315,60
OAXACA,20,SANTIAGO YOSONDÚA,500,ALACRÁN,2,51,18,33,5
OAXACA,20,SANTIAGO YOSONDÚA,500,ATALAYA,2,41,21,20,2
OAXACA,20,SANTIAGO YOSONDÚA,500,BUENAVISTA,3,41,16,25,3
OAXACA,20,SANTIAGO YOSONDÚA,500,CABECERA DE CAÑADA,3,67,32,35,4
OAXACA,20,SANTIAGO YOSONDÚA,500,CAÑADA DE GALICIA,4,121,56,65,11
OAXACA,20,SANTIAGO YOSONDÚA,500,CHIKAVA,3,18,8,10,3
OAXACA,20,SANTIAGO YOSONDÚA,500,CUAJILOTES,4,109,61,48,8
OAXACA,20,SANTIAGO YOSONDÚA,500,GUANACASTLE,2,16,7,9,2
OAXACA,20,SANTIAGO YOSONDÚA,500,IMPERIO,4,158,85,73,8
OAXACA,20,SANTIAGO YOSONDÚA,500,KAVANDIHUI,2,17,6,11,2
OAXACA,20,SANTIAGO YOSONDÚA,500,LÁZARO CÁRDENAS,2,39,22,17,2
OAXACA,20,SANTIAGO YOSONDÚA,500,PLUMAS,4,131,62,69,7
OAXACA,20,SANTIAGO YOSONDÚA,500,PRIMAVERA,2,63,35,28,4
OAXACA,20,SANTIAGO YOSONDÚA,500,SAN MIGUEL IXCATLÁN,2,43,15,28,3
OAXACA,20,SANTIAGO YOSONDÚA,500,SANTA CATARINA CUANANA,3,152,80,72,12
OAXACA,20,SANTIAGO YOSONDÚA,500,SANTIAGO YOSONDÚA,5,593,326,267,38
OAXACA,20,SANTIAGO YOSONDÚA,500,VERGEL,3,101,53,48,6
OAXACA,20,SANTIAGO YOSONDÚA,500,YERBA SANTA,3,44,23,21,6
OAXACA,20,SANTIAGO YOSONDÚA,500,YOLOTEPEC DE LA PAZ,2,29,15,14,3
OAXACA,20,SANTIAGO YOSONDÚA,500,YUCUMAGÑU,2,8,4,4,1
OAXACA,20,SANTIAGO YOSONDÚA,500,YUNIÑE,2,10,4,6,1
OAXACA,20,SANTIAGO YUCUYACHI,501,SANTA ROSA DE JUÁREZ,3,117,66,51,12
OAXACA,20,SANTIAGO YUCUYACHI,501,SANTIAGO YUCUYACHI,3,62,33,29,15
OAXACA,20,SANTIAGO ZACATEPEC,502,LA CANDELARIA,3,356,180,176,19
OAXACA,20,SANTIAGO ZACATEPEC,502,METALTEPEC,3,225,108,117,11
OAXACA,20,SANTIAGO ZACATEPEC,502,SANTIAGO ZACATEPEC,6,564,300,264,37
OAXACA,20,SANTIAGO ZOOCHILA,503,SANTIAGO ZOOCHILA,4,64,30,34,10
OAXACA,20,NUEVO ZOQUIÁPAM,504,NUEVO ZOQUIÁPAM,6,356,190,166,27
OAXACA,20,NUEVO ZOQUIÁPAM,504,SAN MATÍAS ZOQUIÁPAM,3,89,43,46,7
OAXACA,20,SANTO DOMINGO INGENIO,505,BARRIO VENTERO,1,36,21,15,3
OAXACA,20,SANTO DOMINGO INGENIO,505,CAZADERO,1,15,9,6,1
OAXACA,20,SANTO DOMINGO INGENIO,505,CERRO IGUANA,2,35,18,17,5
OAXACA,20,SANTO DOMINGO INGENIO,505,LA BLANCA,4,341,163,178,23
OAXACA,20,SANTO DOMINGO INGENIO,505,SANTO DOMINGO INGENIO,7,1215,590,625,81
OAXACA,20,SANTO DOMINGO ALBARRADAS,506,SANTO DOMINGO ALBARRADAS,4,155,85,70,14
OAXACA,20,SANTO DOMINGO ARMENTA,507,CALLEJÓN DE RÓMULO,3,119,53,66,12
OAXACA,20,SANTO DOMINGO ARMENTA,507,LAGUNILLAS,1,29,9,20,3
OAXACA,20,SANTO DOMINGO ARMENTA,507,SANTO DOMINGO ARMENTA,5,675,341,334,36
OAXACA,20,SANTO DOMINGO CHIHUITÁN,508,SANTO DOMINGO CHIHUITÁN,3,193,104,89,12
OAXACA,20,SANTO DOMINGO DE MORELOS,509,BAJOS DE SANTO DOMINGO,2,105,47,58,5
OAXACA,20,SANTO DOMINGO DE MORELOS,509,BARRIO ALTO,2,18,9,9,2
OAXACA,20,SANTO DOMINGO DE MORELOS,509,BARRIO DEL RÍO,2,74,35,39,3
OAXACA,20,SANTO DOMINGO DE MORELOS,509,BARRIO NUEVO,2,90,40,50,5
OAXACA,20,SANTO DOMINGO DE MORELOS,509,CAÑADA BRAVA,3,444,228,216,23
OAXACA,20,SANTO DOMINGO DE MORELOS,509,CERRO CAMPANA,4,210,101,109,12
OAXACA,20,SANTO DOMINGO DE MORELOS,509,CERRO SAN ANTONIO,1,39,19,20,2
OAXACA,20,SANTO DOMINGO DE MORELOS,509,LAS CUEVAS,3,194,101,93,11
OAXACA,20,SANTO DOMINGO DE MORELOS,509,LAS PILAS,2,130,14,116,8
OAXACA,20,SANTO DOMINGO DE MORELOS,509,MACAHUITERA,2,143,79,64,8
OAXACA,20,SANTO DOMINGO DE MORELOS,509,PASO SAN ANTONIO,1,48,17,31,3
OAXACA,20,SANTO DOMINGO DE MORELOS,509,PIEDRA DEL SOL,3,334,169,165,14
OAXACA,20,SANTO DOMINGO DE MORELOS,509,RÍO GRANDE,1,16,7,9,1
OAXACA,20,SANTO DOMINGO DE MORELOS,509,SAN JOSÉ PIEDRAS NEGRAS,3,319,148,171,18
OAXACA,20,SANTO DOMINGO DE MORELOS,509,SANTO DOMINGO DE MORELOS,7,971,467,504,47
OAXACA,20,SANTO DOMINGO DE MORELOS,509,TARAGUNTÍN,3,35,17,18,3
OAXACA,20,SANTO DOMINGO DE MORELOS,509,YERBA SANTA,3,227,116,111,11
OAXACA,20,SANTO DOMINGO IXCATLÁN,510,EL PORVENIR,1,18,11,7,1
OAXACA,20,SANTO DOMINGO IXCATLÁN,510,SANTO DOMINGO IXCATLÁN,5,207,100,107,15
OAXACA,20,SANTO DOMINGO IXCATLÁN,510,TIERRA BLANCA,2,37,21,16,3
OAXACA,20,SANTO DOMINGO NUXAÁ,511,CERRO MACHÍN,2,10,3,7,1
OAXACA,20,SANTO DOMINGO NUXAÁ,511,EL ORO,4,192,105,87,12
OAXACA,20,SANTO DOMINGO NUXAÁ,511,EL PORVENIR,2,44,25,19,3
OAXACA,20,SANTO DOMINGO NUXAÁ,511,EL SABINAL,2,25,12,13,7
OAXACA,20,SANTO DOMINGO NUXAÁ,511,LA MURALLA,3,63,32,31,5
OAXACA,20,SANTO DOMINGO NUXAÁ,511,LADERA DEL RÍO GARZA,2,20,13,7,2
OAXACA,20,SANTO DOMINGO NUXAÁ,511,LLANO DE AYUCA,3,84,46,38,10
OAXACA,20,SANTO DOMINGO NUXAÁ,511,OJO DE AGUA,5,260,145,115,19
OAXACA,20,SANTO DOMINGO NUXAÁ,511,RÍO COMAL,2,18,7,11,7
OAXACA,20,SANTO DOMINGO NUXAÁ,511,RÍO GARZA,1,4,2,2,1
OAXACA,20,SANTO DOMINGO NUXAÁ,511,SANTO DOMINGO NUXAÁ,3,155,89,66,12
OAXACA,20,SANTO DOMINGO OZOLOTEPEC,512,EL MIRASOL,1,7,0,7,1
OAXACA,20,SANTO DOMINGO OZOLOTEPEC,512,SANTO DOMINGO OZOLOTEPEC,4,317,183,134,20
OAXACA,20,SANTO DOMINGO PETAPA,513,BARRIO SANTA CRUZ,3,373,193,180,22
OAXACA,20,SANTO DOMINGO PETAPA,513,EL CAMPANARIO,2,28,11,17,2
OAXACA,20,SANTO DOMINGO PETAPA,513,EL TEJÓN,2,22,9,13,9
OAXACA,20,SANTO DOMINGO PETAPA,513,EL ZAPOTE,2,21,11,10,2
OAXACA,20,SANTO DOMINGO PETAPA,513,LA MACETA,3,115,63,52,10
OAXACA,20,SANTO DOMINGO PETAPA,513,RÍO DEL SOL,2,66,31,35,4
OAXACA,20,SANTO DOMINGO PETAPA,513,SAN ISIDRO PLATANILLO,5,245,122,123,15
OAXACA,20,SANTO DOMINGO PETAPA,513,SANTA CRUZ CHAHUITEPEC,3,93,49,44,12
OAXACA,20,SANTO DOMINGO PETAPA,513,SANTO DOMINGO PETAPA,6,1278,706,572,71
OAXACA,20,SANTO DOMINGO PETAPA,513,VISTA HERMOSA,1,15,7,8,1
OAXACA,20,SANTO DOMINGO PETAPA,513,YERBA SANTA,1,15,6,9,5
OAXACA,20,SANTO DOMINGO ROAYAGA,514,SANTO DOMINGO ROAYAGA,3,123,57,66,10
OAXACA,20,SANTO DOMINGO ROAYAGA,514,TONAGUÍA,3,112,58,54,7
OAXACA,20,SANTO DOMINGO TEHUANTEPEC,515,15 DE SEPTIEMBRE,2,175,80,95,11
OAXACA,20,SANTO DOMINGO TEHUANTEPEC,515,AGUASCALIENTES DE MAZATÁN,1,18,8,10,6
OAXACA,20,SANTO DOMINGO TEHUANTEPEC,515,BARRIO LIESA,5,958,504,454,90
OAXACA,20,SANTO DOMINGO TEHUANTEPEC,515,BARRIO SANTA CRUZ,3,591,314,277,32
OAXACA,20,SANTO DOMINGO TEHUANTEPEC,515,BUENOS AIRES,3,82,40,42,11
OAXACA,20,SANTO DOMINGO TEHUANTEPEC,515,CAJÓN DE PIEDRA,3,152,88,64,12
OAXACA,20,SANTO DOMINGO TEHUANTEPEC,515,COLONIA ALEJANDRO CRUZ MARTÍNEZ,2,55,28,27,7
OAXACA,20,SANTO DOMINGO TEHUANTEPEC,515,COLONIA JORDÁN,5,406,209,197,25
OAXACA,20,SANTO DOMINGO TEHUANTEPEC,515,COLONIA LÁZARO CÁRDENAS,1,73,39,34,5
OAXACA,20,SANTO DOMINGO TEHUANTEPEC,515,COLONIA SAN LUIS,3,175,90,85,11
OAXACA,20,SANTO DOMINGO TEHUANTEPEC,515,CONCEPCIÓN BAMBA,3,74,46,28,9
OAXACA,20,SANTO DOMINGO TEHUANTEPEC,515,EJIDO EL JORDÁN,2,54,25,29,5
OAXACA,20,SANTO DOMINGO TEHUANTEPEC,515,EL CAIRO,2,161,80,81,11
OAXACA,20,SANTO DOMINGO TEHUANTEPEC,515,GUELAGUECHI,3,141,62,79,12
OAXACA,20,SANTO DOMINGO TEHUANTEPEC,515,LA NORIA,4,455,223,232,26
OAXACA,20,SANTO DOMINGO TEHUANTEPEC,515,LAS CRUCES,3,45,21,24,4
OAXACA,20,SANTO DOMINGO TEHUANTEPEC,515,LAS LÁMINAS,2,28,13,15,2
OAXACA,20,SANTO DOMINGO TEHUANTEPEC,515,LAS TEJAS [PARAJE],2,6,1,5,1
OAXACA,20,SANTO DOMINGO TEHUANTEPEC,515,MORRO DE MAZATÁN,5,776,401,375,39
OAXACA,20,SANTO DOMINGO TEHUANTEPEC,515,PISHISHI,3,119,62,57,10
OAXACA,20,SANTO DOMINGO TEHUANTEPEC,515,POZORRILLO,1,5,3,2,1
OAXACA,20,SANTO DOMINGO TEHUANTEPEC,515,RINCÓN MORENO,3,225,109,116,14
OAXACA,20,SANTO DOMINGO TEHUANTEPEC,515,RINCÓN TAGOLABA (RINCONCITO),1,2,0,2,1
OAXACA,20,SANTO DOMINGO TEHUANTEPEC,515,SAN JOSÉ EL PARAÍSO,3,124,63,61,12
OAXACA,20,SANTO DOMINGO TEHUANTEPEC,515,SAN VICENTE MAZATÁN,3,104,53,51,7
OAXACA,20,SANTO DOMINGO TEHUANTEPEC,515,SANTA CLARA,3,96,54,42,11
OAXACA,20,SANTO DOMINGO TEHUANTEPEC,515,SANTA CRUZ BAMBA Y GARRAPATERO,4,239,133,106,18
OAXACA,20,SANTO DOMINGO TEHUANTEPEC,515,SANTA CRUZ HIDALGO,2,27,13,14,7
OAXACA,20,SANTO DOMINGO TEHUANTEPEC,515,SANTA GERTRUDIS MIRAMAR,3,323,157,166,22
OAXACA,20,SANTO DOMINGO TEHUANTEPEC,515,SANTA ISABEL DE LA REFORMA,2,66,37,29,9
OAXACA,20,SANTO DOMINGO TEHUANTEPEC,515,SANTA MARÍA NATIVITAS COATLÁN,4,172,85,87,15
OAXACA,20,SANTO DOMINGO TEHUANTEPEC,515,SANTA RITA,2,8,4,4,1
OAXACA,20,SANTO DOMINGO TEHUANTEPEC,515,SANTO DOMINGO TEHUANTEPEC,79,10763,5726,5037,863
OAXACA,20,SANTO DOMINGO TEHUANTEPEC,515,TIERRA NEGRA,2,6,3,3,1
OAXACA,20,SANTO DOMINGO TEHUANTEPEC,515,ZANJÓN Y GARRAPATERO,2,88,48,40,10
OAXACA,20,SANTO DOMINGO TEOJOMULCO,516,CUAJINICUIL,3,39,18,21,10
OAXACA,20,SANTO DOMINGO TEOJOMULCO,516,EL HOYO,3,38,20,18,7
OAXACA,20,SANTO DOMINGO TEOJOMULCO,516,EL IXTACHÉ,2,9,4,5,1
OAXACA,20,SANTO DOMINGO TEOJOMULCO,516,EL LIMÓN,3,10,3,7,2
OAXACA,20,SANTO DOMINGO TEOJOMULCO,516,EL PARAÍSO,3,59,25,34,11
OAXACA,20,SANTO DOMINGO TEOJOMULCO,516,HACIENDA VIEJA,2,26,13,13,2
OAXACA,20,SANTO DOMINGO TEOJOMULCO,516,LA ARENA,3,92,51,41,11
OAXACA,20,SANTO DOMINGO TEOJOMULCO,516,LA CIENEGUILLA,2,10,8,2,1
OAXACA,20,SANTO DOMINGO TEOJOMULCO,516,LA ESTANCIA,3,60,30,30,8
OAXACA,20,SANTO DOMINGO TEOJOMULCO,516,LA LAGUNA,3,27,12,15,8
OAXACA,20,SANTO DOMINGO TEOJOMULCO,516,LAS HUERTAS,4,138,77,61,14
OAXACA,20,SANTO DOMINGO TEOJOMULCO,516,LLANO VERDE,3,40,20,20,3
OAXACA,20,SANTO DOMINGO TEOJOMULCO,516,SAN PABLO,3,26,11,15,3
OAXACA,20,SANTO DOMINGO TEOJOMULCO,516,SANTO DOMINGO TEOJOMULCO,6,810,459,351,46
OAXACA,20,SANTO DOMINGO TEPUXTEPEC,517,CERRO ÍDOLO,1,17,10,7,1
OAXACA,20,SANTO DOMINGO TEPUXTEPEC,517,CERRO PASCLE,2,14,8,6,2
OAXACA,20,SANTO DOMINGO TEPUXTEPEC,517,COLONIA MINAS,3,20,7,13,3
OAXACA,20,SANTO DOMINGO TEPUXTEPEC,517,LLANO CRUCERO,3,282,147,135,13
OAXACA,20,SANTO DOMINGO TEPUXTEPEC,517,LLANO LAGUNA,3,165,74,91,9
OAXACA,20,SANTO DOMINGO TEPUXTEPEC,517,LOMA ESPERANZA,3,66,29,37,3
OAXACA,20,SANTO DOMINGO TEPUXTEPEC,517,LOMA LARGA,2,46,20,26,3
OAXACA,20,SANTO DOMINGO TEPUXTEPEC,517,LOMA LINDA,3,58,28,30,4
OAXACA,20,SANTO DOMINGO TEPUXTEPEC,517,PLAYA CERRO,1,18,6,12,1
OAXACA,20,SANTO DOMINGO TEPUXTEPEC,517,RÍO RAMAL,3,117,43,74,5
OAXACA,20,SANTO DOMINGO TEPUXTEPEC,517,SANTO DOMINGO TEPUXTEPEC,11,846,431,415,43
OAXACA,20,SANTO DOMINGO TEPUXTEPEC,517,SIETE CRUCES,2,9,3,6,1
OAXACA,20,SANTO DOMINGO TEPUXTEPEC,517,TIERRA BLANCA,3,61,34,27,6
OAXACA,20,SANTO DOMINGO TLATAYÁPAM,518,SANTO DOMINGO TLATAYÁPAM,2,12,3,9,3
OAXACA,20,SANTO DOMINGO TOMALTEPEC,519,SANTO DOMINGO TOMALTEPEC,3,396,202,194,21
OAXACA,20,SANTO DOMINGO TONALÁ,520,JUQUILA LOMA LARGA,3,38,23,15,8
OAXACA,20,SANTO DOMINGO TONALÁ,520,SAN ANDRÉS SABINILLO,4,179,96,83,17
OAXACA,20,SANTO DOMINGO TONALÁ,520,SAN ISIDRO LAGUNA SECA,3,42,19,23,14
OAXACA,20,SANTO DOMINGO TONALÁ,520,SAN JUAN REYES,2,35,18,17,8
OAXACA,20,SANTO DOMINGO TONALÁ,520,SAN SEBASTIÁN DEL MONTE,4,328,191,137,24
OAXACA,20,SANTO DOMINGO TONALÁ,520,SANTO DOMINGO TONALÁ,11,830,462,368,76
OAXACA,20,SANTO DOMINGO TONALÁ,520,YETLA DE JUÁREZ,3,232,129,103,16
OAXACA,20,SANTO DOMINGO TONALTEPEC,521,SANTO DOMINGO TONALTEPEC,3,31,15,16,7
OAXACA,20,SANTO DOMINGO XAGACÍA,522,SANTO DOMINGO XAGACÍA,4,328,190,138,39
OAXACA,20,SANTO DOMINGO YANHUITLÁN,523,LA CIENEGUILLA,2,14,6,8,6
OAXACA,20,SANTO DOMINGO YANHUITLÁN,523,SANTO DOMINGO YANHUITLÁN,4,450,228,222,58
OAXACA,20,SANTO DOMINGO YANHUITLÁN,523,XACAÑI,2,9,3,6,2
OAXACA,20,SANTO DOMINGO YODOHINO,524,SANTO DOMINGO YODOHINO,3,51,30,21,5
OAXACA,20,SANTO DOMINGO ZANATEPEC,525,BARRIO CHALACA,1,101,49,52,6
OAXACA,20,SANTO DOMINGO ZANATEPEC,525,CABRESTEADA,2,28,11,17,6
OAXACA,20,SANTO DOMINGO ZANATEPEC,525,CARLOS RAMOS,1,5,3,2,1
OAXACA,20,SANTO DOMINGO ZANATEPEC,525,COLONIA RÍO OSTUTA,3,52,13,39,5
OAXACA,20,SANTO DOMINGO ZANATEPEC,525,COYOTERA,3,141,62,79,12
OAXACA,20,SANTO DOMINGO ZANATEPEC,525,GENERAL PASCUAL FUENTES,3,372,190,182,25
OAXACA,20,SANTO DOMINGO ZANATEPEC,525,HUANACASTAL,4,179,89,90,16
OAXACA,20,SANTO DOMINGO ZANATEPEC,525,SANTO DOMINGO ZANATEPEC,13,2098,1106,992,122
OAXACA,20,SANTO DOMINGO ZANATEPEC,525,YERBA SANTA,4,288,134,154,19
OAXACA,20,SANTOS REYES NOPALA,526,ATOTONILCO,1,36,15,21,2
OAXACA,20,SANTOS REYES NOPALA,526,CAÑADA DE LOS MATUS,3,117,63,54,11
OAXACA,20,SANTOS REYES NOPALA,526,CAÑADA LAS FLORES,2,45,20,25,3
OAXACA,20,SANTOS REYES NOPALA,526,CERRO DE AIRE,5,397,201,196,22
OAXACA,20,SANTOS REYES NOPALA,526,CERRO IGLESIAS,3,31,9,22,3
OAXACA,20,SANTOS REYES NOPALA,526,CERRO NIÑO,1,28,19,9,2
OAXACA,20,SANTOS REYES NOPALA,526,CIÉNEGA GRANDE,3,56,21,35,4
OAXACA,20,SANTOS REYES NOPALA,526,EL AGUACATAL,2,38,20,18,3
OAXACA,20,SANTOS REYES NOPALA,526,EL ARMADILLO (SAN JOSÉ ARMADILLO),2,27,11,16,2
OAXACA,20,SANTOS REYES NOPALA,526,EL CARRIZAL,3,18,9,9,2
OAXACA,20,SANTOS REYES NOPALA,526,EL ZACATAL,1,15,7,8,1
OAXACA,20,SANTOS REYES NOPALA,526,EL ZANATE,2,60,29,31,4
OAXACA,20,SANTOS REYES NOPALA,526,LA HIERBA SANTA,1,3,0,3,1
OAXACA,20,SANTOS REYES NOPALA,526,LA MATRACA,3,95,61,34,6
OAXACA,20,SANTOS REYES NOPALA,526,RANCHO NUEVO CUIXTLA,1,5,3,2,1
OAXACA,20,SANTOS REYES NOPALA,526,SAN ANTONIO CUIXTLA,3,77,42,35,7
OAXACA,20,SANTOS REYES NOPALA,526,SAN GONZALO PUEBLO VIEJO,3,30,12,18,3
OAXACA,20,SANTOS REYES NOPALA,526,SAN ISIDRO CAMPECHERO,1,5,3,2,1
OAXACA,20,SANTOS REYES NOPALA,526,SAN MARCOS ZAPOTALITO (EL ZAPOTE),2,13,4,9,1
OAXACA,20,SANTOS REYES NOPALA,526,SAN MARTÍN PIE DEL CERRO,2,8,5,3,2
OAXACA,20,SANTOS REYES NOPALA,526,SANTA LUCÍA TEOTEPEC,8,595,298,297,33
OAXACA,20,SANTOS REYES NOPALA,526,SANTA MARÍA MAGDALENA TILTEPEC,6,679,329,350,34
OAXACA,20,SANTOS REYES NOPALA,526,SANTIAGO CUIXTLA,5,308,145,163,18
OAXACA,20,SANTOS REYES NOPALA,526,SANTOS REYES NOPALA,15,2064,1084,980,113
OAXACA,20,SANTOS REYES PÁPALO,527,CACALOTEPEC,4,136,72,64,12
OAXACA,20,SANTOS REYES PÁPALO,527,EL GIRASOL,3,41,21,20,3
OAXACA,20,SANTOS REYES PÁPALO,527,SANTOS REYES PÁPALO,4,439,223,216,25
OAXACA,20,SANTOS REYES TEPEJILLO,528,SANTOS REYES TEPEJILLO,3,115,60,55,10
OAXACA,20,SANTOS REYES YUCUNÁ,529,COXCATEPEC,1,12,5,7,4
OAXACA,20,SANTOS REYES YUCUNÁ,529,SAN FRANCISCO DE LAS FLORES,1,18,9,9,6
OAXACA,20,SANTOS REYES YUCUNÁ,529,SAN JOSÉ BUENAVISTA,2,75,41,34,9
OAXACA,20,SANTOS REYES YUCUNÁ,529,SANTIAGO EL JAZMÍN,1,12,4,8,1
OAXACA,20,SANTOS REYES YUCUNÁ,529,SANTOS REYES YUCUNÁ,3,225,129,96,14
OAXACA,20,SANTO TOMÁS JALIEZA,530,SANTA CECILIA JALIEZA,3,274,155,119,18
OAXACA,20,SANTO TOMÁS JALIEZA,530,SANTO DOMINGO JALIEZA,4,354,186,168,23
OAXACA,20,SANTO TOMÁS JALIEZA,530,SANTO TOMÁS JALIEZA,3,237,137,100,19
OAXACA,20,SANTO TOMÁS MAZALTEPEC,531,SANTO TOMÁS MAZALTEPEC,4,463,258,205,30
OAXACA,20,SANTO TOMÁS OCOTEPEC,532,BENITO JUÁREZ,2,39,22,17,3
OAXACA,20,SANTO TOMÁS OCOTEPEC,532,DIECINUEVE DE ABRIL,3,151,70,81,9
OAXACA,20,SANTO TOMÁS OCOTEPEC,532,EMILIO PORTES GIL,3,75,31,44,5
OAXACA,20,SANTO TOMÁS OCOTEPEC,532,FRANCISCO VILLA,1,13,6,7,1
OAXACA,20,SANTO TOMÁS OCOTEPEC,532,LAGUNA AMARILLA,2,21,9,12,2
OAXACA,20,SANTO TOMÁS OCOTEPEC,532,LÁZARO CÁRDENAS,2,31,18,13,2
OAXACA,20,SANTO TOMÁS OCOTEPEC,532,MIGUEL HIDALGO,2,67,37,30,5
OAXACA,20,SANTO TOMÁS OCOTEPEC,532,MORELOS,1,16,11,5,1
OAXACA,20,SANTO TOMÁS OCOTEPEC,532,NUNUMA,4,139,63,76,8
OAXACA,20,SANTO TOMÁS OCOTEPEC,532,PLAN ALEMÁN,3,98,45,53,7
OAXACA,20,SANTO TOMÁS OCOTEPEC,532,SANTO TOMÁS OCOTEPEC,4,366,185,181,24
OAXACA,20,SANTO TOMÁS TAMAZULAPAN,533,CERRO DE TEPALCATILLOS,2,5,4,1,1
OAXACA,20,SANTO TOMÁS TAMAZULAPAN,533,EL CERRITO,3,95,53,42,10
OAXACA,20,SANTO TOMÁS TAMAZULAPAN,533,LOS MANANTIALES,2,34,17,17,9
OAXACA,20,SANTO TOMÁS TAMAZULAPAN,533,SAN JERÓNIMO MIAHUATLÁN,3,31,17,14,7
OAXACA,20,SANTO TOMÁS TAMAZULAPAN,533,SANTO TOMÁS TAMAZULAPAN,3,463,273,190,22
OAXACA,20,SAN VICENTE COATLÁN,534,SAN ISIDRO LA CAÑADA,1,22,10,12,6
OAXACA,20,SAN VICENTE COATLÁN,534,SAN VICENTE COATLÁN,6,837,439,398,42
OAXACA,20,SAN VICENTE LACHIXÍO,535,EJIDO EL RINCÓN,4,390,205,185,23
OAXACA,20,SAN VICENTE LACHIXÍO,535,SAN VICENTE LACHIXÍO,4,514,256,258,25
OAXACA,20,SAN VICENTE NUÑÚ,536,ANAMÁ,1,4,1,3,1
OAXACA,20,SAN VICENTE NUÑÚ,536,SAN VICENTE NUÑÚ,2,52,22,30,5
OAXACA,20,SILACAYOÁPAM,537,BARRIO DE LA PROVIDENCIA,2,8,3,5,1
OAXACA,20,SILACAYOÁPAM,537,EL CARMEN,3,66,31,35,7
OAXACA,20,SILACAYOÁPAM,537,LOS REYES MICHAPA,2,21,11,10,1
OAXACA,20,SILACAYOÁPAM,537,RANCHO ALFARO,3,47,18,29,6
OAXACA,20,SILACAYOÁPAM,537,RANCHO VARGAS,1,18,8,10,6
OAXACA,20,SILACAYOÁPAM,537,SAN ANDRÉS MONTAÑA,3,81,41,40,7
OAXACA,20,SILACAYOÁPAM,537,SAN ANTONIO,1,16,8,8,1
OAXACA,20,SILACAYOÁPAM,537,SAN ISIDRO,1,14,7,7,1
OAXACA,20,SILACAYOÁPAM,537,SAN JERÓNIMO PROGRESO,2,46,25,21,5
OAXACA,20,SILACAYOÁPAM,537,SAN JUAN HUAXTEPEC,3,87,47,40,12
OAXACA,20,SILACAYOÁPAM,537,SAN JUAN TRUJANO,2,21,8,13,4
OAXACA,20,SILACAYOÁPAM,537,SAN MARTÍN DEL ESTADO,3,88,46,42,5
OAXACA,20,SILACAYOÁPAM,537,SAN MIGUEL AGUACATES,1,11,7,4,1
OAXACA,20,SILACAYOÁPAM,537,SAN SEBASTIÁN,1,11,8,3,1
OAXACA,20,SILACAYOÁPAM,537,SAN SEBASTIÁN ZOQUIÁPAM,3,131,76,55,9
OAXACA,20,SILACAYOÁPAM,537,SAN VICENTE DEL ZAPOTE,2,21,9,12,9
OAXACA,20,SILACAYOÁPAM,537,SANTIAGO ASUNCIÓN,3,75,40,35,4
OAXACA,20,SILACAYOÁPAM,537,SANTIAGO PATLANALÁ,2,40,15,25,5
OAXACA,20,SILACAYOÁPAM,537,SILACAYOÁPAM,4,740,394,346,45
OAXACA,20,SITIO DE XITLAPEHUA,538,SAÚZ,1,18,7,11,1
OAXACA,20,SITIO DE XITLAPEHUA,538,SITIO DE XITLAPEHUA,3,173,96,77,10
OAXACA,20,SOLEDAD ETLA,539,ESTANZUELA,2,123,63,60,8
OAXACA,20,SOLEDAD ETLA,539,MATADAMAS,2,237,123,114,15
OAXACA,20,SOLEDAD ETLA,539,SOLEDAD ETLA,6,1717,1065,652,219
OAXACA,20,VILLA DE TAMAZULÁPAM DEL PROGRESO,540,EL TEJÓN,2,20,12,8,2
OAXACA,20,VILLA DE TAMAZULÁPAM DEL PROGRESO,540,LA RAYA,1,5,3,2,1
OAXACA,20,VILLA DE TAMAZULÁPAM DEL PROGRESO,540,LAS PILAS,1,11,6,5,1
OAXACA,20,VILLA DE TAMAZULÁPAM DEL PROGRESO,540,RÍO DEL ORO,2,29,15,14,4
OAXACA,20,VILLA DE TAMAZULÁPAM DEL PROGRESO,540,TANDIQUE,1,10,5,5,1
OAXACA,20,VILLA DE TAMAZULÁPAM DEL PROGRESO,540,VILLA DE TAMAZULÁPAM DEL PROGRESO,17,2811,1589,1222,218
OAXACA,20,VILLA DE TAMAZULÁPAM DEL PROGRESO,540,XACAHUA,2,26,13,13,5
OAXACA,20,VILLA DE TAMAZULÁPAM DEL PROGRESO,540,XATÁN,1,3,2,1,1
OAXACA,20,TANETZE DE ZARAGOZA,541,SANTA MARÍA YAVICHE,5,252,131,121,20
OAXACA,20,TANETZE DE ZARAGOZA,541,TANETZE DE ZARAGOZA,4,183,97,86,13
OAXACA,20,TANICHE,542,TANICHE,2,146,83,63,13
OAXACA,20,TATALTEPEC DE VALDÉS,543,EL OCOTE O LA PALMA,3,42,24,18,3
OAXACA,20,TATALTEPEC DE VALDÉS,543,EL OCOTILLO,1,6,4,2,1
OAXACA,20,TATALTEPEC DE VALDÉS,543,PLAN DEL AIRE,3,56,25,31,4
OAXACA,20,TATALTEPEC DE VALDÉS,543,SANTA CRUZ TEPENIXTLAHUACA,8,988,493,495,44
OAXACA,20,TATALTEPEC DE VALDÉS,543,TATALTEPEC DE VALDÉS,8,667,349,318,42
OAXACA,20,TEOCOCUILCO DE MARCOS PÉREZ,544,ARROYO GUACAMAYA,1,10,5,5,1
OAXACA,20,TEOCOCUILCO DE MARCOS PÉREZ,544,TEOCOCUILCO DE MARCOS PÉREZ,4,163,88,75,13
OAXACA,20,TEOTITLÁN DE FLORES MAGÓN,545,CERRO VERDE,1,13,8,5,1
OAXACA,20,TEOTITLÁN DE FLORES MAGÓN,545,IGNACIO MEJÍA,3,90,42,48,10
OAXACA,20,TEOTITLÁN DE FLORES MAGÓN,545,SAN BERNARDINO,2,35,17,18,9
OAXACA,20,TEOTITLÁN DE FLORES MAGÓN,545,TEOTITLÁN DE FLORES MAGÓN,17,2952,1562,1390,227
OAXACA,20,TEOTITLÁN DE FLORES MAGÓN,545,VIGASTEPEC,1,15,8,7,1
OAXACA,20,TEOTITLÁN DEL VALLE,546,SANTIAGO IXTALTEPEC,3,309,178,131,9
OAXACA,20,TEOTITLÁN DEL VALLE,546,TEOTITLÁN DEL VALLE,5,1330,664,666,62
OAXACA,20,TEOTONGO,547,EL PROGRESO,1,11,6,5,2
OAXACA,20,TEOTONGO,547,LA LUZ,1,20,10,10,3
OAXACA,20,TEOTONGO,547,LA MATANZA,1,13,5,8,1
OAXACA,20,TEOTONGO,547,TEOTONGO,5,326,180,146,23
OAXACA,20,TEPELMEME VILLA DE MORELOS,548,EL RODEO,1,22,6,16,2
OAXACA,20,TEPELMEME VILLA DE MORELOS,548,LA UNIÓN,2,22,7,15,3
OAXACA,20,TEPELMEME VILLA DE MORELOS,548,LAS FLORES,2,22,14,8,3
OAXACA,20,TEPELMEME VILLA DE MORELOS,548,MAHUIZAPA,1,4,1,3,1
OAXACA,20,TEPELMEME VILLA DE MORELOS,548,PUERTO MIXTECO,1,21,10,11,2
OAXACA,20,TEPELMEME VILLA DE MORELOS,548,TEPELMEME VILLA DE MORELOS,4,386,200,186,26
OAXACA,20,TEPELMEME VILLA DE MORELOS,548,TORRECILLA,1,19,7,12,3
OAXACA,20,"HEROICA VILLA TEZOATLÁN DE SEGURA Y LUNA, CUNA DE LA INDEPENDENCIA DE OAXACA",549,CUESTA BLANCA,3,74,34,40,6
OAXACA,20,"HEROICA VILLA TEZOATLÁN DE SEGURA Y LUNA, CUNA DE LA INDEPENDENCIA DE OAXACA",549,GUADALUPE DE CISNEROS,2,35,18,17,9
OAXACA,20,"HEROICA VILLA TEZOATLÁN DE SEGURA Y LUNA, CUNA DE LA INDEPENDENCIA DE OAXACA",549,"HEROICA VILLA TEZOATLÁN DE SEGURA Y LUNA, CUNA DE LA INDEPENDENCIA DE OAXACA",9,817,454,363,72
OAXACA,20,"HEROICA VILLA TEZOATLÁN DE SEGURA Y LUNA, CUNA DE LA INDEPENDENCIA DE OAXACA",549,JUQUILA DE LEÓN,3,132,64,68,15
OAXACA,20,"HEROICA VILLA TEZOATLÁN DE SEGURA Y LUNA, CUNA DE LA INDEPENDENCIA DE OAXACA",549,LAS PEÑAS,1,22,11,11,6
OAXACA,20,"HEROICA VILLA TEZOATLÁN DE SEGURA Y LUNA, CUNA DE LA INDEPENDENCIA DE OAXACA",549,RANCHO JUÁREZ,3,85,38,47,4
OAXACA,20,"HEROICA VILLA TEZOATLÁN DE SEGURA Y LUNA, CUNA DE LA INDEPENDENCIA DE OAXACA",549,ROSARIO DE NUEVO,2,14,6,8,2
OAXACA,20,"HEROICA VILLA TEZOATLÁN DE SEGURA Y LUNA, CUNA DE LA INDEPENDENCIA DE OAXACA",549,SAN ANDRÉS YUTATÍO,4,198,106,92,14
OAXACA,20,"HEROICA VILLA TEZOATLÁN DE SEGURA Y LUNA, CUNA DE LA INDEPENDENCIA DE OAXACA",549,SAN ISIDRO EL NARANJO,2,47,24,23,9
OAXACA,20,"HEROICA VILLA TEZOATLÁN DE SEGURA Y LUNA, CUNA DE LA INDEPENDENCIA DE OAXACA",549,SAN ISIDRO ZARAGOZA,3,57,35,22,3
OAXACA,20,"HEROICA VILLA TEZOATLÁN DE SEGURA Y LUNA, CUNA DE LA INDEPENDENCIA DE OAXACA",549,SAN JUAN CUITITÓ,3,333,169,164,24
OAXACA,20,"HEROICA VILLA TEZOATLÁN DE SEGURA Y LUNA, CUNA DE LA INDEPENDENCIA DE OAXACA",549,SAN JUAN DIQUIYÚ,4,119,64,55,13
OAXACA,20,"HEROICA VILLA TEZOATLÁN DE SEGURA Y LUNA, CUNA DE LA INDEPENDENCIA DE OAXACA",549,SAN MARCOS DE GARZÓN,4,67,40,27,6
OAXACA,20,"HEROICA VILLA TEZOATLÁN DE SEGURA Y LUNA, CUNA DE LA INDEPENDENCIA DE OAXACA",549,SAN MARTÍN DEL RÍO,3,80,39,41,10
OAXACA,20,"HEROICA VILLA TEZOATLÁN DE SEGURA Y LUNA, CUNA DE LA INDEPENDENCIA DE OAXACA",549,SAN VALENTÍN GÓMEZ,2,20,11,9,2
OAXACA,20,"HEROICA VILLA TEZOATLÁN DE SEGURA Y LUNA, CUNA DE LA INDEPENDENCIA DE OAXACA",549,SAN VICENTE DEL PALMAR,2,36,17,19,7
OAXACA,20,"HEROICA VILLA TEZOATLÁN DE SEGURA Y LUNA, CUNA DE LA INDEPENDENCIA DE OAXACA",549,SANTA CATARINA YUTANDÚ,2,32,16,16,8
OAXACA,20,"HEROICA VILLA TEZOATLÁN DE SEGURA Y LUNA, CUNA DE LA INDEPENDENCIA DE OAXACA",549,SANTA CRUZ NUMÁ,2,37,19,18,7
OAXACA,20,"HEROICA VILLA TEZOATLÁN DE SEGURA Y LUNA, CUNA DE LA INDEPENDENCIA DE OAXACA",549,SANTA MARÍA TINDÚ,3,67,38,29,10
OAXACA,20,"HEROICA VILLA TEZOATLÁN DE SEGURA Y LUNA, CUNA DE LA INDEPENDENCIA DE OAXACA",549,YUCUÑUTI DE BENITO JUÁREZ,4,183,102,81,12
OAXACA,20,"HEROICA VILLA TEZOATLÁN DE SEGURA Y LUNA, CUNA DE LA INDEPENDENCIA DE OAXACA",549,YUCUQUIMI DE OCAMPO,10,422,227,195,34
OAXACA,20,SAN JERÓNIMO TLACOCHAHUAYA,550,MACUILXÓCHITL DE ARTIGAS CARRANZA,4,485,257,228,28
OAXACA,20,SAN JERÓNIMO TLACOCHAHUAYA,550,SAN JERÓNIMO TLACOCHAHUAYA,4,773,452,321,50
OAXACA,20,TLACOLULA DE MATAMOROS,551,CIUDAD YAGUL [FRACCIONAMIENTO],2,323,159,164,16
OAXACA,20,TLACOLULA DE MATAMOROS,551,DAINZÚ [FRACCIONAMIENTO],2,165,87,78,11
OAXACA,20,TLACOLULA DE MATAMOROS,551,DOCE DE MAYO [UNIDAD HABITACIONAL],2,245,119,126,15
OAXACA,20,TLACOLULA DE MATAMOROS,551,LOMAS DE SANTA ANA [COLONIA],2,56,30,26,4
OAXACA,20,TLACOLULA DE MATAMOROS,551,RANCHO VALLE DEL LAGO [FRACCIONAMIENTO],2,117,59,58,10
OAXACA,20,TLACOLULA DE MATAMOROS,551,SAN LUIS DEL RÍO,4,131,67,64,12
OAXACA,20,TLACOLULA DE MATAMOROS,551,SAN MARCOS TLAPAZOLA,4,108,52,56,8
OAXACA,20,TLACOLULA DE MATAMOROS,551,TANIVÉ,2,28,16,12,3
OAXACA,20,TLACOLULA DE MATAMOROS,551,TLACOLULA DE MATAMOROS,32,5352,2785,2567,308
OAXACA,20,TLACOLULA DE MATAMOROS,551,YAGAY [COLONIA],1,61,34,27,4
OAXACA,20,TLACOTEPEC PLUMAS,552,ORGANAL,1,20,12,8,3
OAXACA,20,TLACOTEPEC PLUMAS,552,TLACOTEPEC PLUMAS,2,54,23,31,7
OAXACA,20,TLALIXTAC DE CABRERA,553,CAMINO DEL REMOLINO [PARAJE],1,20,8,12,6
OAXACA,20,TLALIXTAC DE CABRERA,553,SANTA CATALINA DE SENA,1,13,7,6,3
OAXACA,20,TLALIXTAC DE CABRERA,553,TLALIXTAC DE CABRERA,14,2961,1600,1361,340
OAXACA,20,TOTONTEPEC VILLA DE MORELOS,554,SAN FRANCISCO JAYACAXTEPEC,3,211,113,98,12
OAXACA,20,TOTONTEPEC VILLA DE MORELOS,554,SAN JOSÉ CHINANTEQUILLA,3,123,61,62,9
OAXACA,20,TOTONTEPEC VILLA DE MORELOS,554,SAN MARCOS MOCTUM,2,32,16,16,4
OAXACA,20,TOTONTEPEC VILLA DE MORELOS,554,SAN MIGUEL METEPEC,3,50,28,22,3
OAXACA,20,TOTONTEPEC VILLA DE MORELOS,554,SANTA MARÍA HUITEPEC,2,36,16,20,2
OAXACA,20,TOTONTEPEC VILLA DE MORELOS,554,SANTA MARÍA OCOTEPEC,2,31,17,14,2
OAXACA,20,TOTONTEPEC VILLA DE MORELOS,554,SANTA MARÍA TILTEPEC,3,146,64,82,9
OAXACA,20,TOTONTEPEC VILLA DE MORELOS,554,SANTIAGO AMATEPEC,3,92,40,52,6
OAXACA,20,TOTONTEPEC VILLA DE MORELOS,554,SANTIAGO JARETA,2,38,19,19,4
OAXACA,20,TOTONTEPEC VILLA DE MORELOS,554,SANTIAGO TEPITONGO,4,210,109,101,12
OAXACA,20,TOTONTEPEC VILLA DE MORELOS,554,TOTONTEPEC VILLA DE MORELOS,6,603,303,300,35
OAXACA,20,TRINIDAD ZAACHILA,555,SAN MIGUEL TLANICHICO,3,127,74,53,11
OAXACA,20,TRINIDAD ZAACHILA,555,SANTA MARÍA ROALÓ,4,187,102,85,18
OAXACA,20,TRINIDAD ZAACHILA,555,TRINIDAD ZAACHILA,4,211,116,95,17
OAXACA,20,LA TRINIDAD VISTA HERMOSA,556,LA TRINIDAD VISTA HERMOSA,2,33,12,21,5
OAXACA,20,UNIÓN HIDALGO,557,UNIÓN HIDALGO,21,3515,1721,1794,192
OAXACA,20,VALERIO TRUJANO,558,TOMELLÍN,3,118,65,53,12
OAXACA,20,VALERIO TRUJANO,558,VALERIO TRUJANO,3,124,66,58,12
OAXACA,20,SAN JUAN BAUTISTA VALLE NACIONAL,559,ARROYO COLORADO,2,39,21,18,2
OAXACA,20,SAN JUAN BAUTISTA VALLE NACIONAL,559,ARROYO DE BANCO,6,384,188,196,25
OAXACA,20,SAN JUAN BAUTISTA VALLE NACIONAL,559,ARROYO SECO,1,53,27,26,2
OAXACA,20,SAN JUAN BAUTISTA VALLE NACIONAL,559,ARROYO TORTUGA,3,63,33,30,4
OAXACA,20,SAN JUAN BAUTISTA VALLE NACIONAL,559,CERRO ARMADILLO CHICO,2,14,6,8,2
OAXACA,20,SAN JUAN BAUTISTA VALLE NACIONAL,559,CERRO ARMADILLO GRANDE,7,367,175,192,22
OAXACA,20,SAN JUAN BAUTISTA VALLE NACIONAL,559,CERRO CANGREJO,2,26,14,12,2
OAXACA,20,SAN JUAN BAUTISTA VALLE NACIONAL,559,CERRO CANGREJO GRANDE,2,32,16,16,2
OAXACA,20,SAN JUAN BAUTISTA VALLE NACIONAL,559,CERRO MARÍN,4,173,78,95,11
OAXACA,20,SAN JUAN BAUTISTA VALLE NACIONAL,559,CERRO MIRADOR,3,60,30,30,4
OAXACA,20,SAN JUAN BAUTISTA VALLE NACIONAL,559,COLONIA NUEVO VALLE REAL,1,19,13,6,1
OAXACA,20,SAN JUAN BAUTISTA VALLE NACIONAL,559,EL CASTILLO,5,63,27,36,8
OAXACA,20,SAN JUAN BAUTISTA VALLE NACIONAL,559,LA NUEVA ESPERANZA,3,59,32,27,6
OAXACA,20,SAN JUAN BAUTISTA VALLE NACIONAL,559,LA RINCONADA,3,174,88,86,13
OAXACA,20,SAN JUAN BAUTISTA VALLE NACIONAL,559,LA TRINIDAD (HONDURA DE NANCHE),1,8,3,5,2
OAXACA,20,SAN JUAN BAUTISTA VALLE NACIONAL,559,LOMA SAN RAFAEL,3,86,39,47,6
OAXACA,20,SAN JUAN BAUTISTA VALLE NACIONAL,559,LOMA SANTA FE,2,27,17,10,2
OAXACA,20,SAN JUAN BAUTISTA VALLE NACIONAL,559,MIGUEL HIDALGO,2,20,14,6,3
OAXACA,20,SAN JUAN BAUTISTA VALLE NACIONAL,559,MONTE BELLO,1,15,8,7,1
OAXACA,20,SAN JUAN BAUTISTA VALLE NACIONAL,559,MONTE FLOR,2,29,14,15,2
OAXACA,20,SAN JUAN BAUTISTA VALLE NACIONAL,559,MONTE NEGRO,2,41,23,18,4
OAXACA,20,SAN JUAN BAUTISTA VALLE NACIONAL,559,NUEVO PALANTLA,3,35,19,16,3
OAXACA,20,SAN JUAN BAUTISTA VALLE NACIONAL,559,PASO DEL JOBO,1,8,4,4,1
OAXACA,20,SAN JUAN BAUTISTA VALLE NACIONAL,559,PASO NUEVO LA HAMACA,5,205,107,98,22
OAXACA,20,SAN JUAN BAUTISTA VALLE NACIONAL,559,PLAN DE LAS FLORES,3,76,34,42,5
OAXACA,20,SAN JUAN BAUTISTA VALLE NACIONAL,559,RANCHO CAFETAL,2,24,13,11,2
OAXACA,20,SAN JUAN BAUTISTA VALLE NACIONAL,559,RANCHO GRANDE,2,22,8,14,2
OAXACA,20,SAN JUAN BAUTISTA VALLE NACIONAL,559,RANCHO OJOCHE,3,67,25,42,5
OAXACA,20,SAN JUAN BAUTISTA VALLE NACIONAL,559,RANCHO PÉREZ,1,4,1,3,1
OAXACA,20,SAN JUAN BAUTISTA VALLE NACIONAL,559,SAN ANTONIO OCOTE,3,89,43,46,5
OAXACA,20,SAN JUAN BAUTISTA VALLE NACIONAL,559,SAN ANTONIO OTATE,4,94,58,36,7
OAXACA,20,SAN JUAN BAUTISTA VALLE NACIONAL,559,SAN CRISTÓBAL LA VEGA,1,44,24,20,3
OAXACA,20,SAN JUAN BAUTISTA VALLE NACIONAL,559,SAN FELIPE DE LEÓN,4,219,116,103,13
OAXACA,20,SAN JUAN BAUTISTA VALLE NACIONAL,559,SAN ISIDRO CHINANTILLA,3,201,104,97,17
OAXACA,20,SAN JUAN BAUTISTA VALLE NACIONAL,559,SAN ISIDRO LAGUNA,2,22,10,12,2
OAXACA,20,SAN JUAN BAUTISTA VALLE NACIONAL,559,SAN JUAN BAUTISTA VALLE NACIONAL,17,2543,1349,1194,171
OAXACA,20,SAN JUAN BAUTISTA VALLE NACIONAL,559,SAN JUAN PALANTLA,4,152,81,71,8
OAXACA,20,SAN JUAN BAUTISTA VALLE NACIONAL,559,SAN LUCAS ARROYO PALOMO,4,104,51,53,8
OAXACA,20,SAN JUAN BAUTISTA VALLE NACIONAL,559,SAN MATEO YETLA,2,86,38,48,9
OAXACA,20,SAN JUAN BAUTISTA VALLE NACIONAL,559,SAN MIGUEL METATES,2,10,8,2,1
OAXACA,20,SAN JUAN BAUTISTA VALLE NACIONAL,559,SAN RAFAEL AGUA DE PESCADITO,5,182,84,98,15
OAXACA,20,SAN JUAN BAUTISTA VALLE NACIONAL,559,SANTIAGO PROGRESO,3,118,69,49,13
OAXACA,20,VILLA DÍAZ ORDAZ,560,EL CARRIZAL,2,30,18,12,2
OAXACA,20,VILLA DÍAZ ORDAZ,560,SAN MIGUEL DEL VALLE,6,646,349,297,32
OAXACA,20,VILLA DÍAZ ORDAZ,560,SANTA CATARINA ALBARRADAS,4,78,38,40,7
OAXACA,20,VILLA DÍAZ ORDAZ,560,VILLA DÍAZ ORDAZ,4,445,220,225,25
OAXACA,20,YAXE,561,YAXE,5,638,358,280,41
OAXACA,20,MAGDALENA YODOCONO DE PORFIRIO DÍAZ,562,MAGDALENA YODOCONO DE PORFIRIO DÍAZ,4,428,211,217,23
OAXACA,20,MAGDALENA YODOCONO DE PORFIRIO DÍAZ,562,SANTA CRUZ YODOCONO,2,105,60,45,9
OAXACA,20,YOGANA,563,YOGANA,4,247,132,115,17
OAXACA,20,YUTANDUCHI DE GUERRERO,564,YUTANDUCHI DE GUERRERO,5,369,207,162,23
OAXACA,20,VILLA DE ZAACHILA,565,COLONIA DEL BOSQUE,1,23,12,11,1
OAXACA,20,VILLA DE ZAACHILA,565,COLONIA VALLE DORADO,1,51,28,23,6
OAXACA,20,VILLA DE ZAACHILA,565,EL MANANTIAL [COLONIA],2,241,131,110,14
OAXACA,20,VILLA DE ZAACHILA,565,EMILIANO ZAPATA,2,199,104,95,8
OAXACA,20,VILLA DE ZAACHILA,565,IMPULSSO [COLONIA],1,49,23,26,3
OAXACA,20,VILLA DE ZAACHILA,565,RANCHO VIEJO,1,169,86,83,6
OAXACA,20,VILLA DE ZAACHILA,565,RENACIMIENTO,1,61,31,30,3
OAXACA,20,VILLA DE ZAACHILA,565,SAN LUCAS TLANICHICO,3,119,72,47,10
OAXACA,20,VILLA DE ZAACHILA,565,SAN PEDRO LA REFORMA,1,49,28,21,3
OAXACA,20,VILLA DE ZAACHILA,565,VICENTE GUERRERO,6,812,476,336,50
OAXACA,20,VILLA DE ZAACHILA,565,VILLA DE ZAACHILA,43,8134,4409,3725,496
OAXACA,20,VILLA DE ZAACHILA,565,ZAACHILA SEGUNDO,2,22,9,13,2
OAXACA,20,SAN MATEO YUCUTINDOO,566,BAJA CALIFORNIA,2,47,25,22,7
OAXACA,20,SAN MATEO YUCUTINDOO,566,BENITO JUÁREZ,3,87,39,48,9
OAXACA,20,SAN MATEO YUCUTINDOO,566,EL FRIJOL,2,36,19,17,7
OAXACA,20,SAN MATEO YUCUTINDOO,566,EL LIMÓN,2,44,21,23,7
OAXACA,20,SAN MATEO YUCUTINDOO,566,EL SABINO,3,46,17,29,8
OAXACA,20,SAN MATEO YUCUTINDOO,566,LAS FLORES,3,16,7,9,3
OAXACA,20,SAN MATEO YUCUTINDOO,566,PUEBLO VIEJO,2,69,36,33,8
OAXACA,20,SAN MATEO YUCUTINDOO,566,SAN MATEO YUCUTINDOO,4,362,174,188,22
OAXACA,20,SAN MATEO YUCUTINDOO,566,ZAPOTITLÁN DEL RÍO,4,160,76,84,13
OAXACA,20,ZAPOTITLÁN LAGUNAS,567,GUADALUPE BUENOS AIRES,1,16,7,9,6
OAXACA,20,ZAPOTITLÁN LAGUNAS,567,GUADALUPE DEL RECREO,3,127,68,59,12
OAXACA,20,ZAPOTITLÁN LAGUNAS,567,SAN JOSÉ EL GUAMUCHIL,3,39,19,20,8
OAXACA,20,ZAPOTITLÁN LAGUNAS,567,SAN MIGUEL HIDALGO,1,64,36,28,6
OAXACA,20,ZAPOTITLÁN LAGUNAS,567,SAN PEDRO CUAXOXOCATLA,3,43,26,17,8
OAXACA,20,ZAPOTITLÁN LAGUNAS,567,SANTA CRUZ VISTA HERMOSA,3,75,39,36,10
OAXACA,20,ZAPOTITLÁN LAGUNAS,567,TLACOTEPEC LAGUNAS,2,27,12,15,7
OAXACA,20,ZAPOTITLÁN LAGUNAS,567,ZAPOTITLÁN LAGUNAS,4,483,277,206,33
OAXACA,20,ZAPOTITLÁN PALMAS,568,ZAPOTITLÁN PALMAS,7,435,232,203,25
OAXACA,20,SANTA INÉS DE ZARAGOZA,569,LA PAZ,2,17,6,11,9
OAXACA,20,SANTA INÉS DE ZARAGOZA,569,LA REFORMA,1,6,0,6,1
OAXACA,20,SANTA INÉS DE ZARAGOZA,569,LA UNIÓN ZARAGOZA,3,56,29,27,12
OAXACA,20,SANTA INÉS DE ZARAGOZA,569,SANTA INÉS DE ZARAGOZA,4,273,149,124,16
OAXACA,20,ZIMATLÁN DE ÁLVAREZ,570,EL ROSARIO,1,17,8,9,5
OAXACA,20,ZIMATLÁN DE ÁLVAREZ,570,EL TLACUACHE,2,48,31,17,4
OAXACA,20,ZIMATLÁN DE ÁLVAREZ,570,LA CUMBRE CLAVELLINAS,4,105,48,57,6
OAXACA,20,ZIMATLÁN DE ÁLVAREZ,570,LA RAYA,2,43,22,21,9
OAXACA,20,ZIMATLÁN DE ÁLVAREZ,570,LAS HUERTAS,1,19,9,10,1
OAXACA,20,ZIMATLÁN DE ÁLVAREZ,570,LAS JUNTAS,1,26,12,14,2
OAXACA,20,ZIMATLÁN DE ÁLVAREZ,570,SAN JOSÉ GUELATOVÁ DE DÍAZ,2,64,35,29,9
OAXACA,20,ZIMATLÁN DE ÁLVAREZ,570,SAN NICOLÁS QUIALANA,2,178,104,74,12
OAXACA,20,ZIMATLÁN DE ÁLVAREZ,570,SAN PEDRO EL ALTO,4,487,266,221,27
OAXACA,20,ZIMATLÁN DE ÁLVAREZ,570,SAN PEDRO TOTOMACHÁPAM,3,98,51,47,14
OAXACA,20,ZIMATLÁN DE ÁLVAREZ,570,SAN SEBASTIÁN RÍO DULCE,3,79,41,38,9
OAXACA,20,ZIMATLÁN DE ÁLVAREZ,570,SANTA MARÍA VIGALLO,3,181,103,78,14
OAXACA,20,ZIMATLÁN DE ÁLVAREZ,570,SANTIAGO CLAVELLINAS,3,82,46,36,10
OAXACA,20,ZIMATLÁN DE ÁLVAREZ,570,VALDEFLORES,5,238,126,112,23
OAXACA,20,ZIMATLÁN DE ÁLVAREZ,570,ZIMATLÁN DE ÁLVAREZ,13,3267,1858,1409,257
PUEBLA,21,ACAJETE,001,ACAJETE,32,8058,4171,3887,312
PUEBLA,21,ACAJETE,001,APANGO DE ZARAGOZA,4,638,311,327,25
PUEBLA,21,ACAJETE,001,BUENAVISTA,2,20,9,11,2
PUEBLA,21,ACAJETE,001,LA CARDENISTA (COLONIA LÁZARO CÁRDENAS),2,36,16,20,3
PUEBLA,21,ACAJETE,001,LA MAGDALENA TETELA MORELOS,9,3079,1520,1559,120
PUEBLA,21,ACAJETE,001,LA PROVIDENCIA,2,21,9,12,2
PUEBLA,21,ACAJETE,001,NUESTRA SEÑORA DEL MONTE,1,12,11,1,1
PUEBLA,21,ACAJETE,001,SAN AGUSTÍN TLAXCO,5,1795,889,906,60
PUEBLA,21,ACAJETE,001,SAN ANTONIO TLACAMILCO,1,230,128,102,9
PUEBLA,21,ACAJETE,001,SAN BARTOLO PINAL,1,112,56,56,3
PUEBLA,21,ACAJETE,001,SAN JAVIER,2,15,9,6,2
PUEBLA,21,ACAJETE,001,SAN JERÓNIMO OCOTITLÁN,7,988,504,484,52
PUEBLA,21,ACAJETE,001,SAN JOSÉ EL TINTERO,2,24,15,9,2
PUEBLA,21,ACAJETE,001,SAN JUAN TEPULCO,8,2789,1389,1400,93
PUEBLA,21,ACAJETE,001,SAN MARTÍN LA JOYA,2,65,33,32,4
PUEBLA,21,ACAJETE,001,SANTA ISABEL TEPETZALA,2,506,245,261,27
PUEBLA,21,ACAJETE,001,SANTA MARÍA NENETZINTLA,5,1073,558,515,42
PUEBLA,21,ACAJETE,001,TLACAMILCO,1,122,58,64,6
PUEBLA,21,ACATENO,002,AMPLIACIÓN TILAPA EJIDO,1,12,3,9,1
PUEBLA,21,ACATENO,002,ARROYO BLANCO,2,47,25,22,2
PUEBLA,21,ACATENO,002,CHICHICAZAPAN,1,56,33,23,2
PUEBLA,21,ACATENO,002,DOS AGUAS,1,63,31,32,3
PUEBLA,21,ACATENO,002,DOS CAMINOS,3,83,41,42,8
PUEBLA,21,ACATENO,002,JILIAPAN,4,236,131,105,13
PUEBLA,21,ACATENO,002,LA NUEVA ESPERANZA (PLÁCIDO RÍOS),2,14,7,7,2
PUEBLA,21,ACATENO,002,MONTE LIMPIO,2,26,7,19,2
PUEBLA,21,ACATENO,002,PALMARTEPEC (CERRO DE PALMARTEPEC),4,85,57,28,6
PUEBLA,21,ACATENO,002,PALO GACHO,2,30,18,12,4
PUEBLA,21,ACATENO,002,PALO GACHO [EJIDO],4,97,49,48,8
PUEBLA,21,ACATENO,002,PLAN DE MARÍA,2,38,13,25,3
PUEBLA,21,ACATENO,002,SAN JOSÉ ACATENO,8,1150,592,558,49
PUEBLA,21,ACATENO,002,TIERRA NUEVA (EJIDO DE SAN JOSÉ ACATENO),2,51,24,27,4
PUEBLA,21,ACATENO,002,TOPILA,2,47,20,27,2
PUEBLA,21,ACATENO,002,TZONTECOMAPA,3,133,62,71,7
PUEBLA,21,ACATLÁN,003,ACATLÁN DE OSORIO,41,8271,4294,3977,450
PUEBLA,21,ACATLÁN,003,AMATE REDONDO,2,35,12,23,3
PUEBLA,21,ACATLÁN,003,AMATITLÁN DE AZUETA,4,414,220,194,20
PUEBLA,21,ACATLÁN,003,BARRIO DE GUADALUPE,2,84,47,37,4
PUEBLA,21,ACATLÁN,003,BARRIO SANTIAGO ILAMACINGO,1,36,17,19,1
PUEBLA,21,ACATLÁN,003,COLONIA ALLENDE,2,23,12,11,2
PUEBLA,21,ACATLÁN,003,EL CUAJILOTE,3,50,24,26,4
PUEBLA,21,ACATLÁN,003,EL GARAMBUYO,2,31,13,18,3
PUEBLA,21,ACATLÁN,003,EL MAGUEY,3,22,11,11,2
PUEBLA,21,ACATLÁN,003,EL TEHUIXTLE,2,17,9,8,2
PUEBLA,21,ACATLÁN,003,GARZONES (SANTA GERTRUDIS),3,108,60,48,5
PUEBLA,21,ACATLÁN,003,HERMENEGILDO GALEANA,4,189,90,99,12
PUEBLA,21,ACATLÁN,003,ILAMACINGO,6,269,119,150,17
PUEBLA,21,ACATLÁN,003,JUAN R. ROJAS (LOS COCOS),3,29,17,12,3
PUEBLA,21,ACATLÁN,003,LA HUERTA,3,137,74,63,9
PUEBLA,21,ACATLÁN,003,LA NORIA CHICA,2,23,13,10,2
PUEBLA,21,ACATLÁN,003,LA NORMAL,2,114,60,54,8
PUEBLA,21,ACATLÁN,003,LA PALMA,1,257,120,137,7
PUEBLA,21,ACATLÁN,003,LA TRINIDAD (LOS HOBOS),2,22,7,15,3
PUEBLA,21,ACATLÁN,003,LAS NIEVES,4,307,157,150,15
PUEBLA,21,ACATLÁN,003,NUEVOS HORIZONTES,3,122,63,59,7
PUEBLA,21,ACATLÁN,003,PEÑA COLORADA,4,42,22,20,5
PUEBLA,21,ACATLÁN,003,RANCHO NUEVO,3,68,32,36,5
PUEBLA,21,ACATLÁN,003,SAN BERNARDO,4,290,141,149,19
PUEBLA,21,ACATLÁN,003,SAN CRISTÓBAL,3,107,57,50,7
PUEBLA,21,ACATLÁN,003,SAN FRANCISCO RANCHO NUEVO,3,85,42,43,6
PUEBLA,21,ACATLÁN,003,SAN GABRIEL SEGUNDA SECCIÓN,1,58,21,37,3
PUEBLA,21,ACATLÁN,003,SAN ISIDRO,1,16,9,7,1
PUEBLA,21,ACATLÁN,003,SAN MIGUEL AMATITLANES,1,3,1,2,1
PUEBLA,21,ACATLÁN,003,SAN MIGUEL SAN BERNARDO,3,30,13,17,3
PUEBLA,21,ACATLÁN,003,SAN VICENTE BOQUERÓN,6,642,329,313,32
PUEBLA,21,ACATLÁN,003,TECOMATE,2,61,30,31,4
PUEBLA,21,ACATLÁN,003,TEMPEXQUIXTLE AMARILLO,3,11,7,4,3
PUEBLA,21,ACATLÁN,003,TETELCINGO,2,159,75,84,8
PUEBLA,21,ACATLÁN,003,TIANGUISTENGO,2,81,41,40,4
PUEBLA,21,ACATLÁN,003,ZIMATLÁN BUENA VISTA,4,54,25,29,7
PUEBLA,21,ACATZINGO,004,ACATZINGO DE HIDALGO,38,9459,4941,4518,372
PUEBLA,21,ACATZINGO,004,ACTIPAN DE MORELOS (SANTA MARÍA ACTIPAN),13,2725,1414,1311,113
PUEBLA,21,ACATZINGO,004,APIPILOLCO (LOS ÁLAMOS),2,24,13,11,3
PUEBLA,21,ACATZINGO,004,CARMEN SERDÁN,3,434,204,230,16
PUEBLA,21,ACATZINGO,004,EL CAPULÍN,1,20,15,5,2
PUEBLA,21,ACATZINGO,004,GUADALUPE MORELOS,2,288,149,139,9
PUEBLA,21,ACATZINGO,004,HERNÁNDEZ,3,229,137,92,10
PUEBLA,21,ACATZINGO,004,LA COYOTERA,3,33,16,17,4
PUEBLA,21,ACATZINGO,004,NICOLÁS BRAVO,3,742,372,370,26
PUEBLA,21,ACATZINGO,004,PROGRESO DE JUÁREZ,3,605,283,322,22
PUEBLA,21,ACATZINGO,004,SAN ANTONIO,1,229,126,103,6
PUEBLA,21,ACATZINGO,004,SAN JERÓNIMO TAMARIZ,2,22,9,13,3
PUEBLA,21,ACATZINGO,004,SAN JOSÉ,1,675,351,324,32
PUEBLA,21,ACATZINGO,004,SAN MARCOS EL VIEJO,2,24,10,14,4
PUEBLA,21,ACATZINGO,004,SAN MIGUEL DORANTES (XALTEPEC),2,14,9,5,1
PUEBLA,21,ACATZINGO,004,SAN PEDRO OVANDO (EX-HACIENDA SAN PEDRO OVANDO),1,319,236,83,14
PUEBLA,21,ACATZINGO,004,SAN SEBASTIÁN TETELES,4,766,386,380,27
PUEBLA,21,ACATZINGO,004,SAN SEBASTIÁN VILLANUEVA,8,1791,926,865,60
PUEBLA,21,ACATZINGO,004,VIRREYES DE JUÁREZ,2,36,21,15,4
PUEBLA,21,ACTEOPAN,005,ACTEOPAN,4,361,189,172,19
PUEBLA,21,ACTEOPAN,005,SAN FELIPE TOCTLA,3,158,73,85,7
PUEBLA,21,ACTEOPAN,005,SANTA MARÍA ATZITZINTLA,3,36,14,22,3
PUEBLA,21,AHUACATLÁN,006,AGUA FRÍA,2,103,55,48,5
PUEBLA,21,AHUACATLÁN,006,AHUACATLÁN,12,2466,1353,1113,103
PUEBLA,21,AHUACATLÁN,006,ANALCO,2,77,32,45,4
PUEBLA,21,AHUACATLÁN,006,CAMINO DE SAN MARCOS (PALENQUE),1,11,7,4,1
PUEBLA,21,AHUACATLÁN,006,COALTEPEC (SAN JERÓNIMO),3,88,42,46,7
PUEBLA,21,AHUACATLÁN,006,CUACUILCO,1,8,4,4,1
PUEBLA,21,AHUACATLÁN,006,ELOXOCHITLÁN (SAN MARCOS),3,239,115,124,19
PUEBLA,21,AHUACATLÁN,006,IXQUIHUACÁN (SAN FRANCISCO),5,353,161,192,13
PUEBLA,21,AHUACATLÁN,006,POCHÁLCATL,2,73,40,33,4
PUEBLA,21,AHUACATLÁN,006,TECOMATEPEC TRES CRUCES,2,20,6,14,3
PUEBLA,21,AHUACATLÁN,006,TLACOMULCO,2,75,36,39,4
PUEBLA,21,AHUACATLÁN,006,TLACOTEPEC (SAN MATEO),6,719,344,375,31
PUEBLA,21,AHUACATLÁN,006,TLALACAL,1,53,27,26,4
PUEBLA,21,AHUACATLÁN,006,TLAYEHUALANCINGO (SAN ANDRÉS),3,137,66,71,9
PUEBLA,21,AHUACATLÁN,006,TONALAPA (SANTA BÁRBARA),3,137,72,65,6
PUEBLA,21,AHUACATLÁN,006,XOCHICUAUTLA,4,397,200,197,22
PUEBLA,21,AHUATLÁN,007,AHUATLÁN,4,357,188,169,20
PUEBLA,21,AHUATLÁN,007,EL CARRIZO (PARAJE MICHIHUACAN),2,5,1,4,1
PUEBLA,21,AHUATLÁN,007,GUADALUPE,3,20,9,11,2
PUEBLA,21,AHUATLÁN,007,LA SÁBILA,2,12,7,5,2
PUEBLA,21,AHUATLÁN,007,LAGUNILLA,2,7,6,1,1
PUEBLA,21,AHUATLÁN,007,PATLANOAYA (SAN SALVADOR PATLANOAYA),4,217,94,123,11
PUEBLA,21,AHUATLÁN,007,SAN ISIDRO MIMILULCO (MIMILULCO),2,30,10,20,2
PUEBLA,21,AHUATLÁN,007,SAN JOSÉ EL RODEO (EL RODEO),2,16,7,9,3
PUEBLA,21,AHUATLÁN,007,SAN LUCAS TEJALUCA,4,219,112,107,15
PUEBLA,21,AHUAZOTEPEC,008,AHUACATLA,2,71,32,39,4
PUEBLA,21,AHUAZOTEPEC,008,AHUAZOTEPEC,12,1703,847,856,76
PUEBLA,21,AHUAZOTEPEC,008,BERISTÁIN,4,761,381,380,30
PUEBLA,21,AHUAZOTEPEC,008,EJIDO MESA CHICA,2,30,15,15,2
PUEBLA,21,AHUAZOTEPEC,008,LA ESTACIÓN DE AHUAZOTEPEC,2,94,39,55,5
PUEBLA,21,AHUAZOTEPEC,008,LA MESA CHICA (LAS MILPILLAS),2,19,10,9,2
PUEBLA,21,AHUAZOTEPEC,008,LAGUNA SECA,4,346,150,196,14
PUEBLA,21,AHUAZOTEPEC,008,SAN ANTONIO BUENAVISTA,3,82,37,45,5
PUEBLA,21,AHUAZOTEPEC,008,TEJAMANILES,3,116,53,63,7
PUEBLA,21,AHUAZOTEPEC,008,TENEJAQUE,2,80,42,38,5
PUEBLA,21,AHUEHUETITLA,009,AHUEHUETITLA,6,369,183,186,21
PUEBLA,21,AHUEHUETITLA,009,EL PAPAYO,2,5,2,3,1
PUEBLA,21,AHUEHUETITLA,009,GUADALUPE ALCHIPINI,3,77,37,40,4
PUEBLA,21,AHUEHUETITLA,009,LAS PALOMAS (EL BOLUDO),2,16,6,10,2
PUEBLA,21,AHUEHUETITLA,009,RANCHO DEL IXTAYO,2,8,3,5,1
PUEBLA,21,AHUEHUETITLA,009,SAN VICENTE EL PEÑÓN,2,41,20,21,2
PUEBLA,21,AJALPAN,010,ACHICHINALCO,1,58,33,25,3
PUEBLA,21,AJALPAN,010,AHUATEPEC,2,144,69,75,6
PUEBLA,21,AJALPAN,010,AHUATLA,1,11,5,6,1
PUEBLA,21,AJALPAN,010,AMEYALCO,1,16,11,5,1
PUEBLA,21,AJALPAN,010,BELLA VISTA,2,53,25,28,3
PUEBLA,21,AJALPAN,010,BOCA DEL MONTE,5,323,158,165,13
PUEBLA,21,AJALPAN,010,BUENAVISTA,2,128,64,64,7
PUEBLA,21,AJALPAN,010,CHICHICAPA,4,468,227,241,17
PUEBLA,21,AJALPAN,010,CINCO DE MAYO,4,258,110,148,13
PUEBLA,21,AJALPAN,010,CINCO SEÑORES,1,79,37,42,3
PUEBLA,21,AJALPAN,010,CIUDAD DE AJALPAN,57,10295,5239,5056,449
PUEBLA,21,AJALPAN,010,COATZINGO,1,8,4,4,1
PUEBLA,21,AJALPAN,010,COMULCO,2,21,7,14,2
PUEBLA,21,AJALPAN,010,COXÓLICO,4,620,311,309,27
PUEBLA,21,AJALPAN,010,CRUZ CHICHILTZI,2,56,29,27,3
PUEBLA,21,AJALPAN,010,CUABCAPULA,4,307,160,147,12
PUEBLA,21,AJALPAN,010,CUAHUICHOTLA,2,84,45,39,3
PUEBLA,21,AJALPAN,010,CUAUTOTOLAPAN (SAN JOSÉ),10,403,212,191,25
PUEBLA,21,AJALPAN,010,CUAUTZINTLICA,2,45,20,25,2
PUEBLA,21,AJALPAN,010,CUAXUXPA,5,823,394,429,31
PUEBLA,21,AJALPAN,010,EL MIRADOR,3,76,39,37,4
PUEBLA,21,AJALPAN,010,ESPERANZA,4,239,131,108,12
PUEBLA,21,AJALPAN,010,HUITZMALOC,9,460,231,229,21
PUEBLA,21,AJALPAN,010,LA ESCONDIDA,3,126,63,63,6
PUEBLA,21,AJALPAN,010,LA JOYA,2,80,39,41,3
PUEBLA,21,AJALPAN,010,LA TRINIDAD,2,14,8,6,2
PUEBLA,21,AJALPAN,010,LOMA BONITA,1,42,23,19,3
PUEBLA,21,AJALPAN,010,MACUILCUAUTITLA,3,166,80,86,8
PUEBLA,21,AJALPAN,010,MACUILQUILA,1,15,9,6,1
PUEBLA,21,AJALPAN,010,MAZATIANQUIXCO,4,345,160,185,17
PUEBLA,21,AJALPAN,010,MEXCALA,3,59,23,36,4
PUEBLA,21,AJALPAN,010,MEXCALTOCHINTLA,4,307,159,148,15
PUEBLA,21,AJALPAN,010,MOYOTEPEC,2,96,43,53,4
PUEBLA,21,AJALPAN,010,NATIVITAS (SANTA MARÍA),4,449,215,234,18
PUEBLA,21,AJALPAN,010,OCOTEMPA,2,118,63,55,5
PUEBLA,21,AJALPAN,010,PANTZINGO DE MORELOS,1,14,6,8,1
PUEBLA,21,AJALPAN,010,PEÑA HOREB,2,92,50,42,5
PUEBLA,21,AJALPAN,010,PISCUAUTLA,2,49,23,26,3
PUEBLA,21,AJALPAN,010,PLAYA VICENTE,2,71,37,34,3
PUEBLA,21,AJALPAN,010,RANCHO NUEVO,4,234,120,114,11
PUEBLA,21,AJALPAN,010,RANCHO VIEJO,3,44,25,19,4
PUEBLA,21,AJALPAN,010,SAN ISIDRO EL MIRADOR (MAZATLAXCO),1,9,4,5,1
PUEBLA,21,AJALPAN,010,SAN JOSÉ BUENA VISTA,3,294,139,155,12
PUEBLA,21,AJALPAN,010,SAN SEBASTIÁN ALCOMUNGA,4,617,321,296,22
PUEBLA,21,AJALPAN,010,SANTA CRUZ DE LOS ARENALES,3,36,15,21,3
PUEBLA,21,AJALPAN,010,TECPANTZACUALCO,3,842,433,409,28
PUEBLA,21,AJALPAN,010,TEPANTITLA,2,19,10,9,2
PUEBLA,21,AJALPAN,010,TEPEPA,3,51,20,31,3
PUEBLA,21,AJALPAN,010,TEPEPA DE BUENAVISTA,2,28,17,11,4
PUEBLA,21,AJALPAN,010,TEPEPA DE ZARAGOZA,2,71,30,41,3
PUEBLA,21,AJALPAN,010,TEPETLAMPA,4,269,139,130,13
PUEBLA,21,AJALPAN,010,TIERRA BLANCA,3,75,34,41,4
PUEBLA,21,AJALPAN,010,TLACXITLA,2,62,36,26,3
PUEBLA,21,AJALPAN,010,TLAZOLAPA,2,33,20,13,3
PUEBLA,21,AJALPAN,010,VISTA HERMOSA ZAYULAPA,6,357,176,181,18
PUEBLA,21,AJALPAN,010,XALA,4,147,65,82,8
PUEBLA,21,AJALPAN,010,XOCHITZINGA,4,237,122,115,12
PUEBLA,21,AJALPAN,010,ZACATECOCHCO,3,90,49,41,4
PUEBLA,21,AJALPAN,010,ZACATLAMANIC,4,336,169,167,17
PUEBLA,21,AJALPAN,010,ZACAYUCAN,1,21,6,15,2
PUEBLA,21,ALBINO ZERTUCHE,011,ACAXTLAHUACÁN DE ALBINO ZERTUCHE,4,430,213,217,20
PUEBLA,21,ALBINO ZERTUCHE,011,XOCHICONTLA,3,10,6,4,2
PUEBLA,21,ALJOJUCA,012,ALJOJUCA,4,961,464,497,39
PUEBLA,21,ALJOJUCA,012,JALAPASCO EL GRANDE,1,13,3,10,2
PUEBLA,21,ALJOJUCA,012,SAN ANTONIO JALAPASCO,2,61,27,34,3
PUEBLA,21,ALJOJUCA,012,SAN ANTONIO LAS CUCHILLAS,2,63,26,37,3
PUEBLA,21,ALJOJUCA,012,SAN MIGUEL TECUITLAPA,3,215,101,114,12
PUEBLA,21,ALTEPEXI,013,ALTEPEXI,15,4916,2541,2375,195
PUEBLA,21,ALTEPEXI,013,HIDALGO,1,40,24,16,2
PUEBLA,21,ALTEPEXI,013,TEXCALCO,2,18,8,10,2
PUEBLA,21,AMIXTLÁN,014,AMIXTLÁN,7,823,387,436,34
PUEBLA,21,AMIXTLÁN,014,CACOCHÓN,3,25,8,17,3
PUEBLA,21,AMIXTLÁN,014,CUAUTOTOLA,4,188,97,91,10
PUEBLA,21,AMIXTLÁN,014,EL OCOTAL,4,85,38,47,9
PUEBLA,21,AMIXTLÁN,014,MIRASOL,3,132,66,66,11
PUEBLA,21,AMOZOC,015,AMOZOC DE MOTA,116,28209,14185,14024,1141
PUEBLA,21,AMOZOC,015,CASA BLANCA,5,1404,661,743,44
PUEBLA,21,AMOZOC,015,CONCEPCIÓN CAPULAC (LA EX-HACIENDA),6,1006,511,495,40
PUEBLA,21,AMOZOC,015,GUADALUPE VICTORIA (GUADALUPE DEL MORAL),3,31,16,15,3
PUEBLA,21,AMOZOC,015,IGNACIO ZARAGOZA,1,640,346,294,18
PUEBLA,21,AMOZOC,015,LA VENTA,3,45,26,19,3
PUEBLA,21,AMOZOC,015,SAN JACINTO,1,75,39,36,3
PUEBLA,21,AMOZOC,015,SAN JOSÉ LA LAGUNA,3,490,248,242,15
PUEBLA,21,AMOZOC,015,SAN MATEO,2,587,294,293,22
PUEBLA,21,AQUIXTLA,016,AQUIXTLA,6,638,327,311,28
PUEBLA,21,AQUIXTLA,016,ATECOXCO,3,101,45,56,6
PUEBLA,21,AQUIXTLA,016,ATEXCAC,2,85,38,47,5
PUEBLA,21,AQUIXTLA,016,AYOCUANTLA,2,38,17,21,5
PUEBLA,21,AQUIXTLA,016,CHAUCINGO,1,10,3,7,1
PUEBLA,21,AQUIXTLA,016,CHICHICAXTLA,4,247,130,117,11
PUEBLA,21,AQUIXTLA,016,CHIGNAHUACINGO,2,77,35,42,4
PUEBLA,21,AQUIXTLA,016,COAYUCA,4,152,78,74,8
PUEBLA,21,AQUIXTLA,016,CUAUTIECO,3,191,104,87,9
PUEBLA,21,AQUIXTLA,016,CUAUTOLANICO,4,37,13,24,4
PUEBLA,21,AQUIXTLA,016,ECAPACTLA,2,39,14,25,2
PUEBLA,21,AQUIXTLA,016,EL TERRERO,3,271,128,143,12
PUEBLA,21,AQUIXTLA,016,ILOTEPEC,1,13,2,11,2
PUEBLA,21,AQUIXTLA,016,LA LOMA,2,37,22,15,3
PUEBLA,21,AQUIXTLA,016,PACHUQUILLA,2,27,15,12,2
PUEBLA,21,AQUIXTLA,016,SAN ALFONSO,2,49,26,23,2
PUEBLA,21,AQUIXTLA,016,TLACHIAPA,2,52,24,28,4
PUEBLA,21,AQUIXTLA,016,TLACUITLAPA,2,53,26,27,3
PUEBLA,21,AQUIXTLA,016,TLALTEMPA,2,36,22,14,3
PUEBLA,21,AQUIXTLA,016,TLAPIZAHUACAN,1,8,6,2,1
PUEBLA,21,ATEMPAN,017,APATAUYAN,4,532,285,247,23
PUEBLA,21,ATEMPAN,017,ATEMPAN,16,3974,2041,1933,138
PUEBLA,21,ATEMPAN,017,ATZALÁN,4,326,151,175,14
PUEBLA,21,ATEMPAN,017,CALA NORTE,3,293,148,145,15
PUEBLA,21,ATEMPAN,017,CALA SUR,5,857,451,406,42
PUEBLA,21,ATEMPAN,017,EL CUATRO,2,138,74,64,5
PUEBLA,21,ATEMPAN,017,HUEXOTENO,2,86,40,46,5
PUEBLA,21,ATEMPAN,017,LAS CANOAS,3,281,134,147,12
PUEBLA,21,ATEMPAN,017,LAS DELICIAS,3,257,127,130,12
PUEBLA,21,ATEMPAN,017,SAN AMBROSIO,1,81,46,35,4
PUEBLA,21,ATEMPAN,017,SAN NICOLÁS (ANIMAZCO),2,47,26,21,3
PUEBLA,21,ATEMPAN,017,TACOPAN,7,1741,869,872,71
PUEBLA,21,ATEMPAN,017,TANHUIXCO,4,437,229,208,17
PUEBLA,21,ATEMPAN,017,TEZHUATEPEC,6,681,332,349,30
PUEBLA,21,ATEMPAN,017,TEZOMPAN,2,67,35,32,4
PUEBLA,21,ATEXCAL,018,AGUA EL GABRIEL,2,50,24,26,3
PUEBLA,21,ATEXCAL,018,COLONIA SOLIDARIDAD,1,22,9,13,1
PUEBLA,21,ATEXCAL,018,LAS CUMBRES DE CHICOMETEPEC,2,15,7,8,2
PUEBLA,21,ATEXCAL,018,SAN LUCAS TETELETITLÁN,4,258,133,125,16
PUEBLA,21,ATEXCAL,018,SAN MARTÍN ATEXCAL,6,375,205,170,26
PUEBLA,21,ATEXCAL,018,SAN NICOLÁS TEPOXTITLÁN (NEPOXTITLÁN),1,11,6,5,1
PUEBLA,21,ATEXCAL,018,SANTA CATARINA TEHUIXTLA,3,64,35,29,4
PUEBLA,21,ATEXCAL,018,SANTIAGO NOPALA,4,139,61,78,8
PUEBLA,21,ATEXCAL,018,SANTO TOMÁS OTLALTEPEC,3,63,32,31,4
PUEBLA,21,ATLIXCO,019,ATLIXCO,160,29682,15140,14542,1731
PUEBLA,21,ATLIXCO,019,AXOCOPAN,1,24,13,11,2
PUEBLA,21,ATLIXCO,019,CABRERA,2,911,453,458,58
PUEBLA,21,ATLIXCO,019,COLONIA AGRÍCOLA DE OCOTEPEC (COLONIA SAN JOSÉ),3,575,282,293,23
PUEBLA,21,ATLIXCO,019,DIEZ DE ABRIL,2,14,5,9,2
PUEBLA,21,ATLIXCO,019,EL CARMEN,2,507,243,264,21
PUEBLA,21,ATLIXCO,019,EL PAJAR,3,61,26,35,7
PUEBLA,21,ATLIXCO,019,EMILIANO ZAPATA LOS MOLINOS,1,91,49,42,4
PUEBLA,21,ATLIXCO,019,EMILIANO ZAPATA NEXATENGO,2,211,99,112,8
PUEBLA,21,ATLIXCO,019,EX-HACIENDA SAN AGUSTÍN,2,62,31,31,3
PUEBLA,21,ATLIXCO,019,EX-HACIENDA SAN FÉLIX,1,19,7,12,1
PUEBLA,21,ATLIXCO,019,FRANCISCO VILLA,2,49,25,24,3
PUEBLA,21,ATLIXCO,019,GUADALUPE HUEXOCUAPAN,3,68,31,37,5
PUEBLA,21,ATLIXCO,019,JUAN UVERA,3,177,75,102,11
PUEBLA,21,ATLIXCO,019,LA MAGDALENA,2,721,369,352,27
PUEBLA,21,ATLIXCO,019,LA SABANA (SAN JUAN LA SABANA),4,291,141,150,14
PUEBLA,21,ATLIXCO,019,LA TRINIDAD TEPANGO,1,95,44,51,3
PUEBLA,21,ATLIXCO,019,MÁRTIR DE CHINAMECA,2,18,8,10,2
PUEBLA,21,ATLIXCO,019,SAN AGUSTÍN HUIXAXTLA,2,227,107,120,9
PUEBLA,21,ATLIXCO,019,SAN AGUSTÍN IXTAHUIXTLA,3,132,62,70,9
PUEBLA,21,ATLIXCO,019,SAN ALFONSO,2,358,177,181,11
PUEBLA,21,ATLIXCO,019,SAN DIEGO ACAPULCO,2,173,82,91,9
PUEBLA,21,ATLIXCO,019,SAN DIEGO LA BLANCA,1,197,101,96,9
PUEBLA,21,ATLIXCO,019,SAN ESTEBAN ZOAPILTEPEC,3,122,66,56,8
PUEBLA,21,ATLIXCO,019,SAN FELIPE XONACAYUCAN,2,28,9,19,2
PUEBLA,21,ATLIXCO,019,SAN FÉLIX ALMAZÁN,2,131,71,60,7
PUEBLA,21,ATLIXCO,019,SAN FÉLIX HIDALGO,3,695,329,366,29
PUEBLA,21,ATLIXCO,019,SAN ISIDRO HUILOTEPEC,5,442,215,227,25
PUEBLA,21,ATLIXCO,019,SAN JERÓNIMO CALERAS,4,241,133,108,12
PUEBLA,21,ATLIXCO,019,SAN JERÓNIMO COYULA,8,1610,821,789,69
PUEBLA,21,ATLIXCO,019,SAN JUAN DE LOS LAURELES,1,22,15,7,1
PUEBLA,21,ATLIXCO,019,SAN JUAN OCOTEPEC,3,311,142,169,12
PUEBLA,21,ATLIXCO,019,SAN JUAN PORTEZUELO,3,339,168,171,12
PUEBLA,21,ATLIXCO,019,SAN JUAN TEJALUCA,2,203,112,91,8
PUEBLA,21,ATLIXCO,019,SAN PEDRO BENITO JUÁREZ,5,745,391,354,36
PUEBLA,21,ATLIXCO,019,SANTA ANA YANCUITLALPAN (CHILHUACÁN),2,221,104,117,10
PUEBLA,21,ATLIXCO,019,SANTA CRUZ TEHUIXPANGO,5,821,413,408,32
PUEBLA,21,ATLIXCO,019,SANTA ELENA AXOCOPAN,1,44,24,20,2
PUEBLA,21,ATLIXCO,019,SANTA LUCÍA COSAMALOAPAN,4,464,232,232,24
PUEBLA,21,ATLIXCO,019,SANTO DOMINGO ATOYATEMPAN,4,413,199,214,18
PUEBLA,21,ATLIXCO,019,SOLARES DE TENEXTEPEC,2,86,45,41,5
PUEBLA,21,ATLIXCO,019,TOLOMETLA DE BENITO JUÁREZ,2,28,15,13,2
PUEBLA,21,ATOYATEMPAN,020,ATOYATEMPAN,8,1949,985,964,85
PUEBLA,21,ATOYATEMPAN,020,TLACOMULCO,1,18,10,8,1
PUEBLA,21,ATZALA,021,ATZALA,4,289,133,156,19
PUEBLA,21,ATZITZIHUACÁN,022,AGRARISTA EMILIANO ZAPATA,2,47,16,31,3
PUEBLA,21,ATZITZIHUACÁN,022,EL POTRERO,3,10,4,6,3
PUEBLA,21,ATZITZIHUACÁN,022,SAN FRANCISCO XOCHITEOPAN,4,255,144,111,12
PUEBLA,21,ATZITZIHUACÁN,022,SAN JUAN AMECAC,7,1331,680,651,59
PUEBLA,21,ATZITZIHUACÁN,022,SAN JUAN TEJUPA,5,700,358,342,30
PUEBLA,21,ATZITZIHUACÁN,022,SAN MATEO COATEPEC,3,106,50,56,6
PUEBLA,21,ATZITZIHUACÁN,022,SAN MIGUEL AGUACOMULICAN,3,301,146,155,11
PUEBLA,21,ATZITZIHUACÁN,022,SAN PEDRO IXHUATEPEC,3,125,60,65,7
PUEBLA,21,ATZITZIHUACÁN,022,SANTIAGO ATZITZIHUACÁN,4,248,127,121,14
PUEBLA,21,ATZITZINTLA,023,ATZITZINTLA,6,1064,555,509,45
PUEBLA,21,ATZITZINTLA,023,CHICHIPICA,3,17,8,9,3
PUEBLA,21,ATZITZINTLA,023,GUADALUPE XOCHILOMA,4,161,82,79,11
PUEBLA,21,ATZITZINTLA,023,PASO CARRETAS,4,267,118,149,13
PUEBLA,21,ATZITZINTLA,023,PLAN DEL CAPULÍN,3,120,62,58,6
PUEBLA,21,ATZITZINTLA,023,SAN ANTONIO EL ALTO (RANCHO MONTIEL),2,22,10,12,3
PUEBLA,21,ATZITZINTLA,023,SAN JOSÉ EL DESPACHO (DESPACHO ASERRADERO),1,20,11,9,0
PUEBLA,21,ATZITZINTLA,023,SAN JUAN HUILOAPAN,3,140,79,61,6
PUEBLA,21,ATZITZINTLA,023,SAN JUANERO,3,39,19,20,5
PUEBLA,21,ATZITZINTLA,023,SAN MANUEL DE LA SIERRA,2,40,20,20,2
PUEBLA,21,ATZITZINTLA,023,SANTA CRUZ CUYACHAPA,2,100,53,47,4
PUEBLA,21,ATZITZINTLA,023,SANTA CRUZ TEXMALAQUILLA,4,354,181,173,16
PUEBLA,21,ATZITZINTLA,023,TOLUCA,3,92,46,46,7
PUEBLA,21,AXUTLA,024,AXUTLA,4,133,72,61,11
PUEBLA,21,AXUTLA,024,HUEHUEPIAXTLA,3,40,20,20,3
PUEBLA,21,AXUTLA,024,TLAXIXINCA,2,21,8,13,2
PUEBLA,21,AYOTOXCO DE GUERRERO,025,ARENAL,1,5,3,2,1
PUEBLA,21,AYOTOXCO DE GUERRERO,025,AYOTOXCO DE GUERRERO,7,1152,585,567,63
PUEBLA,21,AYOTOXCO DE GUERRERO,025,BUENA VISTA,5,316,158,158,16
PUEBLA,21,AYOTOXCO DE GUERRERO,025,COPALES,4,71,37,34,7
PUEBLA,21,AYOTOXCO DE GUERRERO,025,CUAUHTÉMOC (TLACUILOLOSTOC),2,52,22,30,3
PUEBLA,21,AYOTOXCO DE GUERRERO,025,EL ROBLE,1,16,11,5,1
PUEBLA,21,AYOTOXCO DE GUERRERO,025,GACHUPINATE (RANCHO NUEVO),3,151,69,82,10
PUEBLA,21,AYOTOXCO DE GUERRERO,025,LA LAGUNILLA,2,43,27,16,3
PUEBLA,21,AYOTOXCO DE GUERRERO,025,LA UNIÓN,2,16,5,11,2
PUEBLA,21,AYOTOXCO DE GUERRERO,025,NANACATEPEC,2,45,17,28,3
PUEBLA,21,AYOTOXCO DE GUERRERO,025,SAN ANTONIO METZONAPA,4,175,87,88,11
PUEBLA,21,AYOTOXCO DE GUERRERO,025,SAN FRANCISCO ATECACALAX,3,102,50,52,6
PUEBLA,21,AYOTOXCO DE GUERRERO,025,URUAPAN,1,9,5,4,2
PUEBLA,21,CALPAN,026,EL PALMAR (LA OCOTERA SECA),2,22,10,12,3
PUEBLA,21,CALPAN,026,PUEBLO NUEVO,2,122,55,67,6
PUEBLA,21,CALPAN,026,SAN ANDRÉS CALPAN,12,2571,1331,1240,148
PUEBLA,21,CALPAN,026,SAN LUCAS ATZALA,2,140,82,58,6
PUEBLA,21,CALPAN,026,SAN MATEO OZOLCO,4,610,314,296,29
PUEBLA,21,CALTEPEC,027,ACATEPEC,4,215,108,107,13
PUEBLA,21,CALTEPEC,027,ACTIPAN (SAN ISIDRO),6,32,15,17,5
PUEBLA,21,CALTEPEC,027,ATECOXCO,2,32,17,15,2
PUEBLA,21,CALTEPEC,027,CALTEPEC,7,276,135,141,15
PUEBLA,21,CALTEPEC,027,COATEPEC,3,89,46,43,4
PUEBLA,21,CALTEPEC,027,LA COMPAÑÍA,2,17,10,7,2
PUEBLA,21,CALTEPEC,027,MARRUBIO,1,10,3,7,1
PUEBLA,21,CALTEPEC,027,PLAN DE SAN MIGUEL,3,65,32,33,4
PUEBLA,21,CALTEPEC,027,SAN JUAN ACATITLÁN,3,50,22,28,5
PUEBLA,21,CALTEPEC,027,SAN LUIS ATOLOTITLÁN (ATOLOTITLÁN),2,67,28,39,6
PUEBLA,21,CALTEPEC,027,SAN SIMÓN TLACUILOTEPEC,3,21,12,9,3
PUEBLA,21,CALTEPEC,027,ZOTOLÍN,2,28,11,17,2
PUEBLA,21,CAMOCUAUTLA,028,CAMOCUAUTLA,4,428,218,210,18
PUEBLA,21,CAMOCUAUTLA,028,LA PILA,2,9,4,5,2
PUEBLA,21,CAMOCUAUTLA,028,SAN BERNARDINO,3,31,18,13,3
PUEBLA,21,CAMOCUAUTLA,028,TACXCOY,3,21,7,14,4
PUEBLA,21,CAMOCUAUTLA,028,TAPAYULA,3,172,87,85,9
PUEBLA,21,CAXHUACAN,029,CAXHUACAN,7,951,464,487,61
PUEBLA,21,CAXHUACAN,029,CUCUCHUCHUT,2,47,25,22,3
PUEBLA,21,COATEPEC,030,COATEPEC,4,211,101,110,12
PUEBLA,21,COATZINGO,031,COATZINGO,6,442,219,223,26
PUEBLA,21,COATZINGO,031,SAN VICENTE,2,114,52,62,6
PUEBLA,21,COATZINGO,031,ZARAGOZA,2,62,34,28,3
PUEBLA,21,COHETZALA,032,EL PLATANAR (SAN JOSÉ EL PLATANAR),3,43,17,26,2
PUEBLA,21,COHETZALA,032,SANTA MARÍA COHETZALA,4,116,61,55,10
PUEBLA,21,COHETZALA,032,SANTA MÓNICA,4,157,71,86,8
PUEBLA,21,COHETZALA,032,ZEPATLA (SANTA CRUZ ZEPATLA),2,6,3,3,2
PUEBLA,21,COHUECAN,033,COHUECAN,5,528,280,248,24
PUEBLA,21,COHUECAN,033,LOS REYES TEOLCO,3,253,131,122,11
PUEBLA,21,COHUECAN,033,SAN ANDRÉS AHUATELCO,2,76,38,38,4
PUEBLA,21,COHUECAN,033,SAN FELIPE CUAPEXCO,3,155,80,75,8
PUEBLA,21,COHUECAN,033,SAN FRANCISCO TEPANGO,4,259,129,130,16
PUEBLA,21,CORONANGO,034,SAN ANTONIO MIHUACAN,1,160,76,84,7
PUEBLA,21,CORONANGO,034,SAN ANTONIO MIHUACÁN,5,1223,592,631,42
PUEBLA,21,CORONANGO,034,SAN FRANCISCO OCOTLÁN,4,757,408,349,34
PUEBLA,21,CORONANGO,034,SAN FRANCISCO OCOTLÁN (OCOTLÁN),20,5185,2586,2599,201
PUEBLA,21,CORONANGO,034,SAN MARTÍN ZOQUIAPAN,2,158,82,76,7
PUEBLA,21,CORONANGO,034,SANTA MARÍA CORONANGO,12,4087,2003,2084,150
PUEBLA,21,COXCATLÁN,035,BENITO JUÁREZ,2,44,21,23,3
PUEBLA,21,COXCATLÁN,035,CALIPAN,7,1305,643,662,110
PUEBLA,21,COXCATLÁN,035,CALPUHUACAN,3,64,29,35,5
PUEBLA,21,COXCATLÁN,035,CHICHILTEPEC,7,129,58,71,11
PUEBLA,21,COXCATLÁN,035,COBATEPEC,1,7,3,4,1
PUEBLA,21,COXCATLÁN,035,COXCATLÁN,11,1680,920,760,86
PUEBLA,21,COXCATLÁN,035,CRUZ DE PALO,1,165,136,29,8
PUEBLA,21,COXCATLÁN,035,EL MIRADOR,1,8,4,4,1
PUEBLA,21,COXCATLÁN,035,GUADALUPE VICTORIA (PUEBLO NUEVO),2,27,14,13,2
PUEBLA,21,COXCATLÁN,035,OCOTLAMANIC,4,387,206,181,17
PUEBLA,21,COXCATLÁN,035,PALA [RANCHERÍA],3,58,25,33,4
PUEBLA,21,COXCATLÁN,035,PALITA,1,43,21,22,2
PUEBLA,21,COXCATLÁN,035,POTRERO,3,37,16,21,4
PUEBLA,21,COXCATLÁN,035,SAN JOSÉ TILAPA,5,315,153,162,25
PUEBLA,21,COXCATLÁN,035,SAN RAFAEL,2,27,14,13,2
PUEBLA,21,COXCATLÁN,035,TECOLTEPEC,4,352,191,161,17
PUEBLA,21,COXCATLÁN,035,TEPEYOLOC,4,148,78,70,7
PUEBLA,21,COXCATLÁN,035,TEQUEXPALCO,4,148,71,77,9
PUEBLA,21,COXCATLÁN,035,TRES OCOTES,1,4,1,3,1
PUEBLA,21,COXCATLÁN,035,VIGASTEPEC,4,31,10,21,4
PUEBLA,21,COXCATLÁN,035,XACALCO,4,322,168,154,14
PUEBLA,21,COYOMEAPAN,036,AHUATEPEC,4,127,54,73,9
PUEBLA,21,COYOMEAPAN,036,AHUATLA,3,54,21,33,4
PUEBLA,21,COYOMEAPAN,036,ATEMPA,2,52,24,28,3
PUEBLA,21,COYOMEAPAN,036,ATEMPANATL,2,14,3,11,2
PUEBLA,21,COYOMEAPAN,036,ATICPAC,3,35,14,21,4
PUEBLA,21,COYOMEAPAN,036,BELLA VISTA,2,57,28,29,3
PUEBLA,21,COYOMEAPAN,036,CAXALLI,2,66,34,32,3
PUEBLA,21,COYOMEAPAN,036,CHIMALHUACA,3,30,15,15,4
PUEBLA,21,COYOMEAPAN,036,CUARTA SECCIÓN,2,111,56,55,4
PUEBLA,21,COYOMEAPAN,036,CUITZALA,5,165,82,83,10
PUEBLA,21,COYOMEAPAN,036,HUILULCO,4,187,76,111,9
PUEBLA,21,COYOMEAPAN,036,HUITZÍLATL,2,23,8,15,2
PUEBLA,21,COYOMEAPAN,036,IXTACXOCHITLA,3,84,46,38,5
PUEBLA,21,COYOMEAPAN,036,IXTLÁHUAC,3,143,76,67,6
PUEBLA,21,COYOMEAPAN,036,LOMA BONITA,4,45,24,21,4
PUEBLA,21,COYOMEAPAN,036,MATLAHUACALA,4,164,92,72,9
PUEBLA,21,COYOMEAPAN,036,MEXCALTCORRAL,1,3,3,0,1
PUEBLA,21,COYOMEAPAN,036,MORELOS,2,35,21,14,2
PUEBLA,21,COYOMEAPAN,036,SAN GABRIEL VISTA HERMOSA,2,28,11,17,2
PUEBLA,21,COYOMEAPAN,036,SAN JUAN CUAUTLA,3,174,77,97,11
PUEBLA,21,COYOMEAPAN,036,SAN MARCOS TLALTLALKILOTL,3,83,39,44,4
PUEBLA,21,COYOMEAPAN,036,SAN MIGUEL,2,12,7,5,2
PUEBLA,21,COYOMEAPAN,036,SAN PEDRO TEPEYAC,2,21,11,10,2
PUEBLA,21,COYOMEAPAN,036,SANTA MARÍA COYOMEAPAN,11,965,500,465,44
PUEBLA,21,COYOMEAPAN,036,SEGUNDA SECCIÓN,2,31,19,12,3
PUEBLA,21,COYOMEAPAN,036,TECUANTIOPA,1,17,10,7,1
PUEBLA,21,COYOMEAPAN,036,TEPEPA DE ZARAGOZA,2,101,52,49,6
PUEBLA,21,COYOMEAPAN,036,TEPOXTLA,5,142,66,76,9
PUEBLA,21,COYOMEAPAN,036,TEQUITLALE,3,114,57,57,7
PUEBLA,21,COYOMEAPAN,036,TEQUIXTEPEC DE JUÁREZ,2,17,6,11,2
PUEBLA,21,COYOMEAPAN,036,TLAMANIK,3,40,19,21,4
PUEBLA,21,COYOMEAPAN,036,TLIXCO (SECCIÓN TERCERA),2,108,55,53,4
PUEBLA,21,COYOMEAPAN,036,XALTEPEC,2,24,12,12,2
PUEBLA,21,COYOMEAPAN,036,XALTILICA,2,22,12,10,2
PUEBLA,21,COYOMEAPAN,036,XOCHIAPA,2,19,11,8,2
PUEBLA,21,COYOMEAPAN,036,XOCHITLALPA,5,102,46,56,8
PUEBLA,21,COYOMEAPAN,036,XOCOTLA,2,49,19,30,3
PUEBLA,21,COYOMEAPAN,036,XOMAPA,2,35,20,15,2
PUEBLA,21,COYOMEAPAN,036,YEHUALTEPEC,3,115,58,57,6
PUEBLA,21,COYOMEAPAN,036,YERBA SANTA,2,36,20,16,3
PUEBLA,21,COYOMEAPAN,036,YOHUAJCA,3,45,28,17,3
PUEBLA,21,COYOMEAPAN,036,ZAYOYOJCA,2,24,11,13,2
PUEBLA,21,COYOTEPEC,037,NATIVITAS CUAUTEMPAN,2,60,36,24,3
PUEBLA,21,COYOTEPEC,037,SAN MATEO ZOYAMAZALCO,3,76,36,40,5
PUEBLA,21,COYOTEPEC,037,SAN VICENTE COYOTEPEC,6,273,129,144,16
PUEBLA,21,CUAPIAXTLA DE MADERO,038,CUAPIAXTLA DE MADERO,8,2048,1006,1042,69
PUEBLA,21,CUAPIAXTLA DE MADERO,038,MIGUEL NEGRETE,4,507,269,238,17
PUEBLA,21,CUAUTEMPAN,039,AHUATLÁN,1,16,10,6,1
PUEBLA,21,CUAUTEMPAN,039,CERRO VERDE (EJECATEPECO),2,102,46,56,6
PUEBLA,21,CUAUTEMPAN,039,HUEYTENTAN,4,170,87,83,11
PUEBLA,21,CUAUTEMPAN,039,IXTOLCO DE MORELOS,4,222,112,110,11
PUEBLA,21,CUAUTEMPAN,039,PAPALOTLA,2,35,16,19,2
PUEBLA,21,CUAUTEMPAN,039,SAN ESTEBAN CUAUTEMPAN,7,1079,574,505,51
PUEBLA,21,CUAUTEMPAN,039,SAN JOSÉ RÍO BRAVO,2,72,32,40,3
PUEBLA,21,CUAUTEMPAN,039,TECAPAGCO,1,35,20,15,3
PUEBLA,21,CUAUTEMPAN,039,TENEPANIGIA (SANTA ELENA),5,336,175,161,19
PUEBLA,21,CUAUTEMPAN,039,TEPIZILA (PRIMERA SECCIÓN),1,14,9,5,1
PUEBLA,21,CUAUTEMPAN,039,TEXAMANILA,1,5,2,3,1
PUEBLA,21,CUAUTEMPAN,039,TLAPACHOLOYA,3,121,56,65,7
PUEBLA,21,CUAUTEMPAN,039,TOTOCUAUTLA,2,22,8,14,3
PUEBLA,21,CUAUTEMPAN,039,TOTOMOXTLA,4,182,99,83,9
PUEBLA,21,CUAUTEMPAN,039,VISTA HERMOSA,2,93,52,41,4
PUEBLA,21,CUAUTINCHÁN,040,ALPATLÁHUAC (SAN PEDRO ALPATLÁHUAC),3,187,89,98,9
PUEBLA,21,CUAUTINCHÁN,040,APAPASCO,2,5,3,2,1
PUEBLA,21,CUAUTINCHÁN,040,CONCEPCIÓN PARDIÑAS,3,234,124,110,11
PUEBLA,21,CUAUTINCHÁN,040,CUAUTINCHÁN,6,969,461,508,35
PUEBLA,21,CUAUTINCHÁN,040,EL GRANADO,2,16,7,9,2
PUEBLA,21,CUAUTINCHÁN,040,HUEXOCALCO,2,18,5,13,2
PUEBLA,21,CUAUTINCHÁN,040,JOSÉ MARÍA MORELOS,2,58,30,28,3
PUEBLA,21,CUAUTINCHÁN,040,SAN BALTAZAR TORIJA,1,31,11,20,2
PUEBLA,21,CUAUTINCHÁN,040,SAN JERÓNIMO ALMOLOYA,4,892,437,455,33
PUEBLA,21,CUAUTINCHÁN,040,SANTA CRUZ ALPUYECA,3,322,143,179,13
PUEBLA,21,CUAUTINCHÁN,040,TORIJA (SAN BALTAZAR TORIJA),5,794,403,391,27
PUEBLA,21,CUAUTLANCINGO,041,BARRIO DE NUEVO LEÓN,2,504,249,255,17
PUEBLA,21,CUAUTLANCINGO,041,GUADALUPE,3,133,68,65,18
PUEBLA,21,CUAUTLANCINGO,041,LA TRINIDAD CHAUTENCO,1,65,36,29,4
PUEBLA,21,CUAUTLANCINGO,041,SAN JUAN CUAUTLANCINGO,105,18332,9562,8770,1131
PUEBLA,21,CUAUTLANCINGO,041,SAN LORENZO ALMECATLA,14,4342,2148,2194,155
PUEBLA,21,CUAUTLANCINGO,041,SANCTORUM,23,4625,2360,2265,224
PUEBLA,21,CUAYUCA DE ANDRADE,042,CAÑADA CHICA,3,46,23,23,4
PUEBLA,21,CUAYUCA DE ANDRADE,042,CERRO GORDO,2,5,2,3,1
PUEBLA,21,CUAYUCA DE ANDRADE,042,CUAJILOTE,2,23,9,14,2
PUEBLA,21,CUAYUCA DE ANDRADE,042,DÉBORA CARRIZAL,3,96,49,47,5
PUEBLA,21,CUAYUCA DE ANDRADE,042,EL MIRADOR EL GRANDE,2,15,9,6,3
PUEBLA,21,CUAYUCA DE ANDRADE,042,LA PROVIDENCIA,2,7,3,4,1
PUEBLA,21,CUAYUCA DE ANDRADE,042,LA VÍBORA,2,9,2,7,1
PUEBLA,21,CUAYUCA DE ANDRADE,042,MICHAPA,2,21,13,8,2
PUEBLA,21,CUAYUCA DE ANDRADE,042,SAN PEDRO CUAYUCA,7,552,253,299,27
PUEBLA,21,CUAYUCA DE ANDRADE,042,SANTA CRUZ ORGANAL,2,19,6,13,2
PUEBLA,21,CUAYUCA DE ANDRADE,042,TLACOTEPEC,3,45,25,20,4
PUEBLA,21,CUETZALAN DEL PROGRESO,043,ACAXILOCO,3,220,106,114,12
PUEBLA,21,CUETZALAN DEL PROGRESO,043,ACHIAUTA,1,7,5,2,1
PUEBLA,21,CUETZALAN DEL PROGRESO,043,ALAHUACAPAN,2,28,8,20,3
PUEBLA,21,CUETZALAN DEL PROGRESO,043,ATALPAN,2,40,16,24,2
PUEBLA,21,CUETZALAN DEL PROGRESO,043,ATEMOLÓN,2,53,23,30,3
PUEBLA,21,CUETZALAN DEL PROGRESO,043,ATEQUIZA,3,38,31,7,3
PUEBLA,21,CUETZALAN DEL PROGRESO,043,AYOTZINAPAN,3,268,136,132,13
PUEBLA,21,CUETZALAN DEL PROGRESO,043,CACATECUAUTA,4,74,41,33,6
PUEBLA,21,CUETZALAN DEL PROGRESO,043,CAHUAYOGCO,2,23,11,12,2
PUEBLA,21,CUETZALAN DEL PROGRESO,043,CALATEPEC,1,4,2,2,1
PUEBLA,21,CUETZALAN DEL PROGRESO,043,CAPOLA,2,59,29,30,3
PUEBLA,21,CUETZALAN DEL PROGRESO,043,CAXALTEPEC,2,42,19,23,3
PUEBLA,21,CUETZALAN DEL PROGRESO,043,CEDRAL ATALPAN,2,23,14,9,4
PUEBLA,21,CUETZALAN DEL PROGRESO,043,CHICUEYACO,2,32,18,14,2
PUEBLA,21,CUETZALAN DEL PROGRESO,043,CHILCUAUHTA,4,71,32,39,6
PUEBLA,21,CUETZALAN DEL PROGRESO,043,CIUDAD DE CUETZALAN,21,2825,1511,1314,148
PUEBLA,21,CUETZALAN DEL PROGRESO,043,COHUATICHAN,3,54,21,33,4
PUEBLA,21,CUETZALAN DEL PROGRESO,043,COZAMALOMILA,1,6,4,2,1
PUEBLA,21,CUETZALAN DEL PROGRESO,043,CUAHUTAMANCA,2,32,13,19,2
PUEBLA,21,CUETZALAN DEL PROGRESO,043,CUAHUTAMAZACO,4,284,147,137,14
PUEBLA,21,CUETZALAN DEL PROGRESO,043,CUAMAYTA,3,17,6,11,2
PUEBLA,21,CUETZALAN DEL PROGRESO,043,CUAMONO,3,43,22,21,3
PUEBLA,21,CUETZALAN DEL PROGRESO,043,CUATRO CAMINOS,1,22,11,11,2
PUEBLA,21,CUETZALAN DEL PROGRESO,043,CUAUHTAPANALOYAN,3,198,95,103,12
PUEBLA,21,CUETZALAN DEL PROGRESO,043,CUICHAT,2,37,19,18,2
PUEBLA,21,CUETZALAN DEL PROGRESO,043,EL AGUACATE,1,18,7,11,1
PUEBLA,21,CUETZALAN DEL PROGRESO,043,EQUIMITA,2,32,16,16,2
PUEBLA,21,CUETZALAN DEL PROGRESO,043,IXTAHUATA,3,35,16,19,2
PUEBLA,21,CUETZALAN DEL PROGRESO,043,LA GALERA,2,15,6,9,2
PUEBLA,21,CUETZALAN DEL PROGRESO,043,LAS HAMACAS,2,52,23,29,3
PUEBLA,21,CUETZALAN DEL PROGRESO,043,LIMONCO,2,130,68,62,8
PUEBLA,21,CUETZALAN DEL PROGRESO,043,LIMONTITÁN,2,87,42,45,5
PUEBLA,21,CUETZALAN DEL PROGRESO,043,LOS MANANTIALES,2,12,7,5,2
PUEBLA,21,CUETZALAN DEL PROGRESO,043,MACUILACACO,1,9,4,5,1
PUEBLA,21,CUETZALAN DEL PROGRESO,043,NAHUIOGPAN,4,43,25,18,4
PUEBLA,21,CUETZALAN DEL PROGRESO,043,NECTEPEC,5,313,149,164,16
PUEBLA,21,CUETZALAN DEL PROGRESO,043,OLOPIOCO,2,10,6,4,2
PUEBLA,21,CUETZALAN DEL PROGRESO,043,PAHPATAPÁN,4,695,339,356,70
PUEBLA,21,CUETZALAN DEL PROGRESO,043,PAHUATAHU,1,5,2,3,1
PUEBLA,21,CUETZALAN DEL PROGRESO,043,PEPEXTA,5,338,157,181,16
PUEBLA,21,CUETZALAN DEL PROGRESO,043,PESMAPÁN,2,65,28,37,3
PUEBLA,21,CUETZALAN DEL PROGRESO,043,PINAHUISTA,4,279,155,124,14
PUEBLA,21,CUETZALAN DEL PROGRESO,043,QUEZAPA,1,16,9,7,1
PUEBLA,21,CUETZALAN DEL PROGRESO,043,REYESHOGPAN DE HIDALGO (EL MIRADOR),7,353,175,178,19
PUEBLA,21,CUETZALAN DEL PROGRESO,043,SAN ANDRÉS TZICUILAN,5,399,192,207,18
PUEBLA,21,CUETZALAN DEL PROGRESO,043,SANTA CRUZ TATEMPA,2,17,7,10,2
PUEBLA,21,CUETZALAN DEL PROGRESO,043,SANTIAGO YANCUITLALPAN,5,512,248,264,22
PUEBLA,21,CUETZALAN DEL PROGRESO,043,TACOPIZACTA,2,4,4,0,2
PUEBLA,21,CUETZALAN DEL PROGRESO,043,TACUAPAN,6,178,83,95,12
PUEBLA,21,CUETZALAN DEL PROGRESO,043,TAJKUILOL,3,53,28,25,3
PUEBLA,21,CUETZALAN DEL PROGRESO,043,TALTZINTÁN,2,22,14,8,2
PUEBLA,21,CUETZALAN DEL PROGRESO,043,TATAHUICTALTIPAN,2,15,7,8,2
PUEBLA,21,CUETZALAN DEL PROGRESO,043,TAXIPÉHUATL,4,88,49,39,8
PUEBLA,21,CUETZALAN DEL PROGRESO,043,TECAZO,2,26,9,17,3
PUEBLA,21,CUETZALAN DEL PROGRESO,043,TECOLAPA,2,17,8,9,2
PUEBLA,21,CUETZALAN DEL PROGRESO,043,TECOLTEPEC,2,63,37,26,4
PUEBLA,21,CUETZALAN DEL PROGRESO,043,TECUAHUTA,3,43,25,18,4
PUEBLA,21,CUETZALAN DEL PROGRESO,043,TENANGO,3,72,34,38,4
PUEBLA,21,CUETZALAN DEL PROGRESO,043,TENANGO ZACATIPAN,1,6,3,3,1
PUEBLA,21,CUETZALAN DEL PROGRESO,043,TENANIKÁN,2,28,15,13,4
PUEBLA,21,CUETZALAN DEL PROGRESO,043,TENCUIX,3,31,17,14,3
PUEBLA,21,CUETZALAN DEL PROGRESO,043,TENEXTEPEC,4,151,72,79,9
PUEBLA,21,CUETZALAN DEL PROGRESO,043,TEPANGO,4,314,166,148,13
PUEBLA,21,CUETZALAN DEL PROGRESO,043,TEPETITAN CHICO,3,33,18,15,4
PUEBLA,21,CUETZALAN DEL PROGRESO,043,TEPETITÁN REYESHOGPAN DE HIDALGO,1,189,84,105,10
PUEBLA,21,CUETZALAN DEL PROGRESO,043,TEPETITÁN ZACATIPAN,2,60,23,37,3
PUEBLA,21,CUETZALAN DEL PROGRESO,043,TEPETZALÁN,3,149,80,69,8
PUEBLA,21,CUETZALAN DEL PROGRESO,043,TEPETZALAN DE MIGUEL HIDALGO,4,67,37,30,6
PUEBLA,21,CUETZALAN DEL PROGRESO,043,TEPETZALAN TZICUILAN,1,113,45,68,6
PUEBLA,21,CUETZALAN DEL PROGRESO,043,TEPETZINTÁN,6,321,175,146,19
PUEBLA,21,CUETZALAN DEL PROGRESO,043,TEXOCHICO,1,5,2,3,1
PUEBLA,21,CUETZALAN DEL PROGRESO,043,TIXAPAN,2,43,19,24,3
PUEBLA,21,CUETZALAN DEL PROGRESO,043,TONALIX,2,73,41,32,4
PUEBLA,21,CUETZALAN DEL PROGRESO,043,TUZAMAPAN,3,106,55,51,6
PUEBLA,21,CUETZALAN DEL PROGRESO,043,TZANATCO,2,30,16,14,2
PUEBLA,21,CUETZALAN DEL PROGRESO,043,TZINACAPAN,7,968,468,500,45
PUEBLA,21,CUETZALAN DEL PROGRESO,043,TZOQUIACO,2,49,24,25,3
PUEBLA,21,CUETZALAN DEL PROGRESO,043,VISTA HERMOSA,2,34,18,16,3
PUEBLA,21,CUETZALAN DEL PROGRESO,043,XALCUAHUTA,2,100,45,55,5
PUEBLA,21,CUETZALAN DEL PROGRESO,043,XALPANAT,1,11,1,10,1
PUEBLA,21,CUETZALAN DEL PROGRESO,043,XALPANTZINGO,3,193,93,100,11
PUEBLA,21,CUETZALAN DEL PROGRESO,043,XALTEPEC,4,36,17,19,4
PUEBLA,21,CUETZALAN DEL PROGRESO,043,XALTICPAC,1,30,13,17,2
PUEBLA,21,CUETZALAN DEL PROGRESO,043,XALTIPAN,4,201,101,100,11
PUEBLA,21,CUETZALAN DEL PROGRESO,043,XALTZINTA,2,161,77,84,7
PUEBLA,21,CUETZALAN DEL PROGRESO,043,XILIAPAN,1,19,11,8,1
PUEBLA,21,CUETZALAN DEL PROGRESO,043,XILOXOCHICO DE RAFAEL ÁVILA CAMACHO,5,386,191,195,23
PUEBLA,21,CUETZALAN DEL PROGRESO,043,XILOXOCHIT,2,61,35,26,3
PUEBLA,21,CUETZALAN DEL PROGRESO,043,XOCHICAL,2,87,46,41,4
PUEBLA,21,CUETZALAN DEL PROGRESO,043,XOCOTA,3,49,24,25,4
PUEBLA,21,CUETZALAN DEL PROGRESO,043,XOCOYOLO,4,279,139,140,15
PUEBLA,21,CUETZALAN DEL PROGRESO,043,YOHUALICHAN,4,314,152,162,19
PUEBLA,21,CUETZALAN DEL PROGRESO,043,ZACATIPAN,4,554,270,284,24
PUEBLA,21,CUETZALAN DEL PROGRESO,043,ZILTEPEC,3,86,40,46,6
PUEBLA,21,CUETZALAN DEL PROGRESO,043,ZOPILOTEPEC,3,24,10,14,3
PUEBLA,21,CUYOACO,044,ALLENDE (COLONIA IGNACIO ALLENDE),3,236,121,115,11
PUEBLA,21,CUYOACO,044,BUENAVISTA DE GUERRERO,3,107,61,46,6
PUEBLA,21,CUYOACO,044,CUYOACO,7,857,433,424,112
PUEBLA,21,CUYOACO,044,EL CALVARIO,1,10,6,4,1
PUEBLA,21,CUYOACO,044,EL VALLE,3,135,63,72,7
PUEBLA,21,CUYOACO,044,EMILIANO ZAPATA (CHILAPA),2,41,23,18,2
PUEBLA,21,CUYOACO,044,FRANCISCO I. MADERO,4,153,76,77,9
PUEBLA,21,CUYOACO,044,GUADALUPE VICTORIA,3,156,87,69,7
PUEBLA,21,CUYOACO,044,INDEPENDENCIA,2,51,25,26,3
PUEBLA,21,CUYOACO,044,LA GLORIA,2,25,11,14,3
PUEBLA,21,CUYOACO,044,LA TRINIDAD POCHINTO,3,89,50,39,6
PUEBLA,21,CUYOACO,044,MORELOS,1,4,2,2,1
PUEBLA,21,CUYOACO,044,SAN ANDRÉS PAYUCA,7,995,522,473,42
PUEBLA,21,CUYOACO,044,SANTIAGO XONACATLÁN,5,558,286,272,24
PUEBLA,21,CUYOACO,044,TEMEXTLA,5,613,289,324,26
PUEBLA,21,CUYOACO,044,TEXCAL,4,195,96,99,12
PUEBLA,21,CHALCHICOMULA DE SESMA,045,AHUATEPEC DEL CAMINO,4,355,180,175,17
PUEBLA,21,CHALCHICOMULA DE SESMA,045,ÁLVARO OBREGÓN,2,90,45,45,4
PUEBLA,21,CHALCHICOMULA DE SESMA,045,CIUDAD SERDÁN,43,10680,5747,4933,548
PUEBLA,21,CHALCHICOMULA DE SESMA,045,CONCEPCIÓN OVIEDO (RANCHO VIEJO),2,37,17,20,2
PUEBLA,21,CHALCHICOMULA DE SESMA,045,DOLORES BUENPAÍS,2,58,26,32,3
PUEBLA,21,CHALCHICOMULA DE SESMA,045,EL VELADERO (SANTA CRUZ VELADERO),3,187,83,104,10
PUEBLA,21,CHALCHICOMULA DE SESMA,045,GUADALUPE SABINAL,3,93,49,44,5
PUEBLA,21,CHALCHICOMULA DE SESMA,045,JESÚS MARÍA,2,59,27,32,3
PUEBLA,21,CHALCHICOMULA DE SESMA,045,JESÚS NAZARENO (RANCHO NUEVO),3,135,66,69,7
PUEBLA,21,CHALCHICOMULA DE SESMA,045,LAS PALMAS,2,64,26,38,4
PUEBLA,21,CHALCHICOMULA DE SESMA,045,LOS RICARDOS,3,233,106,127,12
PUEBLA,21,CHALCHICOMULA DE SESMA,045,MARAVILLAS,4,107,57,50,7
PUEBLA,21,CHALCHICOMULA DE SESMA,045,SAN ANTONIO TECAJETES,1,6,1,5,1
PUEBLA,21,CHALCHICOMULA DE SESMA,045,SAN BLAS TECOLOTEPEC (GAVIOTAS),2,68,37,31,4
PUEBLA,21,CHALCHICOMULA DE SESMA,045,SAN DIEGO TEXMELUCAN,1,15,6,9,1
PUEBLA,21,CHALCHICOMULA DE SESMA,045,SAN FRANCISCO CUAUTLANCINGO (EL BARRIO),4,586,266,320,27
PUEBLA,21,CHALCHICOMULA DE SESMA,045,SAN ISIDRO CANOAS ALTAS,4,190,98,92,10
PUEBLA,21,CHALCHICOMULA DE SESMA,045,SAN JUAN ARCOS OJO DE AGUA,2,224,111,113,8
PUEBLA,21,CHALCHICOMULA DE SESMA,045,SAN MARTÍN OJO DE AGUA,3,362,173,189,14
PUEBLA,21,CHALCHICOMULA DE SESMA,045,SAN MIGUEL OCOTENCO,4,385,185,200,16
PUEBLA,21,CHALCHICOMULA DE SESMA,045,SAN PEDRO CONCEPCIÓN CANDELARIA (CANDELARIA),3,16,7,9,3
PUEBLA,21,CHALCHICOMULA DE SESMA,045,SAN PEDRO TEMAMATLA,3,264,115,149,11
PUEBLA,21,CHALCHICOMULA DE SESMA,045,SANTA INÉS BORBOLLA,2,60,19,41,3
PUEBLA,21,CHALCHICOMULA DE SESMA,045,SANTA MARÍA TECHACHALCO,3,239,111,128,12
PUEBLA,21,CHAPULCO,046,AQUILES SERDÁN,3,46,18,28,4
PUEBLA,21,CHAPULCO,046,CHAPULCO,8,1431,732,699,59
PUEBLA,21,CHAPULCO,046,PUENTE COLORADO,5,486,233,253,20
PUEBLA,21,CHIAUTLA,047,CAÑADA GRANDE,3,28,11,17,3
PUEBLA,21,CHIAUTLA,047,CASCALOTE DE BRAVO,3,32,14,18,3
PUEBLA,21,CHIAUTLA,047,CENTEOCALA,3,42,21,21,4
PUEBLA,21,CHIAUTLA,047,CHIAUZUMBA,3,26,15,11,3
PUEBLA,21,CHIAUTLA,047,CIUDAD DE CHIAUTLA DE TAPIA,24,3830,2016,1814,216
PUEBLA,21,CHIAUTLA,047,CRUZ BLANCA (TITILINTZÍN),1,153,86,67,8
PUEBLA,21,CHIAUTLA,047,CRUZ VERDE,3,58,29,29,6
PUEBLA,21,CHIAUTLA,047,EL LIMÓN,1,16,5,11,2
PUEBLA,21,CHIAUTLA,047,IXHUATLÁN,3,60,34,26,6
PUEBLA,21,CHIAUTLA,047,LA CANTERA (SAN MIGUEL LA CANTERA),2,9,2,7,1
PUEBLA,21,CHIAUTLA,047,LA PALMA,2,43,20,23,5
PUEBLA,21,CHIAUTLA,047,LOS LINDEROS,2,5,4,1,1
PUEBLA,21,CHIAUTLA,047,MEXICALCINGO DE LOS LLANOS,3,16,7,9,3
PUEBLA,21,CHIAUTLA,047,NAHUITUXCO,2,15,11,4,2
PUEBLA,21,CHIAUTLA,047,NANTZINTLA,2,5,3,2,1
PUEBLA,21,CHIAUTLA,047,PILCAYA (SAN JUAN PILCAYA),5,262,121,141,16
PUEBLA,21,CHIAUTLA,047,QUETZOTLA (SAN MIGUEL),3,66,37,29,5
PUEBLA,21,CHIAUTLA,047,SAN FRANCISCO JAVIER,3,9,3,6,3
PUEBLA,21,CHIAUTLA,047,SAN JUAN DE LOS RÍOS (SAN JUAN DEL RÍO),3,37,20,17,5
PUEBLA,21,CHIAUTLA,047,SAN MIGUEL CHICOTITLÁN,3,41,18,23,4
PUEBLA,21,CHIAUTLA,047,SAN MIGUEL EJIDO,2,197,86,111,9
PUEBLA,21,CHIAUTLA,047,SANTA ANA TECOLAPA,4,83,41,42,8
PUEBLA,21,CHIAUTLA,047,TEPOXMATLA,3,33,12,21,4
PUEBLA,21,CHIAUTLA,047,TLAICA,1,12,6,6,1
PUEBLA,21,CHIAUTLA,047,TLANCUALPICAN,9,1060,507,553,50
PUEBLA,21,CHIAUTLA,047,VISTA HERMOSA,1,149,72,77,6
PUEBLA,21,CHIAUTZINGO,048,SAN AGUSTÍN ATZOMPA,3,328,163,165,15
PUEBLA,21,CHIAUTZINGO,048,SAN ANTONIO TLATENCO,6,733,379,354,27
PUEBLA,21,CHIAUTZINGO,048,SAN JUAN TETLA,4,669,321,348,29
PUEBLA,21,CHIAUTZINGO,048,SAN LORENZO CHIAUTZINGO,13,2674,1356,1318,108
PUEBLA,21,CHIAUTZINGO,048,SAN NICOLÁS ZECALACOAYAN,5,474,221,253,21
PUEBLA,21,CHICONCUAUTLA,049,ACALAMA,3,32,17,15,4
PUEBLA,21,CHICONCUAUTLA,049,AXOCOPACTLA,3,26,16,10,3
PUEBLA,21,CHICONCUAUTLA,049,AZACATLA,2,10,1,9,2
PUEBLA,21,CHICONCUAUTLA,049,BENITO JUÁREZ,3,76,38,38,6
PUEBLA,21,CHICONCUAUTLA,049,CHICONCUAUTLA,16,1599,780,819,69
PUEBLA,21,CHICONCUAUTLA,049,COSAMALOAPAN,3,59,33,26,6
PUEBLA,21,CHICONCUAUTLA,049,CUETZALINGO,2,155,72,83,8
PUEBLA,21,CHICONCUAUTLA,049,HUAUTLA,3,31,14,17,3
PUEBLA,21,CHICONCUAUTLA,049,HUIXTLACUATLA,2,24,10,14,2
PUEBLA,21,CHICONCUAUTLA,049,ITLANTIXCALI,1,8,4,4,1
PUEBLA,21,CHICONCUAUTLA,049,IXTACZOQUITLA,2,69,30,39,3
PUEBLA,21,CHICONCUAUTLA,049,MACUILACATLA,3,46,16,30,3
PUEBLA,21,CHICONCUAUTLA,049,MIMITLA,2,26,11,15,2
PUEBLA,21,CHICONCUAUTLA,049,PALZOQUITLA,2,109,53,56,5
PUEBLA,21,CHICONCUAUTLA,049,SAN LORENZO TLAXIPEHUALA,4,554,285,269,25
PUEBLA,21,CHICONCUAUTLA,049,TLALHUAPAN,4,438,235,203,19
PUEBLA,21,CHICONCUAUTLA,049,TLALTENANGO,3,196,98,98,8
PUEBLA,21,CHICONCUAUTLA,049,TLAXCO (SANTIAGO TLAXCO),4,565,285,280,23
PUEBLA,21,CHICONCUAUTLA,049,TOXTLA,3,459,227,232,19
PUEBLA,21,CHICONCUAUTLA,049,ZACATEPEC,4,198,104,94,9
PUEBLA,21,CHICONCUAUTLA,049,ZEMPOALA,4,504,264,240,19
PUEBLA,21,CHICHIQUILA,050,ACALOCOTLA,4,180,98,82,8
PUEBLA,21,CHICHIQUILA,050,AMAXOCHITLA,2,46,26,20,3
PUEBLA,21,CHICHIQUILA,050,ATLAXCO,5,175,91,84,10
PUEBLA,21,CHICHIQUILA,050,BARRIO DEL CARMEN,1,7,4,3,1
PUEBLA,21,CHICHIQUILA,050,CHICHIQUILA,7,987,505,482,36
PUEBLA,21,CHICHIQUILA,050,CINCO DE MAYO,2,99,43,56,5
PUEBLA,21,CHICHIQUILA,050,COLONIA GUADALUPE,2,78,37,41,4
PUEBLA,21,CHICHIQUILA,050,DOS RÍOS,3,116,63,53,7
PUEBLA,21,CHICHIQUILA,050,EL MIRADOR,2,78,35,43,3
PUEBLA,21,CHICHIQUILA,050,EL PALMAR,3,341,174,167,15
PUEBLA,21,CHICHIQUILA,050,EL PROGRESO,4,367,174,193,15
PUEBLA,21,CHICHIQUILA,050,EL ROSARIO,3,180,79,101,12
PUEBLA,21,CHICHIQUILA,050,EL TRIUNFO,4,309,157,152,13
PUEBLA,21,CHICHIQUILA,050,ERMITA,2,65,31,34,3
PUEBLA,21,CHICHIQUILA,050,HUAXCALECA,4,743,363,380,26
PUEBLA,21,CHICHIQUILA,050,JESÚS MARÍA ACATLA,3,161,89,72,10
PUEBLA,21,CHICHIQUILA,050,LA PROVIDENCIA,3,82,39,43,6
PUEBLA,21,CHICHIQUILA,050,LA UNIÓN,1,55,25,30,3
PUEBLA,21,CHICHIQUILA,050,LANCHO,2,7,3,4,1
PUEBLA,21,CHICHIQUILA,050,LAS TRINCHERAS,2,42,30,12,3
PUEBLA,21,CHICHIQUILA,050,LOMA BONITA,2,13,5,8,2
PUEBLA,21,CHICHIQUILA,050,NENEHUACA,4,290,146,144,12
PUEBLA,21,CHICHIQUILA,050,OJO DE AGUA,4,289,128,161,14
PUEBLA,21,CHICHIQUILA,050,RANCHO NUEVO,3,222,107,115,10
PUEBLA,21,CHICHIQUILA,050,SAN ANTONIO,2,31,8,23,1
PUEBLA,21,CHICHIQUILA,050,SAN DIEGO DEL PALMAR,3,167,84,83,9
PUEBLA,21,CHICHIQUILA,050,SAN JOSÉ,2,92,44,48,4
PUEBLA,21,CHICHIQUILA,050,SAN JOSÉ ACATLA,3,187,97,90,9
PUEBLA,21,CHICHIQUILA,050,SAN JOSÉ DE LA RAYA,3,48,24,24,4
PUEBLA,21,CHICHIQUILA,050,SAN JOSÉ DE LAS FLORES,2,7,4,3,1
PUEBLA,21,CHICHIQUILA,050,SAN LUIS ESPERANZA,2,32,17,15,3
PUEBLA,21,CHICHIQUILA,050,SAN MARTÍN COMALAPA,4,202,102,100,9
PUEBLA,21,CHICHIQUILA,050,SANTIAGO,3,29,14,15,2
PUEBLA,21,CHICHIQUILA,050,TEPEHUACAN,3,61,32,29,4
PUEBLA,21,CHICHIQUILA,050,TIZAPA,4,198,94,104,10
PUEBLA,21,CHICHIQUILA,050,VISTA HERMOSA,2,68,30,38,4
PUEBLA,21,CHICHIQUILA,050,XOCHIHUIXTLA,2,123,69,54,7
PUEBLA,21,CHICHIQUILA,050,XOCHIMILCO,4,195,97,98,12
PUEBLA,21,CHICHIQUILA,050,XOPANAPA,3,159,84,75,11
PUEBLA,21,CHIETLA,051,AHUEHUETZINGO,4,241,134,107,17
PUEBLA,21,CHIETLA,051,ATENCINGO,14,2479,1271,1208,197
PUEBLA,21,CHIETLA,051,BUENAVISTA DE BENITO JUÁREZ,4,423,217,206,22
PUEBLA,21,CHIETLA,051,CHIETLA,11,2038,1014,1024,147
PUEBLA,21,CHIETLA,051,COFRADÍA,2,16,9,7,2
PUEBLA,21,CHIETLA,051,DON ROQUE,3,75,38,37,5
PUEBLA,21,CHIETLA,051,EL CAPIRE,2,12,6,6,2
PUEBLA,21,CHIETLA,051,EL CASCALOTE (LÁZARO CÁRDENAS),2,53,24,29,3
PUEBLA,21,CHIETLA,051,EL ÓRGANO,1,72,40,32,3
PUEBLA,21,CHIETLA,051,ESCAPE DE LAGUNILLAS,7,1076,532,544,57
PUEBLA,21,CHIETLA,051,EX-HACIENDA DE JALTEPEC,1,9,6,3,1
PUEBLA,21,CHIETLA,051,LA PALMA (EL TRINQUETE),2,24,13,11,4
PUEBLA,21,CHIETLA,051,LA SOLEDAD,3,74,39,35,4
PUEBLA,21,CHIETLA,051,LAGUNILLAS DE RAYÓN (ALCHICHICA),4,231,105,126,17
PUEBLA,21,CHIETLA,051,PUEBLO NUEVO DE PORFIRIO DÍAZ,3,185,99,86,9
PUEBLA,21,CHIETLA,051,SAN ANTONIO COAYUCA,4,269,131,138,16
PUEBLA,21,CHIETLA,051,SAN ISIDRO EL ORGANAL,2,66,33,33,4
PUEBLA,21,CHIETLA,051,SAN ISIDRO LA SÁBILA,2,29,13,16,2
PUEBLA,21,CHIETLA,051,SAN JOSÉ CHIETLA,1,9,5,4,0
PUEBLA,21,CHIETLA,051,SAN JOSÉ LOS LAURELES,3,54,22,32,4
PUEBLA,21,CHIETLA,051,SAN LUCAS HUAJOTITLÁN,3,14,9,5,2
PUEBLA,21,CHIETLA,051,SAN MIGUEL LA TOMA,2,105,54,51,6
PUEBLA,21,CHIETLA,051,SAN MIGUEL TECOLACIO,3,168,95,73,9
PUEBLA,21,CHIETLA,051,SAN NICOLÁS TENEXCALCO,4,245,122,123,13
PUEBLA,21,CHIETLA,051,SAN VICENTE DE PAUL,2,5,3,2,1
PUEBLA,21,CHIETLA,051,SANTA CRUZ EL MIRADOR,2,70,35,35,3
PUEBLA,21,CHIETLA,051,TEMAXCALAPA DE GABINO BARREDA,4,142,70,72,10
PUEBLA,21,CHIETLA,051,TZOMPAHUACÁN,4,127,60,67,8
PUEBLA,21,CHIETLA,051,VIBORILLAS DE HIDALGO,4,221,109,112,14
PUEBLA,21,CHIGMECATITLÁN,052,CHIGMECATITLÁN,4,223,112,111,15
PUEBLA,21,CHIGNAHUAPAN,053,ACOCULCO (ALAMEDILLA),5,609,327,282,24
PUEBLA,21,CHIGNAHUAPAN,053,ACOLIHUIA,5,221,113,108,11
PUEBLA,21,CHIGNAHUAPAN,053,AJOLOTLA,3,130,62,68,7
PUEBLA,21,CHIGNAHUAPAN,053,ATLAMAXAC,2,63,32,31,4
PUEBLA,21,CHIGNAHUAPAN,053,BUENOS AIRES (PRESA SAN FRANCISCO),3,75,34,41,5
PUEBLA,21,CHIGNAHUAPAN,053,CALAPA,3,88,46,42,6
PUEBLA,21,CHIGNAHUAPAN,053,CAPULAQUITO,2,89,48,41,4
PUEBLA,21,CHIGNAHUAPAN,053,CIÉNEGA LARGA,4,573,290,283,23
PUEBLA,21,CHIGNAHUAPAN,053,CIUDAD DE CHIGNAHUAPAN,47,10419,5588,4831,567
PUEBLA,21,CHIGNAHUAPAN,053,COACOYUNGA,2,20,9,11,3
PUEBLA,21,CHIGNAHUAPAN,053,CRUZ COLORADA,3,121,53,68,7
PUEBLA,21,CHIGNAHUAPAN,053,CUAUTELOLULCO,4,264,132,132,13
PUEBLA,21,CHIGNAHUAPAN,053,EL ECO,3,20,11,9,3
PUEBLA,21,CHIGNAHUAPAN,053,EL FRESNO,3,38,18,20,3
PUEBLA,21,CHIGNAHUAPAN,053,EL MANZANITO,2,14,8,6,2
PUEBLA,21,CHIGNAHUAPAN,053,EL PAREDÓN,6,787,386,401,34
PUEBLA,21,CHIGNAHUAPAN,053,EL SIFÓN,2,30,13,17,2
PUEBLA,21,CHIGNAHUAPAN,053,EL TESMOLAR,1,2,0,2,1
PUEBLA,21,CHIGNAHUAPAN,053,GENERAL RAFAEL ÁVILA CAMACHO (TEOPAN),2,65,30,35,3
PUEBLA,21,CHIGNAHUAPAN,053,IXTLAHUACA (PALANCINGO),4,645,312,333,29
PUEBLA,21,CHIGNAHUAPAN,053,IXTLAHUACA BARRIO,1,79,36,43,3
PUEBLA,21,CHIGNAHUAPAN,053,JONUCO PEDERNALES,5,237,123,114,11
PUEBLA,21,CHIGNAHUAPAN,053,LA GLORIA (PRIMERA SECCIÓN),1,13,8,5,2
PUEBLA,21,CHIGNAHUAPAN,053,LA GLORIA (SEGUNDA SECCIÓN),3,74,35,39,5
PUEBLA,21,CHIGNAHUAPAN,053,LA QUINTA,1,8,4,4,1
PUEBLA,21,CHIGNAHUAPAN,053,LA YERBA,2,22,8,14,2
PUEBLA,21,CHIGNAHUAPAN,053,LAS CABRAS,1,7,1,6,1
PUEBLA,21,CHIGNAHUAPAN,053,LAS MESAS,6,109,58,51,9
PUEBLA,21,CHIGNAHUAPAN,053,LAS VÍBORAS,2,8,5,3,2
PUEBLA,21,CHIGNAHUAPAN,053,LLANO GRANDE (EL ASERRADERO),5,293,150,143,17
PUEBLA,21,CHIGNAHUAPAN,053,LLANO VERDE,4,167,85,82,9
PUEBLA,21,CHIGNAHUAPAN,053,LOMA ALTA,4,504,230,274,22
PUEBLA,21,CHIGNAHUAPAN,053,LOS RANCHOS (RINCONADA),1,7,4,3,1
PUEBLA,21,CHIGNAHUAPAN,053,LOS REYES,2,37,19,18,2
PUEBLA,21,CHIGNAHUAPAN,053,MATLAHUACALA,2,17,8,9,2
PUEBLA,21,CHIGNAHUAPAN,053,MATLAHUACALES DE AQUILES SERDÁN,5,497,241,256,23
PUEBLA,21,CHIGNAHUAPAN,053,MICHAC,3,279,139,140,12
PUEBLA,21,CHIGNAHUAPAN,053,NACAYOLO,1,12,1,11,1
PUEBLA,21,CHIGNAHUAPAN,053,NUEVO SAN CLAUDIO (CARRETERO),1,18,11,7,1
PUEBLA,21,CHIGNAHUAPAN,053,OCOJALA,3,146,83,63,7
PUEBLA,21,CHIGNAHUAPAN,053,PAXTLA,1,10,4,6,1
PUEBLA,21,CHIGNAHUAPAN,053,PIEDRA ANCHA,3,75,37,38,4
PUEBLA,21,CHIGNAHUAPAN,053,POTRERILLOS,2,62,28,34,4
PUEBLA,21,CHIGNAHUAPAN,053,PUEBLO NUEVO (PEÑUELAS),4,207,105,102,11
PUEBLA,21,CHIGNAHUAPAN,053,RINCONADA,4,455,236,219,19
PUEBLA,21,CHIGNAHUAPAN,053,RÍO BLANCO (SEBASTOPOL),1,19,6,13,1
PUEBLA,21,CHIGNAHUAPAN,053,RÍO CHICO,2,85,45,40,4
PUEBLA,21,CHIGNAHUAPAN,053,SAN ANTONIO MATLAHUACALES,5,556,290,266,27
PUEBLA,21,CHIGNAHUAPAN,053,SAN CLAUDIO,1,7,2,5,1
PUEBLA,21,CHIGNAHUAPAN,053,SAN FRANCISCO TERRERILLOS,3,154,79,75,9
PUEBLA,21,CHIGNAHUAPAN,053,SAN ISIDRO COLIUCA,2,25,10,15,2
PUEBLA,21,CHIGNAHUAPAN,053,SAN JOSÉ ATZINTLIMEYA,2,74,30,44,3
PUEBLA,21,CHIGNAHUAPAN,053,SAN JOSÉ CORRAL BLANCO,3,312,145,167,14
PUEBLA,21,CHIGNAHUAPAN,053,SAN LUIS DEL VALLE,3,128,61,67,7
PUEBLA,21,CHIGNAHUAPAN,053,SAN MIGUEL LASTIRI,2,15,7,8,2
PUEBLA,21,CHIGNAHUAPAN,053,SAN MIGUEL PEDERNALES,2,23,8,15,2
PUEBLA,21,CHIGNAHUAPAN,053,SEBASTOPOL,3,293,146,147,12
PUEBLA,21,CHIGNAHUAPAN,053,TECOLOQUILLO,4,137,74,63,10
PUEBLA,21,CHIGNAHUAPAN,053,TECOYUCA,2,26,17,9,3
PUEBLA,21,CHIGNAHUAPAN,053,TENANCINGO,3,127,62,65,7
PUEBLA,21,CHIGNAHUAPAN,053,TENEXTLA,3,336,180,156,16
PUEBLA,21,CHIGNAHUAPAN,053,TOLTEMPAN,2,258,125,133,10
PUEBLA,21,CHIGNAHUAPAN,053,TRES CABEZAS,4,322,149,173,15
PUEBLA,21,CHIGNAHUAPAN,053,TZITLA,3,264,134,130,10
PUEBLA,21,CHIGNAHUAPAN,053,VILLA CUAUHTÉMOC,4,335,175,160,17
PUEBLA,21,CHIGNAHUAPAN,053,ZOTOLTEPEC,3,28,21,7,3
PUEBLA,21,CHIGNAUTLA,054,ANALCO,2,65,37,28,3
PUEBLA,21,CHIGNAUTLA,054,CALICANTO,1,20,6,14,1
PUEBLA,21,CHIGNAUTLA,054,CHIGNAUTLA,17,3781,1907,1874,176
PUEBLA,21,CHIGNAUTLA,054,COAHUIXCO,9,1289,664,625,49
PUEBLA,21,CHIGNAUTLA,054,COATZALA,1,95,40,55,4
PUEBLA,21,CHIGNAUTLA,054,CRUTZITZIN,2,100,38,62,4
PUEBLA,21,CHIGNAUTLA,054,EL ENCANTO,1,12,6,6,1
PUEBLA,21,CHIGNAUTLA,054,ENCINO RICO,1,3,2,1,1
PUEBLA,21,CHIGNAUTLA,054,HUAPALTEPEC (ZACATAMÁNIX),2,87,41,46,3
PUEBLA,21,CHIGNAUTLA,054,LA AGUARDIENTERA,2,65,35,30,3
PUEBLA,21,CHIGNAUTLA,054,LOS HUMEROS,3,143,62,81,10
PUEBLA,21,CHIGNAUTLA,054,LOS PARAJES (ZOMPANATENO),4,153,70,83,9
PUEBLA,21,CHIGNAUTLA,054,SAN ISIDRO,4,621,326,295,25
PUEBLA,21,CHIGNAUTLA,054,SECCIÓN TERCERA DE CHIGNAUTLA,1,600,328,272,18
PUEBLA,21,CHIGNAUTLA,054,SOSA,4,903,459,444,30
PUEBLA,21,CHIGNAUTLA,054,TALZINTÁN,1,32,20,12,2
PUEBLA,21,CHIGNAUTLA,054,TEPEPAN,3,264,142,122,12
PUEBLA,21,CHIGNAUTLA,054,TEQUIMILA,2,416,194,222,16
PUEBLA,21,CHIGNAUTLA,054,TEZOHUATEPEC (TEZOTEPEC),2,219,114,105,14
PUEBLA,21,CHIGNAUTLA,054,YOPI,4,354,172,182,13
PUEBLA,21,CHILA,055,CHILA,6,593,306,287,33
PUEBLA,21,CHILA,055,ESTANCIA BLANCA (RANCHO LA ESTANCIA BLANCA),2,10,3,7,2
PUEBLA,21,CHILA,055,FRANCISCO IBARRA RAMOS,5,285,135,150,18
PUEBLA,21,CHILA,055,LA ESTANCIA COLORADA,2,9,3,6,2
PUEBLA,21,CHILA,055,LA TRINIDAD,2,58,25,33,4
PUEBLA,21,CHILA,055,LAS SIDRAS,2,123,50,73,6
PUEBLA,21,CHILA,055,SAN ISIDRO,2,5,3,2,1
PUEBLA,21,CHILA,055,SAN JOSÉ CHAPULTEPEC,3,53,21,32,5
PUEBLA,21,CHILA,055,SANTA ANA LOS VÁZQUEZ,3,21,12,9,3
PUEBLA,21,CHILA,055,SANTIAGO LA PEDRERA,2,8,2,6,1
PUEBLA,21,CHILA DE LA SAL,056,CHILA DE LA SAL,4,220,110,110,14
PUEBLA,21,CHILA DE LA SAL,056,SAN PEDRO OCOTLÁN,3,87,46,41,6
PUEBLA,21,HONEY,057,AMAPOLOA,2,64,30,34,4
PUEBLA,21,HONEY,057,BUENA VISTA,3,92,40,52,5
PUEBLA,21,HONEY,057,CHILA DE JUÁREZ,4,355,174,181,17
PUEBLA,21,HONEY,057,EL MANZANO,2,31,14,17,2
PUEBLA,21,HONEY,057,HONEY,8,1078,619,459,44
PUEBLA,21,HONEY,057,HUEHUETLILLA,2,21,9,12,2
PUEBLA,21,HONEY,057,LA CUMBRE DEL MANZANO,3,141,66,75,8
PUEBLA,21,HONEY,057,LA MAGDALENA,3,419,194,225,20
PUEBLA,21,HONEY,057,RINCÓN DE CHILA,2,59,31,28,3
PUEBLA,21,HONEY,057,TONALIXCO,3,248,108,140,12
PUEBLA,21,HONEY,057,VISTA HERMOSA,2,34,15,19,3
PUEBLA,21,CHILCHOTLA,058,ACOCOMOTLA,4,210,111,99,12
PUEBLA,21,CHILCHOTLA,058,ALTO LUCERO,3,55,20,35,4
PUEBLA,21,CHILCHOTLA,058,BARRIO DEL CORAZÓN DE JESÚS TERCERA SECCIÓN,1,30,16,14,1
PUEBLA,21,CHILCHOTLA,058,COZALAPA,2,20,11,9,2
PUEBLA,21,CHILCHOTLA,058,EL CARMEN,3,273,141,132,12
PUEBLA,21,CHILCHOTLA,058,EMILIANO ZAPATA (SAN ISIDRO),2,95,49,46,5
PUEBLA,21,CHILCHOTLA,058,FRANCISCO I. MADERO,4,685,361,324,30
PUEBLA,21,CHILCHOTLA,058,IGNACIO ZARAGOZA,3,340,174,166,13
PUEBLA,21,CHILCHOTLA,058,IXTACAPA,1,4,2,2,1
PUEBLA,21,CHILCHOTLA,058,LA CANDELARIA,3,51,29,22,5
PUEBLA,21,CHILCHOTLA,058,LA LUZ,3,182,103,79,11
PUEBLA,21,CHILCHOTLA,058,LA PROVIDENCIA,4,180,99,81,11
PUEBLA,21,CHILCHOTLA,058,LA REFORMA,3,50,33,17,3
PUEBLA,21,CHILCHOTLA,058,LA TRINIDAD,3,178,84,94,11
PUEBLA,21,CHILCHOTLA,058,RAFAEL J. GARCÍA,10,2854,1459,1395,116
PUEBLA,21,CHILCHOTLA,058,SAN ANTONIO,4,355,186,169,18
PUEBLA,21,CHILCHOTLA,058,SAN JOSÉ CHICALOTLA,2,63,30,33,3
PUEBLA,21,CHILCHOTLA,058,SAN JOSÉ MANZANITOS,4,280,136,144,14
PUEBLA,21,CHILCHOTLA,058,SAN JUAN DEL VALLE,3,282,149,133,12
PUEBLA,21,CHILCHOTLA,058,SAN MIGUEL CALIXITLA (MIGUEL HIDALGO),2,70,36,34,4
PUEBLA,21,CHILCHOTLA,058,TETELTITLA,1,18,11,7,2
PUEBLA,21,CHILCHOTLA,058,VICENTE GUERRERO,3,165,90,75,11
PUEBLA,21,CHILCHOTLA,058,XALTEPEC,3,49,27,22,3
PUEBLA,21,CHINANTLA,059,AMATEPETLÁN,2,5,2,3,1
PUEBLA,21,CHINANTLA,059,BUENA VISTA,3,91,37,54,4
PUEBLA,21,CHINANTLA,059,CHINANTLA,6,514,244,270,32
PUEBLA,21,CHINANTLA,059,CUATECONTLA,2,23,9,14,3
PUEBLA,21,CHINANTLA,059,CUICATLÁN,2,39,21,18,3
PUEBLA,21,CHINANTLA,059,TEHUIXTLA (SAN FRANCISCO),1,9,3,6,1
PUEBLA,21,DOMINGO ARENAS,060,CHÁHUAC,3,319,141,178,12
PUEBLA,21,DOMINGO ARENAS,060,DOMINGO ARENAS,6,2006,1015,991,69
PUEBLA,21,ELOXOCHITLÁN,061,AMATITLA,2,53,26,27,3
PUEBLA,21,ELOXOCHITLÁN,061,ATEXACAPA,5,199,103,96,10
PUEBLA,21,ELOXOCHITLÁN,061,ATIOCUABTITLA,1,71,39,32,2
PUEBLA,21,ELOXOCHITLÁN,061,ATLALAQUIA,2,46,20,26,3
PUEBLA,21,ELOXOCHITLÁN,061,ATZITZICATLA,2,21,11,10,3
PUEBLA,21,ELOXOCHITLÁN,061,BUENA VISTA,2,68,33,35,3
PUEBLA,21,ELOXOCHITLÁN,061,CAMPO NUEVO DOS,3,74,40,34,4
PUEBLA,21,ELOXOCHITLÁN,061,CAMPO NUEVO UNO,3,50,25,25,6
PUEBLA,21,ELOXOCHITLÁN,061,CAÑADA RICA,2,33,14,19,2
PUEBLA,21,ELOXOCHITLÁN,061,CHIAPA,6,291,146,145,13
PUEBLA,21,ELOXOCHITLÁN,061,CUABTLAJAPA,2,85,42,43,4
PUEBLA,21,ELOXOCHITLÁN,061,EL CRUCERO,2,34,18,16,3
PUEBLA,21,ELOXOCHITLÁN,061,EL MIRADOR,2,75,44,31,3
PUEBLA,21,ELOXOCHITLÁN,061,EL TEPEYAC,4,118,61,57,6
PUEBLA,21,ELOXOCHITLÁN,061,ELOXOCHITLÁN,8,769,373,396,41
PUEBLA,21,ELOXOCHITLÁN,061,ITZCUINTONALCO,3,76,43,33,4
PUEBLA,21,ELOXOCHITLÁN,061,LAGUNA SECA,3,49,28,21,4
PUEBLA,21,ELOXOCHITLÁN,061,LOMA BONITA,3,226,106,120,10
PUEBLA,21,ELOXOCHITLÁN,061,MACUILTEPEC,2,44,20,24,2
PUEBLA,21,ELOXOCHITLÁN,061,OJO DE AGUA,2,56,28,28,3
PUEBLA,21,ELOXOCHITLÁN,061,PAPALOAPAN,6,185,102,83,11
PUEBLA,21,ELOXOCHITLÁN,061,RANCHO NUEVO,2,30,15,15,2
PUEBLA,21,ELOXOCHITLÁN,061,TEPEPAN,4,172,93,79,8
PUEBLA,21,ELOXOCHITLÁN,061,TEPETICPAC,2,49,21,28,2
PUEBLA,21,ELOXOCHITLÁN,061,TEPETZALA,2,83,44,39,2
PUEBLA,21,ELOXOCHITLÁN,061,TETZIQUITLA,3,31,15,16,3
PUEBLA,21,ELOXOCHITLÁN,061,TLACOTÉPETL,3,94,53,41,7
PUEBLA,21,ELOXOCHITLÁN,061,TLAZOLAPA,2,12,6,6,2
PUEBLA,21,ELOXOCHITLÁN,061,TUXTLA,2,24,12,12,2
PUEBLA,21,ELOXOCHITLÁN,061,UNIÓN Y PROGRESO,2,35,15,20,2
PUEBLA,21,ELOXOCHITLÁN,061,XONOTIPAN DE JUÁREZ,3,293,168,125,13
PUEBLA,21,ELOXOCHITLÁN,061,ZACACOAPAN,4,249,142,107,20
PUEBLA,21,EPATLÁN,062,EMILIANO ZAPATA,2,37,19,18,3
PUEBLA,21,EPATLÁN,062,LAS TRES CRUCES,2,48,21,27,2
PUEBLA,21,EPATLÁN,062,SAN JUAN EPATLÁN,6,592,294,298,29
PUEBLA,21,EPATLÁN,062,SAN MATEO OXTOTLA,2,26,12,14,2
PUEBLA,21,EPATLÁN,062,SAN MIGUEL EL PEDREGAL,1,19,14,5,2
PUEBLA,21,EPATLÁN,062,SANTA ANA NECOXTLA,4,388,187,201,19
PUEBLA,21,EPATLÁN,062,TEPEACATZINGO,2,64,33,31,3
PUEBLA,21,ESPERANZA,063,AHUATEPEC DE LA PRESA (AHUATEPEC),2,29,13,16,1
PUEBLA,21,ESPERANZA,063,BENITO JUÁREZ (CHICALOTE),2,37,22,15,3
PUEBLA,21,ESPERANZA,063,BOCA DEL MONTE,3,90,37,53,7
PUEBLA,21,ESPERANZA,063,ESPERANZA,6,2657,1361,1296,98
PUEBLA,21,ESPERANZA,063,GUADALUPE PILETAS (PUENTE NEGRO),2,38,17,21,2
PUEBLA,21,ESPERANZA,063,GUADALUPE POTREROS,2,10,4,6,2
PUEBLA,21,ESPERANZA,063,MAJADA RAYO,2,16,9,7,2
PUEBLA,21,ESPERANZA,063,OTILIO MONTAÑO,2,101,54,47,5
PUEBLA,21,ESPERANZA,063,SAN ANTONIO DE ABAJO,2,88,39,49,4
PUEBLA,21,ESPERANZA,063,SAN JOSÉ CUYACHAPA,4,276,117,159,15
PUEBLA,21,ESPERANZA,063,SAN JOSÉ ESPERANZA,2,80,35,45,4
PUEBLA,21,ESPERANZA,063,SAN MANUEL LA PUERTA,2,19,10,9,2
PUEBLA,21,ESPERANZA,063,SANTA CATARINA LOS REYES,4,190,91,99,10
PUEBLA,21,FRANCISCO Z. MENA,064,AGUA SALADA,1,8,5,3,1
PUEBLA,21,FRANCISCO Z. MENA,064,BENITO JUÁREZ,2,75,31,44,4
PUEBLA,21,FRANCISCO Z. MENA,064,BUENAVISTA (CERRO DEL TABLÓN),1,9,3,6,1
PUEBLA,21,FRANCISCO Z. MENA,064,CERCO DE PIEDRA,2,54,26,28,3
PUEBLA,21,FRANCISCO Z. MENA,064,COYOLITO (EL COYOL),4,190,95,95,13
PUEBLA,21,FRANCISCO Z. MENA,064,EL CERRO ALTAMIRANO,2,46,22,24,3
PUEBLA,21,FRANCISCO Z. MENA,064,EL ENCINAL,2,30,19,11,2
PUEBLA,21,FRANCISCO Z. MENA,064,EL LABERINTO,2,22,11,11,2
PUEBLA,21,FRANCISCO Z. MENA,064,EL OJITAL,1,14,9,5,1
PUEBLA,21,FRANCISCO Z. MENA,064,EL SERRANITO (EL LLANO),1,15,6,9,1
PUEBLA,21,FRANCISCO Z. MENA,064,EL TECOMATE,4,301,153,148,15
PUEBLA,21,FRANCISCO Z. MENA,064,HUITZILAC,4,307,153,154,14
PUEBLA,21,FRANCISCO Z. MENA,064,JALTOCAN,4,243,117,126,14
PUEBLA,21,FRANCISCO Z. MENA,064,LA CEIBA,2,54,24,30,3
PUEBLA,21,FRANCISCO Z. MENA,064,LA ESPERANZA,2,22,10,12,2
PUEBLA,21,FRANCISCO Z. MENA,064,LA GUADALUPE,3,117,46,71,7
PUEBLA,21,FRANCISCO Z. MENA,064,LA MÁQUINA,4,146,74,72,7
PUEBLA,21,FRANCISCO Z. MENA,064,LA MINA,4,161,77,84,8
PUEBLA,21,FRANCISCO Z. MENA,064,LA PAHUA,4,435,210,225,19
PUEBLA,21,FRANCISCO Z. MENA,064,LAS BALSAS,3,97,54,43,7
PUEBLA,21,FRANCISCO Z. MENA,064,LOS NARANJOS,3,83,43,40,5
PUEBLA,21,FRANCISCO Z. MENA,064,LOS PLANES,3,67,33,34,5
PUEBLA,21,FRANCISCO Z. MENA,064,METLALTOYUCA,13,1403,739,664,74
PUEBLA,21,FRANCISCO Z. MENA,064,MOCTEZUMA (GUAYABAL),3,150,70,80,8
PUEBLA,21,FRANCISCO Z. MENA,064,PALMA REAL DE ADENTRO,4,170,79,91,10
PUEBLA,21,FRANCISCO Z. MENA,064,PASO DEL ARROYO,2,53,28,25,3
PUEBLA,21,FRANCISCO Z. MENA,064,PLAN DE ARROYO,2,82,53,29,4
PUEBLA,21,FRANCISCO Z. MENA,064,RÍO VERDE,1,5,3,2,1
PUEBLA,21,FRANCISCO Z. MENA,064,SALSIPUEDES,1,30,19,11,2
PUEBLA,21,FRANCISCO Z. MENA,064,TIXTEPEC,3,97,43,54,7
PUEBLA,21,GENERAL FELIPE ÁNGELES,065,CANDELARIA PORTEZUELO,2,122,64,58,5
PUEBLA,21,GENERAL FELIPE ÁNGELES,065,GUADALUPE ANALCO,2,222,108,114,8
PUEBLA,21,GENERAL FELIPE ÁNGELES,065,SAN ANTONIO PORTEZUELO,3,903,445,458,38
PUEBLA,21,GENERAL FELIPE ÁNGELES,065,SAN JOSÉ BUENAVISTA,2,76,37,39,4
PUEBLA,21,GENERAL FELIPE ÁNGELES,065,SAN PABLO DE LAS TUNAS,5,1102,590,512,44
PUEBLA,21,GENERAL FELIPE ÁNGELES,065,SAN PEDRO CANDELARIA,3,23,8,15,3
PUEBLA,21,GENERAL FELIPE ÁNGELES,065,SANTA ÚRSULA CHICONQUIAC,5,1614,808,806,58
PUEBLA,21,GENERAL FELIPE ÁNGELES,065,SANTIAGO TENANGO,6,1021,528,493,38
PUEBLA,21,GUADALUPE,066,COLONIA LAS FLORES,2,14,8,6,2
PUEBLA,21,GUADALUPE,066,EL LIMÓN (SAN MIGUEL),3,84,40,44,6
PUEBLA,21,GUADALUPE,066,EL MIRADOR (SANTA CRUZ),1,54,24,30,2
PUEBLA,21,GUADALUPE,066,GUADALUPE,9,530,273,257,37
PUEBLA,21,GUADALUPE,066,GUADALUPITO,1,13,5,8,1
PUEBLA,21,GUADALUPE,066,LA ANGOSTURA (SAN MIGUEL),3,25,15,10,3
PUEBLA,21,GUADALUPE,066,LA PROVIDENCIA,3,88,60,28,5
PUEBLA,21,GUADALUPE,066,MIXQUITEPEC,6,294,157,137,19
PUEBLA,21,GUADALUPE,066,SAN ANTONIO CHILTEPEC,4,182,89,93,10
PUEBLA,21,GUADALUPE,066,SAN ISIDRO JEHUITAL,4,124,42,82,8
PUEBLA,21,GUADALUPE,066,SAN RAFAEL LA PAZ,3,126,62,64,8
PUEBLA,21,GUADALUPE,066,VISTA HERMOSA,3,102,49,53,6
PUEBLA,21,GUADALUPE VICTORIA,067,CANOÍTAS (SAN ANTONIO CANOÍTAS),3,139,54,85,7
PUEBLA,21,GUADALUPE VICTORIA,067,CARMEN SERDÁN,2,232,117,115,10
PUEBLA,21,GUADALUPE VICTORIA,067,EL PROGRESO,3,208,96,112,10
PUEBLA,21,GUADALUPE VICTORIA,067,GUADALUPE BUENAVISTA (EL TECOLOTE),2,57,32,25,3
PUEBLA,21,GUADALUPE VICTORIA,067,GUADALUPE VICTORIA,19,3769,1872,1897,162
PUEBLA,21,GUADALUPE VICTORIA,067,HACIENDA NUEVA (SAN PEDRO EL ÁGUILA),4,300,154,146,15
PUEBLA,21,GUADALUPE VICTORIA,067,MARAVILLAS,3,131,65,66,8
PUEBLA,21,GUADALUPE VICTORIA,067,QUECHULAC (SANTA CRUZ),5,475,237,238,23
PUEBLA,21,GUADALUPE VICTORIA,067,SAN JUAN LA MURALLA,2,30,9,21,2
PUEBLA,21,GUADALUPE VICTORIA,067,SAN LUIS ATEXCAC,3,75,37,38,5
PUEBLA,21,GUADALUPE VICTORIA,067,SAN RAFAEL,1,27,16,11,1
PUEBLA,21,HERMENEGILDO GALEANA,068,AGUA ZARCA,1,4,2,2,1
PUEBLA,21,HERMENEGILDO GALEANA,068,BIENVENIDO,9,657,332,325,30
PUEBLA,21,HERMENEGILDO GALEANA,068,CACATZALA,4,102,56,46,8
PUEBLA,21,HERMENEGILDO GALEANA,068,CALPUHUÁN,3,24,12,12,3
PUEBLA,21,HERMENEGILDO GALEANA,068,CAXTIYU,3,23,9,14,3
PUEBLA,21,HERMENEGILDO GALEANA,068,COYAY,3,290,151,139,15
PUEBLA,21,HERMENEGILDO GALEANA,068,COYOY,2,85,40,45,4
PUEBLA,21,HERMENEGILDO GALEANA,068,EL PLAN,2,61,32,29,3
PUEBLA,21,HERMENEGILDO GALEANA,068,EL ZECNA (EL PLATANAL),3,34,14,20,3
PUEBLA,21,HERMENEGILDO GALEANA,068,FRANCISCO OSORNO,5,236,117,119,13
PUEBLA,21,HERMENEGILDO GALEANA,068,IGNACIO RAMÍREZ,3,136,69,67,8
PUEBLA,21,HERMENEGILDO GALEANA,068,LA FÁBRICA,2,5,3,2,1
PUEBLA,21,HERMENEGILDO GALEANA,068,LA PILA,2,47,24,23,3
PUEBLA,21,HERMENEGILDO GALEANA,068,LACANUY,3,47,26,21,4
PUEBLA,21,HERMENEGILDO GALEANA,068,SAN ANTONIO CUANIXTEPEC,1,43,19,24,3
PUEBLA,21,HERMENEGILDO GALEANA,068,SAN ANTONIO HERMENEGILDO GALEANA,3,156,88,68,7
PUEBLA,21,HERMENEGILDO GALEANA,068,TAMPATAPO,3,16,7,9,3
PUEBLA,21,HUAQUECHULA,069,AHUATLÁN,3,60,30,30,4
PUEBLA,21,HUAQUECHULA,069,CACALOXÚCHITL,4,1233,655,578,45
PUEBLA,21,HUAQUECHULA,069,CHAMPUSCO (SECUNDARIA TÉCNICA NÚMERO 4) [ESCUELA],1,315,315,0,23
PUEBLA,21,HUAQUECHULA,069,EL PROGRESO,2,57,31,26,3
PUEBLA,21,HUAQUECHULA,069,HUAQUECHULA,5,1072,527,545,67
PUEBLA,21,HUAQUECHULA,069,HUEJOTAL (SANTIAGO HUEJOTAL),2,49,26,23,3
PUEBLA,21,HUAQUECHULA,069,LA LIBERTAD (SAN LORENZO TAJONAR),2,41,20,21,3
PUEBLA,21,HUAQUECHULA,069,LA VENTA,2,57,28,29,4
PUEBLA,21,HUAQUECHULA,069,MÁRTIR CUAUHTÉMOC (SAN JOSÉ CUAUHTÉMOC),2,102,50,52,5
PUEBLA,21,HUAQUECHULA,069,MORELOS MATLALA,3,56,30,26,5
PUEBLA,21,HUAQUECHULA,069,RANCHO NUEVO MICHAPITA (MICHAPITA),2,14,6,8,2
PUEBLA,21,HUAQUECHULA,069,SAN ANTONIO CUAUTLA,2,37,17,20,3
PUEBLA,21,HUAQUECHULA,069,SAN DIEGO EL ORGANAL,4,450,229,221,19
PUEBLA,21,HUAQUECHULA,069,SAN JUAN BAUTISTA,2,87,40,47,3
PUEBLA,21,HUAQUECHULA,069,SAN JUAN HUILUCO (HUILUCO),2,213,99,114,9
PUEBLA,21,HUAQUECHULA,069,SAN JUAN VALLARTA,2,192,89,103,8
PUEBLA,21,HUAQUECHULA,069,SAN LUCAS MATLALA,3,93,41,52,7
PUEBLA,21,HUAQUECHULA,069,SAN PEDRO CONTLA,2,24,11,13,2
PUEBLA,21,HUAQUECHULA,069,SANTA ANA COATEPEC,4,271,142,129,15
PUEBLA,21,HUAQUECHULA,069,SANTA CRUZ YANCUITLALPAN,3,37,17,20,3
PUEBLA,21,HUAQUECHULA,069,SANTIAGO TETLA,2,116,58,58,7
PUEBLA,21,HUAQUECHULA,069,SOLEDAD MORELOS,3,604,304,300,19
PUEBLA,21,HUAQUECHULA,069,SOTO Y GAMA,2,93,47,46,5
PUEBLA,21,HUAQUECHULA,069,TEACALCO DE DORANTES (SAN JOSÉ TEACALCO),3,413,202,211,16
PUEBLA,21,HUAQUECHULA,069,TEZONTEOPAN DE BONILLA,4,628,309,319,28
PUEBLA,21,HUAQUECHULA,069,TLAPETLAHUAYA,3,92,46,46,5
PUEBLA,21,HUAQUECHULA,069,TRONCONAL,3,328,179,149,13
PUEBLA,21,HUATLATLAUCA,070,AHUATEMPAN (SAN LUCAS AHUATEMPAN),2,31,13,18,3
PUEBLA,21,HUATLATLAUCA,070,ÁLVARO OBREGÓN,3,29,19,10,3
PUEBLA,21,HUATLATLAUCA,070,BARRANCA SAN MIGUEL,2,10,4,6,2
PUEBLA,21,HUATLATLAUCA,070,CHIMALA,2,32,16,16,2
PUEBLA,21,HUATLATLAUCA,070,COPALCOTITLA,2,35,20,15,3
PUEBLA,21,HUATLATLAUCA,070,EMILIANO ZAPATA,3,94,49,45,5
PUEBLA,21,HUATLATLAUCA,070,HUATLATLAHUCA,2,123,54,69,7
PUEBLA,21,HUATLATLAUCA,070,HUATLATLAUCA,5,131,64,67,10
PUEBLA,21,HUATLATLAUCA,070,QUETZALAPA (SAN BALTAZAR QUETZALAPA),3,54,26,28,6
PUEBLA,21,HUATLATLAUCA,070,SAN MIGUEL COSAHUATLA,4,129,81,48,7
PUEBLA,21,HUATLATLAUCA,070,SAN NICOLÁS ATLALPAN,2,52,24,28,4
PUEBLA,21,HUATLATLAUCA,070,SAN PABLO ZOYATITLANAPAN,4,112,62,50,8
PUEBLA,21,HUATLATLAUCA,070,SANTO TOMÁS ATLIXILIHUIAN,2,4,3,1,1
PUEBLA,21,HUATLATLAUCA,070,TEMPEXQUIXTLA,3,73,39,34,4
PUEBLA,21,HUATLATLAUCA,070,TEPANACITLA (GUADALUPE TEPANACITLA),2,48,32,16,3
PUEBLA,21,HUATLATLAUCA,070,TEPETZITZINTLA,4,279,135,144,16
PUEBLA,21,HUATLATLAUCA,070,TOCHMATZINTLA,3,84,49,35,5
PUEBLA,21,HUAUCHINANGO,071,ACATLÁN,1,35,17,18,1
PUEBLA,21,HUAUCHINANGO,071,AHUACATLÁN,3,502,249,253,25
PUEBLA,21,HUAUCHINANGO,071,ALSESECA,3,70,33,37,5
PUEBLA,21,HUAUCHINANGO,071,AYOHUIXCUAUTLA,3,103,44,59,7
PUEBLA,21,HUAUCHINANGO,071,CACAMOTLA,1,10,5,5,1
PUEBLA,21,HUAUCHINANGO,071,CHICUASE,1,8,5,3,1
PUEBLA,21,HUAUCHINANGO,071,COBRERÍA,2,4,2,2,1
PUEBLA,21,HUAUCHINANGO,071,COLONIA PEMEX (HUEYATLAGCO),1,18,6,12,1
PUEBLA,21,HUAUCHINANGO,071,CUACUILA,6,1090,575,515,48
PUEBLA,21,HUAUCHINANGO,071,CUAHUEYATLA,3,119,47,72,7
PUEBLA,21,HUAUCHINANGO,071,CUAUTLITA,3,256,124,132,9
PUEBLA,21,HUAUCHINANGO,071,CUAUXINCA,2,77,33,44,3
PUEBLA,21,HUAUCHINANGO,071,CUAXICALA,4,281,126,155,14
PUEBLA,21,HUAUCHINANGO,071,EL MIRADOR,3,31,19,12,4
PUEBLA,21,HUAUCHINANGO,071,EL MIRADOR 1 [COLONIA],1,16,9,7,1
PUEBLA,21,HUAUCHINANGO,071,EL PARAÍSO,2,760,361,399,26
PUEBLA,21,HUAUCHINANGO,071,HUAUCHINANGO,104,19467,10135,9332,1181
PUEBLA,21,HUAUCHINANGO,071,HUILACAPIXTLA,4,603,298,305,27
PUEBLA,21,HUAUCHINANGO,071,IXHUACATLA,2,20,8,12,2
PUEBLA,21,HUAUCHINANGO,071,LA PALPA,2,107,45,62,2
PUEBLA,21,HUAUCHINANGO,071,LAS COLONIAS DE HIDALGO,2,595,295,300,21
PUEBLA,21,HUAUCHINANGO,071,LOS CAPULINES,1,43,16,27,2
PUEBLA,21,HUAUCHINANGO,071,LOS TIRADORES,2,8,7,1,1
PUEBLA,21,HUAUCHINANGO,071,MATLALUCA,3,73,39,34,5
PUEBLA,21,HUAUCHINANGO,071,MESA DE CAPULINES,1,13,4,9,1
PUEBLA,21,HUAUCHINANGO,071,MICHIUCA,3,27,15,12,3
PUEBLA,21,HUAUCHINANGO,071,NOPALA,3,125,59,66,7
PUEBLA,21,HUAUCHINANGO,071,OCPACO,4,355,185,170,14
PUEBLA,21,HUAUCHINANGO,071,OZOMATLÁN,4,222,105,117,13
PUEBLA,21,HUAUCHINANGO,071,PAPATLATLA,2,103,53,50,5
PUEBLA,21,HUAUCHINANGO,071,PAPATLAZOLCO,4,732,370,362,31
PUEBLA,21,HUAUCHINANGO,071,PATOLTECOYA,4,168,81,87,13
PUEBLA,21,HUAUCHINANGO,071,PUGA,3,147,75,72,8
PUEBLA,21,HUAUCHINANGO,071,SAN MIGUEL ACUAUTLA,2,47,21,26,3
PUEBLA,21,HUAUCHINANGO,071,SANTIAGO,2,34,14,20,2
PUEBLA,21,HUAUCHINANGO,071,SANTIAGO (BUENA VISTA),2,17,9,8,2
PUEBLA,21,HUAUCHINANGO,071,TENANGO DE LAS FLORES,12,2543,1277,1266,116
PUEBLA,21,HUAUCHINANGO,071,TENOHUATLÁN,2,33,15,18,2
PUEBLA,21,HUAUCHINANGO,071,TEOPANCINGO,4,183,76,107,11
PUEBLA,21,HUAUCHINANGO,071,TEPEHUAQUILA,1,18,10,8,1
PUEBLA,21,HUAUCHINANGO,071,TEPETZINTLA DE GALEANA,4,244,121,123,13
PUEBLA,21,HUAUCHINANGO,071,TLACOMULCO,4,364,182,182,19
PUEBLA,21,HUAUCHINANGO,071,TLALMAYA,3,174,80,94,10
PUEBLA,21,HUAUCHINANGO,071,TZAHUINCO,1,55,19,36,2
PUEBLA,21,HUAUCHINANGO,071,VENTA GRANDE,4,396,168,228,20
PUEBLA,21,HUAUCHINANGO,071,XALTEPEC,4,836,408,428,37
PUEBLA,21,HUAUCHINANGO,071,XILOCUAUTLA,6,448,225,223,25
PUEBLA,21,HUAUCHINANGO,071,XOPANAPA,4,159,80,79,8
PUEBLA,21,HUEHUETLA,072,CHILOCOYO DEL CARMEN,4,259,128,131,13
PUEBLA,21,HUEHUETLA,072,CHILOCOYO GUADALUPE,2,81,33,48,5
PUEBLA,21,HUEHUETLA,072,CINCO DE MAYO,7,419,219,200,20
PUEBLA,21,HUEHUETLA,072,FRANCISCO I. MADERO,3,107,54,53,5
PUEBLA,21,HUEHUETLA,072,HUEHUETLA,14,2984,1710,1274,144
PUEBLA,21,HUEHUETLA,072,KUWIK CHUCHUT,4,197,81,116,10
PUEBLA,21,HUEHUETLA,072,LEACAMAN,6,456,238,218,22
PUEBLA,21,HUEHUETLA,072,LIPUNTAHUACA,4,413,209,204,22
PUEBLA,21,HUEHUETLA,072,OZELONACAXTLA,4,270,128,142,14
PUEBLA,21,HUEHUETLA,072,PUTAXCAT,3,141,61,80,8
PUEBLA,21,HUEHUETLA,072,PUTLUNICHUCHUT (VISTA HERMOSA),6,441,225,216,22
PUEBLA,21,HUEHUETLA,072,XONALPU,5,504,225,279,27
PUEBLA,21,HUEHUETLÁN EL CHICO,073,AYOXUXTLA (AYOXUXTLA DE ZAPATA),4,123,61,62,12
PUEBLA,21,HUEHUETLÁN EL CHICO,073,HUEHUETLÁN EL CHICO,13,1373,668,705,78
PUEBLA,21,HUEHUETLÁN EL CHICO,073,LA PALMA,3,21,6,15,3
PUEBLA,21,HUEHUETLÁN EL CHICO,073,SAN MIGUEL EL TERRERO,2,20,9,11,2
PUEBLA,21,HUEHUETLÁN EL CHICO,073,TZICATLÁN,6,895,458,437,36
PUEBLA,21,HUEJOTZINGO,074,ÁLVARO OBREGÓN,1,15,10,5,1
PUEBLA,21,HUEJOTZINGO,074,BENITO JUÁREZ,1,14,5,9,1
PUEBLA,21,HUEJOTZINGO,074,EL CARMEN,2,783,404,379,25
PUEBLA,21,HUEJOTZINGO,074,GUSTAVO DÍAZ ORDAZ (LA CUENCA),1,91,45,46,3
PUEBLA,21,HUEJOTZINGO,074,HUEJOTZINGO,58,13356,6898,6458,564
PUEBLA,21,HUEJOTZINGO,074,JOSÉ LÓPEZ PORTILLO,1,14,7,7,1
PUEBLA,21,HUEJOTZINGO,074,LOS ENCINOS,1,15,5,10,1
PUEBLA,21,HUEJOTZINGO,074,SAN DIEGO BUENAVISTA,4,280,142,138,14
PUEBLA,21,HUEJOTZINGO,074,SAN JOSÉ TLAUTLA,1,42,25,17,2
PUEBLA,21,HUEJOTZINGO,074,SAN JUAN PANCOAC,4,297,135,162,12
PUEBLA,21,HUEJOTZINGO,074,SAN LUIS COYOTZINGO,4,424,222,202,21
PUEBLA,21,HUEJOTZINGO,074,SAN MATEO CAPULTITLÁN,4,772,390,382,29
PUEBLA,21,HUEJOTZINGO,074,SAN MIGUEL TIANGUIZOLCO,2,447,234,213,16
PUEBLA,21,HUEJOTZINGO,074,SANTA ANA XALMIMILULCO,20,7888,3730,4158,459
PUEBLA,21,HUEJOTZINGO,074,SANTA ELENA,1,194,87,107,7
PUEBLA,21,HUEJOTZINGO,074,SANTA MARÍA ATEXCAC,7,772,396,376,37
PUEBLA,21,HUEJOTZINGO,074,SANTA MARÍA NEPOPUALCO,5,1030,512,518,39
PUEBLA,21,HUEJOTZINGO,074,SANTA MARÍA TIANGUISTENCO,3,268,145,123,12
PUEBLA,21,HUEJOTZINGO,074,SANTO DOMINGO CIÉNEGA HONDA,3,29,11,18,4
PUEBLA,21,HUEYAPAN,075,AHUATEPEC,3,182,82,100,10
PUEBLA,21,HUEYAPAN,075,ATMOLONI,2,82,38,44,4
PUEBLA,21,HUEYAPAN,075,BUENAVISTA,3,144,81,63,8
PUEBLA,21,HUEYAPAN,075,COLOSTITÁN,2,125,63,62,5
PUEBLA,21,HUEYAPAN,075,HUEYAPAN,14,2620,1435,1185,102
PUEBLA,21,HUEYAPAN,075,LA AURORA,3,56,28,28,4
PUEBLA,21,HUEYAPAN,075,MALOAPAN,2,18,7,11,2
PUEBLA,21,HUEYAPAN,075,NEXPAN,3,324,150,174,15
PUEBLA,21,HUEYAPAN,075,PASO REAL,3,37,11,26,4
PUEBLA,21,HUEYAPAN,075,TALZINTÁN,2,32,14,18,2
PUEBLA,21,HUEYAPAN,075,TANAMACOYAN,4,530,262,268,22
PUEBLA,21,HUEYAPAN,075,TEPETITANAPAN,2,15,8,7,2
PUEBLA,21,HUEYAPAN,075,TETELILLA,3,51,28,23,4
PUEBLA,21,HUEYTAMALCO,076,AMATETEL,3,88,43,45,7
PUEBLA,21,HUEYTAMALCO,076,ARROYO BLANCO,2,53,23,30,4
PUEBLA,21,HUEYTAMALCO,076,ATEHUETZIN,4,196,99,97,8
PUEBLA,21,HUEYTAMALCO,076,ATEPETACO,2,9,1,8,2
PUEBLA,21,HUEYTAMALCO,076,AYAHUALO,4,298,158,140,15
PUEBLA,21,HUEYTAMALCO,076,CERRO TAJITEPEC,2,11,4,7,2
PUEBLA,21,HUEYTAMALCO,076,COAPAL GRANDE,3,154,75,79,9
PUEBLA,21,HUEYTAMALCO,076,COLONIA DEL VALLE,1,6,4,2,1
PUEBLA,21,HUEYTAMALCO,076,COLONIA LA VIRGEN,3,69,29,40,4
PUEBLA,21,HUEYTAMALCO,076,COLONIA MORELOS,3,166,73,93,7
PUEBLA,21,HUEYTAMALCO,076,CONTA,3,69,35,34,5
PUEBLA,21,HUEYTAMALCO,076,DOS CERROS,2,27,13,14,3
PUEBLA,21,HUEYTAMALCO,076,DOS RÍOS NUEVO,3,97,47,50,7
PUEBLA,21,HUEYTAMALCO,076,EJIDO HUEYTAMALCO,3,134,57,77,7
PUEBLA,21,HUEYTAMALCO,076,EL ANAYAL,2,20,12,8,2
PUEBLA,21,HUEYTAMALCO,076,EL MANGAL,1,10,2,8,1
PUEBLA,21,HUEYTAMALCO,076,EL MIRADOR (MIRADOR TENEXAPA),3,89,47,42,6
PUEBLA,21,HUEYTAMALCO,076,EL MOHÓN,4,313,151,162,15
PUEBLA,21,HUEYTAMALCO,076,EL PARAÍSO,1,9,7,2,1
PUEBLA,21,HUEYTAMALCO,076,EL PROGRESO,4,443,218,225,20
PUEBLA,21,HUEYTAMALCO,076,EL PUEBLILLO,2,27,12,15,3
PUEBLA,21,HUEYTAMALCO,076,HUEYTAMALCO,11,1955,1028,927,91
PUEBLA,21,HUEYTAMALCO,076,HUEYTAMALCO (PAPALOAPAN),2,48,26,22,3
PUEBLA,21,HUEYTAMALCO,076,JABALINCO,2,5,3,2,1
PUEBLA,21,HUEYTAMALCO,076,LA LÍNEA,1,12,2,10,1
PUEBLA,21,HUEYTAMALCO,076,LA SOLEDAD,2,8,2,6,2
PUEBLA,21,HUEYTAMALCO,076,LAS MARGARITAS,3,107,58,49,7
PUEBLA,21,HUEYTAMALCO,076,LIMONATENO (LIMONATENO GRANDE),2,36,9,27,3
PUEBLA,21,HUEYTAMALCO,076,LIMONTITÁN CHICO,3,111,60,51,7
PUEBLA,21,HUEYTAMALCO,076,LIMONTITÁN GRANDE,4,158,87,71,12
PUEBLA,21,HUEYTAMALCO,076,LLAGOSTERA,3,136,67,69,7
PUEBLA,21,HUEYTAMALCO,076,LOMA ALTA,4,109,61,48,8
PUEBLA,21,HUEYTAMALCO,076,LOMA BONITA,2,12,6,6,2
PUEBLA,21,HUEYTAMALCO,076,MANLIO FABIO ALTAMIRANO,2,20,7,13,2
PUEBLA,21,HUEYTAMALCO,076,MAZOLAPA,2,36,19,17,2
PUEBLA,21,HUEYTAMALCO,076,MECATÉPETL,2,31,18,13,3
PUEBLA,21,HUEYTAMALCO,076,MONTECELLI,3,103,50,53,6
PUEBLA,21,HUEYTAMALCO,076,PALMAGTITÁN,2,19,11,8,2
PUEBLA,21,HUEYTAMALCO,076,PAXTA,2,28,14,14,3
PUEBLA,21,HUEYTAMALCO,076,PEZMACO,2,83,45,38,4
PUEBLA,21,HUEYTAMALCO,076,PUENTE DE PALO,2,72,35,37,4
PUEBLA,21,HUEYTAMALCO,076,RANCHO VIEJO,2,39,17,22,2
PUEBLA,21,HUEYTAMALCO,076,SAN ÁNGEL CUAUXOCOTA,3,210,105,105,13
PUEBLA,21,HUEYTAMALCO,076,SAN ANTONIO DEL SOL,2,24,14,10,2
PUEBLA,21,HUEYTAMALCO,076,SAN CARLOS,2,29,16,13,2
PUEBLA,21,HUEYTAMALCO,076,SAN IGNACIO (SAN IGNACIO DEL PROGRESO),2,40,22,18,2
PUEBLA,21,HUEYTAMALCO,076,SAN LUCAS,2,15,4,11,2
PUEBLA,21,HUEYTAMALCO,076,SAN LUIS,2,42,18,24,3
PUEBLA,21,HUEYTAMALCO,076,SAN MARTÍN,2,24,12,12,2
PUEBLA,21,HUEYTAMALCO,076,SANTA FE,2,10,4,6,2
PUEBLA,21,HUEYTAMALCO,076,SOLÓRZANO,2,33,18,15,2
PUEBLA,21,HUEYTAMALCO,076,TACOTALPA,2,11,5,6,2
PUEBLA,21,HUEYTAMALCO,076,TACUBA,1,9,3,6,1
PUEBLA,21,HUEYTAMALCO,076,TENEXAPA DE AZUETA,4,133,49,84,9
PUEBLA,21,HUEYTAMALCO,076,TENEXATE (EJIDO TENEXATE),3,170,81,89,10
PUEBLA,21,HUEYTAMALCO,076,TEPACTIPAN,2,72,33,39,4
PUEBLA,21,HUEYTAMALCO,076,TEPOZOTECO,1,7,3,4,1
PUEBLA,21,HUEYTAMALCO,076,TETEYAHUALCO,2,57,23,34,4
PUEBLA,21,HUEYTAMALCO,076,TILAPA,3,168,88,80,11
PUEBLA,21,HUEYTAMALCO,076,TLACUILOLAPA,3,97,52,45,6
PUEBLA,21,HUEYTAMALCO,076,TONALMEYOCO,2,53,19,34,4
PUEBLA,21,HUEYTAMALCO,076,VEGA CHICA,1,21,7,14,1
PUEBLA,21,HUEYTAMALCO,076,VEGA DE MONTECELLI (EL AGUILAR),3,41,21,20,4
PUEBLA,21,HUEYTAMALCO,076,VISTA HERMOSA,3,51,28,23,3
PUEBLA,21,HUEYTAMALCO,076,XALTENO,1,46,17,29,2
PUEBLA,21,HUEYTAMALCO,076,XOYOQUILA,1,36,19,17,2
PUEBLA,21,HUEYTAMALCO,076,ZOMPANICO,2,24,15,9,2
PUEBLA,21,HUEYTAMALCO,076,ZOMPAQUISOYAN (COLIHUI),2,10,5,5,1
PUEBLA,21,HUEYTLALPAN,077,CHILILIX,2,53,24,29,2
PUEBLA,21,HUEYTLALPAN,077,EL ARENAL,4,131,60,71,8
PUEBLA,21,HUEYTLALPAN,077,EL CRUCERO,3,152,79,73,9
PUEBLA,21,HUEYTLALPAN,077,EL CUYO,2,21,15,6,2
PUEBLA,21,HUEYTLALPAN,077,HUEYTLALPAN,6,488,250,238,24
PUEBLA,21,HUEYTLALPAN,077,LA CRUZ DE CHACA,2,53,29,24,3
PUEBLA,21,HUEYTLALPAN,077,LA ESPERANZA,2,54,21,33,4
PUEBLA,21,HUEYTLALPAN,077,LA GARZA,1,7,4,3,1
PUEBLA,21,HUEYTLALPAN,077,LA PALMA,2,37,21,16,3
PUEBLA,21,HUEYTLALPAN,077,LA TRANCA,2,29,17,12,3
PUEBLA,21,HUEYTLALPAN,077,POMAXHCA,2,84,39,45,4
PUEBLA,21,HUEYTLALPAN,077,SKANSIPI,2,75,35,40,4
PUEBLA,21,HUEYTLALPAN,077,ZITLALA,4,231,123,108,13
PUEBLA,21,HUITZILAN DE SERDÁN,078,ACUITAPILCO,1,13,7,6,1
PUEBLA,21,HUITZILAN DE SERDÁN,078,CHAGCHALOYAN DE ISIDRO BURGOS,2,65,34,31,4
PUEBLA,21,HUITZILAN DE SERDÁN,078,CHAGCHALOYAN DE ZAPATA,2,46,23,23,3
PUEBLA,21,HUITZILAN DE SERDÁN,078,EL PARAÍSO,2,67,40,27,3
PUEBLA,21,HUITZILAN DE SERDÁN,078,HUITZILAN,8,1339,674,665,52
PUEBLA,21,HUITZILAN DE SERDÁN,078,PEZMATA (PAPALOCONTITLÁN),2,62,32,30,3
PUEBLA,21,HUITZILAN DE SERDÁN,078,PILACTITÁN,3,28,15,13,3
PUEBLA,21,HUITZILAN DE SERDÁN,078,SAN ANTONIO TALTZINTÁN,2,123,55,68,6
PUEBLA,21,HUITZILAN DE SERDÁN,078,SAN JOSÉ AOCOTZOTA,2,109,53,56,5
PUEBLA,21,HUITZILAN DE SERDÁN,078,SAN MIGUEL ACATENO,2,50,26,24,3
PUEBLA,21,HUITZILAN DE SERDÁN,078,SAN MIGUEL DEL PROGRESO,9,805,390,415,40
PUEBLA,21,HUITZILAN DE SERDÁN,078,TANCALCO,1,34,13,21,2
PUEBLA,21,HUITZILAN DE SERDÁN,078,TEPETZINTLA,2,33,20,13,3
PUEBLA,21,HUITZILAN DE SERDÁN,078,TLACALOCO,1,131,57,74,6
PUEBLA,21,HUITZILAN DE SERDÁN,078,TOTUTLA,5,433,220,213,26
PUEBLA,21,HUITZILAN DE SERDÁN,078,XINACHAPAN DE ALLENDE,2,126,56,70,5
PUEBLA,21,HUITZILAN DE SERDÁN,078,XOLOANGO,1,36,17,19,2
PUEBLA,21,HUITZILAN DE SERDÁN,078,ZOYOTLA,7,280,133,147,15
PUEBLA,21,HUITZILTEPEC,079,DOLORES HIDALGO,3,268,125,143,11
PUEBLA,21,HUITZILTEPEC,079,SANTA ANA COAPAN,3,278,131,147,11
PUEBLA,21,HUITZILTEPEC,079,SANTA CLARA HUITZILTEPEC,6,620,300,320,37
PUEBLA,21,ATLEQUIZAYAN,080,ATLEQUIZAYAN,5,355,164,191,19
PUEBLA,21,ATLEQUIZAYAN,080,IGNACIO ALLENDE (CONCEPCIÓN),4,277,149,128,16
PUEBLA,21,IXCAMILPA DE GUERRERO,081,BUENAVISTA DE ZAPATA,4,184,102,82,10
PUEBLA,21,IXCAMILPA DE GUERRERO,081,CUAGUEXQUITEPEC,2,6,2,4,1
PUEBLA,21,IXCAMILPA DE GUERRERO,081,CUATLAXTECOMA,2,20,7,13,2
PUEBLA,21,IXCAMILPA DE GUERRERO,081,EL FRUTILLO,2,17,5,12,2
PUEBLA,21,IXCAMILPA DE GUERRERO,081,EL ORGANAL,1,19,9,10,1
PUEBLA,21,IXCAMILPA DE GUERRERO,081,IXCAMILPA,5,319,159,160,20
PUEBLA,21,IXCAMILPA DE GUERRERO,081,LINDEROS DEL SUR,3,61,35,26,5
PUEBLA,21,IXCAMILPA DE GUERRERO,081,SAN MIGUEL AHUELITLALPAN,3,74,40,34,4
PUEBLA,21,IXCAMILPA DE GUERRERO,081,TLANIPATLA,3,41,20,21,4
PUEBLA,21,IXCAMILPA DE GUERRERO,081,TOLTECAMILA,4,259,134,125,14
PUEBLA,21,IXCAQUIXTLA,082,ALTA LUZ CUATRO RAYAS,4,464,222,242,16
PUEBLA,21,IXCAQUIXTLA,082,BARRIO DE DOLORES,2,76,39,37,3
PUEBLA,21,IXCAQUIXTLA,082,LA SOLEDAD,2,29,19,10,2
PUEBLA,21,IXCAQUIXTLA,082,PIXTIOPAN,2,37,17,20,2
PUEBLA,21,IXCAQUIXTLA,082,SAN JUAN IXCAQUIXTLA,10,2841,1552,1289,128
PUEBLA,21,IXCAQUIXTLA,082,SAN JUAN NEPOMUCENO (RANCHO CHICO),2,56,33,23,3
PUEBLA,21,IXCAQUIXTLA,082,SANTA CECILIA CLAVIJERO,2,48,19,29,3
PUEBLA,21,IXTACAMAXTITLÁN,083,ACAYUCAN,3,13,6,7,3
PUEBLA,21,IXTACAMAXTITLÁN,083,ACOCULCO (ALCAPARRA),2,17,8,9,2
PUEBLA,21,IXTACAMAXTITLÁN,083,AHUATENO,2,18,11,7,2
PUEBLA,21,IXTACAMAXTITLÁN,083,ALMEYA,2,19,11,8,2
PUEBLA,21,IXTACAMAXTITLÁN,083,ALMONAMIQUE,2,12,6,6,1
PUEBLA,21,IXTACAMAXTITLÁN,083,ANALCO (CHANCUAGCO),3,34,17,17,3
PUEBLA,21,IXTACAMAXTITLÁN,083,ATEXQUILLA CUAPAZOLA,4,216,119,97,12
PUEBLA,21,IXTACAMAXTITLÁN,083,BORDO BLANCO,2,10,3,7,2
PUEBLA,21,IXTACAMAXTITLÁN,083,CALPANERÍA ATEZQUILLA,4,570,296,274,23
PUEBLA,21,IXTACAMAXTITLÁN,083,CAPOLICTIC,3,22,11,11,3
PUEBLA,21,IXTACAMAXTITLÁN,083,CAPULUAPAN DE LAS AGUAS,2,47,19,28,3
PUEBLA,21,IXTACAMAXTITLÁN,083,CHAUCINGO ATEZQUILLA,2,6,3,3,1
PUEBLA,21,IXTACAMAXTITLÁN,083,CHAUCINGO TILOXTOC,2,11,9,2,2
PUEBLA,21,IXTACAMAXTITLÁN,083,CRISTALACO,3,177,77,100,10
PUEBLA,21,IXTACAMAXTITLÁN,083,CRUZ DE LEÓN,4,73,41,32,7
PUEBLA,21,IXTACAMAXTITLÁN,083,CRUZ DE OCOTE,3,20,13,7,4
PUEBLA,21,IXTACAMAXTITLÁN,083,CUAHUIGTIC,2,16,8,8,2
PUEBLA,21,IXTACAMAXTITLÁN,083,CUATEXMOLA (XONACATITLA),4,233,121,112,16
PUEBLA,21,IXTACAMAXTITLÁN,083,CUATRO CAMINOS,2,36,16,20,2
PUEBLA,21,IXTACAMAXTITLÁN,083,CUXAC (SAN ANTONIO),3,27,15,12,3
PUEBLA,21,IXTACAMAXTITLÁN,083,EL CAPULÍN OCOJALA,3,35,17,18,5
PUEBLA,21,IXTACAMAXTITLÁN,083,EL ENCANTO,2,16,10,6,2
PUEBLA,21,IXTACAMAXTITLÁN,083,EL MIRADOR,7,436,218,218,21
PUEBLA,21,IXTACAMAXTITLÁN,083,EL PAREDÓN,5,48,23,25,6
PUEBLA,21,IXTACAMAXTITLÁN,083,EL SABINAL (SAN PEDRO),2,4,1,3,1
PUEBLA,21,IXTACAMAXTITLÁN,083,GUADALUPE,3,66,30,36,5
PUEBLA,21,IXTACAMAXTITLÁN,083,GUADALUPE VICTORIA,3,61,30,31,4
PUEBLA,21,IXTACAMAXTITLÁN,083,HUIXCOLOTLA,4,33,10,23,6
PUEBLA,21,IXTACAMAXTITLÁN,083,ILIYUCAN,2,38,21,17,3
PUEBLA,21,IXTACAMAXTITLÁN,083,IXTACAMAXTITLÁN,15,886,463,423,53
PUEBLA,21,IXTACAMAXTITLÁN,083,LA CALDERA,1,37,19,18,1
PUEBLA,21,IXTACAMAXTITLÁN,083,LA FÁBRICA,2,21,10,11,2
PUEBLA,21,IXTACAMAXTITLÁN,083,LA JOYA,2,39,15,24,3
PUEBLA,21,IXTACAMAXTITLÁN,083,LA MESA,3,66,33,33,5
PUEBLA,21,IXTACAMAXTITLÁN,083,LA UNIÓN EJIDO MEXCALTEPEC,2,156,82,74,6
PUEBLA,21,IXTACAMAXTITLÁN,083,LA VEGA,2,9,3,6,1
PUEBLA,21,IXTACAMAXTITLÁN,083,LAGUNILLA PEDERNALES,4,278,158,120,17
PUEBLA,21,IXTACAMAXTITLÁN,083,LAS BARRANCAS,3,37,16,21,5
PUEBLA,21,IXTACAMAXTITLÁN,083,LOMA LARGA,2,8,5,3,2
PUEBLA,21,IXTACAMAXTITLÁN,083,LOS POTRERILLOS,2,10,4,6,2
PUEBLA,21,IXTACAMAXTITLÁN,083,MEXCALTEPEC,4,83,43,40,7
PUEBLA,21,IXTACAMAXTITLÁN,083,MINATITLÁN,2,18,7,11,2
PUEBLA,21,IXTACAMAXTITLÁN,083,MINILLAS,4,97,54,43,8
PUEBLA,21,IXTACAMAXTITLÁN,083,MINILLAS (LA GARITA),2,83,35,48,3
PUEBLA,21,IXTACAMAXTITLÁN,083,NACAYOLO,2,7,3,4,1
PUEBLA,21,IXTACAMAXTITLÁN,083,OCOTITLÁN,3,14,9,5,3
PUEBLA,21,IXTACAMAXTITLÁN,083,OCOTLA,2,19,8,11,2
PUEBLA,21,IXTACAMAXTITLÁN,083,OYAMETEPEC,3,78,38,40,7
PUEBLA,21,IXTACAMAXTITLÁN,083,PLAN DE GUADALUPE,1,3,1,2,1
PUEBLA,21,IXTACAMAXTITLÁN,083,PLAN DE LA FLOR,2,25,16,9,2
PUEBLA,21,IXTACAMAXTITLÁN,083,RANCHITOS,2,8,4,4,1
PUEBLA,21,IXTACAMAXTITLÁN,083,RANCHO VIEJO,1,10,5,5,1
PUEBLA,21,IXTACAMAXTITLÁN,083,SAN ANTONIO DE LOS PINOS,3,31,11,20,3
PUEBLA,21,IXTACAMAXTITLÁN,083,SAN JOSÉ PROVIDENCIA,3,27,15,12,3
PUEBLA,21,IXTACAMAXTITLÁN,083,SANTA MARÍA ZOTOLTEPEC,4,161,85,76,10
PUEBLA,21,IXTACAMAXTITLÁN,083,TAGCOTEPEC,2,19,10,9,2
PUEBLA,21,IXTACAMAXTITLÁN,083,TATEMPANGO,3,17,11,6,3
PUEBLA,21,IXTACAMAXTITLÁN,083,TATENO,3,213,118,95,11
PUEBLA,21,IXTACAMAXTITLÁN,083,TATENO XOCO,3,91,45,46,6
PUEBLA,21,IXTACAMAXTITLÁN,083,TATÓXCAC,2,23,13,10,2
PUEBLA,21,IXTACAMAXTITLÁN,083,TECOLTÉMIC,3,43,22,21,4
PUEBLA,21,IXTACAMAXTITLÁN,083,TENAMIGTIC,2,5,3,2,1
PUEBLA,21,IXTACAMAXTITLÁN,083,TENEXTEPECUACO,2,11,5,6,2
PUEBLA,21,IXTACAMAXTITLÁN,083,TENTZONCUAHUIGTIC,4,168,74,94,10
PUEBLA,21,IXTACAMAXTITLÁN,083,TEPECUAHUIXCO (EL LLANETE),2,59,30,29,3
PUEBLA,21,IXTACAMAXTITLÁN,083,TEPEXOXUCA,4,146,79,67,11
PUEBLA,21,IXTACAMAXTITLÁN,083,TEXOCUICTIC,2,30,14,16,2
PUEBLA,21,IXTACAMAXTITLÁN,083,TEXOCUIXPAN,4,201,94,107,13
PUEBLA,21,IXTACAMAXTITLÁN,083,TILOXTOC,4,116,54,62,9
PUEBLA,21,IXTACAMAXTITLÁN,083,TLACUELA,4,117,63,54,8
PUEBLA,21,IXTACAMAXTITLÁN,083,TLAJOMULCO,2,42,19,23,3
PUEBLA,21,IXTACAMAXTITLÁN,083,TLALMOTOLO,2,45,19,26,3
PUEBLA,21,IXTACAMAXTITLÁN,083,TLANANA (ATECOXCO),3,34,15,19,4
PUEBLA,21,IXTACAMAXTITLÁN,083,TLAXCALANCINGO,3,72,31,41,6
PUEBLA,21,IXTACAMAXTITLÁN,083,TONALAPA,4,296,147,149,18
PUEBLA,21,IXTACAMAXTITLÁN,083,TULIGTIC (SAN MIGUEL),3,54,28,26,5
PUEBLA,21,IXTACAMAXTITLÁN,083,VALSEQUILLO,2,6,6,0,1
PUEBLA,21,IXTACAMAXTITLÁN,083,VISTA HERMOSA DE LÁZARO CÁRDENAS,3,46,20,26,3
PUEBLA,21,IXTACAMAXTITLÁN,083,VISTA HERMOSA DE MORELOS,2,7,3,4,1
PUEBLA,21,IXTACAMAXTITLÁN,083,XALCOMULCO,2,27,13,14,2
PUEBLA,21,IXTACAMAXTITLÁN,083,XIUQUENTA,2,16,6,10,2
PUEBLA,21,IXTACAMAXTITLÁN,083,XOCOXIUTLA,4,235,112,123,14
PUEBLA,21,IXTACAMAXTITLÁN,083,XONACATLA,2,31,11,20,3
PUEBLA,21,IXTACAMAXTITLÁN,083,XOPANAC,2,15,6,9,2
PUEBLA,21,IXTACAMAXTITLÁN,083,ZACATEPEC,2,42,25,17,3
PUEBLA,21,IXTACAMAXTITLÁN,083,ZARAGOZA,1,39,21,18,2
PUEBLA,21,IXTEPEC,084,CAJINANÍN (SAN RAFAEL),3,20,10,10,2
PUEBLA,21,IXTEPEC,084,CAXTAMUSING,2,27,14,13,2
PUEBLA,21,IXTEPEC,084,ESCATACHUCHUT,2,100,41,59,7
PUEBLA,21,IXTEPEC,084,IXTEPEC,5,1144,572,572,54
PUEBLA,21,IXTEPEC,084,PATIY,2,329,157,172,15
PUEBLA,21,IXTEPEC,084,SAN MARTÍN,2,97,44,53,6
PUEBLA,21,IXTEPEC,084,TAKALTZÁPS,2,35,13,22,2
PUEBLA,21,IZÚCAR DE MATAMOROS,085,ABELARDO L. RODRÍGUEZ,2,42,21,21,2
PUEBLA,21,IZÚCAR DE MATAMOROS,085,AGUA ESCONDIDA (SANTA CRUZ AGUA ESCONDIDA),3,168,80,88,9
PUEBLA,21,IZÚCAR DE MATAMOROS,085,AYUTLA (SAN FELIPE AYUTLA),8,1361,688,673,72
PUEBLA,21,IZÚCAR DE MATAMOROS,085,EL AGUACATE,2,26,11,15,2
PUEBLA,21,IZÚCAR DE MATAMOROS,085,EL CALVARIO,2,454,229,225,19
PUEBLA,21,IZÚCAR DE MATAMOROS,085,EL CARMEN,2,5,2,3,2
PUEBLA,21,IZÚCAR DE MATAMOROS,085,EL MIRADOR,3,10,3,7,2
PUEBLA,21,IZÚCAR DE MATAMOROS,085,EL SAUCE,2,4,3,1,2
PUEBLA,21,IZÚCAR DE MATAMOROS,085,GUADALUPE LAS CHICHIHUAS,2,22,8,14,3
PUEBLA,21,IZÚCAR DE MATAMOROS,085,HUAXTEPEC,3,31,17,14,4
PUEBLA,21,IZÚCAR DE MATAMOROS,085,IZÚCAR DE MATAMOROS,92,15409,8080,7329,974
PUEBLA,21,IZÚCAR DE MATAMOROS,085,LA GALARZA,9,1066,558,508,50
PUEBLA,21,IZÚCAR DE MATAMOROS,085,LA SOLEDAD PIZOTLA,1,3,1,2,1
PUEBLA,21,IZÚCAR DE MATAMOROS,085,LAS CASITAS,3,30,15,15,3
PUEBLA,21,IZÚCAR DE MATAMOROS,085,LAS PILETAS,2,9,5,4,1
PUEBLA,21,IZÚCAR DE MATAMOROS,085,LOMAS DE ALCHICHICA,6,606,334,272,37
PUEBLA,21,IZÚCAR DE MATAMOROS,085,LOS AMATES,3,80,37,43,6
PUEBLA,21,IZÚCAR DE MATAMOROS,085,LOS LIMONES,2,8,3,5,2
PUEBLA,21,IZÚCAR DE MATAMOROS,085,MATZACO,5,583,279,304,27
PUEBLA,21,IZÚCAR DE MATAMOROS,085,MEXQUITEPEC,3,49,24,25,4
PUEBLA,21,IZÚCAR DE MATAMOROS,085,SAN CARLOS BUENAVISTA,4,201,103,98,14
PUEBLA,21,IZÚCAR DE MATAMOROS,085,SAN ISIDRO,2,49,28,21,3
PUEBLA,21,IZÚCAR DE MATAMOROS,085,SAN JOSÉ LAS BOCAS,2,108,60,48,5
PUEBLA,21,IZÚCAR DE MATAMOROS,085,SAN JUAN COLÓN,4,451,219,232,36
PUEBLA,21,IZÚCAR DE MATAMOROS,085,SAN JUAN RABOSO,5,1161,551,610,52
PUEBLA,21,IZÚCAR DE MATAMOROS,085,SAN LUCAS COLUCAN,5,580,278,302,32
PUEBLA,21,IZÚCAR DE MATAMOROS,085,SAN MANUEL LA PAROTA,4,166,80,86,7
PUEBLA,21,IZÚCAR DE MATAMOROS,085,SAN MARTÍN LA FLOR (LA FLOR COLORADA),3,33,19,14,4
PUEBLA,21,IZÚCAR DE MATAMOROS,085,SAN MIGUEL LAS MINAS,4,295,148,147,16
PUEBLA,21,IZÚCAR DE MATAMOROS,085,SAN NICOLÁS TOLENTINO,2,208,107,101,10
PUEBLA,21,IZÚCAR DE MATAMOROS,085,SAN PEDRO CALANTLA,4,152,67,85,11
PUEBLA,21,IZÚCAR DE MATAMOROS,085,SAN RAFAEL,2,4,3,1,1
PUEBLA,21,IZÚCAR DE MATAMOROS,085,SAN SEBASTIÁN PUCTLA,3,209,108,101,12
PUEBLA,21,IZÚCAR DE MATAMOROS,085,SANTA MARÍA XUCHAPA,4,279,144,135,14
PUEBLA,21,IZÚCAR DE MATAMOROS,085,VISTA HERMOSA,5,133,69,64,11
PUEBLA,21,IZÚCAR DE MATAMOROS,085,XALTIANGUIS,3,81,41,40,6
PUEBLA,21,JALPAN,086,ACOYOTITLA,3,55,24,31,4
PUEBLA,21,JALPAN,086,AGUA HEDIONDA,2,18,12,6,2
PUEBLA,21,JALPAN,086,AGUA LINDA,4,168,89,79,10
PUEBLA,21,JALPAN,086,APAPANTILLA,8,528,257,271,28
PUEBLA,21,JALPAN,086,AQUILES CÓRDOBA MORÁN,1,9,7,2,1
PUEBLA,21,JALPAN,086,BENITO JUÁREZ,4,144,76,68,9
PUEBLA,21,JALPAN,086,EJIDO DE JALPAN (LA ZONA),4,191,102,89,11
PUEBLA,21,JALPAN,086,EJIDO MUNIXKAN,2,73,39,34,3
PUEBLA,21,JALPAN,086,EL PIÑAL,2,54,29,25,3
PUEBLA,21,JALPAN,086,EL POCHOTE,1,7,4,3,1
PUEBLA,21,JALPAN,086,EL RETIRO,1,19,6,13,1
PUEBLA,21,JALPAN,086,EMILIANO ZAPATA,2,7,4,3,1
PUEBLA,21,JALPAN,086,GUADALUPE VICTORIA,1,28,12,16,1
PUEBLA,21,JALPAN,086,JALPAN,7,309,181,128,14
PUEBLA,21,JALPAN,086,LA GARZA,4,116,69,47,8
PUEBLA,21,JALPAN,086,LA GLORIA,2,27,11,16,3
PUEBLA,21,JALPAN,086,LA REFORMA,1,56,25,31,3
PUEBLA,21,JALPAN,086,LINDA VISTA,2,12,7,5,2
PUEBLA,21,JALPAN,086,LOS PINOS,2,35,13,22,2
PUEBLA,21,JALPAN,086,NUEVO CHALMA,2,19,10,9,2
PUEBLA,21,JALPAN,086,NUEVO ZOQUIAPAN,3,159,81,78,12
PUEBLA,21,JALPAN,086,PANHUATLÁN,2,13,8,5,2
PUEBLA,21,JALPAN,086,PIEDRAS NEGRAS,3,227,128,99,11
PUEBLA,21,JALPAN,086,POZO DEL TIGRE,1,11,8,3,1
PUEBLA,21,JALPAN,086,PUEBLO AMÉRICA,2,93,49,44,8
PUEBLA,21,JALPAN,086,SANTA MARÍA,2,22,10,12,2
PUEBLA,21,JALPAN,086,TECHALOTLA,4,170,94,76,8
PUEBLA,21,JALPAN,086,TENANGUITO,2,9,1,8,2
PUEBLA,21,JALPAN,086,VILLA HERMOSA (VISTA HERMOSA),1,22,14,8,1
PUEBLA,21,JALPAN,086,VISTA HERMOSA,4,278,134,144,16
PUEBLA,21,JALPAN,086,ZOQUIAPAN,1,26,14,12,2
PUEBLA,21,JOLALPAN,087,CUAJINICUILA,1,5,4,1,0
PUEBLA,21,JOLALPAN,087,EL SALADO,3,19,8,11,2
PUEBLA,21,JOLALPAN,087,HUACHINANTLA,4,319,166,153,21
PUEBLA,21,JOLALPAN,087,JOLALPAN,10,1784,896,888,74
PUEBLA,21,JOLALPAN,087,LA NOPALERA,2,4,4,0,1
PUEBLA,21,JOLALPAN,087,LAS PILAS,3,31,18,13,4
PUEBLA,21,JOLALPAN,087,MESA QUINTANA,3,8,6,2,2
PUEBLA,21,JOLALPAN,087,SAN VICENTE,4,39,21,18,5
PUEBLA,21,JOLALPAN,087,SANTIAGO MITEPEC,6,230,117,113,14
PUEBLA,21,JOLALPAN,087,TEHUICTZINGO (TLACOTITLA),2,11,6,5,2
PUEBLA,21,JOLALPAN,087,TEOTLALCINGO,3,20,8,12,4
PUEBLA,21,JOLALPAN,087,TEUTLA,3,117,67,50,8
PUEBLA,21,JOLALPAN,087,XOCHITEPEC,4,224,114,110,13
PUEBLA,21,JOLALPAN,087,ZACACUAUTLA,3,13,6,7,2
PUEBLA,21,JONOTLA,088,ECATLÁN,3,127,50,77,8
PUEBLA,21,JONOTLA,088,EL TOZÁN,3,22,13,9,2
PUEBLA,21,JONOTLA,088,JONOTLA,7,338,170,168,23
PUEBLA,21,JONOTLA,088,LIMONAR [COLONIA],2,8,3,5,1
PUEBLA,21,JONOTLA,088,PASO DEL JARDÍN,4,73,34,39,9
PUEBLA,21,JONOTLA,088,SAN ANTONIO RAYÓN,4,268,155,113,13
PUEBLA,21,JONOTLA,088,TECPANTZINGO,4,151,73,78,11
PUEBLA,21,JONOTLA,088,TEPETITLÁN,3,48,27,21,3
PUEBLA,21,JONOTLA,088,TEPETZINAT,3,39,16,23,4
PUEBLA,21,JONOTLA,088,TIBURCIO JUÁREZ [COLONIA],2,6,3,3,1
PUEBLA,21,JONOTLA,088,XILOXÓCHIT,3,60,31,29,6
PUEBLA,21,JOPALA,089,ARROYO HONDO,2,19,9,10,2
PUEBLA,21,JOPALA,089,BUENOS AIRES,3,306,149,157,14
PUEBLA,21,JOPALA,089,BUGAMBILIAS (LA CRUZ),1,62,29,33,3
PUEBLA,21,JOPALA,089,CHICONTLA,8,1131,548,583,47
PUEBLA,21,JOPALA,089,CUAMAXALCO,3,80,39,41,5
PUEBLA,21,JOPALA,089,EL ENCINAL,4,175,77,98,9
PUEBLA,21,JOPALA,089,JOPALA,5,529,266,263,22
PUEBLA,21,JOPALA,089,PATLA,4,481,231,250,22
PUEBLA,21,JOPALA,089,RANCHO NUEVO,3,99,51,48,6
PUEBLA,21,JOPALA,089,SAN FRANCISCO,1,5,4,1,1
PUEBLA,21,JOPALA,089,SAN MARTÍN,2,18,5,13,2
PUEBLA,21,JOPALA,089,SATASKAUAT,1,156,90,66,7
PUEBLA,21,JOPALA,089,TECUANTLA (LOS REYES),3,39,19,20,3
PUEBLA,21,JOPALA,089,TLAOLANTONGO,4,366,188,178,16
PUEBLA,21,JUAN C. BONILLA,090,CUANALÁ,18,5466,2373,3093,250
PUEBLA,21,JUAN C. BONILLA,090,SAN LUCAS NEXTETELCO,2,97,42,55,4
PUEBLA,21,JUAN C. BONILLA,090,SANTA MARÍA ZACATEPEC,9,3269,1627,1642,120
PUEBLA,21,JUAN GALINDO,091,DOS CAMINOS,1,15,13,2,1
PUEBLA,21,JUAN GALINDO,091,NECAXALTÉPETL,4,314,157,157,15
PUEBLA,21,JUAN GALINDO,091,NUEVO NECAXA,9,1839,913,926,82
PUEBLA,21,JUAN N. MÉNDEZ,092,ÁNIMAS GUADALUPE,2,57,30,27,3
PUEBLA,21,JUAN N. MÉNDEZ,092,ATENAYUCA,5,457,241,216,21
PUEBLA,21,JUAN N. MÉNDEZ,092,COLONIA MIGUEL HIDALGO,2,4,2,2,1
PUEBLA,21,JUAN N. MÉNDEZ,092,GUADALUPE VICTORIA,3,225,116,109,12
PUEBLA,21,JUAN N. MÉNDEZ,092,MAGDALENA ALQUIZAPÁN,4,186,90,96,11
PUEBLA,21,JUAN N. MÉNDEZ,092,SAN JERÓNIMO ZOYATITLANAPAN,3,111,61,50,6
PUEBLA,21,JUAN N. MÉNDEZ,092,ZAMARRILLA DE ÁLVARO OBREGÓN,4,225,108,117,12
PUEBLA,21,LAFRAGUA,093,AGUA DE LA MINA,3,43,26,17,5
PUEBLA,21,LAFRAGUA,093,CUAUHTÉMOC,4,379,203,176,17
PUEBLA,21,LAFRAGUA,093,FRANCISCO I. MADERO (EL SABINAL),3,216,106,110,12
PUEBLA,21,LAFRAGUA,093,GONZÁLEZ ORTEGA,4,479,247,232,23
PUEBLA,21,LAFRAGUA,093,LA ERMITA,2,44,21,23,3
PUEBLA,21,LAFRAGUA,093,LAS TRANCAS (SANTA CRUZ),1,4,3,1,1
PUEBLA,21,LAFRAGUA,093,LOMA BONITA (SANTA CRUZ),1,20,11,9,1
PUEBLA,21,LAFRAGUA,093,POCITOS (SAN MIGUEL),3,84,40,44,7
PUEBLA,21,LAFRAGUA,093,SALTILLO,4,229,121,108,12
PUEBLA,21,LAFRAGUA,093,SAN ISIDRO,3,17,6,11,3
PUEBLA,21,LAFRAGUA,093,TLANALAPAN,4,200,96,104,13
PUEBLA,21,LAFRAGUA,093,VISTA HERMOSA,1,8,6,2,1
PUEBLA,21,LIBRES,094,AHUATENO,2,45,27,18,3
PUEBLA,21,LIBRES,094,ÁLVARO OBREGÓN (SAN FRANCISCO),2,113,54,59,5
PUEBLA,21,LIBRES,094,AYEHUALACO (SAN MARTÍN),2,117,50,67,6
PUEBLA,21,LIBRES,094,BELLA VISTA,2,60,31,29,3
PUEBLA,21,LIBRES,094,CIUDAD DE LIBRES,31,8635,4373,4262,392
PUEBLA,21,LIBRES,094,CUAUHTZOLCO,2,250,112,138,8
PUEBLA,21,LIBRES,094,GUADALUPE VICTORIA,2,124,47,77,8
PUEBLA,21,LIBRES,094,GUERRERO,1,42,19,23,2
PUEBLA,21,LIBRES,094,LA CAÑADA,4,352,178,174,12
PUEBLA,21,LIBRES,094,LA NORIA,1,38,18,20,2
PUEBLA,21,LIBRES,094,LA NORIA GONZÁLEZ COVARRUBIAS,1,25,13,12,2
PUEBLA,21,LIBRES,094,LAS CHAPAS,3,52,23,29,6
PUEBLA,21,LIBRES,094,LOMA BELLA,2,26,12,14,2
PUEBLA,21,LIBRES,094,NUEVO MÉXICO (EL SABINAL),4,617,301,316,26
PUEBLA,21,LIBRES,094,PEDERNALES,2,40,24,16,2
PUEBLA,21,LIBRES,094,PROGRESO,3,403,199,204,20
PUEBLA,21,LIBRES,094,RANCHO VIEJO,3,51,28,23,4
PUEBLA,21,LIBRES,094,SAN CARLOS,3,485,229,256,23
PUEBLA,21,LIBRES,094,SAN JERÓNIMO PALMARITOS,2,26,13,13,3
PUEBLA,21,LIBRES,094,SAN JOSÉ LA LIBERTAD,2,89,44,45,4
PUEBLA,21,LIBRES,094,SAN JOSÉ MORELOS,3,444,245,199,21
PUEBLA,21,LIBRES,094,SAN JUAN,2,632,287,345,20
PUEBLA,21,LIBRES,094,SAN MARTÍN,2,43,29,14,3
PUEBLA,21,LIBRES,094,SAN PEDRO,2,90,51,39,6
PUEBLA,21,LIBRES,094,TEHUATZINGO,4,239,120,119,9
PUEBLA,21,LIBRES,094,TEOLOYUCAN,1,8,4,4,1
PUEBLA,21,LIBRES,094,TIMIMILCO,2,20,12,8,2
PUEBLA,21,LA MAGDALENA TLATLAUQUITEPEC,095,LA MAGDALENA TLATLAUQUITEPEC,4,209,98,111,12
PUEBLA,21,MAZAPILTEPEC DE JUÁREZ,096,ESTACIÓN DE RINCONADA,4,151,83,68,9
PUEBLA,21,MAZAPILTEPEC DE JUÁREZ,096,MAZAPILTEPEC DE JUÁREZ,4,541,261,280,21
PUEBLA,21,MAZAPILTEPEC DE JUÁREZ,096,SAN LUIS SESMA,2,29,15,14,2
PUEBLA,21,MAZAPILTEPEC DE JUÁREZ,096,SAN MARTÍN RINCONADA,2,82,36,46,5
PUEBLA,21,MIXTLA,097,SAN FRANCISCO MIXTLA,4,597,302,295,25
PUEBLA,21,MIXTLA,097,SAN SIMÓN COATEPEC,2,120,57,63,6
PUEBLA,21,MOLCAXAC,098,MOLCAXAC,5,556,252,304,53
PUEBLA,21,MOLCAXAC,098,SAN ANDRÉS MIMIAHUAPAN,4,129,72,57,7
PUEBLA,21,MOLCAXAC,098,SAN JOSÉ DE GRACIA,4,304,148,156,13
PUEBLA,21,MOLCAXAC,098,SAN LUIS TEHUIZOTLA,3,185,89,96,11
PUEBLA,21,MOLCAXAC,098,SANTA CRUZ HUITZILTEPEC,4,529,270,259,29
PUEBLA,21,CAÑADA MORELOS,099,BARRIO DE GUADALUPE,2,42,22,20,2
PUEBLA,21,CAÑADA MORELOS,099,BARRIO LA SOLEDAD,3,142,65,77,8
PUEBLA,21,CAÑADA MORELOS,099,BOCA NOPAL,4,247,103,144,12
PUEBLA,21,CAÑADA MORELOS,099,BUENA VISTA,4,283,161,122,17
PUEBLA,21,CAÑADA MORELOS,099,CENTRO DE AHUATEPEC (EL PILANCÓN),1,6,4,2,1
PUEBLA,21,CAÑADA MORELOS,099,CERRO GORDO,3,81,49,32,5
PUEBLA,21,CAÑADA MORELOS,099,EL CALVARIO,2,29,13,16,3
PUEBLA,21,CAÑADA MORELOS,099,EL LLANO TEMAXCALAPA,2,13,2,11,2
PUEBLA,21,CAÑADA MORELOS,099,GUADALUPE FRESNAL,4,188,106,82,10
PUEBLA,21,CAÑADA MORELOS,099,LÁZARO CÁRDENAS,3,125,52,73,6
PUEBLA,21,CAÑADA MORELOS,099,LLANO GRANDE AHUATEPEC,4,167,91,76,10
PUEBLA,21,CAÑADA MORELOS,099,LLANO GRANDE IXTAPA,2,52,25,27,3
PUEBLA,21,CAÑADA MORELOS,099,LOMA BONITA,3,38,16,22,5
PUEBLA,21,CAÑADA MORELOS,099,LOS GARCÍAS,4,275,128,147,13
PUEBLA,21,CAÑADA MORELOS,099,MORELOS CAÑADA,6,1385,726,659,59
PUEBLA,21,CAÑADA MORELOS,099,PUERTA CAÑADA,3,122,54,68,7
PUEBLA,21,CAÑADA MORELOS,099,SAN ANTONIO SOLEDAD,4,574,275,299,23
PUEBLA,21,CAÑADA MORELOS,099,SAN CAYETANO,3,27,16,11,4
PUEBLA,21,CAÑADA MORELOS,099,SAN JOSÉ IXTAPA,5,870,430,440,35
PUEBLA,21,CAÑADA MORELOS,099,SAN LUCAS,1,47,29,18,2
PUEBLA,21,CAÑADA MORELOS,099,SAN MIGUEL CUESTA CHICA,3,77,38,39,4
PUEBLA,21,CAÑADA MORELOS,099,SANTA ANA OCOTEPEC,1,38,27,11,3
PUEBLA,21,CAÑADA MORELOS,099,SANTA CRUZ SOLEDAD,4,236,116,120,10
PUEBLA,21,CAÑADA MORELOS,099,TEMAXCALAPA,3,128,63,65,7
PUEBLA,21,CAÑADA MORELOS,099,TEZUAPAN (SAN ISIDRO),3,205,107,98,11
PUEBLA,21,NAUPAN,100,ALAMBIQUE,3,27,15,12,3
PUEBLA,21,NAUPAN,100,CHACHAHUANTLA,4,136,61,75,10
PUEBLA,21,NAUPAN,100,COPILA,4,385,190,195,20
PUEBLA,21,NAUPAN,100,COZOLAPA,3,36,16,20,3
PUEBLA,21,NAUPAN,100,CUAHUIHUITZOTITLA,3,117,59,58,7
PUEBLA,21,NAUPAN,100,CUEYATLA,3,162,84,78,8
PUEBLA,21,NAUPAN,100,ICZOTITLA,4,348,172,176,19
PUEBLA,21,NAUPAN,100,MEXTLA,5,161,78,83,10
PUEBLA,21,NAUPAN,100,NAUPAN,6,567,288,279,29
PUEBLA,21,NAUPAN,100,TENEXTITLA,3,83,33,50,6
PUEBLA,21,NAUPAN,100,TEOPANZOLCO,1,10,3,7,1
PUEBLA,21,NAUPAN,100,TLAXPANALOYA,3,194,89,105,12
PUEBLA,21,NAUPAN,100,XIAUTLA (XIAGTLA),3,52,29,23,4
PUEBLA,21,NAUZONTLA,101,CUAHUTAPEHUAL DE BENITO JUÁREZ,4,141,77,64,9
PUEBLA,21,NAUZONTLA,101,LA UNIÓN,2,67,28,39,3
PUEBLA,21,NAUZONTLA,101,NAUZONTLA,4,449,237,212,25
PUEBLA,21,NAUZONTLA,101,SAN RAFAEL AXOLOTA,2,92,41,51,5
PUEBLA,21,NAUZONTLA,101,SANTA LUCÍA ATIOYAN,2,36,16,20,3
PUEBLA,21,NAUZONTLA,101,TEPANYEHUAL,2,32,15,17,3
PUEBLA,21,NEALTICAN,102,SAN BUENAVENTURA NEALTICAN,11,3544,1779,1765,126
PUEBLA,21,NICOLÁS BRAVO,103,AZUMBILLA,6,1240,613,627,44
PUEBLA,21,NICOLÁS BRAVO,103,BARRIO DE LA LUZ,1,23,10,13,1
PUEBLA,21,NICOLÁS BRAVO,103,LOS TABACOS,2,24,10,14,2
PUEBLA,21,NICOLÁS BRAVO,103,NICOLÁS BRAVO,4,346,173,173,16
PUEBLA,21,NICOLÁS BRAVO,103,SAN ISIDRO AHUATLAMPA,2,19,9,10,2
PUEBLA,21,NICOLÁS BRAVO,103,SANTA ANA,4,1182,644,538,97
PUEBLA,21,NOPALUCAN,104,COLONIA OBRERA,1,40,23,17,2
PUEBLA,21,NOPALUCAN,104,EL RINCÓN CITLALTÉPETL,5,1766,932,834,55
PUEBLA,21,NOPALUCAN,104,ERÉNDIRA,3,213,101,112,11
PUEBLA,21,NOPALUCAN,104,JUAN DE LA GRANJA,2,204,100,104,8
PUEBLA,21,NOPALUCAN,104,MANUEL ÁVILA CAMACHO (LA CIMA),3,175,89,86,9
PUEBLA,21,NOPALUCAN,104,NOPALUCAN DE LA GRANJA,11,2568,1364,1204,102
PUEBLA,21,NOPALUCAN,104,SAN ANTONIO TAMARIZ,1,81,35,46,3
PUEBLA,21,NOPALUCAN,104,SAN JUAN SOSA,3,30,16,14,3
PUEBLA,21,NOPALUCAN,104,SANTA CRUZ DEL BOSQUE,4,234,126,108,13
PUEBLA,21,NOPALUCAN,104,SANTA MARÍA IXTIYUCAN,8,2195,1104,1091,78
PUEBLA,21,OCOTEPEC,105,BUENOS AIRES,3,16,9,7,3
PUEBLA,21,OCOTEPEC,105,EL MIRADOR (SAN FRANCISCO),3,166,80,86,9
PUEBLA,21,OCOTEPEC,105,EL PROGRESO,3,55,20,35,5
PUEBLA,21,OCOTEPEC,105,GUADALUPE VICTORIA,3,398,187,211,17
PUEBLA,21,OCOTEPEC,105,LOMA LARGA (OYAMETITA),2,7,2,5,1
PUEBLA,21,OCOTEPEC,105,OCOTEPEC,4,413,199,214,18
PUEBLA,21,OCOTEPEC,105,SAN NICOLÁS CONTLA,2,24,13,11,2
PUEBLA,21,OCOTEPEC,105,TEZOQUITICPAC,2,17,9,8,2
PUEBLA,21,OCOTEPEC,105,XOCHITONAL,2,22,9,13,2
PUEBLA,21,OCOYUCAN,106,EMILIO PORTES GIL,2,76,42,34,3
PUEBLA,21,OCOYUCAN,106,FRANCISCO SARABIA,2,250,129,121,9
PUEBLA,21,OCOYUCAN,106,LA PASTORÍA,3,56,20,36,4
PUEBLA,21,OCOYUCAN,106,SAN BERNABÉ TEMOXTITLA,8,1526,743,783,64
PUEBLA,21,OCOYUCAN,106,SAN BERNARDINO CHALCHIHUAPAN,8,1586,794,792,71
PUEBLA,21,OCOYUCAN,106,SAN HIPÓLITO ACHIAPA,1,41,18,23,2
PUEBLA,21,OCOYUCAN,106,SAN ISIDRO PETLÁCATL,1,34,21,13,1
PUEBLA,21,OCOYUCAN,106,SANTA CLARA OCOYUCAN,11,2133,1067,1066,77
PUEBLA,21,OCOYUCAN,106,SANTA CRUZ HIDALGO,2,56,25,31,4
PUEBLA,21,OCOYUCAN,106,SANTA MARÍA MALACATEPEC,9,2093,1056,1037,65
PUEBLA,21,OCOYUCAN,106,SANTA MARTHA HIDALGO,4,505,242,263,15
PUEBLA,21,OCOYUCAN,106,SANTIAGO COLTZINGO,2,69,31,38,3
PUEBLA,21,OLINTLA,107,BIBIANO HERNÁNDEZ,3,89,45,44,8
PUEBLA,21,OLINTLA,107,CAZTÍN,2,18,6,12,2
PUEBLA,21,OLINTLA,107,CHIPAHUATLÁN,6,435,209,226,25
PUEBLA,21,OLINTLA,107,DIMAS LÓPEZ,5,314,150,164,20
PUEBLA,21,OLINTLA,107,IGNACIO ZARAGOZA,2,76,38,38,4
PUEBLA,21,OLINTLA,107,LACAPAN CAMALLAGNE,4,212,119,93,8
PUEBLA,21,OLINTLA,107,LKUYUM CHUCHUT,2,36,19,17,3
PUEBLA,21,OLINTLA,107,LUWA,3,46,17,29,4
PUEBLA,21,OLINTLA,107,MOCOT,1,6,4,2,1
PUEBLA,21,OLINTLA,107,OLINTLA,10,690,345,345,41
PUEBLA,21,OLINTLA,107,PASUANCA,2,24,10,14,3
PUEBLA,21,OLINTLA,107,SANTA BÁRBARA,2,12,4,8,2
PUEBLA,21,OLINTLA,107,SANTA CATARINA,2,166,88,78,7
PUEBLA,21,OLINTLA,107,VICENTE GUERRERO,10,1088,570,518,55
PUEBLA,21,ORIENTAL,108,EX-HACIENDA SAN ANTONIO VIRREYES,1,59,37,22,3
PUEBLA,21,ORIENTAL,108,JESÚS CARRANZA,2,35,20,15,3
PUEBLA,21,ORIENTAL,108,MIRAVALLES,3,317,152,165,13
PUEBLA,21,ORIENTAL,108,ORIENTAL,19,5139,2538,2601,226
PUEBLA,21,ORIENTAL,108,SAN ANTONIO VIRREYES,3,524,244,280,21
PUEBLA,21,ORIENTAL,108,SAN ISIDRO PATRIMONIO EJIDAL,1,20,10,10,2
PUEBLA,21,ORIENTAL,108,SAN JOSÉ ZACATEPEC,2,328,163,165,10
PUEBLA,21,ORIENTAL,108,SANTA CRUZ MAGDALENA,3,123,65,58,7
PUEBLA,21,PAHUATLÁN,109,ACAHUALES (EL AGUACATE),2,17,10,7,2
PUEBLA,21,PAHUATLÁN,109,ACALAPA,5,155,73,82,10
PUEBLA,21,PAHUATLÁN,109,AGUA DE MACHETE,2,168,92,76,10
PUEBLA,21,PAHUATLÁN,109,AGUA NEGRA,1,6,4,2,1
PUEBLA,21,PAHUATLÁN,109,AHILA,3,37,12,25,4
PUEBLA,21,PAHUATLÁN,109,AHUACATITLA,2,20,14,6,2
PUEBLA,21,PAHUATLÁN,109,ALMOLOYA,1,21,6,15,2
PUEBLA,21,PAHUATLÁN,109,ATLA,4,650,325,325,25
PUEBLA,21,PAHUATLÁN,109,ATLANTONGO,4,221,126,95,13
PUEBLA,21,PAHUATLÁN,109,CHIPOTLA,1,53,30,23,2
PUEBLA,21,PAHUATLÁN,109,CIUDAD DE PAHUATLÁN DE VALLE,11,1845,949,896,82
PUEBLA,21,PAHUATLÁN,109,CUAUNEUTLA DE LA PAZ,4,336,164,172,17
PUEBLA,21,PAHUATLÁN,109,LINDAVISTA,2,32,11,21,2
PUEBLA,21,PAHUATLÁN,109,LOS ÁNGELES,2,25,8,17,2
PUEBLA,21,PAHUATLÁN,109,MAMIQUETLA,2,75,40,35,3
PUEBLA,21,PAHUATLÁN,109,MONTELLANO,2,34,17,17,3
PUEBLA,21,PAHUATLÁN,109,PACIOTLA,2,139,61,78,8
PUEBLA,21,PAHUATLÁN,109,SAN PABLITO,5,803,417,386,36
PUEBLA,21,PAHUATLÁN,109,TLALCRUZ DE LIBRES,4,245,134,111,12
PUEBLA,21,PAHUATLÁN,109,XILEPA,2,22,12,10,2
PUEBLA,21,PAHUATLÁN,109,XOCHIMILCO,4,268,132,136,13
PUEBLA,21,PAHUATLÁN,109,XOLOTLA,4,582,295,287,26
PUEBLA,21,PAHUATLÁN,109,ZACAPEHUAYA,2,28,12,16,2
PUEBLA,21,PAHUATLÁN,109,ZOYATLA DE GUERRERO,6,243,117,126,14
PUEBLA,21,PALMAR DE BRAVO,110,AMOZOQUILLO PILETAS,1,18,7,11,1
PUEBLA,21,PALMAR DE BRAVO,110,BELLAVISTA DE VICTORIA (SAN JOSÉ BELLAVISTA),3,748,374,374,26
PUEBLA,21,PALMAR DE BRAVO,110,CUACNOPALAN,8,2773,1409,1364,129
PUEBLA,21,PALMAR DE BRAVO,110,CUESTA BLANCA,6,1127,536,591,45
PUEBLA,21,PALMAR DE BRAVO,110,CUESTA CHICA PILETAS,2,74,40,34,3
PUEBLA,21,PALMAR DE BRAVO,110,ENCRUCIJADA PRIMERA SECCIÓN,3,31,10,21,3
PUEBLA,21,PALMAR DE BRAVO,110,ENCRUCIJADA SEGUNDA SECCIÓN,1,7,4,3,1
PUEBLA,21,PALMAR DE BRAVO,110,GUADALUPE PILETAS,2,64,29,35,3
PUEBLA,21,PALMAR DE BRAVO,110,JESÚS NAZARENO,2,233,112,121,10
PUEBLA,21,PALMAR DE BRAVO,110,LA PURÍSIMA,4,739,357,382,29
PUEBLA,21,PALMAR DE BRAVO,110,LOMA BELLA (LOMA DEL PATO),2,17,5,12,2
PUEBLA,21,PALMAR DE BRAVO,110,LOS REYES ALTAMIRA,2,53,26,27,5
PUEBLA,21,PALMAR DE BRAVO,110,PALMAR DE BRAVO,8,2275,1156,1119,111
PUEBLA,21,PALMAR DE BRAVO,110,RANCHO DE VERA,1,19,9,10,1
PUEBLA,21,PALMAR DE BRAVO,110,RANCHO VERDE,2,36,15,21,4
PUEBLA,21,PALMAR DE BRAVO,110,SAN FRANCISCO PILETAS,3,89,46,43,4
PUEBLA,21,PALMAR DE BRAVO,110,SAN ISIDRO MONTERROSAS,4,380,179,201,14
PUEBLA,21,PALMAR DE BRAVO,110,SAN MIGUEL XALTEPEC,10,3222,1671,1551,103
PUEBLA,21,PALMAR DE BRAVO,110,SANTA CRUZ MONTERROSAS,2,234,104,130,10
PUEBLA,21,PALMAR DE BRAVO,110,SANTA CRUZ OCOTLÁN,2,34,14,20,3
PUEBLA,21,PALMAR DE BRAVO,110,SANTA ISABEL SABINAL,2,11,6,5,2
PUEBLA,21,PALMAR DE BRAVO,110,TEHUITZO,4,187,85,102,10
PUEBLA,21,PALMAR DE BRAVO,110,TRINIDAD EL ARENAL (LA NIGUA),2,20,9,11,2
PUEBLA,21,PANTEPEC,111,AGUA LINDA,4,263,128,135,14
PUEBLA,21,PANTEPEC,111,AMELUCA,4,474,221,253,24
PUEBLA,21,PANTEPEC,111,BUENA VISTA,3,18,9,9,2
PUEBLA,21,PANTEPEC,111,CAÑADA DE COLOTLA,1,32,13,19,3
PUEBLA,21,PANTEPEC,111,CAYHUAPAN,2,27,14,13,2
PUEBLA,21,PANTEPEC,111,CEBADILLAS,2,39,20,19,2
PUEBLA,21,PANTEPEC,111,EJIDO AGUA LINDA (DOS ARROYOS),3,115,53,62,7
PUEBLA,21,PANTEPEC,111,EJIDO CAÑADA COLOTLA,5,299,152,147,14
PUEBLA,21,PANTEPEC,111,EJIDO CARRIZAL VIEJO,5,119,56,63,7
PUEBLA,21,PANTEPEC,111,EJIDO CERRO DEL TABLÓN,3,48,19,29,4
PUEBLA,21,PANTEPEC,111,EL LIMONAR,2,24,14,10,3
PUEBLA,21,PANTEPEC,111,EL PACÍFICO,2,41,20,21,3
PUEBLA,21,PANTEPEC,111,EL POZO,4,210,108,102,11
PUEBLA,21,PANTEPEC,111,EL TABLÓN (LA PLANADA),1,12,7,5,1
PUEBLA,21,PANTEPEC,111,EL TERRERO,3,104,49,55,6
PUEBLA,21,PANTEPEC,111,EL ZAPOTAL,2,8,4,4,2
PUEBLA,21,PANTEPEC,111,EL ZAPOTE,2,16,4,12,2
PUEBLA,21,PANTEPEC,111,IGNACIO ZARAGOZA,3,73,34,39,6
PUEBLA,21,PANTEPEC,111,IXTOLOLOYA,5,170,85,85,13
PUEBLA,21,PANTEPEC,111,LA CEIBA CHICA,3,132,74,58,6
PUEBLA,21,PANTEPEC,111,LA UNIÓN,2,9,5,4,1
PUEBLA,21,PANTEPEC,111,LAS PALMAS,2,50,31,19,3
PUEBLA,21,PANTEPEC,111,LOMA BONITA,2,20,8,12,2
PUEBLA,21,PANTEPEC,111,MECAPALAPA,7,1180,598,582,55
PUEBLA,21,PANTEPEC,111,NUEVO CARRIZAL,3,182,93,89,13
PUEBLA,21,PANTEPEC,111,NUEVO LIMONAR,2,9,5,4,1
PUEBLA,21,PANTEPEC,111,PANTEPEC,12,966,472,494,52
PUEBLA,21,PANTEPEC,111,PROGRESO DE ALLENDE (RANCHO NUEVO),4,177,91,86,9
PUEBLA,21,PANTEPEC,111,SAN ANTONIO,1,26,14,12,2
PUEBLA,21,PANTEPEC,111,SANTA CRUZ,2,129,83,46,11
PUEBLA,21,PANTEPEC,111,TEJERÍA,3,94,45,49,6
PUEBLA,21,PANTEPEC,111,TENEXCO,1,18,8,10,1
PUEBLA,21,PETLALCINGO,112,BARRIO DE GUADALUPE SECCIÓN TERCERA,1,14,6,8,1
PUEBLA,21,PETLALCINGO,112,EJIDO SAN ANTONIO TIERRA COLORADA,2,23,11,12,2
PUEBLA,21,PETLALCINGO,112,EL ÍDOLO,4,186,90,96,9
PUEBLA,21,PETLALCINGO,112,EL LIMÓN,3,46,19,27,4
PUEBLA,21,PETLALCINGO,112,EL ROSARIO MICALTEPEC,2,31,17,14,2
PUEBLA,21,PETLALCINGO,112,MEZQUITAL (SECCIÓN QUINTA EL MEZQUITAL),2,40,16,24,3
PUEBLA,21,PETLALCINGO,112,PETLALCINGO,8,857,459,398,44
PUEBLA,21,PETLALCINGO,112,SAN ANTONIO TIERRA COLORADA,4,61,31,30,6
PUEBLA,21,PETLALCINGO,112,SAN ISIDRO,2,40,18,22,2
PUEBLA,21,PETLALCINGO,112,SAN JOSÉ TEXCALAPA,3,76,38,38,5
PUEBLA,21,PETLALCINGO,112,SANTA CRUZ (BARRIO DE SANTA CRUZ),1,15,8,7,1
PUEBLA,21,PETLALCINGO,112,SANTA CRUZ DE BRAVO,2,34,22,12,3
PUEBLA,21,PETLALCINGO,112,SANTA GERTRUDIS SALITRILLO,3,126,51,75,8
PUEBLA,21,PETLALCINGO,112,SECCIÓN SEXTA GUADALUPE,4,149,63,86,9
PUEBLA,21,PETLALCINGO,112,TEPEJILLO,5,106,50,56,7
PUEBLA,21,PETLALCINGO,112,TEXCALAPA DE JUÁREZ,8,562,297,265,30
PUEBLA,21,PIAXTLA,113,ATEMPA,1,36,21,15,2
PUEBLA,21,PIAXTLA,113,LOMA BONITA,2,31,11,20,2
PUEBLA,21,PIAXTLA,113,MANINALCINGO,1,19,10,9,1
PUEBLA,21,PIAXTLA,113,PIAXTLA,5,517,257,260,35
PUEBLA,21,PIAXTLA,113,PIAXTLA (TERCERA SECCIÓN),1,17,12,5,1
PUEBLA,21,PIAXTLA,113,PROGRESO,4,428,224,204,22
PUEBLA,21,PIAXTLA,113,SAN JOSÉ TETLA,3,51,16,35,5
PUEBLA,21,PIAXTLA,113,SANTA MARÍA,2,10,6,4,1
PUEBLA,21,PIAXTLA,113,TECUAUTITLÁN,2,49,21,28,3
PUEBLA,21,PIAXTLA,113,TLAXCUAPAN,3,58,25,33,3
PUEBLA,21,PIAXTLA,113,YETLA,3,49,23,26,4
PUEBLA,21,PUEBLA,114,ÁFRICAM SAFARI,1,16,8,8,3
PUEBLA,21,PUEBLA,114,ARTÍCULO PRIMERO CONSTITUCIONAL,3,605,302,303,20
PUEBLA,21,PUEBLA,114,BUENAVISTA TETELA,2,226,107,119,10
PUEBLA,21,PUEBLA,114,EL OASIS VALSEQUILLO,1,41,20,21,3
PUEBLA,21,PUEBLA,114,EL ROSARIO LA HUERTA,3,35,24,11,3
PUEBLA,21,PUEBLA,114,GUADALUPE,1,321,164,157,13
PUEBLA,21,PUEBLA,114,GUADALUPE TLATELPA,3,208,105,103,15
PUEBLA,21,PUEBLA,114,HEROICA PUEBLA DE ZARAGOZA,2171,560777,290104,270673,32087
PUEBLA,21,PUEBLA,114,LA ASUNCIÓN,1,39,21,18,3
PUEBLA,21,PUEBLA,114,LA LIBERTAD TECOLA,2,184,104,80,7
PUEBLA,21,PUEBLA,114,LA PAZ TLAXCOLPAN,2,183,88,95,8
PUEBLA,21,PUEBLA,114,LA RESURRECCIÓN,13,7768,3907,3861,295
PUEBLA,21,PUEBLA,114,LOS ÁNGELES TETELA,5,788,426,362,40
PUEBLA,21,PUEBLA,114,RESURGIMIENTO ATOTONILCO,2,144,82,62,7
PUEBLA,21,PUEBLA,114,SAN ANDRÉS AZUMIATLA,16,3555,1762,1793,118
PUEBLA,21,PUEBLA,114,SAN BALTAZAR TETELA,3,571,293,278,23
PUEBLA,21,PUEBLA,114,SAN ISIDRO TLALCOSTÉPETL,3,38,16,22,3
PUEBLA,21,PUEBLA,114,SAN JOSÉ EL AGUACATE,4,144,77,67,11
PUEBLA,21,PUEBLA,114,SAN JOSÉ EL RINCÓN,3,450,209,241,22
PUEBLA,21,PUEBLA,114,SAN JOSÉ XACXAMAYO,4,227,123,104,11
PUEBLA,21,PUEBLA,114,SAN JOSÉ ZETINA,2,25,15,10,2
PUEBLA,21,PUEBLA,114,SAN MIGUEL,1,32,18,14,1
PUEBLA,21,PUEBLA,114,SAN MIGUEL CANOA,21,6000,2999,3001,240
PUEBLA,21,PUEBLA,114,SAN MIGUEL ESPEJO,4,1023,490,533,30
PUEBLA,21,PUEBLA,114,SAN NICOLÁS COATEPEC,2,595,279,316,19
PUEBLA,21,PUEBLA,114,SAN PEDRO ZACACHIMALPA,4,1273,645,628,54
PUEBLA,21,PUEBLA,114,SAN SEBASTIÁN DE APARICIO,12,3632,1900,1732,138
PUEBLA,21,PUEBLA,114,SANTA CATARINA,5,1341,640,701,52
PUEBLA,21,PUEBLA,114,SANTA CATARINA (TERCERA SECCIÓN),2,74,43,31,3
PUEBLA,21,PUEBLA,114,SANTA CLARA LA VENTA,3,513,251,262,21
PUEBLA,21,PUEBLA,114,SANTA CRUZ LA IXTLA,2,86,39,47,4
PUEBLA,21,PUEBLA,114,SANTA LUCÍA ALTAMIRANO,2,825,414,411,22
PUEBLA,21,PUEBLA,114,SANTA MARÍA GUADALUPE TECOLA,5,445,212,233,19
PUEBLA,21,PUEBLA,114,SANTA MARÍA TZOCUILAC LA CANTERA,3,72,39,33,13
PUEBLA,21,PUEBLA,114,SANTA MARÍA XONACATEPEC,12,3620,1846,1774,141
PUEBLA,21,PUEBLA,114,SANTO TOMÁS CHAUTLA,10,2200,1140,1060,78
PUEBLA,21,QUECHOLAC,115,FRANCISCO I. MADERO,2,251,128,123,8
PUEBLA,21,QUECHOLAC,115,GUADALUPE ENRÍQUEZ,3,421,205,216,16
PUEBLA,21,QUECHOLAC,115,LA COMPAÑÍA,4,565,296,269,24
PUEBLA,21,QUECHOLAC,115,PALMARITO TOCHAPAN,17,4277,2193,2084,159
PUEBLA,21,QUECHOLAC,115,PROGRESO DE MADERO,1,71,35,36,3
PUEBLA,21,QUECHOLAC,115,QUECHOLAC,14,4418,2209,2209,159
PUEBLA,21,QUECHOLAC,115,QUECHOLAC (BARRIO SAN DIEGO),1,338,188,150,10
PUEBLA,21,QUECHOLAC,115,SAN BARTOLOMÉ COSCOMAYA,1,406,209,197,12
PUEBLA,21,QUECHOLAC,115,SAN CAYETANO,2,44,18,26,2
PUEBLA,21,QUECHOLAC,115,SAN JOSÉ TUZUAPAN,5,1366,687,679,44
PUEBLA,21,QUECHOLAC,115,SAN SIMÓN DE BRAVO,7,1654,861,793,61
PUEBLA,21,QUECHOLAC,115,SANTA CATARINA VILLANUEVA,4,681,339,342,27
PUEBLA,21,QUIMIXTLÁN,116,AHUACAITIC,1,7,3,4,1
PUEBLA,21,QUIMIXTLÁN,116,AHUACAPAN,4,111,52,59,7
PUEBLA,21,QUIMIXTLÁN,116,AHUATLA,2,104,54,50,4
PUEBLA,21,QUIMIXTLÁN,116,ALTA LUZ,3,32,15,17,3
PUEBLA,21,QUIMIXTLÁN,116,ALTO LUCERO,2,112,54,58,5
PUEBLA,21,QUIMIXTLÁN,116,ANALCO,2,38,21,17,3
PUEBLA,21,QUIMIXTLÁN,116,BARRIO DE SAN JUAN,2,22,10,12,2
PUEBLA,21,QUIMIXTLÁN,116,BUENAVISTA,5,602,320,282,24
PUEBLA,21,QUIMIXTLÁN,116,CANOAJAPAN (SAN JOSÉ),2,77,32,45,5
PUEBLA,21,QUIMIXTLÁN,116,CHIMALECAN,2,13,6,7,2
PUEBLA,21,QUIMIXTLÁN,116,CONHUITZILA,4,106,59,47,6
PUEBLA,21,QUIMIXTLÁN,116,CRUZ VERDE,3,83,45,38,4
PUEBLA,21,QUIMIXTLÁN,116,CUXAPA,2,80,50,30,3
PUEBLA,21,QUIMIXTLÁN,116,DURAZNILLO,2,23,14,9,2
PUEBLA,21,QUIMIXTLÁN,116,EL CARMEN PETLAHUACÁN,2,13,7,6,2
PUEBLA,21,QUIMIXTLÁN,116,EL MAGUEYAL,3,43,21,22,4
PUEBLA,21,QUIMIXTLÁN,116,EL MIRADOR GUADALUPANO,3,66,44,22,6
PUEBLA,21,QUIMIXTLÁN,116,EL RINCÓN DE LOS REYES,1,9,4,5,1
PUEBLA,21,QUIMIXTLÁN,116,EL TRIUNFO,4,279,136,143,14
PUEBLA,21,QUIMIXTLÁN,116,GUADALUPE CAMOJAPA,3,33,20,13,3
PUEBLA,21,QUIMIXTLÁN,116,JESÚS MARÍA COMALAPA,4,141,79,62,10
PUEBLA,21,QUIMIXTLÁN,116,LA CONCEPCIÓN,2,59,25,34,3
PUEBLA,21,QUIMIXTLÁN,116,LA RAYA,1,6,2,4,1
PUEBLA,21,QUIMIXTLÁN,116,LIMONTITLA,3,124,63,61,5
PUEBLA,21,QUIMIXTLÁN,116,MAGUEYITOS,2,39,23,16,2
PUEBLA,21,QUIMIXTLÁN,116,MALACAHUACAN,2,19,7,12,3
PUEBLA,21,QUIMIXTLÁN,116,NEXQUEXCAN,2,34,14,20,2
PUEBLA,21,QUIMIXTLÁN,116,PALMA SOLA,2,24,14,10,3
PUEBLA,21,QUIMIXTLÁN,116,PATLANALAN,4,358,169,189,16
PUEBLA,21,QUIMIXTLÁN,116,PEÑA BLANCA,1,19,9,10,1
PUEBLA,21,QUIMIXTLÁN,116,QUILIAYO,3,71,32,39,5
PUEBLA,21,QUIMIXTLÁN,116,QUIMIXTLÁN,7,944,480,464,38
PUEBLA,21,QUIMIXTLÁN,116,RINCÓN DE LOS REYES,4,264,137,127,12
PUEBLA,21,QUIMIXTLÁN,116,RINCÓN DE PATLANALÁN,1,16,7,9,1
PUEBLA,21,QUIMIXTLÁN,116,SAN ISIDRO REYNOSA,2,128,63,65,5
PUEBLA,21,QUIMIXTLÁN,116,SAN JUAN TLALPAN,3,25,10,15,3
PUEBLA,21,QUIMIXTLÁN,116,SAN MARTÍN EL CABALLITO,3,46,25,21,3
PUEBLA,21,QUIMIXTLÁN,116,SANTA CRUZ CABALLITO,2,93,46,47,4
PUEBLA,21,QUIMIXTLÁN,116,TEAPA,2,25,12,13,2
PUEBLA,21,QUIMIXTLÁN,116,TEPATZIN,2,55,34,21,3
PUEBLA,21,QUIMIXTLÁN,116,TEPELIHUACAN,1,9,4,5,1
PUEBLA,21,QUIMIXTLÁN,116,TLAHUITOMPA,3,76,35,41,4
PUEBLA,21,QUIMIXTLÁN,116,TLAMOLOAXTLA,3,125,61,64,6
PUEBLA,21,QUIMIXTLÁN,116,TLANEPANTLA,5,692,341,351,25
PUEBLA,21,QUIMIXTLÁN,116,TOTOTZIN,3,28,19,9,3
PUEBLA,21,QUIMIXTLÁN,116,TOZIHUIC,7,583,293,290,27
PUEBLA,21,QUIMIXTLÁN,116,VILLA HERMOSA (SAN JOSÉ),2,58,30,28,2
PUEBLA,21,QUIMIXTLÁN,116,VILLA NUEVA,2,56,28,28,3
PUEBLA,21,QUIMIXTLÁN,116,XACAXOMULCO,4,254,146,108,11
PUEBLA,21,RAFAEL LARA GRAJALES,117,CIUDAD DE RAFAEL LARA GRAJALES,19,4485,2281,2204,253
PUEBLA,21,RAFAEL LARA GRAJALES,117,MÁXIMO SERDÁN,5,1132,566,566,45
PUEBLA,21,LOS REYES DE JUÁREZ,118,BENITO JUÁREZ,5,1249,642,607,40
PUEBLA,21,LOS REYES DE JUÁREZ,118,BUENAVISTA DE JUÁREZ,3,610,326,284,24
PUEBLA,21,LOS REYES DE JUÁREZ,118,LA CONCORDIA,2,82,40,42,4
PUEBLA,21,LOS REYES DE JUÁREZ,118,LOS REYES DE JUÁREZ,17,3827,1890,1937,139
PUEBLA,21,LOS REYES DE JUÁREZ,118,SAN JUAN ACOZAC,4,1187,575,612,45
PUEBLA,21,SAN ANDRÉS CHOLULA,119,CACALOTEPEC,7,2882,1362,1520,254
PUEBLA,21,SAN ANDRÉS CHOLULA,119,SAN ANDRÉS CHOLULA,162,48877,25431,23446,3565
PUEBLA,21,SAN ANDRÉS CHOLULA,119,SAN ANTONIO CACALOTEPEC (EL PETLAYO),1,15,14,1,7
PUEBLA,21,SAN ANDRÉS CHOLULA,119,SAN BERNARDINO TLAXCALANCINGO,30,11360,5975,5385,1049
PUEBLA,21,SAN ANDRÉS CHOLULA,119,SAN LUIS TEHUILOYOCAN,6,1486,795,691,55
PUEBLA,21,SAN ANDRÉS CHOLULA,119,SAN PEDRO TONANTZINTLA,2,240,101,139,8
PUEBLA,21,SAN ANDRÉS CHOLULA,119,SAN RAFAEL COMAC,4,790,380,410,26
PUEBLA,21,SAN ANDRÉS CHOLULA,119,TONANTZINTLA,3,795,382,413,26
PUEBLA,21,SAN ANDRÉS CHOLULA,119,TONANTZINTLA (SANTA MARÍA TONANTZINTLA),7,1119,467,652,227
PUEBLA,21,SAN ANTONIO CAÑADA,120,COLONIA CUITLAXTEPEC,2,58,32,26,3
PUEBLA,21,SAN ANTONIO CAÑADA,120,COLONIA LA LOBERA,2,67,35,32,5
PUEBLA,21,SAN ANTONIO CAÑADA,120,SAN ANTONIO CAÑADA,7,832,413,419,36
PUEBLA,21,SAN ANTONIO CAÑADA,120,SAN ESTEBAN NECOXCALCO,6,491,250,241,18
PUEBLA,21,SAN ANTONIO CAÑADA,120,TLACHICHILCO,2,32,15,17,2
PUEBLA,21,SAN DIEGO LA MESA TOCHIMILTZINGO,121,GUADALUPE AMOLOCAYAN,3,82,39,43,6
PUEBLA,21,SAN DIEGO LA MESA TOCHIMILTZINGO,121,LA SOLEDAD TEPEHUAXTITLA,2,17,8,9,2
PUEBLA,21,SAN DIEGO LA MESA TOCHIMILTZINGO,121,SAN BARTOLOMÉ CHIMALHUACÁN,2,35,13,22,3
PUEBLA,21,SAN DIEGO LA MESA TOCHIMILTZINGO,121,TOCHIMILTZINGO,4,167,82,85,10
PUEBLA,21,SAN FELIPE TEOTLALCINGO,122,SAN FELIPE TEOTLALCINGO,7,1597,778,819,59
PUEBLA,21,SAN FELIPE TEOTLALCINGO,122,SAN JUAN TLALE,2,124,52,72,5
PUEBLA,21,SAN FELIPE TEOTLALCINGO,122,SAN MATÍAS ATZALA,4,600,307,293,26
PUEBLA,21,SAN FELIPE TEPATLÁN,123,ÁFRICA,4,172,75,97,10
PUEBLA,21,SAN FELIPE TEPATLÁN,123,ALTICA,2,114,58,56,6
PUEBLA,21,SAN FELIPE TEPATLÁN,123,CALAPANA,2,7,4,3,1
PUEBLA,21,SAN FELIPE TEPATLÁN,123,JOJUPANGO (SAN MIGUEL JOJUPANGO),4,194,104,90,14
PUEBLA,21,SAN FELIPE TEPATLÁN,123,LA GUADALUPANA,2,33,19,14,2
PUEBLA,21,SAN FELIPE TEPATLÁN,123,PACHOC,2,61,36,25,4
PUEBLA,21,SAN FELIPE TEPATLÁN,123,SAN FELIPE TEPATLÁN,4,170,84,86,8
PUEBLA,21,SAN FELIPE TEPATLÁN,123,SAN MARTÍN DEL PROGRESO (LA PUNTA),3,139,68,71,7
PUEBLA,21,SAN FELIPE TEPATLÁN,123,XOCHICUGTLA,3,30,16,14,3
PUEBLA,21,SAN FELIPE TEPATLÁN,123,XOCHIMILCO,3,24,13,11,4
PUEBLA,21,SAN GABRIEL CHILAC,124,SAN GABRIEL CHILAC,15,3174,1605,1569,124
PUEBLA,21,SAN GABRIEL CHILAC,124,SAN JUAN ATZINGO,5,370,185,185,16
PUEBLA,21,SAN GABRIEL CHILAC,124,VISTA HERMOSA,2,282,138,144,11
PUEBLA,21,SAN GREGORIO ATZOMPA,125,CHIPILO DE FRANCISCO JAVIER MINA,8,1481,791,690,78
PUEBLA,21,SAN GREGORIO ATZOMPA,125,SAN GREGORIO ATZOMPA,8,1547,798,749,90
PUEBLA,21,SAN JERÓNIMO TECUANIPAN,126,LOS REYES TLANECHICOLPAN,2,308,127,181,11
PUEBLA,21,SAN JERÓNIMO TECUANIPAN,126,SAN JERÓNIMO TECUANIPAN,4,559,298,261,30
PUEBLA,21,SAN JERÓNIMO TECUANIPAN,126,SAN MIGUEL PAPAXTLA,4,481,248,233,17
PUEBLA,21,SAN JERÓNIMO XAYACATLÁN,127,BARRANCA SALADA,2,31,17,14,2
PUEBLA,21,SAN JERÓNIMO XAYACATLÁN,127,CAÑADA SAN MIGUEL,1,5,3,2,1
PUEBLA,21,SAN JERÓNIMO XAYACATLÁN,127,EL CUAJILOTE,2,16,5,11,3
PUEBLA,21,SAN JERÓNIMO XAYACATLÁN,127,GABINO BARREDA,4,91,49,42,6
PUEBLA,21,SAN JERÓNIMO XAYACATLÁN,127,SAN JERÓNIMO XAYACATLÁN,6,308,145,163,20
PUEBLA,21,SAN JERÓNIMO XAYACATLÁN,127,SAN PEDRO,2,38,22,16,3
PUEBLA,21,SAN JERÓNIMO XAYACATLÁN,127,SANTO DOMINGO TONAHUIXTLA,4,97,46,51,8
PUEBLA,21,SAN JERÓNIMO XAYACATLÁN,127,SECCIÓN CAÑADA SANDÍA,2,19,10,9,2
PUEBLA,21,SAN JOSÉ CHIAPA,128,CENTRO DE DESARROLLO AGROPECUARIO VICENCIO,2,260,131,129,10
PUEBLA,21,SAN JOSÉ CHIAPA,128,EX-HACIENDA OJO DE AGUA,2,21,7,14,2
PUEBLA,21,SAN JOSÉ CHIAPA,128,EX-HACIENDA OZUMBA,1,222,106,116,9
PUEBLA,21,SAN JOSÉ CHIAPA,128,NUEVO VICENCIO,1,35,15,20,3
PUEBLA,21,SAN JOSÉ CHIAPA,128,SAN ISIDRO OVANDO (LA AMBICIÓN),2,41,16,25,4
PUEBLA,21,SAN JOSÉ CHIAPA,128,SAN JOSÉ CHIAPA,15,3670,1624,2046,206
PUEBLA,21,SAN JOSÉ CHIAPA,128,SAN JOSÉ MORELOS (LOS OCOTES),2,34,13,21,2
PUEBLA,21,SAN JOSÉ CHIAPA,128,SAN JOSÉ OZUMBA,3,209,113,96,8
PUEBLA,21,SAN JOSÉ MIAHUATLÁN,129,SAN JERÓNIMO AXOCHITLÁN,3,197,94,103,10
PUEBLA,21,SAN JOSÉ MIAHUATLÁN,129,SAN JOSÉ AXUXCO,4,528,240,288,23
PUEBLA,21,SAN JOSÉ MIAHUATLÁN,129,SAN JOSÉ MIAHUATLÁN,8,1758,901,857,71
PUEBLA,21,SAN JOSÉ MIAHUATLÁN,129,SAN MATEO TLACOXCALCO,3,173,82,91,10
PUEBLA,21,SAN JOSÉ MIAHUATLÁN,129,SAN PEDRO TETITLÁN,4,223,112,111,14
PUEBLA,21,SAN JUAN ATENCO,130,EL LLANO,2,13,7,6,2
PUEBLA,21,SAN JUAN ATENCO,130,SAN JOSÉ GUERRERO,2,76,43,33,4
PUEBLA,21,SAN JUAN ATENCO,130,SAN JUAN ATENCO,5,536,273,263,23
PUEBLA,21,SAN JUAN ATENCO,130,SANTA CRUZ COYOTEPEC,3,92,43,49,5
PUEBLA,21,SAN JUAN ATENCO,130,TRES CRUCES OCOTEPEC,2,16,6,10,4
PUEBLA,21,SAN JUAN ATZOMPA,131,SAN JUAN ATZOMPA,5,329,164,165,18
PUEBLA,21,SAN MARTÍN TEXMELUCAN,132,SAN BALTAZAR TEMAXCALAC (LA CIÉNEGA),7,1442,692,750,56
PUEBLA,21,SAN MARTÍN TEXMELUCAN,132,SAN BUENAVENTURA TECALTZINGO,7,1401,713,688,66
PUEBLA,21,SAN MARTÍN TEXMELUCAN,132,SAN CRISTÓBAL TEPATLAXCO,9,766,391,375,60
PUEBLA,21,SAN MARTÍN TEXMELUCAN,132,SAN FRANCISCO TEPEYECAC,5,824,398,426,31
PUEBLA,21,SAN MARTÍN TEXMELUCAN,132,SAN JERÓNIMO TIANGUISMANALCO,9,1595,761,834,60
PUEBLA,21,SAN MARTÍN TEXMELUCAN,132,SAN JUAN TUXCO,9,1906,946,960,71
PUEBLA,21,SAN MARTÍN TEXMELUCAN,132,SAN LUCAS ATOYATENCO (LOS RANCHITOS),5,2418,1093,1325,116
PUEBLA,21,SAN MARTÍN TEXMELUCAN,132,SAN MARTÍN TEXMELUCAN DE LABASTIDA,152,30334,16123,14211,1613
PUEBLA,21,SAN MARTÍN TEXMELUCAN,132,SAN RAFAEL TLANALAPAN,10,2119,1043,1076,85
PUEBLA,21,SAN MARTÍN TEXMELUCAN,132,SANTA MARÍA MOYOTZINGO,17,4209,2001,2208,236
PUEBLA,21,SAN MARTÍN TOTOLTEPEC,133,SAN MARTÍN TOTOLTEPEC,3,192,76,116,10
PUEBLA,21,SAN MATÍAS TLALANCALECA,134,BUENAVISTA,1,97,51,46,3
PUEBLA,21,SAN MATÍAS TLALANCALECA,134,EX-HACIENDA MOLINO DE GUADALUPE (SAN FÉLIX),2,12,3,9,1
PUEBLA,21,SAN MATÍAS TLALANCALECA,134,JUÁREZ CORONACO,6,784,389,395,31
PUEBLA,21,SAN MATÍAS TLALANCALECA,134,PALMILLAS,2,291,137,154,10
PUEBLA,21,SAN MATÍAS TLALANCALECA,134,SAN ANTONIO CHIAUTLA DE ARENAS,3,280,151,129,11
PUEBLA,21,SAN MATÍAS TLALANCALECA,134,SAN FERNANDO EL OCOTAL,3,18,9,9,3
PUEBLA,21,SAN MATÍAS TLALANCALECA,134,SAN FRANCISCO TLÁLOC,3,334,170,164,12
PUEBLA,21,SAN MATÍAS TLALANCALECA,134,SAN MATÍAS TLALANCALECA,13,2666,1377,1289,107
PUEBLA,21,SAN MIGUEL IXITLÁN,135,SAN MIGUEL IXITLÁN,4,93,48,45,6
PUEBLA,21,SAN MIGUEL XOXTLA,136,SAN MIGUEL XOXTLA,15,3973,1994,1979,162
PUEBLA,21,SAN NICOLÁS BUENOS AIRES,137,BENITO JUÁREZ (MATA REDONDA),2,49,24,25,4
PUEBLA,21,SAN NICOLÁS BUENOS AIRES,137,BUENAVISTA (SAN JOSÉ BUENAVISTA),2,35,21,14,3
PUEBLA,21,SAN NICOLÁS BUENOS AIRES,137,EMILIO PORTES GIL,4,936,478,458,33
PUEBLA,21,SAN NICOLÁS BUENOS AIRES,137,MIGUEL HIDALGO,3,134,62,72,8
PUEBLA,21,SAN NICOLÁS BUENOS AIRES,137,POZO GUERRA,3,87,49,38,6
PUEBLA,21,SAN NICOLÁS BUENOS AIRES,137,SAN FRANCISCO LA MATA,4,323,143,180,16
PUEBLA,21,SAN NICOLÁS BUENOS AIRES,137,SAN NICOLÁS BUENOS AIRES,6,801,402,399,36
PUEBLA,21,SAN NICOLÁS BUENOS AIRES,137,VENUSTIANO CARRANZA,2,154,72,82,7
PUEBLA,21,SAN NICOLÁS DE LOS RANCHOS,138,SAN NICOLÁS DE LOS RANCHOS,7,2638,1365,1273,91
PUEBLA,21,SAN NICOLÁS DE LOS RANCHOS,138,SAN PEDRO YANCUITLALPAN,3,201,97,104,9
PUEBLA,21,SAN NICOLÁS DE LOS RANCHOS,138,SANTIAGO XALITZINTLA,4,500,257,243,22
PUEBLA,21,SAN PABLO ANICANO,139,FRANCISCO GONZÁLEZ BOCANEGRA,3,52,22,30,4
PUEBLA,21,SAN PABLO ANICANO,139,MIXQUITLIXCO,3,110,63,47,6
PUEBLA,21,SAN PABLO ANICANO,139,PEDREGOSO,3,40,22,18,3
PUEBLA,21,SAN PABLO ANICANO,139,SAN MIGUEL TULAPA,4,68,29,39,5
PUEBLA,21,SAN PABLO ANICANO,139,SAN PABLO ANICANO,9,466,228,238,22
PUEBLA,21,SAN PABLO ANICANO,139,SAN RAFAEL (LA PALMA),2,30,17,13,2
PUEBLA,21,SAN PABLO ANICANO,139,SANTA CRUZ CUAULOTE,2,19,9,10,2
PUEBLA,21,SAN PEDRO CHOLULA,140,CHOLULA DE RIVADAVIA,177,31266,15679,15587,1742
PUEBLA,21,SAN PEDRO CHOLULA,140,SAN CRISTÓBAL TEPONTLA,5,1825,875,950,78
PUEBLA,21,SAN PEDRO CHOLULA,140,SAN FRANCISCO COAPAN,4,715,378,337,28
PUEBLA,21,SAN PEDRO CHOLULA,140,SAN GREGORIO ZACAPECHPAN,8,1965,967,998,68
PUEBLA,21,SAN PEDRO CHOLULA,140,SAN JUAN TLAUTLA,1,220,94,126,8
PUEBLA,21,SAN PEDRO CHOLULA,140,SANTA MARÍA ACUEXCOMAC,7,1568,851,717,60
PUEBLA,21,SAN PEDRO CHOLULA,140,SANTIAGO MOMOXPAN,36,4780,2300,2480,358
PUEBLA,21,SAN PEDRO YELOIXTLAHUACA,141,SAN CRISTÓBAL,2,17,11,6,2
PUEBLA,21,SAN PEDRO YELOIXTLAHUACA,141,SAN ISIDRO LABRADOR,2,67,37,30,3
PUEBLA,21,SAN PEDRO YELOIXTLAHUACA,141,SAN JOSÉ AGUA ZARCA,2,36,15,21,2
PUEBLA,21,SAN PEDRO YELOIXTLAHUACA,141,SAN JOSÉ ÁLAMO,2,65,25,40,3
PUEBLA,21,SAN PEDRO YELOIXTLAHUACA,141,SAN JUAN LLANO GRANDE,4,199,91,108,12
PUEBLA,21,SAN PEDRO YELOIXTLAHUACA,141,SAN PEDRO YELOIXTLAHUACA,5,522,266,256,32
PUEBLA,21,SAN PEDRO YELOIXTLAHUACA,141,SANTA CRUZ MIRADOR,1,11,10,1,1
PUEBLA,21,SAN SALVADOR EL SECO,142,CAMINO A LA HIGUERA,2,304,145,159,10
PUEBLA,21,SAN SALVADOR EL SECO,142,GUADALUPE VICTORIA,1,118,61,57,6
PUEBLA,21,SAN SALVADOR EL SECO,142,PASO PUENTE SANTA ANA,4,356,175,181,23
PUEBLA,21,SAN SALVADOR EL SECO,142,SAN FRANCISCO ALJIBES,3,42,26,16,5
PUEBLA,21,SAN SALVADOR EL SECO,142,SAN JOSÉ BARROSO,2,95,47,48,4
PUEBLA,21,SAN SALVADOR EL SECO,142,SAN SALVADOR EL SECO,22,5128,2595,2533,202
PUEBLA,21,SAN SALVADOR EL SECO,142,SANTA MARÍA COATEPEC,8,1318,643,675,60
PUEBLA,21,SAN SALVADOR EL VERDE,143,ANALCO DE PONCIANO ARRIAGA (SANTA CRUZ ANALCO),4,889,452,437,28
PUEBLA,21,SAN SALVADOR EL VERDE,143,GUADALUPE LA ENCINERA,1,23,11,12,2
PUEBLA,21,SAN SALVADOR EL VERDE,143,SAN ANDRÉS HUEYACATITLA,6,1156,572,584,40
PUEBLA,21,SAN SALVADOR EL VERDE,143,SAN GREGORIO AZTOTOACAN,3,488,249,239,20
PUEBLA,21,SAN SALVADOR EL VERDE,143,SAN LUCAS EL GRANDE,12,2746,1377,1369,113
PUEBLA,21,SAN SALVADOR EL VERDE,143,SAN SALVADOR EL VERDE,14,2004,1048,956,99
PUEBLA,21,SAN SALVADOR EL VERDE,143,SAN SIMÓN ATZITZINTLA,5,1203,580,623,41
PUEBLA,21,SAN SALVADOR EL VERDE,143,TLACOTEPEC DE JOSÉ MANZO,4,795,384,411,24
PUEBLA,21,SAN SALVADOR HUIXCOLOTLA,144,DOLORES,1,7,5,2,1
PUEBLA,21,SAN SALVADOR HUIXCOLOTLA,144,SAN SALVADOR HUIXCOLOTLA,12,3535,1819,1716,131
PUEBLA,21,SAN SEBASTIÁN TLACOTEPEC,145,AGUA AZUL,2,36,21,15,2
PUEBLA,21,SAN SEBASTIÁN TLACOTEPEC,145,BUENA VISTA DE CUAUHTÉMOC,4,173,86,87,10
PUEBLA,21,SAN SEBASTIÁN TLACOTEPEC,145,COYOMEATL,1,6,4,2,1
PUEBLA,21,SAN SEBASTIÁN TLACOTEPEC,145,CRUZTITLA,2,16,8,8,2
PUEBLA,21,SAN SEBASTIÁN TLACOTEPEC,145,CUAXUCHPA,2,90,34,56,5
PUEBLA,21,SAN SEBASTIÁN TLACOTEPEC,145,EL CARPINTERO,3,49,24,25,6
PUEBLA,21,SAN SEBASTIÁN TLACOTEPEC,145,EL MIRADOR,2,35,17,18,2
PUEBLA,21,SAN SEBASTIÁN TLACOTEPEC,145,LA CUMBRE,4,199,107,92,9
PUEBLA,21,SAN SEBASTIÁN TLACOTEPEC,145,LA GARRAPATA,2,20,12,8,2
PUEBLA,21,SAN SEBASTIÁN TLACOTEPEC,145,LA GUACAMAYA,3,45,21,24,3
PUEBLA,21,SAN SEBASTIÁN TLACOTEPEC,145,LA GUADALUPE,1,6,2,4,1
PUEBLA,21,SAN SEBASTIÁN TLACOTEPEC,145,LAS PALMAS,3,17,7,10,3
PUEBLA,21,SAN SEBASTIÁN TLACOTEPEC,145,LIBRES,3,46,28,18,4
PUEBLA,21,SAN SEBASTIÁN TLACOTEPEC,145,LOMAS DE GUADALUPE,1,17,10,7,1
PUEBLA,21,SAN SEBASTIÁN TLACOTEPEC,145,MAZATZONGO DE GUERRERO,3,158,78,80,8
PUEBLA,21,SAN SEBASTIÁN TLACOTEPEC,145,NARANJASTITLA DE VICTORIA,4,122,60,62,11
PUEBLA,21,SAN SEBASTIÁN TLACOTEPEC,145,OJO DE AGUA,3,49,26,23,3
PUEBLA,21,SAN SEBASTIÁN TLACOTEPEC,145,OVATERO Y ATEXACA,2,41,23,18,3
PUEBLA,21,SAN SEBASTIÁN TLACOTEPEC,145,PAPALOCUAUTLA,1,8,7,1,1
PUEBLA,21,SAN SEBASTIÁN TLACOTEPEC,145,PEÑA ALTA,1,13,8,5,1
PUEBLA,21,SAN SEBASTIÁN TLACOTEPEC,145,PLAYA NUEVA,2,37,20,17,3
PUEBLA,21,SAN SEBASTIÁN TLACOTEPEC,145,SAN JOSÉ PETLAPA,3,49,16,33,4
PUEBLA,21,SAN SEBASTIÁN TLACOTEPEC,145,SAN MARTÍN MAZATEOPAN,3,201,106,95,12
PUEBLA,21,SAN SEBASTIÁN TLACOTEPEC,145,TECOLOTEPEC,4,153,76,77,8
PUEBLA,21,SAN SEBASTIÁN TLACOTEPEC,145,TENTZIANTLA,3,174,80,94,10
PUEBLA,21,SAN SEBASTIÁN TLACOTEPEC,145,TEOLOLULCO,3,56,26,30,4
PUEBLA,21,SAN SEBASTIÁN TLACOTEPEC,145,TEPETLA,4,38,25,13,4
PUEBLA,21,SAN SEBASTIÁN TLACOTEPEC,145,TEPEXILOTLA,2,44,20,24,3
PUEBLA,21,SAN SEBASTIÁN TLACOTEPEC,145,TLACOTEPEC DE PORFIRIO DÍAZ,8,738,348,390,36
PUEBLA,21,SAN SEBASTIÁN TLACOTEPEC,145,TLACXITLA,4,68,37,31,5
PUEBLA,21,SAN SEBASTIÁN TLACOTEPEC,145,VILLA DEL RÍO,4,168,91,77,11
PUEBLA,21,SAN SEBASTIÁN TLACOTEPEC,145,VISTA HERMOSA,4,118,51,67,9
PUEBLA,21,SAN SEBASTIÁN TLACOTEPEC,145,XALATIOPA,2,25,12,13,2
PUEBLA,21,SAN SEBASTIÁN TLACOTEPEC,145,XONOÁTL,2,11,5,6,1
PUEBLA,21,SAN SEBASTIÁN TLACOTEPEC,145,YOVALASTOC,1,26,9,17,2
PUEBLA,21,SAN SEBASTIÁN TLACOTEPEC,145,ZACATEPEC DE BRAVO,4,110,53,57,7
PUEBLA,21,SAN SEBASTIÁN TLACOTEPEC,145,ZACATILIHUIC,3,151,75,76,7
PUEBLA,21,SANTA CATARINA TLALTEMPAN,146,SANTA CATARINA TLALTEMPAN,5,198,105,93,12
PUEBLA,21,SANTA INÉS AHUATEMPAN,147,COLONIA CRISTÓBAL COLÓN (LA COLONIA),3,13,8,5,3
PUEBLA,21,SANTA INÉS AHUATEMPAN,147,LA CONCEPCIÓN,3,92,41,51,6
PUEBLA,21,SANTA INÉS AHUATEMPAN,147,LAS MINAS,3,42,21,21,3
PUEBLA,21,SANTA INÉS AHUATEMPAN,147,LOMA PIEDRA PARADA,2,26,17,9,2
PUEBLA,21,SANTA INÉS AHUATEMPAN,147,SAN JUAN NEPOMUCENO,3,246,130,116,10
PUEBLA,21,SANTA INÉS AHUATEMPAN,147,SANTA INÉS AHUATEMPAN,7,1073,550,523,48
PUEBLA,21,SANTA INÉS AHUATEMPAN,147,SIETE LOMAS,2,16,7,9,2
PUEBLA,21,SANTA INÉS AHUATEMPAN,147,TIERRA NUEVA,3,61,36,25,4
PUEBLA,21,SANTA ISABEL CHOLULA,148,COLONIA TLAMAPA,2,34,19,15,3
PUEBLA,21,SANTA ISABEL CHOLULA,148,EL MIRADOR,1,10,3,7,1
PUEBLA,21,SANTA ISABEL CHOLULA,148,SAN MARTÍN TLAMAPA,4,482,242,240,20
PUEBLA,21,SANTA ISABEL CHOLULA,148,SAN PABLO AHUATEMPA,4,615,298,317,28
PUEBLA,21,SANTA ISABEL CHOLULA,148,SANTA ANA ACOZAUTLA,4,622,318,304,27
PUEBLA,21,SANTA ISABEL CHOLULA,148,SANTA ISABEL CHOLULA,4,574,277,297,28
PUEBLA,21,SANTIAGO MIAHUATLÁN,149,EL CARMEN,2,18,9,9,2
PUEBLA,21,SANTIAGO MIAHUATLÁN,149,LA CALAVERA,1,60,32,28,2
PUEBLA,21,SANTIAGO MIAHUATLÁN,149,SAN ISIDRO VISTA HERMOSA,4,1011,500,511,37
PUEBLA,21,SANTIAGO MIAHUATLÁN,149,SAN JOSÉ LAS MINAS,2,72,44,28,4
PUEBLA,21,SANTIAGO MIAHUATLÁN,149,SAN JOSÉ MONTE CHIQUITO,3,998,508,490,38
PUEBLA,21,SANTIAGO MIAHUATLÁN,149,SAN MIGUEL,2,119,64,55,9
PUEBLA,21,SANTIAGO MIAHUATLÁN,149,SANTA CLARA,2,530,265,265,17
PUEBLA,21,SANTIAGO MIAHUATLÁN,149,SANTIAGO MIAHUATLÁN,20,4095,2029,2066,165
PUEBLA,21,HUEHUETLÁN EL GRANDE,150,ANALCO,3,64,36,28,4
PUEBLA,21,HUEHUETLÁN EL GRANDE,150,COLONIA AGRÍCOLA HIDALGO,2,14,9,5,2
PUEBLA,21,HUEHUETLÁN EL GRANDE,150,IXTLAHUACÁN,1,17,5,12,1
PUEBLA,21,HUEHUETLÁN EL GRANDE,150,SAN AGUSTÍN AHUEHUETLA,4,269,135,134,15
PUEBLA,21,HUEHUETLÁN EL GRANDE,150,SAN ANTONIO COATEPEC (TIERRA BLANCA),2,93,50,43,4
PUEBLA,21,HUEHUETLÁN EL GRANDE,150,SAN JUAN COATETELCO,1,20,11,9,1
PUEBLA,21,HUEHUETLÁN EL GRANDE,150,SAN MARTÍN ATEMPAN,3,32,16,16,4
PUEBLA,21,HUEHUETLÁN EL GRANDE,150,SAN MIGUEL ATLAPULCO,4,430,216,214,25
PUEBLA,21,HUEHUETLÁN EL GRANDE,150,SAN NICOLÁS HUAJUAPAN,3,117,67,50,8
PUEBLA,21,HUEHUETLÁN EL GRANDE,150,SAN PEDRO AJALPAN,2,10,4,6,1
PUEBLA,21,HUEHUETLÁN EL GRANDE,150,SANTA ANA OTZOLOTEPEC,3,54,28,26,4
PUEBLA,21,HUEHUETLÁN EL GRANDE,150,SANTO DOMINGO HUEHUETLÁN,4,530,261,269,26
PUEBLA,21,SANTO TOMÁS HUEYOTLIPAN,151,SAN MIGUEL ZACAOLA,4,1289,656,633,59
PUEBLA,21,SANTO TOMÁS HUEYOTLIPAN,151,SANTO TOMÁS HUEYOTLIPAN,5,1420,706,714,50
PUEBLA,21,SANTO TOMÁS HUEYOTLIPAN,151,SANTO TOMÁS HUEYOTLIPAN (LIBERACIÓN),1,136,66,70,6
PUEBLA,21,SOLTEPEC,152,COLONIA BENITO JUÁREZ,3,149,77,72,8
PUEBLA,21,SOLTEPEC,152,DOCTOR RAFAEL SERRANO,3,22,9,13,3
PUEBLA,21,SOLTEPEC,152,LA ERMITA,3,143,79,64,8
PUEBLA,21,SOLTEPEC,152,LIBERTAD ÁLVARO OBREGÓN,4,335,182,153,12
PUEBLA,21,SOLTEPEC,152,PROGRESO,2,98,45,53,5
PUEBLA,21,SOLTEPEC,152,SAN MATEO SOLTEPEC,7,427,218,209,21
PUEBLA,21,SOLTEPEC,152,SOLTEPEC,13,1617,812,805,81
PUEBLA,21,SOLTEPEC,152,VISTA HERMOSA,4,234,113,121,14
PUEBLA,21,TECALI DE HERRERA,153,AHUATEPEC,9,1306,661,645,51
PUEBLA,21,TECALI DE HERRERA,153,AQUILES SERDÁN,2,50,25,25,4
PUEBLA,21,TECALI DE HERRERA,153,CONCEPCIÓN CUAUTLA,3,348,157,191,16
PUEBLA,21,TECALI DE HERRERA,153,LA ESPERANZA,2,37,21,16,2
PUEBLA,21,TECALI DE HERRERA,153,LA MAGDALENA CUAXIXTLA,1,32,17,15,2
PUEBLA,21,TECALI DE HERRERA,153,LA TRINIDAD TIANGUISMANALCO,3,359,172,187,15
PUEBLA,21,TECALI DE HERRERA,153,LAS LOBERAS,1,32,16,16,2
PUEBLA,21,TECALI DE HERRERA,153,SAN BUENAVENTURA TETLANANCA,1,85,54,31,3
PUEBLA,21,TECALI DE HERRERA,153,SAN LUIS AJAJALPAN,4,845,415,430,29
PUEBLA,21,TECALI DE HERRERA,153,SANTA CRUZ AJAJALPAN,4,257,121,136,15
PUEBLA,21,TECALI DE HERRERA,153,TECALI DE HERRERA,18,2731,1445,1286,106
PUEBLA,21,TECALI DE HERRERA,153,TECORRAL,2,12,5,7,2
PUEBLA,21,TECAMACHALCO,154,BARRIO DE JALACINGO (SAN MATEO SECCIÓN 23),2,401,187,214,12
PUEBLA,21,TECAMACHALCO,154,BARRIO LA PROVIDENCIA,2,384,183,201,13
PUEBLA,21,TECAMACHALCO,154,COLONIA CUAUHTÉMOC,2,60,36,24,3
PUEBLA,21,TECAMACHALCO,154,EL SALADO,3,128,59,69,18
PUEBLA,21,TECAMACHALCO,154,EL TEPEYAC,1,27,12,15,1
PUEBLA,21,TECAMACHALCO,154,FRANCISCO VILLA,2,246,121,125,9
PUEBLA,21,TECAMACHALCO,154,JOSÉ MARÍA PINO SUÁREZ,2,76,33,43,4
PUEBLA,21,TECAMACHALCO,154,LA LAGUNA,3,353,168,185,12
PUEBLA,21,TECAMACHALCO,154,LA PURÍSIMA DE HIDALGO,5,815,414,401,33
PUEBLA,21,TECAMACHALCO,154,LA SOLEDAD,2,236,129,107,9
PUEBLA,21,TECAMACHALCO,154,LA VILLITA (KILÓMETRO 59),3,377,177,200,15
PUEBLA,21,TECAMACHALCO,154,LOMAS DE ROMERO,3,294,139,155,13
PUEBLA,21,TECAMACHALCO,154,LOMAS DE SANTA CRUZ,1,36,9,27,2
PUEBLA,21,TECAMACHALCO,154,RANCHERÍA LOS SILVAS,2,15,10,5,2
PUEBLA,21,TECAMACHALCO,154,RUBÉN JARAMILLO,2,206,96,110,10
PUEBLA,21,TECAMACHALCO,154,SAN ANTONIO LA PORTILLA,4,696,346,350,24
PUEBLA,21,TECAMACHALCO,154,SAN ANTONIO TECOLCO,4,563,282,281,21
PUEBLA,21,TECAMACHALCO,154,SAN BALTAZAR,2,167,82,85,8
PUEBLA,21,TECAMACHALCO,154,SAN JOSÉ LA PORTILLA,2,86,45,41,5
PUEBLA,21,TECAMACHALCO,154,SAN MATEO TLAIXPAN,9,3402,1773,1629,126
PUEBLA,21,TECAMACHALCO,154,SAN SEBASTIÁN,1,130,66,64,7
PUEBLA,21,TECAMACHALCO,154,SANTA ROSA,4,965,470,495,39
PUEBLA,21,TECAMACHALCO,154,SANTIAGO ALSESECA,8,2301,1172,1129,80
PUEBLA,21,TECAMACHALCO,154,TECAMACHALCO,53,17614,9192,8422,905
PUEBLA,21,TECAMACHALCO,154,VERACRUCITO,2,133,68,65,5
PUEBLA,21,TECAMACHALCO,154,XOCHIMILCO,3,551,260,291,22
PUEBLA,21,TECOMATLÁN,155,EL TEMPEXQUIXTLE,1,3,1,2,1
PUEBLA,21,TECOMATLÁN,155,INDEPENDENCIA,1,7,5,2,1
PUEBLA,21,TECOMATLÁN,155,LA PAZ (COLONIA LA PAZ),2,10,5,5,1
PUEBLA,21,TECOMATLÁN,155,LA UNIÓN,4,124,58,66,6
PUEBLA,21,TECOMATLÁN,155,MIXQUIAPAN,3,56,22,34,4
PUEBLA,21,TECOMATLÁN,155,OLOMATLÁN,5,287,146,141,10
PUEBLA,21,TECOMATLÁN,155,QUICAYÁN,3,73,39,34,3
PUEBLA,21,TECOMATLÁN,155,SAN MIGUEL DE LOZANO,3,102,43,59,6
PUEBLA,21,TECOMATLÁN,155,TECOMATLÁN,9,2030,1014,1016,108
PUEBLA,21,TECOMATLÁN,155,TEZOQUIPAN,2,23,11,12,2
PUEBLA,21,TECOMATLÁN,155,XANTOXTLA,2,8,7,1,1
PUEBLA,21,TEHUACÁN,156,AGUA LEÓN,1,9,4,5,1
PUEBLA,21,TEHUACÁN,156,CAÑADA GUAJILLO,2,9,5,4,1
PUEBLA,21,TEHUACÁN,156,COLONIA 18 DE MARZO,1,17,10,7,1
PUEBLA,21,TEHUACÁN,156,COLONIA DEL CARMEN SUR,1,54,26,28,3
PUEBLA,21,TEHUACÁN,156,COLONIA GUADALUPE,2,189,103,86,9
PUEBLA,21,TEHUACÁN,156,CRISTO REY,1,32,21,11,2
PUEBLA,21,TEHUACÁN,156,CUCHANIJE [RANCHO],2,13,8,5,2
PUEBLA,21,TEHUACÁN,156,EL ENCINAL,2,47,22,25,3
PUEBLA,21,TEHUACÁN,156,EL PROGRESO,2,47,26,21,3
PUEBLA,21,TEHUACÁN,156,EL RIEGO,3,68,25,43,3
PUEBLA,21,TEHUACÁN,156,FUERTES DE LORETO,1,39,17,22,3
PUEBLA,21,TEHUACÁN,156,LA ASUNCIÓN,2,12,6,6,1
PUEBLA,21,TEHUACÁN,156,LOS PINOS (LOS LIMONES),3,1764,905,859,85
PUEBLA,21,TEHUACÁN,156,MAGDALENA CUAYUCATEPEC,15,2513,1242,1271,108
PUEBLA,21,TEHUACÁN,156,PLAN DE FIERRO,1,13,3,10,1
PUEBLA,21,TEHUACÁN,156,RANCHO CABRAS (SAN SALVADOR OTZOLOTEPEC),2,69,31,38,4
PUEBLA,21,TEHUACÁN,156,RESURRECCIÓN (MESETA EL RIEGO),2,25,12,13,3
PUEBLA,21,TEHUACÁN,156,SAN CRISTÓBAL TEPETEOPAN,7,600,287,313,26
PUEBLA,21,TEHUACÁN,156,SAN DIEGO CHALMA,2,222,114,108,8
PUEBLA,21,TEHUACÁN,156,SAN ISIDRO,1,12,5,7,1
PUEBLA,21,TEHUACÁN,156,SAN MARCOS NECOXTLA,5,826,420,406,48
PUEBLA,21,TEHUACÁN,156,SAN MIGUEL,4,873,418,455,34
PUEBLA,21,TEHUACÁN,156,SAN PABLO TEPETZINGO,7,3616,1741,1875,177
PUEBLA,21,TEHUACÁN,156,SANTA ANA TELOXTOC,5,682,342,340,27
PUEBLA,21,TEHUACÁN,156,SANTA CATARINA OTZOLOTEPEC,6,280,137,143,16
PUEBLA,21,TEHUACÁN,156,SANTA CRUZ ACAPA,4,731,347,384,29
PUEBLA,21,TEHUACÁN,156,SANTA MARÍA COAPAN,8,3111,1767,1344,98
PUEBLA,21,TEHUACÁN,156,TEHUACÁN,357,83693,43912,39781,4780
PUEBLA,21,TEHUITZINGO,157,ATOPOLTITLÁN (SANTA CRUZ ATOPOLTITLÁN),4,142,71,71,10
PUEBLA,21,TEHUITZINGO,157,AZUCHITLÁN,2,7,6,1,1
PUEBLA,21,TEHUITZINGO,157,BOQUERONCITO (SANTA CRUZ),2,39,22,17,3
PUEBLA,21,TEHUITZINGO,157,CUAULUTLA,2,46,24,22,3
PUEBLA,21,TEHUITZINGO,157,GUADALUPE ALLENDE (EL PITAYO),3,48,19,29,4
PUEBLA,21,TEHUITZINGO,157,LA NORIA HIDALGO,2,123,62,61,5
PUEBLA,21,TEHUITZINGO,157,LOS HORNOS DE ZARAGOZA,3,106,54,52,7
PUEBLA,21,TEHUITZINGO,157,PUENTE MARQUÉS,1,6,4,2,1
PUEBLA,21,TEHUITZINGO,157,SAN FRANCISCO DE ASÍS,4,207,114,93,12
PUEBLA,21,TEHUITZINGO,157,SAN JOSÉ (LAS CALAVERAS),4,53,21,32,6
PUEBLA,21,TEHUITZINGO,157,SAN JOSÉ HIDALGO (TEHUIXTLE),3,22,6,16,3
PUEBLA,21,TEHUITZINGO,157,SAN JUAN DE DIOS,1,4,2,2,1
PUEBLA,21,TEHUITZINGO,157,SAN PEDRO LA JUNTA,3,23,6,17,3
PUEBLA,21,TEHUITZINGO,157,SAN VICENTE FERRER,2,31,18,13,2
PUEBLA,21,TEHUITZINGO,157,SANTA CRUZ TEJALPA,2,60,34,26,6
PUEBLA,21,TEHUITZINGO,157,TECOLUTLA,3,73,36,37,4
PUEBLA,21,TEHUITZINGO,157,TEHUITZINGO,21,2038,1013,1025,117
PUEBLA,21,TEHUITZINGO,157,TEHUITZINGO TERCERA SECCIÓN (HUAMUCHILERA),1,34,16,18,2
PUEBLA,21,TEHUITZINGO,157,TEXCALAPA,2,10,5,5,1
PUEBLA,21,TEHUITZINGO,157,TLACHINOLA,3,21,9,12,3
PUEBLA,21,TEHUITZINGO,157,TUZANTLÁN (MARIANO ESCOBEDO),2,36,17,19,2
PUEBLA,21,TENAMPULCO,158,ARROYO BLANCO,2,17,9,8,2
PUEBLA,21,TENAMPULCO,158,ARROYO ZARCO,1,12,7,5,1
PUEBLA,21,TENAMPULCO,158,COLONIA MORELOS,2,16,7,9,4
PUEBLA,21,TENAMPULCO,158,EL CHACAL,4,242,108,134,16
PUEBLA,21,TENAMPULCO,158,EL JICARILLO,2,10,6,4,2
PUEBLA,21,TENAMPULCO,158,EL ZAPOTAL,1,13,5,8,1
PUEBLA,21,TENAMPULCO,158,EL ZAPOTE,1,12,5,7,1
PUEBLA,21,TENAMPULCO,158,LA FLORIDA,2,36,18,18,2
PUEBLA,21,TENAMPULCO,158,LA LIMA,2,171,82,89,8
PUEBLA,21,TENAMPULCO,158,LA NUEVA JUNTA ARROYO ZARCO,1,16,9,7,2
PUEBLA,21,TENAMPULCO,158,LÁZARO CÁRDENAS (SAN DIEGO),3,95,50,45,5
PUEBLA,21,TENAMPULCO,158,PASO DEL PALMAR,3,37,19,18,3
PUEBLA,21,TENAMPULCO,158,POZA VERDE,2,28,15,13,2
PUEBLA,21,TENAMPULCO,158,SALSIPUEDES (CERRO DE LA CAMPANA),1,12,5,7,1
PUEBLA,21,TENAMPULCO,158,SANTA LUCÍA,4,116,70,46,10
PUEBLA,21,TENAMPULCO,158,TENAMPULCO,5,459,241,218,32
PUEBLA,21,TENAMPULCO,158,TENAMPULCO VIEJO,3,74,37,37,6
PUEBLA,21,TENAMPULCO,158,TENEXAPA DE ALLENDE,2,23,6,17,2
PUEBLA,21,TEOPANTLÁN,159,SAN FRANCISCO JALAPEXCO,4,180,101,79,12
PUEBLA,21,TEOPANTLÁN,159,SAN SEBASTIÁN TENANGO,3,25,9,16,2
PUEBLA,21,TEOPANTLÁN,159,TEOPANTLÁN,6,509,245,264,23
PUEBLA,21,TEOTLALCO,160,ACHICHIPICO,3,28,11,17,3
PUEBLA,21,TEOTLALCO,160,CONTLA,2,13,7,6,2
PUEBLA,21,TEOTLALCO,160,LAS MARAVILLAS,2,14,8,6,2
PUEBLA,21,TEOTLALCO,160,SAN MIGUEL,3,193,92,101,11
PUEBLA,21,TEOTLALCO,160,SANTA CRUZ,4,250,119,131,12
PUEBLA,21,TEOTLALCO,160,TEOTLALCO,5,522,260,262,26
PUEBLA,21,TEOTLALCO,160,TLAUCINGO,3,62,29,33,5
PUEBLA,21,TEOTLALCO,160,TLAYEHUALCO,2,16,8,8,2
PUEBLA,21,TEPANCO DE LÓPEZ,161,BARRIO TERCERO (JAGÜEY BLANCO),2,25,9,16,2
PUEBLA,21,TEPANCO DE LÓPEZ,161,CINCO DE MAYO (BARRIO CUARTO),1,5,2,3,1
PUEBLA,21,TEPANCO DE LÓPEZ,161,FRANCISCO I. MADERO,5,711,346,365,24
PUEBLA,21,TEPANCO DE LÓPEZ,161,JOSÉ MARÍA PINO SUÁREZ,4,883,463,420,32
PUEBLA,21,TEPANCO DE LÓPEZ,161,SAN ANDRÉS CACALOAPAN,4,760,384,376,28
PUEBLA,21,TEPANCO DE LÓPEZ,161,SAN BARTOLO TEONTEPEC,9,1677,855,822,63
PUEBLA,21,TEPANCO DE LÓPEZ,161,SAN LUIS TEMALACAYUCA,5,588,313,275,25
PUEBLA,21,TEPANCO DE LÓPEZ,161,SANTA CRUZ,2,275,124,151,9
PUEBLA,21,TEPANCO DE LÓPEZ,161,TEPANCO DE LÓPEZ,4,1072,538,534,50
PUEBLA,21,TEPANGO DE RODRÍGUEZ,162,CALTUCHOCO (LAS LÁMINAS),4,118,50,68,7
PUEBLA,21,TEPANGO DE RODRÍGUEZ,162,TEPANGO DE RODRÍGUEZ,9,1071,543,528,46
PUEBLA,21,TEPATLAXCO DE HIDALGO,163,TEPATLAXCO DE HIDALGO,14,4423,2227,2196,183
PUEBLA,21,TEPEACA,164,ÁLVARO OBREGÓN (SANTA MARÍA GOROZPE),3,608,320,288,21
PUEBLA,21,TEPEACA,164,GUADALUPE CALDERÓN,3,289,135,154,11
PUEBLA,21,TEPEACA,164,LOS CARREONES,2,25,12,13,3
PUEBLA,21,TEPEACA,164,LOS REYES DE OCAMPO,2,115,53,62,5
PUEBLA,21,TEPEACA,164,SAN BARTOLOMÉ HUEYAPAN,4,692,346,346,33
PUEBLA,21,TEPEACA,164,SAN CRISTÓBAL HIDALGO,4,479,220,259,20
PUEBLA,21,TEPEACA,164,SAN CRISTÓBAL LOS NAVA,3,350,176,174,14
PUEBLA,21,TEPEACA,164,SAN FELIPE TENEXTEPEC,3,254,111,143,11
PUEBLA,21,TEPEACA,164,SAN FRANCISCO BUENAVISTA,2,144,74,70,5
PUEBLA,21,TEPEACA,164,SAN HIPÓLITO XOCHILTENANGO,12,2754,1422,1332,109
PUEBLA,21,TEPEACA,164,SAN JOSÉ CARPINTEROS,4,415,189,226,17
PUEBLA,21,TEPEACA,164,SAN LORENZO JOYA DE RODRÍGUEZ,4,615,313,302,26
PUEBLA,21,TEPEACA,164,SAN MATEO PARRA,2,429,222,207,18
PUEBLA,21,TEPEACA,164,SAN MIGUEL,1,214,105,109,6
PUEBLA,21,TEPEACA,164,SAN NICOLÁS ZOYAPETLAYOCA,3,814,391,423,28
PUEBLA,21,TEPEACA,164,SAN PABLO ACTIPAN,6,1025,502,523,42
PUEBLA,21,TEPEACA,164,SAN PEDRO LA JOYA,4,515,273,242,23
PUEBLA,21,TEPEACA,164,SANTA MARÍA OXTOTIPAN,1,79,39,40,3
PUEBLA,21,TEPEACA,164,SANTIAGO ACATLÁN,12,2645,1296,1349,104
PUEBLA,21,TEPEACA,164,TEPEACA,59,16249,8561,7688,806
PUEBLA,21,TEPEACA,164,TLAYOATLA JOYA DE RODRÍGUEZ,5,299,141,158,15
PUEBLA,21,TEPEACA,164,VICENTE GUERRERO,3,226,113,113,11
PUEBLA,21,TEPEACA,164,ZAHUATLÁN DE MORELOS (SAN JOSÉ),3,597,304,293,19
PUEBLA,21,TEPEMAXALCO,165,SAN FELIPE TEPEMAXALCO,4,234,122,112,14
PUEBLA,21,TEPEMAXALCO,165,SAN MIGUEL XICOTZINGO,3,108,52,56,7
PUEBLA,21,TEPEOJUMA,166,EL PEDREGAL,1,6,4,2,1
PUEBLA,21,TEPEOJUMA,166,EL RODEO (SANTA MARÍA EL RODEO),2,74,39,35,3
PUEBLA,21,TEPEOJUMA,166,LA MAGDALENA,2,58,28,30,3
PUEBLA,21,TEPEOJUMA,166,SAN AGUSTÍN LAS PETACAS,2,53,31,22,2
PUEBLA,21,TEPEOJUMA,166,SAN FRANCISCO EL ASTILLERO,3,41,18,23,3
PUEBLA,21,TEPEOJUMA,166,SAN PEDRO TEYUCA,3,210,102,108,11
PUEBLA,21,TEPEOJUMA,166,TEPEOJUMA,10,1404,723,681,64
PUEBLA,21,TEPEOJUMA,166,XOYATLA,3,132,67,65,6
PUEBLA,21,TEPETZINTLA,167,CHACHAYOQUILA,3,43,28,15,4
PUEBLA,21,TEPETZINTLA,167,CHICOMETEPEC (SAN SIMÓN),4,261,134,127,14
PUEBLA,21,TEPETZINTLA,167,EJIDO EL MILAGRO,2,44,23,21,3
PUEBLA,21,TEPETZINTLA,167,KOAKO,3,104,45,59,6
PUEBLA,21,TEPETZINTLA,167,OMITLÁN,3,61,24,37,5
PUEBLA,21,TEPETZINTLA,167,TECPA,3,26,9,17,3
PUEBLA,21,TEPETZINTLA,167,TEMPEXTLA,3,61,37,24,4
PUEBLA,21,TEPETZINTLA,167,TENANTITLA,4,293,134,159,13
PUEBLA,21,TEPETZINTLA,167,TEPETZINTLA,5,383,170,213,18
PUEBLA,21,TEPETZINTLA,167,TLAMANCA DE HERNÁNDEZ,7,567,275,292,26
PUEBLA,21,TEPETZINTLA,167,TLAQUIMPA,4,168,94,74,11
PUEBLA,21,TEPETZINTLA,167,TONALIXCO,4,413,205,208,24
PUEBLA,21,TEPETZINTLA,167,XICALAHUATLA,2,88,49,39,5
PUEBLA,21,TEPETZINTLA,167,XOCHITLAXCO (SAN BALTAZAR),5,428,207,221,22
PUEBLA,21,TEPEXCO,168,CALMECA (SAN JUAN CALMECA),7,1426,722,704,61
PUEBLA,21,TEPEXCO,168,MICHAPA,2,16,8,8,2
PUEBLA,21,TEPEXCO,168,TEPEXCO,5,339,176,163,20
PUEBLA,21,TEPEXI DE RODRÍGUEZ,169,AGUA DE LA LUNA,2,33,16,17,2
PUEBLA,21,TEPEXI DE RODRÍGUEZ,169,AGUA SANTA ANA,4,182,81,101,10
PUEBLA,21,TEPEXI DE RODRÍGUEZ,169,ALMOLONGA (TODOS SANTOS),5,338,166,172,19
PUEBLA,21,TEPEXI DE RODRÍGUEZ,169,AXAMILPA,2,13,8,5,3
PUEBLA,21,TEPEXI DE RODRÍGUEZ,169,CAÑADA COYOTE,2,35,21,14,2
PUEBLA,21,TEPEXI DE RODRÍGUEZ,169,CAÑADA XÓCHITL (SECCIÓN PRIMERA),3,27,11,16,3
PUEBLA,21,TEPEXI DE RODRÍGUEZ,169,CHAPULTEPEC (SANTO DOMINGO),3,143,83,60,7
PUEBLA,21,TEPEXI DE RODRÍGUEZ,169,COLONIA MORELOS (PIE DE VACA),1,66,31,35,3
PUEBLA,21,TEPEXI DE RODRÍGUEZ,169,EL PROGRESO (SAN ANTONIO),4,321,162,159,14
PUEBLA,21,TEPEXI DE RODRÍGUEZ,169,HUAJOYUCA (HUAJOYUCA DE PALACIOS),4,212,99,113,11
PUEBLA,21,TEPEXI DE RODRÍGUEZ,169,HUEJONAPAN (SAN ANTONIO),4,301,170,131,15
PUEBLA,21,TEPEXI DE RODRÍGUEZ,169,LAS FLORES,4,153,73,80,9
PUEBLA,21,TEPEXI DE RODRÍGUEZ,169,LAS YEGUAS (SAN ISIDRO),2,50,25,25,3
PUEBLA,21,TEPEXI DE RODRÍGUEZ,169,LOMA CAJÓN,2,55,26,29,3
PUEBLA,21,TEPEXI DE RODRÍGUEZ,169,LOMA SAN FRANCISCO,8,129,58,71,10
PUEBLA,21,TEPEXI DE RODRÍGUEZ,169,MARISCALA,3,109,53,56,7
PUEBLA,21,TEPEXI DE RODRÍGUEZ,169,MONTÓN DE ARENA,1,3,1,2,1
PUEBLA,21,TEPEXI DE RODRÍGUEZ,169,MORALILLO,3,201,94,107,10
PUEBLA,21,TEPEXI DE RODRÍGUEZ,169,RANCHO ALEGRE,2,12,7,5,2
PUEBLA,21,TEPEXI DE RODRÍGUEZ,169,SAN FELIPE OTLALTEPEC,4,377,194,183,17
PUEBLA,21,TEPEXI DE RODRÍGUEZ,169,SAN MIGUEL IPALTEPEC,2,27,16,11,2
PUEBLA,21,TEPEXI DE RODRÍGUEZ,169,SAN PABLO AMEYALTEPEC,2,28,17,11,2
PUEBLA,21,TEPEXI DE RODRÍGUEZ,169,TEPEXI DE RODRÍGUEZ,24,3170,1595,1575,177
PUEBLA,21,TEPEXI DE RODRÍGUEZ,169,TULA,4,351,146,205,14
PUEBLA,21,TEPEXI DE RODRÍGUEZ,169,ZACATEPEC,1,13,7,6,1
PUEBLA,21,TEPEYAHUALCO,170,CHICHICUAUTLA,4,570,305,265,23
PUEBLA,21,TEPEYAHUALCO,170,EL FUERTE DE LA UNIÓN,4,598,303,295,22
PUEBLA,21,TEPEYAHUALCO,170,GUADALUPE SARABIA,3,472,223,249,18
PUEBLA,21,TEPEYAHUALCO,170,ITZOTENO (SAN MIGUEL),4,362,199,163,15
PUEBLA,21,TEPEYAHUALCO,170,JALAPASCO DE BARRIENTOS,3,329,174,155,11
PUEBLA,21,TEPEYAHUALCO,170,JUAN SARABIA PIZARRO (SAN NICOLÁS),2,89,48,41,4
PUEBLA,21,TEPEYAHUALCO,170,MANCUERNAS (EL TRIUNFO),2,53,22,31,4
PUEBLA,21,TEPEYAHUALCO,170,SAN JOSÉ ALCHICHICA,4,893,466,427,28
PUEBLA,21,TEPEYAHUALCO,170,TECHACHALCO,3,185,98,87,11
PUEBLA,21,TEPEYAHUALCO,170,TEPEYAHUALCO,4,747,380,367,33
PUEBLA,21,TEPEYAHUALCO,170,TETIPANAPA,3,197,98,99,9
PUEBLA,21,TEPEYAHUALCO,170,TEZONTEPEC,2,72,36,36,4
PUEBLA,21,TEPEYAHUALCO,170,XALTIPANAPA,4,231,124,107,11
PUEBLA,21,TEPEYAHUALCO DE CUAUHTÉMOC,171,HUACALTZINGO,4,209,101,108,9
PUEBLA,21,TEPEYAHUALCO DE CUAUHTÉMOC,171,TEPEYAHUALCO DE CUAUHTÉMOC,4,771,401,370,28
PUEBLA,21,TETELA DE OCAMPO,172,ACATLÁN,2,29,12,17,2
PUEBLA,21,TETELA DE OCAMPO,172,ATEHUACPA,1,7,4,3,1
PUEBLA,21,TETELA DE OCAMPO,172,ATENTI ORIENTE,3,95,48,47,6
PUEBLA,21,TETELA DE OCAMPO,172,ATENTI PONIENTE (ATENTI ARRIBA),1,16,9,7,1
PUEBLA,21,TETELA DE OCAMPO,172,BENITO JUÁREZ,3,394,247,147,26
PUEBLA,21,TETELA DE OCAMPO,172,BUENA VISTA,1,21,13,8,1
PUEBLA,21,TETELA DE OCAMPO,172,BUENAVISTA SOLEDAD,3,15,8,7,3
PUEBLA,21,TETELA DE OCAMPO,172,CAPULUAQUE,4,144,69,75,10
PUEBLA,21,TETELA DE OCAMPO,172,CARRERAGCO,3,85,45,40,7
PUEBLA,21,TETELA DE OCAMPO,172,CHALAHUICO,2,23,11,12,2
PUEBLA,21,TETELA DE OCAMPO,172,CIUDAD DE TETELA DE OCAMPO,16,3153,1659,1494,141
PUEBLA,21,TETELA DE OCAMPO,172,CUAPANCINGO,3,237,127,110,11
PUEBLA,21,TETELA DE OCAMPO,172,CUAUTACOMULCO,2,9,7,2,2
PUEBLA,21,TETELA DE OCAMPO,172,CUXATENO,2,52,29,23,3
PUEBLA,21,TETELA DE OCAMPO,172,EL PUERTO,1,5,2,3,1
PUEBLA,21,TETELA DE OCAMPO,172,ELOXOXTLA,1,5,2,3,1
PUEBLA,21,TETELA DE OCAMPO,172,GARCIAXCO,2,6,2,4,1
PUEBLA,21,TETELA DE OCAMPO,172,GUADALUPE BUENA VISTA,1,13,5,8,1
PUEBLA,21,TETELA DE OCAMPO,172,JALACINGO,2,32,19,13,2
PUEBLA,21,TETELA DE OCAMPO,172,JOSÉ MARÍA MORELOS,2,16,10,6,2
PUEBLA,21,TETELA DE OCAMPO,172,LA CAÑADA,3,64,31,33,6
PUEBLA,21,TETELA DE OCAMPO,172,LA LAGUNILLA,4,96,42,54,7
PUEBLA,21,TETELA DE OCAMPO,172,LA SOLEDAD,2,66,31,35,4
PUEBLA,21,TETELA DE OCAMPO,172,LAS CHAPAS,2,13,5,8,2
PUEBLA,21,TETELA DE OCAMPO,172,LOMA BONITA,2,14,9,5,2
PUEBLA,21,TETELA DE OCAMPO,172,LOS PATIOS,2,29,13,16,3
PUEBLA,21,TETELA DE OCAMPO,172,MUYUAPAN,3,41,19,22,4
PUEBLA,21,TETELA DE OCAMPO,172,NANAHUACINGO,2,28,9,19,2
PUEBLA,21,TETELA DE OCAMPO,172,OCOYOHUALULCO,3,48,27,21,4
PUEBLA,21,TETELA DE OCAMPO,172,OMETÉPETL,5,425,215,210,20
PUEBLA,21,TETELA DE OCAMPO,172,OROCTIPAN,1,10,4,6,1
PUEBLA,21,TETELA DE OCAMPO,172,RANCHO VIEJO,2,19,6,13,2
PUEBLA,21,TETELA DE OCAMPO,172,SAN JOSÉ,3,99,43,56,5
PUEBLA,21,TETELA DE OCAMPO,172,SAN NICOLÁS (CUARTA SECCIÓN),4,359,166,193,16
PUEBLA,21,TETELA DE OCAMPO,172,SAN NICOLÁS (TERCERA SECCIÓN),2,437,225,212,14
PUEBLA,21,TETELA DE OCAMPO,172,TALCOZAMÁN,1,4,1,3,1
PUEBLA,21,TETELA DE OCAMPO,172,TALICAN,1,13,5,8,1
PUEBLA,21,TETELA DE OCAMPO,172,TAXCANTLA,3,27,9,18,2
PUEBLA,21,TETELA DE OCAMPO,172,TAXCO,4,138,73,65,8
PUEBLA,21,TETELA DE OCAMPO,172,TECUANTA,2,13,6,7,3
PUEBLA,21,TETELA DE OCAMPO,172,TECUICUILCO,2,18,8,10,2
PUEBLA,21,TETELA DE OCAMPO,172,TETELCO,2,44,17,27,3
PUEBLA,21,TETELA DE OCAMPO,172,TONALAPA,4,536,289,247,25
PUEBLA,21,TETELA DE OCAMPO,172,TOTOTZINAPAN,4,137,72,65,11
PUEBLA,21,TETELA DE OCAMPO,172,XALTATEMPA DE LUCAS,4,195,93,102,11
PUEBLA,21,TETELA DE OCAMPO,172,XILITETITLA,3,61,30,31,5
PUEBLA,21,TETELA DE OCAMPO,172,XOCHITITÁN,2,27,12,15,2
PUEBLA,21,TETELA DE OCAMPO,172,XONOCUAUTLA,1,16,9,7,1
PUEBLA,21,TETELA DE OCAMPO,172,ZACALOMA,3,36,19,17,3
PUEBLA,21,TETELA DE OCAMPO,172,ZITLALCUAUTLA,3,77,32,45,6
PUEBLA,21,TETELA DE OCAMPO,172,ZONTECOMAPAN,3,86,42,44,6
PUEBLA,21,TETELA DE OCAMPO,172,ZOYATITLA,3,165,77,88,7
PUEBLA,21,TETELES DE ÁVILA CASTILLO,173,COACALCO,3,130,63,67,7
PUEBLA,21,TETELES DE ÁVILA CASTILLO,173,TETELES DE ÁVILA CASTILLO,9,1958,1167,791,106
PUEBLA,21,TETELES DE ÁVILA CASTILLO,173,TEXCALACO,2,44,18,26,3
PUEBLA,21,TEZIUTLÁN,174,AHUATA,2,20,14,6,2
PUEBLA,21,TEZIUTLÁN,174,AIRE LIBRE (LA MINA),4,2741,1102,1639,128
PUEBLA,21,TEZIUTLÁN,174,ATOLUCA,7,985,528,457,42
PUEBLA,21,TEZIUTLÁN,174,COYOPOL,4,117,62,55,8
PUEBLA,21,TEZIUTLÁN,174,CUAXOXPAN,2,30,18,12,3
PUEBLA,21,TEZIUTLÁN,174,HUEHUEYMICO,3,168,81,87,11
PUEBLA,21,TEZIUTLÁN,174,IXTAHUIATA (LA LEGUA),3,164,76,88,11
PUEBLA,21,TEZIUTLÁN,174,IXTICPAN,5,438,225,213,25
PUEBLA,21,TEZIUTLÁN,174,IXTLAHUACA,2,169,81,88,8
PUEBLA,21,TEZIUTLÁN,174,LA CANTERA (TEHUATLÁN),2,7,3,4,1
PUEBLA,21,TEZIUTLÁN,174,LOMA BONITA,2,85,37,48,4
PUEBLA,21,TEZIUTLÁN,174,LOMAS DE AYOTZINGO,1,41,16,25,2
PUEBLA,21,TEZIUTLÁN,174,MAXTACO,1,65,26,39,3
PUEBLA,21,TEZIUTLÁN,174,MEXCALCUAUTLA,4,584,284,300,22
PUEBLA,21,TEZIUTLÁN,174,SAN DIEGO,6,679,330,349,50
PUEBLA,21,TEZIUTLÁN,174,SAN JUAN ACATENO,8,1447,673,774,65
PUEBLA,21,TEZIUTLÁN,174,SAN JUAN TEZONGO,2,118,62,56,6
PUEBLA,21,TEZIUTLÁN,174,SAN MIGUEL CAPULINES,2,56,27,29,3
PUEBLA,21,TEZIUTLÁN,174,SAN SEBASTIÁN,6,1261,633,628,47
PUEBLA,21,TEZIUTLÁN,174,SAN SEBASTIÁN (SECCIÓN TERCERA),3,382,189,193,14
PUEBLA,21,TEZIUTLÁN,174,SECCIÓN 23,2,141,71,70,6
PUEBLA,21,TEZIUTLÁN,174,TEMECATA,2,3,1,2,2
PUEBLA,21,TEZIUTLÁN,174,TEZIUTLÁN,127,30660,17431,13229,1775
PUEBLA,21,TEZIUTLÁN,174,XOLOATENO,4,632,285,347,29
PUEBLA,21,TIANGUISMANALCO,175,SAN BALTAZAR ATLIMEYAYA,3,168,82,86,13
PUEBLA,21,TIANGUISMANALCO,175,SAN FRANCISCO BUENAVISTA,3,133,58,75,8
PUEBLA,21,TIANGUISMANALCO,175,SAN ISIDRO TLACXITLA,1,10,5,5,1
PUEBLA,21,TIANGUISMANALCO,175,SAN MARTÍN TLAPALA,4,302,159,143,12
PUEBLA,21,TIANGUISMANALCO,175,SAN PEDRO ATLIXCO,4,352,178,174,13
PUEBLA,21,TIANGUISMANALCO,175,SANTO DOMINGO TENANTITLA,2,18,8,10,3
PUEBLA,21,TIANGUISMANALCO,175,TIANGUISMANALCO,8,1294,694,600,63
PUEBLA,21,TILAPA,176,AGUA DULCE,3,218,113,105,11
PUEBLA,21,TILAPA,176,CASA BLANCA (CUYOTLIAPA),3,221,104,117,11
PUEBLA,21,TILAPA,176,CUEXPALA (SAN BARTOLO CUEXPALA),4,311,154,157,17
PUEBLA,21,TILAPA,176,DERRAMADERO,3,68,33,35,4
PUEBLA,21,TILAPA,176,EMILIANO ZAPATA,1,33,17,16,2
PUEBLA,21,TILAPA,176,SAN FÉLIX RIJO,3,260,129,131,13
PUEBLA,21,TILAPA,176,TILAPA,6,662,326,336,32
PUEBLA,21,TILAPA,176,ZOLONQUIAPA,4,208,95,113,14
PUEBLA,21,TLACOTEPEC DE BENITO JUÁREZ,177,DE ROJAS,2,60,18,42,4
PUEBLA,21,TLACOTEPEC DE BENITO JUÁREZ,177,EL GAVILÁN,1,15,4,11,1
PUEBLA,21,TLACOTEPEC DE BENITO JUÁREZ,177,EL MIRADOR,1,14,9,5,1
PUEBLA,21,TLACOTEPEC DE BENITO JUÁREZ,177,GUADALUPE VICTORIA,4,310,142,168,12
PUEBLA,21,TLACOTEPEC DE BENITO JUÁREZ,177,IGNACIO ZARAGOZA,2,111,51,60,5
PUEBLA,21,TLACOTEPEC DE BENITO JUÁREZ,177,JOSÉ HUERTA (SECCIÓN 17) [COLONIA],1,17,9,8,1
PUEBLA,21,TLACOTEPEC DE BENITO JUÁREZ,177,LA TEPETATERA,2,49,17,32,5
PUEBLA,21,TLACOTEPEC DE BENITO JUÁREZ,177,LA VIRGEN,3,26,10,16,3
PUEBLA,21,TLACOTEPEC DE BENITO JUÁREZ,177,LOS MARÍAS,3,148,81,67,8
PUEBLA,21,TLACOTEPEC DE BENITO JUÁREZ,177,PALMILLAS (LA COLUMNA),3,160,83,77,7
PUEBLA,21,TLACOTEPEC DE BENITO JUÁREZ,177,PALO VERDE,2,32,12,20,2
PUEBLA,21,TLACOTEPEC DE BENITO JUÁREZ,177,PAZOLTEPEC,3,223,103,120,11
PUEBLA,21,TLACOTEPEC DE BENITO JUÁREZ,177,PERICOTEPEC,5,248,115,133,13
PUEBLA,21,TLACOTEPEC DE BENITO JUÁREZ,177,PIEDRA HINCADA DE LA SOLEDAD,3,115,54,61,7
PUEBLA,21,TLACOTEPEC DE BENITO JUÁREZ,177,RINCÓN DE SOMPANTLE,3,23,10,13,3
PUEBLA,21,TLACOTEPEC DE BENITO JUÁREZ,177,SAN ANTONIO TLACUITLAPAN,2,7,2,5,1
PUEBLA,21,TLACOTEPEC DE BENITO JUÁREZ,177,SAN FRANCISCO ESPERILLA,2,89,45,44,4
PUEBLA,21,TLACOTEPEC DE BENITO JUÁREZ,177,SAN JOSÉ BUENAVISTA,3,531,274,257,21
PUEBLA,21,TLACOTEPEC DE BENITO JUÁREZ,177,SAN JOSÉ TLACUITLAPAN,5,156,74,82,8
PUEBLA,21,TLACOTEPEC DE BENITO JUÁREZ,177,SAN JOSÉ VALSEQUILLO SECCIÓN TERCERA,1,78,34,44,3
PUEBLA,21,TLACOTEPEC DE BENITO JUÁREZ,177,SAN JUAN ZACABASCO,2,121,54,67,5
PUEBLA,21,TLACOTEPEC DE BENITO JUÁREZ,177,SAN LUCAS EL VIEJO,4,400,202,198,20
PUEBLA,21,TLACOTEPEC DE BENITO JUÁREZ,177,SAN MARCOS TLACOYALCO,14,3199,1589,1610,130
PUEBLA,21,TLACOTEPEC DE BENITO JUÁREZ,177,SAN MARTÍN ESPERILLA,4,481,237,244,20
PUEBLA,21,TLACOTEPEC DE BENITO JUÁREZ,177,SANTA MARÍA LA ALTA,7,2243,1108,1135,76
PUEBLA,21,TLACOTEPEC DE BENITO JUÁREZ,177,SANTO NOMBRE,6,752,402,350,34
PUEBLA,21,TLACOTEPEC DE BENITO JUÁREZ,177,TECALTZINGO,2,117,63,54,7
PUEBLA,21,TLACOTEPEC DE BENITO JUÁREZ,177,TECOXTLE,2,60,36,24,3
PUEBLA,21,TLACOTEPEC DE BENITO JUÁREZ,177,TEPAZOLCO,4,406,211,195,15
PUEBLA,21,TLACOTEPEC DE BENITO JUÁREZ,177,TEPETLACOLCO,4,441,240,201,19
PUEBLA,21,TLACOTEPEC DE BENITO JUÁREZ,177,TLACOTEPEC DE BENITO JUÁREZ,19,5094,2644,2450,201
PUEBLA,21,TLACOTEPEC DE BENITO JUÁREZ,177,TLACUITLAPAN (LA ESTACIÓN Y LOS CARRASCO),5,251,138,113,12
PUEBLA,21,TLACUILOTEPEC,178,AGUA BLANCA,1,8,4,4,1
PUEBLA,21,TLACUILOTEPEC,178,CERRO PRIETO,2,12,6,6,1
PUEBLA,21,TLACUILOTEPEC,178,CUAUTEPEC,3,224,105,119,11
PUEBLA,21,TLACUILOTEPEC,178,EL COJOLITE,2,18,11,7,2
PUEBLA,21,TLACUILOTEPEC,178,EL ENCINAL,2,32,19,13,2
PUEBLA,21,TLACUILOTEPEC,178,EL JERICÓ,3,93,41,52,7
PUEBLA,21,TLACUILOTEPEC,178,EL MUÑECO (CRISTO REY),4,148,75,73,9
PUEBLA,21,TLACUILOTEPEC,178,EL RINCÓN,4,150,71,79,10
PUEBLA,21,TLACUILOTEPEC,178,EL SALTILLO,1,16,7,9,1
PUEBLA,21,TLACUILOTEPEC,178,EL TEMAXCAL,1,6,3,3,1
PUEBLA,21,TLACUILOTEPEC,178,EL ZACATAL,4,229,113,116,13
PUEBLA,21,TLACUILOTEPEC,178,HULA,3,75,35,40,5
PUEBLA,21,TLACUILOTEPEC,178,ITZATLÁN,4,306,152,154,16
PUEBLA,21,TLACUILOTEPEC,178,LA CAMPANA,3,44,19,25,4
PUEBLA,21,TLACUILOTEPEC,178,LA CUEVA,2,31,14,17,3
PUEBLA,21,TLACUILOTEPEC,178,LA ESPERANZA,2,40,23,17,3
PUEBLA,21,TLACUILOTEPEC,178,LA JOYA,2,17,12,5,2
PUEBLA,21,TLACUILOTEPEC,178,LA LAGUNILLA,4,177,105,72,8
PUEBLA,21,TLACUILOTEPEC,178,LA LOMA DE LA COLMENA,2,14,6,8,2
PUEBLA,21,TLACUILOTEPEC,178,NUEVO TENANCINGO,3,96,65,31,5
PUEBLA,21,TLACUILOTEPEC,178,PALO BLANCO,2,73,33,40,4
PUEBLA,21,TLACUILOTEPEC,178,PAPALOCTIPAN,3,347,164,183,16
PUEBLA,21,TLACUILOTEPEC,178,PLAN DE AYALA,4,310,156,154,17
PUEBLA,21,TLACUILOTEPEC,178,SAN ANDRÉS,2,32,18,14,2
PUEBLA,21,TLACUILOTEPEC,178,SAN ANTONIO ACATLÁN,3,46,27,19,4
PUEBLA,21,TLACUILOTEPEC,178,SAN JOSÉ,2,20,10,10,2
PUEBLA,21,TLACUILOTEPEC,178,SAN JUAN TIHUACÁN,3,123,60,63,7
PUEBLA,21,TLACUILOTEPEC,178,SAN PEDRO PETLACOTLA,3,235,103,132,11
PUEBLA,21,TLACUILOTEPEC,178,SANTA MARÍA,3,211,105,106,10
PUEBLA,21,TLACUILOTEPEC,178,TACUBAYA,3,82,40,42,7
PUEBLA,21,TLACUILOTEPEC,178,TANCHITLA (BUENAVISTA),3,52,31,21,4
PUEBLA,21,TLACUILOTEPEC,178,TEMAXCALAPA,5,110,60,50,9
PUEBLA,21,TLACUILOTEPEC,178,TETELOLOYA,3,66,32,34,5
PUEBLA,21,TLACUILOTEPEC,178,TLACUILOTEPEC,10,834,412,422,40
PUEBLA,21,TLACUILOTEPEC,178,TLAPEHUALITA,4,63,32,31,5
PUEBLA,21,TLACUILOTEPEC,178,TLILTEPEC,3,68,30,38,6
PUEBLA,21,TLACHICHUCA,179,AGUA ESCONDIDA EL SALITRERO (LA JÍCARA),2,26,15,11,2
PUEBLA,21,TLACHICHUCA,179,ÁLAMOS TEPETITLÁN,2,212,105,107,8
PUEBLA,21,TLACHICHUCA,179,COLONIA AGRÍCOLA BELLA VISTA (SAN VICENTE),3,40,14,26,4
PUEBLA,21,TLACHICHUCA,179,COLONIA GUERRA,1,32,15,17,2
PUEBLA,21,TLACHICHUCA,179,EMANCIPACIÓN QUETZALAPA,3,228,107,121,11
PUEBLA,21,TLACHICHUCA,179,GUADALUPE LIBERTAD (RÍO VALIENTE),4,425,216,209,16
PUEBLA,21,TLACHICHUCA,179,JOSÉ MARÍA MORELOS,4,337,191,146,12
PUEBLA,21,TLACHICHUCA,179,LÁZARO CÁRDENAS,3,272,139,133,12
PUEBLA,21,TLACHICHUCA,179,LOS RANCHOS,3,21,10,11,3
PUEBLA,21,TLACHICHUCA,179,MANUEL EDGARDO ÁVALOS (SAN ISIDRO),2,96,47,49,4
PUEBLA,21,TLACHICHUCA,179,MIGUEL HIDALGO Y COSTILLA,3,25,12,13,3
PUEBLA,21,TLACHICHUCA,179,OYAMECALCO EL CAJÓN,3,107,56,51,6
PUEBLA,21,TLACHICHUCA,179,PASO NACIONAL,4,260,135,125,17
PUEBLA,21,TLACHICHUCA,179,PUERTO NACIONAL,2,48,24,24,2
PUEBLA,21,TLACHICHUCA,179,RAFAEL ÁVILA CAMACHO,2,143,71,72,5
PUEBLA,21,TLACHICHUCA,179,SAN FRANCISCO INDEPENDENCIA (SANTA MARÍA ASERRADERO),1,56,34,22,4
PUEBLA,21,TLACHICHUCA,179,SAN JOSÉ LA CAPILLA,2,88,37,51,5
PUEBLA,21,TLACHICHUCA,179,SAN JOSÉ LLANO GRANDE (MÁQUINA VIEJA),4,303,154,149,14
PUEBLA,21,TLACHICHUCA,179,SAN MIGUEL ZOAPAN,3,270,143,127,11
PUEBLA,21,TLACHICHUCA,179,SANTA CECILIA TEPETITLÁN,5,720,360,360,31
PUEBLA,21,TLACHICHUCA,179,SANTA CRUZ BUENA VISTA LA CAPILLA,2,143,62,81,7
PUEBLA,21,TLACHICHUCA,179,SANTA INÉS VARELA LA LUZ,3,229,111,118,12
PUEBLA,21,TLACHICHUCA,179,SANTA MARÍA EL ASERRADERO (PEONES ACASILLADOS),6,816,410,406,33
PUEBLA,21,TLACHICHUCA,179,SANTA MARÍA OYAMECALCO (LOS RANCHOS),2,23,13,10,3
PUEBLA,21,TLACHICHUCA,179,TLACHICHUCA,17,3013,1530,1483,132
PUEBLA,21,TLAHUAPAN,180,EL PIPIRÍN,2,19,9,10,2
PUEBLA,21,TLAHUAPAN,180,GUADALUPE ZARAGOZA,4,868,446,422,47
PUEBLA,21,TLAHUAPAN,180,GUADALUPITO LAS DALIAS,3,220,107,113,10
PUEBLA,21,TLAHUAPAN,180,IGNACIO LÓPEZ RAYÓN (EL GAVILLERO),2,96,55,41,5
PUEBLA,21,TLAHUAPAN,180,IGNACIO MANUEL ALTAMIRANO,3,385,195,190,17
PUEBLA,21,TLAHUAPAN,180,LA PRECIOSITA,3,178,77,101,9
PUEBLA,21,TLAHUAPAN,180,NUEVO TLAHUAPAN,2,42,20,22,3
PUEBLA,21,TLAHUAPAN,180,SAN FRANCISCO LA UNIÓN (SAN VICENTE),2,59,29,30,4
PUEBLA,21,TLAHUAPAN,180,SAN JUAN CUAUHTÉMOC,4,536,271,265,19
PUEBLA,21,TLAHUAPAN,180,SAN MARTINITO,2,95,39,56,4
PUEBLA,21,TLAHUAPAN,180,SAN MIGUEL TIANGUISTENCO,4,788,417,371,25
PUEBLA,21,TLAHUAPAN,180,SAN PEDRO MATAMOROS,3,234,116,118,11
PUEBLA,21,TLAHUAPAN,180,SAN RAFAEL IXTAPALUCAN,5,931,475,456,37
PUEBLA,21,TLAHUAPAN,180,SANTA CRUZ MOXOLAHUAC,3,170,78,92,8
PUEBLA,21,TLAHUAPAN,180,SANTA CRUZ OTLATLA,4,220,115,105,14
PUEBLA,21,TLAHUAPAN,180,SANTA MARÍA TEXMELUCAN,3,1239,614,625,46
PUEBLA,21,TLAHUAPAN,180,SANTA RITA TLAHUAPAN,14,2733,1366,1367,114
PUEBLA,21,TLAHUAPAN,180,SANTIAGO COLTZINGO,4,1076,562,514,39
PUEBLA,21,TLALTENANGO,181,TLALTENANGO,8,1780,884,896,72
PUEBLA,21,TLANEPANTLA,182,SANTA ISABEL TLANEPANTLA,1,86,45,41,3
PUEBLA,21,TLANEPANTLA,182,TLANEPANTLA,5,1218,622,596,49
PUEBLA,21,TLAOLA,183,AMANALCO,2,27,14,13,2
PUEBLA,21,TLAOLA,183,ATEQUEXQUITLA,2,19,5,14,2
PUEBLA,21,TLAOLA,183,CAXAPOTLA,4,170,80,90,10
PUEBLA,21,TLAOLA,183,CHICAHUAXTLA,4,766,402,364,35
PUEBLA,21,TLAOLA,183,COCOLONGO,2,28,11,17,2
PUEBLA,21,TLAOLA,183,COXOLITLA,2,57,25,32,4
PUEBLA,21,TLAOLA,183,CUAMILA,4,340,162,178,14
PUEBLA,21,TLAOLA,183,CUTZONTIPA,4,327,159,168,14
PUEBLA,21,TLAOLA,183,HUIXTLA,5,166,76,90,9
PUEBLA,21,TLAOLA,183,LA GALLERA,4,234,115,119,10
PUEBLA,21,TLAOLA,183,NEXAPA AHILA,4,187,101,86,7
PUEBLA,21,TLAOLA,183,NUEVO HIDALGO,3,63,36,27,4
PUEBLA,21,TLAOLA,183,PLAN DE CUAMILA,2,28,14,14,2
PUEBLA,21,TLAOLA,183,SAN JOSÉ,3,35,20,15,4
PUEBLA,21,TLAOLA,183,TLACOCUGTLA,2,30,17,13,2
PUEBLA,21,TLAOLA,183,TLALTEPANGO,4,358,174,184,14
PUEBLA,21,TLAOLA,183,TLANTENTILOYA,1,35,16,19,2
PUEBLA,21,TLAOLA,183,TLAOLA,6,754,386,368,33
PUEBLA,21,TLAOLA,183,TLAPITZALAPA,4,164,82,82,8
PUEBLA,21,TLAOLA,183,TLATLAPANALA,4,285,148,137,14
PUEBLA,21,TLAOLA,183,TLATZOHUILOYA,1,20,9,11,1
PUEBLA,21,TLAOLA,183,TZITZICAZAPA,4,167,79,88,8
PUEBLA,21,TLAOLA,183,XALTEPUXTLA,6,1115,579,536,41
PUEBLA,21,TLAOLA,183,XOCHINANACATLÁN,6,604,295,309,28
PUEBLA,21,TLAOLA,183,YETLA,2,72,30,42,4
PUEBLA,21,TLAPACOYA,184,AHUACATLAYA,4,198,112,86,10
PUEBLA,21,TLAPACOYA,184,BENITO JUÁREZ (XICALANGO),2,32,14,18,2
PUEBLA,21,TLAPACOYA,184,CUATEPALCATLA,2,76,36,40,3
PUEBLA,21,TLAPACOYA,184,LA CRUZ,3,138,72,66,6
PUEBLA,21,TLAPACOYA,184,LA CUMBRE,2,96,44,52,4
PUEBLA,21,TLAPACOYA,184,SAN ANDRÉS BUENAVISTA,2,70,26,44,4
PUEBLA,21,TLAPACOYA,184,SAN ANTONIO TLILAPA,3,166,79,87,7
PUEBLA,21,TLAPACOYA,184,SAN MIGUEL TLILAPA,2,43,21,22,3
PUEBLA,21,TLAPACOYA,184,TLAMAYA CHICO,4,257,129,128,13
PUEBLA,21,TLAPACOYA,184,TLAMAYA GRANDE,4,352,182,170,15
PUEBLA,21,TLAPACOYA,184,TLAPACOYA,4,361,179,182,15
PUEBLA,21,TLAPACOYA,184,ZINTLAPAL,2,27,11,16,2
PUEBLA,21,TLAPACOYA,184,ZOQUIAPA,2,56,26,30,3
PUEBLA,21,TLAPANALÁ,185,COLONIA LAS PALMAS,2,88,41,47,4
PUEBLA,21,TLAPANALÁ,185,RANCHO DE AZTLA,3,91,46,45,5
PUEBLA,21,TLAPANALÁ,185,RANCHO DE TEPETZINGO,2,106,49,57,4
PUEBLA,21,TLAPANALÁ,185,SAN LUIS CHALMA,2,48,24,24,2
PUEBLA,21,TLAPANALÁ,185,SANTA CATARINA COATEPEC,4,447,236,211,26
PUEBLA,21,TLAPANALÁ,185,SANTO DOMINGO AYOTLICHA,4,230,118,112,14
PUEBLA,21,TLAPANALÁ,185,TEPAPAYECA,4,476,233,243,23
PUEBLA,21,TLAPANALÁ,185,TLAPANALÁ,6,1265,642,623,53
PUEBLA,21,TLATLAUQUITEPEC,186,ACAMALOTA,2,44,25,19,3
PUEBLA,21,TLATLAUQUITEPEC,186,ACOCOGTA,5,167,92,75,10
PUEBLA,21,TLATLAUQUITEPEC,186,AHUATAMIMILOL,2,14,4,10,2
PUEBLA,21,TLATLAUQUITEPEC,186,AJOCOTZINGO,4,280,130,150,13
PUEBLA,21,TLATLAUQUITEPEC,186,ALMOLONI,4,975,468,507,39
PUEBLA,21,TLATLAUQUITEPEC,186,ANALCO,1,13,8,5,1
PUEBLA,21,TLATLAUQUITEPEC,186,ATALPA,1,10,3,7,1
PUEBLA,21,TLATLAUQUITEPEC,186,ATIOYAN,4,301,150,151,16
PUEBLA,21,TLATLAUQUITEPEC,186,BUENA VISTA,1,89,42,47,5
PUEBLA,21,TLATLAUQUITEPEC,186,CALATEPEC,4,85,45,40,7
PUEBLA,21,TLATLAUQUITEPEC,186,CHICUACO,3,113,55,58,7
PUEBLA,21,TLATLAUQUITEPEC,186,CHILILISTIPAN,2,17,11,6,1
PUEBLA,21,TLATLAUQUITEPEC,186,CHINAMPA,2,47,23,24,3
PUEBLA,21,TLATLAUQUITEPEC,186,CIUDAD DE TLATLAUQUITEPEC,28,5273,2780,2493,244
PUEBLA,21,TLATLAUQUITEPEC,186,COATECTZIN CENTRO,5,117,61,56,11
PUEBLA,21,TLATLAUQUITEPEC,186,CUACUALAXTLA,2,27,15,12,2
PUEBLA,21,TLATLAUQUITEPEC,186,CUAUTLAMINGO,5,122,70,52,9
PUEBLA,21,TLATLAUQUITEPEC,186,EL CANAL,2,34,20,14,3
PUEBLA,21,TLATLAUQUITEPEC,186,EL CARMEN ILITA,4,137,61,76,10
PUEBLA,21,TLATLAUQUITEPEC,186,EL DURAZNILLO,2,19,6,13,2
PUEBLA,21,TLATLAUQUITEPEC,186,EL MIRADOR,4,350,182,168,18
PUEBLA,21,TLATLAUQUITEPEC,186,EL PROGRESO,3,43,16,27,6
PUEBLA,21,TLATLAUQUITEPEC,186,ELOXOCHITÁN,2,22,12,10,2
PUEBLA,21,TLATLAUQUITEPEC,186,GÓMEZ ORIENTE,5,481,228,253,24
PUEBLA,21,TLATLAUQUITEPEC,186,GÓMEZ PONIENTE,4,560,298,262,27
PUEBLA,21,TLATLAUQUITEPEC,186,GÓMEZ SUR (LLANO DE TOLUCA),2,56,28,28,3
PUEBLA,21,TLATLAUQUITEPEC,186,HUAXTLA,3,153,79,74,10
PUEBLA,21,TLATLAUQUITEPEC,186,ILITA,2,61,20,41,6
PUEBLA,21,TLATLAUQUITEPEC,186,IXMATLACO,3,167,87,80,9
PUEBLA,21,TLATLAUQUITEPEC,186,JILIAPA,2,19,8,11,2
PUEBLA,21,TLATLAUQUITEPEC,186,JILOTEPEC,2,15,8,7,2
PUEBLA,21,TLATLAUQUITEPEC,186,LA CUMBRE,2,35,15,20,4
PUEBLA,21,TLATLAUQUITEPEC,186,LA CUMBRE CHAGCHALTZIN,2,17,7,10,2
PUEBLA,21,TLATLAUQUITEPEC,186,LA PRIMAVERA,2,6,3,3,1
PUEBLA,21,TLATLAUQUITEPEC,186,LA UNIÓN,6,196,103,93,14
PUEBLA,21,TLATLAUQUITEPEC,186,LAS MESAS,2,6,1,5,2
PUEBLA,21,TLATLAUQUITEPEC,186,LOMA DE LA YERBA,4,55,33,22,4
PUEBLA,21,TLATLAUQUITEPEC,186,MACUILQUILA,3,29,14,15,3
PUEBLA,21,TLATLAUQUITEPEC,186,MAZATEPEC,7,471,235,236,27
PUEBLA,21,TLATLAUQUITEPEC,186,MECAYUCAN,1,6,3,3,1
PUEBLA,21,TLATLAUQUITEPEC,186,OCOTLÁN DE BETANCOURT,5,641,308,333,29
PUEBLA,21,TLATLAUQUITEPEC,186,OYAMELES,7,835,403,432,35
PUEBLA,21,TLATLAUQUITEPEC,186,PABLOGCO,2,135,66,69,6
PUEBLA,21,TLATLAUQUITEPEC,186,PEZMATLÁN,8,681,372,309,43
PUEBLA,21,TLATLAUQUITEPEC,186,PLAN DE GUADALUPE,3,123,62,61,9
PUEBLA,21,TLATLAUQUITEPEC,186,SAN AGUSTÍN CHAGCHALTZIN,2,92,48,44,5
PUEBLA,21,TLATLAUQUITEPEC,186,SAN ANTONIO,2,28,13,15,3
PUEBLA,21,TLATLAUQUITEPEC,186,SAN JOSÉ CHAGCHALTZIN,4,101,50,51,6
PUEBLA,21,TLATLAUQUITEPEC,186,TAMALAYO,3,140,74,66,8
PUEBLA,21,TLATLAUQUITEPEC,186,TANHUIXCO DEL CARMEN,2,64,27,37,3
PUEBLA,21,TLATLAUQUITEPEC,186,TATAUZOQUICO,5,676,315,361,29
PUEBLA,21,TLATLAUQUITEPEC,186,TEHUAGCO,4,180,85,95,9
PUEBLA,21,TLATLAUQUITEPEC,186,TEPANTZOL,2,45,22,23,3
PUEBLA,21,TLATLAUQUITEPEC,186,TEPEHICÁN,4,130,52,78,10
PUEBLA,21,TLATLAUQUITEPEC,186,TEPETENO DE ITURBIDE,4,385,180,205,21
PUEBLA,21,TLATLAUQUITEPEC,186,TEPETZINTLA,2,19,5,14,2
PUEBLA,21,TLATLAUQUITEPEC,186,TEZIUTANAPA,2,45,22,23,3
PUEBLA,21,TLATLAUQUITEPEC,186,TOCHIMPA,3,39,17,22,4
PUEBLA,21,TLATLAUQUITEPEC,186,TÚNEL DOS,3,79,36,43,5
PUEBLA,21,TLATLAUQUITEPEC,186,TZINACANTEPEC,3,340,146,194,15
PUEBLA,21,TLATLAUQUITEPEC,186,TZINCUILAPAN,4,141,75,66,9
PUEBLA,21,TLATLAUQUITEPEC,186,XALTENANGO,1,20,9,11,1
PUEBLA,21,TLATLAUQUITEPEC,186,XOMIACO,2,35,15,20,3
PUEBLA,21,TLATLAUQUITEPEC,186,XONOCUAUTLA,10,669,344,325,31
PUEBLA,21,TLATLAUQUITEPEC,186,YOLOCTZIN,2,22,10,12,2
PUEBLA,21,TLAXCO,187,ACALMAN,4,169,82,87,12
PUEBLA,21,TLAXCO,187,ATLALPAN,4,142,67,75,8
PUEBLA,21,TLAXCO,187,BUENA VISTA,1,23,10,13,2
PUEBLA,21,TLAXCO,187,CERRO PELÓN,2,13,8,5,2
PUEBLA,21,TLAXCO,187,CHIPOTLA,2,21,15,6,2
PUEBLA,21,TLAXCO,187,CUAXTLA,4,169,73,96,8
PUEBLA,21,TLAXCO,187,DOS CAMINOS,2,17,8,9,1
PUEBLA,21,TLAXCO,187,DOS CAMINOS ATLALPAN,2,10,3,7,2
PUEBLA,21,TLAXCO,187,EJIDO PEÑA BLANCA (CERRO DEL COMÚN),2,8,5,3,1
PUEBLA,21,TLAXCO,187,EL ÁLAMO,4,196,113,83,9
PUEBLA,21,TLAXCO,187,EL MOGOTE,2,8,6,2,2
PUEBLA,21,TLAXCO,187,LA CANDELARIA,2,6,5,1,2
PUEBLA,21,TLAXCO,187,LOMA BONITA,2,25,13,12,2
PUEBLA,21,TLAXCO,187,TLAXCO,4,335,161,174,21
PUEBLA,21,TOCHIMILCO,188,GUADALUPE,1,62,34,28,2
PUEBLA,21,TOCHIMILCO,188,GUADALUPE CUILOTEPEC (SANTA CATARINA CUILOTEPEC),1,43,22,21,2
PUEBLA,21,TOCHIMILCO,188,JERUSALÉN,2,205,99,106,8
PUEBLA,21,TOCHIMILCO,188,LA MAGDALENA YANCUITLALPAN,3,485,250,235,21
PUEBLA,21,TOCHIMILCO,188,SAN ANTONIO ALPANOCAN,6,813,392,421,36
PUEBLA,21,TOCHIMILCO,188,SAN FRANCISCO HUILANGO,4,286,145,141,13
PUEBLA,21,TOCHIMILCO,188,SAN LUCAS TULCINGO,3,246,112,134,12
PUEBLA,21,TOCHIMILCO,188,SAN MARTÍN ZACATEMPA,4,228,110,118,12
PUEBLA,21,TOCHIMILCO,188,SANTA CATALINA TEPANAPA,2,109,56,53,5
PUEBLA,21,TOCHIMILCO,188,SANTA CRUZ CUAUTOMATITLA,4,349,191,158,14
PUEBLA,21,TOCHIMILCO,188,SANTIAGO TOCHIMIZOLCO,2,132,61,71,6
PUEBLA,21,TOCHIMILCO,188,TECUANIPA (SAN MIGUEL TECUANIPA),4,470,218,252,18
PUEBLA,21,TOCHIMILCO,188,TOCHIMILCO,6,1296,652,644,56
PUEBLA,21,TOCHTEPEC,189,CHIPILTEPEC,2,206,94,112,8
PUEBLA,21,TOCHTEPEC,189,CRISTO REY,2,18,9,9,3
PUEBLA,21,TOCHTEPEC,189,EJIDO VERACRUCITO (SAN FELIPE LA NOPALERA),2,39,19,20,3
PUEBLA,21,TOCHTEPEC,189,RANCHO BAUTISTA,1,16,8,8,2
PUEBLA,21,TOCHTEPEC,189,SAN BARTOLOMÉ TEPETLACALTECHCO,4,461,238,223,22
PUEBLA,21,TOCHTEPEC,189,SAN JOSÉ BUENAVISTA,2,41,20,21,2
PUEBLA,21,TOCHTEPEC,189,SAN LORENZO OMETEPEC,5,882,423,459,35
PUEBLA,21,TOCHTEPEC,189,SAN MARTÍN CALTENCO,8,1334,662,672,55
PUEBLA,21,TOCHTEPEC,189,TOCHTEPEC,7,2462,1279,1183,94
PUEBLA,21,TOTOLTEPEC DE GUERRERO,190,BARRIO DE SAN JUAN,1,49,24,25,3
PUEBLA,21,TOTOLTEPEC DE GUERRERO,190,BARRIO SAN MIGUEL,1,38,19,19,2
PUEBLA,21,TOTOLTEPEC DE GUERRERO,190,SANTA CRUZ NUEVO,2,24,15,9,2
PUEBLA,21,TOTOLTEPEC DE GUERRERO,190,TOTOLTEPEC DE GUERRERO,3,229,131,98,21
PUEBLA,21,TULCINGO,191,AGUACATITLÁN,2,39,17,22,2
PUEBLA,21,TULCINGO,191,ATZOMPA,2,57,33,24,3
PUEBLA,21,TULCINGO,191,CHASTIPAC,2,22,15,7,2
PUEBLA,21,TULCINGO,191,FRANCISCO VILLA,2,17,7,10,2
PUEBLA,21,TULCINGO,191,GUADALUPE TULCINGO,2,25,13,12,2
PUEBLA,21,TULCINGO,191,GUADALUPE VICTORIA,4,121,58,63,10
PUEBLA,21,TULCINGO,191,LA CIÉNEGA,2,6,4,2,1
PUEBLA,21,TULCINGO,191,SAN MIGUEL TLALTEPEXI,3,128,72,56,7
PUEBLA,21,TULCINGO,191,TULCINGO DE VALLE,10,1742,925,817,89
PUEBLA,21,TULCINGO,191,XIXINGO DE LOS REYES,3,252,120,132,12
PUEBLA,21,TULCINGO,191,ZARAGOZA DE LA LUZ,4,143,74,69,9
PUEBLA,21,TUZAMAPAN DE GALEANA,192,EL JAYAL,2,10,3,7,1
PUEBLA,21,TUZAMAPAN DE GALEANA,192,EL TUTI,2,58,23,35,3
PUEBLA,21,TUZAMAPAN DE GALEANA,192,EL ZORRILLO,2,40,20,20,2
PUEBLA,21,TUZAMAPAN DE GALEANA,192,HUITZILTEPEC,3,99,44,55,6
PUEBLA,21,TUZAMAPAN DE GALEANA,192,LA JUNTA POZA LARGA,3,40,16,24,3
PUEBLA,21,TUZAMAPAN DE GALEANA,192,MORELOS,1,5,2,3,1
PUEBLA,21,TUZAMAPAN DE GALEANA,192,REYES DE VALLARTA,4,129,49,80,8
PUEBLA,21,TUZAMAPAN DE GALEANA,192,RICARDO FLORES MAGÓN,3,98,49,49,7
PUEBLA,21,TUZAMAPAN DE GALEANA,192,TETELILLA DE MIGUEL ISLAS,4,425,209,216,20
PUEBLA,21,TUZAMAPAN DE GALEANA,192,TUZAMAPAN DE GALEANA,7,473,241,232,23
PUEBLA,21,TZICATLACOYAN,193,SAN ANTONIO JUÁREZ,4,506,238,268,22
PUEBLA,21,TZICATLACOYAN,193,SAN BERNARDINO TEPENENE,4,240,120,120,14
PUEBLA,21,TZICATLACOYAN,193,SAN FRANCISCO LAGUNILLAS,2,15,7,8,2
PUEBLA,21,TZICATLACOYAN,193,SAN ISIDRO CHIAPA,3,35,21,14,3
PUEBLA,21,TZICATLACOYAN,193,SAN JOSÉ BALBANERA,1,5,3,2,1
PUEBLA,21,TZICATLACOYAN,193,SAN JOSÉ TEXALUCA,3,198,106,92,9
PUEBLA,21,TZICATLACOYAN,193,SAN MARTÍN TETELES,1,6,2,4,1
PUEBLA,21,TZICATLACOYAN,193,SAN MIGUEL ACUEXCOMAC,4,249,131,118,15
PUEBLA,21,TZICATLACOYAN,193,SANTA CRUZ EL CALVARIO,3,8,3,5,2
PUEBLA,21,TZICATLACOYAN,193,TZICATLACOYAN,4,322,165,157,16
PUEBLA,21,VENUSTIANO CARRANZA,194,AGUA FRÍA,2,208,96,112,11
PUEBLA,21,VENUSTIANO CARRANZA,194,CIUDAD DE LÁZARO CÁRDENAS,16,3516,1762,1754,153
PUEBLA,21,VENUSTIANO CARRANZA,194,CORONEL TITO HERNÁNDEZ (MARÍA ANDREA),5,730,366,364,35
PUEBLA,21,VENUSTIANO CARRANZA,194,EL AJENGIBRE,1,32,17,15,2
PUEBLA,21,VENUSTIANO CARRANZA,194,EL LINDERO,1,33,14,19,2
PUEBLA,21,VENUSTIANO CARRANZA,194,EL OJITE,2,43,25,18,3
PUEBLA,21,VENUSTIANO CARRANZA,194,ESTRELLA ROJA,3,148,72,76,7
PUEBLA,21,VENUSTIANO CARRANZA,194,GENERAL IGNACIO ZARAGOZA,2,70,29,41,6
PUEBLA,21,VENUSTIANO CARRANZA,194,LA LIBERTAD,3,190,103,87,11
PUEBLA,21,VENUSTIANO CARRANZA,194,LA MORENA,2,34,19,15,3
PUEBLA,21,VENUSTIANO CARRANZA,194,LAS PALMITAS,3,109,51,58,7
PUEBLA,21,VENUSTIANO CARRANZA,194,NUEVO CABELLAL,2,35,17,18,3
PUEBLA,21,VENUSTIANO CARRANZA,194,SAN BARTOLO DEL ESCOBAL,4,184,85,99,13
PUEBLA,21,VENUSTIANO CARRANZA,194,SAN DIEGO,1,89,49,40,5
PUEBLA,21,VENUSTIANO CARRANZA,194,SAN JOSÉ,4,258,117,141,15
PUEBLA,21,VENUSTIANO CARRANZA,194,SAN RAFAEL,3,50,25,25,4
PUEBLA,21,VENUSTIANO CARRANZA,194,TUMBADERO ESCOBAL,3,80,45,35,6
PUEBLA,21,VENUSTIANO CARRANZA,194,VENUSTIANO CARRANZA,10,1659,809,850,103
PUEBLA,21,VENUSTIANO CARRANZA,194,VICENTE GUERRERO,3,59,30,29,5
PUEBLA,21,VENUSTIANO CARRANZA,194,VILLA DE GUADALUPE,1,16,7,9,1
PUEBLA,21,VENUSTIANO CARRANZA,194,VILLA LÁZARO CÁRDENAS,1,123,75,48,5
PUEBLA,21,VICENTE GUERRERO,195,AHUATEPEC,3,30,17,13,3
PUEBLA,21,VICENTE GUERRERO,195,ALHUACA,6,475,234,241,22
PUEBLA,21,VICENTE GUERRERO,195,ANTIGUO CAPORALCO,1,49,22,27,3
PUEBLA,21,VICENTE GUERRERO,195,AXUXUMICA,2,22,9,13,2
PUEBLA,21,VICENTE GUERRERO,195,BUENA VISTA,1,32,15,17,1
PUEBLA,21,VICENTE GUERRERO,195,CAMPO CHICO,2,45,20,25,3
PUEBLA,21,VICENTE GUERRERO,195,CAPORALCO BUENOS AIRES,5,279,129,150,11
PUEBLA,21,VICENTE GUERRERO,195,CAPULTITLA,2,20,9,11,2
PUEBLA,21,VICENTE GUERRERO,195,CIÉNEGA GRANDE DE FÁTIMA,2,42,22,20,2
PUEBLA,21,VICENTE GUERRERO,195,COXCATEPACHAPA,2,95,51,44,4
PUEBLA,21,VICENTE GUERRERO,195,CUAJCA,1,21,7,14,1
PUEBLA,21,VICENTE GUERRERO,195,CUATRO CAMINOS,8,400,211,189,22
PUEBLA,21,VICENTE GUERRERO,195,DURAZNOTLA,2,45,20,25,2
PUEBLA,21,VICENTE GUERRERO,195,LA BARRANCA (TEPANZOLA),2,16,9,7,2
PUEBLA,21,VICENTE GUERRERO,195,LAS PRADERAS,5,42,15,27,5
PUEBLA,21,VICENTE GUERRERO,195,LLANO GRANDE DOS,3,26,15,11,3
PUEBLA,21,VICENTE GUERRERO,195,LLANO GRANDE UNO,2,26,10,16,3
PUEBLA,21,VICENTE GUERRERO,195,LOMA MANZANA,2,29,16,13,3
PUEBLA,21,VICENTE GUERRERO,195,MATLATECOYA,2,27,14,13,3
PUEBLA,21,VICENTE GUERRERO,195,OJO DE AGUA,1,13,7,6,1
PUEBLA,21,VICENTE GUERRERO,195,RANCHO NUEVO,4,398,208,190,13
PUEBLA,21,VICENTE GUERRERO,195,SAN BERNARDINO LAGUNAS,6,334,186,148,15
PUEBLA,21,VICENTE GUERRERO,195,SAN JOSÉ CUAMANCO,6,149,76,73,8
PUEBLA,21,VICENTE GUERRERO,195,SAN JOSÉ LOS PINOS,2,26,19,7,4
PUEBLA,21,VICENTE GUERRERO,195,SAN LUIS DEL PINO,4,30,16,14,4
PUEBLA,21,VICENTE GUERRERO,195,SAN PEDRO AHUATLAMPA,2,16,11,5,2
PUEBLA,21,VICENTE GUERRERO,195,SAN SALVADOR,2,19,10,9,2
PUEBLA,21,VICENTE GUERRERO,195,SANTA MARÍA DEL MONTE,15,1315,689,626,58
PUEBLA,21,VICENTE GUERRERO,195,TECOLOTLA,3,43,22,21,4
PUEBLA,21,VICENTE GUERRERO,195,TELPATLÁN,10,1099,579,520,41
PUEBLA,21,VICENTE GUERRERO,195,TEOTLALCO DE HIDALGO,3,171,84,87,7
PUEBLA,21,VICENTE GUERRERO,195,TEPETZITZINTLA,6,1114,576,538,41
PUEBLA,21,VICENTE GUERRERO,195,TEXALA,2,16,9,7,2
PUEBLA,21,VICENTE GUERRERO,195,TLACHIHUALTEPEC (RANCHO DE LOS DURAZNOS),2,12,7,5,2
PUEBLA,21,VICENTE GUERRERO,195,TULIMANCA,8,118,60,58,11
PUEBLA,21,VICENTE GUERRERO,195,YAHUALUTZINGO,4,309,165,144,14
PUEBLA,21,VICENTE GUERRERO,195,ZACATIANQUIXCO,1,14,11,3,1
PUEBLA,21,XAYACATLÁN DE BRAVO,196,SEGUNDA SECCIÓN DE XAYACATLÁN DE BRAVO,1,10,4,6,1
PUEBLA,21,XAYACATLÁN DE BRAVO,196,TERCERA SECCIÓN DE XAYACATLÁN DE BRAVO,1,7,3,4,1
PUEBLA,21,XAYACATLÁN DE BRAVO,196,XAYACATLÁN DE BRAVO,4,232,111,121,18
PUEBLA,21,XICOTEPEC,197,AHUAXINTITLA,4,471,227,244,18
PUEBLA,21,XICOTEPEC,197,ATEQUEXQUITLA,3,173,75,98,9
PUEBLA,21,XICOTEPEC,197,DURAZNOTLA,2,138,66,72,7
PUEBLA,21,XICOTEPEC,197,EJIDO DE NACTANCA,1,35,21,14,1
PUEBLA,21,XICOTEPEC,197,EJIDO DE RANCHO NUEVO (EL OJITE),2,115,47,68,5
PUEBLA,21,XICOTEPEC,197,EL CAJÓN,2,54,25,29,3
PUEBLA,21,XICOTEPEC,197,EL JONOTE,2,18,6,12,2
PUEBLA,21,XICOTEPEC,197,EL MIRADOR,1,58,32,26,2
PUEBLA,21,XICOTEPEC,197,EL PORVENIR EJIDO,3,158,79,79,10
PUEBLA,21,XICOTEPEC,197,EL TABACAL,3,712,348,364,27
PUEBLA,21,XICOTEPEC,197,EL TEPETATE,4,128,54,74,9
PUEBLA,21,XICOTEPEC,197,GILBERTO CAMACHO,7,622,296,326,29
PUEBLA,21,XICOTEPEC,197,IXTEPEC,2,39,18,21,2
PUEBLA,21,XICOTEPEC,197,JALAPILLA,3,118,61,57,8
PUEBLA,21,XICOTEPEC,197,LA CHIVERÍA,2,267,126,141,14
PUEBLA,21,XICOTEPEC,197,LAS PILAS,6,231,107,124,17
PUEBLA,21,XICOTEPEC,197,LOS ARROYOS,3,34,20,14,4
PUEBLA,21,XICOTEPEC,197,LOS LIMONES,4,115,53,62,10
PUEBLA,21,XICOTEPEC,197,LOS NARANJOS,2,8,4,4,1
PUEBLA,21,XICOTEPEC,197,MECATLÁN DE LAS FLORES,3,112,62,50,7
PUEBLA,21,XICOTEPEC,197,MONTE GRANDE DE ZARAGOZA,2,70,28,42,3
PUEBLA,21,XICOTEPEC,197,NACTANCA CHICA (LA COLONIA),3,25,11,14,3
PUEBLA,21,XICOTEPEC,197,NACTANCA GRANDE,6,369,186,183,19
PUEBLA,21,XICOTEPEC,197,RANCHO NUEVO,5,156,72,84,12
PUEBLA,21,XICOTEPEC,197,SAN AGUSTÍN ATLIHUÁCAN,4,735,384,351,30
PUEBLA,21,XICOTEPEC,197,SAN ANTONIO,1,4,3,1,1
PUEBLA,21,XICOTEPEC,197,SAN ANTONIO OCOPETLATLÁN,3,279,141,138,13
PUEBLA,21,XICOTEPEC,197,SAN ISIDRO,6,1294,590,704,48
PUEBLA,21,XICOTEPEC,197,SAN LORENZO,9,246,136,110,17
PUEBLA,21,XICOTEPEC,197,SAN PEDRO ITZTLA,4,359,169,190,14
PUEBLA,21,XICOTEPEC,197,SANTA CRUZ CHICA,2,184,81,103,10
PUEBLA,21,XICOTEPEC,197,SANTA CRUZ GRANDE,2,21,15,6,2
PUEBLA,21,XICOTEPEC,197,SANTA LUZ BUENAVISTA,1,212,102,110,8
PUEBLA,21,XICOTEPEC,197,SANTA RITA,4,375,174,201,17
PUEBLA,21,XICOTEPEC,197,TEPAPATLAXCO,3,21,14,7,3
PUEBLA,21,XICOTEPEC,197,TIERRA NEGRA,1,21,5,16,1
PUEBLA,21,XICOTEPEC,197,TLAPEHUALA,3,158,65,93,10
PUEBLA,21,XICOTEPEC,197,TLAXCALANTONGO,6,533,256,277,26
PUEBLA,21,XICOTEPEC,197,TULANCINGUILLO,2,30,9,21,2
PUEBLA,21,XICOTEPEC,197,VILLA ÁVILA CAMACHO (LA CEIBA),14,2883,1437,1446,119
PUEBLA,21,XICOTEPEC,197,VILLA DE LAS FLORES,2,114,60,54,5
PUEBLA,21,XICOTEPEC,197,XICOTEPEC DE JUÁREZ,58,13546,6807,6739,714
PUEBLA,21,XICOTLÁN,198,COACALCO,4,145,76,69,10
PUEBLA,21,XICOTLÁN,198,XICOTLÁN,4,201,98,103,15
PUEBLA,21,XIUTETELCO,199,ALTO LUCERO,4,150,71,79,10
PUEBLA,21,XIUTETELCO,199,ATECAX,6,491,256,235,25
PUEBLA,21,XIUTETELCO,199,BARRIO CHIQUITO,2,29,10,19,2
PUEBLA,21,XIUTETELCO,199,CAÑADA DE COZCUYUCAN,3,18,9,9,2
PUEBLA,21,XIUTETELCO,199,CHALMA,2,40,23,17,2
PUEBLA,21,XIUTETELCO,199,EL AGUAJE ATOLUCA,3,90,46,44,5
PUEBLA,21,XIUTETELCO,199,EL MILAGRO,2,17,9,8,2
PUEBLA,21,XIUTETELCO,199,EL PROGRESO,1,88,44,44,4
PUEBLA,21,XIUTETELCO,199,EL ZAPOTE,2,177,79,98,8
PUEBLA,21,XIUTETELCO,199,LA CANTERA,2,85,43,42,4
PUEBLA,21,XIUTETELCO,199,LA PALMA,3,103,42,61,8
PUEBLA,21,XIUTETELCO,199,LA POSTA,1,13,7,6,1
PUEBLA,21,XIUTETELCO,199,LA REFORMA,3,94,49,45,6
PUEBLA,21,XIUTETELCO,199,LA VENTANA,2,45,28,17,3
PUEBLA,21,XIUTETELCO,199,LAS CHAPAS,3,109,60,49,7
PUEBLA,21,XIUTETELCO,199,LOMA BONITA,2,43,21,22,3
PUEBLA,21,XIUTETELCO,199,LUIS DONALDO COLOSIO,2,4,2,2,1
PUEBLA,21,XIUTETELCO,199,MAXTALOYA,2,54,22,32,3
PUEBLA,21,XIUTETELCO,199,RANCHO NUEVO,2,86,42,44,3
PUEBLA,21,XIUTETELCO,199,SAN ANDRÉS,6,569,274,295,26
PUEBLA,21,XIUTETELCO,199,SAN ANDRÉS COYOTITLÁN,2,200,77,123,7
PUEBLA,21,XIUTETELCO,199,SAN ANTONIO,3,364,177,187,14
PUEBLA,21,XIUTETELCO,199,SAN FRANCISCO,5,636,309,327,29
PUEBLA,21,XIUTETELCO,199,SAN ISIDRO,3,321,165,156,11
PUEBLA,21,XIUTETELCO,199,SAN JOSÉ,5,286,162,124,16
PUEBLA,21,XIUTETELCO,199,SAN JUAN XIUTETELCO,11,3245,1665,1580,134
PUEBLA,21,XIUTETELCO,199,SAN MARTÍN,3,223,120,103,11
PUEBLA,21,XIUTETELCO,199,SAN SALVADOR (NARANJILLO),4,795,429,366,32
PUEBLA,21,XIUTETELCO,199,SANTIAGO,3,248,134,114,11
PUEBLA,21,XIUTETELCO,199,SECCIÓN SEGUNDA XIUTETELCO,1,59,39,20,3
PUEBLA,21,XIUTETELCO,199,TOMAQUILAPA,3,242,116,126,11
PUEBLA,21,XIUTETELCO,199,VISTA HERMOSA,2,58,26,32,3
PUEBLA,21,XIUTETELCO,199,XALTIPAN,6,1391,680,711,48
PUEBLA,21,XOCHIAPULCO,200,ATZALÁN,2,30,14,16,3
PUEBLA,21,XOCHIAPULCO,200,CINCO DE MAYO,4,416,202,214,26
PUEBLA,21,XOCHIAPULCO,200,CUAUHTECOMACO,2,8,5,3,1
PUEBLA,21,XOCHIAPULCO,200,CUAUTAMANIS,2,43,16,27,3
PUEBLA,21,XOCHIAPULCO,200,CUAUXIMALOYAN,3,89,46,43,8
PUEBLA,21,XOCHIAPULCO,200,IXEHUACO,2,29,20,9,3
PUEBLA,21,XOCHIAPULCO,200,LA MANZANILLA,2,32,17,15,2
PUEBLA,21,XOCHIAPULCO,200,LA ROSA DE CASTILLA,2,23,12,11,2
PUEBLA,21,XOCHIAPULCO,200,SAN JOSÉ,2,8,6,2,1
PUEBLA,21,XOCHIAPULCO,200,XALTAMPA,2,13,8,5,1
PUEBLA,21,XOCHIAPULCO,200,YAUTETELCO,2,38,24,14,3
PUEBLA,21,XOCHILTEPEC,201,ALTAVISTA,1,16,7,9,1
PUEBLA,21,XOCHILTEPEC,201,AYOTLA,3,360,172,188,16
PUEBLA,21,XOCHILTEPEC,201,XOCHILTEPEC,5,385,187,198,21
PUEBLA,21,XOCHITLÁN DE VICENTE SUÁREZ,202,AMATITÁN,2,65,32,33,4
PUEBLA,21,XOCHITLÁN DE VICENTE SUÁREZ,202,BONILLAGCO,1,11,3,8,1
PUEBLA,21,XOCHITLÁN DE VICENTE SUÁREZ,202,CHICUASENCUAUTLA,2,77,44,33,3
PUEBLA,21,XOCHITLÁN DE VICENTE SUÁREZ,202,HUAHUAXTLA,5,761,373,388,32
PUEBLA,21,XOCHITLÁN DE VICENTE SUÁREZ,202,HUAPALEGCAN,4,150,77,73,8
PUEBLA,21,XOCHITLÁN DE VICENTE SUÁREZ,202,PAHUATA,4,251,128,123,12
PUEBLA,21,XOCHITLÁN DE VICENTE SUÁREZ,202,SAN FRANCISCO OCOTEPEC (OCOTEPEC DE CÁRDENAS),2,47,20,27,3
PUEBLA,21,XOCHITLÁN DE VICENTE SUÁREZ,202,TZONTECOMATA (CUAXUCHPAN),2,36,19,17,2
PUEBLA,21,XOCHITLÁN DE VICENTE SUÁREZ,202,XALTIPAC,3,143,72,71,9
PUEBLA,21,XOCHITLÁN DE VICENTE SUÁREZ,202,XICALXOCHICO,2,34,15,19,2
PUEBLA,21,XOCHITLÁN DE VICENTE SUÁREZ,202,XOCHITLÁN DE ROMERO RUBIO (TATEMPAN),2,189,91,98,9
PUEBLA,21,XOCHITLÁN DE VICENTE SUÁREZ,202,XOCHITLÁN DE VICENTE SUÁREZ,6,592,295,297,38
PUEBLA,21,XOCHITLÁN DE VICENTE SUÁREZ,202,XOCOYOLAPAN (SANTA ISABEL),2,51,27,24,3
PUEBLA,21,XOCHITLÁN DE VICENTE SUÁREZ,202,ZOATECPAN,6,884,413,471,34
PUEBLA,21,XOCHITLÁN TODOS SANTOS,203,BUENOS AIRES,3,30,17,13,3
PUEBLA,21,XOCHITLÁN TODOS SANTOS,203,LA UNIÓN,1,31,15,16,2
PUEBLA,21,XOCHITLÁN TODOS SANTOS,203,LAS AMARILLAS,2,6,1,5,1
PUEBLA,21,XOCHITLÁN TODOS SANTOS,203,LOS PINOS,2,10,6,4,2
PUEBLA,21,XOCHITLÁN TODOS SANTOS,203,RANCHO VIEJO,3,29,14,15,3
PUEBLA,21,XOCHITLÁN TODOS SANTOS,203,SAN JERÓNIMO ALFARO,3,106,49,57,6
PUEBLA,21,XOCHITLÁN TODOS SANTOS,203,XOCHITLÁN,6,1577,805,772,64
PUEBLA,21,YAONÁHUAC,204,AHUATA,1,41,19,22,2
PUEBLA,21,YAONÁHUAC,204,AHUEHUETES,1,178,83,95,6
PUEBLA,21,YAONÁHUAC,204,ATEMEYA,2,31,16,15,3
PUEBLA,21,YAONÁHUAC,204,ATOTOCOYAN,4,180,100,80,11
PUEBLA,21,YAONÁHUAC,204,MAZATONAL,4,235,124,111,13
PUEBLA,21,YAONÁHUAC,204,OCOTEPEC,2,25,16,9,2
PUEBLA,21,YAONÁHUAC,204,TATEMPAN,2,29,17,12,2
PUEBLA,21,YAONÁHUAC,204,TETELTIPAN,2,26,13,13,3
PUEBLA,21,YAONÁHUAC,204,YAONÁHUAC,7,1097,543,554,47
PUEBLA,21,YEHUALTEPEC,205,BENITO JUÁREZ [COLONIA],3,45,20,25,3
PUEBLA,21,YEHUALTEPEC,205,EJIDO DE RANCHO CHICO,1,227,124,103,10
PUEBLA,21,YEHUALTEPEC,205,LLANO GRANDE,2,22,15,7,4
PUEBLA,21,YEHUALTEPEC,205,RANCHO CHICO,2,464,228,236,16
PUEBLA,21,YEHUALTEPEC,205,SAN FRANCISCO CUAUTLA,2,22,11,11,3
PUEBLA,21,YEHUALTEPEC,205,SAN GABRIEL TETZOYOCAN,7,1635,823,812,59
PUEBLA,21,YEHUALTEPEC,205,SAN MATEO TLACOMULCO,2,210,101,109,8
PUEBLA,21,YEHUALTEPEC,205,SAN MIGUEL ZOZUTLA,6,1270,620,650,48
PUEBLA,21,YEHUALTEPEC,205,SAN PEDRO ASCONA,1,14,7,7,1
PUEBLA,21,YEHUALTEPEC,205,SAN PEDRO EL CHICO,4,68,34,34,6
PUEBLA,21,YEHUALTEPEC,205,YEHUALTEPEC,13,3092,1677,1415,108
PUEBLA,21,ZACAPALA,206,EL PITAYO,2,6,1,5,1
PUEBLA,21,ZACAPALA,206,EL ROSARIO XOCHITIOPAN,4,299,159,140,13
PUEBLA,21,ZACAPALA,206,EL TIMBRE,3,19,10,9,3
PUEBLA,21,ZACAPALA,206,GUADALUPE HIDALGO,2,19,13,6,2
PUEBLA,21,ZACAPALA,206,LA VICTORIA,4,233,109,124,10
PUEBLA,21,ZACAPALA,206,RANCHO NUEVO LOS NAVARROS,1,18,8,10,3
PUEBLA,21,ZACAPALA,206,RANCHO NUEVO SAN MATEO,1,12,2,10,1
PUEBLA,21,ZACAPALA,206,REPARO MEZQUITE,1,7,5,2,1
PUEBLA,21,ZACAPALA,206,SAN AGUSTÍN,2,5,2,3,1
PUEBLA,21,ZACAPALA,206,SAN MATEO MIMIAPAN,3,58,24,34,3
PUEBLA,21,ZACAPALA,206,SAN MIGUEL DE ALLENDE,2,26,12,14,2
PUEBLA,21,ZACAPALA,206,ZACAPALA,6,338,167,171,19
PUEBLA,21,ZACAPOAXTLA,207,AHUACATLÁN,4,538,271,267,25
PUEBLA,21,ZACAPOAXTLA,207,AHUATEPEC,1,8,5,3,1
PUEBLA,21,ZACAPOAXTLA,207,ATACPAN,5,253,122,131,15
PUEBLA,21,ZACAPOAXTLA,207,CALCAHUALCO,3,68,33,35,5
PUEBLA,21,ZACAPOAXTLA,207,COHUATZALPAN,3,80,39,41,5
PUEBLA,21,ZACAPOAXTLA,207,COMALTEPEC,7,859,394,465,39
PUEBLA,21,ZACAPOAXTLA,207,CUACUILCO,3,129,74,55,8
PUEBLA,21,ZACAPOAXTLA,207,EL MOLINO,4,549,298,251,26
PUEBLA,21,ZACAPOAXTLA,207,EL PROGRESO,5,293,148,145,14
PUEBLA,21,ZACAPOAXTLA,207,FRANCISCO I. MADERO,4,276,140,136,14
PUEBLA,21,ZACAPOAXTLA,207,GONZALO BAUTISTA,3,125,61,64,7
PUEBLA,21,ZACAPOAXTLA,207,HÉROES DEL CINCO DE MAYO,3,118,56,62,10
PUEBLA,21,ZACAPOAXTLA,207,INDEPENDENCIA (XIUTENO),2,66,32,34,3
PUEBLA,21,ZACAPOAXTLA,207,INSURGENTES,2,49,20,29,3
PUEBLA,21,ZACAPOAXTLA,207,IXTACAPAN,2,59,35,24,5
PUEBLA,21,ZACAPOAXTLA,207,JILOTEPEC,3,98,54,44,7
PUEBLA,21,ZACAPOAXTLA,207,LA LIBERTAD,7,1073,532,541,48
PUEBLA,21,ZACAPOAXTLA,207,LAS LOMAS,8,703,358,345,32
PUEBLA,21,ZACAPOAXTLA,207,LOS CRISTALES (TALICAN),2,591,307,284,20
PUEBLA,21,ZACAPOAXTLA,207,MAZAPA,2,68,36,32,5
PUEBLA,21,ZACAPOAXTLA,207,MORAGCO,1,10,4,6,1
PUEBLA,21,ZACAPOAXTLA,207,NEXPANATENO,2,31,16,15,3
PUEBLA,21,ZACAPOAXTLA,207,NEXTICAPAN,4,348,168,180,19
PUEBLA,21,ZACAPOAXTLA,207,OCOTLÁN,3,27,14,13,3
PUEBLA,21,ZACAPOAXTLA,207,SAN CARLOS,2,63,24,39,3
PUEBLA,21,ZACAPOAXTLA,207,SAN FRANCISCO ZACAPEXPAN,1,148,70,78,8
PUEBLA,21,ZACAPOAXTLA,207,SAN JUAN TAHITIC,7,413,197,216,22
PUEBLA,21,ZACAPOAXTLA,207,SANTA CRUZ XALTETELA,3,46,23,23,4
PUEBLA,21,ZACAPOAXTLA,207,TATOXCAC,12,1189,608,581,53
PUEBLA,21,ZACAPOAXTLA,207,TATZECUALA,5,217,101,116,13
PUEBLA,21,ZACAPOAXTLA,207,TEXOCOYOHUAC,3,322,156,166,15
PUEBLA,21,ZACAPOAXTLA,207,XALACAPAN,8,1051,514,537,44
PUEBLA,21,ZACAPOAXTLA,207,XALTICPAC,4,222,98,124,13
PUEBLA,21,ZACAPOAXTLA,207,XILITA,3,266,129,137,13
PUEBLA,21,ZACAPOAXTLA,207,XOCHITEPEC,3,106,45,61,9
PUEBLA,21,ZACAPOAXTLA,207,ZACAPOAXTLA,40,10394,5471,4923,566
PUEBLA,21,ZACATLÁN,208,AJAJALPAN (CUAMANALA),1,11,3,8,1
PUEBLA,21,ZACATLÁN,208,ATENCO,1,4,1,3,1
PUEBLA,21,ZACATLÁN,208,ATEXCA,3,71,33,38,6
PUEBLA,21,ZACATLÁN,208,ATOTONILCO,3,94,42,52,7
PUEBLA,21,ZACATLÁN,208,ATZINGO (LA CUMBRE),6,798,399,399,35
PUEBLA,21,ZACATLÁN,208,AYEHUALULCO,1,71,34,37,8
PUEBLA,21,ZACATLÁN,208,AYEHUALULCO SEGUNDA SECCIÓN (EL TECAJETE),4,128,70,58,10
PUEBLA,21,ZACATLÁN,208,AYOTLA,3,53,28,25,5
PUEBLA,21,ZACATLÁN,208,CAMOTEPEC,5,744,364,380,29
PUEBLA,21,ZACATLÁN,208,CANAUTLA,2,22,9,13,2
PUEBLA,21,ZACATLÁN,208,CRUZTITLA,3,86,47,39,6
PUEBLA,21,ZACATLÁN,208,CUACUILA,4,205,99,106,13
PUEBLA,21,ZACATLÁN,208,CUACUILCO,1,7,4,3,1
PUEBLA,21,ZACATLÁN,208,DOS CERRITOS,2,61,30,31,3
PUEBLA,21,ZACATLÁN,208,EJIDO TULIMAN (POTRERO DE QUETZALAPA),2,72,45,27,3
PUEBLA,21,ZACATLÁN,208,ELOXOCHITLÁN,2,238,111,127,9
PUEBLA,21,ZACATLÁN,208,HUAUCHINANCINGO,1,74,40,34,3
PUEBLA,21,ZACATLÁN,208,HUEYAPAN,3,184,83,101,13
PUEBLA,21,ZACATLÁN,208,HUILOTEPEC,4,155,86,69,10
PUEBLA,21,ZACATLÁN,208,JICOLAPA,5,938,453,485,46
PUEBLA,21,ZACATLÁN,208,JICOLAPA EJIDO,1,15,8,7,1
PUEBLA,21,ZACATLÁN,208,JILOTZINGO,5,653,318,335,28
PUEBLA,21,ZACATLÁN,208,LA ESTRELLA,2,32,15,17,3
PUEBLA,21,ZACATLÁN,208,LA MESA,3,89,42,47,5
PUEBLA,21,ZACATLÁN,208,LAS LAJAS (SEGUNDA SECCIÓN),4,832,415,417,40
PUEBLA,21,ZACATLÁN,208,LAS LAJAS PRIMERA SECCIÓN,2,53,26,27,3
PUEBLA,21,ZACATLÁN,208,MAQUIXTLA,4,862,467,395,34
PUEBLA,21,ZACATLÁN,208,MATLAHUACALA,3,153,82,71,8
PUEBLA,21,ZACATLÁN,208,METEPEC PRIMERA SECCIÓN,2,91,48,43,4
PUEBLA,21,ZACATLÁN,208,METEPEC SEGUNDA SECCIÓN,3,40,19,21,2
PUEBLA,21,ZACATLÁN,208,METLAXIXTLA,5,87,45,42,7
PUEBLA,21,ZACATLÁN,208,NANACAMILA,4,326,163,163,16
PUEBLA,21,ZACATLÁN,208,OTLATLÁN,3,74,31,43,6
PUEBLA,21,ZACATLÁN,208,PALOS CAÍDOS,2,34,19,15,3
PUEBLA,21,ZACATLÁN,208,PAPAXTLA,1,5,4,1,1
PUEBLA,21,ZACATLÁN,208,POPOTOHUILCO,2,21,9,12,2
PUEBLA,21,ZACATLÁN,208,POXCUATZINGO,4,395,186,209,17
PUEBLA,21,ZACATLÁN,208,RANCHO NUEVO (NANACAMILA),3,150,76,74,8
PUEBLA,21,ZACATLÁN,208,SAN BARTOLO,3,142,62,80,7
PUEBLA,21,ZACATLÁN,208,SAN CRISTÓBAL XOCHIMILPA,4,358,163,195,17
PUEBLA,21,ZACATLÁN,208,SAN ISIDRO ATOTONILCO,3,54,29,25,5
PUEBLA,21,ZACATLÁN,208,SAN JOAQUÍN TOMATLÁN (SAN ISIDRO TOMATLÁN),3,169,88,81,9
PUEBLA,21,ZACATLÁN,208,SAN LORENZO TEPEIXCO,4,134,54,80,7
PUEBLA,21,ZACATLÁN,208,SAN MIGUEL TENANGO,6,444,211,233,22
PUEBLA,21,ZACATLÁN,208,SAN PEDRO ATMATLA,4,347,170,177,14
PUEBLA,21,ZACATLÁN,208,SANTA CRUZ BUENAVISTA,2,35,14,21,3
PUEBLA,21,ZACATLÁN,208,SANTA INÉS JILOTZINGO,2,81,36,45,4
PUEBLA,21,ZACATLÁN,208,TEPEIXCO,4,362,179,183,16
PUEBLA,21,ZACATLÁN,208,TEPETLA,2,8,5,3,1
PUEBLA,21,ZACATLÁN,208,TEPOXCUAUTLA,4,187,86,101,12
PUEBLA,21,ZACATLÁN,208,TETELANCINGO,2,26,11,15,2
PUEBLA,21,ZACATLÁN,208,TLALIXTLIPA,5,201,110,91,16
PUEBLA,21,ZACATLÁN,208,TLATEMPA,5,380,186,194,17
PUEBLA,21,ZACATLÁN,208,TOMATLÁN,4,521,266,255,22
PUEBLA,21,ZACATLÁN,208,TULIMÁN,2,14,8,6,2
PUEBLA,21,ZACATLÁN,208,XONOTLA,4,182,95,87,13
PUEBLA,21,ZACATLÁN,208,XOXONACATLA,6,631,332,299,29
PUEBLA,21,ZACATLÁN,208,YEHUALA,3,55,19,36,5
PUEBLA,21,ZACATLÁN,208,ZACATLÁN,80,14880,7825,7055,807
PUEBLA,21,ZACATLÁN,208,ZOQUITLA,2,60,31,29,4
PUEBLA,21,ZAPOTITLÁN,209,AGUA MEZQUITE,2,17,4,13,2
PUEBLA,21,ZAPOTITLÁN,209,EJIDO GUADALUPE,2,11,9,2,1
PUEBLA,21,ZAPOTITLÁN,209,ESTANZUELA,4,120,52,68,9
PUEBLA,21,ZAPOTITLÁN,209,GUADALUPE LA MEZA,3,25,15,10,3
PUEBLA,21,ZAPOTITLÁN,209,LAS VENTAS,2,26,12,14,2
PUEBLA,21,ZAPOTITLÁN,209,LOS REYES METZONTLA,3,181,87,94,9
PUEBLA,21,ZAPOTITLÁN,209,SAN ANTONIO TEXCALA,4,285,126,159,14
PUEBLA,21,ZAPOTITLÁN,209,SAN JOSÉ DIXIÑADO,3,21,7,14,3
PUEBLA,21,ZAPOTITLÁN,209,SAN JUAN RAYA,3,36,19,17,4
PUEBLA,21,ZAPOTITLÁN,209,SAN MARTÍN DEL VALLE,3,61,27,34,5
PUEBLA,21,ZAPOTITLÁN,209,SAN PEDRO ATZUMBA,4,177,90,87,10
PUEBLA,21,ZAPOTITLÁN,209,SAN PEDRO NETITLÁN,4,45,24,21,4
PUEBLA,21,ZAPOTITLÁN,209,XOCHILTEPEC (SAN FRANCISCO),3,15,9,6,2
PUEBLA,21,ZAPOTITLÁN,209,ZAPOTITLÁN SALINAS,8,1002,515,487,54
PUEBLA,21,ZAPOTITLÁN,209,ZARAGOZA,3,72,32,40,5
PUEBLA,21,ZAPOTITLÁN DE MÉNDEZ,210,NANACATLÁN,5,307,149,158,18
PUEBLA,21,ZAPOTITLÁN DE MÉNDEZ,210,TUXTLA,4,484,252,232,26
PUEBLA,21,ZAPOTITLÁN DE MÉNDEZ,210,ZAPOTITLÁN DE MÉNDEZ,4,800,411,389,31
PUEBLA,21,ZARAGOZA,211,ACUACO,2,63,29,34,4
PUEBLA,21,ZARAGOZA,211,EL RETIRO,1,23,12,11,2
PUEBLA,21,ZARAGOZA,211,LAS TRANCAS,3,123,63,60,10
PUEBLA,21,ZARAGOZA,211,MORELOS,3,294,147,147,13
PUEBLA,21,ZARAGOZA,211,SAN JOSÉ BUENAVISTA,2,43,20,23,3
PUEBLA,21,ZARAGOZA,211,XALEHUALA,2,120,62,58,6
PUEBLA,21,ZARAGOZA,211,ZARAGOZA,18,4347,2104,2243,204
PUEBLA,21,ZAUTLA,212,ACATZACATA,2,17,10,7,2
PUEBLA,21,ZAUTLA,212,BUENA VISTA,2,29,13,16,2
PUEBLA,21,ZAUTLA,212,CHILAPA DE VICENTE GUERRERO,5,286,141,145,17
PUEBLA,21,ZAUTLA,212,CHINAMPA,2,11,4,7,2
PUEBLA,21,ZAUTLA,212,CONTLA,3,192,100,92,12
PUEBLA,21,ZAUTLA,212,CRUZ BLANCA,2,107,52,55,6
PUEBLA,21,ZAUTLA,212,EL MIRADOR,3,43,16,27,4
PUEBLA,21,ZAUTLA,212,EL PUERTO (REFORMA),1,5,5,0,1
PUEBLA,21,ZAUTLA,212,EL TEPEYAC,3,125,56,69,6
PUEBLA,21,ZAUTLA,212,EMILIANO ZAPATA,3,16,8,8,2
PUEBLA,21,ZAUTLA,212,EMILIO CARRANZA (SANTA CRUZ),5,462,234,228,21
PUEBLA,21,ZAUTLA,212,GUADALUPE HIDALGO,2,9,5,4,2
PUEBLA,21,ZAUTLA,212,HUITZITZILAPAN,3,131,69,62,6
PUEBLA,21,ZAUTLA,212,IXTACTENANGO,4,96,50,46,8
PUEBLA,21,ZAUTLA,212,JALCOMULCO,4,95,53,42,9
PUEBLA,21,ZAUTLA,212,JUAN FRANCISCO LUCAS,2,30,19,11,3
PUEBLA,21,ZAUTLA,212,OCOPIPILA,1,5,3,2,1
PUEBLA,21,ZAUTLA,212,OCOTZINGO,3,48,20,28,4
PUEBLA,21,ZAUTLA,212,OXPANTLA,2,61,29,32,6
PUEBLA,21,ZAUTLA,212,ROSA DE CASTILLA,4,97,40,57,7
PUEBLA,21,ZAUTLA,212,SAN ANDRÉS YAHUITLALPAN,5,332,193,139,16
PUEBLA,21,ZAUTLA,212,SAN FRANCISCO DEL PROGRESO,3,200,91,109,11
PUEBLA,21,ZAUTLA,212,SAN ISIDRO,2,105,51,54,5
PUEBLA,21,ZAUTLA,212,SAN MIGUEL TENEXTATILOYAN,7,2015,1005,1010,79
PUEBLA,21,ZAUTLA,212,SANTA INÉS MORELOS,2,47,21,26,3
PUEBLA,21,ZAUTLA,212,SANTIAGO ZAUTLA,8,759,431,328,64
PUEBLA,21,ZAUTLA,212,TAGCOTEPEC,5,131,60,71,9
PUEBLA,21,ZAUTLA,212,TENAMPULCO,2,81,40,41,4
PUEBLA,21,ZAUTLA,212,TLAMANCA,5,306,160,146,16
PUEBLA,21,ZAUTLA,212,XOPANACO,1,27,12,15,2
PUEBLA,21,ZAUTLA,212,ZAUTLA,1,36,15,21,2
PUEBLA,21,ZAUTLA,212,ZAYOLAPAN,2,44,19,25,3
PUEBLA,21,ZIHUATEUTLA,213,AZCATLÁN,3,67,33,34,6
PUEBLA,21,ZIHUATEUTLA,213,CACAHUATLÁN,2,54,25,29,3
PUEBLA,21,ZIHUATEUTLA,213,CERRO VERDE,4,214,100,114,14
PUEBLA,21,ZIHUATEUTLA,213,CUATECHALOTLA,2,27,8,19,2
PUEBLA,21,ZIHUATEUTLA,213,CUAUNEPIXCA (LA CUMBRE),2,68,31,37,4
PUEBLA,21,ZIHUATEUTLA,213,ERNESTO HERNÁNDEZ (TLACOYUCO),3,73,34,39,6
PUEBLA,21,ZIHUATEUTLA,213,FINCA LOS PUENTES,1,34,18,16,2
PUEBLA,21,ZIHUATEUTLA,213,LA FLORIDA,3,28,14,14,3
PUEBLA,21,ZIHUATEUTLA,213,LA LAGUNA,3,85,45,40,5
PUEBLA,21,ZIHUATEUTLA,213,LA MESA DEL CRUCERO (LA MESITA),2,19,7,12,2
PUEBLA,21,ZIHUATEUTLA,213,LA TRANCA DE FIERRO,1,30,11,19,1
PUEBLA,21,ZIHUATEUTLA,213,LA UNIÓN,4,561,307,254,27
PUEBLA,21,ZIHUATEUTLA,213,LAGUNILLAS,3,132,65,67,7
PUEBLA,21,ZIHUATEUTLA,213,LOMA BONITA,3,159,77,82,10
PUEBLA,21,ZIHUATEUTLA,213,LOS MANGUITOS,2,34,16,18,3
PUEBLA,21,ZIHUATEUTLA,213,LOS PINOS,2,111,63,48,4
PUEBLA,21,ZIHUATEUTLA,213,MAZACOATLÁN,4,345,166,179,19
PUEBLA,21,ZIHUATEUTLA,213,NANACATEPEC,2,12,6,6,2
PUEBLA,21,ZIHUATEUTLA,213,OCOMANTLA,3,155,81,74,10
PUEBLA,21,ZIHUATEUTLA,213,OJO DE AGUA,2,32,14,18,3
PUEBLA,21,ZIHUATEUTLA,213,SAN ANDRÉS,1,18,12,6,1
PUEBLA,21,ZIHUATEUTLA,213,TECPATLÁN,3,233,105,128,11
PUEBLA,21,ZIHUATEUTLA,213,TECUANTLA,2,38,21,17,3
PUEBLA,21,ZIHUATEUTLA,213,TELOLOTLA,4,242,124,118,14
PUEBLA,21,ZIHUATEUTLA,213,TENANGUITO,4,208,96,112,10
PUEBLA,21,ZIHUATEUTLA,213,ZIHUATEUTLA,6,595,274,321,31
PUEBLA,21,ZINACATEPEC,214,SAN SEBASTIÁN ZINACATEPEC,16,4208,2128,2080,224
PUEBLA,21,ZINACATEPEC,214,ZINACATEPEC,3,252,137,115,17
PUEBLA,21,ZONGOZOTLA,215,ZONGOZOTLA,6,950,424,526,54
PUEBLA,21,ZOQUIAPAN,216,AMATLÁN,4,180,82,98,10
PUEBLA,21,ZOQUIAPAN,216,GUAYABAL,2,42,20,22,3
PUEBLA,21,ZOQUIAPAN,216,SAN ANTONIO BUENAVISTA,2,22,13,9,2
PUEBLA,21,ZOQUIAPAN,216,ZACATILIHUIC,1,68,41,27,4
PUEBLA,21,ZOQUIAPAN,216,ZOQUIAPAN,4,358,184,174,20
PUEBLA,21,ZOQUITLÁN,217,ACATEPEC (SAN ANTONIO),11,580,294,286,27
PUEBLA,21,ZOQUITLÁN,217,ATLANTIOPA,2,41,23,18,3
PUEBLA,21,ZOQUITLÁN,217,AXOCOVAJCA,1,18,8,10,1
PUEBLA,21,ZOQUITLÁN,217,BARRIO TEPEPA LAGUNA,1,5,2,3,1
PUEBLA,21,ZOQUITLÁN,217,CACALOC,6,245,125,120,15
PUEBLA,21,ZOQUITLÁN,217,COBICTIC,2,9,4,5,2
PUEBLA,21,ZOQUITLÁN,217,COTZINGA,3,24,8,16,3
PUEBLA,21,ZOQUITLÁN,217,COYOLAPA,5,245,127,118,13
PUEBLA,21,ZOQUITLÁN,217,CRUZTITLA,3,36,19,17,3
PUEBLA,21,ZOQUITLÁN,217,CUAPNEPANTLA,3,29,16,13,4
PUEBLA,21,ZOQUITLÁN,217,ÍZHUAPA,2,130,65,65,6
PUEBLA,21,ZOQUITLÁN,217,MANGOTITLA (ZOYALTEPEC),2,16,9,7,2
PUEBLA,21,ZOQUITLÁN,217,METZONTLA,1,23,10,13,2
PUEBLA,21,ZOQUITLÁN,217,OCOTEMPA,3,59,28,31,4
PUEBLA,21,ZOQUITLÁN,217,OZTOPULCO,5,123,71,52,8
PUEBLA,21,ZOQUITLÁN,217,POZOTITLA,3,43,24,19,4
PUEBLA,21,ZOQUITLÁN,217,QUETZALTOTOC,3,114,58,56,5
PUEBLA,21,ZOQUITLÁN,217,QUIAPTEPEC,3,21,12,9,3
PUEBLA,21,ZOQUITLÁN,217,TECOLOTLEAPA,1,96,73,23,6
PUEBLA,21,ZOQUITLÁN,217,TEPANTITLA,3,78,35,43,4
PUEBLA,21,ZOQUITLÁN,217,TEPEPA DE ZARAGOZA,6,128,65,63,9
PUEBLA,21,ZOQUITLÁN,217,TEPEPAN BANDERA,3,60,33,27,3
PUEBLA,21,ZOQUITLÁN,217,TEPEQUEXPA,4,55,25,30,5
PUEBLA,21,ZOQUITLÁN,217,TEPETOLONTZI,2,8,4,4,1
PUEBLA,21,ZOQUITLÁN,217,TEPEXILOTLA,6,270,141,129,13
PUEBLA,21,ZOQUITLÁN,217,TEPEYACAC,2,41,26,15,2
PUEBLA,21,ZOQUITLÁN,217,TOTLALA,4,18,13,5,3
PUEBLA,21,ZOQUITLÁN,217,TRANCAS,3,80,43,37,5
PUEBLA,21,ZOQUITLÁN,217,XALTEPEC,3,74,35,39,5
PUEBLA,21,ZOQUITLÁN,217,XICALA,2,46,13,33,3
PUEBLA,21,ZOQUITLÁN,217,XITLAMA,7,713,378,335,34
PUEBLA,21,ZOQUITLÁN,217,XOCOTLA,2,41,23,18,4
PUEBLA,21,ZOQUITLÁN,217,XOLOXTEPEC,3,38,14,24,3
PUEBLA,21,ZOQUITLÁN,217,ZOQUITLÁN,22,1476,771,705,75
PUEBLA,21,ZOQUITLÁN,217,ZOQUITLANZACUALCO,2,138,72,66,7
QUERÉTARO,22,AMEALCO DE BONFIL,001,AGUA BLANCA,2,8,4,4,2
QUERÉTARO,22,AMEALCO DE BONFIL,001,AMEALCO DE BONFIL,24,4787,2485,2302,326
QUERÉTARO,22,AMEALCO DE BONFIL,001,BARRIO DE LA CRUZ (SAN MIGUEL TLAXCALTEPEC),1,6,3,3,1
QUERÉTARO,22,AMEALCO DE BONFIL,001,BARRIO DE LA ISLA (SANTIAGO MEXQUITITLÁN BARRIO 6TO.),1,7,4,3,1
QUERÉTARO,22,AMEALCO DE BONFIL,001,BARRIO DEL BARCO (SAN MIGUEL TLAXCALTEPEC),1,8,5,3,1
QUERÉTARO,22,AMEALCO DE BONFIL,001,BARRIO DEL COYOTE (SAN BARTOLO),2,9,1,8,1
QUERÉTARO,22,AMEALCO DE BONFIL,001,BARRIO LA ESPERANZA (SAN BARTOLO),2,22,10,12,3
QUERÉTARO,22,AMEALCO DE BONFIL,001,BARRIO LA JOYA,2,45,27,18,2
QUERÉTARO,22,AMEALCO DE BONFIL,001,BARRIO PRESA DEL TECOLOTE (EL LINDERO),1,16,6,10,1
QUERÉTARO,22,AMEALCO DE BONFIL,001,BORDOS CUATES,3,44,19,25,5
QUERÉTARO,22,AMEALCO DE BONFIL,001,CERRO DEL GALLO,2,27,7,20,3
QUERÉTARO,22,AMEALCO DE BONFIL,001,CHITEJÉ DE GARABATO,5,498,253,245,21
QUERÉTARO,22,AMEALCO DE BONFIL,001,CHITEJÉ DE LA CRUZ,3,220,106,114,11
QUERÉTARO,22,AMEALCO DE BONFIL,001,CUISILLO (BARRIO DE SAN ILDEFONSO),2,94,52,42,7
QUERÉTARO,22,AMEALCO DE BONFIL,001,DONICÁ,3,315,147,168,13
QUERÉTARO,22,AMEALCO DE BONFIL,001,EJIDO DE SAN JUAN DEHEDÓ,2,117,56,61,6
QUERÉTARO,22,AMEALCO DE BONFIL,001,EJIDO EL RINCÓN (LA BOTIJA),2,14,9,5,2
QUERÉTARO,22,AMEALCO DE BONFIL,001,EL APARTADERO,4,130,58,72,7
QUERÉTARO,22,AMEALCO DE BONFIL,001,EL ASERRÍN (OJO DE AGUA DEL HORNITO),3,105,47,58,5
QUERÉTARO,22,AMEALCO DE BONFIL,001,EL ATORÓN,2,25,9,16,2
QUERÉTARO,22,AMEALCO DE BONFIL,001,EL BATÁN,3,131,67,64,7
QUERÉTARO,22,AMEALCO DE BONFIL,001,EL BOTHÉ,4,363,194,169,20
QUERÉTARO,22,AMEALCO DE BONFIL,001,EL CACAHUATE (SANTIAGO MEXQUITITLÁN BARRIO 6TO.),2,93,44,49,4
QUERÉTARO,22,AMEALCO DE BONFIL,001,EL CAPULÍN,2,25,8,17,2
QUERÉTARO,22,AMEALCO DE BONFIL,001,EL CARMEN (SANTIAGO MEXQUITITLÁN BARRIO 6TO.),1,14,8,6,1
QUERÉTARO,22,AMEALCO DE BONFIL,001,EL CERRITO,3,24,11,13,3
QUERÉTARO,22,AMEALCO DE BONFIL,001,EL COLORÍN,1,7,3,4,1
QUERÉTARO,22,AMEALCO DE BONFIL,001,EL COYOTE,2,56,18,38,3
QUERÉTARO,22,AMEALCO DE BONFIL,001,EL GRANJENO,1,48,21,27,2
QUERÉTARO,22,AMEALCO DE BONFIL,001,EL LINDERO,3,354,167,187,15
QUERÉTARO,22,AMEALCO DE BONFIL,001,EL PICACHO,2,180,85,95,8
QUERÉTARO,22,AMEALCO DE BONFIL,001,EL PINO,2,39,18,21,2
QUERÉTARO,22,AMEALCO DE BONFIL,001,EL PUEBLITO (SAN MIGUEL TLAXCALTEPEC),1,10,4,6,1
QUERÉTARO,22,AMEALCO DE BONFIL,001,EL RAYO,2,29,16,13,3
QUERÉTARO,22,AMEALCO DE BONFIL,001,EL RINCÓN,3,151,79,72,8
QUERÉTARO,22,AMEALCO DE BONFIL,001,EL RINCÓN DE AGUA BUENA (SAN MIGUEL TLAXCALTEPEC),2,30,12,18,3
QUERÉTARO,22,AMEALCO DE BONFIL,001,EL RINCÓN DE SAN ILDEFONSO,3,370,195,175,14
QUERÉTARO,22,AMEALCO DE BONFIL,001,EL SAUCITO,2,28,11,17,2
QUERÉTARO,22,AMEALCO DE BONFIL,001,EL TEPOZÁN (BARRIO DE SAN ILDEFONSO),1,5,2,3,1
QUERÉTARO,22,AMEALCO DE BONFIL,001,EL VARAL,3,220,111,109,10
QUERÉTARO,22,AMEALCO DE BONFIL,001,GALINDILLO,2,32,20,12,2
QUERÉTARO,22,AMEALCO DE BONFIL,001,GUADALUPE EL TERRERO,4,162,74,88,8
QUERÉTARO,22,AMEALCO DE BONFIL,001,HACIENDA BLANCA,3,160,88,72,8
QUERÉTARO,22,AMEALCO DE BONFIL,001,JACAL DE LA PIEDAD,3,173,84,89,7
QUERÉTARO,22,AMEALCO DE BONFIL,001,LA ALAMEDA DEL RINCÓN,5,167,88,79,9
QUERÉTARO,22,AMEALCO DE BONFIL,001,LA BEATA,2,44,28,16,2
QUERÉTARO,22,AMEALCO DE BONFIL,001,LA CAÑADA DEL VARAL,2,19,10,9,2
QUERÉTARO,22,AMEALCO DE BONFIL,001,LA CONCEPCIÓN (LA CONCHA),1,6,2,4,1
QUERÉTARO,22,AMEALCO DE BONFIL,001,LA CRUZ (SAN BARTOLO),3,68,23,45,5
QUERÉTARO,22,AMEALCO DE BONFIL,001,LA ISLA,1,18,6,12,2
QUERÉTARO,22,AMEALCO DE BONFIL,001,LA LADERA,3,165,84,81,8
QUERÉTARO,22,AMEALCO DE BONFIL,001,LA LOMA DEL ROSARIO,3,40,15,25,4
QUERÉTARO,22,AMEALCO DE BONFIL,001,LA MANZANA,2,76,41,35,3
QUERÉTARO,22,AMEALCO DE BONFIL,001,LA MESA,1,10,5,5,1
QUERÉTARO,22,AMEALCO DE BONFIL,001,LA MURALLA,3,175,84,91,7
QUERÉTARO,22,AMEALCO DE BONFIL,001,LA PINÍ,2,35,16,19,3
QUERÉTARO,22,AMEALCO DE BONFIL,001,LA SOLEDAD,2,157,81,76,6
QUERÉTARO,22,AMEALCO DE BONFIL,001,LAGUNA DE SERVÍN,4,327,181,146,14
QUERÉTARO,22,AMEALCO DE BONFIL,001,LAS GRULLAS,1,6,4,2,1
QUERÉTARO,22,AMEALCO DE BONFIL,001,LAS SALVAS,2,87,45,42,4
QUERÉTARO,22,AMEALCO DE BONFIL,001,LLANO LARGO,2,209,99,110,9
QUERÉTARO,22,AMEALCO DE BONFIL,001,LOMA DE LAS VÍBORAS (SANTIAGO MEXQUITITLÁN BARRIO 6TO.),1,35,16,19,2
QUERÉTARO,22,AMEALCO DE BONFIL,001,LOMA LINDA,2,11,7,4,2
QUERÉTARO,22,AMEALCO DE BONFIL,001,LOS ÁRBOLES,3,113,54,59,8
QUERÉTARO,22,AMEALCO DE BONFIL,001,LOS ARCOS,1,47,23,24,2
QUERÉTARO,22,AMEALCO DE BONFIL,001,LOS ARENALES (SAN JUAN DEHEDÓ),2,55,33,22,3
QUERÉTARO,22,AMEALCO DE BONFIL,001,MESA DE SAN MARTÍN,2,49,22,27,3
QUERÉTARO,22,AMEALCO DE BONFIL,001,MESILLAS,3,188,101,87,9
QUERÉTARO,22,AMEALCO DE BONFIL,001,PALOS ALTOS,2,30,13,17,2
QUERÉTARO,22,AMEALCO DE BONFIL,001,QUIOTILLOS,4,279,147,132,14
QUERÉTARO,22,AMEALCO DE BONFIL,001,RINCÓN DE LA FLORIDA,1,5,3,2,1
QUERÉTARO,22,AMEALCO DE BONFIL,001,SAN BARTOLOMÉ DEL PINO (SAN BARTOLO),3,168,78,90,8
QUERÉTARO,22,AMEALCO DE BONFIL,001,SAN FELIPE (SANTIAGO MEXQUITITLÁN BARRIO 6TO.),3,455,249,206,19
QUERÉTARO,22,AMEALCO DE BONFIL,001,SAN ILDEFONSO TULTEPEC (CENTRO),6,1823,971,852,75
QUERÉTARO,22,AMEALCO DE BONFIL,001,SAN JOSÉ ITHÓ,2,225,116,109,8
QUERÉTARO,22,AMEALCO DE BONFIL,001,SAN JUAN DEHEDÓ,2,369,182,187,14
QUERÉTARO,22,AMEALCO DE BONFIL,001,SAN MARTÍN,3,175,89,86,8
QUERÉTARO,22,AMEALCO DE BONFIL,001,SAN MIGUEL DEHETÍ,2,118,61,57,5
QUERÉTARO,22,AMEALCO DE BONFIL,001,SAN MIGUEL TLAXCALTEPEC (BARRIO CENTRO),4,540,278,262,21
QUERÉTARO,22,AMEALCO DE BONFIL,001,SAN NICOLÁS DE LA TORRE,3,766,383,383,32
QUERÉTARO,22,AMEALCO DE BONFIL,001,SAN PABLO,3,173,80,93,7
QUERÉTARO,22,AMEALCO DE BONFIL,001,SAN PEDRO TENANGO,2,26,11,15,2
QUERÉTARO,22,AMEALCO DE BONFIL,001,SANTA CLARA,2,15,11,4,2
QUERÉTARO,22,AMEALCO DE BONFIL,001,SANTIAGO MEXQUITITLÁN BARRIO 1RO.,2,339,158,181,15
QUERÉTARO,22,AMEALCO DE BONFIL,001,SANTIAGO MEXQUITITLÁN BARRIO 2DO.,2,110,52,58,7
QUERÉTARO,22,AMEALCO DE BONFIL,001,SANTIAGO MEXQUITITLÁN BARRIO 3RO.,4,263,128,135,15
QUERÉTARO,22,AMEALCO DE BONFIL,001,SANTIAGO MEXQUITITLÁN BARRIO 4TO.,4,628,324,304,31
QUERÉTARO,22,AMEALCO DE BONFIL,001,SANTIAGO MEXQUITITLÁN BARRIO 5TO. (EL PASTOREO),4,301,151,150,13
QUERÉTARO,22,AMEALCO DE BONFIL,001,TENASDÁ (BARRIO DE SAN ILDEFONSO),2,122,66,56,5
QUERÉTARO,22,AMEALCO DE BONFIL,001,TESQUEDÓ (PUERTO DEL CHIVATO),1,5,2,3,1
QUERÉTARO,22,AMEALCO DE BONFIL,001,VEINTE DE NOVIEMBRE,2,133,77,56,6
QUERÉTARO,22,AMEALCO DE BONFIL,001,XAJAY,2,130,60,70,7
QUERÉTARO,22,AMEALCO DE BONFIL,001,YOSPHÍ,2,286,140,146,16
QUERÉTARO,22,PINAL DE AMOLES,002,ADJUNTA DE GATOS,2,10,5,5,2
QUERÉTARO,22,PINAL DE AMOLES,002,AGUA AMARGA,3,126,53,73,6
QUERÉTARO,22,PINAL DE AMOLES,002,AGUA DEL MAÍZ,2,58,28,30,3
QUERÉTARO,22,PINAL DE AMOLES,002,AGUA FRÍA DE GUDIÑO,3,29,15,14,3
QUERÉTARO,22,PINAL DE AMOLES,002,AGUA FRÍA DE LA BARRANCA,1,13,5,8,1
QUERÉTARO,22,PINAL DE AMOLES,002,AGUACATE DE MORELOS,3,37,21,16,3
QUERÉTARO,22,PINAL DE AMOLES,002,AGUACATE DE SAN PEDRO,2,24,13,11,2
QUERÉTARO,22,PINAL DE AMOLES,002,AHUACATLÁN DE GUADALUPE,6,934,498,436,47
QUERÉTARO,22,PINAL DE AMOLES,002,ALEJANDRÍA DE MORELOS,3,195,101,94,9
QUERÉTARO,22,PINAL DE AMOLES,002,ARQUITOS,2,49,30,19,3
QUERÉTARO,22,PINAL DE AMOLES,002,ARROYO HONDO DE HUILOTLA,2,14,4,10,2
QUERÉTARO,22,PINAL DE AMOLES,002,BARRANCA DEL PLÁTANO,2,18,6,12,2
QUERÉTARO,22,PINAL DE AMOLES,002,BUCARELI,3,68,29,39,6
QUERÉTARO,22,PINAL DE AMOLES,002,CASAS VIEJAS (AGUA ENTERRADA SAN CARLOS),2,28,20,8,2
QUERÉTARO,22,PINAL DE AMOLES,002,CERRO DEL CARMEN,2,12,7,5,2
QUERÉTARO,22,PINAL DE AMOLES,002,CIÉNEGA DE SAN JUAN,1,27,12,15,1
QUERÉTARO,22,PINAL DE AMOLES,002,COATLÁN DE LOS ÁNGELES,2,32,17,15,2
QUERÉTARO,22,PINAL DE AMOLES,002,CUATRO PALOS,3,27,15,12,3
QUERÉTARO,22,PINAL DE AMOLES,002,CUESTA BLANCA,2,7,2,5,1
QUERÉTARO,22,PINAL DE AMOLES,002,CUESTA COLORADA DE HUAZQUILÍCO,2,18,5,13,2
QUERÉTARO,22,PINAL DE AMOLES,002,DERRAMADERO DE BUCARELI,2,98,52,46,4
QUERÉTARO,22,PINAL DE AMOLES,002,DERRAMADERO DE JUÁREZ,3,134,74,60,9
QUERÉTARO,22,PINAL DE AMOLES,002,DURAZNO DE SAN FRANCISCO,2,18,9,9,2
QUERÉTARO,22,PINAL DE AMOLES,002,EL ARPA,2,13,10,3,2
QUERÉTARO,22,PINAL DE AMOLES,002,EL CANTÓN,3,44,25,19,3
QUERÉTARO,22,PINAL DE AMOLES,002,EL CARRIZALITO,3,41,22,19,4
QUERÉTARO,22,PINAL DE AMOLES,002,EL DURAZNO GRANDE,3,28,14,14,3
QUERÉTARO,22,PINAL DE AMOLES,002,EL GALLO,3,42,23,19,4
QUERÉTARO,22,PINAL DE AMOLES,002,EL LIMÓN DE LA CRUZ,2,6,3,3,1
QUERÉTARO,22,PINAL DE AMOLES,002,EL LLANO DE HUAZQUILÍCO,3,111,63,48,6
QUERÉTARO,22,PINAL DE AMOLES,002,EL MADROÑO,3,77,31,46,5
QUERÉTARO,22,PINAL DE AMOLES,002,EL MASTRANTO,2,31,11,20,2
QUERÉTARO,22,PINAL DE AMOLES,002,EL MEZQUITE,3,11,6,5,3
QUERÉTARO,22,PINAL DE AMOLES,002,EL MURCIÉLAGO,2,15,7,8,2
QUERÉTARO,22,PINAL DE AMOLES,002,EL PEDREGAL,2,17,9,8,2
QUERÉTARO,22,PINAL DE AMOLES,002,EL PLÁTANO,2,13,8,5,2
QUERÉTARO,22,PINAL DE AMOLES,002,EL RANCHITO,3,140,78,62,8
QUERÉTARO,22,PINAL DE AMOLES,002,EL REFUGIO,2,44,23,21,3
QUERÉTARO,22,PINAL DE AMOLES,002,EL RODEZNO,2,27,13,14,2
QUERÉTARO,22,PINAL DE AMOLES,002,EL TAMBOR DE HUAZQUILÍCO,2,13,6,7,2
QUERÉTARO,22,PINAL DE AMOLES,002,EL TIMBRE DE GUADALUPE,2,31,11,20,2
QUERÉTARO,22,PINAL DE AMOLES,002,EPAZOTES GRANDES,3,70,36,34,6
QUERÉTARO,22,PINAL DE AMOLES,002,EPAZOTITOS,2,11,1,10,2
QUERÉTARO,22,PINAL DE AMOLES,002,ESCANELILLA,3,136,64,72,9
QUERÉTARO,22,PINAL DE AMOLES,002,HORNITOS,3,17,10,7,3
QUERÉTARO,22,PINAL DE AMOLES,002,HUAJALES,2,55,31,24,3
QUERÉTARO,22,PINAL DE AMOLES,002,HUILOTLA,2,30,14,16,3
QUERÉTARO,22,PINAL DE AMOLES,002,JOYAS DE BUCARELI,3,27,11,16,3
QUERÉTARO,22,PINAL DE AMOLES,002,JOYAS DEL DERRAMADERO,2,14,7,7,2
QUERÉTARO,22,PINAL DE AMOLES,002,JOYAS DEL REAL,2,28,7,21,3
QUERÉTARO,22,PINAL DE AMOLES,002,LA BARRANCA,4,112,60,52,7
QUERÉTARO,22,PINAL DE AMOLES,002,LA CAÑADA,2,43,24,19,3
QUERÉTARO,22,PINAL DE AMOLES,002,LA CEBOLLA,2,28,13,15,2
QUERÉTARO,22,PINAL DE AMOLES,002,LA CIÉNEGA,1,5,4,1,1
QUERÉTARO,22,PINAL DE AMOLES,002,LA COLGADA,3,137,66,71,7
QUERÉTARO,22,PINAL DE AMOLES,002,LA JOYA,3,13,4,9,3
QUERÉTARO,22,PINAL DE AMOLES,002,LA JOYA DE AHUACATLÁN,2,67,37,30,5
QUERÉTARO,22,PINAL DE AMOLES,002,LA MECA,2,8,5,3,2
QUERÉTARO,22,PINAL DE AMOLES,002,LA MOHONERA,3,147,74,73,9
QUERÉTARO,22,PINAL DE AMOLES,002,LA MORITA,2,66,29,37,4
QUERÉTARO,22,PINAL DE AMOLES,002,LA SIERRITA,2,10,9,1,1
QUERÉTARO,22,PINAL DE AMOLES,002,LA TINAJA,3,96,57,39,6
QUERÉTARO,22,PINAL DE AMOLES,002,LA TROJA,1,5,3,2,1
QUERÉTARO,22,PINAL DE AMOLES,002,LA YERBABUENA,2,10,5,5,1
QUERÉTARO,22,PINAL DE AMOLES,002,LAS ADJUNTAS,2,27,13,14,2
QUERÉTARO,22,PINAL DE AMOLES,002,LAS GUAYABAS,2,20,10,10,2
QUERÉTARO,22,PINAL DE AMOLES,002,LAS MESAS DE SANTA INÉS,2,32,16,16,3
QUERÉTARO,22,PINAL DE AMOLES,002,LAS MESITAS,1,34,21,13,2
QUERÉTARO,22,PINAL DE AMOLES,002,LLANO DE SAN FRANCISCO,3,62,32,30,4
QUERÉTARO,22,PINAL DE AMOLES,002,LOMA DE GUADALUPE,3,13,5,8,2
QUERÉTARO,22,PINAL DE AMOLES,002,LOMA LARGA (SANTA CECILIA),2,26,10,16,2
QUERÉTARO,22,PINAL DE AMOLES,002,LOS PINOS,3,83,40,43,6
QUERÉTARO,22,PINAL DE AMOLES,002,MABY,3,45,26,19,4
QUERÉTARO,22,PINAL DE AMOLES,002,MAGUEY BLANCO,3,86,50,36,6
QUERÉTARO,22,PINAL DE AMOLES,002,MAGUEYCITOS,2,22,12,10,2
QUERÉTARO,22,PINAL DE AMOLES,002,MESA DE RAMÍREZ,1,2,0,2,1
QUERÉTARO,22,PINAL DE AMOLES,002,PEÑA ALTA,1,5,3,2,1
QUERÉTARO,22,PINAL DE AMOLES,002,PIE DE LA CUESTA,2,24,12,12,2
QUERÉTARO,22,PINAL DE AMOLES,002,PINAL DE AMOLES,9,1082,565,517,80
QUERÉTARO,22,PINAL DE AMOLES,002,POTRERILLOS,2,14,6,8,2
QUERÉTARO,22,PINAL DE AMOLES,002,PUERTO COLORADO,2,54,27,27,3
QUERÉTARO,22,PINAL DE AMOLES,002,PUERTO DE ESCANELILLA,2,88,42,46,6
QUERÉTARO,22,PINAL DE AMOLES,002,PUERTO DE PUJUNGUÍA,2,26,10,16,2
QUERÉTARO,22,PINAL DE AMOLES,002,PUERTO DE TEJAMANÍL,2,33,16,17,2
QUERÉTARO,22,PINAL DE AMOLES,002,PUERTO DE VIGAS,2,39,24,15,3
QUERÉTARO,22,PINAL DE AMOLES,002,PUERTO DEL DERRAMADERO,3,94,43,51,5
QUERÉTARO,22,PINAL DE AMOLES,002,PUERTO DEL RODEZNO,2,11,5,6,2
QUERÉTARO,22,PINAL DE AMOLES,002,QUIRAMBAL,2,41,26,15,3
QUERÉTARO,22,PINAL DE AMOLES,002,RANCHO NUEVO,3,42,16,26,3
QUERÉTARO,22,PINAL DE AMOLES,002,RANCHO NUEVO DOS,3,37,17,20,4
QUERÉTARO,22,PINAL DE AMOLES,002,RÍO ESCANELA,2,58,26,32,4
QUERÉTARO,22,PINAL DE AMOLES,002,SAN ANTONIO DEL PELÓN,2,8,4,4,1
QUERÉTARO,22,PINAL DE AMOLES,002,SAN GASPAR,3,100,49,51,7
QUERÉTARO,22,PINAL DE AMOLES,002,SAN ISIDRO,6,102,36,66,7
QUERÉTARO,22,PINAL DE AMOLES,002,SAN PEDRO ESCANELA,4,342,192,150,16
QUERÉTARO,22,PINAL DE AMOLES,002,SAN PEDRO VIEJO,4,339,171,168,14
QUERÉTARO,22,PINAL DE AMOLES,002,SANTA ÁGUEDA,4,286,156,130,13
QUERÉTARO,22,PINAL DE AMOLES,002,SAUZ DE GUADALUPE,4,231,110,121,12
QUERÉTARO,22,PINAL DE AMOLES,002,TEMAZCALES,2,20,11,9,2
QUERÉTARO,22,PINAL DE AMOLES,002,TONATICO,3,102,56,46,8
QUERÉTARO,22,PINAL DE AMOLES,002,TRES CRUCES,2,13,6,7,2
QUERÉTARO,22,ARROYO SECO,003,ALPUJARRAS,1,10,8,2,1
QUERÉTARO,22,ARROYO SECO,003,ARROYO SECO,4,604,305,299,35
QUERÉTARO,22,ARROYO SECO,003,AYUTLA,2,34,12,22,3
QUERÉTARO,22,ARROYO SECO,003,CONCÁ,6,749,369,380,60
QUERÉTARO,22,ARROYO SECO,003,EL AGUACATE,2,32,19,13,2
QUERÉTARO,22,ARROYO SECO,003,EL CRUCERO DEL SABINITO,1,10,6,4,1
QUERÉTARO,22,ARROYO SECO,003,EL JARDÍN,2,18,11,7,2
QUERÉTARO,22,ARROYO SECO,003,EL POCITO,2,8,3,5,2
QUERÉTARO,22,ARROYO SECO,003,EL QUIRINO,2,50,31,19,3
QUERÉTARO,22,ARROYO SECO,003,EL REFUGIO,3,184,86,98,10
QUERÉTARO,22,ARROYO SECO,003,EL SABINITO,1,4,0,4,1
QUERÉTARO,22,ARROYO SECO,003,EL SABINO,1,3,2,1,1
QUERÉTARO,22,ARROYO SECO,003,EL SALITRILLO,2,28,14,14,2
QUERÉTARO,22,ARROYO SECO,003,EL TEPOZÁN,2,41,22,19,2
QUERÉTARO,22,ARROYO SECO,003,EL TRAPICHE,1,21,11,10,1
QUERÉTARO,22,ARROYO SECO,003,LA CIÉNEGA,1,3,1,2,1
QUERÉTARO,22,ARROYO SECO,003,LA FLORIDA,4,125,64,61,9
QUERÉTARO,22,ARROYO SECO,003,LA LAGUNITA,1,14,5,9,1
QUERÉTARO,22,ARROYO SECO,003,LA MOHONERA,2,28,18,10,2
QUERÉTARO,22,ARROYO SECO,003,LAGUNA DE LA CRUZ,2,9,4,5,2
QUERÉTARO,22,ARROYO SECO,003,LAS TRANCAS,3,210,113,97,9
QUERÉTARO,22,ARROYO SECO,003,MESA DE PALO BLANCO,2,16,11,5,2
QUERÉTARO,22,ARROYO SECO,003,MESAS DE AGUA FRÍA,2,22,12,10,2
QUERÉTARO,22,ARROYO SECO,003,PURÍSIMA DE ARISTA,5,834,408,426,43
QUERÉTARO,22,ARROYO SECO,003,RÍO DEL CARRIZAL,2,24,9,15,2
QUERÉTARO,22,ARROYO SECO,003,SAN JOSÉ DE LAS FLORES,2,32,12,20,2
QUERÉTARO,22,ARROYO SECO,003,SAN JOSÉ DEL TEPAME,1,7,2,5,1
QUERÉTARO,22,ARROYO SECO,003,SAN JUAN BUENAVENTURA,3,78,35,43,6
QUERÉTARO,22,ARROYO SECO,003,SANGUIJUELA,2,15,6,9,2
QUERÉTARO,22,ARROYO SECO,003,SANTA MARÍA DE LOS COCOS,5,119,62,57,11
QUERÉTARO,22,CADEREYTA DE MONTES,004,ADJUNTITAS DOS,2,19,12,7,2
QUERÉTARO,22,CADEREYTA DE MONTES,004,ADJUNTITAS UNO,1,2,0,2,1
QUERÉTARO,22,CADEREYTA DE MONTES,004,AGUA FRÍA,2,8,5,3,1
QUERÉTARO,22,CADEREYTA DE MONTES,004,ALTAMIRA (LA BONDOTITA),3,69,32,37,6
QUERÉTARO,22,CADEREYTA DE MONTES,004,ARROYO DE ZITUNÍ,1,14,9,5,1
QUERÉTARO,22,CADEREYTA DE MONTES,004,BANTHÍ,2,17,9,8,2
QUERÉTARO,22,CADEREYTA DE MONTES,004,BARRANCA DEL SORDO,2,13,7,6,2
QUERÉTARO,22,CADEREYTA DE MONTES,004,BARRIO DE GUADALUPE (CHARCO FRÍO),2,68,34,34,3
QUERÉTARO,22,CADEREYTA DE MONTES,004,BARRIO DE SANTIAGO (CHARCO FRÍO),4,132,68,64,7
QUERÉTARO,22,CADEREYTA DE MONTES,004,BARRIO SOLARES,1,3,0,3,1
QUERÉTARO,22,CADEREYTA DE MONTES,004,BELLA VISTA DEL RÍO,6,631,302,329,30
QUERÉTARO,22,CADEREYTA DE MONTES,004,BOXASNÍ,3,605,288,317,22
QUERÉTARO,22,CADEREYTA DE MONTES,004,BOYÉ,5,286,143,143,14
QUERÉTARO,22,CADEREYTA DE MONTES,004,BOYECITO,2,118,56,62,7
QUERÉTARO,22,CADEREYTA DE MONTES,004,CADEREYTA DE MONTES,30,6059,3154,2905,330
QUERÉTARO,22,CADEREYTA DE MONTES,004,CAMARONES,3,128,63,65,8
QUERÉTARO,22,CADEREYTA DE MONTES,004,CARRICILLO,2,63,37,26,4
QUERÉTARO,22,CADEREYTA DE MONTES,004,CERRO BLANCO,2,15,7,8,2
QUERÉTARO,22,CADEREYTA DE MONTES,004,CERRO BOLUDO,2,13,5,8,2
QUERÉTARO,22,CADEREYTA DE MONTES,004,CERRO COLORADO,1,5,2,3,1
QUERÉTARO,22,CADEREYTA DE MONTES,004,CERRO PRIETO,3,195,91,104,9
QUERÉTARO,22,CADEREYTA DE MONTES,004,CHAVARRÍAS,3,111,57,54,6
QUERÉTARO,22,CADEREYTA DE MONTES,004,CORRAL BLANCO,3,70,28,42,5
QUERÉTARO,22,CADEREYTA DE MONTES,004,EL AGUACATE,4,176,96,80,13
QUERÉTARO,22,CADEREYTA DE MONTES,004,EL ARBOLITO,2,15,6,9,2
QUERÉTARO,22,CADEREYTA DE MONTES,004,EL BANCO,2,84,36,48,3
QUERÉTARO,22,CADEREYTA DE MONTES,004,EL CHILAR,2,31,16,15,2
QUERÉTARO,22,CADEREYTA DE MONTES,004,EL DEVISADERO,3,55,25,30,4
QUERÉTARO,22,CADEREYTA DE MONTES,004,EL DIVINO PASTOR,2,12,5,7,2
QUERÉTARO,22,CADEREYTA DE MONTES,004,EL DOCTOR,3,68,30,38,5
QUERÉTARO,22,CADEREYTA DE MONTES,004,EL HORTELANO,1,3,1,2,1
QUERÉTARO,22,CADEREYTA DE MONTES,004,EL HUIZACHE,2,24,21,3,2
QUERÉTARO,22,CADEREYTA DE MONTES,004,EL MEMBRILLO,2,55,25,30,3
QUERÉTARO,22,CADEREYTA DE MONTES,004,EL NARANJO,2,4,2,2,2
QUERÉTARO,22,CADEREYTA DE MONTES,004,EL PALMAR (SANTA MARÍA DEL PALMAR),5,996,521,475,55
QUERÉTARO,22,CADEREYTA DE MONTES,004,EL PINALITO,3,64,29,35,4
QUERÉTARO,22,CADEREYTA DE MONTES,004,EL RANCHITO,3,56,21,35,3
QUERÉTARO,22,CADEREYTA DE MONTES,004,EL RINCÓN,4,567,274,293,22
QUERÉTARO,22,CADEREYTA DE MONTES,004,EL SOCAVÓN,2,10,5,5,2
QUERÉTARO,22,CADEREYTA DE MONTES,004,EL SOYATAL,2,51,20,31,3
QUERÉTARO,22,CADEREYTA DE MONTES,004,EL SUSPIRO,2,22,14,8,2
QUERÉTARO,22,CADEREYTA DE MONTES,004,EL TEPOZÁN,1,3,2,1,1
QUERÉTARO,22,CADEREYTA DE MONTES,004,EL TERRERO,2,99,49,50,5
QUERÉTARO,22,CADEREYTA DE MONTES,004,EL TORNO,3,6,3,3,3
QUERÉTARO,22,CADEREYTA DE MONTES,004,HIGUERILLAS,4,366,185,181,16
QUERÉTARO,22,CADEREYTA DE MONTES,004,JABALÍ,2,22,4,18,2
QUERÉTARO,22,CADEREYTA DE MONTES,004,LA ADARGA,2,8,5,3,2
QUERÉTARO,22,CADEREYTA DE MONTES,004,LA BLANCA,2,11,4,7,2
QUERÉTARO,22,CADEREYTA DE MONTES,004,LA CALERA (LOS GUERREROS),2,18,8,10,2
QUERÉTARO,22,CADEREYTA DE MONTES,004,LA CARBONERA,2,8,2,6,2
QUERÉTARO,22,CADEREYTA DE MONTES,004,LA CULATA,2,58,30,28,3
QUERÉTARO,22,CADEREYTA DE MONTES,004,LA ESPERANZA,3,116,60,56,7
QUERÉTARO,22,CADEREYTA DE MONTES,004,LA FLORIDA,3,56,21,35,4
QUERÉTARO,22,CADEREYTA DE MONTES,004,LA LAGUNITA,2,11,4,7,2
QUERÉTARO,22,CADEREYTA DE MONTES,004,LA LAJA,3,148,81,67,9
QUERÉTARO,22,CADEREYTA DE MONTES,004,LA LOMA BONITA,2,23,10,13,2
QUERÉTARO,22,CADEREYTA DE MONTES,004,LA LUZ (CARRIZALITO),3,13,10,3,3
QUERÉTARO,22,CADEREYTA DE MONTES,004,LA MESA,2,8,5,3,2
QUERÉTARO,22,CADEREYTA DE MONTES,004,LA MESA PROVIDENCIA,1,12,4,8,1
QUERÉTARO,22,CADEREYTA DE MONTES,004,LA MOJONERA,2,4,2,2,2
QUERÉTARO,22,CADEREYTA DE MONTES,004,LA MORA,3,34,19,15,4
QUERÉTARO,22,CADEREYTA DE MONTES,004,LA NOPALERA,2,18,10,8,2
QUERÉTARO,22,CADEREYTA DE MONTES,004,LA PASTILLA,2,22,14,8,2
QUERÉTARO,22,CADEREYTA DE MONTES,004,LA PRESA (LA NUEVA PRESITA),2,34,15,19,2
QUERÉTARO,22,CADEREYTA DE MONTES,004,LA PUERTA,3,106,55,51,6
QUERÉTARO,22,CADEREYTA DE MONTES,004,LA RINCONADA,2,51,29,22,3
QUERÉTARO,22,CADEREYTA DE MONTES,004,LA TINAJA,2,46,25,21,3
QUERÉTARO,22,CADEREYTA DE MONTES,004,LA VERACRUZ,3,34,19,15,4
QUERÉTARO,22,CADEREYTA DE MONTES,004,LAS AGUAS,2,5,3,2,2
QUERÉTARO,22,CADEREYTA DE MONTES,004,LAS JOYAS,5,36,18,18,5
QUERÉTARO,22,CADEREYTA DE MONTES,004,LAS LOMAS,1,13,8,5,1
QUERÉTARO,22,CADEREYTA DE MONTES,004,LAS VIGUITAS,2,26,11,15,2
QUERÉTARO,22,CADEREYTA DE MONTES,004,LLANITOS DE SANTA BÁRBARA,2,41,20,21,3
QUERÉTARO,22,CADEREYTA DE MONTES,004,LOMA DE GUADALUPE,2,15,8,7,2
QUERÉTARO,22,CADEREYTA DE MONTES,004,LOS AMOLITOS,2,116,57,59,5
QUERÉTARO,22,CADEREYTA DE MONTES,004,LOS HERNÁNDEZ,3,21,12,9,3
QUERÉTARO,22,CADEREYTA DE MONTES,004,LOS JUÁREZ,6,174,76,98,13
QUERÉTARO,22,CADEREYTA DE MONTES,004,LOS LIRIOS,2,14,8,6,2
QUERÉTARO,22,CADEREYTA DE MONTES,004,LOS LLANITOS DE PATHÉ,2,58,30,28,4
QUERÉTARO,22,CADEREYTA DE MONTES,004,LOS MAQUEDA,2,43,19,24,3
QUERÉTARO,22,CADEREYTA DE MONTES,004,LOS MATEOS,2,11,3,8,2
QUERÉTARO,22,CADEREYTA DE MONTES,004,LOS PALMITOS,2,4,3,1,2
QUERÉTARO,22,CADEREYTA DE MONTES,004,LOS PIÑONES,2,42,22,20,3
QUERÉTARO,22,CADEREYTA DE MONTES,004,LOS REMEDIOS,2,17,9,8,2
QUERÉTARO,22,CADEREYTA DE MONTES,004,LOS RÍOS,2,34,18,16,3
QUERÉTARO,22,CADEREYTA DE MONTES,004,MACONÍ,4,334,164,170,14
QUERÉTARO,22,CADEREYTA DE MONTES,004,MESA DE LEÓN,2,62,37,25,3
QUERÉTARO,22,CADEREYTA DE MONTES,004,MESA DEL CASTILLO (LA FAJILLA),4,62,29,33,4
QUERÉTARO,22,CADEREYTA DE MONTES,004,MINTEHÉ,2,73,30,43,3
QUERÉTARO,22,CADEREYTA DE MONTES,004,OCOTITLÁN,1,77,35,42,3
QUERÉTARO,22,CADEREYTA DE MONTES,004,PATHÉ,4,159,76,83,9
QUERÉTARO,22,CADEREYTA DE MONTES,004,PIE DE LA LOMA,1,5,1,4,1
QUERÉTARO,22,CADEREYTA DE MONTES,004,PORTEZUELO,3,176,84,92,8
QUERÉTARO,22,CADEREYTA DE MONTES,004,PUERTO DE CHIQUIHUITE,1,34,19,15,2
QUERÉTARO,22,CADEREYTA DE MONTES,004,PUERTO DE LA CONCEPCIÓN,2,127,71,56,4
QUERÉTARO,22,CADEREYTA DE MONTES,004,PUERTO DE LA LUZ,3,184,96,88,9
QUERÉTARO,22,CADEREYTA DE MONTES,004,PUERTO DEL SALITRE,3,117,53,64,7
QUERÉTARO,22,CADEREYTA DE MONTES,004,PUERTO DEL ZENTHÉ,2,9,7,2,2
QUERÉTARO,22,CADEREYTA DE MONTES,004,RANCHO DE GUADALUPE,2,70,36,34,4
QUERÉTARO,22,CADEREYTA DE MONTES,004,RANCHO LA HONDA (SAN NICOLÁS),3,38,20,18,3
QUERÉTARO,22,CADEREYTA DE MONTES,004,RANCHO LOS ARTEAGA,1,10,5,5,1
QUERÉTARO,22,CADEREYTA DE MONTES,004,RANCHO NUEVO SOMBRERETE,2,54,27,27,3
QUERÉTARO,22,CADEREYTA DE MONTES,004,RANCHO QUEMADO,2,49,26,23,2
QUERÉTARO,22,CADEREYTA DE MONTES,004,SAN ANTONIO DE LA CAÑADA,2,44,17,27,3
QUERÉTARO,22,CADEREYTA DE MONTES,004,SAN JAVIER,5,549,293,256,23
QUERÉTARO,22,CADEREYTA DE MONTES,004,SAN JOSÉ DEL CATITEO,2,39,14,25,2
QUERÉTARO,22,CADEREYTA DE MONTES,004,SAN JOSÉ TEPOZÁN,3,94,49,45,6
QUERÉTARO,22,CADEREYTA DE MONTES,004,SAN JUAN DE ENRAMADAS,2,20,10,10,3
QUERÉTARO,22,CADEREYTA DE MONTES,004,SAN JUAN DE LA ROSA,2,56,30,26,3
QUERÉTARO,22,CADEREYTA DE MONTES,004,SAN MARTÍN FLORIDA,3,266,126,140,10
QUERÉTARO,22,CADEREYTA DE MONTES,004,SANTA BÁRBARA,2,102,52,50,4
QUERÉTARO,22,CADEREYTA DE MONTES,004,SANTA MARÍA DE GRACIA,2,11,5,6,2
QUERÉTARO,22,CADEREYTA DE MONTES,004,SANTO TOMÁS,2,10,4,6,2
QUERÉTARO,22,CADEREYTA DE MONTES,004,SOMBRERETE,4,328,166,162,14
QUERÉTARO,22,CADEREYTA DE MONTES,004,TAXHIDÓ,2,5,2,3,2
QUERÉTARO,22,CADEREYTA DE MONTES,004,TZIBANTZÁ,3,150,88,62,8
QUERÉTARO,22,CADEREYTA DE MONTES,004,TZIQUIA,2,43,22,21,3
QUERÉTARO,22,CADEREYTA DE MONTES,004,VILLA GUERRERO,3,403,211,192,16
QUERÉTARO,22,CADEREYTA DE MONTES,004,VILLA NUEVA,2,67,42,25,3
QUERÉTARO,22,CADEREYTA DE MONTES,004,VIZARRÓN DE MONTES,6,907,489,418,43
QUERÉTARO,22,CADEREYTA DE MONTES,004,XIDHÍ,2,19,14,5,2
QUERÉTARO,22,CADEREYTA DE MONTES,004,XODHÉ,2,21,11,10,2
QUERÉTARO,22,CADEREYTA DE MONTES,004,YONTHÉ,4,190,85,105,9
QUERÉTARO,22,CADEREYTA DE MONTES,004,ZITUNÍ,2,239,116,123,8
QUERÉTARO,22,COLÓN,005,AHILITOS,1,7,5,2,1
QUERÉTARO,22,COLÓN,005,AJUCHITLÁN,6,1623,820,803,67
QUERÉTARO,22,COLÓN,005,COLÓN,13,1551,725,826,87
QUERÉTARO,22,COLÓN,005,EJIDO PATRIA,3,262,148,114,11
QUERÉTARO,22,COLÓN,005,EL BLANCO,4,890,441,449,31
QUERÉTARO,22,COLÓN,005,EL CARRIZAL,2,34,14,20,2
QUERÉTARO,22,COLÓN,005,EL COYOTE,4,275,137,138,15
QUERÉTARO,22,COLÓN,005,EL FUENTEÑO,3,28,18,10,3
QUERÉTARO,22,COLÓN,005,EL GALLO,3,391,190,201,16
QUERÉTARO,22,COLÓN,005,EL LINDERO,4,1964,1056,908,68
QUERÉTARO,22,COLÓN,005,EL MEZOTE,2,65,33,32,3
QUERÉTARO,22,COLÓN,005,EL POLEO,2,103,46,57,4
QUERÉTARO,22,COLÓN,005,EL SAUCILLO,3,250,120,130,11
QUERÉTARO,22,COLÓN,005,EL ZAMORANO,4,512,266,246,22
QUERÉTARO,22,COLÓN,005,ESPERANZA,7,2219,1069,1150,161
QUERÉTARO,22,COLÓN,005,GALERAS,6,3011,947,2064,89
QUERÉTARO,22,COLÓN,005,LA CARBONERA,4,441,215,226,18
QUERÉTARO,22,COLÓN,005,LA JOYA,3,9,5,4,3
QUERÉTARO,22,COLÓN,005,LA PILA,2,25,13,12,2
QUERÉTARO,22,COLÓN,005,LA ZORRA,2,79,43,36,4
QUERÉTARO,22,COLÓN,005,LAS CENIZAS,3,275,135,140,11
QUERÉTARO,22,COLÓN,005,LOS BENITOS,2,286,149,137,9
QUERÉTARO,22,COLÓN,005,LOS QUIOTES (SAN JOSÉ LOS QUIOTES),2,161,68,93,7
QUERÉTARO,22,COLÓN,005,LOS TRIGOS,3,50,19,31,5
QUERÉTARO,22,COLÓN,005,MÉXICO LINDO,2,191,106,85,8
QUERÉTARO,22,COLÓN,005,NOGALES,3,276,140,136,11
QUERÉTARO,22,COLÓN,005,NUEVO ÁLAMOS,2,53,30,23,3
QUERÉTARO,22,COLÓN,005,PALMAS,2,162,82,80,8
QUERÉTARO,22,COLÓN,005,PEÑA COLORADA,4,346,178,168,13
QUERÉTARO,22,COLÓN,005,PUERTA DE ENMEDIO,3,213,106,107,11
QUERÉTARO,22,COLÓN,005,PUERTO DE SAN ANTONIO,2,4,1,3,2
QUERÉTARO,22,COLÓN,005,PURÍSIMA DE CUBOS (LA PURÍSIMA),2,332,160,172,12
QUERÉTARO,22,COLÓN,005,SALITRERA (PRESA DE LA SOLEDAD),2,63,28,35,4
QUERÉTARO,22,COLÓN,005,SAN FRANCISCO,2,156,73,83,7
QUERÉTARO,22,COLÓN,005,SAN ILDEFONSO,4,667,326,341,24
QUERÉTARO,22,COLÓN,005,SAN JOSÉ LA PEÑUELA (LA PEÑUELA),4,661,330,331,22
QUERÉTARO,22,COLÓN,005,SAN MARTÍN,3,380,199,181,13
QUERÉTARO,22,COLÓN,005,SAN VICENTE EL ALTO (SAN VICENTE),2,261,143,118,9
QUERÉTARO,22,COLÓN,005,SANTA MARÍA DE GUADALUPE,2,84,40,44,15
QUERÉTARO,22,COLÓN,005,SANTA ROSA DE LIMA (SANTA ROSA POBLADO),3,580,315,265,19
QUERÉTARO,22,COLÓN,005,SANTA ROSA FINCA,2,282,134,148,9
QUERÉTARO,22,COLÓN,005,TIERRA ADENTRO,2,3,1,2,2
QUERÉTARO,22,COLÓN,005,TIERRA DURA,2,70,37,33,4
QUERÉTARO,22,COLÓN,005,URECHO,4,560,280,280,22
QUERÉTARO,22,COLÓN,005,VIBORILLAS,2,235,115,120,8
QUERÉTARO,22,COLÓN,005,VISTA HERMOSA,3,238,117,121,11
QUERÉTARO,22,CORREGIDORA,006,ARROYO HONDO,2,52,28,24,3
QUERÉTARO,22,CORREGIDORA,006,BRAVO,4,1199,632,567,55
QUERÉTARO,22,CORREGIDORA,006,CHARCO BLANCO,5,568,286,282,27
QUERÉTARO,22,CORREGIDORA,006,EL CALICHAR,2,63,25,38,3
QUERÉTARO,22,CORREGIDORA,006,EL JARAL,3,490,237,253,20
QUERÉTARO,22,CORREGIDORA,006,EL PROGRESO (LAS TROJAS),2,55,26,29,3
QUERÉTARO,22,CORREGIDORA,006,EL PUEBLITO,185,29831,15020,14811,1929
QUERÉTARO,22,CORREGIDORA,006,EL ROMERAL,2,155,77,78,7
QUERÉTARO,22,CORREGIDORA,006,LA CANTERA,2,20,7,13,2
QUERÉTARO,22,CORREGIDORA,006,LA CUEVA,4,614,303,311,22
QUERÉTARO,22,CORREGIDORA,006,LA NEGRETA,1,288,135,153,9
QUERÉTARO,22,CORREGIDORA,006,LA POZA,2,43,24,19,3
QUERÉTARO,22,CORREGIDORA,006,LA PURÍSIMA DE LA CUEVA,2,108,47,61,5
QUERÉTARO,22,CORREGIDORA,006,LOMAS DE ZARAGOZA,2,34,18,16,2
QUERÉTARO,22,CORREGIDORA,006,LOS ÁNGELES,5,2022,1009,1013,84
QUERÉTARO,22,CORREGIDORA,006,LOS OLVERA,29,5536,2673,2863,433
QUERÉTARO,22,CORREGIDORA,006,LOURDES,3,510,248,262,14
QUERÉTARO,22,CORREGIDORA,006,PITA,1,43,18,25,2
QUERÉTARO,22,CORREGIDORA,006,PRESA DE BRAVO,3,749,372,377,84
QUERÉTARO,22,CORREGIDORA,006,PUERTA DE SAN RAFAEL,2,159,78,81,7
QUERÉTARO,22,CORREGIDORA,006,PURÍSIMA DE SAN RAFAEL,2,169,84,85,7
QUERÉTARO,22,CORREGIDORA,006,SAN FRANCISCO,8,773,429,344,73
QUERÉTARO,22,CORREGIDORA,006,SAN JOSÉ DE LOS OLVERA,20,3504,1826,1678,185
QUERÉTARO,22,CORREGIDORA,006,SAN RAFAEL,3,351,164,187,22
QUERÉTARO,22,CORREGIDORA,006,SANTA FE [RESIDENCIAL],1,52,20,32,4
QUERÉTARO,22,CORREGIDORA,006,VENCEREMOS,5,1279,616,663,43
QUERÉTARO,22,EZEQUIEL MONTES,007,ALFREDO V. BONFIL (LOS PÉREZ),1,132,63,69,6
QUERÉTARO,22,EZEQUIEL MONTES,007,BARRERAS,2,63,29,34,4
QUERÉTARO,22,EZEQUIEL MONTES,007,BERNAL,6,1326,670,656,63
QUERÉTARO,22,EZEQUIEL MONTES,007,EJIDO LOS PÉREZ,1,38,16,22,2
QUERÉTARO,22,EZEQUIEL MONTES,007,EL BONDOTAL,2,43,22,21,3
QUERÉTARO,22,EZEQUIEL MONTES,007,EL CARDONAL (LA TIJERA),2,83,35,48,4
QUERÉTARO,22,EZEQUIEL MONTES,007,EL CIERVO,3,372,185,187,12
QUERÉTARO,22,EZEQUIEL MONTES,007,EL COYOTE,2,25,10,15,2
QUERÉTARO,22,EZEQUIEL MONTES,007,EL JAGÜEY GRANDE,2,142,68,74,5
QUERÉTARO,22,EZEQUIEL MONTES,007,EZEQUIEL MONTES,26,4248,2121,2127,208
QUERÉTARO,22,EZEQUIEL MONTES,007,GUANAJUATITO,2,63,30,33,3
QUERÉTARO,22,EZEQUIEL MONTES,007,LA NUEVA UNIDAD,2,251,126,125,8
QUERÉTARO,22,EZEQUIEL MONTES,007,LA PROVIDENCIA (LAS NORBERTAS),1,60,26,34,2
QUERÉTARO,22,EZEQUIEL MONTES,007,LA PURÍSIMA,7,1651,876,775,104
QUERÉTARO,22,EZEQUIEL MONTES,007,LAS ROSAS,2,37,11,26,3
QUERÉTARO,22,EZEQUIEL MONTES,007,LOBERAS,3,54,31,23,3
QUERÉTARO,22,EZEQUIEL MONTES,007,LOS RAMÍREZ,3,55,28,27,4
QUERÉTARO,22,EZEQUIEL MONTES,007,LOS SÁNCHEZ,2,50,31,19,3
QUERÉTARO,22,EZEQUIEL MONTES,007,PALO SECO,2,41,21,20,2
QUERÉTARO,22,EZEQUIEL MONTES,007,PIEDRAS NEGRAS,2,95,49,46,5
QUERÉTARO,22,EZEQUIEL MONTES,007,SAN ANTONIO,2,54,26,28,3
QUERÉTARO,22,EZEQUIEL MONTES,007,SAN JOSÉ DE LOS TREJO (LAS ADELITAS),2,33,18,15,2
QUERÉTARO,22,EZEQUIEL MONTES,007,SAN JOSÉ DEL JAGÜEY,3,375,194,181,15
QUERÉTARO,22,EZEQUIEL MONTES,007,SOMBRERETE,2,26,18,8,2
QUERÉTARO,22,EZEQUIEL MONTES,007,TUNAS BLANCAS,2,141,74,67,5
QUERÉTARO,22,EZEQUIEL MONTES,007,VILLA NUEVA,1,6,2,4,1
QUERÉTARO,22,EZEQUIEL MONTES,007,VILLA PROGRESO,10,2393,1221,1172,114
QUERÉTARO,22,HUIMILPAN,008,APAPÁTARO,3,309,143,166,11
QUERÉTARO,22,HUIMILPAN,008,BUENAVISTA,3,211,115,96,10
QUERÉTARO,22,HUIMILPAN,008,CAPULA,1,6,2,4,1
QUERÉTARO,22,HUIMILPAN,008,CARRANZA (SAN ANTONIO),2,102,50,52,4
QUERÉTARO,22,HUIMILPAN,008,CEJA DE BRAVO,3,283,126,157,11
QUERÉTARO,22,HUIMILPAN,008,EL BIMBALETE,1,25,9,16,2
QUERÉTARO,22,HUIMILPAN,008,EL GARRUÑAL (SAN FELIPE DE JESÚS),1,23,15,8,2
QUERÉTARO,22,HUIMILPAN,008,EL GRANJENO,2,91,50,41,5
QUERÉTARO,22,HUIMILPAN,008,EL MILAGRO,3,439,225,214,19
QUERÉTARO,22,HUIMILPAN,008,EL PERAL,2,40,21,19,2
QUERÉTARO,22,HUIMILPAN,008,EL RINCÓN,1,5,2,3,1
QUERÉTARO,22,HUIMILPAN,008,EL SALITRILLO,2,54,28,26,3
QUERÉTARO,22,HUIMILPAN,008,EL SALTO,1,8,4,4,1
QUERÉTARO,22,HUIMILPAN,008,EL SAUZ,2,54,26,28,3
QUERÉTARO,22,HUIMILPAN,008,EL VEGIL,5,792,386,406,36
QUERÉTARO,22,HUIMILPAN,008,EL ZORRILLO (SANTA CRUZ),2,69,32,37,3
QUERÉTARO,22,HUIMILPAN,008,GUADALUPE PRIMERO,2,152,77,75,6
QUERÉTARO,22,HUIMILPAN,008,HUIMILPAN,7,1858,1050,808,61
QUERÉTARO,22,HUIMILPAN,008,HUITRÓN,3,173,85,88,7
QUERÉTARO,22,HUIMILPAN,008,LA CEJA,2,268,139,129,8
QUERÉTARO,22,HUIMILPAN,008,LA CUESTA,2,62,31,31,3
QUERÉTARO,22,HUIMILPAN,008,LA HACIENDITA,1,14,5,9,1
QUERÉTARO,22,HUIMILPAN,008,LA JOYA,2,46,24,22,3
QUERÉTARO,22,HUIMILPAN,008,LA MESITA LAGUNILLAS,1,8,2,6,1
QUERÉTARO,22,HUIMILPAN,008,LA NORIA,3,433,213,220,16
QUERÉTARO,22,HUIMILPAN,008,LA NUEVA JOYA,2,56,31,25,3
QUERÉTARO,22,HUIMILPAN,008,LA PEÑA,2,43,21,22,2
QUERÉTARO,22,HUIMILPAN,008,LA PRESITA (PALO BLANCO),1,8,1,7,1
QUERÉTARO,22,HUIMILPAN,008,LA TRASQUILA,1,82,58,24,6
QUERÉTARO,22,HUIMILPAN,008,LAGUNILLAS,4,752,364,388,25
QUERÉTARO,22,HUIMILPAN,008,LAS MONJAS,1,5,3,2,1
QUERÉTARO,22,HUIMILPAN,008,LAS TAPONAS,4,535,266,269,22
QUERÉTARO,22,HUIMILPAN,008,LOS BORDOS,2,67,30,37,4
QUERÉTARO,22,HUIMILPAN,008,LOS CUES,3,587,279,308,21
QUERÉTARO,22,HUIMILPAN,008,LOS TIMOTEO,3,19,8,11,3
QUERÉTARO,22,HUIMILPAN,008,NEVERÍA II,1,7,4,3,1
QUERÉTARO,22,HUIMILPAN,008,NEVERÍA SECTOR NORTE (NEVERÍAS LOS MARTÍNEZ),1,16,10,6,1
QUERÉTARO,22,HUIMILPAN,008,PANIAGUA,4,343,189,154,16
QUERÉTARO,22,HUIMILPAN,008,PIEDRAS LISAS,2,90,40,50,5
QUERÉTARO,22,HUIMILPAN,008,PÍO XII,2,30,13,17,2
QUERÉTARO,22,HUIMILPAN,008,PUERTA DEL TEPOZÁN,2,78,41,37,3
QUERÉTARO,22,HUIMILPAN,008,SAN ANTONIO LA GALERA,2,201,103,98,8
QUERÉTARO,22,HUIMILPAN,008,SAN FRANCISCO (SAN FRANCISCO NEVERÍA),2,59,33,26,3
QUERÉTARO,22,HUIMILPAN,008,SAN IGNACIO,4,323,172,151,14
QUERÉTARO,22,HUIMILPAN,008,SAN JOSÉ TEPUZAS,3,265,126,139,11
QUERÉTARO,22,HUIMILPAN,008,SAN PEDRITO,5,115,59,56,9
QUERÉTARO,22,HUIMILPAN,008,SAN PEDRO,3,359,173,186,13
QUERÉTARO,22,HUIMILPAN,008,SAN PEDRO SECTOR NORTE,3,92,51,41,5
QUERÉTARO,22,HUIMILPAN,008,SANTA TERESA,3,281,137,144,11
QUERÉTARO,22,JALPAN DE SERRA,009,ACATITLÁN DEL RÍO,2,38,17,21,2
QUERÉTARO,22,JALPAN DE SERRA,009,AGUA AMARGA,1,10,2,8,1
QUERÉTARO,22,JALPAN DE SERRA,009,AGUA FRÍA,4,87,50,37,9
QUERÉTARO,22,JALPAN DE SERRA,009,BARREALES,2,65,34,31,3
QUERÉTARO,22,JALPAN DE SERRA,009,CAPULINES,2,6,4,2,2
QUERÉTARO,22,JALPAN DE SERRA,009,CARRIZAL DE LOS DURÁN,2,16,12,4,2
QUERÉTARO,22,JALPAN DE SERRA,009,CARRIZAL DE LOS SÁNCHEZ,3,70,32,38,6
QUERÉTARO,22,JALPAN DE SERRA,009,CARRIZALITO,2,6,4,2,2
QUERÉTARO,22,JALPAN DE SERRA,009,EL ÁLAMO,2,7,4,3,2
QUERÉTARO,22,JALPAN DE SERRA,009,EL CAÑÓN,1,4,1,3,1
QUERÉTARO,22,JALPAN DE SERRA,009,EL EMBOCADERO,2,23,9,14,2
QUERÉTARO,22,JALPAN DE SERRA,009,EL LINDERO,3,249,121,128,11
QUERÉTARO,22,JALPAN DE SERRA,009,EL POCITO,2,25,6,19,2
QUERÉTARO,22,JALPAN DE SERRA,009,EL RAYO,2,15,5,10,2
QUERÉTARO,22,JALPAN DE SERRA,009,EL RINCÓN,1,8,6,2,1
QUERÉTARO,22,JALPAN DE SERRA,009,EL SAUCITO,2,17,9,8,2
QUERÉTARO,22,JALPAN DE SERRA,009,EL ZAPOTE,2,39,13,26,3
QUERÉTARO,22,JALPAN DE SERRA,009,ESPADAÑUELA,1,4,0,4,1
QUERÉTARO,22,JALPAN DE SERRA,009,GUAYABOS,2,20,8,12,2
QUERÉTARO,22,JALPAN DE SERRA,009,JAGÜEY (JAGÜEY GRANDE),1,5,2,3,1
QUERÉTARO,22,JALPAN DE SERRA,009,JAGÜEY NUEVO,1,19,8,11,1
QUERÉTARO,22,JALPAN DE SERRA,009,JALPAN DE SERRA,27,5281,2837,2444,347
QUERÉTARO,22,JALPAN DE SERRA,009,LA ARENA,2,17,6,11,2
QUERÉTARO,22,JALPAN DE SERRA,009,LA CEIBA,1,13,6,7,1
QUERÉTARO,22,JALPAN DE SERRA,009,LA ESPERANZA,3,58,28,30,4
QUERÉTARO,22,JALPAN DE SERRA,009,LA MESA DEL PINO,2,13,4,9,2
QUERÉTARO,22,JALPAN DE SERRA,009,LAGUNA DE PITZQUINTLA,3,86,40,46,6
QUERÉTARO,22,JALPAN DE SERRA,009,LAS NUEVAS FLORES,2,10,4,6,1
QUERÉTARO,22,JALPAN DE SERRA,009,LIMÓN DE LA PEÑA,2,8,1,7,2
QUERÉTARO,22,JALPAN DE SERRA,009,LOMA DELGADA,2,11,8,3,2
QUERÉTARO,22,JALPAN DE SERRA,009,LOS CHARCOS,2,19,12,7,2
QUERÉTARO,22,JALPAN DE SERRA,009,MADROÑO,3,127,70,57,6
QUERÉTARO,22,JALPAN DE SERRA,009,MANZANILLOS,2,26,17,9,2
QUERÉTARO,22,JALPAN DE SERRA,009,MOCTEZUMAS,2,53,18,35,3
QUERÉTARO,22,JALPAN DE SERRA,009,OJO DE AGUA DEL LINDERO,2,72,24,48,4
QUERÉTARO,22,JALPAN DE SERRA,009,PETZCOLA,1,4,2,2,1
QUERÉTARO,22,JALPAN DE SERRA,009,PIEDRAS ANCHAS,2,108,53,55,4
QUERÉTARO,22,JALPAN DE SERRA,009,PUERTO DE ÁNIMAS,2,26,13,13,2
QUERÉTARO,22,JALPAN DE SERRA,009,PUERTO HONDO,2,48,21,27,3
QUERÉTARO,22,JALPAN DE SERRA,009,RANCHO NUEVO,2,15,7,8,2
QUERÉTARO,22,JALPAN DE SERRA,009,RINCÓN DE PITZQUINTLA,2,43,15,28,3
QUERÉTARO,22,JALPAN DE SERRA,009,SABINO CHICO,2,32,22,10,2
QUERÉTARO,22,JALPAN DE SERRA,009,SABINO GRANDE,2,41,17,24,4
QUERÉTARO,22,JALPAN DE SERRA,009,SALDIVEÑA,3,231,110,121,11
QUERÉTARO,22,JALPAN DE SERRA,009,SAN ANTONIO TANCOYOL,2,27,13,14,2
QUERÉTARO,22,JALPAN DE SERRA,009,SAN ISIDRO,2,6,3,3,2
QUERÉTARO,22,JALPAN DE SERRA,009,SAN JUAN DE LOS DURÁN,3,51,29,22,4
QUERÉTARO,22,JALPAN DE SERRA,009,SAN VICENTE,2,36,15,21,2
QUERÉTARO,22,JALPAN DE SERRA,009,SAUCILLO,3,64,31,33,6
QUERÉTARO,22,JALPAN DE SERRA,009,SOLEDAD DE GUADALUPE,2,29,14,15,2
QUERÉTARO,22,JALPAN DE SERRA,009,TANCÁMA,3,130,73,57,7
QUERÉTARO,22,JALPAN DE SERRA,009,TANCOYOL,4,219,108,111,16
QUERÉTARO,22,JALPAN DE SERRA,009,VALLE VERDE,4,216,112,104,13
QUERÉTARO,22,JALPAN DE SERRA,009,YERBABUENA,4,165,80,85,8
QUERÉTARO,22,JALPAN DE SERRA,009,ZOYAPILCA,3,85,42,43,6
QUERÉTARO,22,LANDA DE MATAMOROS,010,ACATITLÁN DE ZARAGOZA,3,59,33,26,6
QUERÉTARO,22,LANDA DE MATAMOROS,010,AGUA ZARCA,6,645,328,317,29
QUERÉTARO,22,LANDA DE MATAMOROS,010,ARBOLEDAS,1,8,3,5,1
QUERÉTARO,22,LANDA DE MATAMOROS,010,BARRIO DE LA LUZ,1,3,0,3,1
QUERÉTARO,22,LANDA DE MATAMOROS,010,BUENAVISTA,1,3,0,3,1
QUERÉTARO,22,LANDA DE MATAMOROS,010,CAMARONES,2,22,11,11,2
QUERÉTARO,22,LANDA DE MATAMOROS,010,CERRO DE LA PALMA,2,59,29,30,4
QUERÉTARO,22,LANDA DE MATAMOROS,010,CERRO DE SAN AGUSTÍN,1,14,4,10,1
QUERÉTARO,22,LANDA DE MATAMOROS,010,EL AGUACATE,2,63,29,34,4
QUERÉTARO,22,LANDA DE MATAMOROS,010,EL AGUACATE (NEBLINAS),2,33,17,16,3
QUERÉTARO,22,LANDA DE MATAMOROS,010,EL BANCO,2,18,6,12,2
QUERÉTARO,22,LANDA DE MATAMOROS,010,EL CHARCO,2,11,5,6,2
QUERÉTARO,22,LANDA DE MATAMOROS,010,EL GAVILÁN,2,13,4,9,2
QUERÉTARO,22,LANDA DE MATAMOROS,010,EL HUMO,2,80,42,38,5
QUERÉTARO,22,LANDA DE MATAMOROS,010,EL LOBO,4,307,157,150,16
QUERÉTARO,22,LANDA DE MATAMOROS,010,EL MADROÑO,2,48,26,22,4
QUERÉTARO,22,LANDA DE MATAMOROS,010,EL NARANJO,2,4,2,2,2
QUERÉTARO,22,LANDA DE MATAMOROS,010,EL PEMOCHE,2,15,7,8,2
QUERÉTARO,22,LANDA DE MATAMOROS,010,EL SABINITO,3,32,17,15,3
QUERÉTARO,22,LANDA DE MATAMOROS,010,ENCINO SOLO,2,85,36,49,4
QUERÉTARO,22,LANDA DE MATAMOROS,010,JAGÜEY COLORADO,2,28,19,9,3
QUERÉTARO,22,LANDA DE MATAMOROS,010,LA AGÜITA,2,19,11,8,2
QUERÉTARO,22,LANDA DE MATAMOROS,010,LA ALBERCA,1,3,1,2,1
QUERÉTARO,22,LANDA DE MATAMOROS,010,LA FLORIDA,2,20,8,12,2
QUERÉTARO,22,LANDA DE MATAMOROS,010,LA LAGUNITA,4,575,302,273,28
QUERÉTARO,22,LANDA DE MATAMOROS,010,LA LIMA,1,6,3,3,1
QUERÉTARO,22,LANDA DE MATAMOROS,010,LA MARGARITA,2,17,7,10,2
QUERÉTARO,22,LANDA DE MATAMOROS,010,LA POLVAREDA,2,26,12,14,2
QUERÉTARO,22,LANDA DE MATAMOROS,010,LA REFORMA,2,60,41,19,3
QUERÉTARO,22,LANDA DE MATAMOROS,010,LA SIERRITA,2,5,1,4,2
QUERÉTARO,22,LANDA DE MATAMOROS,010,LA VUELTA,3,152,68,84,9
QUERÉTARO,22,LANDA DE MATAMOROS,010,LA YERBABUENA,2,40,16,24,3
QUERÉTARO,22,LANDA DE MATAMOROS,010,LA YESCA,2,39,20,19,3
QUERÉTARO,22,LANDA DE MATAMOROS,010,LAGUNITA DE SAN DIEGO,3,50,29,21,4
QUERÉTARO,22,LANDA DE MATAMOROS,010,LANDA DE MATAMOROS,6,578,296,282,44
QUERÉTARO,22,LANDA DE MATAMOROS,010,LAS VALLAS,1,5,5,0,1
QUERÉTARO,22,LANDA DE MATAMOROS,010,MALPAÍS,2,14,6,8,2
QUERÉTARO,22,LANDA DE MATAMOROS,010,MESA DE LA CRUZ,3,14,9,5,3
QUERÉTARO,22,LANDA DE MATAMOROS,010,MESA DEL COROZO,2,31,18,13,2
QUERÉTARO,22,LANDA DE MATAMOROS,010,MESA DEL JAGÜEY (JAGÜEY DEL MUERTO),2,5,1,4,2
QUERÉTARO,22,LANDA DE MATAMOROS,010,NEBLINAS,4,269,143,126,14
QUERÉTARO,22,LANDA DE MATAMOROS,010,OTATES,3,82,41,41,5
QUERÉTARO,22,LANDA DE MATAMOROS,010,PALO VERDE,2,6,4,2,2
QUERÉTARO,22,LANDA DE MATAMOROS,010,PINALITO DE LA CRUZ,3,163,77,86,11
QUERÉTARO,22,LANDA DE MATAMOROS,010,POTRERO DEL LLANO (LA JOYA),2,23,11,12,2
QUERÉTARO,22,LANDA DE MATAMOROS,010,PUERTO DE GUADALUPE,2,27,12,15,2
QUERÉTARO,22,LANDA DE MATAMOROS,010,PUERTO DE SAN AGUSTÍN,2,61,27,34,3
QUERÉTARO,22,LANDA DE MATAMOROS,010,PUERTO HONDO,2,6,2,4,2
QUERÉTARO,22,LANDA DE MATAMOROS,010,RINCÓN DE PIEDRA BLANCA (LA PECHUGA),3,53,30,23,4
QUERÉTARO,22,LANDA DE MATAMOROS,010,RÍO VERDITO,3,103,48,55,6
QUERÉTARO,22,LANDA DE MATAMOROS,010,SAN JOSÉ,2,6,2,4,2
QUERÉTARO,22,LANDA DE MATAMOROS,010,SAN JUANITO,2,41,15,26,2
QUERÉTARO,22,LANDA DE MATAMOROS,010,SAN ONOFRE,2,14,10,4,2
QUERÉTARO,22,LANDA DE MATAMOROS,010,SANTA INÉS,4,119,57,62,10
QUERÉTARO,22,LANDA DE MATAMOROS,010,TANGOJÓ,3,44,25,19,4
QUERÉTARO,22,LANDA DE MATAMOROS,010,TILACO,4,225,99,126,15
QUERÉTARO,22,LANDA DE MATAMOROS,010,TRES LAGUNAS,6,301,157,144,15
QUERÉTARO,22,LANDA DE MATAMOROS,010,VALLE DE GUADALUPE,3,174,103,71,9
QUERÉTARO,22,EL MARQUÉS,011,AGUA AZUL,4,845,425,420,28
QUERÉTARO,22,EL MARQUÉS,011,ALFAJAYUCAN,4,859,441,418,26
QUERÉTARO,22,EL MARQUÉS,011,AMAZCALA,8,2072,1062,1010,115
QUERÉTARO,22,EL MARQUÉS,011,ATONGO,4,954,486,468,31
QUERÉTARO,22,EL MARQUÉS,011,CALAMANDA,2,356,179,177,14
QUERÉTARO,22,EL MARQUÉS,011,CAMPESTRE SAN ISIDRO [FRACCIONAMIENTO],2,145,71,74,9
QUERÉTARO,22,EL MARQUÉS,011,CERRITO COLORADO (LA CURVA),2,447,215,232,16
QUERÉTARO,22,EL MARQUÉS,011,CERRO PRIETO,2,200,100,100,8
QUERÉTARO,22,EL MARQUÉS,011,CHICHIMEQUILLAS,6,2279,1187,1092,109
QUERÉTARO,22,EL MARQUÉS,011,COYOTILLOS,2,337,153,184,13
QUERÉTARO,22,EL MARQUÉS,011,DOLORES,2,111,51,60,4
QUERÉTARO,22,EL MARQUÉS,011,EL CARMEN,4,861,436,425,29
QUERÉTARO,22,EL MARQUÉS,011,EL COYME [RANCHO],1,12,7,5,1
QUERÉTARO,22,EL MARQUÉS,011,EL LOBO,3,517,244,273,20
QUERÉTARO,22,EL MARQUÉS,011,EL PARAÍSO,2,303,138,165,11
QUERÉTARO,22,EL MARQUÉS,011,EL POZO,4,876,463,413,59
QUERÉTARO,22,EL MARQUÉS,011,EL RODEO,1,49,26,23,2
QUERÉTARO,22,EL MARQUÉS,011,EL ROSARIO,3,461,202,259,18
QUERÉTARO,22,EL MARQUÉS,011,GENERAL LÁZARO CÁRDENAS (EL COLORADO),10,2705,1379,1326,140
QUERÉTARO,22,EL MARQUÉS,011,GUADALUPE LA VENTA,2,237,117,120,8
QUERÉTARO,22,EL MARQUÉS,011,HACIENDA LA CRUZ [FRACCIONAMIENTO],3,567,264,303,16
QUERÉTARO,22,EL MARQUÉS,011,JESÚS MARÍA,7,2071,1064,1007,77
QUERÉTARO,22,EL MARQUÉS,011,LA CAÑADA,35,5228,2669,2559,284
QUERÉTARO,22,EL MARQUÉS,011,LA GRIEGA,8,3421,1656,1765,220
QUERÉTARO,22,EL MARQUÉS,011,LA LABORCILLA,4,241,110,131,11
QUERÉTARO,22,EL MARQUÉS,011,LA LOMA,2,512,242,270,15
QUERÉTARO,22,EL MARQUÉS,011,LA MARIOLA (EL ROSARIO),1,7,4,3,1
QUERÉTARO,22,EL MARQUÉS,011,LA PIEDAD (SAN MIGUEL COLORADO),6,1999,1009,990,65
QUERÉTARO,22,EL MARQUÉS,011,LA PRADERA,10,2610,1314,1296,117
QUERÉTARO,22,EL MARQUÉS,011,LAS CRUCES,2,7873,4549,3324,2962
QUERÉTARO,22,EL MARQUÉS,011,LAS LAJITAS,3,253,117,136,11
QUERÉTARO,22,EL MARQUÉS,011,LOS POCITOS,3,338,174,164,12
QUERÉTARO,22,EL MARQUÉS,011,MATANZAS,2,49,21,28,3
QUERÉTARO,22,EL MARQUÉS,011,PALO ALTO,4,1000,477,523,38
QUERÉTARO,22,EL MARQUÉS,011,PASEOS DEL MARQUÉS,6,1991,974,1017,95
QUERÉTARO,22,EL MARQUÉS,011,PRESA DE RAYAS,3,350,172,178,12
QUERÉTARO,22,EL MARQUÉS,011,PRESA DEL CARMEN,1,21,14,7,2
QUERÉTARO,22,EL MARQUÉS,011,REAL SOLARE,2,535,253,282,27
QUERÉTARO,22,EL MARQUÉS,011,SALDARRIAGA,21,7318,3807,3511,654
QUERÉTARO,22,EL MARQUÉS,011,SAN ISIDRO MIRANDA,4,1221,590,631,38
QUERÉTARO,22,EL MARQUÉS,011,SAN JOSÉ NAVAJAS,4,684,322,362,22
QUERÉTARO,22,EL MARQUÉS,011,SAN MIGUEL AMAZCALA,2,302,136,166,9
QUERÉTARO,22,EL MARQUÉS,011,SAN PEDRITO (LA TEGUA),2,22,15,7,2
QUERÉTARO,22,EL MARQUÉS,011,SAN PEDRO ZACATENCO,3,27,10,17,3
QUERÉTARO,22,EL MARQUÉS,011,SAN RAFAEL,4,548,262,286,21
QUERÉTARO,22,EL MARQUÉS,011,SAN VICENTE FERRER,3,562,275,287,16
QUERÉTARO,22,EL MARQUÉS,011,SANTA CRUZ,4,1237,619,618,38
QUERÉTARO,22,EL MARQUÉS,011,SANTA MARÍA BEGOÑA,3,518,258,260,17
QUERÉTARO,22,EL MARQUÉS,011,SANTA MARÍA DE LOS BAÑOS,4,696,345,351,22
QUERÉTARO,22,EL MARQUÉS,011,SANTA MARÍA TICOMÁN,2,391,176,215,14
QUERÉTARO,22,EL MARQUÉS,011,SEGUNDO BARRIO DE DOLORES,1,35,18,17,3
QUERÉTARO,22,EL MARQUÉS,011,TECNOLÓGICO INNOVACIÓN [PARQUE INDUSTRIAL],1,4695,1852,2843,469
QUERÉTARO,22,EL MARQUÉS,011,TIERRA BLANCA,4,748,350,398,26
QUERÉTARO,22,EL MARQUÉS,011,VILLAS LA PIEDAD,3,638,323,315,18
QUERÉTARO,22,PEDRO ESCOBEDO,012,AJUCHITLANCITO,4,877,433,444,30
QUERÉTARO,22,PEDRO ESCOBEDO,012,CHINTEPEC,2,23,11,12,2
QUERÉTARO,22,PEDRO ESCOBEDO,012,DOLORES DE AJUCHITLANCITO,4,471,221,250,20
QUERÉTARO,22,PEDRO ESCOBEDO,012,"EL SAUZ (SAUZ ALTO, SAUZ BAJO)",4,762,443,319,35
QUERÉTARO,22,PEDRO ESCOBEDO,012,EPIGMENIO GONZÁLEZ (EL AHORCADO),4,836,432,404,28
QUERÉTARO,22,PEDRO ESCOBEDO,012,ESCOLÁSTICAS,4,873,466,407,29
QUERÉTARO,22,PEDRO ESCOBEDO,012,GUADALUPE SEPTIÉN,4,676,342,334,23
QUERÉTARO,22,PEDRO ESCOBEDO,012,IGNACIO PÉREZ (EL MUERTO),2,345,171,174,14
QUERÉTARO,22,PEDRO ESCOBEDO,012,LA CEJA,2,116,60,56,4
QUERÉTARO,22,PEDRO ESCOBEDO,012,LA D,5,1134,548,586,44
QUERÉTARO,22,PEDRO ESCOBEDO,012,LA LIRA,6,1625,824,801,63
QUERÉTARO,22,PEDRO ESCOBEDO,012,LA PALMA,2,345,171,174,12
QUERÉTARO,22,PEDRO ESCOBEDO,012,LA PURÍSIMA,2,96,46,50,4
QUERÉTARO,22,PEDRO ESCOBEDO,012,LA VENTA DE AJUCHITLANCITO,3,401,199,202,16
QUERÉTARO,22,PEDRO ESCOBEDO,012,LAS POSTAS,2,52,25,27,3
QUERÉTARO,22,PEDRO ESCOBEDO,012,LOS ÁLVAREZ,2,153,72,81,6
QUERÉTARO,22,PEDRO ESCOBEDO,012,NORIA NUEVA,3,428,207,221,16
QUERÉTARO,22,PEDRO ESCOBEDO,012,PEDRO ESCOBEDO,26,8131,4132,3999,370
QUERÉTARO,22,PEDRO ESCOBEDO,012,QUINTANARES,2,70,29,41,4
QUERÉTARO,22,PEDRO ESCOBEDO,012,SAN ANTONIO LA D,2,215,111,104,8
QUERÉTARO,22,PEDRO ESCOBEDO,012,SAN CIRILO,2,121,58,63,5
QUERÉTARO,22,PEDRO ESCOBEDO,012,SAN CLEMENTE,4,1172,573,599,40
QUERÉTARO,22,PEDRO ESCOBEDO,012,SAN FANDILA,5,1057,517,540,68
QUERÉTARO,22,PEDRO ESCOBEDO,012,SAUZ ALTO,4,1435,681,754,53
QUERÉTARO,22,PEÑAMILLER,013,ADJUNTAS DE HIGUERAS,3,53,23,30,4
QUERÉTARO,22,PEÑAMILLER,013,AGUA CALIENTE,2,55,28,27,2
QUERÉTARO,22,PEÑAMILLER,013,AGUA DE PEDRO,2,51,17,34,3
QUERÉTARO,22,PEÑAMILLER,013,AGUA FRÍA,6,517,263,254,25
QUERÉTARO,22,PEÑAMILLER,013,ALTO BONITO,2,28,17,11,2
QUERÉTARO,22,PEÑAMILLER,013,APOSENTOS,2,31,14,17,2
QUERÉTARO,22,PEÑAMILLER,013,BOQUILLAS,2,40,22,18,3
QUERÉTARO,22,PEÑAMILLER,013,CAMARGO,4,369,185,184,17
QUERÉTARO,22,PEÑAMILLER,013,CERRO COLORADO,2,14,9,5,2
QUERÉTARO,22,PEÑAMILLER,013,CORRAL VIEJO,2,14,6,8,2
QUERÉTARO,22,PEÑAMILLER,013,CRUZ DEL MILAGRO,2,29,15,14,2
QUERÉTARO,22,PEÑAMILLER,013,CUESTA COLORADA,2,14,10,4,2
QUERÉTARO,22,PEÑAMILLER,013,CUESTA DE LOS IBARRA,1,6,2,4,1
QUERÉTARO,22,PEÑAMILLER,013,EL ALAMITO II,2,20,13,7,2
QUERÉTARO,22,PEÑAMILLER,013,EL ÁLAMO,2,16,7,9,2
QUERÉTARO,22,PEÑAMILLER,013,EL ARTE,3,20,13,7,3
QUERÉTARO,22,PEÑAMILLER,013,EL ATORÓN,2,20,7,13,2
QUERÉTARO,22,PEÑAMILLER,013,EL CAJÓN,2,19,10,9,3
QUERÉTARO,22,PEÑAMILLER,013,EL CAMPAMENTO,1,6,3,3,1
QUERÉTARO,22,PEÑAMILLER,013,EL CANTONCITO,3,11,3,8,2
QUERÉTARO,22,PEÑAMILLER,013,EL CARRIZAL,2,11,8,3,2
QUERÉTARO,22,PEÑAMILLER,013,EL CARRIZALILLO,2,16,4,12,2
QUERÉTARO,22,PEÑAMILLER,013,EL COMEDERO,2,5,2,3,2
QUERÉTARO,22,PEÑAMILLER,013,EL ENCINO,2,11,4,7,2
QUERÉTARO,22,PEÑAMILLER,013,EL FRONTONCILLO,3,121,63,58,7
QUERÉTARO,22,PEÑAMILLER,013,EL GARAMBULLAL,1,3,0,3,1
QUERÉTARO,22,PEÑAMILLER,013,EL LINDERO,2,20,10,10,2
QUERÉTARO,22,PEÑAMILLER,013,EL MORAL,3,33,16,17,3
QUERÉTARO,22,PEÑAMILLER,013,EL MOTOSHÍ (LA PAZ),2,5,3,2,2
QUERÉTARO,22,PEÑAMILLER,013,EL PARAÍSO,2,14,6,8,2
QUERÉTARO,22,PEÑAMILLER,013,EL PILÓN,2,59,26,33,3
QUERÉTARO,22,PEÑAMILLER,013,EL PITAHAYO,1,6,2,4,1
QUERÉTARO,22,PEÑAMILLER,013,EL PORTUGUÉS,3,181,93,88,7
QUERÉTARO,22,PEÑAMILLER,013,EL SAUCITO I,2,14,11,3,2
QUERÉTARO,22,PEÑAMILLER,013,EL SAUCITO II,2,8,4,4,2
QUERÉTARO,22,PEÑAMILLER,013,EL SAUZ,2,25,10,15,3
QUERÉTARO,22,PEÑAMILLER,013,EL TEQUEZQUITE,3,20,12,8,3
QUERÉTARO,22,PEÑAMILLER,013,EL TORBELLINO,2,16,6,10,2
QUERÉTARO,22,PEÑAMILLER,013,EL ZAPOTE II,2,16,7,9,2
QUERÉTARO,22,PEÑAMILLER,013,LA ESTACIÓN,2,274,133,141,9
QUERÉTARO,22,PEÑAMILLER,013,LA HIGUERA,3,118,50,68,6
QUERÉTARO,22,PEÑAMILLER,013,LA LAJA,3,21,11,10,3
QUERÉTARO,22,PEÑAMILLER,013,LA ORDEÑA,2,32,20,12,2
QUERÉTARO,22,PEÑAMILLER,013,LA PLAZUELA,4,220,109,111,12
QUERÉTARO,22,PEÑAMILLER,013,LA TECOZAUTLA,2,11,6,5,2
QUERÉTARO,22,PEÑAMILLER,013,LA TINAJA,2,9,2,7,2
QUERÉTARO,22,PEÑAMILLER,013,LA VEGA (LAS VEGAS),2,42,22,20,4
QUERÉTARO,22,PEÑAMILLER,013,LA ZANCONA,2,8,3,5,2
QUERÉTARO,22,PEÑAMILLER,013,LAS ENRAMADAS,2,73,41,32,3
QUERÉTARO,22,PEÑAMILLER,013,LAS MESAS,2,31,17,14,2
QUERÉTARO,22,PEÑAMILLER,013,LOMA BLANCA,2,5,2,3,2
QUERÉTARO,22,PEÑAMILLER,013,LOS ÁLAMOS,2,41,21,20,4
QUERÉTARO,22,PEÑAMILLER,013,LOS ENCINOS,2,31,15,16,2
QUERÉTARO,22,PEÑAMILLER,013,LOS LLANOS DE BUENAVISTA,2,12,9,3,2
QUERÉTARO,22,PEÑAMILLER,013,MAGUEY VERDE,1,20,10,10,1
QUERÉTARO,22,PEÑAMILLER,013,MESA DEL TROJE,2,10,6,4,2
QUERÉTARO,22,PEÑAMILLER,013,MILPILLAS,2,25,8,17,3
QUERÉTARO,22,PEÑAMILLER,013,MOLINITOS (EL MOLINO),2,22,12,10,2
QUERÉTARO,22,PEÑAMILLER,013,PEÑA BLANCA,4,445,249,196,17
QUERÉTARO,22,PEÑAMILLER,013,PEÑAMILLER,4,793,395,398,38
QUERÉTARO,22,PEÑAMILLER,013,PIEDRA GORDA,2,9,5,4,2
QUERÉTARO,22,PEÑAMILLER,013,PUEBLO NUEVO,2,32,13,19,3
QUERÉTARO,22,PEÑAMILLER,013,PUERTO DE SANTA MARÍA,1,10,3,7,1
QUERÉTARO,22,PEÑAMILLER,013,PUERTO DEL AIRE,2,8,3,5,2
QUERÉTARO,22,PEÑAMILLER,013,PUERTO DEL COBRE,2,8,3,5,2
QUERÉTARO,22,PEÑAMILLER,013,RÍO BLANCO,3,68,31,37,5
QUERÉTARO,22,PEÑAMILLER,013,SAN ISIDRO (SAN ISIDRO BOQUILLAS),3,11,3,8,3
QUERÉTARO,22,PEÑAMILLER,013,SAN JUANICO,2,75,44,31,4
QUERÉTARO,22,PEÑAMILLER,013,SAN LORENZO,2,52,21,31,3
QUERÉTARO,22,PEÑAMILLER,013,SAN MIGUEL PALMAS (MISIÓN DE PALMAS),4,301,175,126,12
QUERÉTARO,22,PEÑAMILLER,013,VILLA EMILIANO ZAPATA (EXTORAZ),3,169,76,93,8
QUERÉTARO,22,QUERÉTARO,014,ACEQUIA BLANCA,2,66,29,37,3
QUERÉTARO,22,QUERÉTARO,014,BUENAVISTA,3,910,446,464,37
QUERÉTARO,22,QUERÉTARO,014,BUENAVISTA [POLÍGONO EMPRESARIAL],1,65,35,30,6
QUERÉTARO,22,QUERÉTARO,014,CAÑADA DE LA MONJA,1,11,5,6,1
QUERÉTARO,22,QUERÉTARO,014,CASA BLANCA,3,249,139,110,11
QUERÉTARO,22,QUERÉTARO,014,CERRO COLORADO (EL COLORADO),2,102,54,48,4
QUERÉTARO,22,QUERÉTARO,014,CERRO DE LA CRUZ,3,322,173,149,11
QUERÉTARO,22,QUERÉTARO,014,CERRO PRIETO,2,31,16,15,3
QUERÉTARO,22,QUERÉTARO,014,CHARAPE DE LOS PELONES,3,82,39,43,6
QUERÉTARO,22,QUERÉTARO,014,CHARAPE LA JOYA,3,20,6,14,2
QUERÉTARO,22,QUERÉTARO,014,COREA,2,213,111,102,8
QUERÉTARO,22,QUERÉTARO,014,EJIDO BOLAÑOS,3,1540,878,662,195
QUERÉTARO,22,QUERÉTARO,014,EL HERRERO,3,35,17,18,4
QUERÉTARO,22,QUERÉTARO,014,EL NABO,5,901,449,452,44
QUERÉTARO,22,QUERÉTARO,014,EL PATOL,2,37,25,12,2
QUERÉTARO,22,QUERÉTARO,014,EL PIE,3,111,47,64,5
QUERÉTARO,22,QUERÉTARO,014,EL RINCÓN DE OJO DE AGUA,2,93,47,46,5
QUERÉTARO,22,QUERÉTARO,014,EL SALITRE,8,1853,904,949,91
QUERÉTARO,22,QUERÉTARO,014,EL TRÁNSITO,2,28,13,15,2
QUERÉTARO,22,QUERÉTARO,014,ESTANCIA DE LA ROCHERA,2,122,67,55,5
QUERÉTARO,22,QUERÉTARO,014,HUERTAS LA JOYA [FRACCIONAMIENTO CAMPESTRE],3,814,395,419,42
QUERÉTARO,22,QUERÉTARO,014,JOFRE,2,182,93,89,8
QUERÉTARO,22,QUERÉTARO,014,JOFRITO,4,734,367,367,24
QUERÉTARO,22,QUERÉTARO,014,JURIQUILLA,46,11521,5961,5560,1084
QUERÉTARO,22,QUERÉTARO,014,LA BARRETA,2,206,102,104,9
QUERÉTARO,22,QUERÉTARO,014,LA CANTERA,1,6,4,2,1
QUERÉTARO,22,QUERÉTARO,014,LA CARBONERA,2,108,46,62,4
QUERÉTARO,22,QUERÉTARO,014,LA ESTACADA,3,487,227,260,18
QUERÉTARO,22,QUERÉTARO,014,LA ESTANCIA DE PALO DULCE,3,36,18,18,4
QUERÉTARO,22,QUERÉTARO,014,LA GOTERA,3,683,316,367,23
QUERÉTARO,22,QUERÉTARO,014,LA JOYA,3,24,13,11,3
QUERÉTARO,22,QUERÉTARO,014,LA LUZ,4,636,317,319,23
QUERÉTARO,22,QUERÉTARO,014,LA MONJA,4,444,207,237,18
QUERÉTARO,22,QUERÉTARO,014,LA PALMA,2,207,104,103,8
QUERÉTARO,22,QUERÉTARO,014,LA PURÍSIMA,10,750,461,289,61
QUERÉTARO,22,QUERÉTARO,014,LA SOLANA,6,1168,578,590,35
QUERÉTARO,22,QUERÉTARO,014,LA TINAJA DE LA ESTANCIA,4,585,287,298,34
QUERÉTARO,22,QUERÉTARO,014,LA VERSOLILLA,5,1101,575,526,35
QUERÉTARO,22,QUERÉTARO,014,LLANO DE LA ROCHERA,2,9,6,3,1
QUERÉTARO,22,QUERÉTARO,014,LOMA DEL CHINO,2,43,21,22,3
QUERÉTARO,22,QUERÉTARO,014,MOMPANÍ,3,450,215,235,22
QUERÉTARO,22,QUERÉTARO,014,MONTENEGRO,5,2666,1275,1391,109
QUERÉTARO,22,QUERÉTARO,014,OJO DE AGUA,2,93,44,49,4
QUERÉTARO,22,QUERÉTARO,014,PALO ALTO,2,347,171,176,14
QUERÉTARO,22,QUERÉTARO,014,PIE DE GALLO,4,1298,628,670,42
QUERÉTARO,22,QUERÉTARO,014,PINTILLO,2,218,99,119,8
QUERÉTARO,22,QUERÉTARO,014,PINTO,3,404,194,210,15
QUERÉTARO,22,QUERÉTARO,014,PRESA DE BECERRA,2,81,41,40,4
QUERÉTARO,22,QUERÉTARO,014,PUERTO DE AGUIRRE,4,678,325,353,22
QUERÉTARO,22,QUERÉTARO,014,RANCHO LARGO,5,362,181,181,25
QUERÉTARO,22,QUERÉTARO,014,SAN FRANCISCO DE LA PALMA,2,343,178,165,13
QUERÉTARO,22,QUERÉTARO,014,SAN ISIDRO BUENAVISTA,3,416,213,203,14
QUERÉTARO,22,QUERÉTARO,014,SAN ISIDRO EL ALTO,2,76,34,42,4
QUERÉTARO,22,QUERÉTARO,014,SAN ISIDRO EL VIEJO,2,41,14,27,2
QUERÉTARO,22,QUERÉTARO,014,SAN JOSÉ BUENAVISTA,4,689,346,343,28
QUERÉTARO,22,QUERÉTARO,014,SAN JOSÉ EL ALTO,12,2342,1206,1136,83
QUERÉTARO,22,QUERÉTARO,014,SAN MIGUELITO,4,938,482,456,33
QUERÉTARO,22,QUERÉTARO,014,SAN PEDRITO EL ALTO (EL OBRAJE),2,57,30,27,3
QUERÉTARO,22,QUERÉTARO,014,SAN PEDRO MÁRTIR,8,3308,1658,1650,117
QUERÉTARO,22,QUERÉTARO,014,SANTA CATARINA,3,486,255,231,18
QUERÉTARO,22,QUERÉTARO,014,SANTA MARÍA DEL ZAPOTE,2,169,76,93,7
QUERÉTARO,22,QUERÉTARO,014,SANTA MARÍA MAGDALENA,11,4329,2169,2160,225
QUERÉTARO,22,QUERÉTARO,014,SANTA ROSA JÁUREGUI,32,10774,5611,5163,504
QUERÉTARO,22,QUERÉTARO,014,SANTIAGO DE QUERÉTARO,1023,247435,127963,119472,18102
QUERÉTARO,22,QUERÉTARO,014,SANTO NIÑO DE PRAGA,2,134,62,72,5
QUERÉTARO,22,QUERÉTARO,014,TLACOTE EL ALTO,2,88,46,42,4
QUERÉTARO,22,QUERÉTARO,014,TLACOTE EL BAJO,8,2022,1003,1019,79
QUERÉTARO,22,SAN JOAQUÍN,015,AGUA DEL VENADO,2,9,5,4,2
QUERÉTARO,22,SAN JOAQUÍN,015,APARTADERO,3,74,35,39,4
QUERÉTARO,22,SAN JOAQUÍN,015,BARRIO DE LA LOMA,2,24,14,10,2
QUERÉTARO,22,SAN JOAQUÍN,015,CANOAS (NUEVO SAN JOAQUÍN),2,78,39,39,4
QUERÉTARO,22,SAN JOAQUÍN,015,CULEBRAS,2,17,8,9,2
QUERÉTARO,22,SAN JOAQUÍN,015,EL DECONÍ,2,15,6,9,2
QUERÉTARO,22,SAN JOAQUÍN,015,EL DURAZNO,1,12,3,9,1
QUERÉTARO,22,SAN JOAQUÍN,015,EL PLÁTANO,4,70,37,33,7
QUERÉTARO,22,SAN JOAQUÍN,015,LA GUADALUPANA,2,21,13,8,2
QUERÉTARO,22,SAN JOAQUÍN,015,LA SOLEDAD,2,42,14,28,2
QUERÉTARO,22,SAN JOAQUÍN,015,LLANOS DE SANTA CLARA,1,4,2,2,1
QUERÉTARO,22,SAN JOAQUÍN,015,LOS AZÓGUEZ,3,40,24,16,3
QUERÉTARO,22,SAN JOAQUÍN,015,LOS HERRERA,1,8,3,5,1
QUERÉTARO,22,SAN JOAQUÍN,015,LOS NARANJOS,2,7,4,3,2
QUERÉTARO,22,SAN JOAQUÍN,015,LOS PLANES,2,12,6,6,2
QUERÉTARO,22,SAN JOAQUÍN,015,LOS POZOS,2,16,8,8,2
QUERÉTARO,22,SAN JOAQUÍN,015,MARAVILLAS,2,14,6,8,2
QUERÉTARO,22,SAN JOAQUÍN,015,MEDIAS COLORADAS,2,15,8,7,2
QUERÉTARO,22,SAN JOAQUÍN,015,OCOTITLÁN,1,22,9,13,2
QUERÉTARO,22,SAN JOAQUÍN,015,PUERTO DE LA GARITA,3,6,2,4,3
QUERÉTARO,22,SAN JOAQUÍN,015,PUERTO DE ROSARITO,2,7,4,3,2
QUERÉTARO,22,SAN JOAQUÍN,015,PUERTO HONDO,3,17,10,7,2
QUERÉTARO,22,SAN JOAQUÍN,015,SAN AGUSTÍN,2,12,6,6,2
QUERÉTARO,22,SAN JOAQUÍN,015,SAN ANTONIO,2,24,14,10,3
QUERÉTARO,22,SAN JOAQUÍN,015,SAN BARTOLO,2,18,9,9,2
QUERÉTARO,22,SAN JOAQUÍN,015,SAN CRISTÓBAL,2,41,18,23,2
QUERÉTARO,22,SAN JOAQUÍN,015,SAN FRANCISCO GATOS,2,11,4,7,2
QUERÉTARO,22,SAN JOAQUÍN,015,SAN JOAQUÍN,6,1452,781,671,65
QUERÉTARO,22,SAN JOAQUÍN,015,SAN JOSÉ CARRIZAL,3,100,51,49,6
QUERÉTARO,22,SAN JOAQUÍN,015,SAN JOSÉ QUITASUEÑO,2,15,5,10,2
QUERÉTARO,22,SAN JOAQUÍN,015,SAN JUAN TETLA,2,11,6,5,2
QUERÉTARO,22,SAN JOAQUÍN,015,SAN RAFAEL,2,17,10,7,2
QUERÉTARO,22,SAN JOAQUÍN,015,SAN SEBASTIÁN,3,52,25,27,3
QUERÉTARO,22,SAN JOAQUÍN,015,SANTA ANA,2,64,25,39,4
QUERÉTARO,22,SAN JOAQUÍN,015,SANTA ELENA,3,6,3,3,3
QUERÉTARO,22,SAN JOAQUÍN,015,SANTA MARÍA ÁLAMOS,4,164,90,74,11
QUERÉTARO,22,SAN JOAQUÍN,015,SANTA MÓNICA LAS TINAJAS,2,14,5,9,2
QUERÉTARO,22,SAN JOAQUÍN,015,TIERRAS COLORADAS,2,11,3,8,2
QUERÉTARO,22,SAN JOAQUÍN,015,ZARZA Y SOMERIAL,3,105,53,52,5
QUERÉTARO,22,SAN JUAN DEL RÍO,016,ARCILA,5,1687,874,813,67
QUERÉTARO,22,SAN JUAN DEL RÍO,016,BANTHÍ (FAMILIA NAVARRETE) [RANCHO],3,475,228,247,17
QUERÉTARO,22,SAN JUAN DEL RÍO,016,BARRANCA DE COCHEROS,2,78,42,36,3
QUERÉTARO,22,SAN JUAN DEL RÍO,016,BUENAVISTA,3,119,51,68,6
QUERÉTARO,22,SAN JUAN DEL RÍO,016,CERRO GORDO,7,2999,1527,1472,114
QUERÉTARO,22,SAN JUAN DEL RÍO,016,CUARTO CENTENARIO,2,47,17,30,2
QUERÉTARO,22,SAN JUAN DEL RÍO,016,DOLORES CUADRILLA DE ENMEDIO,3,357,193,164,12
QUERÉTARO,22,SAN JUAN DEL RÍO,016,DOLORES GODOY,2,162,77,85,7
QUERÉTARO,22,SAN JUAN DEL RÍO,016,EJIDO LA ESTANCIA,1,152,75,77,7
QUERÉTARO,22,SAN JUAN DEL RÍO,016,EL CARRIZO [EJIDO],3,425,194,231,15
QUERÉTARO,22,SAN JUAN DEL RÍO,016,EL CAZADERO,5,886,462,424,44
QUERÉTARO,22,SAN JUAN DEL RÍO,016,EL CHAPARRO,2,50,30,20,3
QUERÉTARO,22,SAN JUAN DEL RÍO,016,EL COTO,3,368,195,173,15
QUERÉTARO,22,SAN JUAN DEL RÍO,016,EL GRANJENO,1,19,9,10,2
QUERÉTARO,22,SAN JUAN DEL RÍO,016,EL JAZMÍN,3,321,148,173,14
QUERÉTARO,22,SAN JUAN DEL RÍO,016,EL MIRADOR,2,143,68,75,6
QUERÉTARO,22,SAN JUAN DEL RÍO,016,EL ORGANAL,4,559,262,297,22
QUERÉTARO,22,SAN JUAN DEL RÍO,016,EL PARAÍSO,2,7,1,6,2
QUERÉTARO,22,SAN JUAN DEL RÍO,016,EL ROSARIO,4,500,248,252,21
QUERÉTARO,22,SAN JUAN DEL RÍO,016,EL SITIO,3,179,80,99,7
QUERÉTARO,22,SAN JUAN DEL RÍO,016,ESTANCIA DE BORDOS,2,76,35,41,4
QUERÉTARO,22,SAN JUAN DEL RÍO,016,ESTANCIA DE SANTA LUCÍA,2,79,34,45,4
QUERÉTARO,22,SAN JUAN DEL RÍO,016,GALINDO (SAN JOSÉ GALINDO),6,668,326,342,27
QUERÉTARO,22,SAN JUAN DEL RÍO,016,LA CASETA (AMPLIACIÓN SANTA BÁRBARA),3,39,23,16,4
QUERÉTARO,22,SAN JUAN DEL RÍO,016,LA CORREGIDORA,3,20,10,10,3
QUERÉTARO,22,SAN JUAN DEL RÍO,016,LA ESTANCIA,7,2063,1072,991,124
QUERÉTARO,22,SAN JUAN DEL RÍO,016,LA ESTANCITA,2,39,17,22,2
QUERÉTARO,22,SAN JUAN DEL RÍO,016,LA LABORCILLA,3,43,22,21,3
QUERÉTARO,22,SAN JUAN DEL RÍO,016,LA LLAVE,4,1407,680,727,53
QUERÉTARO,22,SAN JUAN DEL RÍO,016,LA MAGDALENA,2,6,5,1,1
QUERÉTARO,22,SAN JUAN DEL RÍO,016,LA MESA DE SAN ANTONIO,2,87,47,40,4
QUERÉTARO,22,SAN JUAN DEL RÍO,016,LA VALLA,5,1624,795,829,64
QUERÉTARO,22,SAN JUAN DEL RÍO,016,LAGUNA DE LOURDES,2,113,53,60,5
QUERÉTARO,22,SAN JUAN DEL RÍO,016,LAGUNA DE VAQUERÍAS,4,519,282,237,20
QUERÉTARO,22,SAN JUAN DEL RÍO,016,LOMA LINDA,4,578,271,307,22
QUERÉTARO,22,SAN JUAN DEL RÍO,016,LOS CERRITOS SAN MIGUEL,2,73,46,27,4
QUERÉTARO,22,SAN JUAN DEL RÍO,016,NUEVO SAN GERMÁN,2,26,14,12,3
QUERÉTARO,22,SAN JUAN DEL RÍO,016,OJO DE AGUA,2,229,119,110,8
QUERÉTARO,22,SAN JUAN DEL RÍO,016,OJO DE AGUA DE VAQUERÍAS,2,18,6,12,2
QUERÉTARO,22,SAN JUAN DEL RÍO,016,PALMA DE ROMERO,3,415,195,220,22
QUERÉTARO,22,SAN JUAN DEL RÍO,016,PALMILLAS,2,245,127,118,8
QUERÉTARO,22,SAN JUAN DEL RÍO,016,PASO DE MATA,5,1401,712,689,83
QUERÉTARO,22,SAN JUAN DEL RÍO,016,PERALES,2,62,34,28,4
QUERÉTARO,22,SAN JUAN DEL RÍO,016,PUEBLO NUEVO,2,28,16,12,3
QUERÉTARO,22,SAN JUAN DEL RÍO,016,PUERTA DE ALEGRÍAS (PUERTO DE ALEGRÍAS),3,217,108,109,10
QUERÉTARO,22,SAN JUAN DEL RÍO,016,PUERTA DE PALMILLAS,3,400,198,202,15
QUERÉTARO,22,SAN JUAN DEL RÍO,016,SABINO CHICO,3,254,131,123,10
QUERÉTARO,22,SAN JUAN DEL RÍO,016,SALTO DE VAQUERÍAS,2,30,18,12,2
QUERÉTARO,22,SAN JUAN DEL RÍO,016,SAN ANTONIO LA LABOR,2,76,36,40,4
QUERÉTARO,22,SAN JUAN DEL RÍO,016,SAN ANTONIO ZATLAUCO,2,8,6,2,1
QUERÉTARO,22,SAN JUAN DEL RÍO,016,SAN FRANCISCO,1,42,20,22,2
QUERÉTARO,22,SAN JUAN DEL RÍO,016,SAN GERMÁN,3,131,71,60,7
QUERÉTARO,22,SAN JUAN DEL RÍO,016,SAN JAVIER,2,98,57,41,5
QUERÉTARO,22,SAN JUAN DEL RÍO,016,SAN JUAN DEL RÍO,256,54153,27683,26470,3442
QUERÉTARO,22,SAN JUAN DEL RÍO,016,SAN MIGUEL ARCÁNGEL,3,49,19,30,4
QUERÉTARO,22,SAN JUAN DEL RÍO,016,SAN MIGUEL GALINDO,3,357,176,181,12
QUERÉTARO,22,SAN JUAN DEL RÍO,016,SAN PABLO POTRERILLOS,1,49,28,21,2
QUERÉTARO,22,SAN JUAN DEL RÍO,016,SAN PEDRO POTRERILLOS,3,184,88,96,8
QUERÉTARO,22,SAN JUAN DEL RÍO,016,SAN RAFAEL,2,365,176,189,14
QUERÉTARO,22,SAN JUAN DEL RÍO,016,SAN SEBASTIÁN DE LAS BARRANCAS NORTE,3,612,317,295,23
QUERÉTARO,22,SAN JUAN DEL RÍO,016,SAN SEBASTIÁN DE LAS BARRANCAS SUR,2,246,121,125,8
QUERÉTARO,22,SAN JUAN DEL RÍO,016,SAN SEBASTIAN LOMA LINDA,3,28,17,11,3
QUERÉTARO,22,SAN JUAN DEL RÍO,016,SANTA BÁRBARA DE LA CUEVA,4,561,266,295,21
QUERÉTARO,22,SAN JUAN DEL RÍO,016,SANTA CRUZ ESCANDÓN,2,250,119,131,8
QUERÉTARO,22,SAN JUAN DEL RÍO,016,SANTA ISABEL EL COTO,2,153,65,88,8
QUERÉTARO,22,SAN JUAN DEL RÍO,016,SANTA LUCÍA,4,550,293,257,17
QUERÉTARO,22,SAN JUAN DEL RÍO,016,SANTA MATILDE,10,1506,746,760,109
QUERÉTARO,22,SAN JUAN DEL RÍO,016,SANTA RITA,3,50,25,25,4
QUERÉTARO,22,SAN JUAN DEL RÍO,016,SANTA ROSA XAJAY,4,922,429,493,33
QUERÉTARO,22,SAN JUAN DEL RÍO,016,SENEGAL DE LAS PALOMAS,3,408,203,205,16
QUERÉTARO,22,SAN JUAN DEL RÍO,016,SOLEDAD DEL RÍO,2,108,60,48,5
QUERÉTARO,22,SAN JUAN DEL RÍO,016,TUNA MANSA,3,70,29,41,5
QUERÉTARO,22,SAN JUAN DEL RÍO,016,VAQUERÍAS,2,148,73,75,6
QUERÉTARO,22,SAN JUAN DEL RÍO,016,VISTHÁ,3,857,443,414,24
QUERÉTARO,22,TEQUISQUIAPAN,017,BORDO BLANCO,3,445,204,241,16
QUERÉTARO,22,TEQUISQUIAPAN,017,EL CERRITO,2,98,51,47,5
QUERÉTARO,22,TEQUISQUIAPAN,017,EL TEJOCOTE,4,532,248,284,22
QUERÉTARO,22,TEQUISQUIAPAN,017,FÁTIMA (EJIDO DE FUENTEZUELAS),1,19,8,11,2
QUERÉTARO,22,TEQUISQUIAPAN,017,FUENTEZUELAS,4,574,289,285,23
QUERÉTARO,22,TEQUISQUIAPAN,017,HACIENDA GRANDE,2,245,125,120,16
QUERÉTARO,22,TEQUISQUIAPAN,017,LA CHARRETERA,1,9,2,7,3
QUERÉTARO,22,TEQUISQUIAPAN,017,LA FUENTE,5,1224,643,581,40
QUERÉTARO,22,TEQUISQUIAPAN,017,LA LAJA,2,238,120,118,8
QUERÉTARO,22,TEQUISQUIAPAN,017,LA TORTUGA,3,313,154,159,15
QUERÉTARO,22,TEQUISQUIAPAN,017,LA TRINIDAD,3,478,214,264,19
QUERÉTARO,22,TEQUISQUIAPAN,017,LOS CERRITOS,4,645,320,325,22
QUERÉTARO,22,TEQUISQUIAPAN,017,SAN JOSÉ DE LA LAJA,4,364,168,196,18
QUERÉTARO,22,TEQUISQUIAPAN,017,SAN NICOLÁS,4,1490,723,767,46
QUERÉTARO,22,TEQUISQUIAPAN,017,SANTILLÁN,3,443,225,218,17
QUERÉTARO,22,TEQUISQUIAPAN,017,TEQUISQUIAPAN,64,12139,6185,5954,858
QUERÉTARO,22,TOLIMÁN,018,ADJUNTILLAS,3,15,8,7,3
QUERÉTARO,22,TOLIMÁN,018,BARRIO DE GARCÍA,2,132,57,75,6
QUERÉTARO,22,TOLIMÁN,018,BERMEJO,2,6,3,3,2
QUERÉTARO,22,TOLIMÁN,018,BOMINTZÁ,6,306,157,149,15
QUERÉTARO,22,TOLIMÁN,018,CARRIZALILLO,3,67,33,34,3
QUERÉTARO,22,TOLIMÁN,018,CASA BLANCA,4,704,370,334,24
QUERÉTARO,22,TOLIMÁN,018,CIPRÉS,1,4,1,3,1
QUERÉTARO,22,TOLIMÁN,018,DERRAMADERO,3,15,7,8,3
QUERÉTARO,22,TOLIMÁN,018,DIEZMEROS,1,42,12,30,2
QUERÉTARO,22,TOLIMÁN,018,DON LUCAS,1,3,1,2,1
QUERÉTARO,22,TOLIMÁN,018,EL CERRITO PARADO,3,53,30,23,4
QUERÉTARO,22,TOLIMÁN,018,EL CHILAR,3,86,40,46,5
QUERÉTARO,22,TOLIMÁN,018,EL MADROÑO,3,21,10,11,3
QUERÉTARO,22,TOLIMÁN,018,EL PATOL,2,4,2,2,2
QUERÉTARO,22,TOLIMÁN,018,EL SAUCITO,2,13,7,6,2
QUERÉTARO,22,TOLIMÁN,018,EL TERRERO,2,145,78,67,8
QUERÉTARO,22,TOLIMÁN,018,EL TULE,1,36,14,22,2
QUERÉTARO,22,TOLIMÁN,018,EL ZAPOTE,2,14,7,7,2
QUERÉTARO,22,TOLIMÁN,018,GRANJENO,2,392,200,192,13
QUERÉTARO,22,TOLIMÁN,018,GUDIÑOS,2,90,51,39,3
QUERÉTARO,22,TOLIMÁN,018,LA CAÑADA,1,4,1,3,1
QUERÉTARO,22,TOLIMÁN,018,LA MATAMBA DOS,2,4,2,2,2
QUERÉTARO,22,TOLIMÁN,018,LA PRESITA,2,14,7,7,2
QUERÉTARO,22,TOLIMÁN,018,LA VEREDA,3,28,11,17,3
QUERÉTARO,22,TOLIMÁN,018,LAS CRUCITAS,2,18,10,8,2
QUERÉTARO,22,TOLIMÁN,018,LINDERO,1,31,16,15,2
QUERÉTARO,22,TOLIMÁN,018,LOMAS DE CASA BLANCA,3,49,22,27,4
QUERÉTARO,22,TOLIMÁN,018,LOS GONZÁLEZ,2,150,70,80,9
QUERÉTARO,22,TOLIMÁN,018,MAGUEY MANSO,2,67,26,41,4
QUERÉTARO,22,TOLIMÁN,018,MANANTIAL,2,8,6,2,1
QUERÉTARO,22,TOLIMÁN,018,MESA DE CHAGOYA,2,21,9,12,2
QUERÉTARO,22,TOLIMÁN,018,MESA DE RAMÍREZ,4,339,167,172,15
QUERÉTARO,22,TOLIMÁN,018,NOGALES,2,83,42,41,4
QUERÉTARO,22,TOLIMÁN,018,PANALES,2,68,37,31,4
QUERÉTARO,22,TOLIMÁN,018,PUERTO BLANCO,4,111,48,63,7
QUERÉTARO,22,TOLIMÁN,018,RANCHO DE GUADALUPE,2,31,15,16,2
QUERÉTARO,22,TOLIMÁN,018,RANCHO NUEVO,3,87,45,42,7
QUERÉTARO,22,TOLIMÁN,018,RANCHO VIEJO,2,55,29,26,2
QUERÉTARO,22,TOLIMÁN,018,SABINO DE SAN AMBROSIO,4,228,125,103,11
QUERÉTARO,22,TOLIMÁN,018,SAN ANTONIO DE LA CAL,6,1063,549,514,44
QUERÉTARO,22,TOLIMÁN,018,SAN MIGUEL,2,233,125,108,10
QUERÉTARO,22,TOLIMÁN,018,SAN PABLO TOLIMÁN,9,914,448,466,43
QUERÉTARO,22,TOLIMÁN,018,TIERRA VOLTEADA,2,105,50,55,5
QUERÉTARO,22,TOLIMÁN,018,TOLIMÁN,13,2262,1175,1087,120
QUERÉTARO,22,TOLIMÁN,018,TUNA MANZA,2,9,3,6,1
QUERÉTARO,22,TOLIMÁN,018,ZAPOTE DE LOS URIBE (EL ZAPOTE),1,3,1,2,1
QUINTANA ROO,23,COZUMEL,001,COZUMEL,101,20650,10358,10292,1475
QUINTANA ROO,23,FELIPE CARRILLO PUERTO,002,ANDRÉS QUINTANA ROO,3,116,51,65,7
QUINTANA ROO,23,FELIPE CARRILLO PUERTO,002,BETANIA,3,176,87,89,10
QUINTANA ROO,23,FELIPE CARRILLO PUERTO,002,CANZEPCHÉN,2,67,36,31,3
QUINTANA ROO,23,FELIPE CARRILLO PUERTO,002,CECILIO CHÍ (KILÓMETRO SESENTA Y CUATRO),1,15,6,9,1
QUINTANA ROO,23,FELIPE CARRILLO PUERTO,002,CHAN CHEN CHUC,2,9,4,5,2
QUINTANA ROO,23,FELIPE CARRILLO PUERTO,002,CHAN SANTA CRUZ,4,173,93,80,9
QUINTANA ROO,23,FELIPE CARRILLO PUERTO,002,CHANCAH DERREPENTE,2,84,39,45,5
QUINTANA ROO,23,FELIPE CARRILLO PUERTO,002,CHANCAH VERACRUZ,3,135,61,74,7
QUINTANA ROO,23,FELIPE CARRILLO PUERTO,002,CHUMPÓN,5,361,176,185,16
QUINTANA ROO,23,FELIPE CARRILLO PUERTO,002,CHUN ON,3,101,52,49,5
QUINTANA ROO,23,FELIPE CARRILLO PUERTO,002,CHUNHUÁS,4,297,142,155,15
QUINTANA ROO,23,FELIPE CARRILLO PUERTO,002,CHUNHUHUB,10,1340,702,638,113
QUINTANA ROO,23,FELIPE CARRILLO PUERTO,002,CHUN-YAH,5,519,237,282,26
QUINTANA ROO,23,FELIPE CARRILLO PUERTO,002,CHUNYAXCHÉ,3,86,41,45,4
QUINTANA ROO,23,FELIPE CARRILLO PUERTO,002,CRUZ-CHEN,2,4,1,3,1
QUINTANA ROO,23,FELIPE CARRILLO PUERTO,002,DZOYOLA,4,166,77,89,9
QUINTANA ROO,23,FELIPE CARRILLO PUERTO,002,DZULÁ,5,320,148,172,16
QUINTANA ROO,23,FELIPE CARRILLO PUERTO,002,EMILIANO ZAPATA,3,107,48,59,6
QUINTANA ROO,23,FELIPE CARRILLO PUERTO,002,FELIPE CARRILLO PUERTO,44,9728,4984,4744,649
QUINTANA ROO,23,FELIPE CARRILLO PUERTO,002,FILOMENO MATA,4,216,105,111,13
QUINTANA ROO,23,FELIPE CARRILLO PUERTO,002,FRANCISCO I. MADERO,3,98,43,55,6
QUINTANA ROO,23,FELIPE CARRILLO PUERTO,002,FRANCISCO MAY,2,48,20,28,3
QUINTANA ROO,23,FELIPE CARRILLO PUERTO,002,HOBOMPICH,2,29,13,16,2
QUINTANA ROO,23,FELIPE CARRILLO PUERTO,002,IGNACIO MANUEL ALTAMIRANO,4,220,111,109,14
QUINTANA ROO,23,FELIPE CARRILLO PUERTO,002,JOSÉ MARÍA PINO SUÁREZ,2,65,35,30,3
QUINTANA ROO,23,FELIPE CARRILLO PUERTO,002,KAMPOKOLCHÉ,5,249,127,122,15
QUINTANA ROO,23,FELIPE CARRILLO PUERTO,002,KANKABDZONOT,3,58,27,31,4
QUINTANA ROO,23,FELIPE CARRILLO PUERTO,002,KOPCHEN,4,193,87,106,12
QUINTANA ROO,23,FELIPE CARRILLO PUERTO,002,LA NORIA,3,21,11,10,3
QUINTANA ROO,23,FELIPE CARRILLO PUERTO,002,LAGUNA KANÁ,4,268,140,128,16
QUINTANA ROO,23,FELIPE CARRILLO PUERTO,002,MELCHOR OCAMPO,2,21,9,12,2
QUINTANA ROO,23,FELIPE CARRILLO PUERTO,002,MIXTEQUILLA,2,18,9,9,2
QUINTANA ROO,23,FELIPE CARRILLO PUERTO,002,NARANJAL PONIENTE,3,196,113,83,12
QUINTANA ROO,23,FELIPE CARRILLO PUERTO,002,NOH-BEC,5,576,273,303,35
QUINTANA ROO,23,FELIPE CARRILLO PUERTO,002,NUEVA LORÍA,2,43,26,17,2
QUINTANA ROO,23,FELIPE CARRILLO PUERTO,002,NUEVO ISRAEL,3,77,35,42,6
QUINTANA ROO,23,FELIPE CARRILLO PUERTO,002,PETCACAB,4,222,121,101,12
QUINTANA ROO,23,FELIPE CARRILLO PUERTO,002,POLINKÍN,2,37,21,16,2
QUINTANA ROO,23,FELIPE CARRILLO PUERTO,002,POLYUC,4,320,162,158,15
QUINTANA ROO,23,FELIPE CARRILLO PUERTO,002,PRESIDENTE JUÁREZ,6,440,216,224,29
QUINTANA ROO,23,FELIPE CARRILLO PUERTO,002,RAMONAL,4,173,84,89,10
QUINTANA ROO,23,FELIPE CARRILLO PUERTO,002,REFORMA AGRARIA,3,115,61,54,6
QUINTANA ROO,23,FELIPE CARRILLO PUERTO,002,SAHCABCHÉN,1,7,4,3,1
QUINTANA ROO,23,FELIPE CARRILLO PUERTO,002,SAN ANDRÉS,2,55,28,27,3
QUINTANA ROO,23,FELIPE CARRILLO PUERTO,002,SAN ANTONIO NUEVO,3,20,9,11,3
QUINTANA ROO,23,FELIPE CARRILLO PUERTO,002,SAN BARTOLO,2,8,4,4,1
QUINTANA ROO,23,FELIPE CARRILLO PUERTO,002,SAN FELIPE BERRIOZÁBAL,3,153,82,71,8
QUINTANA ROO,23,FELIPE CARRILLO PUERTO,002,SAN FRANCISCO AKÉ,4,152,79,73,8
QUINTANA ROO,23,FELIPE CARRILLO PUERTO,002,SAN HIPÓLITO,3,19,9,10,3
QUINTANA ROO,23,FELIPE CARRILLO PUERTO,002,SAN JOSÉ SEGUNDO,2,41,21,20,2
QUINTANA ROO,23,FELIPE CARRILLO PUERTO,002,SAN LUIS,2,30,12,18,2
QUINTANA ROO,23,FELIPE CARRILLO PUERTO,002,SAN RAMÓN,3,169,79,90,11
QUINTANA ROO,23,FELIPE CARRILLO PUERTO,002,SAN SALVADOR,3,19,7,12,3
QUINTANA ROO,23,FELIPE CARRILLO PUERTO,002,SAN SILVERIO,4,218,101,117,12
QUINTANA ROO,23,FELIPE CARRILLO PUERTO,002,SANTA AMALIA,3,30,10,20,3
QUINTANA ROO,23,FELIPE CARRILLO PUERTO,002,SANTA ISABEL,3,27,11,16,4
QUINTANA ROO,23,FELIPE CARRILLO PUERTO,002,SANTA LUCÍA,2,13,4,9,2
QUINTANA ROO,23,FELIPE CARRILLO PUERTO,002,SANTA MARÍA PONIENTE,5,249,132,117,14
QUINTANA ROO,23,FELIPE CARRILLO PUERTO,002,SANTA ROSA SEGUNDO,4,276,131,145,16
QUINTANA ROO,23,FELIPE CARRILLO PUERTO,002,SEÑOR,7,1254,607,647,53
QUINTANA ROO,23,FELIPE CARRILLO PUERTO,002,TABI,3,80,43,37,5
QUINTANA ROO,23,FELIPE CARRILLO PUERTO,002,TAC-CHIVO,2,65,27,38,4
QUINTANA ROO,23,FELIPE CARRILLO PUERTO,002,TEPICH,6,1100,535,565,40
QUINTANA ROO,23,FELIPE CARRILLO PUERTO,002,TIHOSUCO,14,1738,897,841,73
QUINTANA ROO,23,FELIPE CARRILLO PUERTO,002,TIXCACAL GUARDIA,4,232,108,124,15
QUINTANA ROO,23,FELIPE CARRILLO PUERTO,002,TRANQUILO [RANCHO],2,6,5,1,1
QUINTANA ROO,23,FELIPE CARRILLO PUERTO,002,TRAPICH,4,144,80,64,9
QUINTANA ROO,23,FELIPE CARRILLO PUERTO,002,TRES REYES,2,29,15,14,2
QUINTANA ROO,23,FELIPE CARRILLO PUERTO,002,TUZIK,5,238,120,118,15
QUINTANA ROO,23,FELIPE CARRILLO PUERTO,002,TZUKUM,2,4,1,3,1
QUINTANA ROO,23,FELIPE CARRILLO PUERTO,002,UH MAY,4,162,85,77,8
QUINTANA ROO,23,FELIPE CARRILLO PUERTO,002,VILLAHERMOSA,2,42,21,21,3
QUINTANA ROO,23,FELIPE CARRILLO PUERTO,002,X-HAZIL NORTE,4,83,51,32,6
QUINTANA ROO,23,FELIPE CARRILLO PUERTO,002,X-HAZIL PRIMERO,3,26,14,12,3
QUINTANA ROO,23,FELIPE CARRILLO PUERTO,002,X-HAZIL SUR,5,562,278,284,26
QUINTANA ROO,23,FELIPE CARRILLO PUERTO,002,X-KONHA,2,13,8,5,2
QUINTANA ROO,23,FELIPE CARRILLO PUERTO,002,X-PICHIL,5,411,223,188,19
QUINTANA ROO,23,FELIPE CARRILLO PUERTO,002,X-YATIL,4,305,147,158,15
QUINTANA ROO,23,FELIPE CARRILLO PUERTO,002,YALCHÉN,4,224,94,130,12
QUINTANA ROO,23,FELIPE CARRILLO PUERTO,002,YAXCHÉ CHAL,2,12,5,7,1
QUINTANA ROO,23,FELIPE CARRILLO PUERTO,002,YAXLEY,4,163,79,84,11
QUINTANA ROO,23,FELIPE CARRILLO PUERTO,002,YOACTÚN,3,167,73,94,8
QUINTANA ROO,23,FELIPE CARRILLO PUERTO,002,YODZONOT CHICO,3,42,24,18,3
QUINTANA ROO,23,FELIPE CARRILLO PUERTO,002,YODZONOT NUEVO,3,21,7,14,2
QUINTANA ROO,23,ISLA MUJERES,003,FRANCISCO MAY,4,112,49,63,8
QUINTANA ROO,23,ISLA MUJERES,003,ISLA MUJERES,22,2921,1426,1495,193
QUINTANA ROO,23,ISLA MUJERES,003,LA VICTORIA,4,681,351,330,23
QUINTANA ROO,23,ISLA MUJERES,003,PUNTA SAM,1,62,49,13,28
QUINTANA ROO,23,ISLA MUJERES,003,RANCHO VIEJO,7,2394,1202,1192,118
QUINTANA ROO,23,ISLA MUJERES,003,SAN ANTONIO,3,30,13,17,5
QUINTANA ROO,23,OTHÓN P. BLANCO,004,ACADEMIA ESTATAL DE SEGURIDAD PÚBLICA,2,189,93,96,42
QUINTANA ROO,23,OTHÓN P. BLANCO,004,ALLENDE,6,220,99,121,15
QUINTANA ROO,23,OTHÓN P. BLANCO,004,ÁLVARO OBREGÓN,3,568,287,281,28
QUINTANA ROO,23,OTHÓN P. BLANCO,004,ÁLVARO OBREGÓN VIEJO,2,22,15,7,2
QUINTANA ROO,23,OTHÓN P. BLANCO,004,CACAO,4,494,250,244,26
QUINTANA ROO,23,OTHÓN P. BLANCO,004,CALDERITAS,6,927,447,480,41
QUINTANA ROO,23,OTHÓN P. BLANCO,004,CALIFORNIA,3,18,12,6,3
QUINTANA ROO,23,OTHÓN P. BLANCO,004,CAOBAS,4,426,218,208,21
QUINTANA ROO,23,OTHÓN P. BLANCO,004,CARLOS A. MADRAZO,5,787,406,381,51
QUINTANA ROO,23,OTHÓN P. BLANCO,004,CHETUMAL,302,50241,25162,25079,5010
QUINTANA ROO,23,OTHÓN P. BLANCO,004,CINCO DE MAYO,3,42,25,17,3
QUINTANA ROO,23,OTHÓN P. BLANCO,004,COCOYOL,3,212,92,120,11
QUINTANA ROO,23,OTHÓN P. BLANCO,004,DOS AGUADAS,3,66,34,32,4
QUINTANA ROO,23,OTHÓN P. BLANCO,004,EL CEDRAL,3,67,33,34,5
QUINTANA ROO,23,OTHÓN P. BLANCO,004,EL POTRILLO,3,7,4,3,2
QUINTANA ROO,23,OTHÓN P. BLANCO,004,ESTEBAN BACA CALDERÓN,4,59,28,31,6
QUINTANA ROO,23,OTHÓN P. BLANCO,004,FRANCISCO VILLA,4,246,128,118,14
QUINTANA ROO,23,OTHÓN P. BLANCO,004,FRATERNIDAD ANTORCHISTA,3,173,92,81,5
QUINTANA ROO,23,OTHÓN P. BLANCO,004,HUAY-PIX,4,454,228,226,23
QUINTANA ROO,23,OTHÓN P. BLANCO,004,ICAICHÉ,3,50,30,20,4
QUINTANA ROO,23,OTHÓN P. BLANCO,004,JAVIER ROJO GÓMEZ,5,668,337,331,34
QUINTANA ROO,23,OTHÓN P. BLANCO,004,JESÚS GONZÁLEZ ORTEGA,4,194,94,100,12
QUINTANA ROO,23,OTHÓN P. BLANCO,004,JOSÉ NARCISO ROVIROSA,4,319,157,162,18
QUINTANA ROO,23,OTHÓN P. BLANCO,004,JUAN SARABIA,6,795,364,431,72
QUINTANA ROO,23,OTHÓN P. BLANCO,004,LA LIBERTAD,3,87,38,49,5
QUINTANA ROO,23,OTHÓN P. BLANCO,004,LA UNIÓN,4,214,102,112,14
QUINTANA ROO,23,OTHÓN P. BLANCO,004,LAGUNA GUERRERO,4,231,108,123,15
QUINTANA ROO,23,OTHÓN P. BLANCO,004,LÁZARO CÁRDENAS SEGUNDO,2,127,54,73,8
QUINTANA ROO,23,OTHÓN P. BLANCO,004,LIMONAR,3,43,21,22,3
QUINTANA ROO,23,OTHÓN P. BLANCO,004,LOS ALACRANES,1,8,1,7,1
QUINTANA ROO,23,OTHÓN P. BLANCO,004,LUIS ECHEVERRÍA ÁLVAREZ,4,216,106,110,13
QUINTANA ROO,23,OTHÓN P. BLANCO,004,MAHAHUAL,4,886,438,448,30
QUINTANA ROO,23,OTHÓN P. BLANCO,004,MÁRTIRES ANTORCHISTAS,3,152,70,82,7
QUINTANA ROO,23,OTHÓN P. BLANCO,004,MOROCOY,4,386,203,183,16
QUINTANA ROO,23,OTHÓN P. BLANCO,004,NACHI COCOM,3,243,115,128,11
QUINTANA ROO,23,OTHÓN P. BLANCO,004,NICOLÁS BRAVO,6,1117,546,571,55
QUINTANA ROO,23,OTHÓN P. BLANCO,004,NUEVO BÉCAR,4,159,78,81,11
QUINTANA ROO,23,OTHÓN P. BLANCO,004,NUEVO CAANÁN,3,64,30,34,4
QUINTANA ROO,23,OTHÓN P. BLANCO,004,PALMAR,3,185,88,97,10
QUINTANA ROO,23,OTHÓN P. BLANCO,004,PEDRO JOAQUÍN COLDWELL,2,159,82,77,8
QUINTANA ROO,23,OTHÓN P. BLANCO,004,PUCTÉ,5,809,456,353,57
QUINTANA ROO,23,OTHÓN P. BLANCO,004,RAMONAL,5,250,126,124,14
QUINTANA ROO,23,OTHÓN P. BLANCO,004,RAUDALES,2,31,21,10,3
QUINTANA ROO,23,OTHÓN P. BLANCO,004,REVOLUCIÓN,3,21,14,7,3
QUINTANA ROO,23,OTHÓN P. BLANCO,004,SABIDOS,3,324,160,164,18
QUINTANA ROO,23,OTHÓN P. BLANCO,004,SACXÁN,3,223,110,113,11
QUINTANA ROO,23,OTHÓN P. BLANCO,004,SAN FRANCISCO BOTES,2,54,24,30,3
QUINTANA ROO,23,OTHÓN P. BLANCO,004,SAN JOSÉ DE LA MONTAÑA,3,56,27,29,4
QUINTANA ROO,23,OTHÓN P. BLANCO,004,SAN PEDRO PERALTA,4,310,174,136,17
QUINTANA ROO,23,OTHÓN P. BLANCO,004,SANTA ROSA,2,30,18,12,3
QUINTANA ROO,23,OTHÓN P. BLANCO,004,SERGIO BUTRÓN CASAS,4,357,169,188,20
QUINTANA ROO,23,OTHÓN P. BLANCO,004,SHEKINAH LA GLORIA DE DIOS,2,17,8,9,2
QUINTANA ROO,23,OTHÓN P. BLANCO,004,SUBTENIENTE LÓPEZ,5,946,414,532,164
QUINTANA ROO,23,OTHÓN P. BLANCO,004,TOMÁS GARRIDO CANABAL,3,55,25,30,4
QUINTANA ROO,23,OTHÓN P. BLANCO,004,TRES GARANTÍAS,4,187,87,100,13
QUINTANA ROO,23,OTHÓN P. BLANCO,004,UCUM,2,193,93,100,8
QUINTANA ROO,23,OTHÓN P. BLANCO,004,VERACRUZ,3,45,23,22,4
QUINTANA ROO,23,OTHÓN P. BLANCO,004,XCALAK,4,135,62,73,10
QUINTANA ROO,23,OTHÓN P. BLANCO,004,XUL-HA,3,517,245,272,22
QUINTANA ROO,23,BENITO JUÁREZ,005,ALFREDO V. BONFIL,33,4849,2393,2456,274
QUINTANA ROO,23,BENITO JUÁREZ,005,CANCÚN,781,209450,104301,105149,13354
QUINTANA ROO,23,BENITO JUÁREZ,005,COLONIA CHIAPANECA SIGLO XXI,3,73,38,35,4
QUINTANA ROO,23,BENITO JUÁREZ,005,EL PORVENIR,3,215,106,109,10
QUINTANA ROO,23,BENITO JUÁREZ,005,EMILIANO ZAPATA,3,30,13,17,4
QUINTANA ROO,23,JOSÉ MARÍA MORELOS,006,ADOLFO DE LA HUERTA,1,13,4,9,1
QUINTANA ROO,23,JOSÉ MARÍA MORELOS,006,ADOLFO LÓPEZ MATEOS,4,120,51,69,8
QUINTANA ROO,23,JOSÉ MARÍA MORELOS,006,AGUADA LA PRESUMIDA,3,23,10,13,3
QUINTANA ROO,23,JOSÉ MARÍA MORELOS,006,BENITO JUÁREZ,1,13,5,8,1
QUINTANA ROO,23,JOSÉ MARÍA MORELOS,006,BULUKAX,3,160,79,81,8
QUINTANA ROO,23,JOSÉ MARÍA MORELOS,006,CAFETAL GRANDE,2,57,30,27,3
QUINTANA ROO,23,JOSÉ MARÍA MORELOS,006,CAFETALITO,2,55,29,26,3
QUINTANA ROO,23,JOSÉ MARÍA MORELOS,006,CANDELARIA,5,490,252,238,22
QUINTANA ROO,23,JOSÉ MARÍA MORELOS,006,COLMENITAS,2,6,5,1,1
QUINTANA ROO,23,JOSÉ MARÍA MORELOS,006,DOS AGUADAS,2,38,20,18,2
QUINTANA ROO,23,JOSÉ MARÍA MORELOS,006,DZIUCHÉ,6,946,471,475,87
QUINTANA ROO,23,JOSÉ MARÍA MORELOS,006,EL MARTIRIO,2,21,10,11,2
QUINTANA ROO,23,JOSÉ MARÍA MORELOS,006,EL NARANJAL,4,304,163,141,16
QUINTANA ROO,23,JOSÉ MARÍA MORELOS,006,EL TRIUNFO,2,28,12,16,2
QUINTANA ROO,23,JOSÉ MARÍA MORELOS,006,GAVILANES,4,171,89,82,11
QUINTANA ROO,23,JOSÉ MARÍA MORELOS,006,HUAY MAX,4,445,206,239,19
QUINTANA ROO,23,JOSÉ MARÍA MORELOS,006,INSURGENTES,2,20,10,10,2
QUINTANA ROO,23,JOSÉ MARÍA MORELOS,006,JOSÉ MARÍA MORELOS,20,4125,2031,2094,176
QUINTANA ROO,23,JOSÉ MARÍA MORELOS,006,KANCABCHÉN,5,389,209,180,19
QUINTANA ROO,23,JOSÉ MARÍA MORELOS,006,KANTEMÓ,2,32,14,18,3
QUINTANA ROO,23,JOSÉ MARÍA MORELOS,006,LA CAROLINA,2,16,9,7,2
QUINTANA ROO,23,JOSÉ MARÍA MORELOS,006,LA ESPERANZA,5,295,143,152,16
QUINTANA ROO,23,JOSÉ MARÍA MORELOS,006,LA PIMIENTITA,3,76,36,40,4
QUINTANA ROO,23,JOSÉ MARÍA MORELOS,006,LA PRESUMIDA,4,1171,622,549,42
QUINTANA ROO,23,JOSÉ MARÍA MORELOS,006,LÁZARO CÁRDENAS,3,56,27,29,4
QUINTANA ROO,23,JOSÉ MARÍA MORELOS,006,LOS LAGARTOS,2,7,3,4,2
QUINTANA ROO,23,JOSÉ MARÍA MORELOS,006,NUEVA REFORMA,3,84,33,51,4
QUINTANA ROO,23,JOSÉ MARÍA MORELOS,006,NUEVO PLAN DE LA NORIA,2,75,32,43,3
QUINTANA ROO,23,JOSÉ MARÍA MORELOS,006,NUEVO SAN MARCOS,3,37,19,18,4
QUINTANA ROO,23,JOSÉ MARÍA MORELOS,006,OTHÓN P. BLANCO,3,161,80,81,10
QUINTANA ROO,23,JOSÉ MARÍA MORELOS,006,PEDRO MORENO,1,9,6,3,1
QUINTANA ROO,23,JOSÉ MARÍA MORELOS,006,PIEDRAS NEGRAS,2,32,15,17,2
QUINTANA ROO,23,JOSÉ MARÍA MORELOS,006,PLAN DE LA NORIA PONIENTE,4,120,58,62,9
QUINTANA ROO,23,JOSÉ MARÍA MORELOS,006,POZO PIRATA,4,58,28,30,5
QUINTANA ROO,23,JOSÉ MARÍA MORELOS,006,PUERTO ARTURO,4,224,111,113,14
QUINTANA ROO,23,JOSÉ MARÍA MORELOS,006,SABÁN,7,1038,506,532,43
QUINTANA ROO,23,JOSÉ MARÍA MORELOS,006,SABANA SAN FRANCISCO,3,28,14,14,3
QUINTANA ROO,23,JOSÉ MARÍA MORELOS,006,SACALACA,5,320,144,176,18
QUINTANA ROO,23,JOSÉ MARÍA MORELOS,006,SACZUQUIL,3,101,47,54,4
QUINTANA ROO,23,JOSÉ MARÍA MORELOS,006,SAN ANTONIO TUK,3,51,23,28,3
QUINTANA ROO,23,JOSÉ MARÍA MORELOS,006,SAN CARLOS,3,42,27,15,3
QUINTANA ROO,23,JOSÉ MARÍA MORELOS,006,SAN DIEGO,4,248,136,112,12
QUINTANA ROO,23,JOSÉ MARÍA MORELOS,006,SAN FELIPE ORIENTE,2,49,27,22,3
QUINTANA ROO,23,JOSÉ MARÍA MORELOS,006,SAN FELIPE PRIMERO,4,282,153,129,16
QUINTANA ROO,23,JOSÉ MARÍA MORELOS,006,SAN FELIPE SEGUNDO,2,66,26,40,4
QUINTANA ROO,23,JOSÉ MARÍA MORELOS,006,SAN ISIDRO PONIENTE,3,57,28,29,4
QUINTANA ROO,23,JOSÉ MARÍA MORELOS,006,SAN JUAN ORIENTE,2,41,24,17,2
QUINTANA ROO,23,JOSÉ MARÍA MORELOS,006,SANTA GERTRUDIS,4,282,134,148,14
QUINTANA ROO,23,JOSÉ MARÍA MORELOS,006,TABASCO,3,74,33,41,4
QUINTANA ROO,23,JOSÉ MARÍA MORELOS,006,VENUSTIANO CARRANZA,3,76,29,47,4
QUINTANA ROO,23,JOSÉ MARÍA MORELOS,006,X-CABIL,4,350,168,182,16
QUINTANA ROO,23,JOSÉ MARÍA MORELOS,006,XNOH CRUZ,2,61,23,38,3
QUINTANA ROO,23,JOSÉ MARÍA MORELOS,006,X-QUEROL,2,11,5,6,2
QUINTANA ROO,23,JOSÉ MARÍA MORELOS,006,ZAFARRANCHO,4,144,62,82,7
QUINTANA ROO,23,LÁZARO CÁRDENAS,007,AGUA AZUL,5,205,108,97,11
QUINTANA ROO,23,LÁZARO CÁRDENAS,007,CHIQUILÁ,4,752,373,379,29
QUINTANA ROO,23,LÁZARO CÁRDENAS,007,CONSTITUYENTES DEL SETENTA Y CUATRO,3,37,14,23,3
QUINTANA ROO,23,LÁZARO CÁRDENAS,007,CRISTÓBAL COLÓN,3,106,54,52,4
QUINTANA ROO,23,LÁZARO CÁRDENAS,007,DELIRIOS,2,8,3,5,1
QUINTANA ROO,23,LÁZARO CÁRDENAS,007,EBEN EZER,3,21,10,11,3
QUINTANA ROO,23,LÁZARO CÁRDENAS,007,EL CEDRAL,4,259,128,131,13
QUINTANA ROO,23,LÁZARO CÁRDENAS,007,EL IDEAL,4,311,159,152,14
QUINTANA ROO,23,LÁZARO CÁRDENAS,007,EL NARANJAL,2,15,8,7,2
QUINTANA ROO,23,LÁZARO CÁRDENAS,007,EL POCITO,1,17,8,9,1
QUINTANA ROO,23,LÁZARO CÁRDENAS,007,EL TINTAL,5,469,212,257,20
QUINTANA ROO,23,LÁZARO CÁRDENAS,007,ESPERANZA,4,159,90,69,8
QUINTANA ROO,23,LÁZARO CÁRDENAS,007,GUADALUPE VICTORIA,3,24,12,12,3
QUINTANA ROO,23,LÁZARO CÁRDENAS,007,HÉROE DE NACOZARI,3,54,26,28,4
QUINTANA ROO,23,LÁZARO CÁRDENAS,007,HOLBOX,4,536,254,282,30
QUINTANA ROO,23,LÁZARO CÁRDENAS,007,IGNACIO ZARAGOZA,6,833,397,436,56
QUINTANA ROO,23,LÁZARO CÁRDENAS,007,JUÁREZ,3,29,19,10,3
QUINTANA ROO,23,LÁZARO CÁRDENAS,007,KANTUNILKÍN,9,2187,1072,1115,124
QUINTANA ROO,23,LÁZARO CÁRDENAS,007,NUEVO DURANGO,3,49,25,24,3
QUINTANA ROO,23,LÁZARO CÁRDENAS,007,NUEVO VALLADOLID,5,426,206,220,19
QUINTANA ROO,23,LÁZARO CÁRDENAS,007,NUEVO XCÁN,4,280,130,150,14
QUINTANA ROO,23,LÁZARO CÁRDENAS,007,PACCHEN,2,26,11,15,2
QUINTANA ROO,23,LÁZARO CÁRDENAS,007,SAN ÁNGEL,4,379,181,198,18
QUINTANA ROO,23,LÁZARO CÁRDENAS,007,SAN ANTONIO,2,8,5,3,1
QUINTANA ROO,23,LÁZARO CÁRDENAS,007,SAN COSME,3,96,44,52,5
QUINTANA ROO,23,LÁZARO CÁRDENAS,007,SAN FRANCISCO,4,334,157,177,16
QUINTANA ROO,23,LÁZARO CÁRDENAS,007,SAN JUAN DE DIOS,3,89,42,47,5
QUINTANA ROO,23,LÁZARO CÁRDENAS,007,SAN LORENZO,2,34,12,22,2
QUINTANA ROO,23,LÁZARO CÁRDENAS,007,SAN MARTINIANO,3,46,27,19,4
QUINTANA ROO,23,LÁZARO CÁRDENAS,007,SAN ROMÁN,2,23,12,11,2
QUINTANA ROO,23,LÁZARO CÁRDENAS,007,SANTA MELVA,2,17,7,10,1
QUINTANA ROO,23,LÁZARO CÁRDENAS,007,SANTO DOMINGO,4,115,48,67,6
QUINTANA ROO,23,LÁZARO CÁRDENAS,007,SOLFERINO,4,302,157,145,15
QUINTANA ROO,23,LÁZARO CÁRDENAS,007,TRES REYES,4,168,63,105,10
QUINTANA ROO,23,LÁZARO CÁRDENAS,007,VICENTE GUERRERO,4,182,82,100,11
QUINTANA ROO,23,LÁZARO CÁRDENAS,007,VILLA GUADALUPE,2,5,2,3,1
QUINTANA ROO,23,SOLIDARIDAD,008,EL SAUCE,3,150,71,79,7
QUINTANA ROO,23,SOLIDARIDAD,008,HIDALGO Y CORTEZ,2,31,14,17,3
QUINTANA ROO,23,SOLIDARIDAD,008,LOS FAISANES,3,64,33,31,3
QUINTANA ROO,23,SOLIDARIDAD,008,LOS PÁJAROS,2,20,9,11,2
QUINTANA ROO,23,SOLIDARIDAD,008,NUEVO NOH-BEC,3,735,368,367,27
QUINTANA ROO,23,SOLIDARIDAD,008,PARAÍSO,2,30,7,23,2
QUINTANA ROO,23,SOLIDARIDAD,008,PLAYA DEL CARMEN,289,73368,37171,36197,4259
QUINTANA ROO,23,SOLIDARIDAD,008,PUERTO AVENTURAS,22,5116,2578,2538,252
QUINTANA ROO,23,SOLIDARIDAD,008,PUNTA LAGUNA,3,19,11,8,3
QUINTANA ROO,23,SOLIDARIDAD,008,SAN CARLOS,2,17,11,6,2
QUINTANA ROO,23,SOLIDARIDAD,008,SANTA CECILIA,3,25,13,12,3
QUINTANA ROO,23,SOLIDARIDAD,008,TORRES DE LA PAZ,3,82,43,39,5
QUINTANA ROO,23,SOLIDARIDAD,008,VALLE ENCANTADO,3,33,12,21,3
QUINTANA ROO,23,SOLIDARIDAD,008,VIDA Y ESPERANZA,3,58,30,28,3
QUINTANA ROO,23,TULUM,009,AKUMAL,6,737,350,387,28
QUINTANA ROO,23,TULUM,009,ALDEA TULUM,3,278,115,163,17
QUINTANA ROO,23,TULUM,009,CHANCHÉN PALMAR,4,192,84,108,10
QUINTANA ROO,23,TULUM,009,CHANCHEN PRIMERO,4,474,207,267,21
QUINTANA ROO,23,TULUM,009,CIUDAD CHEMUYIL,4,382,184,198,18
QUINTANA ROO,23,TULUM,009,COBÁ,6,608,265,343,25
QUINTANA ROO,23,TULUM,009,FRANCISCO UH MAY,7,1017,531,486,38
QUINTANA ROO,23,TULUM,009,GRAN BAHÍA PRÍNCIPE,4,120,70,50,20
QUINTANA ROO,23,TULUM,009,HONDZONOT,2,69,37,32,3
QUINTANA ROO,23,TULUM,009,JAVIER ROJO GÓMEZ (PUNTA ALLEN),3,124,60,64,6
QUINTANA ROO,23,TULUM,009,MACARIO GÓMEZ,3,304,155,149,11
QUINTANA ROO,23,TULUM,009,MANUEL ANTONIO AY,3,180,88,92,7
QUINTANA ROO,23,TULUM,009,SAHCAB MUCUY,2,138,68,70,5
QUINTANA ROO,23,TULUM,009,SAN JUAN,4,291,150,141,15
QUINTANA ROO,23,TULUM,009,SAN PEDRO,3,32,16,16,3
QUINTANA ROO,23,TULUM,009,TULUM,39,9273,4593,4680,453
QUINTANA ROO,23,TULUM,009,YAXCHÉ,2,80,46,34,4
QUINTANA ROO,23,BACALAR,010,ALTOS DE SEVILLA,4,227,93,134,14
QUINTANA ROO,23,BACALAR,010,BACALAR,20,4585,2399,2186,291
QUINTANA ROO,23,BACALAR,010,BLANCA FLOR,4,266,124,142,15
QUINTANA ROO,23,BACALAR,010,BUENA ESPERANZA,3,78,39,39,5
QUINTANA ROO,23,BACALAR,010,BUENAVISTA,4,194,96,98,10
QUINTANA ROO,23,BACALAR,010,CAAN LUMIL,3,109,53,56,6
QUINTANA ROO,23,BACALAR,010,CAANÁN,3,34,18,16,3
QUINTANA ROO,23,BACALAR,010,CHACCHOBEN,3,107,47,60,6
QUINTANA ROO,23,BACALAR,010,CHULA VISTA,3,27,15,12,3
QUINTANA ROO,23,BACALAR,010,DAVID GUSTAVO GUTIÉRREZ RUIZ,3,117,63,54,6
QUINTANA ROO,23,BACALAR,010,DIECIOCHO DE MARZO,2,30,10,20,3
QUINTANA ROO,23,BACALAR,010,EL CEDRALITO,4,136,74,62,9
QUINTANA ROO,23,BACALAR,010,EL PARAÍSO,3,31,14,17,3
QUINTANA ROO,23,BACALAR,010,EL PROGRESO,2,28,10,18,2
QUINTANA ROO,23,BACALAR,010,FRANCISCO J. MÚJICA,3,37,21,16,3
QUINTANA ROO,23,BACALAR,010,GUADALUPE VICTORIA,2,102,53,49,5
QUINTANA ROO,23,BACALAR,010,GUSTAVO DÍAZ ORDAZ,3,23,13,10,3
QUINTANA ROO,23,BACALAR,010,HUATUSCO,4,156,70,86,9
QUINTANA ROO,23,BACALAR,010,ISIDRO FABELA,2,9,5,4,2
QUINTANA ROO,23,BACALAR,010,ITURBIDE,2,18,10,8,2
QUINTANA ROO,23,BACALAR,010,JESÚS MARTÍNEZ ROSS,3,38,13,25,3
QUINTANA ROO,23,BACALAR,010,KUCHUMATÁN,3,286,155,131,13
QUINTANA ROO,23,BACALAR,010,LA BUENA FE,2,41,18,23,2
QUINTANA ROO,23,BACALAR,010,LA CEIBA,3,32,18,14,3
QUINTANA ROO,23,BACALAR,010,LA PANTERA,4,292,145,147,16
QUINTANA ROO,23,BACALAR,010,LÁZARO CÁRDENAS,3,132,64,68,6
QUINTANA ROO,23,BACALAR,010,LÁZARO CÁRDENAS DEL RÍO TERCERO,3,66,34,32,4
QUINTANA ROO,23,BACALAR,010,LIMONES,5,751,385,366,30
QUINTANA ROO,23,BACALAR,010,LOS DIVORCIADOS,4,465,241,224,21
QUINTANA ROO,23,BACALAR,010,MANUEL ÁVILA CAMACHO,4,301,144,157,15
QUINTANA ROO,23,BACALAR,010,MARGARITA MAZA DE JUÁREZ,4,130,63,67,8
QUINTANA ROO,23,BACALAR,010,MAYA BALAM,5,831,426,405,37
QUINTANA ROO,23,BACALAR,010,MELCHOR OCAMPO,3,136,66,70,6
QUINTANA ROO,23,BACALAR,010,MIGUEL ALEMÁN,4,228,129,99,16
QUINTANA ROO,23,BACALAR,010,MIGUEL HIDALGO Y COSTILLA,3,235,123,112,11
QUINTANA ROO,23,BACALAR,010,MONTE OLIVO,2,23,12,11,3
QUINTANA ROO,23,BACALAR,010,NUEVO HOCTÚN,3,20,10,10,2
QUINTANA ROO,23,BACALAR,010,NUEVO JERUSALÉN,4,154,81,73,10
QUINTANA ROO,23,BACALAR,010,NUEVO TABASCO,3,45,18,27,4
QUINTANA ROO,23,BACALAR,010,OTILIO MONTAÑO,3,111,53,58,6
QUINTANA ROO,23,BACALAR,010,PAYO OBISPO,3,36,19,17,4
QUINTANA ROO,23,BACALAR,010,PEDRO ANTONIO SANTOS,3,148,86,62,7
QUINTANA ROO,23,BACALAR,010,REFORMA,4,353,152,201,17
QUINTANA ROO,23,BACALAR,010,RÍO ESCONDIDO,3,63,28,35,4
QUINTANA ROO,23,BACALAR,010,RÍO VERDE,4,161,70,91,13
QUINTANA ROO,23,BACALAR,010,SAN FERNANDO,3,85,36,49,5
QUINTANA ROO,23,BACALAR,010,SAN ISIDRO LA LAGUNA,4,387,197,190,19
QUINTANA ROO,23,BACALAR,010,SAN ROMÁN,4,175,93,82,12
QUINTANA ROO,23,BACALAR,010,TIERRA NEGRA,2,29,15,14,2
QUINTANA ROO,23,BACALAR,010,VALENTÍN GÓMEZ FARÍAS,3,28,16,12,3
QUINTANA ROO,23,BACALAR,010,VALLEHERMOSO,4,209,111,98,12
QUINTANA ROO,23,BACALAR,010,ZAMORA,4,181,94,87,12
QUINTANA ROO,23,PUERTO MORELOS,011,CENTRAL VALLARTA,2,17,9,8,2
QUINTANA ROO,23,PUERTO MORELOS,011,EL RETOÑO,2,10,5,5,2
QUINTANA ROO,23,PUERTO MORELOS,011,LEONA VICARIO,10,2210,1098,1112,141
QUINTANA ROO,23,PUERTO MORELOS,011,PUERTO MORELOS,20,3769,1937,1832,164
SAN LUIS POTOSÍ,24,AHUALULCO DEL SONIDO 13,001,AHUALULCO DEL SONIDO 13,7,2186,1141,1045,95
SAN LUIS POTOSÍ,24,AHUALULCO DEL SONIDO 13,001,ARENAL DE MORELOS,3,24,10,14,3
SAN LUIS POTOSÍ,24,AHUALULCO DEL SONIDO 13,001,ARROYO BLANCO,2,4,2,2,1
SAN LUIS POTOSÍ,24,AHUALULCO DEL SONIDO 13,001,BARRANCAS,3,129,53,76,8
SAN LUIS POTOSÍ,24,AHUALULCO DEL SONIDO 13,001,CAÑADA GRANDE,3,78,28,50,6
SAN LUIS POTOSÍ,24,AHUALULCO DEL SONIDO 13,001,CAÑADA GRANDE (EL BOSQUE),1,7,3,4,1
SAN LUIS POTOSÍ,24,AHUALULCO DEL SONIDO 13,001,CAÑÓN DE YERBABUENA,3,40,19,21,4
SAN LUIS POTOSÍ,24,AHUALULCO DEL SONIDO 13,001,CASITA BLANCA,2,4,3,1,1
SAN LUIS POTOSÍ,24,AHUALULCO DEL SONIDO 13,001,CERRITO DE ROJAS,4,232,108,124,13
SAN LUIS POTOSÍ,24,AHUALULCO DEL SONIDO 13,001,CERRO BLANCO,3,62,29,33,5
SAN LUIS POTOSÍ,24,AHUALULCO DEL SONIDO 13,001,CIENEGUITA (CIENEGUILLA),2,10,6,4,1
SAN LUIS POTOSÍ,24,AHUALULCO DEL SONIDO 13,001,CLAVELLINAS,2,131,66,65,7
SAN LUIS POTOSÍ,24,AHUALULCO DEL SONIDO 13,001,COCHINILLAS,2,33,17,16,2
SAN LUIS POTOSÍ,24,AHUALULCO DEL SONIDO 13,001,COLONIA DE LA CRUZ,3,56,20,36,4
SAN LUIS POTOSÍ,24,AHUALULCO DEL SONIDO 13,001,COYOTILLOS,3,91,33,58,5
SAN LUIS POTOSÍ,24,AHUALULCO DEL SONIDO 13,001,EJIDO DEL CENTRO,3,68,29,39,4
SAN LUIS POTOSÍ,24,AHUALULCO DEL SONIDO 13,001,EL NOVILLO,2,13,3,10,1
SAN LUIS POTOSÍ,24,AHUALULCO DEL SONIDO 13,001,EL PASTILLO,2,23,11,12,3
SAN LUIS POTOSÍ,24,AHUALULCO DEL SONIDO 13,001,EL SALITRE,2,25,12,13,2
SAN LUIS POTOSÍ,24,AHUALULCO DEL SONIDO 13,001,EL SALTO,2,6,3,3,1
SAN LUIS POTOSÍ,24,AHUALULCO DEL SONIDO 13,001,EL TEMAZCAL,3,49,20,29,5
SAN LUIS POTOSÍ,24,AHUALULCO DEL SONIDO 13,001,EL TEPOZÁN,2,5,4,1,1
SAN LUIS POTOSÍ,24,AHUALULCO DEL SONIDO 13,001,EL TULILLO,4,45,19,26,3
SAN LUIS POTOSÍ,24,AHUALULCO DEL SONIDO 13,001,EL TULILLO (SAN NICOLÁS),1,6,4,2,1
SAN LUIS POTOSÍ,24,AHUALULCO DEL SONIDO 13,001,EL ZAPATERO,3,55,23,32,3
SAN LUIS POTOSÍ,24,AHUALULCO DEL SONIDO 13,001,EL ZAPOTE (CERRITO BLANCO),5,116,56,60,12
SAN LUIS POTOSÍ,24,AHUALULCO DEL SONIDO 13,001,ESTACIÓN IPIÑA,3,53,27,26,4
SAN LUIS POTOSÍ,24,AHUALULCO DEL SONIDO 13,001,LA ENCARNACIÓN,3,99,45,54,7
SAN LUIS POTOSÍ,24,AHUALULCO DEL SONIDO 13,001,LA HIGUERA,3,36,18,18,3
SAN LUIS POTOSÍ,24,AHUALULCO DEL SONIDO 13,001,LA PARADA,2,45,18,27,3
SAN LUIS POTOSÍ,24,AHUALULCO DEL SONIDO 13,001,LA TRINIDAD,3,22,10,12,3
SAN LUIS POTOSÍ,24,AHUALULCO DEL SONIDO 13,001,LOS ÁRBOLES (COLONIA DE LA CRUZ),2,14,9,5,2
SAN LUIS POTOSÍ,24,AHUALULCO DEL SONIDO 13,001,LOS CERRITOS,2,16,9,7,2
SAN LUIS POTOSÍ,24,AHUALULCO DEL SONIDO 13,001,MINA BLANCA,3,42,22,20,4
SAN LUIS POTOSÍ,24,AHUALULCO DEL SONIDO 13,001,PASO BONITO,4,499,261,238,27
SAN LUIS POTOSÍ,24,AHUALULCO DEL SONIDO 13,001,PEDREGAL,3,43,13,30,3
SAN LUIS POTOSÍ,24,AHUALULCO DEL SONIDO 13,001,POTRERILLOS,2,26,13,13,2
SAN LUIS POTOSÍ,24,AHUALULCO DEL SONIDO 13,001,POTRERO AGUA BENDITA,2,6,3,3,1
SAN LUIS POTOSÍ,24,AHUALULCO DEL SONIDO 13,001,RINCÓN DE YERBABUENA,3,48,21,27,5
SAN LUIS POTOSÍ,24,AHUALULCO DEL SONIDO 13,001,SAN ANTONIO OJO DE AGUA,4,64,32,32,5
SAN LUIS POTOSÍ,24,AHUALULCO DEL SONIDO 13,001,SAN IGNACIO,2,6,2,4,1
SAN LUIS POTOSÍ,24,AHUALULCO DEL SONIDO 13,001,SAN JUAN (SAN JUAN DE COYOTILLOS),3,124,64,60,8
SAN LUIS POTOSÍ,24,AHUALULCO DEL SONIDO 13,001,SAN JUAN DE LA HIJA,3,14,7,7,2
SAN LUIS POTOSÍ,24,AHUALULCO DEL SONIDO 13,001,SAN SALVADOR,2,31,10,21,3
SAN LUIS POTOSÍ,24,AHUALULCO DEL SONIDO 13,001,SANTA PETRONILAS,3,26,8,18,3
SAN LUIS POTOSÍ,24,AHUALULCO DEL SONIDO 13,001,SANTA TERESA,3,157,82,75,10
SAN LUIS POTOSÍ,24,AHUALULCO DEL SONIDO 13,001,TIERRA PRIETA,1,4,2,2,1
SAN LUIS POTOSÍ,24,AHUALULCO DEL SONIDO 13,001,TINAJA,3,21,7,14,3
SAN LUIS POTOSÍ,24,AHUALULCO DEL SONIDO 13,001,YERBABUENA,3,64,28,36,7
SAN LUIS POTOSÍ,24,ALAQUINES,002,ALAQUINES,7,341,170,171,28
SAN LUIS POTOSÍ,24,ALAQUINES,002,CAÑADITAS,3,15,8,7,3
SAN LUIS POTOSÍ,24,ALAQUINES,002,COLONIA INDÍGENA (PASCUAL OSORIO ORTEGA),1,46,25,21,4
SAN LUIS POTOSÍ,24,ALAQUINES,002,EL CALLEJÓN DE LA LUZ,3,37,14,23,3
SAN LUIS POTOSÍ,24,ALAQUINES,002,EL LLANITO,2,31,18,13,2
SAN LUIS POTOSÍ,24,ALAQUINES,002,EL SABINO,3,86,45,41,6
SAN LUIS POTOSÍ,24,ALAQUINES,002,LA CAÑADA,4,158,77,81,14
SAN LUIS POTOSÍ,24,ALAQUINES,002,LAS CRUCITAS,2,4,4,0,1
SAN LUIS POTOSÍ,24,ALAQUINES,002,LAS HUERTAS,3,52,28,24,3
SAN LUIS POTOSÍ,24,ALAQUINES,002,LAS PEÑITAS,3,28,16,12,3
SAN LUIS POTOSÍ,24,ALAQUINES,002,LAS TUZAS,2,14,5,9,2
SAN LUIS POTOSÍ,24,ALAQUINES,002,LOS POCITOS (LOS POZOS),3,37,19,18,3
SAN LUIS POTOSÍ,24,ALAQUINES,002,MALDONADO,1,5,2,3,1
SAN LUIS POTOSÍ,24,ALAQUINES,002,MARTÍNEZ,3,164,73,91,11
SAN LUIS POTOSÍ,24,ALAQUINES,002,NUEVA REFORMA,3,41,23,18,3
SAN LUIS POTOSÍ,24,ALAQUINES,002,OJO DE AGUA,3,57,24,33,3
SAN LUIS POTOSÍ,24,ALAQUINES,002,OLLA DEL DURAZNO (JOYA DEL DURAZNO),4,79,52,27,6
SAN LUIS POTOSÍ,24,ALAQUINES,002,PASITO DE SAN FRANCISCO,2,5,1,4,1
SAN LUIS POTOSÍ,24,ALAQUINES,002,PASO DE MENDIOLAS,1,9,3,6,1
SAN LUIS POTOSÍ,24,ALAQUINES,002,RANCHO DE MORALES,1,15,5,10,1
SAN LUIS POTOSÍ,24,ALAQUINES,002,RANCHO DE PRO,4,240,116,124,14
SAN LUIS POTOSÍ,24,ALAQUINES,002,RANCHO NUEVO,3,94,46,48,6
SAN LUIS POTOSÍ,24,ALAQUINES,002,RINCÓN GRANDE,2,11,8,3,1
SAN LUIS POTOSÍ,24,ALAQUINES,002,SAN ANTONIO DE LAS TORTUGAS,3,20,9,11,3
SAN LUIS POTOSÍ,24,ALAQUINES,002,SAN JOSÉ DE PALMAS,3,54,26,28,4
SAN LUIS POTOSÍ,24,ALAQUINES,002,SAN JOSÉ DEL CORITO,3,67,36,31,5
SAN LUIS POTOSÍ,24,AQUISMÓN,003,AGUA AMARGA,3,160,89,71,11
SAN LUIS POTOSÍ,24,AQUISMÓN,003,ALITZÉ,4,151,70,81,12
SAN LUIS POTOSÍ,24,AQUISMÓN,003,AQUISMÓN,9,1573,792,781,76
SAN LUIS POTOSÍ,24,AQUISMÓN,003,BARRIO DE JOLJA,2,39,25,14,3
SAN LUIS POTOSÍ,24,AQUISMÓN,003,BARRIO DE LAS GOLONDRINAS,2,40,24,16,4
SAN LUIS POTOSÍ,24,AQUISMÓN,003,BARRIO EL CHAMAL,3,49,27,22,4
SAN LUIS POTOSÍ,24,AQUISMÓN,003,BARRIO EL PROGRESO,1,17,7,10,1
SAN LUIS POTOSÍ,24,AQUISMÓN,003,BARRIO LA CRUZ,4,236,110,126,15
SAN LUIS POTOSÍ,24,AQUISMÓN,003,BARRIO LA MINA,2,56,25,31,4
SAN LUIS POTOSÍ,24,AQUISMÓN,003,BARRIO LA SAGRADA FAMILIA,2,24,13,11,3
SAN LUIS POTOSÍ,24,AQUISMÓN,003,BARRIO SAN JOSÉ,2,36,14,22,2
SAN LUIS POTOSÍ,24,AQUISMÓN,003,BARRIO SAN MIGUEL,3,102,60,42,6
SAN LUIS POTOSÍ,24,AQUISMÓN,003,CAMARONES,2,17,6,11,2
SAN LUIS POTOSÍ,24,AQUISMÓN,003,CUETÁB,4,73,37,36,7
SAN LUIS POTOSÍ,24,AQUISMÓN,003,EL AGUACATE,6,353,182,171,26
SAN LUIS POTOSÍ,24,AQUISMÓN,003,EL CARACOL,2,14,7,7,2
SAN LUIS POTOSÍ,24,AQUISMÓN,003,EL JABALÍ,3,126,72,54,8
SAN LUIS POTOSÍ,24,AQUISMÓN,003,EL MIRADOR,2,17,8,9,2
SAN LUIS POTOSÍ,24,AQUISMÓN,003,EL NARANJITO,3,94,46,48,6
SAN LUIS POTOSÍ,24,AQUISMÓN,003,EL OTATE,3,68,38,30,6
SAN LUIS POTOSÍ,24,AQUISMÓN,003,EL PEMOCHE,3,11,5,6,3
SAN LUIS POTOSÍ,24,AQUISMÓN,003,EL PROGRESO,1,36,19,17,2
SAN LUIS POTOSÍ,24,AQUISMÓN,003,EL ROSARIO,3,87,52,35,7
SAN LUIS POTOSÍ,24,AQUISMÓN,003,EL SABINAL,1,3,0,3,1
SAN LUIS POTOSÍ,24,AQUISMÓN,003,EL SAUZ (EL SAUCITO),4,213,115,98,14
SAN LUIS POTOSÍ,24,AQUISMÓN,003,EL TÚNEL,2,10,6,4,2
SAN LUIS POTOSÍ,24,AQUISMÓN,003,EL VERGEL,1,30,16,14,2
SAN LUIS POTOSÍ,24,AQUISMÓN,003,EL VOLANTÍN,1,12,6,6,1
SAN LUIS POTOSÍ,24,AQUISMÓN,003,EL ZOPOPE,4,317,152,165,21
SAN LUIS POTOSÍ,24,AQUISMÓN,003,EUREKA,11,297,139,158,22
SAN LUIS POTOSÍ,24,AQUISMÓN,003,JAGÜEY CERCADO,2,32,17,15,3
SAN LUIS POTOSÍ,24,AQUISMÓN,003,JOL MOM,4,196,94,102,14
SAN LUIS POTOSÍ,24,AQUISMÓN,003,JOYA DE LAS VACAS,3,54,26,28,5
SAN LUIS POTOSÍ,24,AQUISMÓN,003,LA BRECHA (LA BRECHA DE TANTZOTZOB),4,79,36,43,6
SAN LUIS POTOSÍ,24,AQUISMÓN,003,LA CALDERA,3,235,100,135,14
SAN LUIS POTOSÍ,24,AQUISMÓN,003,LA CAÑADA (LOS CORRALES),2,26,9,17,2
SAN LUIS POTOSÍ,24,AQUISMÓN,003,LA CRUZ DE GUADALUPE,2,16,10,6,2
SAN LUIS POTOSÍ,24,AQUISMÓN,003,LA CUCHILLA,3,113,56,57,7
SAN LUIS POTOSÍ,24,AQUISMÓN,003,LA LAJA,3,30,17,13,3
SAN LUIS POTOSÍ,24,AQUISMÓN,003,LA MESA,6,143,83,60,10
SAN LUIS POTOSÍ,24,AQUISMÓN,003,LA MORENA,3,85,41,44,4
SAN LUIS POTOSÍ,24,AQUISMÓN,003,LA PEÑA,2,8,4,4,1
SAN LUIS POTOSÍ,24,AQUISMÓN,003,LA PEÑA BLANCA,1,4,2,2,1
SAN LUIS POTOSÍ,24,AQUISMÓN,003,LA REFORMA,3,50,25,25,4
SAN LUIS POTOSÍ,24,AQUISMÓN,003,LA SOLEDAD,4,74,36,38,5
SAN LUIS POTOSÍ,24,AQUISMÓN,003,LA UNIÓN DE GUADALUPE,4,89,52,37,6
SAN LUIS POTOSÍ,24,AQUISMÓN,003,LANIM,3,103,41,62,6
SAN LUIS POTOSÍ,24,AQUISMÓN,003,LAS ÁNIMAS,2,10,3,7,2
SAN LUIS POTOSÍ,24,AQUISMÓN,003,LINJÁ,4,214,100,114,14
SAN LUIS POTOSÍ,24,AQUISMÓN,003,LOMA BONITA,2,16,7,9,2
SAN LUIS POTOSÍ,24,AQUISMÓN,003,LOMA BONITA (CHARCO),1,14,9,5,2
SAN LUIS POTOSÍ,24,AQUISMÓN,003,LOS CHARCOS,3,29,13,16,4
SAN LUIS POTOSÍ,24,AQUISMÓN,003,LOS HORNOS,3,112,45,67,6
SAN LUIS POTOSÍ,24,AQUISMÓN,003,LOS OTATES,3,130,56,74,8
SAN LUIS POTOSÍ,24,AQUISMÓN,003,LOS REMEDIOS,2,75,38,37,4
SAN LUIS POTOSÍ,24,AQUISMÓN,003,MANJA,6,96,49,47,8
SAN LUIS POTOSÍ,24,AQUISMÓN,003,MANTEZULEL,3,168,88,80,9
SAN LUIS POTOSÍ,24,AQUISMÓN,003,MINA DE BELEMONT,2,21,11,10,2
SAN LUIS POTOSÍ,24,AQUISMÓN,003,MOCTEZUMA,3,132,53,79,7
SAN LUIS POTOSÍ,24,AQUISMÓN,003,MÚHUATL,4,178,81,97,11
SAN LUIS POTOSÍ,24,AQUISMÓN,003,OCTUJUB O CAMPECHE,4,197,101,96,13
SAN LUIS POTOSÍ,24,AQUISMÓN,003,OCTZÉN,2,23,11,12,3
SAN LUIS POTOSÍ,24,AQUISMÓN,003,PALO DE ARCO,4,143,75,68,12
SAN LUIS POTOSÍ,24,AQUISMÓN,003,PAXALJÁ,4,236,122,114,16
SAN LUIS POTOSÍ,24,AQUISMÓN,003,PUERTO DE GUAYMAS,2,27,11,16,2
SAN LUIS POTOSÍ,24,AQUISMÓN,003,PUERTO DE TANTZOTZOB,2,96,41,55,5
SAN LUIS POTOSÍ,24,AQUISMÓN,003,PUHUITZÉ,3,144,76,68,10
SAN LUIS POTOSÍ,24,AQUISMÓN,003,RANCHO ALEGRE (EL CAÑÓN),2,7,2,5,1
SAN LUIS POTOSÍ,24,AQUISMÓN,003,SAN FRANCISCO,3,107,52,55,7
SAN LUIS POTOSÍ,24,AQUISMÓN,003,SAN FRANCISCO DE ASÍS,3,46,29,17,3
SAN LUIS POTOSÍ,24,AQUISMÓN,003,SAN ISIDRO,4,153,74,79,11
SAN LUIS POTOSÍ,24,AQUISMÓN,003,SAN JOSÉ EL VIEJO,2,16,6,10,2
SAN LUIS POTOSÍ,24,AQUISMÓN,003,SAN JOSÉ OIJA,2,22,12,10,2
SAN LUIS POTOSÍ,24,AQUISMÓN,003,SAN MARTÍN,2,40,25,15,3
SAN LUIS POTOSÍ,24,AQUISMÓN,003,SAN PEDRO DE LAS ANONAS,5,390,195,195,27
SAN LUIS POTOSÍ,24,AQUISMÓN,003,SAN RAFAEL TAMÁPATZ,3,142,65,77,7
SAN LUIS POTOSÍ,24,AQUISMÓN,003,SAN RAFAEL TAMPAXAL,4,167,89,78,8
SAN LUIS POTOSÍ,24,AQUISMÓN,003,SANJUANITA,2,16,7,9,2
SAN LUIS POTOSÍ,24,AQUISMÓN,003,SANTA ANITA,3,87,45,42,6
SAN LUIS POTOSÍ,24,AQUISMÓN,003,SANTA ANITA DOS,2,12,7,5,2
SAN LUIS POTOSÍ,24,AQUISMÓN,003,SANTA BÁRBARA,3,227,124,103,14
SAN LUIS POTOSÍ,24,AQUISMÓN,003,SANTA CRUZ,5,228,110,118,16
SAN LUIS POTOSÍ,24,AQUISMÓN,003,SANTA RITA,3,66,38,28,4
SAN LUIS POTOSÍ,24,AQUISMÓN,003,TAHUILATZÉN,1,15,9,6,1
SAN LUIS POTOSÍ,24,AQUISMÓN,003,TAMÁPATZ,4,733,365,368,31
SAN LUIS POTOSÍ,24,AQUISMÓN,003,TAMCUEM,4,186,85,101,13
SAN LUIS POTOSÍ,24,AQUISMÓN,003,TAMCUIME,6,498,228,270,30
SAN LUIS POTOSÍ,24,AQUISMÓN,003,TAMPATE,9,446,211,235,28
SAN LUIS POTOSÍ,24,AQUISMÓN,003,TAMPAXAL,4,513,241,272,23
SAN LUIS POTOSÍ,24,AQUISMÓN,003,TAMPEMOCHE,5,416,226,190,31
SAN LUIS POTOSÍ,24,AQUISMÓN,003,TAMPETE,2,25,8,17,3
SAN LUIS POTOSÍ,24,AQUISMÓN,003,TAN TZAJIB,3,40,23,17,4
SAN LUIS POTOSÍ,24,AQUISMÓN,003,TANCHACHÍN,4,264,124,140,18
SAN LUIS POTOSÍ,24,AQUISMÓN,003,TANCHANACO,3,238,125,113,13
SAN LUIS POTOSÍ,24,AQUISMÓN,003,TANCHOPOL,2,51,24,27,4
SAN LUIS POTOSÍ,24,AQUISMÓN,003,TANQUIZUL,3,75,39,36,4
SAN LUIS POTOSÍ,24,AQUISMÓN,003,TANTZOTZOB,4,229,119,110,17
SAN LUIS POTOSÍ,24,AQUISMÓN,003,TANUTE,7,399,199,200,26
SAN LUIS POTOSÍ,24,AQUISMÓN,003,YERBABUENA,2,37,17,20,3
SAN LUIS POTOSÍ,24,ARMADILLO DE LOS INFANTE,004,ARMADILLO DE LOS INFANTE,4,165,88,77,9
SAN LUIS POTOSÍ,24,ARMADILLO DE LOS INFANTE,004,CERRO GRANDE,1,6,2,4,1
SAN LUIS POTOSÍ,24,ARMADILLO DE LOS INFANTE,004,EL RANCHITO DE LOS GUZMÁN,3,37,16,21,3
SAN LUIS POTOSÍ,24,ARMADILLO DE LOS INFANTE,004,LA CONCORDIA,3,207,93,114,11
SAN LUIS POTOSÍ,24,ARMADILLO DE LOS INFANTE,004,LA MESA DEL REFUGIO,2,6,4,2,1
SAN LUIS POTOSÍ,24,ARMADILLO DE LOS INFANTE,004,LLANO DE LOS SALDAÑA,3,14,7,7,2
SAN LUIS POTOSÍ,24,ARMADILLO DE LOS INFANTE,004,MEZQUITALILLO,3,30,12,18,3
SAN LUIS POTOSÍ,24,ARMADILLO DE LOS INFANTE,004,PALOMAS (EL VALLE DE PALOMAS),3,91,40,51,5
SAN LUIS POTOSÍ,24,ARMADILLO DE LOS INFANTE,004,PARADITA DEL REFUGIO,3,62,39,23,4
SAN LUIS POTOSÍ,24,ARMADILLO DE LOS INFANTE,004,POZO DEL CARMEN,3,104,58,46,6
SAN LUIS POTOSÍ,24,ARMADILLO DE LOS INFANTE,004,PUERTA DEL REFUGIO,2,4,2,2,1
SAN LUIS POTOSÍ,24,ARMADILLO DE LOS INFANTE,004,RANCHO NUEVO DE LA CRUZ,2,18,10,8,2
SAN LUIS POTOSÍ,24,ARMADILLO DE LOS INFANTE,004,SAN MIGUEL,2,7,4,3,1
SAN LUIS POTOSÍ,24,CÁRDENAS,005,CAÑADA DE PASTORES,3,43,19,24,4
SAN LUIS POTOSÍ,24,CÁRDENAS,005,CÁRDENAS,33,3732,1917,1815,269
SAN LUIS POTOSÍ,24,CÁRDENAS,005,COLONIA AGRÍCOLA EL NARANJO,1,9,5,4,1
SAN LUIS POTOSÍ,24,CÁRDENAS,005,EL AGUAJE,3,63,31,32,4
SAN LUIS POTOSÍ,24,CÁRDENAS,005,EL NARANJO,2,21,8,13,2
SAN LUIS POTOSÍ,24,CÁRDENAS,005,HIGINIO OLIVO (LA LABOR),3,159,86,73,10
SAN LUIS POTOSÍ,24,CÁRDENAS,005,LA NORIA,3,68,32,36,4
SAN LUIS POTOSÍ,24,CÁRDENAS,005,LAS CANOAS,3,34,18,16,3
SAN LUIS POTOSÍ,24,CÁRDENAS,005,LOBOS,3,127,66,61,9
SAN LUIS POTOSÍ,24,CÁRDENAS,005,PANTANO,3,26,13,13,3
SAN LUIS POTOSÍ,24,CATORCE,006,ALAMITOS DE LOS DÍAZ,3,48,22,26,4
SAN LUIS POTOSÍ,24,CATORCE,006,CASTAÑÓN,1,6,3,3,1
SAN LUIS POTOSÍ,24,CATORCE,006,CHARCO LARGO,2,19,7,12,2
SAN LUIS POTOSÍ,24,CATORCE,006,EL HUIZACHAL,2,12,6,6,2
SAN LUIS POTOSÍ,24,CATORCE,006,EL JORDÁN,2,44,21,23,3
SAN LUIS POTOSÍ,24,CATORCE,006,EL MASTRANTO,3,112,55,57,6
SAN LUIS POTOSÍ,24,CATORCE,006,EL POTRERO,4,112,58,54,9
SAN LUIS POTOSÍ,24,CATORCE,006,EL REFUGIO (LA LUZ),2,41,18,23,3
SAN LUIS POTOSÍ,24,CATORCE,006,EL SALTO,3,79,38,41,5
SAN LUIS POTOSÍ,24,CATORCE,006,EL TECOLOTE,1,5,2,3,1
SAN LUIS POTOSÍ,24,CATORCE,006,ESTACIÓN CATORCE,4,538,262,276,27
SAN LUIS POTOSÍ,24,CATORCE,006,ESTACIÓN WADLEY,3,115,68,47,6
SAN LUIS POTOSÍ,24,CATORCE,006,GUADALUPE DEL CARNICERO (LA MAROMA),3,73,33,40,6
SAN LUIS POTOSÍ,24,CATORCE,006,JESÚS DE CORONADOS,2,22,10,12,2
SAN LUIS POTOSÍ,24,CATORCE,006,LA ALBERCA,3,23,11,12,2
SAN LUIS POTOSÍ,24,CATORCE,006,LA CAÑADA,2,9,2,7,2
SAN LUIS POTOSÍ,24,CATORCE,006,LA CARDONCITA,3,103,56,47,6
SAN LUIS POTOSÍ,24,CATORCE,006,LA LAGUNITA (MAGUEY MOCHO),3,24,14,10,4
SAN LUIS POTOSÍ,24,CATORCE,006,LAS ADJUNTAS,1,5,2,3,1
SAN LUIS POTOSÍ,24,CATORCE,006,LAS MARGARITAS,2,11,8,3,1
SAN LUIS POTOSÍ,24,CATORCE,006,LOS CATORCE,3,50,25,25,3
SAN LUIS POTOSÍ,24,CATORCE,006,POBLAZÓN,2,16,6,10,2
SAN LUIS POTOSÍ,24,CATORCE,006,POTRERILLOS,3,50,27,23,4
SAN LUIS POTOSÍ,24,CATORCE,006,RANCHITO DE CORONADOS,3,43,21,22,4
SAN LUIS POTOSÍ,24,CATORCE,006,REAL DE CATORCE,5,449,241,208,28
SAN LUIS POTOSÍ,24,CATORCE,006,REAL DE MAROMA,4,52,21,31,6
SAN LUIS POTOSÍ,24,CATORCE,006,SAN ANTONIO DE CORONADOS,3,75,38,37,4
SAN LUIS POTOSÍ,24,CATORCE,006,SAN CRISTÓBAL,2,26,12,14,2
SAN LUIS POTOSÍ,24,CATORCE,006,SAN JOSÉ DE CORONADOS,3,55,19,36,3
SAN LUIS POTOSÍ,24,CATORCE,006,SAN JUAN DE MATANZAS,2,14,8,6,2
SAN LUIS POTOSÍ,24,CATORCE,006,SANTA CRUZ DE CARRETAS,2,32,12,20,2
SAN LUIS POTOSÍ,24,CATORCE,006,SANTA CRUZ DEL MOGOTE,3,29,14,15,4
SAN LUIS POTOSÍ,24,CATORCE,006,SANTA MARÍA DEL REFUGIO,4,120,62,58,10
SAN LUIS POTOSÍ,24,CATORCE,006,TAHONAS DEL JORDÁN,2,16,6,10,2
SAN LUIS POTOSÍ,24,CATORCE,006,TAHONITAS DEL SALTO,1,5,3,2,1
SAN LUIS POTOSÍ,24,CATORCE,006,TANQUE DE ARENAS,3,12,6,6,2
SAN LUIS POTOSÍ,24,CATORCE,006,TANQUE DE DOLORES,3,63,31,32,4
SAN LUIS POTOSÍ,24,CATORCE,006,VIGAS DE CORONADOS,2,8,6,2,1
SAN LUIS POTOSÍ,24,CEDRAL,007,CEDRAL,20,4252,2280,1972,173
SAN LUIS POTOSÍ,24,CEDRAL,007,CERRO DE FLORES,3,36,19,17,3
SAN LUIS POTOSÍ,24,CEDRAL,007,EJIDO HIDALGO,3,38,17,21,3
SAN LUIS POTOSÍ,24,CEDRAL,007,EJIDO VICTORIA SAN MANUEL,1,21,15,6,1
SAN LUIS POTOSÍ,24,CEDRAL,007,EL BLANCO,3,200,91,109,12
SAN LUIS POTOSÍ,24,CEDRAL,007,EL CUAREJO,3,40,17,23,4
SAN LUIS POTOSÍ,24,CEDRAL,007,EL SALADITO,3,23,10,13,3
SAN LUIS POTOSÍ,24,CEDRAL,007,GALLOS BLANCOS,3,53,32,21,3
SAN LUIS POTOSÍ,24,CEDRAL,007,LA BOQUILLA,2,6,5,1,1
SAN LUIS POTOSÍ,24,CEDRAL,007,LA CRUZ,4,81,36,45,8
SAN LUIS POTOSÍ,24,CEDRAL,007,LA RINCONADA,1,8,5,3,1
SAN LUIS POTOSÍ,24,CEDRAL,007,LAGUNILLAS,3,52,23,29,4
SAN LUIS POTOSÍ,24,CEDRAL,007,NORIA DE DOLORES,3,118,58,60,7
SAN LUIS POTOSÍ,24,CEDRAL,007,NORIA DE SAN PEDRO,2,55,26,29,3
SAN LUIS POTOSÍ,24,CEDRAL,007,PALO BLANCO,2,9,6,3,1
SAN LUIS POTOSÍ,24,CEDRAL,007,PRESA VERDE,4,95,40,55,8
SAN LUIS POTOSÍ,24,CEDRAL,007,REFUGIO DE SALADITO,2,7,3,4,1
SAN LUIS POTOSÍ,24,CEDRAL,007,SALITRILLOS DEL REFUGIO,3,66,28,38,5
SAN LUIS POTOSÍ,24,CEDRAL,007,SAN ANTONIO DE LOS MONTOYA,1,5,2,3,1
SAN LUIS POTOSÍ,24,CEDRAL,007,SAN ANTONIO DEL SOTOL,2,17,6,11,2
SAN LUIS POTOSÍ,24,CEDRAL,007,SAN ISIDRO,4,448,220,228,27
SAN LUIS POTOSÍ,24,CEDRAL,007,SAN LORENZO,3,55,26,29,3
SAN LUIS POTOSÍ,24,CEDRAL,007,SAN MATEO,3,9,2,7,2
SAN LUIS POTOSÍ,24,CEDRAL,007,SAN PABLO,3,14,8,6,2
SAN LUIS POTOSÍ,24,CEDRAL,007,SANTA RITA DEL SOTOL,3,47,22,25,3
SAN LUIS POTOSÍ,24,CEDRAL,007,TANQUE NUEVO,1,2,1,1,1
SAN LUIS POTOSÍ,24,CEDRAL,007,ZAMARRIPA,3,64,33,31,4
SAN LUIS POTOSÍ,24,CERRITOS,008,CERRITO BLANCO,3,37,11,26,4
SAN LUIS POTOSÍ,24,CERRITOS,008,CERRITOS,21,3903,1960,1943,210
SAN LUIS POTOSÍ,24,CERRITOS,008,CERROS BLANCOS,3,36,20,16,3
SAN LUIS POTOSÍ,24,CERRITOS,008,DERRAMADEROS,3,89,40,49,6
SAN LUIS POTOSÍ,24,CERRITOS,008,EL GAVILÁN,3,36,21,15,3
SAN LUIS POTOSÍ,24,CERRITOS,008,EL SAUZ,3,81,46,35,5
SAN LUIS POTOSÍ,24,CERRITOS,008,EL TEPETATE,3,52,21,31,4
SAN LUIS POTOSÍ,24,CERRITOS,008,EL TEPOZÁN,1,14,7,7,1
SAN LUIS POTOSÍ,24,CERRITOS,008,JOYA DE LUNA,3,96,45,51,6
SAN LUIS POTOSÍ,24,CERRITOS,008,LA PEÑA DE SALAZAR,3,6,1,5,2
SAN LUIS POTOSÍ,24,CERRITOS,008,LAS MARAVILLAS,1,6,1,5,1
SAN LUIS POTOSÍ,24,CERRITOS,008,MANZANILLAS,2,21,9,12,2
SAN LUIS POTOSÍ,24,CERRITOS,008,MEZQUITES CHICOS,3,34,17,17,3
SAN LUIS POTOSÍ,24,CERRITOS,008,MEZQUITES GRANDES,2,25,6,19,2
SAN LUIS POTOSÍ,24,CERRITOS,008,MONTAÑA,3,55,25,30,4
SAN LUIS POTOSÍ,24,CERRITOS,008,NUEVO EJIDO SAN PEDRO DE LOS HERNÁNDEZ (LAS VIBORILLAS),2,16,7,9,2
SAN LUIS POTOSÍ,24,CERRITOS,008,OJO DE AGUA,4,367,186,181,22
SAN LUIS POTOSÍ,24,CERRITOS,008,PUERTO DE SAN JOSÉ (EL PUERTO),1,7,3,4,1
SAN LUIS POTOSÍ,24,CERRITOS,008,RINCÓN DE TURRUBIARTES,3,33,16,17,3
SAN LUIS POTOSÍ,24,CERRITOS,008,SAN JOSÉ DE TURRUBIARTES (EL ZAMANDOQUE),2,31,18,13,2
SAN LUIS POTOSÍ,24,CERRITOS,008,SAN NICOLÁS DEL BOSQUE,3,31,19,12,3
SAN LUIS POTOSÍ,24,CERRITOS,008,SAN PEDRO DE LOS HERNÁNDEZ,4,96,42,54,5
SAN LUIS POTOSÍ,24,CERRITOS,008,TANQUITO DE BANDA,3,13,3,10,2
SAN LUIS POTOSÍ,24,CERRITOS,008,VILLAR (ESTACIÓN VILLAR),2,28,12,16,2
SAN LUIS POTOSÍ,24,CERRO DE SAN PEDRO,009,CALDERÓN,2,14,9,5,2
SAN LUIS POTOSÍ,24,CERRO DE SAN PEDRO,009,CUESTA DE CAMPA,2,11,5,6,2
SAN LUIS POTOSÍ,24,CERRO DE SAN PEDRO,009,DIVISADERO,3,45,22,23,3
SAN LUIS POTOSÍ,24,CERRO DE SAN PEDRO,009,JESÚS MARÍA,2,10,2,8,2
SAN LUIS POTOSÍ,24,CERRO DE SAN PEDRO,009,JOYITA DE LA CRUZ,1,12,8,4,1
SAN LUIS POTOSÍ,24,CERRO DE SAN PEDRO,009,MONTE CALDERA,3,44,22,22,3
SAN LUIS POTOSÍ,24,CERRO DE SAN PEDRO,009,NUEVA ZAPATILLA,3,43,25,18,4
SAN LUIS POTOSÍ,24,CERRO DE SAN PEDRO,009,NUEVO AMANECER,3,28,14,14,3
SAN LUIS POTOSÍ,24,CERRO DE SAN PEDRO,009,PLANTA DEL CARMEN (EL OCHO),3,405,199,206,21
SAN LUIS POTOSÍ,24,CERRO DE SAN PEDRO,009,PORTEZUELO,4,636,332,304,38
SAN LUIS POTOSÍ,24,CIUDAD DEL MAÍZ,010,AGUA NUEVA DEL NORTE,3,63,29,34,3
SAN LUIS POTOSÍ,24,CIUDAD DEL MAÍZ,010,AQUILES SERDÁN,4,178,80,98,9
SAN LUIS POTOSÍ,24,CIUDAD DEL MAÍZ,010,BUENAVISTA,4,54,32,22,4
SAN LUIS POTOSÍ,24,CIUDAD DEL MAÍZ,010,CARRIZAL GRANDE,3,26,15,11,3
SAN LUIS POTOSÍ,24,CIUDAD DEL MAÍZ,010,CIUDAD DEL MAÍZ,17,2909,1438,1471,174
SAN LUIS POTOSÍ,24,CIUDAD DEL MAÍZ,010,COLONIA AGRÍCOLA MAGDALENO CEDILLO,4,356,181,175,18
SAN LUIS POTOSÍ,24,CIUDAD DEL MAÍZ,010,COLONIA AGRÍCOLA OLLITAS DE LAS VACAS,3,49,27,22,3
SAN LUIS POTOSÍ,24,CIUDAD DEL MAÍZ,010,COLONIA ÁLVARO OBREGÓN,3,167,86,81,11
SAN LUIS POTOSÍ,24,CIUDAD DEL MAÍZ,010,COLONIA CARLOS DIEZ GUTIÉRREZ (LA ITALIANA),2,5,1,4,1
SAN LUIS POTOSÍ,24,CIUDAD DEL MAÍZ,010,COLONIA LA LIBERTAD,3,98,47,51,6
SAN LUIS POTOSÍ,24,CIUDAD DEL MAÍZ,010,COLONIA LA MORITA,3,112,47,65,7
SAN LUIS POTOSÍ,24,CIUDAD DEL MAÍZ,010,COLONIA LAGUNILLAS,3,132,64,68,6
SAN LUIS POTOSÍ,24,CIUDAD DEL MAÍZ,010,EJIDO SAN JOSÉ,3,324,163,161,20
SAN LUIS POTOSÍ,24,CIUDAD DEL MAÍZ,010,EL CAPULÍN,3,24,12,12,3
SAN LUIS POTOSÍ,24,CIUDAD DEL MAÍZ,010,EL CUSTODIO,3,90,50,40,6
SAN LUIS POTOSÍ,24,CIUDAD DEL MAÍZ,010,EL DIVISADERO (LA GARRA),2,4,3,1,1
SAN LUIS POTOSÍ,24,CIUDAD DEL MAÍZ,010,EL DURO,3,32,20,12,3
SAN LUIS POTOSÍ,24,CIUDAD DEL MAÍZ,010,EL OLIVO,3,70,35,35,5
SAN LUIS POTOSÍ,24,CIUDAD DEL MAÍZ,010,EL PORVENIR,3,59,30,29,4
SAN LUIS POTOSÍ,24,CIUDAD DEL MAÍZ,010,EL PUERTO SANTA GERTRUDIS,3,52,17,35,4
SAN LUIS POTOSÍ,24,CIUDAD DEL MAÍZ,010,EL TEPEYAC,3,29,16,13,3
SAN LUIS POTOSÍ,24,CIUDAD DEL MAÍZ,010,ESTACIÓN LAS TABLAS,3,7,4,3,2
SAN LUIS POTOSÍ,24,CIUDAD DEL MAÍZ,010,FRANCIA CHICA,2,10,3,7,1
SAN LUIS POTOSÍ,24,CIUDAD DEL MAÍZ,010,LA CALZADA DE SAN RAFAEL,3,132,68,64,7
SAN LUIS POTOSÍ,24,CIUDAD DEL MAÍZ,010,LA ENCARNACIÓN,3,85,39,46,4
SAN LUIS POTOSÍ,24,CIUDAD DEL MAÍZ,010,LA MANZANA (AMPLIACIÓN BUENAVISTA Y OLIVO),2,2,1,1,1
SAN LUIS POTOSÍ,24,CIUDAD DEL MAÍZ,010,LA PENDENCIA,3,71,38,33,5
SAN LUIS POTOSÍ,24,CIUDAD DEL MAÍZ,010,LAS GAVIAS,2,9,6,3,2
SAN LUIS POTOSÍ,24,CIUDAD DEL MAÍZ,010,LAS MESAS DE DON LUIS,3,39,19,20,3
SAN LUIS POTOSÍ,24,CIUDAD DEL MAÍZ,010,LAS MORAS,1,15,5,10,1
SAN LUIS POTOSÍ,24,CIUDAD DEL MAÍZ,010,LOS ÁVALOS,2,52,26,26,3
SAN LUIS POTOSÍ,24,CIUDAD DEL MAÍZ,010,LOS CHARCOS DEL PONIENTE,3,49,15,34,3
SAN LUIS POTOSÍ,24,CIUDAD DEL MAÍZ,010,MEMELA,3,72,40,32,4
SAN LUIS POTOSÍ,24,CIUDAD DEL MAÍZ,010,MONTEBELLO,3,66,40,26,4
SAN LUIS POTOSÍ,24,CIUDAD DEL MAÍZ,010,NUEVO CENTRO DE POBLACIÓN GANADERO PAPAGAYOS,3,111,48,63,6
SAN LUIS POTOSÍ,24,CIUDAD DEL MAÍZ,010,NUEVO SAN RAFAEL,2,52,26,26,3
SAN LUIS POTOSÍ,24,CIUDAD DEL MAÍZ,010,PALOMAS,6,959,486,473,40
SAN LUIS POTOSÍ,24,CIUDAD DEL MAÍZ,010,PAPAGAYOS (EJIDO PAPAGAYOS),3,62,29,33,4
SAN LUIS POTOSÍ,24,CIUDAD DEL MAÍZ,010,POTRERITOS DE LOS LLANOS,2,18,7,11,3
SAN LUIS POTOSÍ,24,CIUDAD DEL MAÍZ,010,PUERTO DE SAN JUAN DE DIOS,2,25,16,9,2
SAN LUIS POTOSÍ,24,CIUDAD DEL MAÍZ,010,PUERTO DEL ZAMANDOQUE,3,13,5,8,2
SAN LUIS POTOSÍ,24,CIUDAD DEL MAÍZ,010,RANCHO NUEVO,1,1,1,0,1
SAN LUIS POTOSÍ,24,CIUDAD DEL MAÍZ,010,RINCÓN SECO,3,15,10,5,2
SAN LUIS POTOSÍ,24,CIUDAD DEL MAÍZ,010,SAN ANTONIO,3,66,33,33,5
SAN LUIS POTOSÍ,24,CIUDAD DEL MAÍZ,010,SAN ANTONIO DEL TORO (CABEZA DEL TORO),1,5,3,2,1
SAN LUIS POTOSÍ,24,CIUDAD DEL MAÍZ,010,SAN JUAN DEL LLANO,3,75,38,37,4
SAN LUIS POTOSÍ,24,CIUDAD DEL MAÍZ,010,SAN JUAN DEL MECO,3,42,17,25,3
SAN LUIS POTOSÍ,24,CIUDAD DEL MAÍZ,010,SAN MATEO,3,27,11,16,3
SAN LUIS POTOSÍ,24,CIUDAD DEL MAÍZ,010,SAN RAFAEL CARRETERA,4,104,49,55,7
SAN LUIS POTOSÍ,24,CIUDAD DEL MAÍZ,010,SAN RAFAEL MATRIZ,3,160,94,66,8
SAN LUIS POTOSÍ,24,CIUDAD DEL MAÍZ,010,SARTENEJO,3,54,25,29,4
SAN LUIS POTOSÍ,24,CIUDAD DEL MAÍZ,010,SECCIÓN SETENTA Y NUEVE LOS ANTEOJOS,2,6,4,2,1
SAN LUIS POTOSÍ,24,CIUDAD DEL MAÍZ,010,TANQUE DE LOS ÁNGELES (EL VENADITO),4,207,107,100,13
SAN LUIS POTOSÍ,24,CIUDAD DEL MAÍZ,010,ZAMACHIHUE,4,384,191,193,20
SAN LUIS POTOSÍ,24,CIUDAD FERNÁNDEZ,011,ATOTONILCO,3,105,49,56,6
SAN LUIS POTOSÍ,24,CIUDAD FERNÁNDEZ,011,BARRIO DE GUADALUPE,2,192,90,102,9
SAN LUIS POTOSÍ,24,CIUDAD FERNÁNDEZ,011,CIUDAD FERNÁNDEZ,38,7539,3893,3646,415
SAN LUIS POTOSÍ,24,CIUDAD FERNÁNDEZ,011,COLONIA LA PEÑITA,2,26,9,17,2
SAN LUIS POTOSÍ,24,CIUDAD FERNÁNDEZ,011,COLONIA VEINTE DE NOVIEMBRE,5,403,211,192,26
SAN LUIS POTOSÍ,24,CIUDAD FERNÁNDEZ,011,EJIDO LOS LLANITOS,3,739,364,375,30
SAN LUIS POTOSÍ,24,CIUDAD FERNÁNDEZ,011,EL SAUCILLO,3,59,30,29,4
SAN LUIS POTOSÍ,24,CIUDAD FERNÁNDEZ,011,EL SERMÓN SANTA ANA,3,51,19,32,4
SAN LUIS POTOSÍ,24,CIUDAD FERNÁNDEZ,011,LA NORIA,3,135,63,72,8
SAN LUIS POTOSÍ,24,CIUDAD FERNÁNDEZ,011,LA REFORMA,4,358,183,175,23
SAN LUIS POTOSÍ,24,CIUDAD FERNÁNDEZ,011,LA REFORMITA,2,46,20,26,3
SAN LUIS POTOSÍ,24,CIUDAD FERNÁNDEZ,011,LA VENTILLA,3,34,16,18,3
SAN LUIS POTOSÍ,24,CIUDAD FERNÁNDEZ,011,LABOR VIEJA,4,237,130,107,13
SAN LUIS POTOSÍ,24,CIUDAD FERNÁNDEZ,011,LAS PILAS,3,28,11,17,3
SAN LUIS POTOSÍ,24,CIUDAD FERNÁNDEZ,011,MOJARRAS DE ARRIBA,3,26,10,16,3
SAN LUIS POTOSÍ,24,CIUDAD FERNÁNDEZ,011,MORILLOS,4,91,36,55,9
SAN LUIS POTOSÍ,24,CIUDAD FERNÁNDEZ,011,OJO DE AGUA DE SAN JUAN,2,14,6,8,2
SAN LUIS POTOSÍ,24,CIUDAD FERNÁNDEZ,011,OJO DE AGUA DE SOLANO,3,396,188,208,21
SAN LUIS POTOSÍ,24,CIUDAD FERNÁNDEZ,011,PASO DE SAN MARTÍN,2,7,3,4,1
SAN LUIS POTOSÍ,24,CIUDAD FERNÁNDEZ,011,PUESTECITOS,3,82,37,45,5
SAN LUIS POTOSÍ,24,CIUDAD FERNÁNDEZ,011,RANCHO NUEVO,2,5,3,2,1
SAN LUIS POTOSÍ,24,CIUDAD FERNÁNDEZ,011,SAN ISIDRO,3,63,37,26,5
SAN LUIS POTOSÍ,24,CIUDAD FERNÁNDEZ,011,SAN JOSÉ DEL TERREMOTO,3,79,36,43,6
SAN LUIS POTOSÍ,24,CIUDAD FERNÁNDEZ,011,SAN PABLO,1,8,5,3,1
SAN LUIS POTOSÍ,24,CIUDAD FERNÁNDEZ,011,SOLANO,3,67,37,30,5
SAN LUIS POTOSÍ,24,TANCANHUITZ,012,ALDZULUP,3,68,28,40,4
SAN LUIS POTOSÍ,24,TANCANHUITZ,012,ALDZULUP POYTZÉN,4,125,60,65,9
SAN LUIS POTOSÍ,24,TANCANHUITZ,012,ATEMPA,2,27,15,12,2
SAN LUIS POTOSÍ,24,TANCANHUITZ,012,CAMANCO,2,37,14,23,3
SAN LUIS POTOSÍ,24,TANCANHUITZ,012,CHACATITLA SEGUNDA SECCIÓN,2,88,41,47,5
SAN LUIS POTOSÍ,24,TANCANHUITZ,012,COLONIA PRIMERO DE MAYO,1,33,16,17,2
SAN LUIS POTOSÍ,24,TANCANHUITZ,012,COYOL JÁ (TZÁC ANAM),2,56,19,37,3
SAN LUIS POTOSÍ,24,TANCANHUITZ,012,CRUZTUJUB,2,41,21,20,3
SAN LUIS POTOSÍ,24,TANCANHUITZ,012,CUAJENCO PRIMERA SECCIÓN,2,43,23,20,2
SAN LUIS POTOSÍ,24,TANCANHUITZ,012,CUATLAMAYÁN,4,299,153,146,20
SAN LUIS POTOSÍ,24,TANCANHUITZ,012,CUAYO,3,185,98,87,12
SAN LUIS POTOSÍ,24,TANCANHUITZ,012,EJIDO LA CEIBA,2,16,9,7,2
SAN LUIS POTOSÍ,24,TANCANHUITZ,012,EL CRUCERO (CRUCERITO),2,52,22,30,4
SAN LUIS POTOSÍ,24,TANCANHUITZ,012,EL JUK,1,25,14,11,1
SAN LUIS POTOSÍ,24,TANCANHUITZ,012,EL TAMARINDO (CACOYOLE),1,56,27,29,2
SAN LUIS POTOSÍ,24,TANCANHUITZ,012,FRACCIÓN O'CTZÉN,5,84,40,44,7
SAN LUIS POTOSÍ,24,TANCANHUITZ,012,GUADALUPE VICTORIA,2,48,22,26,4
SAN LUIS POTOSÍ,24,TANCANHUITZ,012,HAC MOM (TAMALETOM SEGUNDA SECCIÓN),3,79,42,37,5
SAN LUIS POTOSÍ,24,TANCANHUITZ,012,JÓPOYMOM SEGUNDA SECCIÓN,2,7,3,4,1
SAN LUIS POTOSÍ,24,TANCANHUITZ,012,LA CUESTA,1,13,8,5,1
SAN LUIS POTOSÍ,24,TANCANHUITZ,012,LA GARZA (PEQUETZÉN DE LA GARZA),4,109,61,48,10
SAN LUIS POTOSÍ,24,TANCANHUITZ,012,LAS ARMAS,5,257,110,147,22
SAN LUIS POTOSÍ,24,TANCANHUITZ,012,LINARES,3,60,31,29,5
SAN LUIS POTOSÍ,24,TANCANHUITZ,012,PALMIRA NUEVO,1,8,2,6,1
SAN LUIS POTOSÍ,24,TANCANHUITZ,012,PALMIRA VIEJO,2,40,21,19,3
SAN LUIS POTOSÍ,24,TANCANHUITZ,012,SAN JOSÉ PEQUETZÉN,3,181,97,84,11
SAN LUIS POTOSÍ,24,TANCANHUITZ,012,SOCOHUIJIO,3,236,119,117,17
SAN LUIS POTOSÍ,24,TANCANHUITZ,012,TAMALETOM PRIMERA SECCIÓN,4,183,86,97,12
SAN LUIS POTOSÍ,24,TANCANHUITZ,012,TAMALETÓM TERCERA SECCIÓN,1,15,7,8,1
SAN LUIS POTOSÍ,24,TANCANHUITZ,012,TAMARINDO,2,53,32,21,3
SAN LUIS POTOSÍ,24,TANCANHUITZ,012,TANCANHUITZ,9,2034,1038,996,89
SAN LUIS POTOSÍ,24,TANCANHUITZ,012,TANCOLTZE PRIMERA SECCIÓN,2,33,15,18,2
SAN LUIS POTOSÍ,24,TANCANHUITZ,012,TEPEYAC,2,79,37,42,4
SAN LUIS POTOSÍ,24,TANCANHUITZ,012,TLALZINTLA,1,8,3,5,1
SAN LUIS POTOSÍ,24,TANCANHUITZ,012,TOLOJCO,2,16,8,8,2
SAN LUIS POTOSÍ,24,TANCANHUITZ,012,TUZANTLA,4,332,164,168,21
SAN LUIS POTOSÍ,24,TANCANHUITZ,012,TZÉ PAKÁB PRIMERA SECCIÓN,2,61,27,34,3
SAN LUIS POTOSÍ,24,TANCANHUITZ,012,TZÉPACAB SEGUNDA SECCIÓN TZAPICTÉ,3,70,32,38,5
SAN LUIS POTOSÍ,24,TANCANHUITZ,012,UNUP JUK TZEPACAB,1,65,36,29,5
SAN LUIS POTOSÍ,24,TANCANHUITZ,012,XOLOL BETHANIA,2,16,12,4,2
SAN LUIS POTOSÍ,24,TANCANHUITZ,012,XOLOL TANCOLTZE SEGUNDA SECCIÓN,2,15,5,10,2
SAN LUIS POTOSÍ,24,TANCANHUITZ,012,ZOJUALO,2,67,34,33,5
SAN LUIS POTOSÍ,24,CIUDAD VALLES,013,ADOLFO LÓPEZ MATEOS,3,36,21,15,3
SAN LUIS POTOSÍ,24,CIUDAD VALLES,013,ÁLVARO OBREGÓN (EL PUJAL),7,709,348,361,38
SAN LUIS POTOSÍ,24,CIUDAD VALLES,013,AMPLIACIÓN LA HINCADA,6,800,389,411,47
SAN LUIS POTOSÍ,24,CIUDAD VALLES,013,BUENA VISTA,1,10,7,3,1
SAN LUIS POTOSÍ,24,CIUDAD VALLES,013,BUENAVISTA,2,23,12,11,2
SAN LUIS POTOSÍ,24,CIUDAD VALLES,013,CAMILLAS,2,47,24,23,3
SAN LUIS POTOSÍ,24,CIUDAD VALLES,013,CASA BLANCA,1,7,2,5,1
SAN LUIS POTOSÍ,24,CIUDAD VALLES,013,CERRO ALTO,3,60,25,35,5
SAN LUIS POTOSÍ,24,CIUDAD VALLES,013,CHANTOL,2,33,16,17,3
SAN LUIS POTOSÍ,24,CIUDAD VALLES,013,CIUDAD VALLES,172,37166,19090,18076,2360
SAN LUIS POTOSÍ,24,CIUDAD VALLES,013,COLONIA IGNACIO ZARAGOZA,4,218,114,104,13
SAN LUIS POTOSÍ,24,CIUDAD VALLES,013,COYOLES,4,357,176,181,14
SAN LUIS POTOSÍ,24,CIUDAD VALLES,013,CRUCERO LAS PITAS,2,4,0,4,1
SAN LUIS POTOSÍ,24,CIUDAD VALLES,013,EJIDO EL CHUCHUPE,1,11,4,7,1
SAN LUIS POTOSÍ,24,CIUDAD VALLES,013,EJIDO EL LOBO,4,88,42,46,5
SAN LUIS POTOSÍ,24,CIUDAD VALLES,013,EJIDO LA LOMA,1,12,4,8,1
SAN LUIS POTOSÍ,24,CIUDAD VALLES,013,EJIDO LA MARINA (EJIDO COLECTIVO),3,45,27,18,3
SAN LUIS POTOSÍ,24,CIUDAD VALLES,013,EJIDO LA TOCONALA UNO (LA VIRGEN),2,48,21,27,3
SAN LUIS POTOSÍ,24,CIUDAD VALLES,013,EJIDO LAS CANOAS (CANOAS),3,69,30,39,4
SAN LUIS POTOSÍ,24,CIUDAD VALLES,013,EL ABRA (SAN FELIPE),2,38,21,17,3
SAN LUIS POTOSÍ,24,CIUDAD VALLES,013,EL AZULEJO,3,66,34,32,5
SAN LUIS POTOSÍ,24,CIUDAD VALLES,013,EL BÁRBOL,2,11,4,7,2
SAN LUIS POTOSÍ,24,CIUDAD VALLES,013,EL CAÑÓN DEL TANINUL (EL ABRA),1,5,3,2,1
SAN LUIS POTOSÍ,24,CIUDAD VALLES,013,EL CARMEN,2,471,229,242,19
SAN LUIS POTOSÍ,24,CIUDAD VALLES,013,EL CHICAL DOS,3,34,19,15,3
SAN LUIS POTOSÍ,24,CIUDAD VALLES,013,EL CHICAL UNO,2,16,10,6,2
SAN LUIS POTOSÍ,24,CIUDAD VALLES,013,EL CHOYOSO,1,9,2,7,1
SAN LUIS POTOSÍ,24,CIUDAD VALLES,013,EL CINCO,2,6,1,5,1
SAN LUIS POTOSÍ,24,CIUDAD VALLES,013,EL CONSUELO,1,217,107,110,8
SAN LUIS POTOSÍ,24,CIUDAD VALLES,013,EL CUICHE,3,39,21,18,3
SAN LUIS POTOSÍ,24,CIUDAD VALLES,013,EL DESENGAÑO,3,56,28,28,5
SAN LUIS POTOSÍ,24,CIUDAD VALLES,013,EL DETALLE,2,28,11,17,2
SAN LUIS POTOSÍ,24,CIUDAD VALLES,013,EL GRITADERO,1,5,2,3,1
SAN LUIS POTOSÍ,24,CIUDAD VALLES,013,EL JOPOY,2,16,8,8,2
SAN LUIS POTOSÍ,24,CIUDAD VALLES,013,EL OJITE,2,78,37,41,5
SAN LUIS POTOSÍ,24,CIUDAD VALLES,013,EL PLATANITO,3,53,33,20,4
SAN LUIS POTOSÍ,24,CIUDAD VALLES,013,EL RECUERDO,4,530,259,271,25
SAN LUIS POTOSÍ,24,CIUDAD VALLES,013,EL SIDRAL (SAN MIGUEL EL SIDRAL),3,49,20,29,3
SAN LUIS POTOSÍ,24,CIUDAD VALLES,013,EL TAMARINDO,3,64,30,34,4
SAN LUIS POTOSÍ,24,CIUDAD VALLES,013,EL VELADERO,2,19,7,12,2
SAN LUIS POTOSÍ,24,CIUDAD VALLES,013,ENTRADA A TAMALTE,2,5,4,1,1
SAN LUIS POTOSÍ,24,CIUDAD VALLES,013,ESTACIÓN MICOS,3,36,18,18,3
SAN LUIS POTOSÍ,24,CIUDAD VALLES,013,ESTACIÓN QUINIENTOS,1,38,12,26,2
SAN LUIS POTOSÍ,24,CIUDAD VALLES,013,GRANJAS UNO [FRACCIONAMIENTO],2,49,26,23,3
SAN LUIS POTOSÍ,24,CIUDAD VALLES,013,GUSTAVO GARMENDIA (LA UNIÓN),3,57,23,34,4
SAN LUIS POTOSÍ,24,CIUDAD VALLES,013,LA CAJITA,1,42,22,20,2
SAN LUIS POTOSÍ,24,CIUDAD VALLES,013,LA CONCEPCIÓN (LA CONCHA),3,28,15,13,3
SAN LUIS POTOSÍ,24,CIUDAD VALLES,013,LA ESCONDIDA,1,17,7,10,1
SAN LUIS POTOSÍ,24,CIUDAD VALLES,013,LA ESTRIBERA,3,53,33,20,5
SAN LUIS POTOSÍ,24,CIUDAD VALLES,013,LA LIMA,7,472,238,234,35
SAN LUIS POTOSÍ,24,CIUDAD VALLES,013,LA LOMA (QUINIENTOS UNO),1,28,16,12,2
SAN LUIS POTOSÍ,24,CIUDAD VALLES,013,LA PILA,5,331,151,180,15
SAN LUIS POTOSÍ,24,CIUDAD VALLES,013,LA PITAYA (LA PITAHAYA),2,22,8,14,2
SAN LUIS POTOSÍ,24,CIUDAD VALLES,013,LA PUERTA DEL ESPÍRITU SANTO,3,38,22,16,3
SAN LUIS POTOSÍ,24,CIUDAD VALLES,013,LA RAYA,2,7,2,5,1
SAN LUIS POTOSÍ,24,CIUDAD VALLES,013,LA SUBIDA,7,374,184,190,24
SAN LUIS POTOSÍ,24,CIUDAD VALLES,013,LAGUNA DEL MANTE,4,480,221,259,29
SAN LUIS POTOSÍ,24,CIUDAD VALLES,013,LAS CRUCITAS,3,71,32,39,4
SAN LUIS POTOSÍ,24,CIUDAD VALLES,013,LAS FLORES,3,36,16,20,3
SAN LUIS POTOSÍ,24,CIUDAD VALLES,013,LAS HUERTAS,3,44,27,17,4
SAN LUIS POTOSÍ,24,CIUDAD VALLES,013,LAS PITAS,3,30,20,10,3
SAN LUIS POTOSÍ,24,CIUDAD VALLES,013,LEÓN GARCÍA,1,6,2,4,1
SAN LUIS POTOSÍ,24,CIUDAD VALLES,013,LOMA DEL DESENGAÑO (EJIDO EL DESENGAÑO DOS),2,6,4,2,1
SAN LUIS POTOSÍ,24,CIUDAD VALLES,013,LOS JOVITOS,1,19,5,14,1
SAN LUIS POTOSÍ,24,CIUDAD VALLES,013,LOS SABINOS NÚMERO DOS,4,100,40,60,10
SAN LUIS POTOSÍ,24,CIUDAD VALLES,013,MONTECILLOS,3,85,45,40,6
SAN LUIS POTOSÍ,24,CIUDAD VALLES,013,NUEVO CRUCITAS,4,239,103,136,19
SAN LUIS POTOSÍ,24,CIUDAD VALLES,013,NUEVO TAMBOLÓN,1,5,3,2,1
SAN LUIS POTOSÍ,24,CIUDAD VALLES,013,OJO DE AGUA,7,572,269,303,36
SAN LUIS POTOSÍ,24,CIUDAD VALLES,013,RANCHO CASAS VIEJAS,2,8,4,4,2
SAN LUIS POTOSÍ,24,CIUDAD VALLES,013,RANCHO NUEVO,8,456,211,245,28
SAN LUIS POTOSÍ,24,CIUDAD VALLES,013,RANCHO SAN CARLOS,2,5,0,5,1
SAN LUIS POTOSÍ,24,CIUDAD VALLES,013,RASCÓN,5,548,276,272,32
SAN LUIS POTOSÍ,24,CIUDAD VALLES,013,SALCEDO,2,15,5,10,2
SAN LUIS POTOSÍ,24,CIUDAD VALLES,013,SAN ANTONIO HUICHIMAL,4,200,100,100,12
SAN LUIS POTOSÍ,24,CIUDAD VALLES,013,SAN DIEGUITO,4,125,71,54,7
SAN LUIS POTOSÍ,24,CIUDAD VALLES,013,SAN FELIPE,4,215,104,111,17
SAN LUIS POTOSÍ,24,CIUDAD VALLES,013,SAN FRANCISCO,2,16,6,10,2
SAN LUIS POTOSÍ,24,CIUDAD VALLES,013,SAN MATEO,3,41,25,16,4
SAN LUIS POTOSÍ,24,CIUDAD VALLES,013,SAN MIGUEL,4,78,38,40,9
SAN LUIS POTOSÍ,24,CIUDAD VALLES,013,SAN RAFAEL,1,4,2,2,1
SAN LUIS POTOSÍ,24,CIUDAD VALLES,013,SANTA FE,1,39,21,18,3
SAN LUIS POTOSÍ,24,CIUDAD VALLES,013,TANLECUE (EL OLIVO),2,7,3,4,1
SAN LUIS POTOSÍ,24,CIUDAD VALLES,013,TANTIZOHUICHE,3,69,38,31,4
SAN LUIS POTOSÍ,24,CIUDAD VALLES,013,TANTÓBAL,3,93,49,44,6
SAN LUIS POTOSÍ,24,CIUDAD VALLES,013,ZOCOHUITE,3,103,59,44,7
SAN LUIS POTOSÍ,24,COXCATLÁN,014,AJACACO,2,46,21,25,4
SAN LUIS POTOSÍ,24,COXCATLÁN,014,AJUATITLA PRIMERA SECCIÓN,2,70,33,37,4
SAN LUIS POTOSÍ,24,COXCATLÁN,014,AJUATITLA SEGUNDA SECCIÓN,3,86,41,45,7
SAN LUIS POTOSÍ,24,COXCATLÁN,014,AMAXAC,5,237,124,113,18
SAN LUIS POTOSÍ,24,COXCATLÁN,014,ATLAPA,2,19,11,8,2
SAN LUIS POTOSÍ,24,COXCATLÁN,014,BARRIO DEL ZOCOTE,1,19,7,12,1
SAN LUIS POTOSÍ,24,COXCATLÁN,014,BARRIO TEPETZINTLA DOS,1,11,6,5,1
SAN LUIS POTOSÍ,24,COXCATLÁN,014,COAMILA,3,51,25,26,5
SAN LUIS POTOSÍ,24,COXCATLÁN,014,COLALTITLA,2,31,12,19,3
SAN LUIS POTOSÍ,24,COXCATLÁN,014,COMUNIDAD CALMECAYO,4,161,72,89,15
SAN LUIS POTOSÍ,24,COXCATLÁN,014,COXCATLÁN,7,1547,769,778,120
SAN LUIS POTOSÍ,24,COXCATLÁN,014,CUILONICO,2,45,22,23,3
SAN LUIS POTOSÍ,24,COXCATLÁN,014,EJIDO CALMECAYO,4,75,34,41,6
SAN LUIS POTOSÍ,24,COXCATLÁN,014,EJIDO NUEVO CALMECAYO,1,13,7,6,1
SAN LUIS POTOSÍ,24,COXCATLÁN,014,EL JOPOY,2,20,13,7,2
SAN LUIS POTOSÍ,24,COXCATLÁN,014,EL SABINO,3,62,24,38,5
SAN LUIS POTOSÍ,24,COXCATLÁN,014,IXPATLACH,2,92,48,44,7
SAN LUIS POTOSÍ,24,COXCATLÁN,014,IXTIAMEL,2,11,5,6,2
SAN LUIS POTOSÍ,24,COXCATLÁN,014,LAS MESAS,4,114,59,55,7
SAN LUIS POTOSÍ,24,COXCATLÁN,014,MAHUAJCO,3,44,22,22,3
SAN LUIS POTOSÍ,24,COXCATLÁN,014,MAYTLA (EL CIRUELO),2,15,8,7,2
SAN LUIS POTOSÍ,24,COXCATLÁN,014,MOYOTLA,3,103,66,37,6
SAN LUIS POTOSÍ,24,COXCATLÁN,014,PALO DE ROSA,1,4,1,3,1
SAN LUIS POTOSÍ,24,COXCATLÁN,014,PALZOQUILLO,3,59,26,33,5
SAN LUIS POTOSÍ,24,COXCATLÁN,014,PETLACOYO,2,21,9,12,2
SAN LUIS POTOSÍ,24,COXCATLÁN,014,PICHOLCO,1,11,3,8,1
SAN LUIS POTOSÍ,24,COXCATLÁN,014,SAN ANDRÉS,3,88,36,52,7
SAN LUIS POTOSÍ,24,COXCATLÁN,014,SAN PABLO PRIMERO,3,135,65,70,8
SAN LUIS POTOSÍ,24,COXCATLÁN,014,SESECAMEL,2,8,3,5,1
SAN LUIS POTOSÍ,24,COXCATLÁN,014,SUCHIACO,3,135,66,69,9
SAN LUIS POTOSÍ,24,COXCATLÁN,014,TAMPUCHÓN,3,215,115,100,12
SAN LUIS POTOSÍ,24,COXCATLÁN,014,TAZAQUIL,5,214,114,100,14
SAN LUIS POTOSÍ,24,COXCATLÁN,014,TAZAQUIL EJIDO,3,105,55,50,7
SAN LUIS POTOSÍ,24,COXCATLÁN,014,TEPOTZUAPA DOS SEGUNDA SECCIÓN,2,50,19,31,3
SAN LUIS POTOSÍ,24,COXCATLÁN,014,TEPOTZUAPA PRIMERA SECCIÓN,3,78,35,43,6
SAN LUIS POTOSÍ,24,COXCATLÁN,014,TIOAMEL,3,45,22,23,3
SAN LUIS POTOSÍ,24,COXCATLÁN,014,TLAPANI,2,33,16,17,3
SAN LUIS POTOSÍ,24,COXCATLÁN,014,TLAXCO,2,15,4,11,2
SAN LUIS POTOSÍ,24,COXCATLÁN,014,TOTÓATL,1,34,15,19,2
SAN LUIS POTOSÍ,24,CHARCAS,015,ÁLVARO OBREGÓN (ESTACIÓN LOS CHARCOS),3,115,54,61,5
SAN LUIS POTOSÍ,24,CHARCAS,015,AQUILES SERDÁN,3,50,26,24,4
SAN LUIS POTOSÍ,24,CHARCAS,015,CALABACILLAS,3,23,6,17,2
SAN LUIS POTOSÍ,24,CHARCAS,015,CAÑADA VERDE,3,112,55,57,7
SAN LUIS POTOSÍ,24,CHARCAS,015,CERRO PRIETO,4,83,38,45,5
SAN LUIS POTOSÍ,24,CHARCAS,015,CHARCAS,16,3297,1662,1635,180
SAN LUIS POTOSÍ,24,CHARCAS,015,CHARCO VERDE,2,14,6,8,1
SAN LUIS POTOSÍ,24,CHARCAS,015,CHUPADEROS,3,14,8,6,2
SAN LUIS POTOSÍ,24,CHARCAS,015,CLAVELLINA,1,123,54,69,5
SAN LUIS POTOSÍ,24,CHARCAS,015,COYOTILLOS,3,67,34,33,4
SAN LUIS POTOSÍ,24,CHARCAS,015,EL ARENAL,2,6,3,3,1
SAN LUIS POTOSÍ,24,CHARCAS,015,EL ASTILLERO,3,18,8,10,4
SAN LUIS POTOSÍ,24,CHARCAS,015,EL CEDAZO,3,17,9,8,3
SAN LUIS POTOSÍ,24,CHARCAS,015,EL HOSPITAL,3,36,20,16,3
SAN LUIS POTOSÍ,24,CHARCAS,015,EL REFUGIO,2,13,8,5,1
SAN LUIS POTOSÍ,24,CHARCAS,015,EL ZACATONAL,1,9,3,6,1
SAN LUIS POTOSÍ,24,CHARCAS,015,ELORZA,4,78,40,38,5
SAN LUIS POTOSÍ,24,CHARCAS,015,EMILIANO ZAPATA (LAS CANTERAS),3,46,19,27,3
SAN LUIS POTOSÍ,24,CHARCAS,015,ESTACIÓN BERRENDO,1,7,4,3,2
SAN LUIS POTOSÍ,24,CHARCAS,015,FÁTIMA,1,6,2,4,1
SAN LUIS POTOSÍ,24,CHARCAS,015,FRACCIÓN PALMAS (PALMAS),3,34,16,18,4
SAN LUIS POTOSÍ,24,CHARCAS,015,FRANCISCO I. MADERO,2,30,17,13,3
SAN LUIS POTOSÍ,24,CHARCAS,015,GUADALUPE VICTORIA,2,58,27,31,3
SAN LUIS POTOSÍ,24,CHARCAS,015,IGNACIO ALDAMA,3,19,9,10,3
SAN LUIS POTOSÍ,24,CHARCAS,015,IMMSA [MINA TIRO GENERAL],1,13,9,4,1
SAN LUIS POTOSÍ,24,CHARCAS,015,LA TRINIDAD,3,32,18,14,3
SAN LUIS POTOSÍ,24,CHARCAS,015,LA ZAPATILLA,2,11,7,4,1
SAN LUIS POTOSÍ,24,CHARCAS,015,LABORCILLA,3,34,18,16,3
SAN LUIS POTOSÍ,24,CHARCAS,015,LAJAS,3,29,9,20,3
SAN LUIS POTOSÍ,24,CHARCAS,015,LOS CALLEJONES,3,23,15,8,3
SAN LUIS POTOSÍ,24,CHARCAS,015,MAJADITA BLANCA,2,15,8,7,3
SAN LUIS POTOSÍ,24,CHARCAS,015,MIGUEL HIDALGO,4,113,59,54,8
SAN LUIS POTOSÍ,24,CHARCAS,015,NORIA DE GUTIÉRREZ (JOSÉ MARÍA MORELOS),3,34,17,17,4
SAN LUIS POTOSÍ,24,CHARCAS,015,NORIA DEL CERRO GORDO,3,39,15,24,3
SAN LUIS POTOSÍ,24,CHARCAS,015,OJITO SANTA CRUZ,1,83,44,39,3
SAN LUIS POTOSÍ,24,CHARCAS,015,PASO DEL MEZQUITE (CERRO BLANCO),1,2,1,1,1
SAN LUIS POTOSÍ,24,CHARCAS,015,POCITOS,3,77,28,49,5
SAN LUIS POTOSÍ,24,CHARCAS,015,PRESA DE SANTA GERTRUDIS,1,15,9,6,1
SAN LUIS POTOSÍ,24,CHARCAS,015,SALINILLAS,2,17,4,13,2
SAN LUIS POTOSÍ,24,CHARCAS,015,SAN JUAN DEL TUZAL,3,30,13,17,4
SAN LUIS POTOSÍ,24,CHARCAS,015,SAN RAFAEL,3,30,13,17,4
SAN LUIS POTOSÍ,24,CHARCAS,015,SANTA ANA DE ZARAGOZA,1,2,2,0,1
SAN LUIS POTOSÍ,24,CHARCAS,015,TINAJUELAS,2,21,7,14,2
SAN LUIS POTOSÍ,24,CHARCAS,015,VICENTE GUERRERO (LAS ESCOBAS),3,33,16,17,3
SAN LUIS POTOSÍ,24,EBANO,016,AJINCHE MARLAND,2,31,12,19,2
SAN LUIS POTOSÍ,24,EBANO,016,ANTIGUA REFORMA,3,46,27,19,4
SAN LUIS POTOSÍ,24,EBANO,016,AURELIO MANRIQUE,4,522,252,270,30
SAN LUIS POTOSÍ,24,EBANO,016,EBANO,28,5554,2729,2825,260
SAN LUIS POTOSÍ,24,EBANO,016,EJIDO AMPLIACIÓN VELAZCO,3,47,19,28,5
SAN LUIS POTOSÍ,24,EBANO,016,EJIDO FULGENCIO M. SANTOS (EJIDO SOSTEPEC),2,70,26,44,4
SAN LUIS POTOSÍ,24,EBANO,016,EL TRONCONAL,3,20,10,10,3
SAN LUIS POTOSÍ,24,EBANO,016,ESTACIÓN AUZA,1,17,8,9,1
SAN LUIS POTOSÍ,24,EBANO,016,ESTACIÓN VELAZCO,2,59,37,22,3
SAN LUIS POTOSÍ,24,EBANO,016,LAS COLORADAS,1,118,68,50,9
SAN LUIS POTOSÍ,24,EBANO,016,PLAN DE IGUALA,3,339,179,160,21
SAN LUIS POTOSÍ,24,EBANO,016,PONCIANO ARRIAGA,12,1640,819,821,100
SAN LUIS POTOSÍ,24,EBANO,016,PUJAL COY,5,824,411,413,43
SAN LUIS POTOSÍ,24,EBANO,016,REFORMA EL ALTO,3,160,80,80,7
SAN LUIS POTOSÍ,24,EBANO,016,VICHINCHIJOL NUEVO,3,100,56,44,5
SAN LUIS POTOSÍ,24,GUADALCÁZAR,017,ÁBREGO,3,68,41,27,5
SAN LUIS POTOSÍ,24,GUADALCÁZAR,017,BUENAVISTA,4,208,115,93,16
SAN LUIS POTOSÍ,24,GUADALCÁZAR,017,CHARCO BLANCO,3,169,81,88,11
SAN LUIS POTOSÍ,24,GUADALCÁZAR,017,CHARCO CERCADO,4,388,165,223,19
SAN LUIS POTOSÍ,24,GUADALCÁZAR,017,COLONIA AGRÍCOLA SAN JOSÉ,3,56,26,30,4
SAN LUIS POTOSÍ,24,GUADALCÁZAR,017,CRUCERO DE CHARCO CERCADO (EL PARADOR),1,13,10,3,1
SAN LUIS POTOSÍ,24,GUADALCÁZAR,017,DOMINGO GÁMEZ,2,12,5,7,2
SAN LUIS POTOSÍ,24,GUADALCÁZAR,017,EL AGUAJE DE GARCÍA,2,12,7,5,2
SAN LUIS POTOSÍ,24,GUADALCÁZAR,017,EL FRAILE,2,14,10,4,2
SAN LUIS POTOSÍ,24,GUADALCÁZAR,017,EL HUIZACHE,4,298,156,142,14
SAN LUIS POTOSÍ,24,GUADALCÁZAR,017,EL JAUJAL,3,59,31,28,3
SAN LUIS POTOSÍ,24,GUADALCÁZAR,017,EL JICOTE,3,55,29,26,4
SAN LUIS POTOSÍ,24,GUADALCÁZAR,017,EL MILAGRO DE GUADALUPE,4,295,142,153,17
SAN LUIS POTOSÍ,24,GUADALCÁZAR,017,EL ORO,2,6,3,3,1
SAN LUIS POTOSÍ,24,GUADALCÁZAR,017,EL PUERTO DE LA CLAVELLINA,3,140,78,62,6
SAN LUIS POTOSÍ,24,GUADALCÁZAR,017,EL QUELITAL,3,146,86,60,8
SAN LUIS POTOSÍ,24,GUADALCÁZAR,017,EL TULILLO,1,3,1,2,1
SAN LUIS POTOSÍ,24,GUADALCÁZAR,017,ENTRONQUE DE MATEHUALA (EL HUIZACHE),4,451,239,212,21
SAN LUIS POTOSÍ,24,GUADALCÁZAR,017,ESTANQUE BLANCO,2,9,5,4,2
SAN LUIS POTOSÍ,24,GUADALCÁZAR,017,GUADALCÁZAR,7,331,167,164,29
SAN LUIS POTOSÍ,24,GUADALCÁZAR,017,LA BOQUILLA,2,8,3,5,1
SAN LUIS POTOSÍ,24,GUADALCÁZAR,017,LA CAMPANA,2,42,29,13,3
SAN LUIS POTOSÍ,24,GUADALCÁZAR,017,LA HINCADA,3,187,103,84,10
SAN LUIS POTOSÍ,24,GUADALCÁZAR,017,LA MEDIA NEGA,2,10,8,2,2
SAN LUIS POTOSÍ,24,GUADALCÁZAR,017,LA NARANJITA,3,34,17,17,3
SAN LUIS POTOSÍ,24,GUADALCÁZAR,017,LA NEGRITA,2,30,20,10,2
SAN LUIS POTOSÍ,24,GUADALCÁZAR,017,LA NORIA DE LAS FLORES,3,44,18,26,3
SAN LUIS POTOSÍ,24,GUADALCÁZAR,017,LA PÓLVORA,4,219,98,121,12
SAN LUIS POTOSÍ,24,GUADALCÁZAR,017,LA VENTANA,3,108,50,58,6
SAN LUIS POTOSÍ,24,GUADALCÁZAR,017,LA YERBABUENA,2,7,3,4,2
SAN LUIS POTOSÍ,24,GUADALCÁZAR,017,LAS NEGRITAS,4,220,107,113,11
SAN LUIS POTOSÍ,24,GUADALCÁZAR,017,LOS AMOLES,3,59,29,30,4
SAN LUIS POTOSÍ,24,GUADALCÁZAR,017,LOS ÁNGELES NÚMERO DOS,3,15,5,10,2
SAN LUIS POTOSÍ,24,GUADALCÁZAR,017,LOS TRES REALES,2,7,2,5,2
SAN LUIS POTOSÍ,24,GUADALCÁZAR,017,NORIAS DEL REFUGIO,3,228,109,119,11
SAN LUIS POTOSÍ,24,GUADALCÁZAR,017,NÚÑEZ,3,207,100,107,12
SAN LUIS POTOSÍ,24,GUADALCÁZAR,017,PEYOTE,3,102,43,59,7
SAN LUIS POTOSÍ,24,GUADALCÁZAR,017,POZAS DE SANTA ANA,4,376,191,185,18
SAN LUIS POTOSÍ,24,GUADALCÁZAR,017,PRESA DE GUADALUPE,3,89,45,44,5
SAN LUIS POTOSÍ,24,GUADALCÁZAR,017,PRESA EL PINTO,1,3,1,2,1
SAN LUIS POTOSÍ,24,GUADALCÁZAR,017,PRESITA DEL TEPETATE,3,52,19,33,4
SAN LUIS POTOSÍ,24,GUADALCÁZAR,017,PROGRESO,2,14,5,9,2
SAN LUIS POTOSÍ,24,GUADALCÁZAR,017,PUERTA DE JESÚS MARÍA (LA ROSITA),3,25,12,13,4
SAN LUIS POTOSÍ,24,GUADALCÁZAR,017,RANCHO NUEVO,2,24,9,15,2
SAN LUIS POTOSÍ,24,GUADALCÁZAR,017,REALEJO,3,41,20,21,2
SAN LUIS POTOSÍ,24,GUADALCÁZAR,017,SAN AGUSTÍN,3,26,14,12,3
SAN LUIS POTOSÍ,24,GUADALCÁZAR,017,SAN ANTONIO DE TROJES,3,16,8,8,3
SAN LUIS POTOSÍ,24,GUADALCÁZAR,017,SAN ANTONIO DEL TULILLO,3,31,18,13,3
SAN LUIS POTOSÍ,24,GUADALCÁZAR,017,SAN CARLOS,3,69,40,29,4
SAN LUIS POTOSÍ,24,GUADALCÁZAR,017,SAN CRISTÓBAL,2,13,5,8,2
SAN LUIS POTOSÍ,24,GUADALCÁZAR,017,SAN FRANCISCO DEL TULILLO,3,41,18,23,3
SAN LUIS POTOSÍ,24,GUADALCÁZAR,017,SAN GREGORIO,2,25,12,13,2
SAN LUIS POTOSÍ,24,GUADALCÁZAR,017,SAN IGNACIO,4,168,88,80,13
SAN LUIS POTOSÍ,24,GUADALCÁZAR,017,SAN JOSÉ DE CERVANTES,3,14,6,8,3
SAN LUIS POTOSÍ,24,GUADALCÁZAR,017,SAN JOSÉ DE LAS FLORES,3,9,6,3,2
SAN LUIS POTOSÍ,24,GUADALCÁZAR,017,SAN JUAN SIN AGUA,3,178,89,89,10
SAN LUIS POTOSÍ,24,GUADALCÁZAR,017,SAN MARTÍN (SAN MARTÍN DEL TANQUITO),2,8,6,2,1
SAN LUIS POTOSÍ,24,GUADALCÁZAR,017,SANTA RITA DEL RUCIO,3,25,12,13,3
SAN LUIS POTOSÍ,24,GUADALCÁZAR,017,SANTO DOMINGO,3,166,91,75,9
SAN LUIS POTOSÍ,24,GUADALCÁZAR,017,SOLEDAD DE LA BIZNAGA,2,18,8,10,2
SAN LUIS POTOSÍ,24,HUEHUETLÁN,018,ALAQUICH,2,52,29,23,4
SAN LUIS POTOSÍ,24,HUEHUETLÁN,018,AMPLIACIÓN DE HUICHIHUAYÁN,2,22,16,6,2
SAN LUIS POTOSÍ,24,HUEHUETLÁN,018,CHUNUNTZÉN DOS SECCIÓN DOS,4,590,288,302,30
SAN LUIS POTOSÍ,24,HUEHUETLÁN,018,CHUNUNTZÉN DOS SECCIÓN OCHO,2,25,13,12,3
SAN LUIS POTOSÍ,24,HUEHUETLÁN,018,CHUNUNTZÉN UNO,2,303,140,163,14
SAN LUIS POTOSÍ,24,HUEHUETLÁN,018,COMPLEMENTO CHUNUNTZÉN,2,15,5,10,2
SAN LUIS POTOSÍ,24,HUEHUETLÁN,018,CRUZ BLANCA,3,93,55,38,6
SAN LUIS POTOSÍ,24,HUEHUETLÁN,018,EL NACIMIENTO,3,81,40,41,5
SAN LUIS POTOSÍ,24,HUEHUETLÁN,018,HUEHUETLÁN,3,270,127,143,21
SAN LUIS POTOSÍ,24,HUEHUETLÁN,018,HUICHIHUAYÁN,6,943,469,474,64
SAN LUIS POTOSÍ,24,HUEHUETLÁN,018,JILIM TANTOCOY TRES,3,136,67,69,9
SAN LUIS POTOSÍ,24,HUEHUETLÁN,018,LA ESCALERA,2,112,52,60,5
SAN LUIS POTOSÍ,24,HUEHUETLÁN,018,LA PEDRERA,2,7,4,3,1
SAN LUIS POTOSÍ,24,HUEHUETLÁN,018,LA PIMIENTA,3,180,81,99,11
SAN LUIS POTOSÍ,24,HUEHUETLÁN,018,LOS PINOS,2,49,24,25,3
SAN LUIS POTOSÍ,24,HUEHUETLÁN,018,SAN JOSÉ,4,166,83,83,10
SAN LUIS POTOSÍ,24,HUEHUETLÁN,018,TANDZUMADZ,6,230,100,130,16
SAN LUIS POTOSÍ,24,HUEHUETLÁN,018,TANLEAB DOS,3,55,29,26,4
SAN LUIS POTOSÍ,24,HUEHUETLÁN,018,TANLEAB UNO,3,130,63,67,10
SAN LUIS POTOSÍ,24,HUEHUETLÁN,018,TANTOCOY UNO,3,190,99,91,12
SAN LUIS POTOSÍ,24,HUEHUETLÁN,018,TATACUATLA,3,98,40,58,7
SAN LUIS POTOSÍ,24,HUEHUETLÁN,018,TIERRAS COLORADAS,2,71,28,43,4
SAN LUIS POTOSÍ,24,HUEHUETLÁN,018,TZINEJÁ DOS,2,21,11,10,2
SAN LUIS POTOSÍ,24,HUEHUETLÁN,018,TZINEJÁ UNO,2,70,32,38,3
SAN LUIS POTOSÍ,24,LAGUNILLAS,019,CARRIZAL DE SAN JUAN DE ABAJO,3,44,22,22,4
SAN LUIS POTOSÍ,24,LAGUNILLAS,019,EL AHOGADO,2,3,2,1,1
SAN LUIS POTOSÍ,24,LAGUNILLAS,019,EL CAPULÍN,1,7,3,4,1
SAN LUIS POTOSÍ,24,LAGUNILLAS,019,EL COCO,2,17,7,10,2
SAN LUIS POTOSÍ,24,LAGUNILLAS,019,EL EPAZOTE,3,44,22,22,4
SAN LUIS POTOSÍ,24,LAGUNILLAS,019,EL LIMÓN,2,6,4,2,1
SAN LUIS POTOSÍ,24,LAGUNILLAS,019,EL MIRADOR (EL PEDREGAL),3,88,45,43,7
SAN LUIS POTOSÍ,24,LAGUNILLAS,019,EL QUELITALILLO (EL QUELITAL),3,65,32,33,4
SAN LUIS POTOSÍ,24,LAGUNILLAS,019,ENCINILLAS,2,11,7,4,1
SAN LUIS POTOSÍ,24,LAGUNILLAS,019,LA LÍNEA,3,28,18,10,3
SAN LUIS POTOSÍ,24,LAGUNILLAS,019,LA PRESA,3,25,11,14,3
SAN LUIS POTOSÍ,24,LAGUNILLAS,019,LA REFORMA,2,21,10,11,2
SAN LUIS POTOSÍ,24,LAGUNILLAS,019,LA RODADA,3,30,15,15,3
SAN LUIS POTOSÍ,24,LAGUNILLAS,019,LAGUNA VERDE,3,35,14,21,3
SAN LUIS POTOSÍ,24,LAGUNILLAS,019,LAGUNILLAS,3,89,36,53,10
SAN LUIS POTOSÍ,24,LAGUNILLAS,019,LAS NORIAS,3,29,13,16,3
SAN LUIS POTOSÍ,24,LAGUNILLAS,019,PINIHUAN (RÍO PINIHUAN),3,118,63,55,8
SAN LUIS POTOSÍ,24,LAGUNILLAS,019,SAN ISIDRO,2,24,10,14,3
SAN LUIS POTOSÍ,24,LAGUNILLAS,019,SAN JUAN TETLAS,2,10,6,4,1
SAN LUIS POTOSÍ,24,LAGUNILLAS,019,SAN RAFAEL,4,253,125,128,20
SAN LUIS POTOSÍ,24,MATEHUALA,020,ARROYITO DEL AGUA,3,61,35,26,4
SAN LUIS POTOSÍ,24,MATEHUALA,020,BUENAVISTA,3,53,25,28,4
SAN LUIS POTOSÍ,24,MATEHUALA,020,CARBONERA,3,70,36,34,5
SAN LUIS POTOSÍ,24,MATEHUALA,020,CERRITO BLANCO,2,22,9,13,2
SAN LUIS POTOSÍ,24,MATEHUALA,020,CRUCERO LA LUZ,2,12,6,6,1
SAN LUIS POTOSÍ,24,MATEHUALA,020,EL CARMEN,3,114,58,56,8
SAN LUIS POTOSÍ,24,MATEHUALA,020,EL GUERRERO,1,23,8,15,2
SAN LUIS POTOSÍ,24,MATEHUALA,020,EL HERRERO,2,57,28,29,3
SAN LUIS POTOSÍ,24,MATEHUALA,020,EL MEZQUITE,3,71,37,34,4
SAN LUIS POTOSÍ,24,MATEHUALA,020,EL VAQUERO,4,129,61,68,9
SAN LUIS POTOSÍ,24,MATEHUALA,020,ENCARNACIÓN DE ABAJO,2,26,13,13,2
SAN LUIS POTOSÍ,24,MATEHUALA,020,ESTANQUE DE AGUA BUENA,3,89,49,40,5
SAN LUIS POTOSÍ,24,MATEHUALA,020,LA BONITA,3,14,7,7,3
SAN LUIS POTOSÍ,24,MATEHUALA,020,LA CAJA,3,45,24,21,4
SAN LUIS POTOSÍ,24,MATEHUALA,020,LA CONCEPCIÓN,3,78,36,42,4
SAN LUIS POTOSÍ,24,MATEHUALA,020,LA JOYA,3,36,19,17,4
SAN LUIS POTOSÍ,24,MATEHUALA,020,LA LUZ,2,9,1,8,1
SAN LUIS POTOSÍ,24,MATEHUALA,020,LA MISIÓN,2,11,4,7,2
SAN LUIS POTOSÍ,24,MATEHUALA,020,LOS POCITOS,3,55,25,30,4
SAN LUIS POTOSÍ,24,MATEHUALA,020,MARAVILLAS,3,30,14,16,3
SAN LUIS POTOSÍ,24,MATEHUALA,020,MATEHUALA,129,22595,11431,11164,1546
SAN LUIS POTOSÍ,24,MATEHUALA,020,NORIA DE LA CABRA,3,165,74,91,10
SAN LUIS POTOSÍ,24,MATEHUALA,020,NORIA DE LOS CASTILLOS,2,24,11,13,2
SAN LUIS POTOSÍ,24,MATEHUALA,020,PALMAS,1,22,11,11,1
SAN LUIS POTOSÍ,24,MATEHUALA,020,PASTORIZA,3,68,35,33,5
SAN LUIS POTOSÍ,24,MATEHUALA,020,PIEDRA BLANCA,3,35,13,22,4
SAN LUIS POTOSÍ,24,MATEHUALA,020,POTRERO DE SANTA ANA,1,7,3,4,1
SAN LUIS POTOSÍ,24,MATEHUALA,020,POZO DE SANTA CLARA,3,51,23,28,3
SAN LUIS POTOSÍ,24,MATEHUALA,020,RANCHO NUEVO,3,127,66,61,9
SAN LUIS POTOSÍ,24,MATEHUALA,020,SACRAMENTO,3,129,60,69,8
SAN LUIS POTOSÍ,24,MATEHUALA,020,SAN ANTONIO DE LAS BARRANCAS,3,45,24,21,4
SAN LUIS POTOSÍ,24,MATEHUALA,020,SAN ANTONIO DE LOS CASTILLO,2,28,10,18,2
SAN LUIS POTOSÍ,24,MATEHUALA,020,SAN ANTONIO DE ZARAGOZA,3,82,40,42,6
SAN LUIS POTOSÍ,24,MATEHUALA,020,SAN CARLOS,2,23,11,12,2
SAN LUIS POTOSÍ,24,MATEHUALA,020,SAN FRANCISCO DE CALEROS,2,16,7,9,2
SAN LUIS POTOSÍ,24,MATEHUALA,020,SAN FRANCISCO DE LOS BOCANEGRA,2,6,3,3,1
SAN LUIS POTOSÍ,24,MATEHUALA,020,SAN GABRIEL,2,8,3,5,1
SAN LUIS POTOSÍ,24,MATEHUALA,020,SAN JOSÉ DE IPOA,2,34,21,13,3
SAN LUIS POTOSÍ,24,MATEHUALA,020,SAN JOSÉ DE LA PEÑA,3,42,13,29,3
SAN LUIS POTOSÍ,24,MATEHUALA,020,SAN JOSÉ DE LA VIUDA (ESTANQUE BLANCO),3,58,27,31,4
SAN LUIS POTOSÍ,24,MATEHUALA,020,SAN JOSÉ DE LAS TROJES,4,1225,622,603,16
SAN LUIS POTOSÍ,24,MATEHUALA,020,SAN JOSÉ DE LOS GUAJES,3,86,36,50,5
SAN LUIS POTOSÍ,24,MATEHUALA,020,SAN JOSÉ DE LOS SOTOLES,2,32,17,15,2
SAN LUIS POTOSÍ,24,MATEHUALA,020,SAN JOSÉ DEL PLAN,3,33,22,11,3
SAN LUIS POTOSÍ,24,MATEHUALA,020,SAN MIGUEL,3,66,24,42,4
SAN LUIS POTOSÍ,24,MATEHUALA,020,SAN RAFAEL,2,24,17,7,2
SAN LUIS POTOSÍ,24,MATEHUALA,020,SANTA BRÍGIDA,3,88,42,46,6
SAN LUIS POTOSÍ,24,MATEHUALA,020,SANTA CRUZ,4,160,85,75,11
SAN LUIS POTOSÍ,24,MATEHUALA,020,SANTA LUCÍA,4,444,217,227,46
SAN LUIS POTOSÍ,24,MATEHUALA,020,TANQUE COLORADO,4,223,122,101,14
SAN LUIS POTOSÍ,24,MATEHUALA,020,TROJE DE LOS MORENO,2,5,1,4,1
SAN LUIS POTOSÍ,24,MATEHUALA,020,VIBORILLAS,2,28,15,13,3
SAN LUIS POTOSÍ,24,MEXQUITIC DE CARMONA,021,AGUA PRIETA,3,68,36,32,6
SAN LUIS POTOSÍ,24,MEXQUITIC DE CARMONA,021,AGUA SEÑORA,3,232,113,119,13
SAN LUIS POTOSÍ,24,MEXQUITIC DE CARMONA,021,BENITO JUÁREZ,3,64,27,37,4
SAN LUIS POTOSÍ,24,MEXQUITIC DE CARMONA,021,BUENAVISTA,2,27,5,22,2
SAN LUIS POTOSÍ,24,MEXQUITIC DE CARMONA,021,CENICERA,3,36,19,17,4
SAN LUIS POTOSÍ,24,MEXQUITIC DE CARMONA,021,CERRITO DE ESTANZUELA,1,7,4,3,1
SAN LUIS POTOSÍ,24,MEXQUITIC DE CARMONA,021,CERRITO DE JARAL,3,343,165,178,19
SAN LUIS POTOSÍ,24,MEXQUITIC DE CARMONA,021,CERRITO DE MARAVILLAS,2,56,29,27,3
SAN LUIS POTOSÍ,24,MEXQUITIC DE CARMONA,021,CERRO PRIETO,3,85,43,42,5
SAN LUIS POTOSÍ,24,MEXQUITIC DE CARMONA,021,COLONIA ÁLVARO OBREGÓN,3,77,46,31,5
SAN LUIS POTOSÍ,24,MEXQUITIC DE CARMONA,021,COLONIA EMILIANO ZAPATA (EL CHAMIZAL),3,150,73,77,10
SAN LUIS POTOSÍ,24,MEXQUITIC DE CARMONA,021,COLONIA GUADALUPES,2,65,36,29,4
SAN LUIS POTOSÍ,24,MEXQUITIC DE CARMONA,021,COLONIA MOLINO DEL CARMEN,2,16,5,11,3
SAN LUIS POTOSÍ,24,MEXQUITIC DE CARMONA,021,COLONIA ORILLA DEL RÍO,2,39,18,21,2
SAN LUIS POTOSÍ,24,MEXQUITIC DE CARMONA,021,COLONIA PRIMERO DE ENERO,2,30,21,9,2
SAN LUIS POTOSÍ,24,MEXQUITIC DE CARMONA,021,COLONIA PROGRESO,2,28,13,15,2
SAN LUIS POTOSÍ,24,MEXQUITIC DE CARMONA,021,COMUNIDAD CORTE PRIMERO,4,561,300,261,36
SAN LUIS POTOSÍ,24,MEXQUITIC DE CARMONA,021,COMUNIDAD DE CORTE SEGUNDO,3,331,175,156,17
SAN LUIS POTOSÍ,24,MEXQUITIC DE CARMONA,021,CONTRERAS,3,174,94,80,11
SAN LUIS POTOSÍ,24,MEXQUITIC DE CARMONA,021,DERRAMADEROS,2,82,39,43,4
SAN LUIS POTOSÍ,24,MEXQUITIC DE CARMONA,021,EJIDO DE MORAS,3,191,92,99,10
SAN LUIS POTOSÍ,24,MEXQUITIC DE CARMONA,021,EJIDO MIGUEL HIDALGO,3,57,27,30,4
SAN LUIS POTOSÍ,24,MEXQUITIC DE CARMONA,021,EJIDO MILPILLAS,1,24,10,14,1
SAN LUIS POTOSÍ,24,MEXQUITIC DE CARMONA,021,EL CARRILLO,2,30,13,17,3
SAN LUIS POTOSÍ,24,MEXQUITIC DE CARMONA,021,EL CARRIZAL,5,268,131,137,13
SAN LUIS POTOSÍ,24,MEXQUITIC DE CARMONA,021,EL JARALITO,3,99,46,53,8
SAN LUIS POTOSÍ,24,MEXQUITIC DE CARMONA,021,EL PALMAR PRIMERO,3,169,77,92,11
SAN LUIS POTOSÍ,24,MEXQUITIC DE CARMONA,021,EL RODEO,2,12,5,7,2
SAN LUIS POTOSÍ,24,MEXQUITIC DE CARMONA,021,EL TEPOZÁN,2,34,21,13,2
SAN LUIS POTOSÍ,24,MEXQUITIC DE CARMONA,021,ESTACIÓN JUSTINO,2,47,30,17,3
SAN LUIS POTOSÍ,24,MEXQUITIC DE CARMONA,021,ESTANCITA,3,48,22,26,4
SAN LUIS POTOSÍ,24,MEXQUITIC DE CARMONA,021,ESTANZUELA,4,425,227,198,30
SAN LUIS POTOSÍ,24,MEXQUITIC DE CARMONA,021,FRACCIÓN OJO DE PINTO,3,66,38,28,5
SAN LUIS POTOSÍ,24,MEXQUITIC DE CARMONA,021,FRACCIÓN SALITRERA,3,31,18,13,3
SAN LUIS POTOSÍ,24,MEXQUITIC DE CARMONA,021,GUADALUPE VICTORIA,3,234,114,120,12
SAN LUIS POTOSÍ,24,MEXQUITIC DE CARMONA,021,HUIZACHILLOS,2,95,52,43,5
SAN LUIS POTOSÍ,24,MEXQUITIC DE CARMONA,021,IGNACIO ALLENDE,3,41,18,23,4
SAN LUIS POTOSÍ,24,MEXQUITIC DE CARMONA,021,LA CABRA,1,11,4,7,1
SAN LUIS POTOSÍ,24,MEXQUITIC DE CARMONA,021,LA CAMPANA,3,151,66,85,8
SAN LUIS POTOSÍ,24,MEXQUITIC DE CARMONA,021,LA COLORADA,2,125,65,60,6
SAN LUIS POTOSÍ,24,MEXQUITIC DE CARMONA,021,LA CRUZ,4,113,63,50,6
SAN LUIS POTOSÍ,24,MEXQUITIC DE CARMONA,021,LA JACOBA,1,5,0,5,1
SAN LUIS POTOSÍ,24,MEXQUITIC DE CARMONA,021,LA LOMA,1,14,2,12,1
SAN LUIS POTOSÍ,24,MEXQUITIC DE CARMONA,021,LA MATANZA,1,5,2,3,1
SAN LUIS POTOSÍ,24,MEXQUITIC DE CARMONA,021,LA TAPONA,4,194,85,109,14
SAN LUIS POTOSÍ,24,MEXQUITIC DE CARMONA,021,LAGUNILLAS,2,13,5,8,2
SAN LUIS POTOSÍ,24,MEXQUITIC DE CARMONA,021,LAS MANGAS DOS,1,6,3,3,1
SAN LUIS POTOSÍ,24,MEXQUITIC DE CARMONA,021,LAS MORAS,3,132,60,72,8
SAN LUIS POTOSÍ,24,MEXQUITIC DE CARMONA,021,LOS CORONADO,2,31,16,15,3
SAN LUIS POTOSÍ,24,MEXQUITIC DE CARMONA,021,LOS HERNÁNDEZ,2,24,14,10,3
SAN LUIS POTOSÍ,24,MEXQUITIC DE CARMONA,021,LOS JIMÉNEZ,2,12,8,4,2
SAN LUIS POTOSÍ,24,MEXQUITIC DE CARMONA,021,LOS LÓPEZ,2,42,23,19,3
SAN LUIS POTOSÍ,24,MEXQUITIC DE CARMONA,021,LOS MORENO,2,145,60,85,8
SAN LUIS POTOSÍ,24,MEXQUITIC DE CARMONA,021,LOS RETES,2,72,29,43,3
SAN LUIS POTOSÍ,24,MEXQUITIC DE CARMONA,021,LOS RODRÍGUEZ,2,29,13,16,2
SAN LUIS POTOSÍ,24,MEXQUITIC DE CARMONA,021,LOS ROJAS,3,81,50,31,5
SAN LUIS POTOSÍ,24,MEXQUITIC DE CARMONA,021,LOS VANEGAS,2,74,35,39,4
SAN LUIS POTOSÍ,24,MEXQUITIC DE CARMONA,021,LOS VÁZQUEZ,3,273,135,138,14
SAN LUIS POTOSÍ,24,MEXQUITIC DE CARMONA,021,MARAVILLAS,4,1102,555,547,52
SAN LUIS POTOSÍ,24,MEXQUITIC DE CARMONA,021,MATANCILLAS,3,141,63,78,8
SAN LUIS POTOSÍ,24,MEXQUITIC DE CARMONA,021,MEXQUITIC DE CARMONA,10,1694,879,815,94
SAN LUIS POTOSÍ,24,MEXQUITIC DE CARMONA,021,MILPILLAS,2,86,34,52,5
SAN LUIS POTOSÍ,24,MEXQUITIC DE CARMONA,021,MONTE OBSCURO,3,457,230,227,25
SAN LUIS POTOSÍ,24,MEXQUITIC DE CARMONA,021,MORELOS,3,27,11,16,3
SAN LUIS POTOSÍ,24,MEXQUITIC DE CARMONA,021,OJO ZARCO DE ARISTA,3,180,89,91,11
SAN LUIS POTOSÍ,24,MEXQUITIC DE CARMONA,021,PAISANOS,3,321,165,156,18
SAN LUIS POTOSÍ,24,MEXQUITIC DE CARMONA,021,PALMAR SEGUNDO,2,77,42,35,3
SAN LUIS POTOSÍ,24,MEXQUITIC DE CARMONA,021,PASO BLANCO,3,217,102,115,13
SAN LUIS POTOSÍ,24,MEXQUITIC DE CARMONA,021,POLLITOS,3,135,71,64,9
SAN LUIS POTOSÍ,24,MEXQUITIC DE CARMONA,021,PUERTO DE PROVIDENCIA,4,372,191,181,21
SAN LUIS POTOSÍ,24,MEXQUITIC DE CARMONA,021,RANCHERÍA DE GUADALUPE,3,226,120,106,12
SAN LUIS POTOSÍ,24,MEXQUITIC DE CARMONA,021,RINCÓN DE SAN JOSÉ,3,80,40,40,5
SAN LUIS POTOSÍ,24,MEXQUITIC DE CARMONA,021,RINCÓN DEL PORVENIR,3,245,105,140,13
SAN LUIS POTOSÍ,24,MEXQUITIC DE CARMONA,021,RIVERA,3,36,18,18,4
SAN LUIS POTOSÍ,24,MEXQUITIC DE CARMONA,021,SALITRILLO,4,71,30,41,6
SAN LUIS POTOSÍ,24,MEXQUITIC DE CARMONA,021,SAN AGUSTÍN,3,110,56,54,7
SAN LUIS POTOSÍ,24,MEXQUITIC DE CARMONA,021,SAN FRANCISCO (LOMAS DE SAN FRANCISCO),5,137,66,71,9
SAN LUIS POTOSÍ,24,MEXQUITIC DE CARMONA,021,SAN MARCOS (SAN MARCOS CARMONA),11,1055,482,573,87
SAN LUIS POTOSÍ,24,MEXQUITIC DE CARMONA,021,SAN PEDRO OJO ZARCO,4,674,334,340,37
SAN LUIS POTOSÍ,24,MEXQUITIC DE CARMONA,021,SAN SALVADOR,2,4,2,2,1
SAN LUIS POTOSÍ,24,MEXQUITIC DE CARMONA,021,SUSPIRO PICACHO,3,266,139,127,16
SAN LUIS POTOSÍ,24,MEXQUITIC DE CARMONA,021,TANQUE GRANDE,2,45,25,20,3
SAN LUIS POTOSÍ,24,MEXQUITIC DE CARMONA,021,TEMAXCALILLO,4,19,11,8,5
SAN LUIS POTOSÍ,24,MEXQUITIC DE CARMONA,021,VALLE UMBROSO,4,151,60,91,13
SAN LUIS POTOSÍ,24,MEXQUITIC DE CARMONA,021,VENADITO,3,80,40,40,5
SAN LUIS POTOSÍ,24,MOCTEZUMA,022,ANCÓN,3,43,19,24,3
SAN LUIS POTOSÍ,24,MOCTEZUMA,022,ARROYO HONDO,3,17,12,5,2
SAN LUIS POTOSÍ,24,MOCTEZUMA,022,BARRANCAS,3,132,74,58,8
SAN LUIS POTOSÍ,24,MOCTEZUMA,022,CHARCO DEL LOBO (CENTRO),4,204,109,95,13
SAN LUIS POTOSÍ,24,MOCTEZUMA,022,CODORNIZ,3,74,40,34,5
SAN LUIS POTOSÍ,24,MOCTEZUMA,022,COLONIA PROGRESO,1,7,3,4,1
SAN LUIS POTOSÍ,24,MOCTEZUMA,022,CRISTO REY,2,129,63,66,5
SAN LUIS POTOSÍ,24,MOCTEZUMA,022,CRUCES,3,69,38,31,5
SAN LUIS POTOSÍ,24,MOCTEZUMA,022,EJIDO JUÁREZ,1,22,10,12,1
SAN LUIS POTOSÍ,24,MOCTEZUMA,022,EL AMPARO,3,22,11,11,2
SAN LUIS POTOSÍ,24,MOCTEZUMA,022,EL CARPINTERO,3,53,21,32,4
SAN LUIS POTOSÍ,24,MOCTEZUMA,022,EL COLORADO,3,71,36,35,4
SAN LUIS POTOSÍ,24,MOCTEZUMA,022,EL CÚCAMO,3,208,93,115,12
SAN LUIS POTOSÍ,24,MOCTEZUMA,022,EL MULERO,2,48,28,20,2
SAN LUIS POTOSÍ,24,MOCTEZUMA,022,EL NARANJO,3,23,15,8,3
SAN LUIS POTOSÍ,24,MOCTEZUMA,022,EL PEDERNAL,3,40,21,19,3
SAN LUIS POTOSÍ,24,MOCTEZUMA,022,EL PUERTO DE DUQUES,2,12,4,8,2
SAN LUIS POTOSÍ,24,MOCTEZUMA,022,EL REBALÍN,3,123,64,59,8
SAN LUIS POTOSÍ,24,MOCTEZUMA,022,EL RETIRO,3,148,68,80,8
SAN LUIS POTOSÍ,24,MOCTEZUMA,022,EL ROSARIO,1,6,2,4,1
SAN LUIS POTOSÍ,24,MOCTEZUMA,022,EL SAUCITO,3,31,15,16,4
SAN LUIS POTOSÍ,24,MOCTEZUMA,022,EL SOTOL,3,30,14,16,3
SAN LUIS POTOSÍ,24,MOCTEZUMA,022,ESTACIÓN DE ENRAMADA,2,37,14,23,3
SAN LUIS POTOSÍ,24,MOCTEZUMA,022,ESTACIÓN MOCTEZUMA,3,58,29,29,4
SAN LUIS POTOSÍ,24,MOCTEZUMA,022,ESTANCO,3,31,11,20,3
SAN LUIS POTOSÍ,24,MOCTEZUMA,022,EX-HACIENDA DE ENRAMADA,3,98,49,49,7
SAN LUIS POTOSÍ,24,MOCTEZUMA,022,GARABATILLO,3,20,10,10,3
SAN LUIS POTOSÍ,24,MOCTEZUMA,022,JUACHE,3,56,29,27,3
SAN LUIS POTOSÍ,24,MOCTEZUMA,022,LA ADUANA,2,30,11,19,2
SAN LUIS POTOSÍ,24,MOCTEZUMA,022,LA CARBONERA DE ARRIBA,2,12,7,5,2
SAN LUIS POTOSÍ,24,MOCTEZUMA,022,LA CUEVA,1,3,2,1,1
SAN LUIS POTOSÍ,24,MOCTEZUMA,022,LA ENCARNACIÓN,2,10,3,7,1
SAN LUIS POTOSÍ,24,MOCTEZUMA,022,LA ESCONDIDA,2,5,1,4,1
SAN LUIS POTOSÍ,24,MOCTEZUMA,022,LA LUZ,3,73,44,29,5
SAN LUIS POTOSÍ,24,MOCTEZUMA,022,LA MATANZA,1,6,3,3,1
SAN LUIS POTOSÍ,24,MOCTEZUMA,022,LA PRESA,3,24,12,12,4
SAN LUIS POTOSÍ,24,MOCTEZUMA,022,LABOR VIEJA,3,67,31,36,4
SAN LUIS POTOSÍ,24,MOCTEZUMA,022,LAS ALTEÑAS,4,85,38,47,5
SAN LUIS POTOSÍ,24,MOCTEZUMA,022,LOS TAJOS,2,8,4,4,1
SAN LUIS POTOSÍ,24,MOCTEZUMA,022,MOCTEZUMA,8,1587,797,790,68
SAN LUIS POTOSÍ,24,MOCTEZUMA,022,MORADOS,3,175,84,91,9
SAN LUIS POTOSÍ,24,MOCTEZUMA,022,MORTERILLOS,3,138,60,78,8
SAN LUIS POTOSÍ,24,MOCTEZUMA,022,PIEDRA AZUL (LA PIEDRA),2,25,12,13,2
SAN LUIS POTOSÍ,24,MOCTEZUMA,022,POZOS DE MATANZA,2,17,9,8,2
SAN LUIS POTOSÍ,24,MOCTEZUMA,022,PROVIDENCIA,3,33,18,15,3
SAN LUIS POTOSÍ,24,MOCTEZUMA,022,RAMÍREZ DE ARRIBA,2,23,12,11,3
SAN LUIS POTOSÍ,24,MOCTEZUMA,022,RANCHO NUEVO,3,28,16,12,3
SAN LUIS POTOSÍ,24,MOCTEZUMA,022,SALSIPUEDES,3,65,28,37,4
SAN LUIS POTOSÍ,24,MOCTEZUMA,022,SAN ANTONIO DEL RUL,3,34,16,18,3
SAN LUIS POTOSÍ,24,MOCTEZUMA,022,SAN FRANCISCO DE LA DICHA,4,191,82,109,11
SAN LUIS POTOSÍ,24,MOCTEZUMA,022,SAN IGNACIO,4,80,42,38,7
SAN LUIS POTOSÍ,24,MOCTEZUMA,022,SAN JERÓNIMO DE DUANA,2,13,2,11,2
SAN LUIS POTOSÍ,24,MOCTEZUMA,022,SAN JOSÉ DE ENRAMADA,2,110,60,50,5
SAN LUIS POTOSÍ,24,MOCTEZUMA,022,SAN JOSÉ DEL GRITO,3,79,35,44,5
SAN LUIS POTOSÍ,24,MOCTEZUMA,022,SAN MATÍAS,2,6,4,2,1
SAN LUIS POTOSÍ,24,MOCTEZUMA,022,SANTA CATARINA,3,38,20,18,3
SAN LUIS POTOSÍ,24,MOCTEZUMA,022,SANTA RITA,1,5,1,4,1
SAN LUIS POTOSÍ,24,MOCTEZUMA,022,SANTA TERESA,3,44,27,17,3
SAN LUIS POTOSÍ,24,RAYÓN,023,AGUA DE GAMOTES,2,6,3,3,1
SAN LUIS POTOSÍ,24,RAYÓN,023,AGUACATILLOS,3,62,32,30,4
SAN LUIS POTOSÍ,24,RAYÓN,023,AMOLADERAS,3,74,37,37,4
SAN LUIS POTOSÍ,24,RAYÓN,023,CERRITO DE LA CRUZ,3,104,50,54,6
SAN LUIS POTOSÍ,24,RAYÓN,023,CRUCERO DE RAYÓN,2,134,66,68,9
SAN LUIS POTOSÍ,24,RAYÓN,023,EL AGUACATE,3,58,31,27,4
SAN LUIS POTOSÍ,24,RAYÓN,023,EL EPAZOTE,3,90,42,48,8
SAN LUIS POTOSÍ,24,RAYÓN,023,EL NOGALITO,2,12,8,4,2
SAN LUIS POTOSÍ,24,RAYÓN,023,EL PAJARITO,3,68,34,34,5
SAN LUIS POTOSÍ,24,RAYÓN,023,EL PIRUCHE,2,22,10,12,2
SAN LUIS POTOSÍ,24,RAYÓN,023,EL RANCHITO,3,21,9,12,3
SAN LUIS POTOSÍ,24,RAYÓN,023,EL SABINITO,3,119,65,54,8
SAN LUIS POTOSÍ,24,RAYÓN,023,LA LUZ,3,36,21,15,3
SAN LUIS POTOSÍ,24,RAYÓN,023,LA NUEVA REFORMA,3,37,15,22,3
SAN LUIS POTOSÍ,24,RAYÓN,023,LA VIEJA,1,4,2,2,1
SAN LUIS POTOSÍ,24,RAYÓN,023,LAS CANOAS,5,273,123,150,15
SAN LUIS POTOSÍ,24,RAYÓN,023,LAS GUAPAS,4,200,91,109,12
SAN LUIS POTOSÍ,24,RAYÓN,023,MORELOS,1,4,2,2,1
SAN LUIS POTOSÍ,24,RAYÓN,023,NOGALES,3,51,24,27,4
SAN LUIS POTOSÍ,24,RAYÓN,023,OBREGÓN (ESTANCITAS),3,125,63,62,7
SAN LUIS POTOSÍ,24,RAYÓN,023,POTRERO DEL CARNERO,3,38,21,17,3
SAN LUIS POTOSÍ,24,RAYÓN,023,POZO BENDITO,3,22,9,13,3
SAN LUIS POTOSÍ,24,RAYÓN,023,POZO DE MOSCAS,1,4,2,2,1
SAN LUIS POTOSÍ,24,RAYÓN,023,PUERTECITOS,1,2,2,0,1
SAN LUIS POTOSÍ,24,RAYÓN,023,RAYÓN,9,1445,756,689,67
SAN LUIS POTOSÍ,24,RAYÓN,023,SAN FELIPE DE JESÚS GAMOTES,3,65,31,34,4
SAN LUIS POTOSÍ,24,RAYÓN,023,SAN FRANCISCO,3,35,16,19,4
SAN LUIS POTOSÍ,24,RAYÓN,023,TIERRAS COLORADAS,3,108,53,55,8
SAN LUIS POTOSÍ,24,RAYÓN,023,TORTUGAS,3,61,23,38,4
SAN LUIS POTOSÍ,24,RAYÓN,023,VALLECITOS,2,5,5,0,1
SAN LUIS POTOSÍ,24,RAYÓN,023,VAQUEROS,3,53,20,33,5
SAN LUIS POTOSÍ,24,RAYÓN,023,VICENTE GUERRERO,5,194,98,96,20
SAN LUIS POTOSÍ,24,RIOVERDE,024,ADJUNTAS,3,73,41,32,6
SAN LUIS POTOSÍ,24,RIOVERDE,024,AGUA DULCE,1,4,0,4,1
SAN LUIS POTOSÍ,24,RIOVERDE,024,ALAMEDA,3,7,4,3,2
SAN LUIS POTOSÍ,24,RIOVERDE,024,AMPLIACIÓN EJIDO EL JABALÍ (LA CURVA),1,112,59,53,6
SAN LUIS POTOSÍ,24,RIOVERDE,024,ANGOSTURA (LOS CANELOS),3,78,28,50,5
SAN LUIS POTOSÍ,24,RIOVERDE,024,ARCO GRANDE (LOS ARQUITOS DE SAN ISIDRO),3,34,15,19,3
SAN LUIS POTOSÍ,24,RIOVERDE,024,BAGRES DE ABAJO,3,13,7,6,2
SAN LUIS POTOSÍ,24,RIOVERDE,024,BORDO BLANCO,3,119,58,61,6
SAN LUIS POTOSÍ,24,RIOVERDE,024,CAÑADA GRANDE,3,228,105,123,15
SAN LUIS POTOSÍ,24,RIOVERDE,024,CHARCO SALADO,3,45,20,25,3
SAN LUIS POTOSÍ,24,RIOVERDE,024,CHUPADEROS,1,5,3,2,1
SAN LUIS POTOSÍ,24,RIOVERDE,024,CIENEGUILLAS,4,237,134,103,16
SAN LUIS POTOSÍ,24,RIOVERDE,024,COLONIA LA ESPERANZA DOS,1,72,37,35,4
SAN LUIS POTOSÍ,24,RIOVERDE,024,COLONIA MARÍA ASUNCIÓN DEL BARRIO DE LOS ÁNGELES,5,235,112,123,12
SAN LUIS POTOSÍ,24,RIOVERDE,024,COLONIA MARÍA DEL ROSARIO (PUENTE DEL CARMEN),2,146,70,76,7
SAN LUIS POTOSÍ,24,RIOVERDE,024,DIEGO RUIZ,2,4,2,2,1
SAN LUIS POTOSÍ,24,RIOVERDE,024,EL AGUACATE,3,95,43,52,7
SAN LUIS POTOSÍ,24,RIOVERDE,024,EL ALISO,3,17,10,7,4
SAN LUIS POTOSÍ,24,RIOVERDE,024,EL CAPULÍN,4,472,257,215,33
SAN LUIS POTOSÍ,24,RIOVERDE,024,EL CARRIZAL,1,5,0,5,1
SAN LUIS POTOSÍ,24,RIOVERDE,024,EL CHARCO,2,13,6,7,2
SAN LUIS POTOSÍ,24,RIOVERDE,024,EL FRENO,2,18,13,5,2
SAN LUIS POTOSÍ,24,RIOVERDE,024,EL HIGUERÓN,2,14,4,10,2
SAN LUIS POTOSÍ,24,RIOVERDE,024,EL HUIZACHAL,3,65,34,31,5
SAN LUIS POTOSÍ,24,RIOVERDE,024,EL JABALÍ,5,630,303,327,41
SAN LUIS POTOSÍ,24,RIOVERDE,024,EL NACIMIENTO,3,32,14,18,4
SAN LUIS POTOSÍ,24,RIOVERDE,024,EL NOGALITO,3,22,14,8,3
SAN LUIS POTOSÍ,24,RIOVERDE,024,EL OBRAJERO,2,26,14,12,2
SAN LUIS POTOSÍ,24,RIOVERDE,024,EL PESCADITO,3,87,46,41,5
SAN LUIS POTOSÍ,24,RIOVERDE,024,EL RIACHUELO (EL CARACOL),3,78,40,38,7
SAN LUIS POTOSÍ,24,RIOVERDE,024,EL RODEO,1,3,0,3,1
SAN LUIS POTOSÍ,24,RIOVERDE,024,EL SAUCITO,2,14,11,3,2
SAN LUIS POTOSÍ,24,RIOVERDE,024,EL TULE,3,34,15,19,3
SAN LUIS POTOSÍ,24,RIOVERDE,024,EL ZAPOTE,3,112,51,61,8
SAN LUIS POTOSÍ,24,RIOVERDE,024,ILDEFONSO TURRUBIARTES (LA BOQUILLA),3,160,91,69,9
SAN LUIS POTOSÍ,24,RIOVERDE,024,JOYA DEL DURAZNO,3,21,10,11,3
SAN LUIS POTOSÍ,24,RIOVERDE,024,JOYAS DE VENTURA,2,7,4,3,2
SAN LUIS POTOSÍ,24,RIOVERDE,024,LA COFRADÍA,3,251,124,127,12
SAN LUIS POTOSÍ,24,RIOVERDE,024,LA ESCONDIDA,1,16,9,7,1
SAN LUIS POTOSÍ,24,RIOVERDE,024,LA LABORCILLA,3,92,44,48,6
SAN LUIS POTOSÍ,24,RIOVERDE,024,LA LOMA,3,196,111,85,13
SAN LUIS POTOSÍ,24,RIOVERDE,024,LA MANGA,3,31,12,19,3
SAN LUIS POTOSÍ,24,RIOVERDE,024,LA MISIÓN,3,10,2,8,2
SAN LUIS POTOSÍ,24,RIOVERDE,024,LA MURALLA,3,69,38,31,5
SAN LUIS POTOSÍ,24,RIOVERDE,024,LA PALMITA,3,176,86,90,11
SAN LUIS POTOSÍ,24,RIOVERDE,024,LA PERDIDA,1,9,4,5,1
SAN LUIS POTOSÍ,24,RIOVERDE,024,LA PROVIDENCIA,3,29,14,15,3
SAN LUIS POTOSÍ,24,RIOVERDE,024,LA ROSITA,1,4,2,2,1
SAN LUIS POTOSÍ,24,RIOVERDE,024,LA TAPONA,3,88,42,46,7
SAN LUIS POTOSÍ,24,RIOVERDE,024,LA VIRGEN,3,146,86,60,9
SAN LUIS POTOSÍ,24,RIOVERDE,024,LAS ADJUNTAS DE BAGRES,2,16,7,9,2
SAN LUIS POTOSÍ,24,RIOVERDE,024,LAS GUAYABITAS,2,18,12,6,2
SAN LUIS POTOSÍ,24,RIOVERDE,024,LAS HUERTITAS,2,232,120,112,8
SAN LUIS POTOSÍ,24,RIOVERDE,024,LAS MAGDALENAS,3,216,111,105,11
SAN LUIS POTOSÍ,24,RIOVERDE,024,LAS MANGAS,3,13,6,7,3
SAN LUIS POTOSÍ,24,RIOVERDE,024,LAS PILAS,3,12,8,4,2
SAN LUIS POTOSÍ,24,RIOVERDE,024,LOS ALAMITOS,3,21,12,9,3
SAN LUIS POTOSÍ,24,RIOVERDE,024,MESA DEL SALTO,3,59,31,28,5
SAN LUIS POTOSÍ,24,RIOVERDE,024,MIGUEL HIDALGO,4,239,129,110,22
SAN LUIS POTOSÍ,24,RIOVERDE,024,MILPITAS,2,7,4,3,2
SAN LUIS POTOSÍ,24,RIOVERDE,024,OJO DE AGUA SECO,3,155,62,93,7
SAN LUIS POTOSÍ,24,RIOVERDE,024,PALMILLAS,3,16,4,12,4
SAN LUIS POTOSÍ,24,RIOVERDE,024,PALOMAS,2,13,5,8,1
SAN LUIS POTOSÍ,24,RIOVERDE,024,PAREDES,2,6,2,4,1
SAN LUIS POTOSÍ,24,RIOVERDE,024,PASO DE LOS HERREROS (PASO DE GUADALUPE),3,31,17,14,3
SAN LUIS POTOSÍ,24,RIOVERDE,024,PASO DE SAN ANTONIO,3,59,32,27,4
SAN LUIS POTOSÍ,24,RIOVERDE,024,PASO REAL,3,104,58,46,7
SAN LUIS POTOSÍ,24,RIOVERDE,024,PASTORA,3,248,135,113,14
SAN LUIS POTOSÍ,24,RIOVERDE,024,PLAZUELA,4,410,191,219,22
SAN LUIS POTOSÍ,24,RIOVERDE,024,PROGRESO,3,386,195,191,21
SAN LUIS POTOSÍ,24,RIOVERDE,024,PUENTE LA ESCONDIDA,2,9,4,5,2
SAN LUIS POTOSÍ,24,RIOVERDE,024,PUERTO DE LA VACA,1,3,1,2,1
SAN LUIS POTOSÍ,24,RIOVERDE,024,PUERTO DE LA YERBABUENA,2,15,9,6,2
SAN LUIS POTOSÍ,24,RIOVERDE,024,PUERTO DE MARTÍNEZ,3,105,52,53,7
SAN LUIS POTOSÍ,24,RIOVERDE,024,RANCHO LA CONCEPCIÓN,3,544,288,256,26
SAN LUIS POTOSÍ,24,RIOVERDE,024,RANCHO NUEVO (RANCHITO),2,8,1,7,1
SAN LUIS POTOSÍ,24,RIOVERDE,024,RESUMIDERO,2,9,4,5,1
SAN LUIS POTOSÍ,24,RIOVERDE,024,RIOVERDE,102,17517,8964,8553,1098
SAN LUIS POTOSÍ,24,RIOVERDE,024,SAN BARTOLO,3,155,75,80,10
SAN LUIS POTOSÍ,24,RIOVERDE,024,SAN DIEGO,4,287,143,144,26
SAN LUIS POTOSÍ,24,RIOVERDE,024,SAN FRANCISCO,4,438,221,217,28
SAN LUIS POTOSÍ,24,RIOVERDE,024,SAN ISIDRO DE VIGAS (EL HUACAL),2,14,5,9,2
SAN LUIS POTOSÍ,24,RIOVERDE,024,SAN JOSÉ DE CANOAS,3,95,55,40,7
SAN LUIS POTOSÍ,24,RIOVERDE,024,SAN JOSÉ DE LAS FLORES,3,112,62,50,6
SAN LUIS POTOSÍ,24,RIOVERDE,024,SAN JOSÉ DEL TAPANCO,4,377,183,194,30
SAN LUIS POTOSÍ,24,RIOVERDE,024,SAN JOSÉ GALLINAS,3,109,49,60,6
SAN LUIS POTOSÍ,24,RIOVERDE,024,SAN MARTÍN,3,170,80,90,11
SAN LUIS POTOSÍ,24,RIOVERDE,024,SAN RAFAELITO,2,5,3,2,1
SAN LUIS POTOSÍ,24,RIOVERDE,024,SAN SEBASTIÁN,3,47,20,27,3
SAN LUIS POTOSÍ,24,RIOVERDE,024,SAN VICENTE,4,201,115,86,12
SAN LUIS POTOSÍ,24,RIOVERDE,024,SANGUIJUELA,1,12,8,4,1
SAN LUIS POTOSÍ,24,RIOVERDE,024,SANTA ISABEL,2,46,26,20,3
SAN LUIS POTOSÍ,24,RIOVERDE,024,SANTA RITA,3,269,125,144,15
SAN LUIS POTOSÍ,24,RIOVERDE,024,SOLEDAD,1,6,2,4,1
SAN LUIS POTOSÍ,24,RIOVERDE,024,TANQUE DE SAN JUAN,3,45,18,27,4
SAN LUIS POTOSÍ,24,RIOVERDE,024,TECOMATES,3,41,20,21,3
SAN LUIS POTOSÍ,24,RIOVERDE,024,VALLE FLORIDO,2,29,16,13,2
SAN LUIS POTOSÍ,24,SALINAS,025,AZOGUEROS,3,117,54,63,7
SAN LUIS POTOSÍ,24,SALINAS,025,BAJÍO DE LOS ENCINOS (LOS ENCINITOS),2,20,9,11,1
SAN LUIS POTOSÍ,24,SALINAS,025,COLONIA ZARAGOZA (GARABATILLO),3,79,37,42,4
SAN LUIS POTOSÍ,24,SALINAS,025,CONEJILLO,5,265,144,121,19
SAN LUIS POTOSÍ,24,SALINAS,025,EL ALEGRE,3,80,40,40,5
SAN LUIS POTOSÍ,24,SALINAS,025,EL CAMARÓN,2,12,5,7,1
SAN LUIS POTOSÍ,24,SALINAS,025,EL ESTRIBO,3,120,57,63,5
SAN LUIS POTOSÍ,24,SALINAS,025,EL JABONERO,2,14,8,6,2
SAN LUIS POTOSÍ,24,SALINAS,025,EL LLANO DEL CONEJILLO,2,34,16,18,4
SAN LUIS POTOSÍ,24,SALINAS,025,EL MEZQUITAL,2,15,10,5,2
SAN LUIS POTOSÍ,24,SALINAS,025,EL MEZQUITE,3,44,18,26,3
SAN LUIS POTOSÍ,24,SALINAS,025,EL POTRO,3,51,28,23,5
SAN LUIS POTOSÍ,24,SALINAS,025,EL TECOLOTE,2,11,4,7,1
SAN LUIS POTOSÍ,24,SALINAS,025,GUADALUPE VICTORIA (LA NORIA DEL JACALÓN),3,34,19,15,3
SAN LUIS POTOSÍ,24,SALINAS,025,GUADALUPITO,2,15,8,7,1
SAN LUIS POTOSÍ,24,SALINAS,025,LA BOLSA,2,19,10,9,2
SAN LUIS POTOSÍ,24,SALINAS,025,LA MANTENEDORA,3,42,15,27,3
SAN LUIS POTOSÍ,24,SALINAS,025,LA MESILLA,3,63,32,31,4
SAN LUIS POTOSÍ,24,SALINAS,025,LA REFORMA,4,230,130,100,16
SAN LUIS POTOSÍ,24,SALINAS,025,LAS COLONIAS (COLONIA JUÁREZ),10,418,205,213,25
SAN LUIS POTOSÍ,24,SALINAS,025,LOS MONTECITOS,1,5,4,1,1
SAN LUIS POTOSÍ,24,SALINAS,025,NORIA DE CAÑAS,4,165,81,84,10
SAN LUIS POTOSÍ,24,SALINAS,025,PALMA PEGADA,4,305,165,140,20
SAN LUIS POTOSÍ,24,SALINAS,025,PIEDRAS NEGRAS,3,22,9,13,3
SAN LUIS POTOSÍ,24,SALINAS,025,POZO SECO,3,40,20,20,4
SAN LUIS POTOSÍ,24,SALINAS,025,PUNTEROS (SAN JOSÉ DE PUNTEROS),3,156,73,83,10
SAN LUIS POTOSÍ,24,SALINAS,025,RANCHO NUEVO,2,14,6,8,1
SAN LUIS POTOSÍ,24,SALINAS,025,SALINAS DE HIDALGO,24,4669,2396,2273,285
SAN LUIS POTOSÍ,24,SALINAS,025,SALITRILLO,3,156,91,65,10
SAN LUIS POTOSÍ,24,SALINAS,025,SALTO MATORRAL,2,5,2,3,1
SAN LUIS POTOSÍ,24,SALINAS,025,SAN ANTONIO DE LA PAZ,3,29,14,15,3
SAN LUIS POTOSÍ,24,SALINAS,025,SAN EVARISTO,3,65,29,36,5
SAN LUIS POTOSÍ,24,SALINAS,025,SAN EXPEDITO,3,27,11,16,4
SAN LUIS POTOSÍ,24,SALINAS,025,SAN ISIDRO PEÑÓN BLANCO,3,122,57,65,7
SAN LUIS POTOSÍ,24,SALINAS,025,SAN JUAN SIN AGUA,3,23,13,10,3
SAN LUIS POTOSÍ,24,SALINAS,025,SAN PEDRO DE ALCÁNTAR,3,20,10,10,4
SAN LUIS POTOSÍ,24,SALINAS,025,SANTA ELENA,1,5,2,3,1
SAN LUIS POTOSÍ,24,SALINAS,025,SANTA MARÍA,3,64,31,33,5
SAN LUIS POTOSÍ,24,SALINAS,025,SOTOL,1,9,6,3,1
SAN LUIS POTOSÍ,24,SALINAS,025,TRIANA,2,11,6,5,1
SAN LUIS POTOSÍ,24,SALINAS,025,VIBORILLAS,3,23,13,10,3
SAN LUIS POTOSÍ,24,SALINAS,025,VICENTE GUERRERO (LA CÓCONA),1,12,7,5,1
SAN LUIS POTOSÍ,24,SAN ANTONIO,026,AL TZÁJIB,3,53,28,25,4
SAN LUIS POTOSÍ,24,SAN ANTONIO,026,COLONIA ALTAMIRA,2,94,46,48,5
SAN LUIS POTOSÍ,24,SAN ANTONIO,026,COLONIA EL PROGRESO,2,68,37,31,4
SAN LUIS POTOSÍ,24,SAN ANTONIO,026,CUÉCHOD,2,24,7,17,2
SAN LUIS POTOSÍ,24,SAN ANTONIO,026,EL FRIJOLILLO (TANCHAHUIL),1,23,9,14,2
SAN LUIS POTOSÍ,24,SAN ANTONIO,026,EL HUAYAL (CUICILLO),3,15,9,6,2
SAN LUIS POTOSÍ,24,SAN ANTONIO,026,EL ICTZEN,2,6,3,3,1
SAN LUIS POTOSÍ,24,SAN ANTONIO,026,LA ROSITA,2,13,6,7,2
SAN LUIS POTOSÍ,24,SAN ANTONIO,026,LANASH (EL NARANJAL),1,4,2,2,1
SAN LUIS POTOSÍ,24,SAN ANTONIO,026,LEJEM,3,282,154,128,22
SAN LUIS POTOSÍ,24,SAN ANTONIO,026,PA'TNEL,4,126,54,72,6
SAN LUIS POTOSÍ,24,SAN ANTONIO,026,POKCHICH,4,69,28,41,5
SAN LUIS POTOSÍ,24,SAN ANTONIO,026,POZO BLANCO III (TANCHAHUIL),2,22,11,11,2
SAN LUIS POTOSÍ,24,SAN ANTONIO,026,SAN ANTONIO,5,556,258,298,47
SAN LUIS POTOSÍ,24,SAN ANTONIO,026,SAN PEDRO,4,98,48,50,6
SAN LUIS POTOSÍ,24,SAN ANTONIO,026,SANTA MARTHA,4,112,49,63,8
SAN LUIS POTOSÍ,24,SAN ANTONIO,026,SINAÍ,1,6,3,3,1
SAN LUIS POTOSÍ,24,SAN ANTONIO,026,TAN D'HUYÚ (TANZUYO),2,29,12,17,3
SAN LUIS POTOSÍ,24,SAN ANTONIO,026,TAN JAJNEC,3,147,76,71,10
SAN LUIS POTOSÍ,24,SAN ANTONIO,026,TANCHAHUIL,5,446,220,226,29
SAN LUIS POTOSÍ,24,SAN ANTONIO,026,TANCHAHUIL SEGUNDA SECCIÓN,2,64,35,29,4
SAN LUIS POTOSÍ,24,SAN ANTONIO,026,TOCOY,5,288,127,161,17
SAN LUIS POTOSÍ,24,SAN ANTONIO,026,VISTA HERMOSA (XOLOL),2,8,6,2,2
SAN LUIS POTOSÍ,24,SAN ANTONIO,026,XOLOL,3,50,24,26,4
SAN LUIS POTOSÍ,24,SAN ANTONIO,026,ZARAGOZA,2,7,4,3,1
SAN LUIS POTOSÍ,24,SAN CIRO DE ACOSTA,027,AGUA FRÍA,2,7,3,4,1
SAN LUIS POTOSÍ,24,SAN CIRO DE ACOSTA,027,CODORNICES,2,4,0,4,1
SAN LUIS POTOSÍ,24,SAN CIRO DE ACOSTA,027,CORRAL QUEMADO,1,4,2,2,1
SAN LUIS POTOSÍ,24,SAN CIRO DE ACOSTA,027,EL AGUACATE,2,19,8,11,2
SAN LUIS POTOSÍ,24,SAN CIRO DE ACOSTA,027,EL CHUPADERO,2,7,4,3,2
SAN LUIS POTOSÍ,24,SAN CIRO DE ACOSTA,027,EL ENCANTADO,2,5,3,2,2
SAN LUIS POTOSÍ,24,SAN CIRO DE ACOSTA,027,EL ÓRGANO,2,19,11,8,2
SAN LUIS POTOSÍ,24,SAN CIRO DE ACOSTA,027,EL PITAHAYO (SANTA CRUZ DEL PITAYO),3,28,12,16,4
SAN LUIS POTOSÍ,24,SAN CIRO DE ACOSTA,027,EL RELÁMPAGO,2,17,10,7,1
SAN LUIS POTOSÍ,24,SAN CIRO DE ACOSTA,027,EL SOYOTAL,2,10,7,3,1
SAN LUIS POTOSÍ,24,SAN CIRO DE ACOSTA,027,GUERRERO,1,4,1,3,1
SAN LUIS POTOSÍ,24,SAN CIRO DE ACOSTA,027,LA CAÑADA SANTA GERTRUDIS,3,31,15,16,3
SAN LUIS POTOSÍ,24,SAN CIRO DE ACOSTA,027,LA TRINIDAD,3,74,34,40,6
SAN LUIS POTOSÍ,24,SAN CIRO DE ACOSTA,027,LAS MOCTEZUMAS,3,19,9,10,3
SAN LUIS POTOSÍ,24,SAN CIRO DE ACOSTA,027,LAS PILAS,1,5,2,3,1
SAN LUIS POTOSÍ,24,SAN CIRO DE ACOSTA,027,NUEVO SAN LUIS,2,4,2,2,2
SAN LUIS POTOSÍ,24,SAN CIRO DE ACOSTA,027,PALO ALTO DE LA PURÍSIMA CONCEPCIÓN,3,102,45,57,7
SAN LUIS POTOSÍ,24,SAN CIRO DE ACOSTA,027,PALOS CLAVADOS,1,5,3,2,1
SAN LUIS POTOSÍ,24,SAN CIRO DE ACOSTA,027,PASO DE JESÚS,3,27,11,16,3
SAN LUIS POTOSÍ,24,SAN CIRO DE ACOSTA,027,RANCHO NUEVO,2,9,3,6,1
SAN LUIS POTOSÍ,24,SAN CIRO DE ACOSTA,027,SAN CIRO DE ACOSTA,14,1775,893,882,116
SAN LUIS POTOSÍ,24,SAN LUIS POTOSÍ,028,ANGOSTURA,2,19,12,7,2
SAN LUIS POTOSÍ,24,SAN LUIS POTOSÍ,028,ARROYOS,3,458,213,245,21
SAN LUIS POTOSÍ,24,SAN LUIS POTOSÍ,028,BOCAS (ESTACIÓN BOCAS),5,791,425,366,58
SAN LUIS POTOSÍ,24,SAN LUIS POTOSÍ,028,CAPULINES,3,204,99,105,11
SAN LUIS POTOSÍ,24,SAN LUIS POTOSÍ,028,CERRITOS DE ZAVALA,3,251,128,123,13
SAN LUIS POTOSÍ,24,SAN LUIS POTOSÍ,028,CERRO DE LA VIRGEN (SAN JUAN DE BOCAS),2,28,11,17,3
SAN LUIS POTOSÍ,24,SAN LUIS POTOSÍ,028,CHARCO BLANCO,3,48,24,24,4
SAN LUIS POTOSÍ,24,SAN LUIS POTOSÍ,028,COLONIA DE COMITÉ MOVIMIENTO AMPLIO POPULAR,1,79,46,33,3
SAN LUIS POTOSÍ,24,SAN LUIS POTOSÍ,028,COLONIA INSURGENTES,2,140,65,75,7
SAN LUIS POTOSÍ,24,SAN LUIS POTOSÍ,028,EL BLANCO,3,28,13,15,4
SAN LUIS POTOSÍ,24,SAN LUIS POTOSÍ,028,EL CASCARÓN,3,66,32,34,4
SAN LUIS POTOSÍ,24,SAN LUIS POTOSÍ,028,EL CHAPARRAL,1,8,6,2,1
SAN LUIS POTOSÍ,24,SAN LUIS POTOSÍ,028,EL HACHA,3,37,12,25,4
SAN LUIS POTOSÍ,24,SAN LUIS POTOSÍ,028,EL HUIZACHE,2,13,5,8,2
SAN LUIS POTOSÍ,24,SAN LUIS POTOSÍ,028,EL JARALITO,3,425,225,200,22
SAN LUIS POTOSÍ,24,SAN LUIS POTOSÍ,028,EL MALACATE,3,55,35,20,4
SAN LUIS POTOSÍ,24,SAN LUIS POTOSÍ,028,EL REFUGIO,1,11,3,8,1
SAN LUIS POTOSÍ,24,SAN LUIS POTOSÍ,028,EL SANTUARIO,1,38,10,28,2
SAN LUIS POTOSÍ,24,SAN LUIS POTOSÍ,028,EL TERRERO SUR,3,274,128,146,11
SAN LUIS POTOSÍ,24,SAN LUIS POTOSÍ,028,ESCALERILLAS,10,1453,736,717,68
SAN LUIS POTOSÍ,24,SAN LUIS POTOSÍ,028,ESTACIÓN PINTO,2,13,5,8,2
SAN LUIS POTOSÍ,24,SAN LUIS POTOSÍ,028,FRACCIÓN EL AGUAJE,3,394,189,205,19
SAN LUIS POTOSÍ,24,SAN LUIS POTOSÍ,028,FRACCIÓN MILPILLAS,3,598,284,314,29
SAN LUIS POTOSÍ,24,SAN LUIS POTOSÍ,028,GONZÁLEZ,3,170,81,89,7
SAN LUIS POTOSÍ,24,SAN LUIS POTOSÍ,028,LA AMAPOLA,2,14,9,5,2
SAN LUIS POTOSÍ,24,SAN LUIS POTOSÍ,028,LA CALDERA,2,13,5,8,2
SAN LUIS POTOSÍ,24,SAN LUIS POTOSÍ,028,LA CANTERA,1,6,4,2,1
SAN LUIS POTOSÍ,24,SAN LUIS POTOSÍ,028,LA ENCINA,2,6,3,3,1
SAN LUIS POTOSÍ,24,SAN LUIS POTOSÍ,028,LA HUARACHA,2,19,9,10,2
SAN LUIS POTOSÍ,24,SAN LUIS POTOSÍ,028,LA MANTA,3,182,86,96,9
SAN LUIS POTOSÍ,24,SAN LUIS POTOSÍ,028,LA MANTEQUILLA,4,158,83,75,10
SAN LUIS POTOSÍ,24,SAN LUIS POTOSÍ,028,LA MELADA,3,180,99,81,10
SAN LUIS POTOSÍ,24,SAN LUIS POTOSÍ,028,LA MORITA,2,13,5,8,1
SAN LUIS POTOSÍ,24,SAN LUIS POTOSÍ,028,LA PILA,6,2384,1169,1215,105
SAN LUIS POTOSÍ,24,SAN LUIS POTOSÍ,028,LAGUNA DE SANTA RITA,3,992,485,507,37
SAN LUIS POTOSÍ,24,SAN LUIS POTOSÍ,028,LAS CUIJAS (CHAUTE),3,93,44,49,5
SAN LUIS POTOSÍ,24,SAN LUIS POTOSÍ,028,LAS ESCOBAS,3,17,7,10,3
SAN LUIS POTOSÍ,24,SAN LUIS POTOSÍ,028,LAS JARRILLAS,3,78,37,41,4
SAN LUIS POTOSÍ,24,SAN LUIS POTOSÍ,028,LAS MANGUITAS,3,36,14,22,3
SAN LUIS POTOSÍ,24,SAN LUIS POTOSÍ,028,LECHUGUILLAS,1,10,3,7,1
SAN LUIS POTOSÍ,24,SAN LUIS POTOSÍ,028,LOMA PRIETA,3,120,56,64,7
SAN LUIS POTOSÍ,24,SAN LUIS POTOSÍ,028,LOS GARCÍA,2,134,63,71,7
SAN LUIS POTOSÍ,24,SAN LUIS POTOSÍ,028,LOS GÓMEZ,2,254,115,139,14
SAN LUIS POTOSÍ,24,SAN LUIS POTOSÍ,028,MACARENOS,2,15,7,8,2
SAN LUIS POTOSÍ,24,SAN LUIS POTOSÍ,028,MESA DE LOS CONEJOS,3,356,153,203,21
SAN LUIS POTOSÍ,24,SAN LUIS POTOSÍ,028,MEZQUITAL,2,607,312,295,26
SAN LUIS POTOSÍ,24,SAN LUIS POTOSÍ,028,PALMAR DE LAS FLORES (EL POZO SEIS),2,15,5,10,1
SAN LUIS POTOSÍ,24,SAN LUIS POTOSÍ,028,PALMERAS,2,5,5,0,1
SAN LUIS POTOSÍ,24,SAN LUIS POTOSÍ,028,PANALILLO,3,155,83,72,9
SAN LUIS POTOSÍ,24,SAN LUIS POTOSÍ,028,PEÑASCO,4,399,196,203,24
SAN LUIS POTOSÍ,24,SAN LUIS POTOSÍ,028,POZUELOS,3,265,128,137,13
SAN LUIS POTOSÍ,24,SAN LUIS POTOSÍ,028,RANCHO CAÑÓN DEL SAUZ,2,13,7,6,2
SAN LUIS POTOSÍ,24,SAN LUIS POTOSÍ,028,RANCHO LAS FLORES,3,26,13,13,5
SAN LUIS POTOSÍ,24,SAN LUIS POTOSÍ,028,RINCONADA,3,278,128,150,14
SAN LUIS POTOSÍ,24,SAN LUIS POTOSÍ,028,SAN JOSÉ DE BUENAVISTA,1,18,11,7,1
SAN LUIS POTOSÍ,24,SAN LUIS POTOSÍ,028,SAN JUANICO CHICO,2,53,21,32,3
SAN LUIS POTOSÍ,24,SAN LUIS POTOSÍ,028,SAN JUANICO EL GRANDE,2,34,18,16,3
SAN LUIS POTOSÍ,24,SAN LUIS POTOSÍ,028,SAN LUIS POTOSÍ,1109,242932,123681,119251,17445
SAN LUIS POTOSÍ,24,SAN LUIS POTOSÍ,028,SAN RAFAEL NÚMERO DOS,2,15,8,7,3
SAN LUIS POTOSÍ,24,SAN LUIS POTOSÍ,028,SAN RAFAEL UNO (EL CAÑÓN),1,16,7,9,2
SAN LUIS POTOSÍ,24,SAN LUIS POTOSÍ,028,SAN SEBASTIÁN,1,7,2,5,1
SAN LUIS POTOSÍ,24,SAN LUIS POTOSÍ,028,SANTO DOMINGO,2,14,7,7,1
SAN LUIS POTOSÍ,24,SAN LUIS POTOSÍ,028,TANQUE CIENEGUITA,3,23,8,15,3
SAN LUIS POTOSÍ,24,SAN LUIS POTOSÍ,028,TANQUE DE LA CRUZ,2,60,27,33,4
SAN LUIS POTOSÍ,24,SAN LUIS POTOSÍ,028,TANQUE EL JAGÜEY,1,519,243,276,29
SAN LUIS POTOSÍ,24,SAN LUIS POTOSÍ,028,TANQUE URESTI,2,27,13,14,2
SAN LUIS POTOSÍ,24,SAN LUIS POTOSÍ,028,TANQUECITO DE MENDOZA,4,62,28,34,8
SAN LUIS POTOSÍ,24,SAN LUIS POTOSÍ,028,TERRERO NORTE,3,18,12,6,3
SAN LUIS POTOSÍ,24,SAN LUIS POTOSÍ,028,TERRONCITOS (LOS CONTRERAS),1,4,2,2,1
SAN LUIS POTOSÍ,24,SAN LUIS POTOSÍ,028,TERRONES (SANGRE DE CRISTO),1,10,6,4,1
SAN LUIS POTOSÍ,24,SAN LUIS POTOSÍ,028,UNIDAD BENITO JUÁREZ (LA CHORA),1,6,2,4,1
SAN LUIS POTOSÍ,24,SAN LUIS POTOSÍ,028,YERBABUENA,3,35,17,18,4
SAN LUIS POTOSÍ,24,SAN LUIS POTOSÍ,028,ZAMORILLA,2,49,19,30,3
SAN LUIS POTOSÍ,24,SAN MARTÍN CHALCHICUAUTLA,029,ACATITLA,2,10,8,2,2
SAN LUIS POTOSÍ,24,SAN MARTÍN CHALCHICUAUTLA,029,ACAYO,3,58,30,28,5
SAN LUIS POTOSÍ,24,SAN MARTÍN CHALCHICUAUTLA,029,AGUACATE SEGUNDO (ANEXO AL CARRIZO),1,8,5,3,1
SAN LUIS POTOSÍ,24,SAN MARTÍN CHALCHICUAUTLA,029,AGUAMOLO,4,95,46,49,7
SAN LUIS POTOSÍ,24,SAN MARTÍN CHALCHICUAUTLA,029,APAXTIANTLA (APAXTIANTLÁN),2,7,3,4,1
SAN LUIS POTOSÍ,24,SAN MARTÍN CHALCHICUAUTLA,029,BARRANQUILLAS (TEPETZINTLA),3,63,28,35,7
SAN LUIS POTOSÍ,24,SAN MARTÍN CHALCHICUAUTLA,029,BARRIO LA CRUZ,2,32,15,17,2
SAN LUIS POTOSÍ,24,SAN MARTÍN CHALCHICUAUTLA,029,BUENAVISTA (PALMAR ALTO),3,62,38,24,5
SAN LUIS POTOSÍ,24,SAN MARTÍN CHALCHICUAUTLA,029,CERRO (CERRO DE LA CRUZ),3,53,18,35,5
SAN LUIS POTOSÍ,24,SAN MARTÍN CHALCHICUAUTLA,029,CHACHATIPA,2,29,18,11,3
SAN LUIS POTOSÍ,24,SAN MARTÍN CHALCHICUAUTLA,029,COAMIXCO,1,7,4,3,1
SAN LUIS POTOSÍ,24,SAN MARTÍN CHALCHICUAUTLA,029,DOMINGO ZAPOYO,4,92,40,52,7
SAN LUIS POTOSÍ,24,SAN MARTÍN CHALCHICUAUTLA,029,EJIDO DOMINGO,1,4,1,3,1
SAN LUIS POTOSÍ,24,SAN MARTÍN CHALCHICUAUTLA,029,EJIDO LA PUERTA,3,34,20,14,4
SAN LUIS POTOSÍ,24,SAN MARTÍN CHALCHICUAUTLA,029,EL CARRIZO,3,96,38,58,9
SAN LUIS POTOSÍ,24,SAN MARTÍN CHALCHICUAUTLA,029,EL FRIJOLILLO,3,27,11,16,5
SAN LUIS POTOSÍ,24,SAN MARTÍN CHALCHICUAUTLA,029,EL HIGUITO,2,19,5,14,2
SAN LUIS POTOSÍ,24,SAN MARTÍN CHALCHICUAUTLA,029,EL HUAYAL,4,276,116,160,20
SAN LUIS POTOSÍ,24,SAN MARTÍN CHALCHICUAUTLA,029,EL JOBO,2,9,0,9,1
SAN LUIS POTOSÍ,24,SAN MARTÍN CHALCHICUAUTLA,029,EL PEMUCHE VIEJO,4,79,32,47,7
SAN LUIS POTOSÍ,24,SAN MARTÍN CHALCHICUAUTLA,029,EL POTRERO,3,70,35,35,7
SAN LUIS POTOSÍ,24,SAN MARTÍN CHALCHICUAUTLA,029,EL RODEO DE LA CRUZ,1,5,3,2,1
SAN LUIS POTOSÍ,24,SAN MARTÍN CHALCHICUAUTLA,029,EL SACRIFICIO,2,21,12,9,2
SAN LUIS POTOSÍ,24,SAN MARTÍN CHALCHICUAUTLA,029,ESCUATITLA,5,185,84,101,17
SAN LUIS POTOSÍ,24,SAN MARTÍN CHALCHICUAUTLA,029,IXPATLACH,1,9,6,3,1
SAN LUIS POTOSÍ,24,SAN MARTÍN CHALCHICUAUTLA,029,LA ESPERANZA,3,84,47,37,5
SAN LUIS POTOSÍ,24,SAN MARTÍN CHALCHICUAUTLA,029,LA LABOR,1,35,11,24,2
SAN LUIS POTOSÍ,24,SAN MARTÍN CHALCHICUAUTLA,029,LA MESA DEL TORO,4,72,31,41,7
SAN LUIS POTOSÍ,24,SAN MARTÍN CHALCHICUAUTLA,029,LA PEÑUELA,2,7,6,1,1
SAN LUIS POTOSÍ,24,SAN MARTÍN CHALCHICUAUTLA,029,LA PIMIENTA,4,69,35,34,6
SAN LUIS POTOSÍ,24,SAN MARTÍN CHALCHICUAUTLA,029,LA SOLEDAD,4,74,31,43,7
SAN LUIS POTOSÍ,24,SAN MARTÍN CHALCHICUAUTLA,029,LALAXO,3,35,23,12,4
SAN LUIS POTOSÍ,24,SAN MARTÍN CHALCHICUAUTLA,029,LAS ACAMAYAS,2,15,7,8,2
SAN LUIS POTOSÍ,24,SAN MARTÍN CHALCHICUAUTLA,029,LLANO GRANDE,2,7,1,6,2
SAN LUIS POTOSÍ,24,SAN MARTÍN CHALCHICUAUTLA,029,LOS BORDONES,3,33,15,18,4
SAN LUIS POTOSÍ,24,SAN MARTÍN CHALCHICUAUTLA,029,MANCHOC,3,131,63,68,10
SAN LUIS POTOSÍ,24,SAN MARTÍN CHALCHICUAUTLA,029,MATLAPITA,1,14,9,5,1
SAN LUIS POTOSÍ,24,SAN MARTÍN CHALCHICUAUTLA,029,MESA DE SAN ISIDRO,2,13,3,10,2
SAN LUIS POTOSÍ,24,SAN MARTÍN CHALCHICUAUTLA,029,MESA DEL FLOJO,2,24,11,13,2
SAN LUIS POTOSÍ,24,SAN MARTÍN CHALCHICUAUTLA,029,MESA DEL MACHO,1,8,4,4,1
SAN LUIS POTOSÍ,24,SAN MARTÍN CHALCHICUAUTLA,029,OCTLAMECAYO,4,96,48,48,9
SAN LUIS POTOSÍ,24,SAN MARTÍN CHALCHICUAUTLA,029,OCUILTZAPOYO,5,245,103,142,22
SAN LUIS POTOSÍ,24,SAN MARTÍN CHALCHICUAUTLA,029,PIEDRA PARADA,2,11,1,10,2
SAN LUIS POTOSÍ,24,SAN MARTÍN CHALCHICUAUTLA,029,PITAGIO,3,82,32,50,6
SAN LUIS POTOSÍ,24,SAN MARTÍN CHALCHICUAUTLA,029,POZA REDONDA,2,32,20,12,2
SAN LUIS POTOSÍ,24,SAN MARTÍN CHALCHICUAUTLA,029,RANCHO NUEVO,7,59,27,32,10
SAN LUIS POTOSÍ,24,SAN MARTÍN CHALCHICUAUTLA,029,SABINITO,2,9,5,4,1
SAN LUIS POTOSÍ,24,SAN MARTÍN CHALCHICUAUTLA,029,SAN JOSÉ DE LAS ADJUNTAS,3,29,14,15,3
SAN LUIS POTOSÍ,24,SAN MARTÍN CHALCHICUAUTLA,029,SAN LUISITO,2,56,22,34,4
SAN LUIS POTOSÍ,24,SAN MARTÍN CHALCHICUAUTLA,029,SAN MARTÍN CHALCHICUAUTLA,7,1046,533,513,51
SAN LUIS POTOSÍ,24,SAN MARTÍN CHALCHICUAUTLA,029,TAXICHO,3,45,21,24,4
SAN LUIS POTOSÍ,24,SAN MARTÍN CHALCHICUAUTLA,029,TEMPEXQUITITLA,5,173,85,88,12
SAN LUIS POTOSÍ,24,SAN MARTÍN CHALCHICUAUTLA,029,TENEXAMEL,2,19,9,10,2
SAN LUIS POTOSÍ,24,SAN MARTÍN CHALCHICUAUTLA,029,TEPEMICHE,4,58,24,34,8
SAN LUIS POTOSÍ,24,SAN MARTÍN CHALCHICUAUTLA,029,TEPETATE (RANCHO NUEVO),2,22,12,10,2
SAN LUIS POTOSÍ,24,SAN MARTÍN CHALCHICUAUTLA,029,TOTOLTEO,3,71,36,35,7
SAN LUIS POTOSÍ,24,SAN NICOLÁS TOLENTINO,030,BARRANCA DE SAN JOAQUÍN,2,5,1,4,1
SAN LUIS POTOSÍ,24,SAN NICOLÁS TOLENTINO,030,CAÑAS,2,8,4,4,3
SAN LUIS POTOSÍ,24,SAN NICOLÁS TOLENTINO,030,CARRIZAL DE GUADALUPE,1,4,1,3,1
SAN LUIS POTOSÍ,24,SAN NICOLÁS TOLENTINO,030,EL PINAL,2,3,1,2,1
SAN LUIS POTOSÍ,24,SAN NICOLÁS TOLENTINO,030,FRACCIÓN OCAMPO,4,76,36,40,8
SAN LUIS POTOSÍ,24,SAN NICOLÁS TOLENTINO,030,IGNACIO ALLENDE,3,39,18,21,3
SAN LUIS POTOSÍ,24,SAN NICOLÁS TOLENTINO,030,JAGÜEY DE SAN FRANCISCO,2,4,1,3,1
SAN LUIS POTOSÍ,24,SAN NICOLÁS TOLENTINO,030,LAGUNA DE SANTO DOMINGO,3,61,29,32,4
SAN LUIS POTOSÍ,24,SAN NICOLÁS TOLENTINO,030,LAS GOLONDRINAS,2,5,1,4,1
SAN LUIS POTOSÍ,24,SAN NICOLÁS TOLENTINO,030,LOS NOGALES (NOGALES DE SANTA CRUZ),3,9,7,2,3
SAN LUIS POTOSÍ,24,SAN NICOLÁS TOLENTINO,030,MORENOS,3,54,24,30,4
SAN LUIS POTOSÍ,24,SAN NICOLÁS TOLENTINO,030,OJO DE AGUA,3,77,38,39,5
SAN LUIS POTOSÍ,24,SAN NICOLÁS TOLENTINO,030,POTRERO DE SANTA GERTRUDIS,2,6,2,4,1
SAN LUIS POTOSÍ,24,SAN NICOLÁS TOLENTINO,030,PUERTO DE LA DESCUBRIDORA,3,13,8,5,3
SAN LUIS POTOSÍ,24,SAN NICOLÁS TOLENTINO,030,SAN JOSÉ DE NOGALITOS,2,8,3,5,2
SAN LUIS POTOSÍ,24,SAN NICOLÁS TOLENTINO,030,SAN MARTÍN DE ABAJO,3,55,32,23,4
SAN LUIS POTOSÍ,24,SAN NICOLÁS TOLENTINO,030,SAN NICOLÁS TOLENTINO,4,233,121,112,16
SAN LUIS POTOSÍ,24,SAN NICOLÁS TOLENTINO,030,SANTA CATARINA,4,444,223,221,23
SAN LUIS POTOSÍ,24,SANTA CATARINA,031,AGUA AMARGA,3,25,14,11,3
SAN LUIS POTOSÍ,24,SANTA CATARINA,031,AGUA NUEVA,2,15,6,9,2
SAN LUIS POTOSÍ,24,SANTA CATARINA,031,ANTEOJOS,3,28,16,12,3
SAN LUIS POTOSÍ,24,SANTA CATARINA,031,CABALLOS,2,5,1,4,1
SAN LUIS POTOSÍ,24,SANTA CATARINA,031,CALABAZAS (SAN FRANCISCO DEL SAUCE),3,56,31,25,4
SAN LUIS POTOSÍ,24,SANTA CATARINA,031,CARRIZAL GRANDE,2,21,13,8,2
SAN LUIS POTOSÍ,24,SANTA CATARINA,031,CHACUALA,4,51,23,28,4
SAN LUIS POTOSÍ,24,SANTA CATARINA,031,EL AGARROSO,3,16,11,5,3
SAN LUIS POTOSÍ,24,SANTA CATARINA,031,EL COCO,4,127,72,55,8
SAN LUIS POTOSÍ,24,SANTA CATARINA,031,EL HUIZACHE (LAS JARITAS),2,14,8,6,2
SAN LUIS POTOSÍ,24,SANTA CATARINA,031,EL MEZQUITAL,4,85,36,49,5
SAN LUIS POTOSÍ,24,SANTA CATARINA,031,EL PEDREGOSO,2,8,4,4,1
SAN LUIS POTOSÍ,24,SANTA CATARINA,031,EL PUENTE (EJIDO GUAYABOS),6,158,76,82,14
SAN LUIS POTOSÍ,24,SANTA CATARINA,031,EL SAUCILLO,3,15,5,10,3
SAN LUIS POTOSÍ,24,SANTA CATARINA,031,FRIJOLARES,3,26,13,13,3
SAN LUIS POTOSÍ,24,SANTA CATARINA,031,JOYA DEL GAVILÁN,3,31,16,15,3
SAN LUIS POTOSÍ,24,SANTA CATARINA,031,JOYA DEL GUAYABO,2,15,5,10,2
SAN LUIS POTOSÍ,24,SANTA CATARINA,031,LA AHORCADA,2,11,9,2,1
SAN LUIS POTOSÍ,24,SANTA CATARINA,031,LA BARRANCA,4,139,73,66,9
SAN LUIS POTOSÍ,24,SANTA CATARINA,031,LA CERCADA,2,17,5,12,2
SAN LUIS POTOSÍ,24,SANTA CATARINA,031,LA COMPUERTA,4,96,50,46,6
SAN LUIS POTOSÍ,24,SANTA CATARINA,031,LA CUCHILLA,4,160,84,76,9
SAN LUIS POTOSÍ,24,SANTA CATARINA,031,LA ENCANTADA,4,197,101,96,14
SAN LUIS POTOSÍ,24,SANTA CATARINA,031,LA PARADA,4,278,143,135,16
SAN LUIS POTOSÍ,24,SANTA CATARINA,031,LAS JOYAS,1,13,7,6,1
SAN LUIS POTOSÍ,24,SANTA CATARINA,031,LAS LAGUNITAS,5,219,114,105,15
SAN LUIS POTOSÍ,24,SANTA CATARINA,031,LAS MORAS,2,6,3,3,1
SAN LUIS POTOSÍ,24,SANTA CATARINA,031,LIMÓN DE LA PEÑA,4,139,65,74,8
SAN LUIS POTOSÍ,24,SANTA CATARINA,031,LOS CUICILLOS,2,6,4,2,1
SAN LUIS POTOSÍ,24,SANTA CATARINA,031,LOS POCITOS,2,13,5,8,2
SAN LUIS POTOSÍ,24,SANTA CATARINA,031,MESA DEL JUNCO,3,45,21,24,4
SAN LUIS POTOSÍ,24,SANTA CATARINA,031,MILPAS VIEJAS,3,20,14,6,3
SAN LUIS POTOSÍ,24,SANTA CATARINA,031,PALO RAJADO,2,9,3,6,1
SAN LUIS POTOSÍ,24,SANTA CATARINA,031,PASO DE BOTELLO,3,54,31,23,4
SAN LUIS POTOSÍ,24,SANTA CATARINA,031,PLAN DE SANTO DOMINGO,2,5,3,2,1
SAN LUIS POTOSÍ,24,SANTA CATARINA,031,PUERTA DEL SALTO,3,24,11,13,2
SAN LUIS POTOSÍ,24,SANTA CATARINA,031,PUERTO LA CRUZ,1,4,1,3,1
SAN LUIS POTOSÍ,24,SANTA CATARINA,031,SAN ANTONIO DE LOS GUAYABOS,2,34,18,16,2
SAN LUIS POTOSÍ,24,SANTA CATARINA,031,SAN DIEGO (PUEBLO VIEJO),4,238,120,118,16
SAN LUIS POTOSÍ,24,SANTA CATARINA,031,SAN JOSÉ,3,108,58,50,5
SAN LUIS POTOSÍ,24,SANTA CATARINA,031,SAN JOSÉ DE ARRIBA,3,22,11,11,3
SAN LUIS POTOSÍ,24,SANTA CATARINA,031,SAN NICOLÁS DE TAMPOTE,3,20,8,12,3
SAN LUIS POTOSÍ,24,SANTA CATARINA,031,SAN PEDRO,2,65,30,35,3
SAN LUIS POTOSÍ,24,SANTA CATARINA,031,SANTA CATARINA,2,37,18,19,2
SAN LUIS POTOSÍ,24,SANTA CATARINA,031,SANTA MARÍA ACAPULCO,4,246,115,131,17
SAN LUIS POTOSÍ,24,SANTA CATARINA,031,SANTA TERESA,2,18,7,11,2
SAN LUIS POTOSÍ,24,SANTA CATARINA,031,TANLACUT (LABOR ZAPATA),3,142,63,79,11
SAN LUIS POTOSÍ,24,SANTA CATARINA,031,TANLACUT (PUEBLO DE TANLACUT),3,54,24,30,5
SAN LUIS POTOSÍ,24,SANTA CATARINA,031,TANLÚ,4,104,45,59,7
SAN LUIS POTOSÍ,24,SANTA CATARINA,031,TORTUGAS,2,11,6,5,1
SAN LUIS POTOSÍ,24,SANTA MARÍA DEL RÍO,032,ADJUNTAS DOS,1,12,8,4,1
SAN LUIS POTOSÍ,24,SANTA MARÍA DEL RÍO,032,AGOSTADERO DE SANTA BÁRBARA,3,29,15,14,3
SAN LUIS POTOSÍ,24,SANTA MARÍA DEL RÍO,032,BARRANCA,2,81,44,37,4
SAN LUIS POTOSÍ,24,SANTA MARÍA DEL RÍO,032,BARRANCAS DEL PUEBLITO (CUESTA COLORADA),2,26,12,14,2
SAN LUIS POTOSÍ,24,SANTA MARÍA DEL RÍO,032,BERNALEJO,4,287,134,153,18
SAN LUIS POTOSÍ,24,SANTA MARÍA DEL RÍO,032,CAÑADA DE YÁÑEZ,5,201,92,109,12
SAN LUIS POTOSÍ,24,SANTA MARÍA DEL RÍO,032,CAÑADA DEL CACAO,2,7,3,4,1
SAN LUIS POTOSÍ,24,SANTA MARÍA DEL RÍO,032,CERRITO DE VARAS BLANCAS,3,34,19,15,3
SAN LUIS POTOSÍ,24,SANTA MARÍA DEL RÍO,032,CERRO PRIETO,2,33,16,17,3
SAN LUIS POTOSÍ,24,SANTA MARÍA DEL RÍO,032,CHIQUEROS DEL SAUCITO,2,8,6,2,1
SAN LUIS POTOSÍ,24,SANTA MARÍA DEL RÍO,032,EJIDO LA PITAHAYA (SANTO DOMINGO),4,554,262,292,30
SAN LUIS POTOSÍ,24,SANTA MARÍA DEL RÍO,032,EL ÁLAMO,2,52,26,26,4
SAN LUIS POTOSÍ,24,SANTA MARÍA DEL RÍO,032,EL CARMEN,3,57,20,37,5
SAN LUIS POTOSÍ,24,SANTA MARÍA DEL RÍO,032,EL CERRITO,3,237,119,118,12
SAN LUIS POTOSÍ,24,SANTA MARÍA DEL RÍO,032,EL FUERTE,4,442,220,222,32
SAN LUIS POTOSÍ,24,SANTA MARÍA DEL RÍO,032,EL GUARICHO,2,9,6,3,2
SAN LUIS POTOSÍ,24,SANTA MARÍA DEL RÍO,032,EL HUIZACHE,2,24,9,15,2
SAN LUIS POTOSÍ,24,SANTA MARÍA DEL RÍO,032,EL MOLINO CINCO SEÑORES,2,29,13,16,2
SAN LUIS POTOSÍ,24,SANTA MARÍA DEL RÍO,032,EL ORGANITO,2,19,10,9,2
SAN LUIS POTOSÍ,24,SANTA MARÍA DEL RÍO,032,EL PUEBLITO,2,54,32,22,4
SAN LUIS POTOSÍ,24,SANTA MARÍA DEL RÍO,032,EL QUEMADO,2,9,3,6,1
SAN LUIS POTOSÍ,24,SANTA MARÍA DEL RÍO,032,EL SOYATE,3,102,48,54,5
SAN LUIS POTOSÍ,24,SANTA MARÍA DEL RÍO,032,EL TEPOZÁN,3,197,89,108,8
SAN LUIS POTOSÍ,24,SANTA MARÍA DEL RÍO,032,EL TULE,3,88,35,53,5
SAN LUIS POTOSÍ,24,SANTA MARÍA DEL RÍO,032,ENRAMADAS,3,376,194,182,22
SAN LUIS POTOSÍ,24,SANTA MARÍA DEL RÍO,032,ESCALERILLAS,2,27,10,17,2
SAN LUIS POTOSÍ,24,SANTA MARÍA DEL RÍO,032,ESTANCIA DE ATOTONILCO,3,134,63,71,8
SAN LUIS POTOSÍ,24,SANTA MARÍA DEL RÍO,032,FRACCIÓN EL TORO,3,248,124,124,13
SAN LUIS POTOSÍ,24,SANTA MARÍA DEL RÍO,032,FRACCIÓN SÁNCHEZ,3,141,69,72,9
SAN LUIS POTOSÍ,24,SANTA MARÍA DEL RÍO,032,FRACCIÓN UNO EX-HACIENDA SANTO DOMINGO,1,11,4,7,1
SAN LUIS POTOSÍ,24,SANTA MARÍA DEL RÍO,032,GUANAJUATITO (CERRITO DE LA CRUZ),2,140,67,73,8
SAN LUIS POTOSÍ,24,SANTA MARÍA DEL RÍO,032,LA CAJA,2,14,4,10,2
SAN LUIS POTOSÍ,24,SANTA MARÍA DEL RÍO,032,LA CARDONA,3,200,106,94,11
SAN LUIS POTOSÍ,24,SANTA MARÍA DEL RÍO,032,LA CATEDRAL,1,13,4,9,1
SAN LUIS POTOSÍ,24,SANTA MARÍA DEL RÍO,032,LA LABOR DEL RÍO (HACIENDA LA LABOR DEL RÍO),3,61,25,36,3
SAN LUIS POTOSÍ,24,SANTA MARÍA DEL RÍO,032,LA ORDEÑA,1,2,0,2,1
SAN LUIS POTOSÍ,24,SANTA MARÍA DEL RÍO,032,LA SIRENA,2,5,2,3,2
SAN LUIS POTOSÍ,24,SANTA MARÍA DEL RÍO,032,LA YERBABUENA,3,275,135,140,13
SAN LUIS POTOSÍ,24,SANTA MARÍA DEL RÍO,032,LABOR DE BAGRES,2,40,18,22,3
SAN LUIS POTOSÍ,24,SANTA MARÍA DEL RÍO,032,LABORCILLA,2,17,8,9,3
SAN LUIS POTOSÍ,24,SANTA MARÍA DEL RÍO,032,LAS ADJUNTAS,1,8,2,6,1
SAN LUIS POTOSÍ,24,SANTA MARÍA DEL RÍO,032,LAS PACHONAS,2,8,2,6,1
SAN LUIS POTOSÍ,24,SANTA MARÍA DEL RÍO,032,LLANO DE GUADALUPE,2,41,19,22,3
SAN LUIS POTOSÍ,24,SANTA MARÍA DEL RÍO,032,LOS CUARTOS,2,27,16,11,2
SAN LUIS POTOSÍ,24,SANTA MARÍA DEL RÍO,032,OJO CALIENTE,5,533,258,275,34
SAN LUIS POTOSÍ,24,SANTA MARÍA DEL RÍO,032,OJO DE AGUA DE LAS FLORES,3,50,24,26,4
SAN LUIS POTOSÍ,24,SANTA MARÍA DEL RÍO,032,PALMARITO,3,39,18,21,3
SAN LUIS POTOSÍ,24,SANTA MARÍA DEL RÍO,032,PASO DE LOS TORRES,3,29,17,12,3
SAN LUIS POTOSÍ,24,SANTA MARÍA DEL RÍO,032,PEREGRINA DE ABAJO,3,123,59,64,6
SAN LUIS POTOSÍ,24,SANTA MARÍA DEL RÍO,032,PEREGRINA DE ARRIBA,2,15,8,7,2
SAN LUIS POTOSÍ,24,SANTA MARÍA DEL RÍO,032,PRESA DE DOLORES,3,366,175,191,18
SAN LUIS POTOSÍ,24,SANTA MARÍA DEL RÍO,032,PUERTA DE LOS TRONCONES,4,119,65,54,6
SAN LUIS POTOSÍ,24,SANTA MARÍA DEL RÍO,032,PUERTO DE VICTORIA,2,8,5,3,1
SAN LUIS POTOSÍ,24,SANTA MARÍA DEL RÍO,032,RANCHO DE MILPILLAS,3,18,9,9,3
SAN LUIS POTOSÍ,24,SANTA MARÍA DEL RÍO,032,ROSA DE CASTILLA,3,17,11,6,2
SAN LUIS POTOSÍ,24,SANTA MARÍA DEL RÍO,032,SAN ISIDRO DE BAGRES,2,9,2,7,1
SAN LUIS POTOSÍ,24,SANTA MARÍA DEL RÍO,032,SAN JOSÉ ALBURQUERQUE,3,40,21,19,3
SAN LUIS POTOSÍ,24,SANTA MARÍA DEL RÍO,032,SAN JUAN CAPISTRÁN,2,65,33,32,4
SAN LUIS POTOSÍ,24,SANTA MARÍA DEL RÍO,032,SANTA LUCÍA,2,35,13,22,2
SAN LUIS POTOSÍ,24,SANTA MARÍA DEL RÍO,032,SANTA MARÍA DEL RÍO,23,4793,2514,2279,314
SAN LUIS POTOSÍ,24,SANTA MARÍA DEL RÍO,032,SOLEDAD DE LAS FLORES,3,9,2,7,2
SAN LUIS POTOSÍ,24,SANTA MARÍA DEL RÍO,032,TIERRA QUEMADA,2,23,16,7,2
SAN LUIS POTOSÍ,24,SANTA MARÍA DEL RÍO,032,TORTUGAS,2,5,3,2,1
SAN LUIS POTOSÍ,24,SANTA MARÍA DEL RÍO,032,TORTUGAS DE ARRIBA,2,8,4,4,1
SAN LUIS POTOSÍ,24,SANTA MARÍA DEL RÍO,032,VALLECITO DE LA CRUZ,2,5,5,0,2
SAN LUIS POTOSÍ,24,SANTA MARÍA DEL RÍO,032,VILLELA,3,238,122,116,11
SAN LUIS POTOSÍ,24,SANTO DOMINGO,033,BAJÍO DEL CIRIACO,3,50,20,30,4
SAN LUIS POTOSÍ,24,SANTO DOMINGO,033,CERRITOS DE BERNAL,3,45,18,27,3
SAN LUIS POTOSÍ,24,SANTO DOMINGO,033,CONGREGACIÓN DE SANTO DOMINGO,3,27,11,16,3
SAN LUIS POTOSÍ,24,SANTO DOMINGO,033,EL ARENAL,3,38,21,17,3
SAN LUIS POTOSÍ,24,SANTO DOMINGO,033,EL SABINO,3,87,45,42,5
SAN LUIS POTOSÍ,24,SANTO DOMINGO,033,EL TEPETATE,3,26,15,11,3
SAN LUIS POTOSÍ,24,SANTO DOMINGO,033,GÁMEZ,1,17,12,5,1
SAN LUIS POTOSÍ,24,SANTO DOMINGO,033,ILLESCAS,4,573,299,274,29
SAN LUIS POTOSÍ,24,SANTO DOMINGO,033,JESÚS MARÍA,3,404,208,196,21
SAN LUIS POTOSÍ,24,SANTO DOMINGO,033,JUAN SARABIA (CENTRO OVINO),3,43,23,20,4
SAN LUIS POTOSÍ,24,SANTO DOMINGO,033,LA VENTURA (EL GRULLO),2,13,7,6,2
SAN LUIS POTOSÍ,24,SANTO DOMINGO,033,LA VICTORIA,3,55,30,25,4
SAN LUIS POTOSÍ,24,SANTO DOMINGO,033,LA YERBABUENA,2,6,3,3,1
SAN LUIS POTOSÍ,24,SANTO DOMINGO,033,MORELOS,2,9,3,6,2
SAN LUIS POTOSÍ,24,SANTO DOMINGO,033,PROVIDENCIA,3,144,74,70,8
SAN LUIS POTOSÍ,24,SANTO DOMINGO,033,SAN ANTONIO DE LOS GARZA,1,5,5,0,1
SAN LUIS POTOSÍ,24,SANTO DOMINGO,033,SAN ANTONIO DEL MEZQUITE,3,53,28,25,3
SAN LUIS POTOSÍ,24,SANTO DOMINGO,033,SAN FRANCISCO,3,41,18,23,4
SAN LUIS POTOSÍ,24,SANTO DOMINGO,033,SAN JOSÉ CALIHUEY,3,49,25,24,4
SAN LUIS POTOSÍ,24,SANTO DOMINGO,033,SAN JUAN DEL SALADO,3,49,25,24,4
SAN LUIS POTOSÍ,24,SANTO DOMINGO,033,SAN MATÍAS,1,4,2,2,1
SAN LUIS POTOSÍ,24,SANTO DOMINGO,033,SAN VICENTE BANDERILLAS,3,63,32,31,4
SAN LUIS POTOSÍ,24,SANTO DOMINGO,033,SANTA CLARA,3,86,41,45,4
SAN LUIS POTOSÍ,24,SANTO DOMINGO,033,SANTA EFIGENIA,2,9,5,4,2
SAN LUIS POTOSÍ,24,SANTO DOMINGO,033,SANTA MATILDE,3,113,57,56,6
SAN LUIS POTOSÍ,24,SANTO DOMINGO,033,SANTO DOMINGO,4,265,142,123,22
SAN LUIS POTOSÍ,24,SANTO DOMINGO,033,SOCORRO DE DIOS,3,55,29,26,4
SAN LUIS POTOSÍ,24,SANTO DOMINGO,033,ZANCARRÓN,3,94,35,59,7
SAN LUIS POTOSÍ,24,SANTO DOMINGO,033,ZARAGOZA (POZO SALADO),3,85,36,49,5
SAN LUIS POTOSÍ,24,SAN VICENTE TANCUAYALAB,034,EL ÁLAMO,3,103,53,50,6
SAN LUIS POTOSÍ,24,SAN VICENTE TANCUAYALAB,034,EL CHOTE,3,41,25,16,4
SAN LUIS POTOSÍ,24,SAN VICENTE TANCUAYALAB,034,EL CIRUELAR,1,130,53,77,9
SAN LUIS POTOSÍ,24,SAN VICENTE TANCUAYALAB,034,EL SASUB,2,45,20,25,3
SAN LUIS POTOSÍ,24,SAN VICENTE TANCUAYALAB,034,EL TRÉBOL,2,296,140,156,12
SAN LUIS POTOSÍ,24,SAN VICENTE TANCUAYALAB,034,FLORES MAGÓN,2,25,13,12,3
SAN LUIS POTOSÍ,24,SAN VICENTE TANCUAYALAB,034,FRANCISCO VILLA,3,103,50,53,7
SAN LUIS POTOSÍ,24,SAN VICENTE TANCUAYALAB,034,GENERAL LEÓN MARTÍNEZ MHD,1,22,11,11,1
SAN LUIS POTOSÍ,24,SAN VICENTE TANCUAYALAB,034,LÁZARO CÁRDENAS,3,71,27,44,5
SAN LUIS POTOSÍ,24,SAN VICENTE TANCUAYALAB,034,NARCISO MENDOZA,1,6,3,3,1
SAN LUIS POTOSÍ,24,SAN VICENTE TANCUAYALAB,034,NUEVO JOMTÉ (NUEVO MAY),4,385,175,210,26
SAN LUIS POTOSÍ,24,SAN VICENTE TANCUAYALAB,034,SAGRADA FAMILIA,2,8,6,2,1
SAN LUIS POTOSÍ,24,SAN VICENTE TANCUAYALAB,034,SAN FRANCISCO CUAYALAB,5,568,287,281,28
SAN LUIS POTOSÍ,24,SAN VICENTE TANCUAYALAB,034,SAN JUAN DE LAS VEGAS DOS FRACCIÓN TANCOJOL,3,45,27,18,3
SAN LUIS POTOSÍ,24,SAN VICENTE TANCUAYALAB,034,SAN JUAN VIEJO,2,56,31,25,4
SAN LUIS POTOSÍ,24,SAN VICENTE TANCUAYALAB,034,SAN VICENTE TANCUAYALAB,10,1482,763,719,102
SAN LUIS POTOSÍ,24,SAN VICENTE TANCUAYALAB,034,TANCOJOL,3,95,48,47,5
SAN LUIS POTOSÍ,24,SAN VICENTE TANCUAYALAB,034,TANCUICHE,2,44,22,22,2
SAN LUIS POTOSÍ,24,SAN VICENTE TANCUAYALAB,034,TANTOJÓN,3,132,56,76,9
SAN LUIS POTOSÍ,24,SAN VICENTE TANCUAYALAB,034,TASAJERAS,3,53,32,21,5
SAN LUIS POTOSÍ,24,SOLEDAD DE GRACIANO SÁNCHEZ,035,EL HUIZACHE,3,22,9,13,3
SAN LUIS POTOSÍ,24,SOLEDAD DE GRACIANO SÁNCHEZ,035,EL ZAPOTE,3,310,121,189,14
SAN LUIS POTOSÍ,24,SOLEDAD DE GRACIANO SÁNCHEZ,035,ENRIQUE ESTRADA (LA CONCHA),4,508,248,260,39
SAN LUIS POTOSÍ,24,SOLEDAD DE GRACIANO SÁNCHEZ,035,ESTACIÓN TECHA,3,36,20,16,3
SAN LUIS POTOSÍ,24,SOLEDAD DE GRACIANO SÁNCHEZ,035,ESTACIÓN VENTURA,3,91,43,48,4
SAN LUIS POTOSÍ,24,SOLEDAD DE GRACIANO SÁNCHEZ,035,GENERAL CÁNDIDO NAVARRO (LAGUNA SECA),3,246,123,123,12
SAN LUIS POTOSÍ,24,SOLEDAD DE GRACIANO SÁNCHEZ,035,LA PURÍSIMA (FRACCIÓN LA PURÍSIMA),3,34,14,20,3
SAN LUIS POTOSÍ,24,SOLEDAD DE GRACIANO SÁNCHEZ,035,LA TINAJA (EX-HACIENDA LA TINAJA),3,120,47,73,7
SAN LUIS POTOSÍ,24,SOLEDAD DE GRACIANO SÁNCHEZ,035,LOS GÓMEZ,7,1038,520,518,72
SAN LUIS POTOSÍ,24,SOLEDAD DE GRACIANO SÁNCHEZ,035,PALMA DE LA CRUZ,5,1353,689,664,102
SAN LUIS POTOSÍ,24,SOLEDAD DE GRACIANO SÁNCHEZ,035,RANCHO NUEVO,9,4768,2070,2698,300
SAN LUIS POTOSÍ,24,SOLEDAD DE GRACIANO SÁNCHEZ,035,SAN JOSÉ DEL BARRO,2,125,68,57,4
SAN LUIS POTOSÍ,24,SOLEDAD DE GRACIANO SÁNCHEZ,035,SOLEDAD DE GRACIANO SÁNCHEZ,277,70368,34001,36367,4072
SAN LUIS POTOSÍ,24,TAMASOPO,036,ABRAS DEL COROZO,3,123,50,73,7
SAN LUIS POTOSÍ,24,TAMASOPO,036,AGUA BUENA,7,1138,570,568,62
SAN LUIS POTOSÍ,24,TAMASOPO,036,AGUA PUERCA,4,110,65,45,9
SAN LUIS POTOSÍ,24,TAMASOPO,036,BUENAVISTA,2,21,11,10,2
SAN LUIS POTOSÍ,24,TAMASOPO,036,CABEZAS,3,33,12,21,3
SAN LUIS POTOSÍ,24,TAMASOPO,036,CALIFORNIA,3,39,21,18,4
SAN LUIS POTOSÍ,24,TAMASOPO,036,CAMPAMENTO ALFA (LOS CUATES),3,139,63,76,9
SAN LUIS POTOSÍ,24,TAMASOPO,036,CAPUCHINAS,3,57,24,33,4
SAN LUIS POTOSÍ,24,TAMASOPO,036,CARRIZALITO DE TROMPETEROS,2,14,7,7,2
SAN LUIS POTOSÍ,24,TAMASOPO,036,CEBADILLA,2,22,8,14,2
SAN LUIS POTOSÍ,24,TAMASOPO,036,COPALILLOS,3,48,25,23,4
SAN LUIS POTOSÍ,24,TAMASOPO,036,CUESTA BLANCA,4,119,56,63,7
SAN LUIS POTOSÍ,24,TAMASOPO,036,DAMIÁN CARMONA,5,456,221,235,32
SAN LUIS POTOSÍ,24,TAMASOPO,036,EL AGUACATE,2,46,18,28,3
SAN LUIS POTOSÍ,24,TAMASOPO,036,EL CARPINTERO,3,69,33,36,5
SAN LUIS POTOSÍ,24,TAMASOPO,036,EL CARRIZO,3,25,13,12,2
SAN LUIS POTOSÍ,24,TAMASOPO,036,EL CHINO,3,141,70,71,9
SAN LUIS POTOSÍ,24,TAMASOPO,036,EL CLARÍN (ENTRONQUE A TAMASOPO),1,7,3,4,1
SAN LUIS POTOSÍ,24,TAMASOPO,036,EL HUIZACHAL,2,62,27,35,3
SAN LUIS POTOSÍ,24,TAMASOPO,036,EL HUIZACHE,2,44,27,17,3
SAN LUIS POTOSÍ,24,TAMASOPO,036,EL MIRADOR,1,70,34,36,3
SAN LUIS POTOSÍ,24,TAMASOPO,036,EL NARANJO,3,43,16,27,3
SAN LUIS POTOSÍ,24,TAMASOPO,036,EL NOGALITO,1,22,12,10,1
SAN LUIS POTOSÍ,24,TAMASOPO,036,EL PUERTO DE RANCHO NUEVO,2,23,9,14,2
SAN LUIS POTOSÍ,24,TAMASOPO,036,EL SABINITO QUEMADO,3,96,48,48,5
SAN LUIS POTOSÍ,24,TAMASOPO,036,EL SAUCILLO,3,87,41,46,4
SAN LUIS POTOSÍ,24,TAMASOPO,036,EL TRIGO,3,35,19,16,3
SAN LUIS POTOSÍ,24,TAMASOPO,036,EMILIANO ZAPATA (LA BOQUILLA),3,48,27,21,3
SAN LUIS POTOSÍ,24,TAMASOPO,036,HUAMÚCHIL,2,33,11,22,2
SAN LUIS POTOSÍ,24,TAMASOPO,036,JOYA DE LA ESPERANZA,2,15,9,6,2
SAN LUIS POTOSÍ,24,TAMASOPO,036,JOYA DE LOS NOVILLOS,2,22,10,12,2
SAN LUIS POTOSÍ,24,TAMASOPO,036,KILÓMETRO CUATROCIENTOS SETENTA,2,11,5,6,2
SAN LUIS POTOSÍ,24,TAMASOPO,036,LA ESPERANZA,2,26,12,14,3
SAN LUIS POTOSÍ,24,TAMASOPO,036,LA GAVIA,4,98,43,55,9
SAN LUIS POTOSÍ,24,TAMASOPO,036,LA MANZANILLA,3,196,96,100,12
SAN LUIS POTOSÍ,24,TAMASOPO,036,LA MOJONERA (LA MOHONERA),3,100,54,46,7
SAN LUIS POTOSÍ,24,TAMASOPO,036,LA PALMA (VILLA DE LA PALMA),4,206,119,87,13
SAN LUIS POTOSÍ,24,TAMASOPO,036,LA TANTOLA,2,8,4,4,1
SAN LUIS POTOSÍ,24,TAMASOPO,036,LAGUNA DE GÓMEZ,3,14,5,9,2
SAN LUIS POTOSÍ,24,TAMASOPO,036,LAGUNITA DE SAN FRANCISCO,3,10,4,6,2
SAN LUIS POTOSÍ,24,TAMASOPO,036,LAS JOYAS,2,9,3,6,1
SAN LUIS POTOSÍ,24,TAMASOPO,036,NARANJITO,3,84,29,55,6
SAN LUIS POTOSÍ,24,TAMASOPO,036,POZO CUATES,2,25,11,14,2
SAN LUIS POTOSÍ,24,TAMASOPO,036,POZO DEL SAUZ,2,70,33,37,4
SAN LUIS POTOSÍ,24,TAMASOPO,036,PROVIDENCIA,3,19,10,9,3
SAN LUIS POTOSÍ,24,TAMASOPO,036,PUERTO VERDE,4,129,68,61,10
SAN LUIS POTOSÍ,24,TAMASOPO,036,RANCHO NUEVO,5,58,33,25,4
SAN LUIS POTOSÍ,24,TAMASOPO,036,RINCÓN DE RAMÍREZ,2,40,16,24,3
SAN LUIS POTOSÍ,24,TAMASOPO,036,SABINITO DE LOS OROZCO,2,8,3,5,1
SAN LUIS POTOSÍ,24,TAMASOPO,036,SAN ANDRÉS DE LOS LIMONES,3,27,12,15,3
SAN LUIS POTOSÍ,24,TAMASOPO,036,SAN JERÓNIMO,2,31,16,15,2
SAN LUIS POTOSÍ,24,TAMASOPO,036,SAN JOSÉ EL VIEJO (HUAMÚCHIL LA TIGRA),3,85,33,52,6
SAN LUIS POTOSÍ,24,TAMASOPO,036,SAN MIGUEL,3,9,5,4,2
SAN LUIS POTOSÍ,24,TAMASOPO,036,SAN NICOLÁS DE LOS MONTES,3,72,36,36,4
SAN LUIS POTOSÍ,24,TAMASOPO,036,SANTA ELENA (EL RETACHO),2,40,15,25,3
SAN LUIS POTOSÍ,24,TAMASOPO,036,SANTA ISABEL,2,17,10,7,2
SAN LUIS POTOSÍ,24,TAMASOPO,036,SANTA MARÍA TAMPALATÍN,3,71,34,37,6
SAN LUIS POTOSÍ,24,TAMASOPO,036,SANTA ROSALÍA,3,20,13,7,3
SAN LUIS POTOSÍ,24,TAMASOPO,036,TAMASOPO,8,1034,503,531,51
SAN LUIS POTOSÍ,24,TAMASOPO,036,TAMBACA,8,723,349,374,45
SAN LUIS POTOSÍ,24,TAMASOPO,036,TAMPASQUÍN,2,5,4,1,1
SAN LUIS POTOSÍ,24,TAMASOPO,036,TANQUE DEL BORREGO,2,38,20,18,3
SAN LUIS POTOSÍ,24,TAMASOPO,036,TIERRITAS BLANCAS,1,6,3,3,1
SAN LUIS POTOSÍ,24,TAMASOPO,036,VEINTE DE NOVIEMBRE,4,122,59,63,11
SAN LUIS POTOSÍ,24,TAMAZUNCHALE,037,ACALAMAYO,2,34,15,19,3
SAN LUIS POTOSÍ,24,TAMAZUNCHALE,037,ACHIQUICO,1,1153,488,665,56
SAN LUIS POTOSÍ,24,TAMAZUNCHALE,037,ACUAPICH (PIXTEYO),1,13,6,7,1
SAN LUIS POTOSÍ,24,TAMAZUNCHALE,037,AGUAZARCA,7,724,365,359,42
SAN LUIS POTOSÍ,24,TAMAZUNCHALE,037,AHUEHUEYO,5,247,115,132,18
SAN LUIS POTOSÍ,24,TAMAZUNCHALE,037,AMATITLA SANTIAGO,3,104,54,50,7
SAN LUIS POTOSÍ,24,TAMAZUNCHALE,037,AMATITLA TAMÁN,4,227,105,122,13
SAN LUIS POTOSÍ,24,TAMAZUNCHALE,037,ARROYO DE LOS PATOS,2,16,7,9,2
SAN LUIS POTOSÍ,24,TAMAZUNCHALE,037,ATEHUAC,4,91,39,52,7
SAN LUIS POTOSÍ,24,TAMAZUNCHALE,037,ATLAJQUE,3,183,103,80,14
SAN LUIS POTOSÍ,24,TAMAZUNCHALE,037,AXHUMOL,3,176,88,88,12
SAN LUIS POTOSÍ,24,TAMAZUNCHALE,037,BARRIO BENITO JUÁREZ,1,53,27,26,4
SAN LUIS POTOSÍ,24,TAMAZUNCHALE,037,BARRIO DE GUADALUPE,2,96,53,43,8
SAN LUIS POTOSÍ,24,TAMAZUNCHALE,037,BARRIO LA VEGA CUIXCUATITLA,3,40,21,19,4
SAN LUIS POTOSÍ,24,TAMAZUNCHALE,037,BARRIO LAS PALMAS,2,9,5,4,1
SAN LUIS POTOSÍ,24,TAMAZUNCHALE,037,BARRIO PROGRESO,6,123,65,58,9
SAN LUIS POTOSÍ,24,TAMAZUNCHALE,037,BUENAVISTA,2,13,6,7,2
SAN LUIS POTOSÍ,24,TAMAZUNCHALE,037,BUENOS AIRES RETROCESO,2,48,24,24,3
SAN LUIS POTOSÍ,24,TAMAZUNCHALE,037,CACALACAYO,3,42,23,19,4
SAN LUIS POTOSÍ,24,TAMAZUNCHALE,037,CACATEO,4,140,77,63,10
SAN LUIS POTOSÍ,24,TAMAZUNCHALE,037,CAMARONES,3,55,34,21,4
SAN LUIS POTOSÍ,24,TAMAZUNCHALE,037,CERRO GRANDE,4,148,74,74,11
SAN LUIS POTOSÍ,24,TAMAZUNCHALE,037,CERRO GRANDE SANTIAGO,1,17,8,9,1
SAN LUIS POTOSÍ,24,TAMAZUNCHALE,037,CHAPULHUACANITO,8,1580,790,790,106
SAN LUIS POTOSÍ,24,TAMAZUNCHALE,037,CHILOCUIL TAMÁN,2,196,95,101,10
SAN LUIS POTOSÍ,24,TAMAZUNCHALE,037,COAHUICA,2,31,18,13,3
SAN LUIS POTOSÍ,24,TAMAZUNCHALE,037,COAXOCOTITLA,4,136,60,76,12
SAN LUIS POTOSÍ,24,TAMAZUNCHALE,037,COJOLAPA,4,191,106,85,14
SAN LUIS POTOSÍ,24,TAMAZUNCHALE,037,COLONIA NEZAHUALCÓYOTL,2,15,6,9,2
SAN LUIS POTOSÍ,24,TAMAZUNCHALE,037,COXOTLA,3,34,18,16,3
SAN LUIS POTOSÍ,24,TAMAZUNCHALE,037,COYOL (VEGA LARGA),3,109,57,52,7
SAN LUIS POTOSÍ,24,TAMAZUNCHALE,037,CUAJAPA SANTIAGO,3,41,18,23,3
SAN LUIS POTOSÍ,24,TAMAZUNCHALE,037,CUAJAPA TAMÁN,2,56,26,30,3
SAN LUIS POTOSÍ,24,TAMAZUNCHALE,037,CUAPILOL,3,79,36,43,5
SAN LUIS POTOSÍ,24,TAMAZUNCHALE,037,CUATZONTITLA,3,47,26,21,4
SAN LUIS POTOSÍ,24,TAMAZUNCHALE,037,CUITLAMECACO,2,19,11,8,2
SAN LUIS POTOSÍ,24,TAMAZUNCHALE,037,CUIXCUATITLA,4,214,111,103,16
SAN LUIS POTOSÍ,24,TAMAZUNCHALE,037,ECUATITLA,3,30,16,14,3
SAN LUIS POTOSÍ,24,TAMAZUNCHALE,037,EL BANCO (SAN FRANCISCO),3,69,35,34,5
SAN LUIS POTOSÍ,24,TAMAZUNCHALE,037,EL CARRIZAL,5,225,93,132,15
SAN LUIS POTOSÍ,24,TAMAZUNCHALE,037,EL CHAPARRAL,2,19,11,8,2
SAN LUIS POTOSÍ,24,TAMAZUNCHALE,037,EL COYOL SAN FRANCISCO,3,80,29,51,6
SAN LUIS POTOSÍ,24,TAMAZUNCHALE,037,EL ENCINAL,2,39,23,16,3
SAN LUIS POTOSÍ,24,TAMAZUNCHALE,037,EL GAVILÁN,2,33,16,17,3
SAN LUIS POTOSÍ,24,TAMAZUNCHALE,037,EL INFIERNILLO,2,11,5,6,2
SAN LUIS POTOSÍ,24,TAMAZUNCHALE,037,EL LAUREL,2,47,21,26,4
SAN LUIS POTOSÍ,24,TAMAZUNCHALE,037,EL NARANJAL,3,38,18,20,3
SAN LUIS POTOSÍ,24,TAMAZUNCHALE,037,EL PALMITO,4,268,129,139,15
SAN LUIS POTOSÍ,24,TAMAZUNCHALE,037,EL PIÑAL,3,474,228,246,22
SAN LUIS POTOSÍ,24,TAMAZUNCHALE,037,EL PLATANITO,3,58,31,27,6
SAN LUIS POTOSÍ,24,TAMAZUNCHALE,037,EL RANCHITO,1,12,5,7,1
SAN LUIS POTOSÍ,24,TAMAZUNCHALE,037,EL TEPETATE,3,68,41,27,4
SAN LUIS POTOSÍ,24,TAMAZUNCHALE,037,EMILIANO ZAPATA,6,157,80,77,13
SAN LUIS POTOSÍ,24,TAMAZUNCHALE,037,ENCINO SOLO,4,78,38,40,5
SAN LUIS POTOSÍ,24,TAMAZUNCHALE,037,ENRAMADITAS,4,207,102,105,13
SAN LUIS POTOSÍ,24,TAMAZUNCHALE,037,GUAXCUACO,3,142,71,71,8
SAN LUIS POTOSÍ,24,TAMAZUNCHALE,037,HUAZALINGO,3,150,70,80,11
SAN LUIS POTOSÍ,24,TAMAZUNCHALE,037,HUICHAPA,2,29,9,20,3
SAN LUIS POTOSÍ,24,TAMAZUNCHALE,037,IXTEAMEL,4,220,99,121,15
SAN LUIS POTOSÍ,24,TAMAZUNCHALE,037,IXTLA (IXTLA SANTIAGO),5,162,78,84,11
SAN LUIS POTOSÍ,24,TAMAZUNCHALE,037,IXTLAPALACO,4,160,75,85,12
SAN LUIS POTOSÍ,24,TAMAZUNCHALE,037,JALTOCÁN SAN FRANCISCO,2,40,22,18,3
SAN LUIS POTOSÍ,24,TAMAZUNCHALE,037,LA BANDERA,2,27,16,11,3
SAN LUIS POTOSÍ,24,TAMAZUNCHALE,037,LA CEIBA,3,23,9,14,3
SAN LUIS POTOSÍ,24,TAMAZUNCHALE,037,LA CUCHILLA,5,816,545,271,52
SAN LUIS POTOSÍ,24,TAMAZUNCHALE,037,LA LAGUNA,4,139,76,63,12
SAN LUIS POTOSÍ,24,TAMAZUNCHALE,037,LA PEÑITA SANTIAGO,1,11,4,7,1
SAN LUIS POTOSÍ,24,TAMAZUNCHALE,037,LA PIMIENTA (LOMAS DE AGUAYO),2,31,18,13,3
SAN LUIS POTOSÍ,24,TAMAZUNCHALE,037,LA REFORMA (EL LINDERO),3,28,14,14,3
SAN LUIS POTOSÍ,24,TAMAZUNCHALE,037,LALAXTZINTLA,1,14,8,6,1
SAN LUIS POTOSÍ,24,TAMAZUNCHALE,037,LAS CABAÑAS,2,36,18,18,3
SAN LUIS POTOSÍ,24,TAMAZUNCHALE,037,LAS CHACHALACAS,2,11,5,6,1
SAN LUIS POTOSÍ,24,TAMAZUNCHALE,037,LAS PALOMAS,3,64,29,35,5
SAN LUIS POTOSÍ,24,TAMAZUNCHALE,037,LIMAJYO,3,62,28,34,5
SAN LUIS POTOSÍ,24,TAMAZUNCHALE,037,LIMATITLA,2,25,10,15,2
SAN LUIS POTOSÍ,24,TAMAZUNCHALE,037,LOMAS DE BUENAVISTA TAMÁN,2,24,13,11,2
SAN LUIS POTOSÍ,24,TAMAZUNCHALE,037,LOS CERRITOS,2,34,17,17,3
SAN LUIS POTOSÍ,24,TAMAZUNCHALE,037,LOS NARANJOS SANTIAGO,2,14,6,8,2
SAN LUIS POTOSÍ,24,TAMAZUNCHALE,037,LUIS DONALDO COLOSIO (SAN JOSÉ),2,18,4,14,2
SAN LUIS POTOSÍ,24,TAMAZUNCHALE,037,MAZATÉTL,4,96,47,49,8
SAN LUIS POTOSÍ,24,TAMAZUNCHALE,037,MECACHIQUICO,4,141,65,76,11
SAN LUIS POTOSÍ,24,TAMAZUNCHALE,037,MECAPALA,2,75,37,38,4
SAN LUIS POTOSÍ,24,TAMAZUNCHALE,037,MECATLÁN,6,705,370,335,35
SAN LUIS POTOSÍ,24,TAMAZUNCHALE,037,MONTE ALEGRE,1,12,8,4,1
SAN LUIS POTOSÍ,24,TAMAZUNCHALE,037,PAGUAYO,2,76,40,36,4
SAN LUIS POTOSÍ,24,TAMAZUNCHALE,037,PAHUAYO,4,162,69,93,10
SAN LUIS POTOSÍ,24,TAMAZUNCHALE,037,PAHUAYO SAN MIGUEL,3,36,17,19,4
SAN LUIS POTOSÍ,24,TAMAZUNCHALE,037,PALICTLA,3,99,54,45,6
SAN LUIS POTOSÍ,24,TAMAZUNCHALE,037,PAPATLACO SANTIAGO,4,198,87,111,16
SAN LUIS POTOSÍ,24,TAMAZUNCHALE,037,PAYANTLA,2,19,7,12,2
SAN LUIS POTOSÍ,24,TAMAZUNCHALE,037,PEMUCHO,7,322,165,157,24
SAN LUIS POTOSÍ,24,TAMAZUNCHALE,037,PEZMAYO SANTIAGO,2,39,20,19,2
SAN LUIS POTOSÍ,24,TAMAZUNCHALE,037,POXANTLA,4,144,64,80,10
SAN LUIS POTOSÍ,24,TAMAZUNCHALE,037,RANCHO NUEVO,4,104,46,58,7
SAN LUIS POTOSÍ,24,TAMAZUNCHALE,037,SAN ANDRES,2,4,4,0,2
SAN LUIS POTOSÍ,24,TAMAZUNCHALE,037,SAN ANTONIO,2,29,16,13,3
SAN LUIS POTOSÍ,24,TAMAZUNCHALE,037,SAN FRANCISCO,7,313,161,152,21
SAN LUIS POTOSÍ,24,TAMAZUNCHALE,037,SAN ISIDRO,2,11,6,5,2
SAN LUIS POTOSÍ,24,TAMAZUNCHALE,037,SAN JOSÉ SANTIAGO,2,23,10,13,2
SAN LUIS POTOSÍ,24,TAMAZUNCHALE,037,SANTA MARÍA PICULA,4,275,148,127,16
SAN LUIS POTOSÍ,24,TAMAZUNCHALE,037,SANTIAGO CENTRO,5,296,140,156,23
SAN LUIS POTOSÍ,24,TAMAZUNCHALE,037,SUKIAMEL,3,152,72,80,9
SAN LUIS POTOSÍ,24,TAMAZUNCHALE,037,TACIAL,3,123,66,57,11
SAN LUIS POTOSÍ,24,TAMAZUNCHALE,037,TAMACOL,4,118,55,63,10
SAN LUIS POTOSÍ,24,TAMAZUNCHALE,037,TAMÁN,4,1069,558,511,45
SAN LUIS POTOSÍ,24,TAMAZUNCHALE,037,TAMAZUNCHALE,48,7989,4207,3782,565
SAN LUIS POTOSÍ,24,TAMAZUNCHALE,037,TANTOYUQUITA,2,21,10,11,3
SAN LUIS POTOSÍ,24,TAMAZUNCHALE,037,TAXICHO,2,18,9,9,2
SAN LUIS POTOSÍ,24,TAMAZUNCHALE,037,TECOMATE DOS,1,5,4,1,1
SAN LUIS POTOSÍ,24,TAMAZUNCHALE,037,TECOMATE UNO,3,69,38,31,5
SAN LUIS POTOSÍ,24,TAMAZUNCHALE,037,TEMACUIL,2,43,24,19,3
SAN LUIS POTOSÍ,24,TAMAZUNCHALE,037,TEMAMATLA,4,237,118,119,13
SAN LUIS POTOSÍ,24,TAMAZUNCHALE,037,TENEXCO,4,76,35,41,7
SAN LUIS POTOSÍ,24,TAMAZUNCHALE,037,TENEXTIPA,2,32,14,18,3
SAN LUIS POTOSÍ,24,TAMAZUNCHALE,037,TENSONAPA,2,5,2,3,1
SAN LUIS POTOSÍ,24,TAMAZUNCHALE,037,TEOZELOC,3,44,17,27,4
SAN LUIS POTOSÍ,24,TAMAZUNCHALE,037,TEPETZINTLA,3,24,12,12,3
SAN LUIS POTOSÍ,24,TAMAZUNCHALE,037,TEPEYAC,1,27,11,16,2
SAN LUIS POTOSÍ,24,TAMAZUNCHALE,037,TEQUILILLO,2,12,9,3,3
SAN LUIS POTOSÍ,24,TAMAZUNCHALE,037,TETITLA,4,206,110,96,15
SAN LUIS POTOSÍ,24,TAMAZUNCHALE,037,TETLAMA,3,35,18,17,4
SAN LUIS POTOSÍ,24,TAMAZUNCHALE,037,TEXOCHITL,3,37,18,19,4
SAN LUIS POTOSÍ,24,TAMAZUNCHALE,037,TEXOJOL,4,96,45,51,9
SAN LUIS POTOSÍ,24,TAMAZUNCHALE,037,TEXOPIS,4,66,38,28,7
SAN LUIS POTOSÍ,24,TAMAZUNCHALE,037,TEZAPOTLA,7,1009,512,497,62
SAN LUIS POTOSÍ,24,TAMAZUNCHALE,037,TEZONTLA,5,276,128,148,21
SAN LUIS POTOSÍ,24,TAMAZUNCHALE,037,TIANGUISPICULA,4,319,155,164,27
SAN LUIS POTOSÍ,24,TAMAZUNCHALE,037,TILAPA,2,18,14,4,2
SAN LUIS POTOSÍ,24,TAMAZUNCHALE,037,TIXCUAYUCA,4,201,101,100,14
SAN LUIS POTOSÍ,24,TAMAZUNCHALE,037,TLACHIQUILYACAPA,2,138,70,68,7
SAN LUIS POTOSÍ,24,TAMAZUNCHALE,037,TLACUILOLA,3,212,106,106,13
SAN LUIS POTOSÍ,24,TAMAZUNCHALE,037,TLALIXCO,4,188,87,101,14
SAN LUIS POTOSÍ,24,TAMAZUNCHALE,037,TLALNEPANTLA,4,615,312,303,40
SAN LUIS POTOSÍ,24,TAMAZUNCHALE,037,TLALOCUIL,2,11,9,2,2
SAN LUIS POTOSÍ,24,TAMAZUNCHALE,037,TLAMAYA SANTIAGO,5,122,59,63,8
SAN LUIS POTOSÍ,24,TAMAZUNCHALE,037,TLAXCALA,1,11,6,5,1
SAN LUIS POTOSÍ,24,TAMAZUNCHALE,037,TLAZUAPA,2,17,7,10,2
SAN LUIS POTOSÍ,24,TAMAZUNCHALE,037,TOLAPA (TOLAPA TAMÁN),2,29,12,17,2
SAN LUIS POTOSÍ,24,TAMAZUNCHALE,037,TOROJATL,3,31,14,17,4
SAN LUIS POTOSÍ,24,TAMAZUNCHALE,037,TOTECTITLA LOS CIRUELOS,2,18,11,7,2
SAN LUIS POTOSÍ,24,TAMAZUNCHALE,037,VEGA LARGA,3,195,86,109,13
SAN LUIS POTOSÍ,24,TAMAZUNCHALE,037,XALTIPA,3,147,75,72,10
SAN LUIS POTOSÍ,24,TAMAZUNCHALE,037,XICOTLA,3,72,34,38,5
SAN LUIS POTOSÍ,24,TAMAZUNCHALE,037,XILHUAZO,3,73,35,38,7
SAN LUIS POTOSÍ,24,TAMAZUNCHALE,037,XILIAPA,2,32,14,18,3
SAN LUIS POTOSÍ,24,TAMAZUNCHALE,037,XINICTLE,4,83,43,40,6
SAN LUIS POTOSÍ,24,TAMAZUNCHALE,037,XOCHIAYO SANTIAGO,2,16,6,10,2
SAN LUIS POTOSÍ,24,TAMAZUNCHALE,037,XOMOCO,3,89,41,48,5
SAN LUIS POTOSÍ,24,TAMAZUNCHALE,037,ZOPILOAPA,2,40,14,26,3
SAN LUIS POTOSÍ,24,TAMAZUNCHALE,037,ZOQUITIPA,4,119,59,60,12
SAN LUIS POTOSÍ,24,TAMPACÁN,038,AMPLIACIÓN NUEVO HULERO,2,16,6,10,2
SAN LUIS POTOSÍ,24,TAMPACÁN,038,BARRIO ARRIBA (FÁTIMA),2,10,5,5,2
SAN LUIS POTOSÍ,24,TAMPACÁN,038,BARRIO VIBORITAS,2,14,8,6,2
SAN LUIS POTOSÍ,24,TAMPACÁN,038,CHICONAMEL,4,194,102,92,12
SAN LUIS POTOSÍ,24,TAMPACÁN,038,CHILILILLO,4,97,41,56,8
SAN LUIS POTOSÍ,24,TAMPACÁN,038,CHIMIMEXCO,2,40,24,16,3
SAN LUIS POTOSÍ,24,TAMPACÁN,038,CHUPADERO,2,39,26,13,3
SAN LUIS POTOSÍ,24,TAMPACÁN,038,CUAYAHUAL,3,60,27,33,5
SAN LUIS POTOSÍ,24,TAMPACÁN,038,DOCTOR SALVADOR NAVA MARTÍNEZ (NUEVO SANTA RITA),2,5,4,1,1
SAN LUIS POTOSÍ,24,TAMPACÁN,038,EL CEDRAL,3,110,52,58,8
SAN LUIS POTOSÍ,24,TAMPACÁN,038,EL HUEXCO,4,233,92,141,18
SAN LUIS POTOSÍ,24,TAMPACÁN,038,EL HULERO,4,209,103,106,17
SAN LUIS POTOSÍ,24,TAMPACÁN,038,EL REFUGIO,3,42,21,21,4
SAN LUIS POTOSÍ,24,TAMPACÁN,038,LA BAJADA (JAIME RAMÍREZ),1,6,2,4,1
SAN LUIS POTOSÍ,24,TAMPACÁN,038,LA FINCA MIRAFLORES,3,74,42,32,5
SAN LUIS POTOSÍ,24,TAMPACÁN,038,LA MATA,4,136,70,66,12
SAN LUIS POTOSÍ,24,TAMPACÁN,038,LA SOLEDAD,4,433,206,227,25
SAN LUIS POTOSÍ,24,TAMPACÁN,038,LAGUNILLAS,1,10,4,6,1
SAN LUIS POTOSÍ,24,TAMPACÁN,038,LAS MESAS,3,77,39,38,5
SAN LUIS POTOSÍ,24,TAMPACÁN,038,LÁZARO CÁRDENAS,3,57,28,29,5
SAN LUIS POTOSÍ,24,TAMPACÁN,038,LOS COYOLES,3,76,37,39,5
SAN LUIS POTOSÍ,24,TAMPACÁN,038,LOS CUES,3,78,46,32,6
SAN LUIS POTOSÍ,24,TAMPACÁN,038,LOS SABINOS,2,7,3,4,1
SAN LUIS POTOSÍ,24,TAMPACÁN,038,MACUILOCATL,3,69,38,31,4
SAN LUIS POTOSÍ,24,TAMPACÁN,038,NUEVO HULERO (LA CURVA),2,38,14,24,2
SAN LUIS POTOSÍ,24,TAMPACÁN,038,NUEVO JALPILLA,3,79,38,41,4
SAN LUIS POTOSÍ,24,TAMPACÁN,038,PALANTITLA,2,6,4,2,1
SAN LUIS POTOSÍ,24,TAMPACÁN,038,PALOLCO,3,69,31,38,5
SAN LUIS POTOSÍ,24,TAMPACÁN,038,PUYÉCATL,2,33,16,17,2
SAN LUIS POTOSÍ,24,TAMPACÁN,038,SANTOMILA,2,26,10,16,2
SAN LUIS POTOSÍ,24,TAMPACÁN,038,TAMPACÁN,3,712,330,382,23
SAN LUIS POTOSÍ,24,TAMPACÁN,038,TENEXTITLA DOS,2,57,29,28,4
SAN LUIS POTOSÍ,24,TAMPACÁN,038,TENEXTITLA UNO,3,66,29,37,4
SAN LUIS POTOSÍ,24,TAMPACÁN,038,TOTOMOXTLA DOS (HUEXCO),3,138,62,76,9
SAN LUIS POTOSÍ,24,TAMPACÁN,038,TOTOMOXTLA TRES (HUEXCO),1,6,3,3,1
SAN LUIS POTOSÍ,24,TAMPACÁN,038,XOCHIAYO,2,21,9,12,2
SAN LUIS POTOSÍ,24,TAMPACÁN,038,XOCHICUATLA,4,180,76,104,11
SAN LUIS POTOSÍ,24,TAMPAMOLÓN CORONA,039,AGUA FRÍA,2,25,15,10,2
SAN LUIS POTOSÍ,24,TAMPAMOLÓN CORONA,039,CHIQUINTECO,2,33,21,12,3
SAN LUIS POTOSÍ,24,TAMPAMOLÓN CORONA,039,COAXINQUILA,3,106,50,56,6
SAN LUIS POTOSÍ,24,TAMPAMOLÓN CORONA,039,COAXOCOYO,2,26,12,14,2
SAN LUIS POTOSÍ,24,TAMPAMOLÓN CORONA,039,COMUNIDAD EL NARANJO,3,79,43,36,5
SAN LUIS POTOSÍ,24,TAMPAMOLÓN CORONA,039,C'OYOB TÚJUB,2,42,21,21,2
SAN LUIS POTOSÍ,24,TAMPAMOLÓN CORONA,039,CUATZ AJIN (COATZAJÍN),1,9,2,7,1
SAN LUIS POTOSÍ,24,TAMPAMOLÓN CORONA,039,EL CARRIZAL,4,175,98,77,12
SAN LUIS POTOSÍ,24,TAMPAMOLÓN CORONA,039,EL CHIJOL,3,56,31,25,5
SAN LUIS POTOSÍ,24,TAMPAMOLÓN CORONA,039,EL CHUCHE,2,13,5,8,2
SAN LUIS POTOSÍ,24,TAMPAMOLÓN CORONA,039,EL NARANJO TAYABTZÉN (TRES PALMAS),4,132,64,68,8
SAN LUIS POTOSÍ,24,TAMPAMOLÓN CORONA,039,EL PUENTE UNO,3,39,22,17,3
SAN LUIS POTOSÍ,24,TAMPAMOLÓN CORONA,039,EL TAMARINDO MEXICANO,1,7,4,3,1
SAN LUIS POTOSÍ,24,TAMPAMOLÓN CORONA,039,LA CANDELARIA,2,12,5,7,2
SAN LUIS POTOSÍ,24,TAMPAMOLÓN CORONA,039,LA PEÑA,1,12,6,6,1
SAN LUIS POTOSÍ,24,TAMPAMOLÓN CORONA,039,LAS MESITAS,2,17,7,10,2
SAN LUIS POTOSÍ,24,TAMPAMOLÓN CORONA,039,LAS VÍBORAS,5,290,129,161,22
SAN LUIS POTOSÍ,24,TAMPAMOLÓN CORONA,039,MANCORNADERO,2,17,10,7,2
SAN LUIS POTOSÍ,24,TAMPAMOLÓN CORONA,039,PAXQUID,3,83,42,41,5
SAN LUIS POTOSÍ,24,TAMPAMOLÓN CORONA,039,PAXQUID (LA PIMIENTA),1,4,3,1,1
SAN LUIS POTOSÍ,24,TAMPAMOLÓN CORONA,039,POYQUID,2,25,13,12,3
SAN LUIS POTOSÍ,24,TAMPAMOLÓN CORONA,039,PUCTÉ,2,61,31,30,4
SAN LUIS POTOSÍ,24,TAMPAMOLÓN CORONA,039,PUNCHUMU,3,38,17,21,3
SAN LUIS POTOSÍ,24,TAMPAMOLÓN CORONA,039,RÍO FLORIDO,2,23,16,7,2
SAN LUIS POTOSÍ,24,TAMPAMOLÓN CORONA,039,SAN BARTOLO,2,33,11,22,3
SAN LUIS POTOSÍ,24,TAMPAMOLÓN CORONA,039,TAJINAB,2,36,17,19,3
SAN LUIS POTOSÍ,24,TAMPAMOLÓN CORONA,039,TALLABTZÉN,3,59,29,30,4
SAN LUIS POTOSÍ,24,TAMPAMOLÓN CORONA,039,TAMARINDO HUASTECO,4,119,69,50,11
SAN LUIS POTOSÍ,24,TAMPAMOLÓN CORONA,039,TAMPAMOLÓN CORONA,7,1494,771,723,85
SAN LUIS POTOSÍ,24,TAMPAMOLÓN CORONA,039,TEAXIL,2,49,22,27,3
SAN LUIS POTOSÍ,24,TAMPAMOLÓN CORONA,039,TENEXO,3,70,29,41,7
SAN LUIS POTOSÍ,24,TAMPAMOLÓN CORONA,039,TIERRA BLANCA,3,63,29,34,6
SAN LUIS POTOSÍ,24,TAMPAMOLÓN CORONA,039,TONATICO,3,167,75,92,11
SAN LUIS POTOSÍ,24,TAMPAMOLÓN CORONA,039,TUT TZEN (TIUTZÉN),2,31,10,21,2
SAN LUIS POTOSÍ,24,TAMPAMOLÓN CORONA,039,TZAPUW JÁ (TZAPUJA),3,96,47,49,6
SAN LUIS POTOSÍ,24,TAMPAMOLÓN CORONA,039,YOHUALA,2,26,12,14,2
SAN LUIS POTOSÍ,24,TAMUÍN,040,ANTIGUO TAMUÍN,3,85,39,46,4
SAN LUIS POTOSÍ,24,TAMUÍN,040,EJIDO GRACIANO SÁNCHEZ,3,69,33,36,5
SAN LUIS POTOSÍ,24,TAMUÍN,040,EJIDO LOS HUASTECOS,4,340,178,162,21
SAN LUIS POTOSÍ,24,TAMUÍN,040,EJIDO SANTA ELENA,3,162,84,78,12
SAN LUIS POTOSÍ,24,TAMUÍN,040,EJIDO VELAZCO,3,85,37,48,6
SAN LUIS POTOSÍ,24,TAMUÍN,040,EL ASERRADERO,2,11,5,6,1
SAN LUIS POTOSÍ,24,TAMUÍN,040,EL CARACOL,3,15,9,6,3
SAN LUIS POTOSÍ,24,TAMUÍN,040,EL CARRIZO,4,290,132,158,12
SAN LUIS POTOSÍ,24,TAMUÍN,040,EL CENTINELA,2,174,83,91,8
SAN LUIS POTOSÍ,24,TAMUÍN,040,EL PALMAR,3,79,44,35,4
SAN LUIS POTOSÍ,24,TAMUÍN,040,EMILIANO ZAPATA,2,115,66,49,8
SAN LUIS POTOSÍ,24,TAMUÍN,040,ESTACIÓN EL COCO,1,3,2,1,1
SAN LUIS POTOSÍ,24,TAMUÍN,040,ESTACIÓN TAMUÍN,3,241,127,114,14
SAN LUIS POTOSÍ,24,TAMUÍN,040,LA CEIBA,3,97,47,50,6
SAN LUIS POTOSÍ,24,TAMUÍN,040,LA FORTALEZA,3,107,55,52,5
SAN LUIS POTOSÍ,24,TAMUÍN,040,LA TIMA (FRACCIÓN LAS PALMAS),2,14,5,9,1
SAN LUIS POTOSÍ,24,TAMUÍN,040,LAS PALMAS,5,323,164,159,22
SAN LUIS POTOSÍ,24,TAMUÍN,040,LOMA ALTA,3,50,30,20,5
SAN LUIS POTOSÍ,24,TAMUÍN,040,LUIS DONALDO COLOSIO,3,91,52,39,7
SAN LUIS POTOSÍ,24,TAMUÍN,040,MANUEL ÁVILA CAMACHO,3,44,22,22,3
SAN LUIS POTOSÍ,24,TAMUÍN,040,NUEVO AHUACATITLA,3,173,78,95,11
SAN LUIS POTOSÍ,24,TAMUÍN,040,NUEVO AQUISMÓN,4,241,117,124,12
SAN LUIS POTOSÍ,24,TAMUÍN,040,NUEVO TAMPAÓN,9,851,438,413,49
SAN LUIS POTOSÍ,24,TAMUÍN,040,PRIMAVERA,1,116,58,58,6
SAN LUIS POTOSÍ,24,TAMUÍN,040,SAN JOSÉ DE LIMÓN,3,41,16,25,3
SAN LUIS POTOSÍ,24,TAMUÍN,040,SANTA MARTHA,5,417,213,204,30
SAN LUIS POTOSÍ,24,TAMUÍN,040,TAMANTE,3,42,17,25,3
SAN LUIS POTOSÍ,24,TAMUÍN,040,TAMPACOY,3,72,36,36,4
SAN LUIS POTOSÍ,24,TAMUÍN,040,TAMUÍN,21,3953,1991,1962,253
SAN LUIS POTOSÍ,24,TAMUÍN,040,VENUSTIANO CARRANZA,3,54,32,22,3
SAN LUIS POTOSÍ,24,TAMUÍN,040,VILLA GUERRERO,2,383,179,204,17
SAN LUIS POTOSÍ,24,TANLAJÁS,041,AGUAHEDIONDA,2,40,23,17,3
SAN LUIS POTOSÍ,24,TANLAJÁS,041,AGUALOJA,4,96,40,56,8
SAN LUIS POTOSÍ,24,TANLAJÁS,041,ANEXO QUELABITAD CALABAZAS,2,48,22,26,3
SAN LUIS POTOSÍ,24,TANLAJÁS,041,BARRIO TOCOYMOHOM,5,183,75,108,11
SAN LUIS POTOSÍ,24,TANLAJÁS,041,COROMOHOM (TOCOYMOHOM),2,109,56,53,8
SAN LUIS POTOSÍ,24,TANLAJÁS,041,CUITZABTZÉN,2,29,16,13,2
SAN LUIS POTOSÍ,24,TANLAJÁS,041,DHOKOB,2,50,24,26,3
SAN LUIS POTOSÍ,24,TANLAJÁS,041,EJIDO EL BARRANCÓN,3,108,46,62,9
SAN LUIS POTOSÍ,24,TANLAJÁS,041,EJIDO EL TZAJIB,2,29,17,12,2
SAN LUIS POTOSÍ,24,TANLAJÁS,041,EJIDO LA ARGENTINA,3,89,41,48,7
SAN LUIS POTOSÍ,24,TANLAJÁS,041,EJIDO LA CEBADILLA,4,110,41,69,9
SAN LUIS POTOSÍ,24,TANLAJÁS,041,EJIDO LA CONCEPCIÓN,4,132,69,63,9
SAN LUIS POTOSÍ,24,TANLAJÁS,041,EJIDO NIÑOS HÉROES,2,40,20,20,3
SAN LUIS POTOSÍ,24,TANLAJÁS,041,EJIDO SAN JOSÉ XILATZÉN,6,304,149,155,22
SAN LUIS POTOSÍ,24,TANLAJÁS,041,EJIDO SERAPIO GUTIÉRREZ,2,6,2,4,2
SAN LUIS POTOSÍ,24,TANLAJÁS,041,EL CHUCHE,3,51,25,26,4
SAN LUIS POTOSÍ,24,TANLAJÁS,041,EL FORTÍN MAY,3,81,37,44,7
SAN LUIS POTOSÍ,24,TANLAJÁS,041,EL JOMTE,4,154,76,78,12
SAN LUIS POTOSÍ,24,TANLAJÁS,041,EL JOPOY,2,6,2,4,1
SAN LUIS POTOSÍ,24,TANLAJÁS,041,EL LAUREL,2,11,7,4,2
SAN LUIS POTOSÍ,24,TANLAJÁS,041,EL MANTE,2,45,25,20,3
SAN LUIS POTOSÍ,24,TANLAJÁS,041,EL MAY,2,34,16,18,3
SAN LUIS POTOSÍ,24,TANLAJÁS,041,EL PANDO,4,85,45,40,7
SAN LUIS POTOSÍ,24,TANLAJÁS,041,EL TIYÓU,2,40,20,20,3
SAN LUIS POTOSÍ,24,TANLAJÁS,041,EL ZAPOTE,2,20,5,15,2
SAN LUIS POTOSÍ,24,TANLAJÁS,041,LA LABOR,2,32,17,15,2
SAN LUIS POTOSÍ,24,TANLAJÁS,041,MALILIJA,4,76,34,42,6
SAN LUIS POTOSÍ,24,TANLAJÁS,041,MONEC,4,75,39,36,5
SAN LUIS POTOSÍ,24,TANLAJÁS,041,MULULTZÉN,1,9,6,3,1
SAN LUIS POTOSÍ,24,TANLAJÁS,041,NUEVO CUEYTZÉN,3,123,58,65,11
SAN LUIS POTOSÍ,24,TANLAJÁS,041,OJOX,3,50,27,23,5
SAN LUIS POTOSÍ,24,TANLAJÁS,041,PAIXTZÁN,3,68,35,33,4
SAN LUIS POTOSÍ,24,TANLAJÁS,041,PATALJA,2,10,4,6,2
SAN LUIS POTOSÍ,24,TANLAJÁS,041,QUELABITAD COMUNAL,2,29,16,13,2
SAN LUIS POTOSÍ,24,TANLAJÁS,041,QUELABITAD CUARESMA,2,32,19,13,2
SAN LUIS POTOSÍ,24,TANLAJÁS,041,SAN BENITO,4,81,35,46,6
SAN LUIS POTOSÍ,24,TANLAJÁS,041,SAN ISIDRO,2,32,17,15,3
SAN LUIS POTOSÍ,24,TANLAJÁS,041,SAN JOSÉ DEL TINTO (LA GLORIA),3,80,35,45,5
SAN LUIS POTOSÍ,24,TANLAJÁS,041,SAN NICOLÁS,5,276,137,139,17
SAN LUIS POTOSÍ,24,TANLAJÁS,041,SANTA ELENA,4,125,52,73,8
SAN LUIS POTOSÍ,24,TANLAJÁS,041,SANTA ROSA,3,110,44,66,7
SAN LUIS POTOSÍ,24,TANLAJÁS,041,TANCOLOL,3,250,111,139,19
SAN LUIS POTOSÍ,24,TANLAJÁS,041,TANLAJÁS,6,1108,549,559,44
SAN LUIS POTOSÍ,24,TANLAJÁS,041,TIZOAPATZ,2,33,15,18,3
SAN LUIS POTOSÍ,24,TANLAJÁS,041,TRES CRUCES,3,140,73,67,9
SAN LUIS POTOSÍ,24,TANQUIÁN DE ESCOBEDO,042,BUENAVISTA,3,59,29,30,3
SAN LUIS POTOSÍ,24,TANQUIÁN DE ESCOBEDO,042,EL BASUCHE,3,61,28,33,5
SAN LUIS POTOSÍ,24,TANQUIÁN DE ESCOBEDO,042,EL CERRITO,3,52,21,31,3
SAN LUIS POTOSÍ,24,TANQUIÁN DE ESCOBEDO,042,EL GAVIAL,3,54,25,29,4
SAN LUIS POTOSÍ,24,TANQUIÁN DE ESCOBEDO,042,EL OJITAL,2,23,12,11,2
SAN LUIS POTOSÍ,24,TANQUIÁN DE ESCOBEDO,042,LA HERRADURA,2,14,7,7,2
SAN LUIS POTOSÍ,24,TANQUIÁN DE ESCOBEDO,042,LAS LOMAS,3,147,73,74,9
SAN LUIS POTOSÍ,24,TANQUIÁN DE ESCOBEDO,042,SAGRADA FAMILIA,3,134,68,66,10
SAN LUIS POTOSÍ,24,TANQUIÁN DE ESCOBEDO,042,TAMPICOL,3,55,29,26,3
SAN LUIS POTOSÍ,24,TANQUIÁN DE ESCOBEDO,042,TANQUIÁN DE ESCOBEDO,17,2853,1435,1418,170
SAN LUIS POTOSÍ,24,TIERRA NUEVA,043,BARRIO DE SANTIAGO,2,55,26,29,3
SAN LUIS POTOSÍ,24,TIERRA NUEVA,043,CAÑADA DEL PALMAR,2,6,4,2,1
SAN LUIS POTOSÍ,24,TIERRA NUEVA,043,CERRO DE LA VIRGEN,2,29,14,15,2
SAN LUIS POTOSÍ,24,TIERRA NUEVA,043,CHARCOS,3,297,146,151,16
SAN LUIS POTOSÍ,24,TIERRA NUEVA,043,EL CAMARÓN,2,18,11,7,2
SAN LUIS POTOSÍ,24,TIERRA NUEVA,043,EL DIVISADERO,2,4,1,3,2
SAN LUIS POTOSÍ,24,TIERRA NUEVA,043,EL NOGALITO,1,3,1,2,1
SAN LUIS POTOSÍ,24,TIERRA NUEVA,043,EL PATOL,3,126,56,70,7
SAN LUIS POTOSÍ,24,TIERRA NUEVA,043,EL PIQUÍN,1,11,7,4,1
SAN LUIS POTOSÍ,24,TIERRA NUEVA,043,FRACCIÓN DE HACIENDA VIEJA,3,116,48,68,7
SAN LUIS POTOSÍ,24,TIERRA NUEVA,043,LA ORDEÑITA,2,8,2,6,1
SAN LUIS POTOSÍ,24,TIERRA NUEVA,043,LOS LOBOS,4,97,38,59,8
SAN LUIS POTOSÍ,24,TIERRA NUEVA,043,PASO DEL BALCÓN,3,47,18,29,4
SAN LUIS POTOSÍ,24,TIERRA NUEVA,043,SANTA ROSA,2,6,2,4,1
SAN LUIS POTOSÍ,24,TIERRA NUEVA,043,TIERRA NUEVA,13,1574,827,747,84
SAN LUIS POTOSÍ,24,VANEGAS,044,CUATRO MILPAS,3,32,19,13,3
SAN LUIS POTOSÍ,24,VANEGAS,044,EL GALLO,3,52,22,30,4
SAN LUIS POTOSÍ,24,VANEGAS,044,EL SALADO (ESTACIÓN EL SALADO),3,22,5,17,3
SAN LUIS POTOSÍ,24,VANEGAS,044,EL SALTO COLORADO,2,18,9,9,2
SAN LUIS POTOSÍ,24,VANEGAS,044,EL TEPETATE,4,223,117,106,15
SAN LUIS POTOSÍ,24,VANEGAS,044,HUERTECILLAS,3,70,32,38,4
SAN LUIS POTOSÍ,24,VANEGAS,044,LA NORIA DE JESÚS,3,52,28,24,5
SAN LUIS POTOSÍ,24,VANEGAS,044,LA PINTA,2,43,18,25,3
SAN LUIS POTOSÍ,24,VANEGAS,044,LA PUNTA (SAN JOSÉ DE LA PUNTA),3,73,41,32,4
SAN LUIS POTOSÍ,24,VANEGAS,044,LA SABANILLA,2,10,6,4,1
SAN LUIS POTOSÍ,24,VANEGAS,044,LA TRUEBA,3,13,3,10,2
SAN LUIS POTOSÍ,24,VANEGAS,044,NORIA DE LOS CEDROS,2,11,6,5,1
SAN LUIS POTOSÍ,24,VANEGAS,044,SALITRILLOS,3,14,4,10,2
SAN LUIS POTOSÍ,24,VANEGAS,044,SAN JUAN DE VANEGAS,3,61,33,28,4
SAN LUIS POTOSÍ,24,VANEGAS,044,SAN VICENTE,3,72,37,35,5
SAN LUIS POTOSÍ,24,VANEGAS,044,SANTA TERESA,2,11,5,6,1
SAN LUIS POTOSÍ,24,VANEGAS,044,TANQUE DE LÓPEZ,2,16,8,8,2
SAN LUIS POTOSÍ,24,VANEGAS,044,VANEGAS,7,698,344,354,41
SAN LUIS POTOSÍ,24,VANEGAS,044,VANEGAS DE ABAJO,3,97,51,46,6
SAN LUIS POTOSÍ,24,VANEGAS,044,ZARAGOZA (LA VACA),3,136,66,70,8
SAN LUIS POTOSÍ,24,VENADO,045,BARRIO DE GUADALUPE,2,25,11,14,2
SAN LUIS POTOSÍ,24,VENADO,045,BARRIO DE GUADALUPE DOS (MEXIQUITO),1,4,3,1,1
SAN LUIS POTOSÍ,24,VENADO,045,BUENAVISTA,3,22,5,17,3
SAN LUIS POTOSÍ,24,VENADO,045,CAÑADA GRANDE,2,15,12,3,2
SAN LUIS POTOSÍ,24,VENADO,045,CERRO BLANCO,2,3,0,3,1
SAN LUIS POTOSÍ,24,VENADO,045,CINCO DE FEBRERO,3,29,19,10,3
SAN LUIS POTOSÍ,24,VENADO,045,CINCO DE MAYO,2,14,7,7,2
SAN LUIS POTOSÍ,24,VENADO,045,CORONADO (HACIENDA DE CORONADO),3,56,34,22,4
SAN LUIS POTOSÍ,24,VENADO,045,DON DIEGO,3,31,14,17,3
SAN LUIS POTOSÍ,24,VENADO,045,EJIDO EL SALERO,1,5,4,1,1
SAN LUIS POTOSÍ,24,VENADO,045,EL CHARQUILLO,2,4,1,3,1
SAN LUIS POTOSÍ,24,VENADO,045,EL EPAZOTE,3,100,57,43,6
SAN LUIS POTOSÍ,24,VENADO,045,EL GATEADO,2,8,2,6,2
SAN LUIS POTOSÍ,24,VENADO,045,EL LAUREL,3,49,24,25,5
SAN LUIS POTOSÍ,24,VENADO,045,EL MATORRAL,3,19,4,15,3
SAN LUIS POTOSÍ,24,VENADO,045,EL POZOTE,2,6,2,4,1
SAN LUIS POTOSÍ,24,VENADO,045,EL RANCHITO,3,46,21,25,4
SAN LUIS POTOSÍ,24,VENADO,045,EL REBAJE,3,29,12,17,3
SAN LUIS POTOSÍ,24,VENADO,045,EL SALERO,4,33,13,20,4
SAN LUIS POTOSÍ,24,VENADO,045,EL SALITRE,3,44,23,21,4
SAN LUIS POTOSÍ,24,VENADO,045,EL SOTOL,3,28,14,14,3
SAN LUIS POTOSÍ,24,VENADO,045,EL TECOLOTE,2,18,8,10,2
SAN LUIS POTOSÍ,24,VENADO,045,GUANAMÉ,3,63,25,38,4
SAN LUIS POTOSÍ,24,VENADO,045,LA CIÉNAGA DE GUANAMÉ,2,35,18,17,3
SAN LUIS POTOSÍ,24,VENADO,045,LA PIEDRA,2,11,6,5,2
SAN LUIS POTOSÍ,24,VENADO,045,LA REFORMA,1,7,5,2,1
SAN LUIS POTOSÍ,24,VENADO,045,LA TRINIDAD,3,42,15,27,4
SAN LUIS POTOSÍ,24,VENADO,045,LOS REMEDIOS,3,30,9,21,3
SAN LUIS POTOSÍ,24,VENADO,045,NORIA DE SANTA TERESA,2,25,14,11,2
SAN LUIS POTOSÍ,24,VENADO,045,POLOCOTE DE ABAJO (POLOCOTILLO),2,10,6,4,1
SAN LUIS POTOSÍ,24,VENADO,045,POLOCOTE DE ARRIBA,3,70,38,32,5
SAN LUIS POTOSÍ,24,VENADO,045,SAN JOAQUÍN DE LAS FLORES,2,13,8,5,2
SAN LUIS POTOSÍ,24,VENADO,045,SAN PEDRO,3,21,10,11,3
SAN LUIS POTOSÍ,24,VENADO,045,SANTA RITA,3,83,42,41,6
SAN LUIS POTOSÍ,24,VENADO,045,TANQUE LA MILPA,3,11,7,4,3
SAN LUIS POTOSÍ,24,VENADO,045,TIERRA BLANCA,3,52,19,33,4
SAN LUIS POTOSÍ,24,VENADO,045,TOLEDO,1,4,3,1,1
SAN LUIS POTOSÍ,24,VENADO,045,VENADO,13,1968,950,1018,148
SAN LUIS POTOSÍ,24,VILLA DE ARRIAGA,046,COLONIA AQUILES CÓRDOVA MORÁN,2,18,11,7,4
SAN LUIS POTOSÍ,24,VILLA DE ARRIAGA,046,COLONIA EMILIANO ZAPATA,3,185,86,99,10
SAN LUIS POTOSÍ,24,VILLA DE ARRIAGA,046,COLONIA GUADALUPE VICTORIA (FÁTIMA),3,60,31,29,4
SAN LUIS POTOSÍ,24,VILLA DE ARRIAGA,046,COLONIA LA LABORCILLA,3,207,114,93,12
SAN LUIS POTOSÍ,24,VILLA DE ARRIAGA,046,COLONIA LA LUZ,3,80,35,45,5
SAN LUIS POTOSÍ,24,VILLA DE ARRIAGA,046,COLONIA LOS MANUELES,3,31,14,17,3
SAN LUIS POTOSÍ,24,VILLA DE ARRIAGA,046,COLONIA PALOMAS,3,157,66,91,10
SAN LUIS POTOSÍ,24,VILLA DE ARRIAGA,046,EL ÁGUILA,3,48,31,17,4
SAN LUIS POTOSÍ,24,VILLA DE ARRIAGA,046,EL JARDÍN,2,30,19,11,2
SAN LUIS POTOSÍ,24,VILLA DE ARRIAGA,046,EL JARDÍN DE LOS CUÉLLAR (PUERTA EL JARDÍN),1,9,3,6,1
SAN LUIS POTOSÍ,24,VILLA DE ARRIAGA,046,EL MEZQUITAL,3,32,17,15,3
SAN LUIS POTOSÍ,24,VILLA DE ARRIAGA,046,EL PALMAR (PUERTA DE LAS CHIVAS),1,4,0,4,1
SAN LUIS POTOSÍ,24,VILLA DE ARRIAGA,046,EL SAUCITO,3,25,15,10,3
SAN LUIS POTOSÍ,24,VILLA DE ARRIAGA,046,EL TEPETATE,4,345,165,180,18
SAN LUIS POTOSÍ,24,VILLA DE ARRIAGA,046,EL TROMPILLO,2,5,2,3,1
SAN LUIS POTOSÍ,24,VILLA DE ARRIAGA,046,FRANCISCO I. MADERO,3,41,24,17,3
SAN LUIS POTOSÍ,24,VILLA DE ARRIAGA,046,LA MOCHA,2,24,11,13,2
SAN LUIS POTOSÍ,24,VILLA DE ARRIAGA,046,LA PUERTA DEL REFUGIO,2,14,9,5,2
SAN LUIS POTOSÍ,24,VILLA DE ARRIAGA,046,OJO DE AGUA DE JUAN PÉREZ,1,3,2,1,1
SAN LUIS POTOSÍ,24,VILLA DE ARRIAGA,046,PROVIDENCIA,2,30,13,17,2
SAN LUIS POTOSÍ,24,VILLA DE ARRIAGA,046,PUERTO ESPINO,2,19,8,11,2
SAN LUIS POTOSÍ,24,VILLA DE ARRIAGA,046,SAN AGUSTÍN,2,57,21,36,4
SAN LUIS POTOSÍ,24,VILLA DE ARRIAGA,046,SAN ANTONIO,3,210,106,104,11
SAN LUIS POTOSÍ,24,VILLA DE ARRIAGA,046,SAN ELÍAS,2,27,12,15,3
SAN LUIS POTOSÍ,24,VILLA DE ARRIAGA,046,SAN FRANCISCO,4,421,236,185,25
SAN LUIS POTOSÍ,24,VILLA DE ARRIAGA,046,SAN JOSÉ DE LA PURÍSIMA,3,122,66,56,7
SAN LUIS POTOSÍ,24,VILLA DE ARRIAGA,046,SAN LUIS GONZAGA,3,223,113,110,11
SAN LUIS POTOSÍ,24,VILLA DE ARRIAGA,046,SAN MIGUELITO,2,8,2,6,1
SAN LUIS POTOSÍ,24,VILLA DE ARRIAGA,046,SANTA ROSA DE GALLINAS,3,274,139,135,13
SAN LUIS POTOSÍ,24,VILLA DE ARRIAGA,046,TANQUE DE SAN JUAN,2,5,2,3,1
SAN LUIS POTOSÍ,24,VILLA DE ARRIAGA,046,VILLA DE ARRIAGA,9,1821,932,889,94
SAN LUIS POTOSÍ,24,VILLA DE GUADALUPE,047,BUENAVISTA,3,37,27,10,4
SAN LUIS POTOSÍ,24,VILLA DE GUADALUPE,047,BUSTAMANTE (LAS TROJAS),1,8,7,1,1
SAN LUIS POTOSÍ,24,VILLA DE GUADALUPE,047,EL LEONCITO,2,50,28,22,3
SAN LUIS POTOSÍ,24,VILLA DE GUADALUPE,047,EL MATORRAL,2,6,1,5,1
SAN LUIS POTOSÍ,24,VILLA DE GUADALUPE,047,EL VENADITO,2,12,7,5,1
SAN LUIS POTOSÍ,24,VILLA DE GUADALUPE,047,EL VENADITO CHICO,2,9,7,2,1
SAN LUIS POTOSÍ,24,VILLA DE GUADALUPE,047,GUADALUPITO,4,116,54,62,8
SAN LUIS POTOSÍ,24,VILLA DE GUADALUPE,047,JARILLAS,3,41,26,15,4
SAN LUIS POTOSÍ,24,VILLA DE GUADALUPE,047,LA JOYA,2,24,10,14,2
SAN LUIS POTOSÍ,24,VILLA DE GUADALUPE,047,LA PRESA,2,20,10,10,2
SAN LUIS POTOSÍ,24,VILLA DE GUADALUPE,047,LA PRESITA,4,70,32,38,8
SAN LUIS POTOSÍ,24,VILLA DE GUADALUPE,047,LLANO DE JESÚS MARÍA,3,62,34,28,4
SAN LUIS POTOSÍ,24,VILLA DE GUADALUPE,047,LOS CHILARES,4,127,68,59,9
SAN LUIS POTOSÍ,24,VILLA DE GUADALUPE,047,MAGDALENAS,3,33,14,19,3
SAN LUIS POTOSÍ,24,VILLA DE GUADALUPE,047,MORELOS,2,4,2,2,1
SAN LUIS POTOSÍ,24,VILLA DE GUADALUPE,047,OJO DE AGUA DE RODRÍGUEZ,3,17,11,6,3
SAN LUIS POTOSÍ,24,VILLA DE GUADALUPE,047,PALO BLANCO,4,138,73,65,8
SAN LUIS POTOSÍ,24,VILLA DE GUADALUPE,047,PUERTO DE MAGDALENA,2,6,4,2,1
SAN LUIS POTOSÍ,24,VILLA DE GUADALUPE,047,RANCHO ALEGRE,3,65,31,34,4
SAN LUIS POTOSÍ,24,VILLA DE GUADALUPE,047,SAN ANTONIO DE LA ORDEÑA,3,25,15,10,4
SAN LUIS POTOSÍ,24,VILLA DE GUADALUPE,047,SAN BARTOLO,3,33,17,16,3
SAN LUIS POTOSÍ,24,VILLA DE GUADALUPE,047,SAN FRANCISCO,3,110,57,53,6
SAN LUIS POTOSÍ,24,VILLA DE GUADALUPE,047,SAN JOSÉ DE LA PEÑA,2,10,3,7,1
SAN LUIS POTOSÍ,24,VILLA DE GUADALUPE,047,SAN JOSÉ DEL MUERTO,3,23,8,15,3
SAN LUIS POTOSÍ,24,VILLA DE GUADALUPE,047,SAN JUDAS,3,47,24,23,4
SAN LUIS POTOSÍ,24,VILLA DE GUADALUPE,047,SANTA ISABEL (EL POZO),3,43,18,25,4
SAN LUIS POTOSÍ,24,VILLA DE GUADALUPE,047,SANTA MARÍA DEL RINCÓN (EL GUAJOLOTE),3,20,10,10,4
SAN LUIS POTOSÍ,24,VILLA DE GUADALUPE,047,SANTA RITA DE CASIA,2,30,14,16,2
SAN LUIS POTOSÍ,24,VILLA DE GUADALUPE,047,SANTA RITA DE LOS HERNÁNDEZ,3,69,31,38,4
SAN LUIS POTOSÍ,24,VILLA DE GUADALUPE,047,SANTA ROSA LA MASITA,3,161,78,83,8
SAN LUIS POTOSÍ,24,VILLA DE GUADALUPE,047,SANTA ROSALÍA DEL CENTRO,2,14,6,8,2
SAN LUIS POTOSÍ,24,VILLA DE GUADALUPE,047,SANTA TERESA,3,112,55,57,8
SAN LUIS POTOSÍ,24,VILLA DE GUADALUPE,047,TANQUE EL REFUGIO,1,6,2,4,1
SAN LUIS POTOSÍ,24,VILLA DE GUADALUPE,047,VALLEJOS,2,12,6,6,1
SAN LUIS POTOSÍ,24,VILLA DE GUADALUPE,047,VILLA DE GUADALUPE,4,317,166,151,21
SAN LUIS POTOSÍ,24,VILLA DE GUADALUPE,047,ZARAGOZA DE SOLÍS,4,193,92,101,12
SAN LUIS POTOSÍ,24,VILLA DE LA PAZ,048,EL CARMEN,1,5,3,2,1
SAN LUIS POTOSÍ,24,VILLA DE LA PAZ,048,EL JATO,2,13,6,7,2
SAN LUIS POTOSÍ,24,VILLA DE LA PAZ,048,LA BOCA,2,45,25,20,3
SAN LUIS POTOSÍ,24,VILLA DE LA PAZ,048,LAURELES,3,26,16,10,3
SAN LUIS POTOSÍ,24,VILLA DE LA PAZ,048,LIMONES,3,55,26,29,5
SAN LUIS POTOSÍ,24,VILLA DE LA PAZ,048,LOS NAZARIOS,2,26,14,12,3
SAN LUIS POTOSÍ,24,VILLA DE LA PAZ,048,SAN ANTONIO DE LAS TROJES,3,36,15,21,4
SAN LUIS POTOSÍ,24,VILLA DE LA PAZ,048,VILLA DE LA PAZ,7,1073,543,530,65
SAN LUIS POTOSÍ,24,VILLA DE RAMOS,049,AGUA NUEVA,3,15,8,7,2
SAN LUIS POTOSÍ,24,VILLA DE RAMOS,049,BUENAVISTA (LOS ARENALITOS),2,6,1,5,1
SAN LUIS POTOSÍ,24,VILLA DE RAMOS,049,DULCE GRANDE,8,1687,854,833,72
SAN LUIS POTOSÍ,24,VILLA DE RAMOS,049,EL BARRIL,8,1010,536,474,58
SAN LUIS POTOSÍ,24,VILLA DE RAMOS,049,EL DURAZNILLO,3,46,24,22,4
SAN LUIS POTOSÍ,24,VILLA DE RAMOS,049,EL NARANJAL,3,61,31,30,5
SAN LUIS POTOSÍ,24,VILLA DE RAMOS,049,EL TORO,6,210,104,106,13
SAN LUIS POTOSÍ,24,VILLA DE RAMOS,049,EL ZACATÓN,9,1284,659,625,60
SAN LUIS POTOSÍ,24,VILLA DE RAMOS,049,EMILIANO ZAPATA,3,97,50,47,5
SAN LUIS POTOSÍ,24,VILLA DE RAMOS,049,HERNÁNDEZ,4,334,169,165,15
SAN LUIS POTOSÍ,24,VILLA DE RAMOS,049,LA CONCEPCIÓN,3,102,57,45,5
SAN LUIS POTOSÍ,24,VILLA DE RAMOS,049,LA DULCITA,3,278,134,144,13
SAN LUIS POTOSÍ,24,VILLA DE RAMOS,049,LA ESPERANZA,2,6,5,1,1
SAN LUIS POTOSÍ,24,VILLA DE RAMOS,049,LA HEDIONDILLA,1,8,5,3,1
SAN LUIS POTOSÍ,24,VILLA DE RAMOS,049,LA HERRADURA,5,660,347,313,37
SAN LUIS POTOSÍ,24,VILLA DE RAMOS,049,LAGUNILLAS,3,38,19,19,4
SAN LUIS POTOSÍ,24,VILLA DE RAMOS,049,LAS ÁNIMAS Y ANEXAS,1,14,8,6,1
SAN LUIS POTOSÍ,24,VILLA DE RAMOS,049,NORIA DEL GATO,3,64,34,30,4
SAN LUIS POTOSÍ,24,VILLA DE RAMOS,049,NUEVO SAN FRANCISCO,2,43,20,23,3
SAN LUIS POTOSÍ,24,VILLA DE RAMOS,049,POZO BLANCO,4,191,93,98,13
SAN LUIS POTOSÍ,24,VILLA DE RAMOS,049,RANCHO NUEVO,3,31,15,16,3
SAN LUIS POTOSÍ,24,VILLA DE RAMOS,049,RANCHO SECO,3,43,24,19,5
SAN LUIS POTOSÍ,24,VILLA DE RAMOS,049,RANCHO TORRES,1,18,12,6,1
SAN LUIS POTOSÍ,24,VILLA DE RAMOS,049,SALITRAL DE CARRERA,5,662,352,310,38
SAN LUIS POTOSÍ,24,VILLA DE RAMOS,049,SAN CIPRIANO,3,129,68,61,6
SAN LUIS POTOSÍ,24,VILLA DE RAMOS,049,SAN DIONISIO,1,6,3,3,1
SAN LUIS POTOSÍ,24,VILLA DE RAMOS,049,SAN FELIPE (SAN PEDRO),3,13,10,3,3
SAN LUIS POTOSÍ,24,VILLA DE RAMOS,049,SAN FRANCISCO,4,207,103,104,13
SAN LUIS POTOSÍ,24,VILLA DE RAMOS,049,SAN MARTÍN,3,75,39,36,4
SAN LUIS POTOSÍ,24,VILLA DE RAMOS,049,SAN PABLO,3,107,58,49,6
SAN LUIS POTOSÍ,24,VILLA DE RAMOS,049,SAN PEDRO DEL SALTITO,3,30,15,15,3
SAN LUIS POTOSÍ,24,VILLA DE RAMOS,049,SAN RAFAEL,3,40,22,18,3
SAN LUIS POTOSÍ,24,VILLA DE RAMOS,049,SANTA ANA,3,43,20,23,3
SAN LUIS POTOSÍ,24,VILLA DE RAMOS,049,SANTA LUCÍA,3,233,119,114,11
SAN LUIS POTOSÍ,24,VILLA DE RAMOS,049,SAUZ DE CALERA,3,249,122,127,11
SAN LUIS POTOSÍ,24,VILLA DE RAMOS,049,VILLA DE RAMOS,6,1228,688,540,56
SAN LUIS POTOSÍ,24,VILLA DE RAMOS,049,YOLIÁTL,3,106,49,57,5
SAN LUIS POTOSÍ,24,VILLA DE REYES,050,ALBERTO CARRERA TORRES,3,325,152,173,16
SAN LUIS POTOSÍ,24,VILLA DE REYES,050,ARROYO BLANCO,3,84,43,41,5
SAN LUIS POTOSÍ,24,VILLA DE REYES,050,BLEDOS,4,486,253,233,29
SAN LUIS POTOSÍ,24,VILLA DE REYES,050,BOCA DE SANTIAGO,3,59,40,19,4
SAN LUIS POTOSÍ,24,VILLA DE REYES,050,CABRAS,3,50,27,23,3
SAN LUIS POTOSÍ,24,VILLA DE REYES,050,CAÑÓN DE BLEDOS,2,16,8,8,2
SAN LUIS POTOSÍ,24,VILLA DE REYES,050,CARRANCO,4,658,351,307,35
SAN LUIS POTOSÍ,24,VILLA DE REYES,050,EL ÁLAMO (ALAMITOS),1,3,0,3,1
SAN LUIS POTOSÍ,24,VILLA DE REYES,050,EL CENTENARIO,2,130,72,58,6
SAN LUIS POTOSÍ,24,VILLA DE REYES,050,EL MIRADOR,2,207,110,97,9
SAN LUIS POTOSÍ,24,VILLA DE REYES,050,EL ROSARIO,5,890,447,443,46
SAN LUIS POTOSÍ,24,VILLA DE REYES,050,EL TEJOCOTE DE SAN MIGUEL,4,236,122,114,12
SAN LUIS POTOSÍ,24,VILLA DE REYES,050,EL VERDE,1,5,1,4,1
SAN LUIS POTOSÍ,24,VILLA DE REYES,050,EMILIANO ZAPATA,3,436,212,224,24
SAN LUIS POTOSÍ,24,VILLA DE REYES,050,ESTACIÓN VILLA DE REYES,1,119,58,61,6
SAN LUIS POTOSÍ,24,VILLA DE REYES,050,ESTANCIA DE CALDERÓN,3,278,132,146,13
SAN LUIS POTOSÍ,24,VILLA DE REYES,050,GOGORRÓN VIEJO (EL POZO DEL CARMEN),3,452,212,240,23
SAN LUIS POTOSÍ,24,VILLA DE REYES,050,GRANJA SAN MARTÍN (LAS CALERAS),2,33,18,15,2
SAN LUIS POTOSÍ,24,VILLA DE REYES,050,GUADIANA,3,230,100,130,12
SAN LUIS POTOSÍ,24,VILLA DE REYES,050,JESÚS MARÍA,2,66,31,35,3
SAN LUIS POTOSÍ,24,VILLA DE REYES,050,JIMÉNEZ,2,7,4,3,1
SAN LUIS POTOSÍ,24,VILLA DE REYES,050,LA BOQUILLA (LA PEQUEÑA IRRIGACIÓN),3,105,46,59,5
SAN LUIS POTOSÍ,24,VILLA DE REYES,050,LA CUEVA,2,18,9,9,2
SAN LUIS POTOSÍ,24,VILLA DE REYES,050,LA LAGUNITA DE LOS JASSO,2,17,7,10,2
SAN LUIS POTOSÍ,24,VILLA DE REYES,050,LA LOMA DEL TEJOCOTE (LA LOMA),3,87,40,47,4
SAN LUIS POTOSÍ,24,VILLA DE REYES,050,LA LOMITA,2,8,6,2,1
SAN LUIS POTOSÍ,24,VILLA DE REYES,050,LA PRESA (LA PRESITA),3,354,176,178,18
SAN LUIS POTOSÍ,24,VILLA DE REYES,050,LA PUERTA DE SAN ANTONIO,3,81,41,40,5
SAN LUIS POTOSÍ,24,VILLA DE REYES,050,LA RINCONEÑA,2,9,5,4,2
SAN LUIS POTOSÍ,24,VILLA DE REYES,050,LA VENTILLA,4,478,249,229,26
SAN LUIS POTOSÍ,24,VILLA DE REYES,050,LAGUNA DE SAN VICENTE,5,853,428,425,46
SAN LUIS POTOSÍ,24,VILLA DE REYES,050,LAS GUALUPAS,1,48,18,30,2
SAN LUIS POTOSÍ,24,VILLA DE REYES,050,LAS RUSIAS (CUESILLO),3,94,52,42,5
SAN LUIS POTOSÍ,24,VILLA DE REYES,050,MACHADO,3,153,69,84,8
SAN LUIS POTOSÍ,24,VILLA DE REYES,050,MALINTO,3,83,46,37,4
SAN LUIS POTOSÍ,24,VILLA DE REYES,050,OJO DE AGUA DEL GATO,3,114,62,52,6
SAN LUIS POTOSÍ,24,VILLA DE REYES,050,PALOMAS,2,79,45,34,5
SAN LUIS POTOSÍ,24,VILLA DE REYES,050,PARDO,5,976,473,503,41
SAN LUIS POTOSÍ,24,VILLA DE REYES,050,PLAN DE SAN LUIS DE BLEDOS,3,67,32,35,6
SAN LUIS POTOSÍ,24,VILLA DE REYES,050,PRESA DEL ORGANITO,2,48,24,24,3
SAN LUIS POTOSÍ,24,VILLA DE REYES,050,PRESA SAN AGUSTÍN,3,147,70,77,7
SAN LUIS POTOSÍ,24,VILLA DE REYES,050,PUENTE DE TIERRA,2,40,25,15,2
SAN LUIS POTOSÍ,24,VILLA DE REYES,050,RODRIGO,3,438,219,219,23
SAN LUIS POTOSÍ,24,VILLA DE REYES,050,SAN LORENZO,3,290,139,151,14
SAN LUIS POTOSÍ,24,VILLA DE REYES,050,SAN MIGUEL,3,224,104,120,12
SAN LUIS POTOSÍ,24,VILLA DE REYES,050,SAUCILLO,4,662,347,315,37
SAN LUIS POTOSÍ,24,VILLA DE REYES,050,SAUCILLO DE BLEDOS,3,48,28,20,3
SAN LUIS POTOSÍ,24,VILLA DE REYES,050,SOCAVÓN (EL CARMEN),4,509,238,271,27
SAN LUIS POTOSÍ,24,VILLA DE REYES,050,VILLA DE REYES,22,5658,2854,2804,417
SAN LUIS POTOSÍ,24,VILLA HIDALGO,051,CORAZONES,3,40,18,22,3
SAN LUIS POTOSÍ,24,VILLA HIDALGO,051,CORCOVADA,3,373,183,190,20
SAN LUIS POTOSÍ,24,VILLA HIDALGO,051,EL ALJÍBER,2,10,4,6,1
SAN LUIS POTOSÍ,24,VILLA HIDALGO,051,EL COYOTE,3,108,56,52,5
SAN LUIS POTOSÍ,24,VILLA HIDALGO,051,EL LEONCITO,3,220,107,113,12
SAN LUIS POTOSÍ,24,VILLA HIDALGO,051,EL OJITO,3,76,33,43,5
SAN LUIS POTOSÍ,24,VILLA HIDALGO,051,EL POCITO,3,70,37,33,4
SAN LUIS POTOSÍ,24,VILLA HIDALGO,051,JAGÜEY,3,31,14,17,3
SAN LUIS POTOSÍ,24,VILLA HIDALGO,051,LA REDONDA,3,106,43,63,6
SAN LUIS POTOSÍ,24,VILLA HIDALGO,051,LA TAPONA,3,80,40,40,5
SAN LUIS POTOSÍ,24,VILLA HIDALGO,051,LAGUNILLAS,2,7,3,4,1
SAN LUIS POTOSÍ,24,VILLA HIDALGO,051,LLANO DEL CARMEN,3,44,15,29,4
SAN LUIS POTOSÍ,24,VILLA HIDALGO,051,PEDRERA DEL TANQUITO,3,93,43,50,5
SAN LUIS POTOSÍ,24,VILLA HIDALGO,051,PEOTILLOS,3,198,104,94,17
SAN LUIS POTOSÍ,24,VILLA HIDALGO,051,PRESA DE CHANCAQUERO,3,44,21,23,3
SAN LUIS POTOSÍ,24,VILLA HIDALGO,051,PRESITA DE LA CRUZ,3,36,18,18,3
SAN LUIS POTOSÍ,24,VILLA HIDALGO,051,RINCÓN DEL REFUGIO,2,7,2,5,1
SAN LUIS POTOSÍ,24,VILLA HIDALGO,051,SAN IGNACIO,2,15,3,12,2
SAN LUIS POTOSÍ,24,VILLA HIDALGO,051,SAN LORENZO,3,142,71,71,8
SAN LUIS POTOSÍ,24,VILLA HIDALGO,051,SAN NICOLÁS DEL REFUGIO,1,12,6,6,1
SAN LUIS POTOSÍ,24,VILLA HIDALGO,051,SILOS,4,140,65,75,9
SAN LUIS POTOSÍ,24,VILLA HIDALGO,051,TANQUE DE LUNA,3,73,31,42,5
SAN LUIS POTOSÍ,24,VILLA HIDALGO,051,TANQUE NUEVO,3,35,16,19,3
SAN LUIS POTOSÍ,24,VILLA HIDALGO,051,TANQUITO DE SAN FRANCISCO,3,100,50,50,5
SAN LUIS POTOSÍ,24,VILLA HIDALGO,051,VALLE DE SAN JUAN,3,66,32,34,5
SAN LUIS POTOSÍ,24,VILLA HIDALGO,051,VEINTE DE NOVIEMBRE,3,174,83,91,11
SAN LUIS POTOSÍ,24,VILLA HIDALGO,051,VENADITOS,3,35,15,20,3
SAN LUIS POTOSÍ,24,VILLA HIDALGO,051,VILLA HIDALGO,7,1221,628,593,59
SAN LUIS POTOSÍ,24,VILLA HIDALGO,051,ZAPOTILLO,3,61,29,32,4
SAN LUIS POTOSÍ,24,VILLA JUÁREZ,052,AGUA DEL MEDIO,3,63,25,38,4
SAN LUIS POTOSÍ,24,VILLA JUÁREZ,052,BUENAVISTA,2,10,4,6,1
SAN LUIS POTOSÍ,24,VILLA JUÁREZ,052,CARRIZAL,1,9,4,5,1
SAN LUIS POTOSÍ,24,VILLA JUÁREZ,052,EL COLORADO,3,14,7,7,2
SAN LUIS POTOSÍ,24,VILLA JUÁREZ,052,EL TEJOCOTE,2,12,9,3,2
SAN LUIS POTOSÍ,24,VILLA JUÁREZ,052,GRANJENAL,4,360,167,193,29
SAN LUIS POTOSÍ,24,VILLA JUÁREZ,052,GUAXCAMÁ,3,25,6,19,3
SAN LUIS POTOSÍ,24,VILLA JUÁREZ,052,JUAN DOMÍNGUEZ,2,8,4,4,1
SAN LUIS POTOSÍ,24,VILLA JUÁREZ,052,LA CARDONA,3,79,42,37,4
SAN LUIS POTOSÍ,24,VILLA JUÁREZ,052,LA GAVIA,3,85,45,40,5
SAN LUIS POTOSÍ,24,VILLA JUÁREZ,052,LAS FINCAS,2,14,7,7,2
SAN LUIS POTOSÍ,24,VILLA JUÁREZ,052,PALO SECO (EL GATO),3,282,144,138,17
SAN LUIS POTOSÍ,24,VILLA JUÁREZ,052,PUERTA DEL RÍO,3,96,41,55,5
SAN LUIS POTOSÍ,24,VILLA JUÁREZ,052,SAN ISIDRO,3,22,13,9,3
SAN LUIS POTOSÍ,24,VILLA JUÁREZ,052,SAN JOSÉ DEL MATORRAL,2,11,6,5,1
SAN LUIS POTOSÍ,24,VILLA JUÁREZ,052,SANTO DOMINGO,3,264,136,128,15
SAN LUIS POTOSÍ,24,VILLA JUÁREZ,052,VILLA JUÁREZ,5,769,400,369,41
SAN LUIS POTOSÍ,24,AXTLA DE TERRAZAS,053,AHUACATITLA,3,109,53,56,7
SAN LUIS POTOSÍ,24,AXTLA DE TERRAZAS,053,AMPLIACIÓN CUAYO BUENAVISTA,1,9,7,2,1
SAN LUIS POTOSÍ,24,AXTLA DE TERRAZAS,053,AXTLA DE TERRAZAS,20,2440,1285,1155,191
SAN LUIS POTOSÍ,24,AXTLA DE TERRAZAS,053,BARRIO EL TAMARINDO,2,25,18,7,3
SAN LUIS POTOSÍ,24,AXTLA DE TERRAZAS,053,CALCAHUAL,1,15,6,9,1
SAN LUIS POTOSÍ,24,AXTLA DE TERRAZAS,053,CHACUALA,4,320,158,162,25
SAN LUIS POTOSÍ,24,AXTLA DE TERRAZAS,053,CHIMALACO,3,173,89,84,10
SAN LUIS POTOSÍ,24,AXTLA DE TERRAZAS,053,COAMILA,2,398,193,205,15
SAN LUIS POTOSÍ,24,AXTLA DE TERRAZAS,053,COAMÍZATL,2,13,7,6,2
SAN LUIS POTOSÍ,24,AXTLA DE TERRAZAS,053,COATZONTITLA,3,182,91,91,13
SAN LUIS POTOSÍ,24,AXTLA DE TERRAZAS,053,COMOCA AHUACATITLA,2,32,16,16,3
SAN LUIS POTOSÍ,24,AXTLA DE TERRAZAS,053,COMUNIDAD LA PURÍSIMA,1,6,2,4,1
SAN LUIS POTOSÍ,24,AXTLA DE TERRAZAS,053,COMUNIDAD PICHOLCO (PICHOLCO VIEJO),1,19,8,11,1
SAN LUIS POTOSÍ,24,AXTLA DE TERRAZAS,053,COPALO (CHALCO),1,142,68,74,6
SAN LUIS POTOSÍ,24,AXTLA DE TERRAZAS,053,CUAYO (CHALCO),2,61,36,25,4
SAN LUIS POTOSÍ,24,AXTLA DE TERRAZAS,053,CUAYO BUENAVISTA,3,52,23,29,4
SAN LUIS POTOSÍ,24,AXTLA DE TERRAZAS,053,CUAYO CERRO,3,89,42,47,4
SAN LUIS POTOSÍ,24,AXTLA DE TERRAZAS,053,CUIXCOATITLA (CHALCO),3,181,90,91,12
SAN LUIS POTOSÍ,24,AXTLA DE TERRAZAS,053,EL AQUICHAL,3,79,37,42,6
SAN LUIS POTOSÍ,24,AXTLA DE TERRAZAS,053,EL CERRO,2,5,2,3,1
SAN LUIS POTOSÍ,24,AXTLA DE TERRAZAS,053,EL RINCÓN,2,19,9,10,2
SAN LUIS POTOSÍ,24,AXTLA DE TERRAZAS,053,ENSENADA (CHALCO),2,38,19,19,2
SAN LUIS POTOSÍ,24,AXTLA DE TERRAZAS,053,FRACCIÓN AHUEHUEYO,1,5,0,5,1
SAN LUIS POTOSÍ,24,AXTLA DE TERRAZAS,053,JALPILLA,8,1364,683,681,86
SAN LUIS POTOSÍ,24,AXTLA DE TERRAZAS,053,LA GARITA,2,32,17,15,3
SAN LUIS POTOSÍ,24,AXTLA DE TERRAZAS,053,LA LAJA,2,104,53,51,8
SAN LUIS POTOSÍ,24,AXTLA DE TERRAZAS,053,LA LIBERTAD (EJIDO LA LIBERTAD),2,34,18,16,2
SAN LUIS POTOSÍ,24,AXTLA DE TERRAZAS,053,LA PURÍSIMA,3,137,77,60,10
SAN LUIS POTOSÍ,24,AXTLA DE TERRAZAS,053,LAS CUEVAS,4,127,70,57,10
SAN LUIS POTOSÍ,24,AXTLA DE TERRAZAS,053,MAPOTLA,2,43,25,18,2
SAN LUIS POTOSÍ,24,AXTLA DE TERRAZAS,053,MATLALAPA,2,16,5,11,2
SAN LUIS POTOSÍ,24,AXTLA DE TERRAZAS,053,MICHOTLAYO (CHALCO),2,62,37,25,5
SAN LUIS POTOSÍ,24,AXTLA DE TERRAZAS,053,NUEVO AYOTOXCO,4,132,67,65,9
SAN LUIS POTOSÍ,24,AXTLA DE TERRAZAS,053,OTLASXUACO,2,10,6,4,2
SAN LUIS POTOSÍ,24,AXTLA DE TERRAZAS,053,PAPATLAYO,2,11,9,2,2
SAN LUIS POTOSÍ,24,AXTLA DE TERRAZAS,053,PICHOLCO,3,211,110,101,12
SAN LUIS POTOSÍ,24,AXTLA DE TERRAZAS,053,RANCHO NUEVO,3,62,31,31,5
SAN LUIS POTOSÍ,24,AXTLA DE TERRAZAS,053,SANTA FE TEXACAL (CENTRO URBANO),5,310,164,146,19
SAN LUIS POTOSÍ,24,AXTLA DE TERRAZAS,053,TAMPOCHOCHO,5,326,149,177,22
SAN LUIS POTOSÍ,24,AXTLA DE TERRAZAS,053,TEMALACACO,5,448,218,230,28
SAN LUIS POTOSÍ,24,AXTLA DE TERRAZAS,053,TENEXCALCO (LA CEIBA),4,285,130,155,18
SAN LUIS POTOSÍ,24,AXTLA DE TERRAZAS,053,TENEXIO,3,186,92,94,14
SAN LUIS POTOSÍ,24,AXTLA DE TERRAZAS,053,VIEJO AYOTOXCO,2,34,13,21,2
SAN LUIS POTOSÍ,24,AXTLA DE TERRAZAS,053,XOCOYO (CHALCO),1,43,21,22,2
SAN LUIS POTOSÍ,24,AXTLA DE TERRAZAS,053,XOLOCO,4,247,119,128,18
SAN LUIS POTOSÍ,24,AXTLA DE TERRAZAS,053,ZACAYUHUAL,1,14,7,7,1
SAN LUIS POTOSÍ,24,AXTLA DE TERRAZAS,053,ZOJUALO (CHALCO),3,126,63,63,10
SAN LUIS POTOSÍ,24,XILITLA,054,AGUA DE LA PEÑA,3,33,13,20,4
SAN LUIS POTOSÍ,24,XILITLA,054,AGUA FIERRO,2,33,15,18,3
SAN LUIS POTOSÍ,24,XILITLA,054,AGUA PUERCA,2,29,13,16,2
SAN LUIS POTOSÍ,24,XILITLA,054,AHUACATLÁN DE JESÚS,4,427,217,210,28
SAN LUIS POTOSÍ,24,XILITLA,054,AHUAYO,2,45,21,24,3
SAN LUIS POTOSÍ,24,XILITLA,054,AHUEHUEYO,3,221,104,117,15
SAN LUIS POTOSÍ,24,XILITLA,054,AMAYO DE ZARAGOZA (PUERTO DE AMAYO),3,145,67,78,11
SAN LUIS POTOSÍ,24,XILITLA,054,APETZCO,3,240,121,119,16
SAN LUIS POTOSÍ,24,XILITLA,054,ARROYO SECO,2,18,11,7,2
SAN LUIS POTOSÍ,24,XILITLA,054,BARRIO DE CRISTO REY (APETZCO),2,68,36,32,4
SAN LUIS POTOSÍ,24,XILITLA,054,BUENAVISTA,6,180,87,93,14
SAN LUIS POTOSÍ,24,XILITLA,054,CAFETALES,1,33,16,17,2
SAN LUIS POTOSÍ,24,XILITLA,054,CERRO QUEBRADO,3,71,37,34,5
SAN LUIS POTOSÍ,24,XILITLA,054,CHICHIMIXTITLA,3,73,27,46,5
SAN LUIS POTOSÍ,24,XILITLA,054,CRUZTITLA,3,91,44,47,6
SAN LUIS POTOSÍ,24,XILITLA,054,CUÁHUATL,2,28,8,20,2
SAN LUIS POTOSÍ,24,XILITLA,054,CUARTILLO NUEVO,4,175,95,80,13
SAN LUIS POTOSÍ,24,XILITLA,054,CUARTILLO VIEJO,3,43,20,23,5
SAN LUIS POTOSÍ,24,XILITLA,054,EJIDO PEÑA BLANCA LIMONTITLA,4,142,74,68,9
SAN LUIS POTOSÍ,24,XILITLA,054,EJIDO XILITLILLA,1,11,6,5,1
SAN LUIS POTOSÍ,24,XILITLA,054,EL BALCÓN,2,26,9,17,2
SAN LUIS POTOSÍ,24,XILITLA,054,EL CAÑÓN,3,118,60,58,7
SAN LUIS POTOSÍ,24,XILITLA,054,EL CARRIZAL,1,16,8,8,1
SAN LUIS POTOSÍ,24,XILITLA,054,EL CEDRAL,2,13,6,7,2
SAN LUIS POTOSÍ,24,XILITLA,054,EL CHALAHUITE,2,33,20,13,3
SAN LUIS POTOSÍ,24,XILITLA,054,EL CORAZÓN DE MARÍA (EL CAMPAMENTO),2,32,12,20,3
SAN LUIS POTOSÍ,24,XILITLA,054,EL GRANADO,2,25,14,11,2
SAN LUIS POTOSÍ,24,XILITLA,054,EL JOBO,6,372,187,185,33
SAN LUIS POTOSÍ,24,XILITLA,054,EL LIMONCITO,2,15,6,9,2
SAN LUIS POTOSÍ,24,XILITLA,054,EL NACIMIENTO,3,44,26,18,4
SAN LUIS POTOSÍ,24,XILITLA,054,EL NARANJAL (LA CEIBA),4,193,106,87,13
SAN LUIS POTOSÍ,24,XILITLA,054,EL NARANJAL DOS,3,38,22,16,4
SAN LUIS POTOSÍ,24,XILITLA,054,EL PINO,4,69,28,41,5
SAN LUIS POTOSÍ,24,XILITLA,054,EL RETÉN,2,33,18,15,3
SAN LUIS POTOSÍ,24,XILITLA,054,EL RINCÓN,2,19,10,9,2
SAN LUIS POTOSÍ,24,XILITLA,054,EL RINCÓN DE ZACATIPA,2,19,8,11,2
SAN LUIS POTOSÍ,24,XILITLA,054,EL SABINO,4,176,85,91,12
SAN LUIS POTOSÍ,24,XILITLA,054,EL TÚNEL,2,15,8,7,2
SAN LUIS POTOSÍ,24,XILITLA,054,EL ZANCUDO,1,17,10,7,1
SAN LUIS POTOSÍ,24,XILITLA,054,ENCINAL UNO,1,15,9,6,1
SAN LUIS POTOSÍ,24,XILITLA,054,IXTACAMEL BUENOS AIRES,2,47,20,27,3
SAN LUIS POTOSÍ,24,XILITLA,054,IZTACAPA,6,500,231,269,35
SAN LUIS POTOSÍ,24,XILITLA,054,JOYITA DEL TRES,3,70,31,39,4
SAN LUIS POTOSÍ,24,XILITLA,054,LA BARRANCA,2,22,8,14,2
SAN LUIS POTOSÍ,24,XILITLA,054,LA CONCHITA,2,95,54,41,5
SAN LUIS POTOSÍ,24,XILITLA,054,LA ESCALERA,2,42,19,23,4
SAN LUIS POTOSÍ,24,XILITLA,054,LA FINCA,2,6,2,4,1
SAN LUIS POTOSÍ,24,XILITLA,054,LA GLORIA,2,25,13,12,3
SAN LUIS POTOSÍ,24,XILITLA,054,LA HERRADURA,7,341,167,174,22
SAN LUIS POTOSÍ,24,XILITLA,054,LA JOYA,3,41,17,24,5
SAN LUIS POTOSÍ,24,XILITLA,054,LA LOMA,4,53,28,25,5
SAN LUIS POTOSÍ,24,XILITLA,054,LA MOJONERA,2,12,6,6,2
SAN LUIS POTOSÍ,24,XILITLA,054,LA NUEVA INDEPENDENCIA,2,9,4,5,2
SAN LUIS POTOSÍ,24,XILITLA,054,LA PAGUA,1,4,2,2,1
SAN LUIS POTOSÍ,24,XILITLA,054,LA PALANGANA,2,15,4,11,2
SAN LUIS POTOSÍ,24,XILITLA,054,LA PALIZADA,2,10,5,5,2
SAN LUIS POTOSÍ,24,XILITLA,054,LA PALMA,6,99,47,52,8
SAN LUIS POTOSÍ,24,XILITLA,054,LA PUERTA DE LA ESPERANZA,2,16,10,6,2
SAN LUIS POTOSÍ,24,XILITLA,054,LA SILLETA,3,38,18,20,3
SAN LUIS POTOSÍ,24,XILITLA,054,LA TINAJA,2,80,41,39,4
SAN LUIS POTOSÍ,24,XILITLA,054,LA TRINIDAD,3,22,13,9,3
SAN LUIS POTOSÍ,24,XILITLA,054,LA VICTORIA,3,138,75,63,8
SAN LUIS POTOSÍ,24,XILITLA,054,LAS CRUCITAS,2,40,16,24,3
SAN LUIS POTOSÍ,24,XILITLA,054,LAS JOYAS,4,41,14,27,4
SAN LUIS POTOSÍ,24,XILITLA,054,LAS PALMAS,3,34,19,15,4
SAN LUIS POTOSÍ,24,XILITLA,054,LOS JARROS (AHUACATLÁN),2,9,3,6,2
SAN LUIS POTOSÍ,24,XILITLA,054,LOS JARROS (XILITLILLA),1,13,10,3,1
SAN LUIS POTOSÍ,24,XILITLA,054,LOS POCITOS,1,6,4,2,1
SAN LUIS POTOSÍ,24,XILITLA,054,MANTEYO,3,100,54,46,7
SAN LUIS POTOSÍ,24,XILITLA,054,MIRAMAR VIEJO,3,56,31,25,5
SAN LUIS POTOSÍ,24,XILITLA,054,MOLOXCO,2,15,9,6,1
SAN LUIS POTOSÍ,24,XILITLA,054,NUEVO MIRAMAR,6,167,79,88,13
SAN LUIS POTOSÍ,24,XILITLA,054,OLLITA DEL PINO,3,75,37,38,5
SAN LUIS POTOSÍ,24,XILITLA,054,OTLAXHUAYO,2,35,15,20,2
SAN LUIS POTOSÍ,24,XILITLA,054,PAGUAYO,1,5,3,2,1
SAN LUIS POTOSÍ,24,XILITLA,054,PEMOXCO,3,165,85,80,11
SAN LUIS POTOSÍ,24,XILITLA,054,PEÑA BLANCA,3,159,77,82,12
SAN LUIS POTOSÍ,24,XILITLA,054,PETATILLO,7,308,161,147,23
SAN LUIS POTOSÍ,24,XILITLA,054,PILAHUEHUEYO,2,16,8,8,2
SAN LUIS POTOSÍ,24,XILITLA,054,PILATENO,4,124,58,66,10
SAN LUIS POTOSÍ,24,XILITLA,054,PITZÓATL,1,30,17,13,2
SAN LUIS POTOSÍ,24,XILITLA,054,PLAN DE JUÁREZ,2,23,12,11,2
SAN LUIS POTOSÍ,24,XILITLA,054,POTRERILLOS,3,96,41,55,7
SAN LUIS POTOSÍ,24,XILITLA,054,POXTLA (LA EMPRESA),5,427,213,214,27
SAN LUIS POTOSÍ,24,XILITLA,054,PUERTO DE BELÉN,3,80,44,36,7
SAN LUIS POTOSÍ,24,XILITLA,054,PUERTO DE LA VICTORIA,3,17,7,10,3
SAN LUIS POTOSÍ,24,XILITLA,054,PUERTO ENCINAL,2,50,21,29,4
SAN LUIS POTOSÍ,24,XILITLA,054,PUERTO TLALETLA,4,438,212,226,20
SAN LUIS POTOSÍ,24,XILITLA,054,QUIRÁMBARO,3,22,11,11,3
SAN LUIS POTOSÍ,24,XILITLA,054,RANCHO LOS BARBECHOS,2,7,3,4,1
SAN LUIS POTOSÍ,24,XILITLA,054,RANCHO NUEVO,6,135,68,67,9
SAN LUIS POTOSÍ,24,XILITLA,054,SAN ANTONIO HUITZQUILICO (BARRIO CENTRO),4,145,74,71,10
SAN LUIS POTOSÍ,24,XILITLA,054,SAN ANTONIO XALCUAYO DOS,2,38,23,15,3
SAN LUIS POTOSÍ,24,XILITLA,054,SAN PEDRO HUITZQUILICO,6,642,331,311,36
SAN LUIS POTOSÍ,24,XILITLA,054,SAN RAFAEL,2,41,24,17,4
SAN LUIS POTOSÍ,24,XILITLA,054,SANTA ANITA,2,53,29,24,4
SAN LUIS POTOSÍ,24,XILITLA,054,SIERRA MOJADA,2,18,13,5,2
SAN LUIS POTOSÍ,24,XILITLA,054,SOLEDAD DE ZARAGOZA,3,131,67,64,9
SAN LUIS POTOSÍ,24,XILITLA,054,SORIANITO,1,20,8,12,2
SAN LUIS POTOSÍ,24,XILITLA,054,SUCHIAYO,1,14,7,7,1
SAN LUIS POTOSÍ,24,XILITLA,054,TECAYA UNO,4,41,21,20,4
SAN LUIS POTOSÍ,24,XILITLA,054,TEMASCALES,1,17,9,8,1
SAN LUIS POTOSÍ,24,XILITLA,054,TEPETZINTLA,2,31,12,19,3
SAN LUIS POTOSÍ,24,XILITLA,054,TIERRA BLANCA EJIDO,2,44,19,25,3
SAN LUIS POTOSÍ,24,XILITLA,054,TIERRA BLANCA FRACCIÓN,3,41,25,16,3
SAN LUIS POTOSÍ,24,XILITLA,054,TLACUAPA (TEMASCAL),3,206,102,104,13
SAN LUIS POTOSÍ,24,XILITLA,054,TLACUAPA PRIMERA SECCIÓN,2,23,13,10,3
SAN LUIS POTOSÍ,24,XILITLA,054,TLAHUILAPA,4,152,69,83,10
SAN LUIS POTOSÍ,24,XILITLA,054,TLAMAYA,4,125,58,67,10
SAN LUIS POTOSÍ,24,XILITLA,054,TLAMIMIL,2,43,20,23,3
SAN LUIS POTOSÍ,24,XILITLA,054,TLAPEXMECAYO,2,11,3,8,2
SAN LUIS POTOSÍ,24,XILITLA,054,UHAXUCO,3,85,48,37,6
SAN LUIS POTOSÍ,24,XILITLA,054,XALTIPA,3,79,38,41,5
SAN LUIS POTOSÍ,24,XILITLA,054,XILITLA,13,2557,1318,1239,131
SAN LUIS POTOSÍ,24,XILITLA,054,XILITLILLA,3,54,23,31,4
SAN LUIS POTOSÍ,24,XILITLA,054,XILOXOCHICO (EL CHICO),4,101,54,47,7
SAN LUIS POTOSÍ,24,XILITLA,054,XOCOYO,2,28,13,15,3
SAN LUIS POTOSÍ,24,XILITLA,054,ZACATIPA,4,143,72,71,10
SAN LUIS POTOSÍ,24,XILITLA,054,ZAPUYO,6,323,155,168,25
SAN LUIS POTOSÍ,24,ZARAGOZA,055,AGUA ZARCA,1,5,4,1,1
SAN LUIS POTOSÍ,24,ZARAGOZA,055,ALBERCA DE LA CRUZ,3,69,32,37,4
SAN LUIS POTOSÍ,24,ZARAGOZA,055,ALTAMIRA,2,15,8,7,2
SAN LUIS POTOSÍ,24,ZARAGOZA,055,ARREATES,2,27,14,13,2
SAN LUIS POTOSÍ,24,ZARAGOZA,055,ARROYO HONDO,2,31,14,17,2
SAN LUIS POTOSÍ,24,ZARAGOZA,055,CERRO GORDO,5,894,438,456,44
SAN LUIS POTOSÍ,24,ZARAGOZA,055,COAHUILA,3,39,22,17,5
SAN LUIS POTOSÍ,24,ZARAGOZA,055,COLONIA EL PEDREGAL,2,41,16,25,3
SAN LUIS POTOSÍ,24,ZARAGOZA,055,EL CARMEN,2,16,9,7,2
SAN LUIS POTOSÍ,24,ZARAGOZA,055,EMILIANO ZAPATA (EL TEPOZÁN),2,70,38,32,3
SAN LUIS POTOSÍ,24,ZARAGOZA,055,ESTANCO DEL CARMEN,3,28,12,16,3
SAN LUIS POTOSÍ,24,ZARAGOZA,055,INDEPENDENCIA (PATOL),3,54,27,27,5
SAN LUIS POTOSÍ,24,ZARAGOZA,055,JAMAY,3,137,64,73,8
SAN LUIS POTOSÍ,24,ZARAGOZA,055,KILÓMETRO 58,3,37,19,18,3
SAN LUIS POTOSÍ,24,ZARAGOZA,055,LA CALERA,3,90,43,47,5
SAN LUIS POTOSÍ,24,ZARAGOZA,055,LA ESPERANZA,4,648,338,310,28
SAN LUIS POTOSÍ,24,ZARAGOZA,055,LA ESTANCIA,3,94,47,47,5
SAN LUIS POTOSÍ,24,ZARAGOZA,055,LA MORENA,3,23,9,14,3
SAN LUIS POTOSÍ,24,ZARAGOZA,055,LA PARADA DEL ZARCIDO,3,115,63,52,7
SAN LUIS POTOSÍ,24,ZARAGOZA,055,LA SALITRERA,3,115,55,60,6
SAN LUIS POTOSÍ,24,ZARAGOZA,055,LAS RUSIAS,1,3,3,0,1
SAN LUIS POTOSÍ,24,ZARAGOZA,055,LOS MATÍAS,1,5,3,2,1
SAN LUIS POTOSÍ,24,ZARAGOZA,055,LOS PILARES,3,97,46,51,5
SAN LUIS POTOSÍ,24,ZARAGOZA,055,LOS TERREROS,2,16,7,9,2
SAN LUIS POTOSÍ,24,ZARAGOZA,055,PARADA DE LOS MARTÍNEZ,3,120,63,57,6
SAN LUIS POTOSÍ,24,ZARAGOZA,055,PILAR DE GUADALUPE,2,26,10,16,3
SAN LUIS POTOSÍ,24,ZARAGOZA,055,PUERTA DE LAS ANDANAS,3,25,12,13,4
SAN LUIS POTOSÍ,24,ZARAGOZA,055,RANCHITO DE LOS RIVERA,3,62,28,34,4
SAN LUIS POTOSÍ,24,ZARAGOZA,055,RINCÓN DE SANTA EDUWIGES,1,4,3,1,1
SAN LUIS POTOSÍ,24,ZARAGOZA,055,SAN FRANCISCO,3,151,66,85,8
SAN LUIS POTOSÍ,24,ZARAGOZA,055,SAN JOSÉ DE GÓMEZ,3,258,124,134,13
SAN LUIS POTOSÍ,24,ZARAGOZA,055,SANTO DOMINGO,3,209,105,104,11
SAN LUIS POTOSÍ,24,ZARAGOZA,055,TEXAS,3,197,94,103,11
SAN LUIS POTOSÍ,24,ZARAGOZA,055,VALLE DE LOS FANTASMAS,3,53,25,28,4
SAN LUIS POTOSÍ,24,ZARAGOZA,055,VILLA DE ZARAGOZA,14,3365,1700,1665,167
SAN LUIS POTOSÍ,24,ZARAGOZA,055,XOCONOXTLE,3,240,120,120,12
SAN LUIS POTOSÍ,24,VILLA DE ARISTA,056,BUENAVISTA,2,32,14,18,2
SAN LUIS POTOSÍ,24,VILLA DE ARISTA,056,CHARCO BLANCO,2,16,11,5,1
SAN LUIS POTOSÍ,24,VILLA DE ARISTA,056,CORAZÓN DE JESÚS,2,24,10,14,2
SAN LUIS POTOSÍ,24,VILLA DE ARISTA,056,DERRAMADEROS,4,439,220,219,21
SAN LUIS POTOSÍ,24,VILLA DE ARISTA,056,EL CHARQUITO,3,94,53,41,6
SAN LUIS POTOSÍ,24,VILLA DE ARISTA,056,EL MAGUEY DE EZQUEDA,2,28,17,11,2
SAN LUIS POTOSÍ,24,VILLA DE ARISTA,056,EL MAGUEY DE LIMONES,2,14,8,6,2
SAN LUIS POTOSÍ,24,VILLA DE ARISTA,056,EL MEZQUITE,4,441,236,205,25
SAN LUIS POTOSÍ,24,VILLA DE ARISTA,056,EL POZO,1,54,34,20,3
SAN LUIS POTOSÍ,24,VILLA DE ARISTA,056,EL TAJO,2,77,41,36,4
SAN LUIS POTOSÍ,24,VILLA DE ARISTA,056,GUARDARRAYA,2,127,64,63,8
SAN LUIS POTOSÍ,24,VILLA DE ARISTA,056,LA CECILIA,3,40,21,19,4
SAN LUIS POTOSÍ,24,VILLA DE ARISTA,056,LA ESCONDIDA,3,22,13,9,3
SAN LUIS POTOSÍ,24,VILLA DE ARISTA,056,LA PELOTERA (VENTA DEL CARMEN),3,53,27,26,4
SAN LUIS POTOSÍ,24,VILLA DE ARISTA,056,MILPAS,3,70,38,32,5
SAN LUIS POTOSÍ,24,VILLA DE ARISTA,056,PALMAS ANCHAS,1,9,7,2,1
SAN LUIS POTOSÍ,24,VILLA DE ARISTA,056,RINCÓN DE LEIJAS,3,79,37,42,5
SAN LUIS POTOSÍ,24,VILLA DE ARISTA,056,SALITRILLOS,4,169,85,84,11
SAN LUIS POTOSÍ,24,VILLA DE ARISTA,056,SAN ELÍAS,3,186,82,104,10
SAN LUIS POTOSÍ,24,VILLA DE ARISTA,056,SAN FIDEL,2,7,6,1,1
SAN LUIS POTOSÍ,24,VILLA DE ARISTA,056,SAN JOSÉ DEL ARBOLITO,4,207,95,112,15
SAN LUIS POTOSÍ,24,VILLA DE ARISTA,056,SAN PEDRO,3,44,23,21,3
SAN LUIS POTOSÍ,24,VILLA DE ARISTA,056,SAN RAFAEL,3,44,28,16,3
SAN LUIS POTOSÍ,24,VILLA DE ARISTA,056,VILLA DE ARISTA,8,1885,954,931,104
SAN LUIS POTOSÍ,24,MATLAPA,057,AGUACATITLA,2,200,108,92,11
SAN LUIS POTOSÍ,24,MATLAPA,057,AHUEHUEYO PRIMERO CENTRO,2,147,75,72,8
SAN LUIS POTOSÍ,24,MATLAPA,057,AHUEHUEYO SEGUNDO,1,771,505,266,34
SAN LUIS POTOSÍ,24,MATLAPA,057,ATLAMAXÁTL,5,226,108,118,13
SAN LUIS POTOSÍ,24,MATLAPA,057,BARRIO CHILTZAPOYO,3,58,24,34,5
SAN LUIS POTOSÍ,24,MATLAPA,057,BARRIO DE ARRIBA,3,762,383,379,24
SAN LUIS POTOSÍ,24,MATLAPA,057,BARRIO DE EN MEDIO,2,45,27,18,4
SAN LUIS POTOSÍ,24,MATLAPA,057,BARRIO SAN ISIDRO (TLAJUMPAL),3,43,21,22,4
SAN LUIS POTOSÍ,24,MATLAPA,057,BARRIO SAN JOSÉ (TLAJUMPAL),2,21,11,10,2
SAN LUIS POTOSÍ,24,MATLAPA,057,BARRIO SAN JUAN (TLAJUMPAL),2,35,14,21,2
SAN LUIS POTOSÍ,24,MATLAPA,057,CARBONERA COAQUENTLA,2,12,7,5,2
SAN LUIS POTOSÍ,24,MATLAPA,057,CHALCHITÉPETL,1,16,6,10,1
SAN LUIS POTOSÍ,24,MATLAPA,057,CHALCHOCOYO,6,754,385,369,44
SAN LUIS POTOSÍ,24,MATLAPA,057,COAQUENTLA,4,170,82,88,14
SAN LUIS POTOSÍ,24,MATLAPA,057,COPALCOATITLA (COPALO),1,13,5,8,1
SAN LUIS POTOSÍ,24,MATLAPA,057,COYOLO,2,18,7,11,2
SAN LUIS POTOSÍ,24,MATLAPA,057,CUAXILOTITLA,3,48,31,17,3
SAN LUIS POTOSÍ,24,MATLAPA,057,CUICHAPA,3,43,26,17,4
SAN LUIS POTOSÍ,24,MATLAPA,057,EJIDO MATLAPA MESTIZOS (COLONIA ESCALANAR),3,136,64,72,9
SAN LUIS POTOSÍ,24,MATLAPA,057,EL MANANTIAL,1,10,3,7,1
SAN LUIS POTOSÍ,24,MATLAPA,057,IGLESIA VIEJA,2,37,15,22,3
SAN LUIS POTOSÍ,24,MATLAPA,057,LA ISLA,2,35,19,16,3
SAN LUIS POTOSÍ,24,MATLAPA,057,LA PEÑITA (LA PEÑA),4,180,89,91,13
SAN LUIS POTOSÍ,24,MATLAPA,057,LA PROVIDENCIA,2,15,4,11,2
SAN LUIS POTOSÍ,24,MATLAPA,057,LOS TIGRES,2,23,10,13,2
SAN LUIS POTOSÍ,24,MATLAPA,057,MATLAPA,9,1434,713,721,79
SAN LUIS POTOSÍ,24,MATLAPA,057,NEQUEXPILOYA,1,75,36,39,6
SAN LUIS POTOSÍ,24,MATLAPA,057,NEXCUAYO,6,642,306,336,47
SAN LUIS POTOSÍ,24,MATLAPA,057,NEXCUAYO II,1,33,17,16,2
SAN LUIS POTOSÍ,24,MATLAPA,057,NUEVO TEPETZINTLA,2,43,26,17,3
SAN LUIS POTOSÍ,24,MATLAPA,057,OTLAYO,3,86,32,54,5
SAN LUIS POTOSÍ,24,MATLAPA,057,PAHUAYO PRIMERO,4,142,71,71,9
SAN LUIS POTOSÍ,24,MATLAPA,057,PAPATLAS,3,104,52,52,8
SAN LUIS POTOSÍ,24,MATLAPA,057,PILAXTLA,3,37,20,17,4
SAN LUIS POTOSÍ,24,MATLAPA,057,PILVEGA ATLAMAXÁTL,2,12,6,6,2
SAN LUIS POTOSÍ,24,MATLAPA,057,PITZOTEYO,2,51,31,20,3
SAN LUIS POTOSÍ,24,MATLAPA,057,SAJUANCO,1,25,11,14,3
SAN LUIS POTOSÍ,24,MATLAPA,057,SAN ANTONIO,3,162,92,70,11
SAN LUIS POTOSÍ,24,MATLAPA,057,SAN JOSÉ BARRIO ARRIBA,2,51,21,30,3
SAN LUIS POTOSÍ,24,MATLAPA,057,TAMALA,3,133,70,63,8
SAN LUIS POTOSÍ,24,MATLAPA,057,TANCUILÍN,4,111,49,62,8
SAN LUIS POTOSÍ,24,MATLAPA,057,TANCUILÍN (MANANTIALES),2,36,17,19,3
SAN LUIS POTOSÍ,24,MATLAPA,057,TEPETZINTLA,4,221,103,118,12
SAN LUIS POTOSÍ,24,MATLAPA,057,TERRERO COLORADO,3,134,68,66,8
SAN LUIS POTOSÍ,24,MATLAPA,057,TEXQUITOTE PRIMERO,3,102,57,45,8
SAN LUIS POTOSÍ,24,MATLAPA,057,TEXQUITOTE SEGUNDO,4,161,77,84,12
SAN LUIS POTOSÍ,24,MATLAPA,057,TEZONQUILILLO,3,83,39,44,6
SAN LUIS POTOSÍ,24,MATLAPA,057,TLACOHUAQUE,5,268,136,132,23
SAN LUIS POTOSÍ,24,MATLAPA,057,TLAMAXAC,2,31,18,13,3
SAN LUIS POTOSÍ,24,MATLAPA,057,TLAMAYA,1,54,24,30,4
SAN LUIS POTOSÍ,24,MATLAPA,057,TLAXCO,3,123,54,69,10
SAN LUIS POTOSÍ,24,MATLAPA,057,TZOPELACO,3,39,19,20,3
SAN LUIS POTOSÍ,24,MATLAPA,057,XALTIPA COAQUENTLA,2,66,34,32,4
SAN LUIS POTOSÍ,24,MATLAPA,057,XOCHITITLA,2,38,20,18,3
SAN LUIS POTOSÍ,24,MATLAPA,057,ZACARRINCÓN,1,15,8,7,1
SAN LUIS POTOSÍ,24,MATLAPA,057,ZACAYO,5,389,203,186,22
SAN LUIS POTOSÍ,24,EL NARANJO,058,CHUPADEROS,2,33,15,18,2
SAN LUIS POTOSÍ,24,EL NARANJO,058,COLONIA EL MECO,3,335,177,158,18
SAN LUIS POTOSÍ,24,EL NARANJO,058,COLONIA LAS GRANJAS,2,21,11,10,2
SAN LUIS POTOSÍ,24,EL NARANJO,058,COLONIA SALTO DEL AGUA,4,167,71,96,14
SAN LUIS POTOSÍ,24,EL NARANJO,058,EL AGUACATE,3,23,10,13,3
SAN LUIS POTOSÍ,24,EL NARANJO,058,EL LIMONAL,3,118,60,58,8
SAN LUIS POTOSÍ,24,EL NARANJO,058,EL NARANJITO,1,28,10,18,1
SAN LUIS POTOSÍ,24,EL NARANJO,058,EL NARANJO,14,2735,1387,1348,108
SAN LUIS POTOSÍ,24,EL NARANJO,058,EL PLATANITO,3,54,26,28,4
SAN LUIS POTOSÍ,24,EL NARANJO,058,EL SABINITO,5,478,237,241,27
SAN LUIS POTOSÍ,24,EL NARANJO,058,KILÓMETRO CUARENTA Y DOS,3,68,31,37,5
SAN LUIS POTOSÍ,24,EL NARANJO,058,LA CONCEPCIÓN,2,48,26,22,2
SAN LUIS POTOSÍ,24,EL NARANJO,058,LA MUTUA,1,16,9,7,1
SAN LUIS POTOSÍ,24,EL NARANJO,058,LA SOLEDAD,2,54,32,22,3
SAN LUIS POTOSÍ,24,EL NARANJO,058,LAS ABRITAS,3,30,15,15,3
SAN LUIS POTOSÍ,24,EL NARANJO,058,LOS ÁLAMOS,1,5,3,2,1
SAN LUIS POTOSÍ,24,EL NARANJO,058,LOS ÁLAMOS DE ABAJO,3,56,27,29,3
SAN LUIS POTOSÍ,24,EL NARANJO,058,LOS ÁLAMOS DE ARRIBA,3,26,11,15,4
SAN LUIS POTOSÍ,24,EL NARANJO,058,LOS CHARCOS DE ORIENTE,3,42,20,22,4
SAN LUIS POTOSÍ,24,EL NARANJO,058,MAGUEY DE ORIENTE,3,66,35,31,4
SAN LUIS POTOSÍ,24,EL NARANJO,058,MAITINEZ,4,329,158,171,21
SAN LUIS POTOSÍ,24,EL NARANJO,058,MINAS VIEJAS,3,174,90,84,9
SAN LUIS POTOSÍ,24,EL NARANJO,058,OJO DE AGUA DE TIERRA NUEVA,3,79,32,47,4
SAN LUIS POTOSÍ,24,EL NARANJO,058,RINCÓN DE ÁLAMOS,2,13,4,9,2
SAN LUIS POTOSÍ,24,VILLA DE POZOS,059,VILLA DE POZOS,1,283,149,134,12
SINALOA,25,AHOME,001,AGUA NUEVA,2,83,44,39,5
SINALOA,25,AHOME,001,ÁGUILA AZTECA,2,272,146,126,9
SINALOA,25,AHOME,001,AHOME,12,2744,1377,1367,148
SINALOA,25,AHOME,001,ALFONSO G. CALDERÓN (POBLADO SIETE),5,742,362,380,52
SINALOA,25,AHOME,001,BACAPOROBAMPO,3,121,62,59,6
SINALOA,25,AHOME,001,BACHOMOBAMPO NÚMERO DOS,4,329,171,158,39
SINALOA,25,AHOME,001,BACHOMOBAMPO NÚMERO UNO,2,127,51,76,8
SINALOA,25,AHOME,001,BACOREHUIS,4,572,278,294,32
SINALOA,25,AHOME,001,BAGOJO COLECTIVO,5,617,304,313,29
SINALOA,25,AHOME,001,BAGOJO DEL RÍO [BOMBAS ÁGUILA],2,74,38,36,4
SINALOA,25,AHOME,001,BOLSA DE TOSALIBAMPO DOS,2,92,42,50,6
SINALOA,25,AHOME,001,BOLSA DE TOSALIBAMPO UNO,5,295,162,133,35
SINALOA,25,AHOME,001,CACHOANA,2,120,65,55,5
SINALOA,25,AHOME,001,CAMAYECA,3,50,18,32,5
SINALOA,25,AHOME,001,CAMPO CLEYTON,2,16,6,10,2
SINALOA,25,AHOME,001,CAMPO GASTÉLUM,2,25,14,11,3
SINALOA,25,AHOME,001,CAMPO LA ARROCERA,2,315,150,165,15
SINALOA,25,AHOME,001,CERRILLOS (CAMPO 35),6,713,351,362,55
SINALOA,25,AHOME,001,CHIHUAHUITA,4,756,285,471,82
SINALOA,25,AHOME,001,CHOACAHUI,3,137,59,78,7
SINALOA,25,AHOME,001,CINCO DE MAYO,3,386,178,208,16
SINALOA,25,AHOME,001,COBAYME,3,51,25,26,5
SINALOA,25,AHOME,001,COHUIBAMPO,4,729,383,346,49
SINALOA,25,AHOME,001,COMPUERTAS,4,702,325,377,50
SINALOA,25,AHOME,001,DIECIOCHO DE MARZO,2,145,68,77,5
SINALOA,25,AHOME,001,DOLORES HIDALGO,2,37,24,13,3
SINALOA,25,AHOME,001,EJIDO 9 DE DICIEMBRE,7,1003,476,527,103
SINALOA,25,AHOME,001,EJIDO BENITO JUÁREZ,3,470,202,268,29
SINALOA,25,AHOME,001,EJIDO CUCHILLA DE CACHOANA,2,104,52,52,6
SINALOA,25,AHOME,001,EJIDO LOUISIANA,2,94,46,48,5
SINALOA,25,AHOME,001,EJIDO MACAPUL,4,511,251,260,32
SINALOA,25,AHOME,001,EJIDO MAYOCOBA,2,255,120,135,10
SINALOA,25,AHOME,001,EJIDO OHUIRA,5,572,276,296,24
SINALOA,25,AHOME,001,EJIDO PLAN DE GUADALUPE,3,84,35,49,6
SINALOA,25,AHOME,001,EJIDO PORVENIR VALLEJO,4,342,168,174,18
SINALOA,25,AHOME,001,EJIDO RICARDO FLORES MAGÓN,2,417,200,217,15
SINALOA,25,AHOME,001,EJIDO ROSENDO G. CASTRO,2,139,68,71,8
SINALOA,25,AHOME,001,EJIDO TOSALIBAMPO,4,334,170,164,17
SINALOA,25,AHOME,001,EL AGUAJITO,3,398,192,206,32
SINALOA,25,AHOME,001,EL ALHUATE,1,19,8,11,1
SINALOA,25,AHOME,001,EL AÑIL,2,40,17,23,3
SINALOA,25,AHOME,001,EL BULE,2,87,45,42,5
SINALOA,25,AHOME,001,EL CARDAL,3,24,8,16,3
SINALOA,25,AHOME,001,EL CHALATE,1,33,14,19,1
SINALOA,25,AHOME,001,EL COLORADO,5,792,382,410,37
SINALOA,25,AHOME,001,EL GUAYABO,3,362,192,170,27
SINALOA,25,AHOME,001,EL HECHO,2,39,19,20,3
SINALOA,25,AHOME,001,EL MOLINO,1,8,6,2,1
SINALOA,25,AHOME,001,EL PELUCHÍN,2,24,11,13,3
SINALOA,25,AHOME,001,EL PORVENIR,2,84,48,36,5
SINALOA,25,AHOME,001,EL RANCHITO,2,37,18,19,4
SINALOA,25,AHOME,001,EL REFUGIO,2,206,98,108,10
SINALOA,25,AHOME,001,EL SABINO,1,23,10,13,1
SINALOA,25,AHOME,001,EL TULE,2,64,30,34,4
SINALOA,25,AHOME,001,EL UNO,1,19,7,12,1
SINALOA,25,AHOME,001,EMIGDIO RUIZ,4,186,97,89,20
SINALOA,25,AHOME,001,FELIPE ÁNGELES,2,140,65,75,8
SINALOA,25,AHOME,001,FLOR AZUL,2,202,92,110,9
SINALOA,25,AHOME,001,GABRIEL LEYVA SOLANO (ZAPOTILLO DOS),4,542,274,268,38
SINALOA,25,AHOME,001,GOROS NÚMERO DOS,3,312,160,152,18
SINALOA,25,AHOME,001,GOROS PUEBLO,3,218,106,112,9
SINALOA,25,AHOME,001,GOROS VIEJO,2,31,14,17,3
SINALOA,25,AHOME,001,GUILLERMO CHÁVEZ TALAMANTES,4,388,183,205,32
SINALOA,25,AHOME,001,GUSTAVO DÍAZ ORDAZ (EL CARRIZO),12,2323,1187,1136,198
SINALOA,25,AHOME,001,HIGUERA DE ZARAGOZA,13,2606,1298,1308,153
SINALOA,25,AHOME,001,HUACAPORITO,3,93,41,52,6
SINALOA,25,AHOME,001,HUATABAMPITO,2,64,29,35,3
SINALOA,25,AHOME,001,JITZÁMURI,4,334,174,160,16
SINALOA,25,AHOME,001,JOSÉ MARÍA ROBLES QUINTERO,2,43,15,28,3
SINALOA,25,AHOME,001,LA BAJADA DE SAN MIGUEL,3,124,64,60,8
SINALOA,25,AHOME,001,LA CAPILLA,1,61,29,32,2
SINALOA,25,AHOME,001,LA DESPENSA,4,297,139,158,35
SINALOA,25,AHOME,001,LA FLORIDA VIEJA,1,38,17,21,2
SINALOA,25,AHOME,001,LA FORTUNA,2,39,23,16,3
SINALOA,25,AHOME,001,LAS GRULLAS MARGEN DERECHA,3,240,112,128,18
SINALOA,25,AHOME,001,LAS GRULLAS MARGEN IZQUIERDA,3,560,261,299,33
SINALOA,25,AHOME,001,LAS LAJITAS,4,233,107,126,14
SINALOA,25,AHOME,001,LAS QUINTAS,2,28,16,12,3
SINALOA,25,AHOME,001,LOS ALGODONES,2,51,22,29,3
SINALOA,25,AHOME,001,LOS MOCHIS,378,101159,54045,47114,6889
SINALOA,25,AHOME,001,LOS SUÁREZ,2,91,54,37,5
SINALOA,25,AHOME,001,MACAPUL [ALMACENES],3,243,118,125,19
SINALOA,25,AHOME,001,MÁRTIRES DE SINALOA DOS,1,14,7,7,1
SINALOA,25,AHOME,001,MATACAHUI (EL CAMPITO),2,27,15,12,3
SINALOA,25,AHOME,001,MOCHIS (EJIDO MOCHIS),5,1107,535,572,115
SINALOA,25,AHOME,001,NIÑOS HÉROES DE CHAPULTEPEC [ESTACIÓN FRANCISCO],2,30,17,13,3
SINALOA,25,AHOME,001,NUEVO SAN MIGUEL,4,550,295,255,31
SINALOA,25,AHOME,001,PAREDONES,4,239,123,116,12
SINALOA,25,AHOME,001,PLAN DE AYALA [CAMPO CINCO],2,167,87,80,8
SINALOA,25,AHOME,001,PLAN DE SAN LUIS,2,71,37,34,4
SINALOA,25,AHOME,001,POBLADO NÚMERO CINCO,4,348,166,182,29
SINALOA,25,AHOME,001,POBLADO NÚMERO SEIS (LOS NATOCHES),4,207,98,109,23
SINALOA,25,AHOME,001,PRIMERO DE MAYO,2,412,193,219,17
SINALOA,25,AHOME,001,REVOLUCIÓN MEXICANA,3,206,100,106,24
SINALOA,25,AHOME,001,SAN ISIDRO,3,232,104,128,9
SINALOA,25,AHOME,001,SAN ISIDRO VIEJO,1,18,5,13,1
SINALOA,25,AHOME,001,SAN JOSÉ DE AHOME,4,568,290,278,45
SINALOA,25,AHOME,001,SAN LORENZO VIEJO,1,24,13,11,1
SINALOA,25,AHOME,001,SAN MIGUEL ZAPOTITLÁN,7,2264,1113,1151,141
SINALOA,25,AHOME,001,SAN MIGUELITO,1,5,2,3,1
SINALOA,25,AHOME,001,SAN PABLO,4,250,120,130,14
SINALOA,25,AHOME,001,SANTA BÁRBARA (CABAIHUNACA),1,6,5,1,1
SINALOA,25,AHOME,001,SANTA TERESITA,1,21,12,9,2
SINALOA,25,AHOME,001,SINALOA DE LEYVA (EL VENADILLO),2,51,24,27,3
SINALOA,25,AHOME,001,TABELOJECA,4,220,106,114,13
SINALOA,25,AHOME,001,TOPOLOBAMPO,10,1580,740,840,178
SINALOA,25,AHOME,001,VENUSTIANO CARRANZA Y REFORMA,2,7,3,4,2
SINALOA,25,AHOME,001,ZAPOTILLO UNO (ZAPOTILLO VIEJO),3,337,167,170,25
SINALOA,25,ANGOSTURA,002,18 DE DICIEMBRE,3,58,31,27,5
SINALOA,25,ANGOSTURA,002,AGUSTINA RAMÍREZ,3,267,143,124,17
SINALOA,25,ANGOSTURA,002,ALHUEY,5,398,204,194,35
SINALOA,25,ANGOSTURA,002,ANGOSTURA,10,1860,976,884,99
SINALOA,25,ANGOSTURA,002,BATAMOTOS,3,57,26,31,6
SINALOA,25,ANGOSTURA,002,BATURY,5,236,107,129,14
SINALOA,25,ANGOSTURA,002,BRUNO BELTRÁN GARCÍA,2,46,18,28,3
SINALOA,25,ANGOSTURA,002,CAMPO EL GENERAL,2,83,38,45,4
SINALOA,25,ANGOSTURA,002,CAPOMOS,4,228,106,122,13
SINALOA,25,ANGOSTURA,002,CERRO DE LOS SÁNCHEZ,2,24,5,19,2
SINALOA,25,ANGOSTURA,002,CERRO SEGUNDO,1,3,1,2,1
SINALOA,25,ANGOSTURA,002,COLONIA AGRÍCOLA MÉXICO (PALMITAS),4,543,258,285,55
SINALOA,25,ANGOSTURA,002,COLONIA AGRÍCOLA SINALOA,2,84,40,44,4
SINALOA,25,ANGOSTURA,002,COLONIA INDEPENDENCIA (CHINITOS),5,942,442,500,64
SINALOA,25,ANGOSTURA,002,COSTA AZUL,5,335,165,170,30
SINALOA,25,ANGOSTURA,002,DÁMASO CÁRDENAS,2,24,8,16,2
SINALOA,25,ANGOSTURA,002,EJIDO INDEPENDENCIA,3,174,87,87,17
SINALOA,25,ANGOSTURA,002,EL BATALLÓN (EL BATALLÓN DE LOS PAYANES),1,5,2,3,1
SINALOA,25,ANGOSTURA,002,EL ÉBANO,4,234,95,139,15
SINALOA,25,ANGOSTURA,002,EL ENCANTO,1,1,0,1,1
SINALOA,25,ANGOSTURA,002,EL LLANO,2,46,21,25,4
SINALOA,25,ANGOSTURA,002,ESTACIÓN ACATITA,3,118,65,53,13
SINALOA,25,ANGOSTURA,002,GUSTAVO DÍAZ ORDAZ (CAMPO PLATA),5,284,128,156,33
SINALOA,25,ANGOSTURA,002,IGNACIO ALLENDE,2,40,21,19,2
SINALOA,25,ANGOSTURA,002,LA CERCADA,2,31,20,11,2
SINALOA,25,ANGOSTURA,002,LA COLORADA,1,22,12,10,2
SINALOA,25,ANGOSTURA,002,LA ESPERANZA,3,237,113,124,10
SINALOA,25,ANGOSTURA,002,LA ILAMA,2,18,12,6,2
SINALOA,25,ANGOSTURA,002,LA ISLETA,1,10,8,2,1
SINALOA,25,ANGOSTURA,002,LA PALMA,2,147,81,66,8
SINALOA,25,ANGOSTURA,002,LA PRIMAVERA,2,63,40,23,3
SINALOA,25,ANGOSTURA,002,LA REFORMA,10,1372,684,688,105
SINALOA,25,ANGOSTURA,002,LA UNIÓN,1,20,7,13,2
SINALOA,25,ANGOSTURA,002,LAS INFAMIAS,1,6,4,2,1
SINALOA,25,ANGOSTURA,002,LEOPOLDO SÁNCHEZ CELIS (EL GATO DE LARA),5,1283,574,709,116
SINALOA,25,ANGOSTURA,002,NINGUNO [DELIA MORENO],2,16,6,10,2
SINALOA,25,ANGOSTURA,002,PLAYA COLORADA,3,146,63,83,11
SINALOA,25,ANGOSTURA,002,PROTOMÁRTIR DE SINALOA,4,244,118,126,28
SINALOA,25,ANGOSTURA,002,SAN ANTONIO,4,108,57,51,14
SINALOA,25,ANGOSTURA,002,SAN ISIDRO,3,208,101,107,11
SINALOA,25,ANGOSTURA,002,SAN LUCIANO,3,79,40,39,4
SINALOA,25,ANGOSTURA,002,TOBERI,1,6,5,1,1
SINALOA,25,ANGOSTURA,002,VALENTÍN GÓMEZ FARÍAS (EL MUERTO),3,88,41,47,7
SINALOA,25,BADIRAGUATO,003,AGUA AMARILLA,3,28,17,11,3
SINALOA,25,BADIRAGUATO,003,AGUAJE GRANDE,3,10,4,6,2
SINALOA,25,BADIRAGUATO,003,AGUJAS,1,9,5,4,1
SINALOA,25,BADIRAGUATO,003,ALISITOS,2,15,10,5,2
SINALOA,25,BADIRAGUATO,003,ALISOS,1,10,4,6,1
SINALOA,25,BADIRAGUATO,003,ALISOS (ALISITOS),2,12,8,4,2
SINALOA,25,BADIRAGUATO,003,ARROYO SECO,3,30,17,13,3
SINALOA,25,BADIRAGUATO,003,BABUNICA,3,23,7,16,3
SINALOA,25,BADIRAGUATO,003,BACACORAGUA,3,14,9,5,2
SINALOA,25,BADIRAGUATO,003,BADIRAGUATO,10,1771,908,863,116
SINALOA,25,BADIRAGUATO,003,BAIMUSARI,2,5,2,3,1
SINALOA,25,BADIRAGUATO,003,BAMOPA,1,6,1,5,1
SINALOA,25,BADIRAGUATO,003,BATACOMITO,3,40,20,20,4
SINALOA,25,BADIRAGUATO,003,BATEQUITAS,1,9,3,6,1
SINALOA,25,BADIRAGUATO,003,BATOPITO,3,72,30,42,6
SINALOA,25,BADIRAGUATO,003,BOCA DE ARROYO,2,10,3,7,1
SINALOA,25,BADIRAGUATO,003,CALABAZAS,3,17,12,5,4
SINALOA,25,BADIRAGUATO,003,CAMOTETE [CAMPO CAMOTETE],2,26,8,18,3
SINALOA,25,BADIRAGUATO,003,CARIATAPA,3,29,12,17,3
SINALOA,25,BADIRAGUATO,003,CARRICITOS,2,23,13,10,2
SINALOA,25,BADIRAGUATO,003,CIÉNEGA DE LOS LARA,3,59,37,22,6
SINALOA,25,BADIRAGUATO,003,COPALITOS,3,25,11,14,4
SINALOA,25,BADIRAGUATO,003,CORTIJOS DE GUATÉNIPA,3,25,11,14,3
SINALOA,25,BADIRAGUATO,003,DOS ARROYOS,4,63,36,27,6
SINALOA,25,BADIRAGUATO,003,EL AGUAJE DE LOS MONZÓN,2,14,6,8,2
SINALOA,25,BADIRAGUATO,003,EL AGUAJE DEL CHARO,2,22,13,9,2
SINALOA,25,BADIRAGUATO,003,EL BARRIL,3,60,25,35,6
SINALOA,25,BADIRAGUATO,003,EL BRASIL,2,11,5,6,1
SINALOA,25,BADIRAGUATO,003,EL CHORRO,2,18,7,11,2
SINALOA,25,BADIRAGUATO,003,EL FRIJOLAR,4,98,43,55,8
SINALOA,25,BADIRAGUATO,003,EL GARBANCITO,1,4,3,1,1
SINALOA,25,BADIRAGUATO,003,EL GATO,2,12,3,9,2
SINALOA,25,BADIRAGUATO,003,EL GUAYABO DE ABAJO,3,41,18,23,5
SINALOA,25,BADIRAGUATO,003,EL HORMIGUERO,2,45,16,29,5
SINALOA,25,BADIRAGUATO,003,EL HUEJOTE,3,43,19,24,5
SINALOA,25,BADIRAGUATO,003,EL HUEJOTILLO,1,11,5,6,1
SINALOA,25,BADIRAGUATO,003,EL JACAL,4,88,42,46,7
SINALOA,25,BADIRAGUATO,003,EL LAUREL,2,25,9,16,2
SINALOA,25,BADIRAGUATO,003,EL MAUTAL,3,30,15,15,3
SINALOA,25,BADIRAGUATO,003,EL MEZCAL,1,10,4,6,1
SINALOA,25,BADIRAGUATO,003,EL MEZCALITO,3,28,15,13,5
SINALOA,25,BADIRAGUATO,003,EL MEZQUITE,3,24,13,11,3
SINALOA,25,BADIRAGUATO,003,EL MOLINO,2,18,9,9,2
SINALOA,25,BADIRAGUATO,003,EL NOGALITO,3,58,27,31,5
SINALOA,25,BADIRAGUATO,003,EL OJITO,3,34,20,14,4
SINALOA,25,BADIRAGUATO,003,EL PASO DE SAN NICOLÁS,1,7,3,4,1
SINALOA,25,BADIRAGUATO,003,EL PINAL,2,7,3,4,1
SINALOA,25,BADIRAGUATO,003,EL POTRERILLO,2,5,3,2,1
SINALOA,25,BADIRAGUATO,003,EL POTRERITO,2,6,0,6,2
SINALOA,25,BADIRAGUATO,003,EL POTRERO DE BEJARANO,4,122,64,58,12
SINALOA,25,BADIRAGUATO,003,EL POTRERO DE LOS PÁEZ,1,10,4,6,1
SINALOA,25,BADIRAGUATO,003,EL PUEBLITO,2,23,10,13,2
SINALOA,25,BADIRAGUATO,003,EL RANCHITO,1,11,8,3,1
SINALOA,25,BADIRAGUATO,003,EL RINCÓN DE LOS MONTES,3,49,24,25,5
SINALOA,25,BADIRAGUATO,003,EL SAPO,1,6,3,3,1
SINALOA,25,BADIRAGUATO,003,EL SAUCE,4,24,14,10,3
SINALOA,25,BADIRAGUATO,003,EL TASTECITO,2,32,13,19,3
SINALOA,25,BADIRAGUATO,003,EL TEPEHUÁN,2,6,3,3,1
SINALOA,25,BADIRAGUATO,003,EL TERRERO,2,11,6,5,1
SINALOA,25,BADIRAGUATO,003,EL TRIGO,3,25,13,12,3
SINALOA,25,BADIRAGUATO,003,EL TRIGUITO,3,101,50,51,7
SINALOA,25,BADIRAGUATO,003,EL VAREJONAL,3,128,53,75,6
SINALOA,25,BADIRAGUATO,003,GUANAJUATO,2,24,12,12,2
SINALOA,25,BADIRAGUATO,003,HIGUERAS DE ÁLVAREZ BORBOA (HIGUERA DE LOS MONZÓN),1,38,20,18,7
SINALOA,25,BADIRAGUATO,003,HUIXIOPA,4,114,61,53,9
SINALOA,25,BADIRAGUATO,003,JAJALPA,1,11,5,6,1
SINALOA,25,BADIRAGUATO,003,LA APOMA,2,34,20,14,3
SINALOA,25,BADIRAGUATO,003,LA CALERA,2,20,10,10,2
SINALOA,25,BADIRAGUATO,003,LA CIENEGUILLA,2,9,4,5,2
SINALOA,25,BADIRAGUATO,003,LA GUÁSIMA DE LOS GUERRERO,2,17,10,7,2
SINALOA,25,BADIRAGUATO,003,LA HACIENDA,3,45,21,24,4
SINALOA,25,BADIRAGUATO,003,LA HIGUERITA,2,31,14,17,3
SINALOA,25,BADIRAGUATO,003,LA HUERTA,1,8,2,6,1
SINALOA,25,BADIRAGUATO,003,LA JUANILLA,1,5,3,2,1
SINALOA,25,BADIRAGUATO,003,LA LAPARA,3,40,20,20,4
SINALOA,25,BADIRAGUATO,003,LA LECHUGUILLA,3,23,12,11,3
SINALOA,25,BADIRAGUATO,003,LA MAJADA DE ARRIBA,2,18,11,7,2
SINALOA,25,BADIRAGUATO,003,LA MESA DEL FIERRO,2,28,14,14,2
SINALOA,25,BADIRAGUATO,003,LA OTRA BANDA DE BADIRAGUATO,2,16,12,4,2
SINALOA,25,BADIRAGUATO,003,LA PALMA,1,11,7,4,1
SINALOA,25,BADIRAGUATO,003,LA PITAHAYITA,3,39,14,25,3
SINALOA,25,BADIRAGUATO,003,LA PRESITA,2,11,5,6,1
SINALOA,25,BADIRAGUATO,003,LA SÁBILA,4,60,28,32,8
SINALOA,25,BADIRAGUATO,003,LA SOLEDAD,3,50,23,27,5
SINALOA,25,BADIRAGUATO,003,LA TARAHUMARA,3,9,4,5,2
SINALOA,25,BADIRAGUATO,003,LA TUNA,4,75,36,39,10
SINALOA,25,BADIRAGUATO,003,LA VAINILLA,2,6,5,1,1
SINALOA,25,BADIRAGUATO,003,LAS HIGUERAS DEL TECUÁN,3,44,23,21,5
SINALOA,25,BADIRAGUATO,003,LAS JUNTAS,3,30,18,12,3
SINALOA,25,BADIRAGUATO,003,LAS POZAS,1,8,3,5,1
SINALOA,25,BADIRAGUATO,003,LLANO DE LOS ROCHÍN,3,110,53,57,12
SINALOA,25,BADIRAGUATO,003,LLANO GRANDE,1,12,8,4,1
SINALOA,25,BADIRAGUATO,003,LO DE GABRIEL,2,27,13,14,2
SINALOA,25,BADIRAGUATO,003,LO DE GERÓNIMO,3,28,14,14,3
SINALOA,25,BADIRAGUATO,003,LOS AYALES,2,8,5,3,2
SINALOA,25,BADIRAGUATO,003,LOS COQUITOS,3,17,10,7,3
SINALOA,25,BADIRAGUATO,003,LOS LAURELES,3,37,17,20,3
SINALOA,25,BADIRAGUATO,003,LOS LOBITOS,2,24,14,10,3
SINALOA,25,BADIRAGUATO,003,LOS NARANJOS,1,13,6,7,1
SINALOA,25,BADIRAGUATO,003,LOS NEGRITOS,3,21,14,7,2
SINALOA,25,BADIRAGUATO,003,LOS PACHECO,3,20,9,11,3
SINALOA,25,BADIRAGUATO,003,LOS TEPEHUAJES,4,74,35,39,8
SINALOA,25,BADIRAGUATO,003,LOS ZAPOTES,1,7,1,6,1
SINALOA,25,BADIRAGUATO,003,LOS ZAPOTILLOS,2,16,2,14,2
SINALOA,25,BADIRAGUATO,003,MILPITAS,1,6,4,2,1
SINALOA,25,BADIRAGUATO,003,MORIRATO,3,42,20,22,3
SINALOA,25,BADIRAGUATO,003,NOCORIBA,2,21,10,11,2
SINALOA,25,BADIRAGUATO,003,OJO DE AGUA,3,24,13,11,3
SINALOA,25,BADIRAGUATO,003,OTATILLOS,4,126,58,68,11
SINALOA,25,BADIRAGUATO,003,PALMAR DE LOS RÍOS,3,43,24,19,5
SINALOA,25,BADIRAGUATO,003,PALO VERDE,3,39,27,12,4
SINALOA,25,BADIRAGUATO,003,PERICOS,4,58,29,29,6
SINALOA,25,BADIRAGUATO,003,PIEDRA BOLA,1,2,1,1,1
SINALOA,25,BADIRAGUATO,003,PLAN GRANDE,2,20,13,7,2
SINALOA,25,BADIRAGUATO,003,POTRERILLO,3,40,14,26,3
SINALOA,25,BADIRAGUATO,003,POTRERILLOS,1,12,9,3,1
SINALOA,25,BADIRAGUATO,003,POTRERITO,1,9,6,3,1
SINALOA,25,BADIRAGUATO,003,POTRERO DE LA VAINILLA,3,18,12,6,3
SINALOA,25,BADIRAGUATO,003,POTRERO DE LOS MEDINA,3,46,24,22,5
SINALOA,25,BADIRAGUATO,003,POTRERO DE LOS VEGA,1,7,2,5,1
SINALOA,25,BADIRAGUATO,003,POTRERO DE VICTORIA,1,10,5,5,1
SINALOA,25,BADIRAGUATO,003,RANCHO DE LUNA,2,13,8,5,2
SINALOA,25,BADIRAGUATO,003,RANCHO VIEJO,2,15,9,6,2
SINALOA,25,BADIRAGUATO,003,RANCHO VIEJO DE LOS VELÁZQUEZ,2,9,3,6,2
SINALOA,25,BADIRAGUATO,003,REVOLCADERO,3,65,31,34,5
SINALOA,25,BADIRAGUATO,003,RINCÓN DE LOS LÓPEZ,3,70,32,38,6
SINALOA,25,BADIRAGUATO,003,RINCÓN DE LOS MONZÓN,2,22,10,12,2
SINALOA,25,BADIRAGUATO,003,SABANILLAS,3,4,3,1,2
SINALOA,25,BADIRAGUATO,003,SACA DE AGUA,3,11,6,5,2
SINALOA,25,BADIRAGUATO,003,SAN ANTONIO DE LA PALMA,2,39,17,22,4
SINALOA,25,BADIRAGUATO,003,SAN ANTONIO DE LOS ORTIZ (EL RIYITO),1,5,4,1,1
SINALOA,25,BADIRAGUATO,003,SAN JAVIER DE ABAJO,4,167,81,86,12
SINALOA,25,BADIRAGUATO,003,SAN JAVIER DE ARRIBA,2,27,11,16,2
SINALOA,25,BADIRAGUATO,003,SAN JOSÉ DE LA PUERTA,3,40,14,26,5
SINALOA,25,BADIRAGUATO,003,SAN JOSÉ DEL BARRANCO,3,17,9,8,3
SINALOA,25,BADIRAGUATO,003,SAN JOSÉ DEL LLANO,4,204,109,95,16
SINALOA,25,BADIRAGUATO,003,SAN MIGUEL,3,55,25,30,5
SINALOA,25,BADIRAGUATO,003,SAN NICOLÁS DEL SITIO (SITIO DE ARRIBA),2,46,24,22,3
SINALOA,25,BADIRAGUATO,003,SANTA BÁRBARA DE LA CAÑA,3,42,21,21,4
SINALOA,25,BADIRAGUATO,003,SANTA CRUZ,3,12,5,7,2
SINALOA,25,BADIRAGUATO,003,SANTA GERTRUDIS,4,124,55,69,8
SINALOA,25,BADIRAGUATO,003,SANTA MARÍA,3,38,12,26,3
SINALOA,25,BADIRAGUATO,003,SANTA RITA DE ABAJO,4,157,82,75,16
SINALOA,25,BADIRAGUATO,003,SANTA RITA DE ARRIBA,1,2,0,2,1
SINALOA,25,BADIRAGUATO,003,SANTA ROSA,3,56,26,30,5
SINALOA,25,BADIRAGUATO,003,SANTIAGO DE LOS CABALLEROS (SANTIAGO),4,92,48,44,10
SINALOA,25,BADIRAGUATO,003,SANTO TOMÁS DE ABAJO,1,3,0,3,1
SINALOA,25,BADIRAGUATO,003,SANTO TOMÁS DE ARRIBA,2,14,6,8,2
SINALOA,25,BADIRAGUATO,003,SITIO DE EN MEDIO,4,171,75,96,18
SINALOA,25,BADIRAGUATO,003,SOTOLE,1,5,0,5,1
SINALOA,25,BADIRAGUATO,003,SOYATITA,4,126,66,60,9
SINALOA,25,BADIRAGUATO,003,SURUTATO,9,535,266,269,57
SINALOA,25,BADIRAGUATO,003,TAMEAPA,4,208,94,114,18
SINALOA,25,BADIRAGUATO,003,TECUXIAPA,2,11,6,5,1
SINALOA,25,BADIRAGUATO,003,TEGORIPA,4,116,56,60,10
SINALOA,25,BADIRAGUATO,003,TEPACA,1,9,6,3,1
SINALOA,25,BADIRAGUATO,003,TERREROS BAYOS,1,10,4,6,1
SINALOA,25,BADIRAGUATO,003,VÁLGAME DIOS,1,11,3,8,1
SINALOA,25,BADIRAGUATO,003,VINATERÍAS,1,22,13,9,2
SINALOA,25,CONCORDIA,004,AGUA CALIENTE DE GÁRATE (AGUA CALIENTE),4,368,180,188,29
SINALOA,25,CONCORDIA,004,AGUA CALIENTE DE JACOBO,2,15,6,9,2
SINALOA,25,CONCORDIA,004,AGUA CALIENTE DEL FAVOR,3,21,12,9,2
SINALOA,25,CONCORDIA,004,CHARCAS,2,4,2,2,1
SINALOA,25,CONCORDIA,004,CHIRIMOYOS,2,54,23,31,3
SINALOA,25,CONCORDIA,004,CHUPADEROS,2,57,23,34,3
SINALOA,25,CONCORDIA,004,COPALA,3,70,34,36,6
SINALOA,25,CONCORDIA,004,CUATANTAL,3,38,23,15,3
SINALOA,25,CONCORDIA,004,EJIDO CALERITAS,2,13,4,9,2
SINALOA,25,CONCORDIA,004,EL CARDÓN,2,13,5,8,1
SINALOA,25,CONCORDIA,004,EL COCO,2,5,3,2,2
SINALOA,25,CONCORDIA,004,EL HUAJOTE,3,271,144,127,27
SINALOA,25,CONCORDIA,004,EL PALMITO,4,159,82,77,22
SINALOA,25,CONCORDIA,004,EL TIRO,3,5,2,3,2
SINALOA,25,CONCORDIA,004,EL VERDE,4,228,110,118,33
SINALOA,25,CONCORDIA,004,HABAL DE COPALA,2,20,8,12,2
SINALOA,25,CONCORDIA,004,HEROICA CIUDAD CONCORDIA,14,2655,1341,1314,166
SINALOA,25,CONCORDIA,004,LA CAPILLA DEL TAXTE,2,29,16,13,3
SINALOA,25,CONCORDIA,004,LA CONCEPCIÓN (LA BARRIGONA),3,222,108,114,11
SINALOA,25,CONCORDIA,004,LA EMBOCADA,1,5,2,3,1
SINALOA,25,CONCORDIA,004,LA GUÁSIMA,3,16,6,10,3
SINALOA,25,CONCORDIA,004,LA GUAYANERA,2,27,15,12,2
SINALOA,25,CONCORDIA,004,LA MESA DEL CARRIZAL,2,14,7,7,2
SINALOA,25,CONCORDIA,004,LA PASTORÍA,3,28,16,12,3
SINALOA,25,CONCORDIA,004,LA PETACA,4,192,93,99,12
SINALOA,25,CONCORDIA,004,LAS IGUANAS,4,124,66,58,11
SINALOA,25,CONCORDIA,004,LOS CERRITOS,2,32,16,16,2
SINALOA,25,CONCORDIA,004,LOS CIRUELOS,3,11,3,8,3
SINALOA,25,CONCORDIA,004,LOS NARANJOS,2,21,4,17,2
SINALOA,25,CONCORDIA,004,MAGISTRAL,3,36,10,26,4
SINALOA,25,CONCORDIA,004,MALPICA,4,116,50,66,9
SINALOA,25,CONCORDIA,004,MESILLAS,3,361,167,194,27
SINALOA,25,CONCORDIA,004,PALMILLAS,3,33,17,16,3
SINALOA,25,CONCORDIA,004,PÁNUCO,4,134,74,60,11
SINALOA,25,CONCORDIA,004,PIEDRA BLANCA,2,25,16,9,2
SINALOA,25,CONCORDIA,004,POTRERILLOS,5,241,126,115,20
SINALOA,25,CONCORDIA,004,SAN JUAN DE JACOBO,3,67,32,35,5
SINALOA,25,CONCORDIA,004,SAN LORENZO,2,7,4,3,1
SINALOA,25,CONCORDIA,004,SANTA CATARINA,4,91,50,41,8
SINALOA,25,CONCORDIA,004,SANTA LUCÍA,3,83,40,43,6
SINALOA,25,CONCORDIA,004,SANTA RITA,2,23,13,10,3
SINALOA,25,CONCORDIA,004,TEPUXTA,4,137,72,65,10
SINALOA,25,CONCORDIA,004,ZAVALA,4,129,66,63,10
SINALOA,25,COSALÁ,005,AGUA CALIENTE DE ALAYÁ,2,24,11,13,2
SINALOA,25,COSALÁ,005,BACATA,3,52,27,25,5
SINALOA,25,COSALÁ,005,CALAFATO,3,28,14,14,3
SINALOA,25,COSALÁ,005,CHAPALA,3,103,39,64,6
SINALOA,25,COSALÁ,005,CHIRICAHUETO,4,103,56,47,8
SINALOA,25,COSALÁ,005,CHOLULA,2,57,26,31,4
SINALOA,25,COSALÁ,005,CHUCHUPIRAS,2,8,3,5,1
SINALOA,25,COSALÁ,005,COLONIA LOS ALGODONES,2,3,2,1,1
SINALOA,25,COSALÁ,005,COMOA,3,30,15,15,3
SINALOA,25,COSALÁ,005,COSALÁ,18,2633,1321,1312,187
SINALOA,25,COSALÁ,005,EL CAMICHÍN,3,15,6,9,2
SINALOA,25,COSALÁ,005,EL CAPULE,1,4,2,2,1
SINALOA,25,COSALÁ,005,EL CARRIZAL,3,69,34,35,5
SINALOA,25,COSALÁ,005,EL GUAMÚCHIL,2,8,4,4,1
SINALOA,25,COSALÁ,005,EL PAPACHAL,1,4,2,2,1
SINALOA,25,COSALÁ,005,EL PINO,2,3,1,2,1
SINALOA,25,COSALÁ,005,EL PORTEZUELO,1,8,3,5,1
SINALOA,25,COSALÁ,005,EL POTRERO,2,25,14,11,2
SINALOA,25,COSALÁ,005,EL RANCHITO,3,65,27,38,5
SINALOA,25,COSALÁ,005,EL REALITO,3,23,12,11,3
SINALOA,25,COSALÁ,005,EL RINCÓN DE LA LAGUNITA,2,22,8,14,2
SINALOA,25,COSALÁ,005,EL RODEO,4,161,83,78,9
SINALOA,25,COSALÁ,005,EL SABINO,3,66,22,44,5
SINALOA,25,COSALÁ,005,EL SAUCE,3,10,5,5,2
SINALOA,25,COSALÁ,005,EL SAUCITO,3,25,9,16,3
SINALOA,25,COSALÁ,005,EL TECOMATE,1,7,3,4,1
SINALOA,25,COSALÁ,005,EL TULE,3,19,12,7,2
SINALOA,25,COSALÁ,005,EL VEINTICUATRO,2,5,2,3,1
SINALOA,25,COSALÁ,005,EL VERTEDOR,1,3,1,2,1
SINALOA,25,COSALÁ,005,GUADALUPE DE LOS REYES,3,28,17,11,3
SINALOA,25,COSALÁ,005,HIGUERAS DE CAMPAÑA,2,26,9,17,2
SINALOA,25,COSALÁ,005,HIGUERAS DE JACOPA,3,17,7,10,3
SINALOA,25,COSALÁ,005,HIGUERAS DE PADILLA,3,74,38,36,5
SINALOA,25,COSALÁ,005,HIGUERAS DE URREA,2,13,7,6,2
SINALOA,25,COSALÁ,005,IPUCHA,4,89,43,46,7
SINALOA,25,COSALÁ,005,LA CAÑITA,1,5,4,1,1
SINALOA,25,COSALÁ,005,LA CIÉNEGA,3,11,8,3,2
SINALOA,25,COSALÁ,005,LA CUCHILLA (CACHAHUA),2,31,14,17,2
SINALOA,25,COSALÁ,005,LA CULACHA,3,20,10,10,2
SINALOA,25,COSALÁ,005,LA ESTANCIA,2,31,9,22,2
SINALOA,25,COSALÁ,005,LA HUERTA,3,46,22,24,4
SINALOA,25,COSALÁ,005,LA ILAMA,4,113,72,41,8
SINALOA,25,COSALÁ,005,LA TASAJERA,3,27,15,12,3
SINALOA,25,COSALÁ,005,LA VUELTA DEL CERRO,1,4,2,2,1
SINALOA,25,COSALÁ,005,LAS AMARGOSAS,3,18,6,12,3
SINALOA,25,COSALÁ,005,LAS CUPÍAS DE CACHAHUA,3,10,7,3,2
SINALOA,25,COSALÁ,005,LAS HABAS,2,54,31,23,3
SINALOA,25,COSALÁ,005,LAS HABITAS,2,8,5,3,1
SINALOA,25,COSALÁ,005,LAS MILPAS DEL CARRIZO,2,31,13,18,2
SINALOA,25,COSALÁ,005,LLANO GRANDE,2,5,1,4,2
SINALOA,25,COSALÁ,005,LO DE GARZA,2,8,6,2,1
SINALOA,25,COSALÁ,005,LOS BRACEROS,3,13,7,6,3
SINALOA,25,COSALÁ,005,LOS BULITOS,3,14,8,6,3
SINALOA,25,COSALÁ,005,LOS CARRICITOS,1,2,2,0,1
SINALOA,25,COSALÁ,005,LOS CEDRITOS,3,18,6,12,3
SINALOA,25,COSALÁ,005,LOS MIMBRES,3,33,17,16,4
SINALOA,25,COSALÁ,005,LOS MIMBRES DEL PADRE,2,5,1,4,1
SINALOA,25,COSALÁ,005,LOS MOLINOS,3,32,12,20,3
SINALOA,25,COSALÁ,005,LOS SALATES,3,13,8,5,3
SINALOA,25,COSALÁ,005,MEZCALTITÁN,3,48,29,19,4
SINALOA,25,COSALÁ,005,PALMAR DE LOS CEBALLOS,3,21,12,9,3
SINALOA,25,COSALÁ,005,PALMILLAS,2,10,5,5,2
SINALOA,25,COSALÁ,005,PALO VERDE,3,18,8,10,3
SINALOA,25,COSALÁ,005,POTRERILLO DE LOS TORRES,3,22,9,13,3
SINALOA,25,COSALÁ,005,POZO ZARCO,2,4,0,4,1
SINALOA,25,COSALÁ,005,PUEBLO DE ALAYÁ,3,29,18,11,3
SINALOA,25,COSALÁ,005,SAN JOSÉ DE LAS BOCAS,3,27,15,12,3
SINALOA,25,COSALÁ,005,SAN MIGUEL DE LAS MESAS,3,72,33,39,7
SINALOA,25,COSALÁ,005,SANTA ANA,2,8,2,6,1
SINALOA,25,COSALÁ,005,SANTA ANITA,1,9,2,7,1
SINALOA,25,COSALÁ,005,SANTA CRUZ,2,10,2,8,1
SINALOA,25,COSALÁ,005,SANTA CRUZ DE ALAYÁ,3,82,32,50,7
SINALOA,25,COSALÁ,005,VADO HONDO,3,32,19,13,3
SINALOA,25,CULIACÁN,006,ABUYA,2,11,3,8,1
SINALOA,25,CULIACÁN,006,ABUYA Y CEUTA SEGUNDA (EJIDO ECHEVERRÍA),3,116,56,60,7
SINALOA,25,CULIACÁN,006,ADOLFO LÓPEZ MATEOS (CASA BLANCA),2,27,13,14,2
SINALOA,25,CULIACÁN,006,ADOLFO LÓPEZ MATEOS (EL TAMARINDO),8,1172,558,614,85
SINALOA,25,CULIACÁN,006,AGUA BLANCA,3,82,30,52,5
SINALOA,25,CULIACÁN,006,AGUA CALIENTE DE LOS MONZÓN,4,382,203,179,17
SINALOA,25,CULIACÁN,006,ALCOYONQUI,3,13,3,10,4
SINALOA,25,CULIACÁN,006,ALGODONES DE TOMO,2,17,8,9,2
SINALOA,25,CULIACÁN,006,AMATÁN,1,13,7,6,1
SINALOA,25,CULIACÁN,006,ARGENTINA DOS,2,117,71,46,5
SINALOA,25,CULIACÁN,006,ARROYO DE LA HIGUERA,2,35,13,22,2
SINALOA,25,CULIACÁN,006,ARROYO GRANDE,3,57,27,30,4
SINALOA,25,CULIACÁN,006,AYUNÉ,2,31,15,16,2
SINALOA,25,CULIACÁN,006,BACHIGUALATITO,3,324,163,161,12
SINALOA,25,CULIACÁN,006,BACURIMÍ,2,213,107,106,8
SINALOA,25,CULIACÁN,006,BAGRECITOS,4,80,43,37,8
SINALOA,25,CULIACÁN,006,BAILA,3,65,35,30,6
SINALOA,25,CULIACÁN,006,BEBELAMA,3,19,8,11,3
SINALOA,25,CULIACÁN,006,BELLAVISTA,5,745,387,358,46
SINALOA,25,CULIACÁN,006,CAMINAGUATO,3,44,27,17,4
SINALOA,25,CULIACÁN,006,CAMPO ACAPULCO,1,39,16,23,2
SINALOA,25,CULIACÁN,006,CAMPO AGRÍCOLA SAN MIGUEL,2,32,18,14,7
SINALOA,25,CULIACÁN,006,CAMPO ARBACO,1,19,11,8,2
SINALOA,25,CULIACÁN,006,CAMPO CAMATO,3,364,172,192,20
SINALOA,25,CULIACÁN,006,CAMPO CHULAVISTA [CAMPO LA VEINTE],1,37,19,18,3
SINALOA,25,CULIACÁN,006,CAMPO CINCO Y MEDIO,3,161,73,88,10
SINALOA,25,CULIACÁN,006,CAMPO EL PORVENIR,1,28,15,13,1
SINALOA,25,CULIACÁN,006,CAMPO ÉRIKA,1,6,2,4,2
SINALOA,25,CULIACÁN,006,CAMPO EXPERIMENTAL DEL VALLE,2,214,117,97,7
SINALOA,25,CULIACÁN,006,CAMPO FLORENCIA (LA PÍLDORA),1,14,9,5,2
SINALOA,25,CULIACÁN,006,CAMPO FRAGA,1,20,11,9,2
SINALOA,25,CULIACÁN,006,CAMPO ISABELITAS,2,8,4,4,3
SINALOA,25,CULIACÁN,006,CAMPO JAL-ACA,3,33,11,22,8
SINALOA,25,CULIACÁN,006,CAMPO LA CATORCE,1,10,2,8,1
SINALOA,25,CULIACÁN,006,CAMPO LA FLOR,5,80,38,42,6
SINALOA,25,CULIACÁN,006,CAMPO LAGUNA,1,6,2,4,1
SINALOA,25,CULIACÁN,006,CAMPO MORELIA,1,18,8,10,1
SINALOA,25,CULIACÁN,006,CAMPO NORA,2,25,15,10,3
SINALOA,25,CULIACÁN,006,CAMPO NOTA,1,16,8,8,2
SINALOA,25,CULIACÁN,006,CAMPO PARALELO 38,1,22,9,13,2
SINALOA,25,CULIACÁN,006,CAMPO PAREDES,1,9,1,8,3
SINALOA,25,CULIACÁN,006,CAMPO PATRICIA,2,58,24,34,5
SINALOA,25,CULIACÁN,006,CAMPO SAN EMILIO,1,4,1,3,1
SINALOA,25,CULIACÁN,006,CAMPO SANTA AURORA,1,12,6,6,2
SINALOA,25,CULIACÁN,006,CAMPO SANTA BÁRBARA,2,44,18,26,3
SINALOA,25,CULIACÁN,006,CAMPO SANTA LUCÍA,1,11,5,6,3
SINALOA,25,CULIACÁN,006,CARBONERAS,5,245,106,139,13
SINALOA,25,CULIACÁN,006,CARRIZALEJO,2,74,40,34,4
SINALOA,25,CULIACÁN,006,CHIQUERITOS,3,119,47,72,7
SINALOA,25,CULIACÁN,006,CINCO Y MEDIO [EMPAQUE],1,37,10,27,3
SINALOA,25,CULIACÁN,006,COLONIA EMANCIPACIÓN,4,251,122,129,16
SINALOA,25,CULIACÁN,006,COLONIA VILLA ARREDONDO,1,10,3,7,1
SINALOA,25,CULIACÁN,006,COPACO,2,4,3,1,1
SINALOA,25,CULIACÁN,006,COSPITA,3,181,82,99,11
SINALOA,25,CULIACÁN,006,COSTA RICA,26,6629,3157,3472,361
SINALOA,25,CULIACÁN,006,CULIACÁN ROSALES,886,282586,146094,136492,17321
SINALOA,25,CULIACÁN,006,CULIACANCITO,7,1808,912,896,122
SINALOA,25,CULIACÁN,006,DOROTEO ARANGO,2,32,18,14,2
SINALOA,25,CULIACÁN,006,DOS ARROYOS,2,42,27,15,2
SINALOA,25,CULIACÁN,006,EJIDO CAMPO GOBIERNO NÚMERO DOS,3,139,65,74,7
SINALOA,25,CULIACÁN,006,EJIDO CAMPO LAGUNA,1,76,42,34,3
SINALOA,25,CULIACÁN,006,EJIDO CANÁN,3,143,64,79,9
SINALOA,25,CULIACÁN,006,EJIDO COMANITO,2,48,29,19,3
SINALOA,25,CULIACÁN,006,EJIDO EL ÁLAMO,2,35,20,15,3
SINALOA,25,CULIACÁN,006,EJIDO EL MELÓN (SAN ALEJANDRO),2,223,120,103,10
SINALOA,25,CULIACÁN,006,EJIDO EL QUEMADITO,4,250,125,125,12
SINALOA,25,CULIACÁN,006,EJIDO EL QUINCE (EL QUINCITO),2,44,23,21,3
SINALOA,25,CULIACÁN,006,EJIDO FRANCISCO VILLA,2,43,20,23,3
SINALOA,25,CULIACÁN,006,EJIDO LA ESPERANZA (LA TORTA),2,36,21,15,3
SINALOA,25,CULIACÁN,006,EJIDO LIBERTAD NÚMERO DOS (PÍRAMO VIEJO),2,24,13,11,2
SINALOA,25,CULIACÁN,006,EJIDO LOS BECOS (DURANGUITO),2,114,48,66,6
SINALOA,25,CULIACÁN,006,EJIDO LOS HUIZACHES,3,95,41,54,6
SINALOA,25,CULIACÁN,006,EJIDO MEZQUITILLO (CHAPETEADO),2,61,26,35,4
SINALOA,25,CULIACÁN,006,EJIDO MEZQUITILLO (LA CURVA),2,170,74,96,8
SINALOA,25,CULIACÁN,006,EJIDO MEZQUITILLO NÚMERO DOS,5,177,89,88,9
SINALOA,25,CULIACÁN,006,EJIDO REBECA UNO (PRIMERO DE MAYO),2,95,43,52,5
SINALOA,25,CULIACÁN,006,EJIDO TIERRA Y LIBERTAD NÚMERO DOS,2,138,68,70,7
SINALOA,25,CULIACÁN,006,EL ÁLAMO,2,46,22,24,2
SINALOA,25,CULIACÁN,006,EL ALTO DEL COYOTE,2,51,27,24,3
SINALOA,25,CULIACÁN,006,EL AVIÓN,2,8,5,3,1
SINALOA,25,CULIACÁN,006,EL CACHORÓN (NUEVO ROSARITO),2,26,16,10,2
SINALOA,25,CULIACÁN,006,EL CAMALOTE,2,134,63,71,8
SINALOA,25,CULIACÁN,006,EL CARRIZAL,3,64,31,33,5
SINALOA,25,CULIACÁN,006,EL CARRIZAL NÚMERO DOS,3,61,18,43,5
SINALOA,25,CULIACÁN,006,EL CEDRITO,3,57,21,36,5
SINALOA,25,CULIACÁN,006,EL DIEZ,9,1934,937,997,105
SINALOA,25,CULIACÁN,006,EL GUASIMAL,2,9,1,8,1
SINALOA,25,CULIACÁN,006,EL GUAYABITO,1,7,2,5,1
SINALOA,25,CULIACÁN,006,EL HUINACAXTLE,4,207,100,107,11
SINALOA,25,CULIACÁN,006,EL LIMÓN DE LOS RAMOS,5,997,485,512,52
SINALOA,25,CULIACÁN,006,EL LIMÓN DE TELLAECHE,4,122,62,60,10
SINALOA,25,CULIACÁN,006,EL LIMONCITO,3,35,22,13,3
SINALOA,25,CULIACÁN,006,EL LLANO DE LA PALMA (LLANO DE ARRIBA),2,28,12,16,2
SINALOA,25,CULIACÁN,006,EL MELÓN,1,10,3,7,1
SINALOA,25,CULIACÁN,006,EL PALMAR,3,14,8,6,2
SINALOA,25,CULIACÁN,006,EL PARAÍSO,2,29,11,18,2
SINALOA,25,CULIACÁN,006,EL PEÑASCO,2,21,8,13,2
SINALOA,25,CULIACÁN,006,EL PINOLE,2,54,24,30,2
SINALOA,25,CULIACÁN,006,EL POZO,4,215,103,112,23
SINALOA,25,CULIACÁN,006,EL RANCHITO,2,428,211,217,15
SINALOA,25,CULIACÁN,006,EL RANCHITO DE LOS BURGOS,2,35,17,18,2
SINALOA,25,CULIACÁN,006,EL RANCHITO II (SAN NICOLÁS),1,20,9,11,3
SINALOA,25,CULIACÁN,006,EL REALITO,3,19,10,9,7
SINALOA,25,CULIACÁN,006,EL RINCÓN,3,45,19,26,3
SINALOA,25,CULIACÁN,006,EL SALADO,6,863,432,431,53
SINALOA,25,CULIACÁN,006,EL SIFÓN,3,28,13,15,4
SINALOA,25,CULIACÁN,006,EL SINALOENSE,2,70,30,40,4
SINALOA,25,CULIACÁN,006,EL TALAYOTE,2,26,17,9,2
SINALOA,25,CULIACÁN,006,EL TEPUCHE,4,326,152,174,22
SINALOA,25,CULIACÁN,006,EL TEPUCHITO,2,63,33,30,3
SINALOA,25,CULIACÁN,006,EL TULE,5,110,47,63,13
SINALOA,25,CULIACÁN,006,EL VENADILLO,1,21,11,10,1
SINALOA,25,CULIACÁN,006,EL VIZCAÍNO,1,20,12,8,1
SINALOA,25,CULIACÁN,006,ESTACIÓN ABUYA,3,78,43,35,6
SINALOA,25,CULIACÁN,006,ESTACIÓN QUILÁ,2,70,33,37,5
SINALOA,25,CULIACÁN,006,ESTACIÓN ROSALES,2,194,107,87,8
SINALOA,25,CULIACÁN,006,ESTANCIA DE LOS GARCÍA,3,158,83,75,8
SINALOA,25,CULIACÁN,006,GOLDEN FIELDS [AGRÍCOLA],3,210,108,102,17
SINALOA,25,CULIACÁN,006,HERACLIO BERNAL,2,37,19,18,3
SINALOA,25,CULIACÁN,006,HIGUERAS DE ABUYA,4,488,232,256,29
SINALOA,25,CULIACÁN,006,HIGUERAS DE BAILA,2,31,13,18,2
SINALOA,25,CULIACÁN,006,HIGUERAS DE TACHINOLPA,2,5,1,4,2
SINALOA,25,CULIACÁN,006,IMALA,3,108,48,60,5
SINALOA,25,CULIACÁN,006,JACOLA,4,291,132,159,18
SINALOA,25,CULIACÁN,006,JACOLA (EL GUAYABO),3,73,33,40,6
SINALOA,25,CULIACÁN,006,JESÚS MARÍA,4,690,335,355,32
SINALOA,25,CULIACÁN,006,JUNTAS DE SAN IGNACIO,3,22,11,11,3
SINALOA,25,CULIACÁN,006,LA ANONA,3,87,46,41,5
SINALOA,25,CULIACÁN,006,LA BEBELAMA SAN LORENZO,2,36,18,18,2
SINALOA,25,CULIACÁN,006,LA BOCA,2,30,14,16,3
SINALOA,25,CULIACÁN,006,LA CAMPANA,3,169,79,90,9
SINALOA,25,CULIACÁN,006,LA CAÑADA,2,9,5,4,1
SINALOA,25,CULIACÁN,006,LA CHILLA,3,65,26,39,5
SINALOA,25,CULIACÁN,006,LA COMPUERTA,2,26,17,9,2
SINALOA,25,CULIACÁN,006,LA CONSTANCIA,2,31,12,19,3
SINALOA,25,CULIACÁN,006,LA CUESTA,1,3,2,1,1
SINALOA,25,CULIACÁN,006,LA ESPERANZA,2,22,9,13,2
SINALOA,25,CULIACÁN,006,LA ESPINITA,2,6,1,5,1
SINALOA,25,CULIACÁN,006,LA ESTANCIA DE LOS BURGOS,2,21,11,10,2
SINALOA,25,CULIACÁN,006,LA FLORIDA,1,24,14,10,1
SINALOA,25,CULIACÁN,006,LA FORTUNA [INVERNADERO],1,1,1,0,2
SINALOA,25,CULIACÁN,006,LA GRUÑIDORA,3,14,8,6,2
SINALOA,25,CULIACÁN,006,LA GUAMUCHILERA,3,96,47,49,6
SINALOA,25,CULIACÁN,006,LA GUÁSIMA,2,41,25,16,4
SINALOA,25,CULIACÁN,006,LA HIGUERA,6,231,112,119,12
SINALOA,25,CULIACÁN,006,LA HIGUERITA,2,8,5,3,1
SINALOA,25,CULIACÁN,006,LA HIGUERITA (LAS HIGUERAS DE CULIACÁN),2,254,123,131,9
SINALOA,25,CULIACÁN,006,LA LAGUNA SECA,1,11,4,7,1
SINALOA,25,CULIACÁN,006,LA LIMITA DE ITAJE,2,86,37,49,4
SINALOA,25,CULIACÁN,006,LA LOMA (LA LOMA DE QUILA),3,226,113,113,20
SINALOA,25,CULIACÁN,006,LA MORA,2,37,15,22,2
SINALOA,25,CULIACÁN,006,LA NORIA,3,116,54,62,17
SINALOA,25,CULIACÁN,006,LA PALMA,2,45,20,25,3
SINALOA,25,CULIACÁN,006,LA PALMITA Y ANEXOS (LA PRESITA),4,325,156,169,18
SINALOA,25,CULIACÁN,006,LA PEDRERA,2,75,36,39,4
SINALOA,25,CULIACÁN,006,LA PITAHAYITA,5,61,36,25,6
SINALOA,25,CULIACÁN,006,LA PLATANERA (EL PIZAL),1,8,3,5,1
SINALOA,25,CULIACÁN,006,LA PRESITA,2,109,43,66,5
SINALOA,25,CULIACÁN,006,LA REFORMA,5,91,51,40,6
SINALOA,25,CULIACÁN,006,LA ROMANA,2,6,3,3,1
SINALOA,25,CULIACÁN,006,LAGUNA COLORADA,3,211,104,107,16
SINALOA,25,CULIACÁN,006,LAGUNA DE CANACHI,4,428,211,217,24
SINALOA,25,CULIACÁN,006,LAS BATEAS,3,97,51,46,6
SINALOA,25,CULIACÁN,006,LAS BEBELAMAS DE ROMERO,1,4,2,2,1
SINALOA,25,CULIACÁN,006,LAS BRISAS,2,78,38,40,5
SINALOA,25,CULIACÁN,006,LAS FLECHAS,3,89,40,49,6
SINALOA,25,CULIACÁN,006,LAS FLORES,2,61,28,33,3
SINALOA,25,CULIACÁN,006,LAS GUÁSIMAS,3,50,27,23,4
SINALOA,25,CULIACÁN,006,LAS HIGUERAS,2,25,14,11,3
SINALOA,25,CULIACÁN,006,LAS ISABELES,1,7,6,1,2
SINALOA,25,CULIACÁN,006,LAS JUNTAS,2,6,3,3,2
SINALOA,25,CULIACÁN,006,LAS MILPAS NÚMERO DOS (LAS MILPAS),2,19,12,7,2
SINALOA,25,CULIACÁN,006,LAS TAPIAS,2,6,3,3,1
SINALOA,25,CULIACÁN,006,LIBERTAD (PÍRAMO),2,50,24,26,4
SINALOA,25,CULIACÁN,006,LO DE BARTOLO,2,35,13,22,2
SINALOA,25,CULIACÁN,006,LO DE CLEMENTE,3,20,12,8,3
SINALOA,25,CULIACÁN,006,LOS AYALES,2,39,18,21,2
SINALOA,25,CULIACÁN,006,LOS BRASILES,3,30,15,15,3
SINALOA,25,CULIACÁN,006,LOS CEDROS,2,4,4,0,2
SINALOA,25,CULIACÁN,006,LOS DURMIENTES,1,11,5,6,1
SINALOA,25,CULIACÁN,006,LOS LIMONES,2,29,17,12,2
SINALOA,25,CULIACÁN,006,LOS LOBITOS,3,23,12,11,3
SINALOA,25,CULIACÁN,006,LOS MAYOS,3,52,31,21,4
SINALOA,25,CULIACÁN,006,LOS NARANJOS,3,72,33,39,6
SINALOA,25,CULIACÁN,006,LOS VASITOS,4,146,82,64,9
SINALOA,25,CULIACÁN,006,MARCELO LOYA (LAS GÜERAS),2,70,39,31,3
SINALOA,25,CULIACÁN,006,MEZQUITITA,3,91,45,46,6
SINALOA,25,CULIACÁN,006,MIGUEL VALDEZ QUINTERO (EL CORAZÓN),4,531,243,288,32
SINALOA,25,CULIACÁN,006,MOJOLO,2,29,12,17,3
SINALOA,25,CULIACÁN,006,MOLO VIEJO,1,12,5,7,1
SINALOA,25,CULIACÁN,006,MONTE VERDE DE VILLA (EL VERDE),3,78,40,38,5
SINALOA,25,CULIACÁN,006,NICOLÁS BRAVO,1,8,6,2,1
SINALOA,25,CULIACÁN,006,NUEVO CENTRO DE POBLACIÓN EJIDAL EL 30,2,191,107,84,8
SINALOA,25,CULIACÁN,006,NUEVO MUNDO,2,35,25,10,2
SINALOA,25,CULIACÁN,006,NUEVO SEMINARIO,3,35,0,35,69
SINALOA,25,CULIACÁN,006,OBISPO,3,133,70,63,9
SINALOA,25,CULIACÁN,006,OSO NUEVO (EL OSO),2,84,43,41,6
SINALOA,25,CULIACÁN,006,OSO VIEJO,3,380,186,194,27
SINALOA,25,CULIACÁN,006,PALO BLANCO,2,28,11,17,3
SINALOA,25,CULIACÁN,006,PALO VERDE,2,15,9,6,2
SINALOA,25,CULIACÁN,006,PALOS BLANCOS,2,79,43,36,4
SINALOA,25,CULIACÁN,006,PANALTITA,2,23,12,11,2
SINALOA,25,CULIACÁN,006,PANTULE,1,11,5,6,2
SINALOA,25,CULIACÁN,006,PARALELO TREINTA Y OCHO [EMPAQUE AGRÍCOLA],1,1,0,1,1
SINALOA,25,CULIACÁN,006,PAREDONES,4,137,67,70,9
SINALOA,25,CULIACÁN,006,PASO NORTE (EL PASITO),2,19,11,8,2
SINALOA,25,CULIACÁN,006,PENÍNSULA DE VILLAMOROS,2,125,65,60,8
SINALOA,25,CULIACÁN,006,PLAN DE ORIENTE (EL DOCE),2,48,31,17,3
SINALOA,25,CULIACÁN,006,PORTEZUELO,3,27,17,10,3
SINALOA,25,CULIACÁN,006,POSTA ZOOTECNIA,1,2683,435,2248,99
SINALOA,25,CULIACÁN,006,POTRERO DE LOS IBARRA DE ABAJO,2,19,10,9,3
SINALOA,25,CULIACÁN,006,POTRERO DE LOS IBARRA DE ARRIBA,2,31,14,17,3
SINALOA,25,CULIACÁN,006,PUEBLO NUEVO,3,376,189,187,24
SINALOA,25,CULIACÁN,006,PUEBLO NUEVO DE CANACHI (EL CAMPITO),2,49,26,23,4
SINALOA,25,CULIACÁN,006,PUEBLOS UNIDOS,8,1267,637,630,67
SINALOA,25,CULIACÁN,006,PUERTO RICO (EL REPARITO),2,21,11,10,2
SINALOA,25,CULIACÁN,006,QUILÁ,8,1941,952,989,100
SINALOA,25,CULIACÁN,006,RICARDO FLORES MAGÓN,2,29,13,16,3
SINALOA,25,CULIACÁN,006,RÍO FLORIDO,2,24,6,18,2
SINALOA,25,CULIACÁN,006,SALATE DE LOS TAPIAS,1,21,13,8,1
SINALOA,25,CULIACÁN,006,SAN ANTONIO,3,18,9,9,3
SINALOA,25,CULIACÁN,006,SAN ANTONIO DOS,1,3,0,3,1
SINALOA,25,CULIACÁN,006,SAN CAYETANO,3,30,18,12,3
SINALOA,25,CULIACÁN,006,SAN FRANCISCO,2,21,11,10,2
SINALOA,25,CULIACÁN,006,SAN FRANCISCO DE TACUICHAMONA,4,361,172,189,25
SINALOA,25,CULIACÁN,006,SAN JOSÉ,2,8,6,2,1
SINALOA,25,CULIACÁN,006,SAN LORENZO,3,88,44,44,5
SINALOA,25,CULIACÁN,006,SAN LORENZO NUEVO,1,17,7,10,1
SINALOA,25,CULIACÁN,006,SAN MIGUEL DE LOS PICACHOS,2,11,4,7,2
SINALOA,25,CULIACÁN,006,SAN RAFAEL,2,20,10,10,2
SINALOA,25,CULIACÁN,006,SAN ROMÁN,1,1,1,0,1
SINALOA,25,CULIACÁN,006,SANALONA,4,351,176,175,17
SINALOA,25,CULIACÁN,006,SANTA ELENA [CAMPO],1,2,2,0,3
SINALOA,25,CULIACÁN,006,SANTA LORETO,2,24,8,16,2
SINALOA,25,CULIACÁN,006,SANTA REFUGIO,2,44,21,23,3
SINALOA,25,CULIACÁN,006,SECCIÓN ALHUATE,2,54,31,23,3
SINALOA,25,CULIACÁN,006,TABALÁ,3,213,101,112,11
SINALOA,25,CULIACÁN,006,TACHINOLPA,2,29,14,15,2
SINALOA,25,CULIACÁN,006,TECORITO,2,5,3,2,1
SINALOA,25,CULIACÁN,006,TIERRA Y LIBERTAD UNO,4,289,141,148,16
SINALOA,25,CULIACÁN,006,TOMO,3,51,24,27,4
SINALOA,25,CULIACÁN,006,VALLE DEL SOL [EMPAQUE],1,3,3,0,1
SINALOA,25,CULIACÁN,006,VALLE ESCONDIDO,3,176,75,101,17
SINALOA,25,CULIACÁN,006,VICENTE LOMBARDO TOLEDANO (LAS VÍBORAS),3,20,9,11,3
SINALOA,25,CULIACÁN,006,VIVEROS EL SAUZ,3,222,107,115,14
SINALOA,25,CULIACÁN,006,WALAMITO,2,33,14,19,3
SINALOA,25,CULIACÁN,006,ZALATE DE LOS IBARRA,3,40,18,22,4
SINALOA,25,CHOIX,007,AGUA CALIENTE DE BACA,4,109,55,54,14
SINALOA,25,CHOIX,007,AGUA CALIENTE GRANDE (DE GASTÉLUM),5,397,197,200,25
SINALOA,25,CHOIX,007,AGUA ZARCA,2,26,14,12,2
SINALOA,25,CHOIX,007,ANTONIO ROSALES (EL DISPARATE),2,11,6,5,2
SINALOA,25,CHOIX,007,BACA,5,131,52,79,10
SINALOA,25,CHOIX,007,BACAYOPA,3,61,29,32,6
SINALOA,25,CHOIX,007,BAJOSORI,4,199,92,107,19
SINALOA,25,CHOIX,007,BAYMENA,5,216,110,106,12
SINALOA,25,CHOIX,007,BUYUBAMPO,3,46,22,24,5
SINALOA,25,CHOIX,007,CAJÓN DE CANCIO,2,45,24,21,3
SINALOA,25,CHOIX,007,CASAS VIEJAS,4,109,51,58,10
SINALOA,25,CHOIX,007,CHOIX,17,3495,1857,1638,182
SINALOA,25,CHOIX,007,CONICARI,3,40,19,21,4
SINALOA,25,CHOIX,007,EL AGUAJITO DE BAJAHUI,2,60,26,34,3
SINALOA,25,CHOIX,007,EL BABÚ,2,29,17,12,2
SINALOA,25,CHOIX,007,EL BAINORAL,1,5,0,5,1
SINALOA,25,CHOIX,007,EL CAJÓN DE LOS FÉLIX,1,6,4,2,1
SINALOA,25,CHOIX,007,EL CAJONCITO (LA CIENEGUITA),3,17,6,11,3
SINALOA,25,CHOIX,007,EL COLEXIO,3,30,17,13,4
SINALOA,25,CHOIX,007,EL DESCANSO,3,19,7,12,3
SINALOA,25,CHOIX,007,EL FRIJOL,4,43,21,22,6
SINALOA,25,CHOIX,007,EL GUAMÚCHIL (GUAMÚCHIL DE LOS VALDEZ),1,5,4,1,1
SINALOA,25,CHOIX,007,EL GUAYABITO,2,42,19,23,3
SINALOA,25,CHOIX,007,EL MEZQUITE CAÍDO,2,30,17,13,2
SINALOA,25,CHOIX,007,EL MOCHIQUE,2,45,23,22,3
SINALOA,25,CHOIX,007,EL MUERTO,3,27,13,14,3
SINALOA,25,CHOIX,007,EL NACIMIENTO,4,116,57,59,9
SINALOA,25,CHOIX,007,EL PÍCHOL,3,58,27,31,5
SINALOA,25,CHOIX,007,EL REALITO,2,17,6,11,2
SINALOA,25,CHOIX,007,EL REPARO,7,109,53,56,9
SINALOA,25,CHOIX,007,EL SAUZ,2,8,3,5,2
SINALOA,25,CHOIX,007,EL SAUZ DE BACA,3,45,28,17,4
SINALOA,25,CHOIX,007,EL SAUZ DE SAN ISIDRO,3,27,13,14,3
SINALOA,25,CHOIX,007,EL TEPEHUAJE (CABALLIHUAZA),1,6,3,3,1
SINALOA,25,CHOIX,007,EL TRIGO,2,14,5,9,2
SINALOA,25,CHOIX,007,EL VADO (EL CERRITO),2,26,13,13,2
SINALOA,25,CHOIX,007,EL ZAPOTE DE BAYMENA,2,61,32,29,3
SINALOA,25,CHOIX,007,EL ZÁTAQUE,1,5,3,2,1
SINALOA,25,CHOIX,007,GUADALUPE,5,177,82,95,12
SINALOA,25,CHOIX,007,GÜILLACHAPA,3,12,6,6,3
SINALOA,25,CHOIX,007,HORCONCITOS,3,12,5,7,2
SINALOA,25,CHOIX,007,LA CIÉNEGA,2,40,15,25,3
SINALOA,25,CHOIX,007,LA CIENEGUITA DE NÚÑEZ,3,10,4,6,3
SINALOA,25,CHOIX,007,LA CULEBRA,1,108,50,58,6
SINALOA,25,CHOIX,007,LA ESTANCIA,2,6,3,3,1
SINALOA,25,CHOIX,007,LA ESTANCIA DE BAYMENA,2,54,31,23,3
SINALOA,25,CHOIX,007,LA LADRILLERA DE MADRILES,2,10,5,5,2
SINALOA,25,CHOIX,007,LA NORIA DE MINITAS,3,24,12,12,3
SINALOA,25,CHOIX,007,LA TUNA,2,4,2,2,2
SINALOA,25,CHOIX,007,LAS COLMENAS,3,15,9,6,3
SINALOA,25,CHOIX,007,LAS CRUCES,2,9,4,5,2
SINALOA,25,CHOIX,007,LAS GUAYABAS,1,8,5,3,1
SINALOA,25,CHOIX,007,LAS RASTRAS,3,61,26,35,4
SINALOA,25,CHOIX,007,LORETILLO,2,26,9,17,2
SINALOA,25,CHOIX,007,LOS BATEQUIS,2,19,9,10,2
SINALOA,25,CHOIX,007,LOS CEDROS,3,22,9,13,3
SINALOA,25,CHOIX,007,LOS CHINOS,2,8,2,6,1
SINALOA,25,CHOIX,007,LOS MAUTOS,2,12,2,10,2
SINALOA,25,CHOIX,007,LOS MIMBRES,2,19,10,9,2
SINALOA,25,CHOIX,007,LOS PICACHOS,4,142,67,75,12
SINALOA,25,CHOIX,007,LOS POZOS,3,101,61,40,8
SINALOA,25,CHOIX,007,MESA DE LOS TORRES,2,37,16,21,3
SINALOA,25,CHOIX,007,NUEVO TECHOBAMPO,3,40,15,25,3
SINALOA,25,CHOIX,007,POBLADO NUEVO,2,23,13,10,3
SINALOA,25,CHOIX,007,POTRERILLO,2,6,2,4,1
SINALOA,25,CHOIX,007,POTRERO DE CANCIO,3,74,38,36,10
SINALOA,25,CHOIX,007,RANCHITO DE CABRERA,3,32,10,22,3
SINALOA,25,CHOIX,007,RANCHITO DE ISLAS,3,52,30,22,5
SINALOA,25,CHOIX,007,RANCHO DE BAYMENA,2,26,15,11,2
SINALOA,25,CHOIX,007,RINCÓN DE AGUA CALIENTE GRANDE,2,23,15,8,2
SINALOA,25,CHOIX,007,SAN JAVIER,4,284,153,131,24
SINALOA,25,CHOIX,007,SAN JOSÉ DE LOS LLANOS (LOS LLANOS),3,39,22,17,4
SINALOA,25,CHOIX,007,SAN JOSÉ DE LOS PERICOS,3,25,10,15,3
SINALOA,25,CHOIX,007,SAN JOSÉ DE LOS PORTILLO,2,35,17,18,3
SINALOA,25,CHOIX,007,SAN PANTALEÓN,4,82,34,48,8
SINALOA,25,CHOIX,007,SANTA ANA,3,110,55,55,7
SINALOA,25,CHOIX,007,SAUZ DE BAYMENA (EL SAUZ),3,90,36,54,7
SINALOA,25,CHOIX,007,TABUCAHUI,3,97,54,43,6
SINALOA,25,CHOIX,007,TARARANCITO,2,9,4,5,2
SINALOA,25,CHOIX,007,TASAJERAS,4,172,85,87,12
SINALOA,25,CHOIX,007,TECHOBAMPO DE LOS COTA,1,6,2,4,1
SINALOA,25,CHOIX,007,TECHOBAMPO DE LOS MONTES,1,9,4,5,1
SINALOA,25,CHOIX,007,TOIPAQUI,3,34,18,16,4
SINALOA,25,CHOIX,007,ÚLTIMO VADO,3,35,17,18,3
SINALOA,25,CHOIX,007,VENICIA,2,34,11,23,2
SINALOA,25,CHOIX,007,VINATERÍAS,1,16,6,10,1
SINALOA,25,CHOIX,007,YECORATO,4,109,44,65,9
SINALOA,25,CHOIX,007,ZAPOTE DE MADRILES,3,30,13,17,3
SINALOA,25,ELOTA,008,26 DE ENERO,2,21,9,12,2
SINALOA,25,ELOTA,008,ABOCHO (ESTACIÓN ABOCHO),2,23,9,14,2
SINALOA,25,ELOTA,008,AGUA NUEVA,2,12,2,10,2
SINALOA,25,ELOTA,008,AGUAPEPE,2,32,14,18,3
SINALOA,25,ELOTA,008,ALTA ROSA (PÍPILA II),4,71,40,31,8
SINALOA,25,ELOTA,008,BELLAVISTA,5,114,65,49,6
SINALOA,25,ELOTA,008,BENITO JUÁREZ,3,58,35,23,6
SINALOA,25,ELOTA,008,BOSCOSO,2,111,55,56,7
SINALOA,25,ELOTA,008,BUENAVISTA,1,9,6,3,1
SINALOA,25,ELOTA,008,CAIMANES II,4,233,117,116,14
SINALOA,25,ELOTA,008,CAMPO BELLAVISTA,2,88,42,46,5
SINALOA,25,ELOTA,008,CAMPO CACHANILLA,3,89,37,52,6
SINALOA,25,ELOTA,008,CAMPO CINCO (LA RETAMA),4,197,103,94,9
SINALOA,25,ELOTA,008,CAMPO LA PALOMA [AGRÍCOLA EL CHAPARRAL],3,278,133,145,10
SINALOA,25,ELOTA,008,CAMPO NUEVA FLORIDA,4,80,41,39,5
SINALOA,25,ELOTA,008,CAMPO NUEVO CAIMANES,4,126,70,56,4
SINALOA,25,ELOTA,008,CAMPO SAN JUAN,3,61,29,32,4
SINALOA,25,ELOTA,008,CAMPO TAYOLTITA,3,107,53,54,5
SINALOA,25,ELOTA,008,CASAS GRANDES,2,20,10,10,2
SINALOA,25,ELOTA,008,CASAS VIEJAS,2,102,50,52,8
SINALOA,25,ELOTA,008,CELESTINO GAZCA VILLASEÑOR,4,247,120,127,14
SINALOA,25,ELOTA,008,CEUTA,5,503,244,259,24
SINALOA,25,ELOTA,008,COLONIA BUENOS AIRES,1,2,1,1,1
SINALOA,25,ELOTA,008,EJIDO CULIACÁN (CULIACANCITO),6,202,110,92,12
SINALOA,25,ELOTA,008,EJIDO LA VENTANA (EL CARRIZO),3,94,58,36,5
SINALOA,25,ELOTA,008,EL AGUAJE,2,23,8,15,3
SINALOA,25,ELOTA,008,EL BOLILLO,3,149,89,60,8
SINALOA,25,ELOTA,008,EL CHIRIMOLE,3,16,7,9,2
SINALOA,25,ELOTA,008,EL ESPINAL,3,317,164,153,17
SINALOA,25,ELOTA,008,EL PORTEZUELO DE ARRIBA,3,34,17,17,3
SINALOA,25,ELOTA,008,EL ROBLE,3,142,59,83,6
SINALOA,25,ELOTA,008,EL SABINAL,2,13,5,8,2
SINALOA,25,ELOTA,008,EL SALADITO,5,749,376,373,42
SINALOA,25,ELOTA,008,EL SALADO,5,129,57,72,10
SINALOA,25,ELOTA,008,EL SOLITO,2,4,1,3,1
SINALOA,25,ELOTA,008,ELOTA,4,186,100,86,20
SINALOA,25,ELOTA,008,EMILIANO ZAPATA,3,234,99,135,12
SINALOA,25,ELOTA,008,EMPAQUE TARRIBA,2,27,17,10,5
SINALOA,25,ELOTA,008,ENSENADA,3,75,40,35,6
SINALOA,25,ELOTA,008,HIGUERAS DE CULIACANCITO,2,13,7,6,2
SINALOA,25,ELOTA,008,IBONÍA,3,35,19,16,3
SINALOA,25,ELOTA,008,JAPUINO,2,18,11,7,2
SINALOA,25,ELOTA,008,LA CRUZ,26,6465,3221,3244,340
SINALOA,25,ELOTA,008,LAS GRANJAS DEL NOROTE,1,13,8,5,1
SINALOA,25,ELOTA,008,LAS TINAS,2,34,18,16,2
SINALOA,25,ELOTA,008,LOMA DE TECUYO,3,81,37,44,7
SINALOA,25,ELOTA,008,LOS DIFUNTOS,2,17,10,7,2
SINALOA,25,ELOTA,008,LOS MECATES,2,10,5,5,1
SINALOA,25,ELOTA,008,NUEVO SALTO GRANDE,3,76,38,38,4
SINALOA,25,ELOTA,008,PAREDÓN COLORADO,2,38,17,21,3
SINALOA,25,ELOTA,008,POTRERILLO DE LOS LANDEROS,2,15,3,12,2
SINALOA,25,ELOTA,008,POTRERILLO DEL NOROTE,4,653,323,330,34
SINALOA,25,ELOTA,008,PUEBLO NUEVO,5,432,219,213,34
SINALOA,25,ELOTA,008,RINCÓN DE IBONÍA,3,37,23,14,3
SINALOA,25,ELOTA,008,ROSENDO NIEBLAS,2,17,4,13,2
SINALOA,25,ELOTA,008,SAN JOSÉ DE CONITACA (NUEVO CONITACA),3,223,113,110,16
SINALOA,25,ELOTA,008,SOL Y ARENA,3,85,40,45,3
SINALOA,25,ELOTA,008,TANQUES,6,468,254,214,25
SINALOA,25,ELOTA,008,TAYOLTITA,3,246,115,131,10
SINALOA,25,ELOTA,008,VIDA CAMPESINA,3,100,48,52,7
SINALOA,25,ESCUINAPA,009,AGUA CALIENTE,2,19,5,14,2
SINALOA,25,ESCUINAPA,009,CELAYA,2,82,47,35,4
SINALOA,25,ESCUINAPA,009,COPALES,3,101,44,57,7
SINALOA,25,ESCUINAPA,009,CRISTO REY,5,384,188,196,27
SINALOA,25,ESCUINAPA,009,EJIDO DE LA CAMPANA NÚMERO UNO,3,305,149,156,31
SINALOA,25,ESCUINAPA,009,EL TECOMATILLO,3,44,19,25,4
SINALOA,25,ESCUINAPA,009,EL TRÉBOL,2,113,59,54,5
SINALOA,25,ESCUINAPA,009,EL TRÉBOL DOS,3,76,37,39,4
SINALOA,25,ESCUINAPA,009,ESCUINAPA DE HIDALGO,47,9194,4594,4600,684
SINALOA,25,ESCUINAPA,009,ISLA DEL BOSQUE,9,1760,835,925,84
SINALOA,25,ESCUINAPA,009,LA CAMPANA NÚMERO DOS (EL POCHOTE),2,32,13,19,3
SINALOA,25,ESCUINAPA,009,LA CONCHA (LA CONCEPCIÓN),5,444,216,228,29
SINALOA,25,ESCUINAPA,009,LA LOMA (GABRIEL LEYVA SOLANO),2,47,26,21,3
SINALOA,25,ESCUINAPA,009,LAS PILAS,3,40,23,17,3
SINALOA,25,ESCUINAPA,009,OJO DE AGUA DE PALMILLAS,6,681,337,344,46
SINALOA,25,ESCUINAPA,009,PALMITO DEL VERDE,5,530,258,272,33
SINALOA,25,ESCUINAPA,009,RINCÓN DEL VERDE,3,61,24,37,4
SINALOA,25,ESCUINAPA,009,SAN MIGUEL DE LA ATARJEA,1,5,3,2,1
SINALOA,25,ESCUINAPA,009,TEACAPÁN,8,1011,499,512,119
SINALOA,25,ESCUINAPA,009,TECUALILLA,4,450,212,238,20
SINALOA,25,EL FUERTE,010,3 DE MAYO (CAMPO SECO),3,102,47,55,5
SINALOA,25,EL FUERTE,010,ADOLFO LÓPEZ MATEOS (JAHUARA SEGUNDO),8,1216,596,620,100
SINALOA,25,EL FUERTE,010,AGUA CALIENTITA,3,77,35,42,6
SINALOA,25,EL FUERTE,010,ANTONIO ROSALES,2,159,87,72,8
SINALOA,25,EL FUERTE,010,ARROYO DE LOS ARMENTA,3,82,44,38,6
SINALOA,25,EL FUERTE,010,BACAPACO,3,16,7,9,2
SINALOA,25,EL FUERTE,010,BACAUSA DE ABAJO,2,10,4,6,1
SINALOA,25,EL FUERTE,010,BAMICORI,1,7,3,4,1
SINALOA,25,EL FUERTE,010,BAROTÉN,3,143,73,70,9
SINALOA,25,EL FUERTE,010,BASOTEVE,3,45,20,25,4
SINALOA,25,EL FUERTE,010,BATEBE,3,53,25,28,4
SINALOA,25,EL FUERTE,010,BENITO JUÁREZ (VINATERÍA),4,334,168,166,18
SINALOA,25,EL FUERTE,010,BIBAJAQUI,4,85,34,51,8
SINALOA,25,EL FUERTE,010,BOCA DE ARROYO,2,81,36,45,3
SINALOA,25,EL FUERTE,010,BORABAMPO,6,239,113,126,17
SINALOA,25,EL FUERTE,010,BUENA VISTA,4,108,57,51,9
SINALOA,25,EL FUERTE,010,BUENAVISTA,3,136,70,66,13
SINALOA,25,EL FUERTE,010,CAJÓN DE LOS LUGO,2,6,2,4,2
SINALOA,25,EL FUERTE,010,CAMAJOA,1,83,46,37,3
SINALOA,25,EL FUERTE,010,CAMPO CUATRO,2,25,18,7,3
SINALOA,25,EL FUERTE,010,CANAL DE CONEXIÓN [DIQUE SEIS],3,12,8,4,3
SINALOA,25,EL FUERTE,010,CANUTILLO,4,166,79,87,9
SINALOA,25,EL FUERTE,010,CERRILLOS NÚMERO DOS,1,9,4,5,1
SINALOA,25,EL FUERTE,010,CERRILLOS NÚMERO UNO,2,28,15,13,3
SINALOA,25,EL FUERTE,010,CHARAY,5,799,394,405,57
SINALOA,25,EL FUERTE,010,CHINOBAMPO,4,384,175,209,30
SINALOA,25,EL FUERTE,010,COFRADÍA,3,20,11,9,3
SINALOA,25,EL FUERTE,010,CONSTANCIA,10,1794,938,856,106
SINALOA,25,EL FUERTE,010,CUATRO MILPAS,2,148,73,75,8
SINALOA,25,EL FUERTE,010,DIQUE NÚMERO DOS,2,6,4,2,1
SINALOA,25,EL FUERTE,010,DOS DE ABRIL,4,1287,648,639,104
SINALOA,25,EL FUERTE,010,EJIDO EMILIANO ZAPATA,1,13,7,6,1
SINALOA,25,EL FUERTE,010,EJIDO LOS TORRES,3,22,8,14,3
SINALOA,25,EL FUERTE,010,EL ALHUATE,2,39,23,16,4
SINALOA,25,EL FUERTE,010,EL ALISO,2,52,37,15,3
SINALOA,25,EL FUERTE,010,EL ALTILLO,2,18,8,10,2
SINALOA,25,EL FUERTE,010,EL CARRICITO,5,238,135,103,14
SINALOA,25,EL FUERTE,010,EL FUERTE,18,4156,2208,1948,339
SINALOA,25,EL FUERTE,010,EL MAHONE,3,54,26,28,4
SINALOA,25,EL FUERTE,010,EL MEZQUITAL,2,8,4,4,1
SINALOA,25,EL FUERTE,010,EL MEZQUITALITO,1,5,4,1,1
SINALOA,25,EL FUERTE,010,EL NARANJO,3,84,31,53,6
SINALOA,25,EL FUERTE,010,EL PASITO,2,7,4,3,1
SINALOA,25,EL FUERTE,010,EL POCHOTAL,3,380,185,195,13
SINALOA,25,EL FUERTE,010,EL RANCHITO,6,173,86,87,13
SINALOA,25,EL FUERTE,010,EL REALITO,4,59,25,34,4
SINALOA,25,EL FUERTE,010,EL SABINITO,2,4,2,2,1
SINALOA,25,EL FUERTE,010,EL TEPEHUAJE,4,177,91,86,10
SINALOA,25,EL FUERTE,010,EL VADO,2,29,14,15,3
SINALOA,25,EL FUERTE,010,EL ZAPOTE DE CHINOBAMPO,2,5,3,2,1
SINALOA,25,EL FUERTE,010,ESCUELA NORMAL EXPERIMENTAL DE EL FUERTE,2,180,147,33,18
SINALOA,25,EL FUERTE,010,ESTACIÓN CHARAY (LOS TERCOS),1,21,11,10,1
SINALOA,25,EL FUERTE,010,ESTACIÓN HOYANCOS [ESTACIÓN EL FUERTE],3,76,38,38,5
SINALOA,25,EL FUERTE,010,HUEPACO,2,360,175,185,15
SINALOA,25,EL FUERTE,010,JAHUARA PRIMERO (LOS LEYVA),4,177,80,97,12
SINALOA,25,EL FUERTE,010,JOAQUÍN AMARO,3,28,16,12,3
SINALOA,25,EL FUERTE,010,JOSÉ MARÍA PINO SUÁREZ,1,12,6,6,1
SINALOA,25,EL FUERTE,010,JÚPARE,4,106,52,54,8
SINALOA,25,EL FUERTE,010,KILÓMETRO 19,3,167,81,86,7
SINALOA,25,EL FUERTE,010,KILÓMETRO 26 (LAS PANGUITAS),2,149,73,76,8
SINALOA,25,EL FUERTE,010,LA ARROCERA,4,215,111,104,13
SINALOA,25,EL FUERTE,010,LA BAJADA DEL MONTE,4,167,88,79,10
SINALOA,25,EL FUERTE,010,LA BOMBA,1,26,10,16,1
SINALOA,25,EL FUERTE,010,LA CAPILLA,4,220,108,112,15
SINALOA,25,EL FUERTE,010,LA CARRERA,2,68,38,30,4
SINALOA,25,EL FUERTE,010,LA CHIRIPA,1,5,3,2,1
SINALOA,25,EL FUERTE,010,LA DIVISA,2,10,6,4,2
SINALOA,25,EL FUERTE,010,LA GALERA,2,33,18,15,2
SINALOA,25,EL FUERTE,010,LA GENOVEVA,2,115,50,65,6
SINALOA,25,EL FUERTE,010,LA LADRILLERA,1,42,20,22,3
SINALOA,25,EL FUERTE,010,LA LADRILLERA (EL CAMPITO),1,7,4,3,1
SINALOA,25,EL FUERTE,010,LA LAGUNA,2,22,10,12,2
SINALOA,25,EL FUERTE,010,LA LÍNEA,3,97,49,48,6
SINALOA,25,EL FUERTE,010,LA MISIÓN NUEVA,3,48,27,21,3
SINALOA,25,EL FUERTE,010,LA MISIÓN VIEJA,3,80,38,42,7
SINALOA,25,EL FUERTE,010,LA PALMA,4,262,135,127,15
SINALOA,25,EL FUERTE,010,LA TUNITA,2,7,6,1,1
SINALOA,25,EL FUERTE,010,LAS CABANILLAS,2,73,43,30,3
SINALOA,25,EL FUERTE,010,LAS CHUNAS,2,39,19,20,4
SINALOA,25,EL FUERTE,010,LAS ESTACAS,3,175,92,83,9
SINALOA,25,EL FUERTE,010,LAS HIGUERAS DE LOS NATOCHES,8,728,359,369,55
SINALOA,25,EL FUERTE,010,LÁZARO CÁRDENAS,3,73,30,43,7
SINALOA,25,EL FUERTE,010,LÁZARO CÁRDENAS (CAMPO ESPERANZA),5,414,193,221,22
SINALOA,25,EL FUERTE,010,LLANO DE LOS LÓPEZ,3,47,23,24,14
SINALOA,25,EL FUERTE,010,LLANO DE LOS SOTO,3,85,48,37,7
SINALOA,25,EL FUERTE,010,LO DE MAYO (ÁLAMO CAÍDO),2,10,4,6,2
SINALOA,25,EL FUERTE,010,LO DE VEGA,3,35,24,11,4
SINALOA,25,EL FUERTE,010,LOMA DE LOS PATOS,2,7,3,4,1
SINALOA,25,EL FUERTE,010,LOS AMOLES,2,4,1,3,1
SINALOA,25,EL FUERTE,010,LOS CAPOMITOS,1,8,4,4,1
SINALOA,25,EL FUERTE,010,LOS CAPOMOS,4,173,86,87,13
SINALOA,25,EL FUERTE,010,LOS CHARCOS,2,7,3,4,1
SINALOA,25,EL FUERTE,010,LOS HORNILLOS,3,55,26,29,5
SINALOA,25,EL FUERTE,010,LOS MUSOS,1,9,4,5,1
SINALOA,25,EL FUERTE,010,LOS MUSOS MARGEN DERECHA,2,17,10,7,2
SINALOA,25,EL FUERTE,010,LOS OJITOS,2,22,8,14,2
SINALOA,25,EL FUERTE,010,LOS PARAJES,2,33,18,15,2
SINALOA,25,EL FUERTE,010,LOS TAXTES,2,247,119,128,11
SINALOA,25,EL FUERTE,010,MACOYAHUI (EL SUFRAGIO),3,143,57,86,8
SINALOA,25,EL FUERTE,010,MOCHICAHUI,9,3801,2231,1570,242
SINALOA,25,EL FUERTE,010,MULANJEY [ESTACIÓN VEGA],4,162,74,88,9
SINALOA,25,EL FUERTE,010,NUEVO SAN FELIPE,2,7,6,1,1
SINALOA,25,EL FUERTE,010,OCOLOME,1,11,3,8,1
SINALOA,25,EL FUERTE,010,PALO VERDE,3,113,60,53,9
SINALOA,25,EL FUERTE,010,POTRERO DE LOS SOTO,3,52,29,23,4
SINALOA,25,EL FUERTE,010,PRESA DE LOS VALDEZ,1,4,3,1,1
SINALOA,25,EL FUERTE,010,PRODUCTO DE LA REVOLUCIÓN,2,76,34,42,3
SINALOA,25,EL FUERTE,010,RANCHO DE LOS PACHECO,2,5,2,3,1
SINALOA,25,EL FUERTE,010,RINCÓN DE ALISO,4,142,63,79,8
SINALOA,25,EL FUERTE,010,SACA DE AGUA,3,13,9,4,2
SINALOA,25,EL FUERTE,010,SAN ANTONIO,3,34,17,17,4
SINALOA,25,EL FUERTE,010,SAN BLAS,14,1927,975,952,144
SINALOA,25,EL FUERTE,010,SAN JOSÉ DE CAHUINAHUA,3,34,15,19,4
SINALOA,25,EL FUERTE,010,SAN LÁZARO,2,28,10,18,2
SINALOA,25,EL FUERTE,010,SAN PEDRO,3,75,40,35,7
SINALOA,25,EL FUERTE,010,SAN RAFAEL,3,60,26,34,6
SINALOA,25,EL FUERTE,010,SANTA ANA,1,7,4,3,1
SINALOA,25,EL FUERTE,010,SANTA BLANCA,2,31,18,13,2
SINALOA,25,EL FUERTE,010,SANTA LUCÍA,1,7,3,4,1
SINALOA,25,EL FUERTE,010,SANTA MARÍA,2,30,18,12,3
SINALOA,25,EL FUERTE,010,SIBAJAHUI,3,105,53,52,6
SINALOA,25,EL FUERTE,010,SIBIRIJOA,2,15,8,7,2
SINALOA,25,EL FUERTE,010,TEHUECO,5,341,159,182,19
SINALOA,25,EL FUERTE,010,TEPIC,2,40,24,16,3
SINALOA,25,EL FUERTE,010,TÉROQUE VIEJO,3,182,78,104,12
SINALOA,25,EL FUERTE,010,TESILA,5,304,167,137,20
SINALOA,25,EL FUERTE,010,TETAMBOCA,3,59,29,30,4
SINALOA,25,EL FUERTE,010,TETAROBA,3,89,44,45,17
SINALOA,25,EL FUERTE,010,TETAROBITA,1,5,2,3,1
SINALOA,25,EL FUERTE,010,TETASIARI,3,6,2,4,2
SINALOA,25,EL FUERTE,010,ZOZORIQUE,3,87,42,45,5
SINALOA,25,GUASAVE,011,15 DE OCTUBRE,1,6,3,3,1
SINALOA,25,GUASAVE,011,24 DE FEBRERO,2,274,133,141,11
SINALOA,25,GUASAVE,011,ADOLFO RUIZ CORTINES,23,3622,1802,1820,219
SINALOA,25,GUASAVE,011,ALAMITO CAIMANERO,2,19,10,9,2
SINALOA,25,GUASAVE,011,BAMOA,4,614,301,313,37
SINALOA,25,GUASAVE,011,BOCA DEL RÍO,3,112,52,60,7
SINALOA,25,GUASAVE,011,BUEN RETIRO (EL RETIRO),2,233,117,116,10
SINALOA,25,GUASAVE,011,BUENAVISTA,3,129,61,68,8
SINALOA,25,GUASAVE,011,CAIMANERO,2,227,114,113,8
SINALOA,25,GUASAVE,011,CALLEJONES DE GUASAVITO,4,807,404,403,54
SINALOA,25,GUASAVE,011,CALLEJONES DE TAMAZULA,2,69,23,46,4
SINALOA,25,GUASAVE,011,CAMPO BÓRQUEZ,2,64,28,36,3
SINALOA,25,GUASAVE,011,CAMPO CALIFORNIA,2,22,12,10,2
SINALOA,25,GUASAVE,011,CAMPO CRUCERO [CAMPO DÍAZ],2,59,26,33,3
SINALOA,25,GUASAVE,011,CAMPO PRECIADO,1,12,5,7,1
SINALOA,25,GUASAVE,011,CAMPO SAN JOSÉ,2,254,114,140,9
SINALOA,25,GUASAVE,011,CAMPO SANTA ISABEL,1,2,1,1,2
SINALOA,25,GUASAVE,011,CARBONERAS,2,104,47,57,5
SINALOA,25,GUASAVE,011,CARRICITOS,1,18,9,9,2
SINALOA,25,GUASAVE,011,CASA BLANCA,4,617,313,304,54
SINALOA,25,GUASAVE,011,CHARCO LARGO,1,7,4,3,1
SINALOA,25,GUASAVE,011,CHINO DE LOS LÓPEZ,1,20,9,11,1
SINALOA,25,GUASAVE,011,CHOIPA,4,204,101,103,16
SINALOA,25,GUASAVE,011,CHOIPA DOS,1,8,5,3,1
SINALOA,25,GUASAVE,011,CHOROHUI,3,74,33,41,5
SINALOA,25,GUASAVE,011,CINCO DE MAYO (AGUA BLANCA),2,94,48,46,4
SINALOA,25,GUASAVE,011,COFRADÍA DE TAMAZULA (LA COFRADÍA),2,152,74,78,8
SINALOA,25,GUASAVE,011,COREREPE (EL GALLO),8,844,427,417,69
SINALOA,25,GUASAVE,011,CRUZ BLANCA,2,71,41,30,4
SINALOA,25,GUASAVE,011,CUATRO CAMINOS,1,7,2,5,1
SINALOA,25,GUASAVE,011,CUBIRI DEL AMOLE,1,20,7,13,1
SINALOA,25,GUASAVE,011,CUESTA DE ARRIBA,2,76,35,41,3
SINALOA,25,GUASAVE,011,DORADO NÚMERO TRES (DORADITO),2,17,8,9,2
SINALOA,25,GUASAVE,011,EJIDO ABELARDO L. RODRÍGUEZ,3,70,40,30,5
SINALOA,25,GUASAVE,011,EJIDO CALLEJÓN DE TAMAZULA,3,152,71,81,4
SINALOA,25,GUASAVE,011,EJIDO CHARCO LARGO,2,13,6,7,2
SINALOA,25,GUASAVE,011,EJIDO CHINO DE LOS LÓPEZ,4,63,30,33,7
SINALOA,25,GUASAVE,011,EJIDO CHOROHUI,2,12,3,9,2
SINALOA,25,GUASAVE,011,EJIDO EL TECOMATE,2,23,7,16,3
SINALOA,25,GUASAVE,011,EJIDO FIGUEROA,3,141,66,75,8
SINALOA,25,GUASAVE,011,EJIDO LA ENTRADA (EL POBLADO),4,401,193,208,30
SINALOA,25,GUASAVE,011,EJIDO LOS PINITOS,3,53,29,24,4
SINALOA,25,GUASAVE,011,EL AMOLE,2,121,64,57,7
SINALOA,25,GUASAVE,011,EL BURRIÓN,7,916,428,488,69
SINALOA,25,GUASAVE,011,EL CAMPESINO,2,136,65,71,6
SINALOA,25,GUASAVE,011,EL CARACOL,3,219,110,109,11
SINALOA,25,GUASAVE,011,EL COLORADITO,2,35,19,16,2
SINALOA,25,GUASAVE,011,EL CRUCERO,2,14,5,9,2
SINALOA,25,GUASAVE,011,EL CUBILETE (EL CUBILETE NÚMERO UNO),4,507,247,260,34
SINALOA,25,GUASAVE,011,EL CUITABÓN,2,52,22,30,3
SINALOA,25,GUASAVE,011,EL DORADO NÚMERO DOS,1,11,7,4,1
SINALOA,25,GUASAVE,011,EL DORADO NÚMERO UNO,2,48,23,25,3
SINALOA,25,GUASAVE,011,EL HUITUSSI,4,547,281,266,39
SINALOA,25,GUASAVE,011,EL HUITUSSI Y ANEXOS (EL HUITUSSITO),2,91,51,40,5
SINALOA,25,GUASAVE,011,EL MARCOL,2,158,85,73,8
SINALOA,25,GUASAVE,011,EL MEZQUITAL,2,36,15,21,3
SINALOA,25,GUASAVE,011,EL MEZQUITÓN,2,17,9,8,2
SINALOA,25,GUASAVE,011,EL PAPACHAL,1,6,2,4,1
SINALOA,25,GUASAVE,011,EL PITAHAYAL,3,227,102,125,23
SINALOA,25,GUASAVE,011,EL PLATANITO,3,342,172,170,28
SINALOA,25,GUASAVE,011,EL PROGRESO,4,350,171,179,37
SINALOA,25,GUASAVE,011,EL REPARO,1,8,5,3,1
SINALOA,25,GUASAVE,011,EL SABINO,4,265,130,135,14
SINALOA,25,GUASAVE,011,EL SACRIFICIO,3,164,72,92,8
SINALOA,25,GUASAVE,011,EL SERRANITO,2,44,25,19,4
SINALOA,25,GUASAVE,011,EL TORTUGO,3,48,18,30,4
SINALOA,25,GUASAVE,011,EL TORUNO,2,39,16,23,3
SINALOA,25,GUASAVE,011,EL VARAL (SAN SEBASTIÁN NÚMERO UNO),5,646,346,300,29
SINALOA,25,GUASAVE,011,EL ZOPILOTE,2,93,44,49,5
SINALOA,25,GUASAVE,011,EMILIO PORTES GIL (AGUA BLANCA),3,168,83,85,9
SINALOA,25,GUASAVE,011,ESTACIÓN BAMOA (CAMPO WILSON),11,1825,868,957,124
SINALOA,25,GUASAVE,011,ESTACIÓN CAPOMAS,3,252,122,130,21
SINALOA,25,GUASAVE,011,FLOR DE MAYO,2,42,21,21,3
SINALOA,25,GUASAVE,011,FRANCISCO R. SERRANO,3,192,103,89,20
SINALOA,25,GUASAVE,011,GABRIEL LEYVA SOLANO (BENITO JUÁREZ),28,5748,2886,2862,302
SINALOA,25,GUASAVE,011,GAMBINO,3,137,69,68,8
SINALOA,25,GUASAVE,011,GUASAVE,115,29857,15721,14136,2269
SINALOA,25,GUASAVE,011,GUASAVITO,4,286,137,149,13
SINALOA,25,GUASAVE,011,HERCULANO DE LA ROCHA,2,129,51,78,6
SINALOA,25,GUASAVE,011,JAVIER ROJO GÓMEZ,2,225,116,109,10
SINALOA,25,GUASAVE,011,JESÚS MARÍA,3,23,10,13,3
SINALOA,25,GUASAVE,011,LA BEBELAMA,2,82,34,48,4
SINALOA,25,GUASAVE,011,LA BRECHA,4,428,213,215,39
SINALOA,25,GUASAVE,011,LA CHUPARROSA,5,213,105,108,13
SINALOA,25,GUASAVE,011,LA CUCHILLA,1,14,5,9,1
SINALOA,25,GUASAVE,011,LA CUERDA,1,20,9,11,1
SINALOA,25,GUASAVE,011,LA CUESTONA,3,115,58,57,11
SINALOA,25,GUASAVE,011,LA ENTRADA VIEJA,1,12,5,7,1
SINALOA,25,GUASAVE,011,LA ESCALERA,2,69,31,38,3
SINALOA,25,GUASAVE,011,LA GUAMUCHILERA,1,5,1,4,1
SINALOA,25,GUASAVE,011,LA NORIA,2,178,90,88,8
SINALOA,25,GUASAVE,011,LA PELTI,2,31,16,15,2
SINALOA,25,GUASAVE,011,LA PICHIHUILA,2,100,54,46,4
SINALOA,25,GUASAVE,011,LA SABANILLA [CAMPO PRECIADO],1,46,27,19,2
SINALOA,25,GUASAVE,011,LA TRINIDAD,6,1075,536,539,72
SINALOA,25,GUASAVE,011,LA UVA,1,12,6,6,1
SINALOA,25,GUASAVE,011,LADRILLERAS DE OCORO,2,178,94,84,8
SINALOA,25,GUASAVE,011,LAS AMÉRICAS,2,160,72,88,8
SINALOA,25,GUASAVE,011,LAS BRISAS (EMILIANO ZAPATA),6,570,276,294,43
SINALOA,25,GUASAVE,011,LAS CAÑADAS NÚMERO DOS,2,18,8,10,2
SINALOA,25,GUASAVE,011,LAS CAÑADAS NÚMERO UNO,3,99,53,46,6
SINALOA,25,GUASAVE,011,LAS COLONIAS (COLONIA ÁNGEL FLORES),3,110,57,53,7
SINALOA,25,GUASAVE,011,LAS COMPUERTAS,1,10,7,3,1
SINALOA,25,GUASAVE,011,LAS CRUCES,1,1636,446,1190,81
SINALOA,25,GUASAVE,011,LAS CUCHILLAS,1,11,3,8,1
SINALOA,25,GUASAVE,011,LAS CULEBRAS,3,100,51,49,6
SINALOA,25,GUASAVE,011,LAS FLORES,4,85,45,40,8
SINALOA,25,GUASAVE,011,LAS HIGUERAS (LAS FLORES),2,31,19,12,3
SINALOA,25,GUASAVE,011,LAS JUNTAS DE CHAMICARI,2,98,49,49,5
SINALOA,25,GUASAVE,011,LAS JUNTITAS DE VALDEZ,2,46,24,22,3
SINALOA,25,GUASAVE,011,LAS LADRILLERAS DEL BURRIÓN,1,9,3,6,1
SINALOA,25,GUASAVE,011,LAS MORAS,5,682,328,354,53
SINALOA,25,GUASAVE,011,LAS MORITAS,3,32,14,18,3
SINALOA,25,GUASAVE,011,LAS PALMITAS,2,9,2,7,2
SINALOA,25,GUASAVE,011,LAS PARRITAS,3,115,60,55,7
SINALOA,25,GUASAVE,011,LAS PITAHAYAS,2,8,6,2,2
SINALOA,25,GUASAVE,011,LAS PITAHAYITAS,2,24,8,16,2
SINALOA,25,GUASAVE,011,LAS PLAYAS (LA PALMA),2,45,21,24,3
SINALOA,25,GUASAVE,011,LAS QUEMAZONES,2,206,111,95,9
SINALOA,25,GUASAVE,011,LEÓN FONSECA (ESTACIÓN VERDURA),5,1023,492,531,73
SINALOA,25,GUASAVE,011,LOS ÁNGELES,5,878,430,448,53
SINALOA,25,GUASAVE,011,LOS HORNOS NÚMERO DOS,2,77,31,46,5
SINALOA,25,GUASAVE,011,LOS HORNOS NÚMERO UNO (SALSIPUEDES),2,81,39,42,4
SINALOA,25,GUASAVE,011,MAXIMILIANO R. LÓPEZ (EL POCHOTE),2,96,41,55,5
SINALOA,25,GUASAVE,011,MIGUEL ALEMÁN,3,137,73,64,8
SINALOA,25,GUASAVE,011,MIGUEL HIDALGO,2,43,25,18,2
SINALOA,25,GUASAVE,011,NÍO,7,793,399,394,60
SINALOA,25,GUASAVE,011,NOROTILLOS,2,106,49,57,5
SINALOA,25,GUASAVE,011,NOROTÍO (EL GATO),2,18,10,8,2
SINALOA,25,GUASAVE,011,NOROTÍOS CUBA,2,27,11,16,2
SINALOA,25,GUASAVE,011,ORBA (INFIERNITO),2,207,105,102,9
SINALOA,25,GUASAVE,011,PALMARITO DE LOS ANGULO,2,24,8,16,2
SINALOA,25,GUASAVE,011,PALOS VERDES,4,481,247,234,33
SINALOA,25,GUASAVE,011,PLAN DEL RÍO,1,23,9,14,1
SINALOA,25,GUASAVE,011,PORTUGUÉS DE GÁLVEZ,3,303,141,162,23
SINALOA,25,GUASAVE,011,PUEBLO VIEJO,2,216,108,108,8
SINALOA,25,GUASAVE,011,RANCHITO DE CAIMANERO (INFIERNITO),2,9,6,3,2
SINALOA,25,GUASAVE,011,RANCHITO DE CASTRO,2,172,81,91,8
SINALOA,25,GUASAVE,011,RANCHITO DE INZUNZA,2,88,44,44,4
SINALOA,25,GUASAVE,011,RANCHITO DE ZAVALA,2,124,65,59,8
SINALOA,25,GUASAVE,011,ROBERTO BARRIOS,3,107,51,56,15
SINALOA,25,GUASAVE,011,SABANILLAS DEL BURRIÓN,1,8,2,6,1
SINALOA,25,GUASAVE,011,SAN ANTONIO,2,79,36,43,5
SINALOA,25,GUASAVE,011,SAN FERNANDO,2,123,65,58,7
SINALOA,25,GUASAVE,011,SAN FRANCISCO DE CAPOMOS (EL CHARRO),1,18,11,7,1
SINALOA,25,GUASAVE,011,SAN FRANCISQUITO DE CAPOMOS,1,6,3,3,1
SINALOA,25,GUASAVE,011,SAN GABRIEL,2,60,30,30,3
SINALOA,25,GUASAVE,011,SAN JOSÉ DE GUAYPARIME,2,27,12,15,2
SINALOA,25,GUASAVE,011,SAN JOSÉ DE LA BRECHA,2,109,44,65,5
SINALOA,25,GUASAVE,011,SAN JOSÉ DE PALOS BLANCOS (PALOS BLANCOS),3,241,117,124,14
SINALOA,25,GUASAVE,011,SAN PEDRO GUASAVE (EL RANCHITO),2,201,103,98,9
SINALOA,25,GUASAVE,011,SAN PEDRO PAREDES,2,76,44,32,4
SINALOA,25,GUASAVE,011,SAN RAFAEL (GENERAL MIGUEL VALLE DÁVALOS),3,239,109,130,20
SINALOA,25,GUASAVE,011,SAN SEBASTIÁN NÚMERO DOS,3,119,62,57,6
SINALOA,25,GUASAVE,011,SANTA TERESA DE LOS OLIVOS (EL PINITO),2,16,8,8,2
SINALOA,25,GUASAVE,011,TAHUILANA (EL CHORIZO),2,16,7,9,3
SINALOA,25,GUASAVE,011,TAMAZULA,4,807,400,407,63
SINALOA,25,GUASAVE,011,TAPACHULA,2,26,8,18,2
SINALOA,25,GUASAVE,011,TECOMATE,2,208,106,102,9
SINALOA,25,GUASAVE,011,TERAHUITO,4,457,218,239,33
SINALOA,25,GUASAVE,011,TIERRA Y LIBERTAD,1,17,8,9,1
SINALOA,25,GUASAVE,011,TRES DE MAYO (NOMBRE FEO),2,20,9,11,2
SINALOA,25,GUASAVE,011,UTATAVE (MAUTILLOS),2,79,34,45,4
SINALOA,25,GUASAVE,011,VALLE DE HUYAQUI (LOS SOLARES),1,13,7,6,1
SINALOA,25,GUASAVE,011,VICENTE GUERRERO,2,93,45,48,5
SINALOA,25,GUASAVE,011,VILLA SAN JOSÉ [LA COSTEÑA],1,77,39,38,2
SINALOA,25,MAZATLÁN,012,AMPLIACIÓN EL CASTILLO,1,13,6,7,1
SINALOA,25,MAZATLÁN,012,ARMADILLO,3,41,19,22,4
SINALOA,25,MAZATLÁN,012,BARRÓN,4,479,224,255,35
SINALOA,25,MAZATLÁN,012,CAMACHO,2,23,6,17,2
SINALOA,25,MAZATLÁN,012,CHICURA DE LA NORIA,2,10,5,5,2
SINALOA,25,MAZATLÁN,012,COFRADÍA (COFRADÍA DE LEYVA SOLANO),3,76,39,37,7
SINALOA,25,MAZATLÁN,012,EL AGUAJE DE COSTILLA,2,19,8,11,2
SINALOA,25,MAZATLÁN,012,EL AMOLE DEL QUELITE,2,5,3,2,1
SINALOA,25,MAZATLÁN,012,EL BAJÍO,3,93,52,41,5
SINALOA,25,MAZATLÁN,012,EL CASTILLO,4,1199,594,605,67
SINALOA,25,MAZATLÁN,012,EL CERRO VERDE,3,7,5,2,2
SINALOA,25,MAZATLÁN,012,EL CHILILLO,2,67,38,29,3
SINALOA,25,MAZATLÁN,012,EL ESPINAL,2,36,17,19,2
SINALOA,25,MAZATLÁN,012,EL GUAYABO,2,35,18,17,3
SINALOA,25,MAZATLÁN,012,EL HABAL,4,472,233,239,38
SINALOA,25,MAZATLÁN,012,EL HABALITO DEL TUBO,2,39,21,18,2
SINALOA,25,MAZATLÁN,012,EL MORAL,3,35,12,23,3
SINALOA,25,MAZATLÁN,012,EL PALMILLAR (EL PALMILLAR DE LOS AGÜEROS),1,6,5,1,1
SINALOA,25,MAZATLÁN,012,EL PLACER,3,28,12,16,3
SINALOA,25,MAZATLÁN,012,EL POTRERO DE CARRASCO,2,49,25,24,4
SINALOA,25,MAZATLÁN,012,EL POZOLE,2,31,15,16,2
SINALOA,25,MAZATLÁN,012,EL PUENTE DEL QUELITE,2,52,27,25,2
SINALOA,25,MAZATLÁN,012,EL QUELITE,4,396,186,210,27
SINALOA,25,MAZATLÁN,012,EL QUEMADO,3,159,75,84,10
SINALOA,25,MAZATLÁN,012,EL RECODO,4,153,82,71,12
SINALOA,25,MAZATLÁN,012,EL RECREO,4,193,114,79,9
SINALOA,25,MAZATLÁN,012,EL ROBLE,4,423,219,204,47
SINALOA,25,MAZATLÁN,012,EL SALTO,3,39,17,22,3
SINALOA,25,MAZATLÁN,012,EL TECOMATE DE LA NORIA,2,10,6,4,2
SINALOA,25,MAZATLÁN,012,EL TECOMATE DE SIQUEROS,2,27,16,11,2
SINALOA,25,MAZATLÁN,012,EL VAINILLO,4,146,73,73,11
SINALOA,25,MAZATLÁN,012,EL WALAMO,4,634,325,309,41
SINALOA,25,MAZATLÁN,012,EL ZAPOTE,2,100,46,54,5
SINALOA,25,MAZATLÁN,012,ESCAMILLAS,4,398,193,205,50
SINALOA,25,MAZATLÁN,012,GUAMÚCHIL,3,14,6,8,3
SINALOA,25,MAZATLÁN,012,JUANTILLOS,3,14,9,5,3
SINALOA,25,MAZATLÁN,012,LA AMAPA,3,104,46,58,6
SINALOA,25,MAZATLÁN,012,LA NORIA DE SAN ANTONIO (LA NORIA),4,201,97,104,22
SINALOA,25,MAZATLÁN,012,LA PALMA SOLA,3,36,18,18,3
SINALOA,25,MAZATLÁN,012,LA SÁBILA,3,22,8,14,3
SINALOA,25,MAZATLÁN,012,LA TUNA,3,58,30,28,4
SINALOA,25,MAZATLÁN,012,LA URRACA NUEVA,2,31,12,19,2
SINALOA,25,MAZATLÁN,012,LA URRACA VIEJA,2,42,25,17,2
SINALOA,25,MAZATLÁN,012,LAS HIGUERAS DEL CONCHI,2,115,58,57,4
SINALOA,25,MAZATLÁN,012,LOMAS DE MONTERREY,2,120,64,56,5
SINALOA,25,MAZATLÁN,012,LOMAS DEL GUAYABO,2,29,14,15,2
SINALOA,25,MAZATLÁN,012,LOS COPALES,3,11,4,7,2
SINALOA,25,MAZATLÁN,012,LOS LIMONES,2,19,10,9,2
SINALOA,25,MAZATLÁN,012,LOS LLANITOS,2,25,8,17,2
SINALOA,25,MAZATLÁN,012,LOS ZAPOTES,3,66,23,43,4
SINALOA,25,MAZATLÁN,012,MÁRMOL DE SALCIDO (MÁRMOL),4,245,122,123,25
SINALOA,25,MAZATLÁN,012,MAZATLÁN,497,129675,66148,63527,9047
SINALOA,25,MAZATLÁN,012,METATES,3,14,11,3,2
SINALOA,25,MAZATLÁN,012,MIRAVALLES,2,18,9,9,2
SINALOA,25,MAZATLÁN,012,PALMILLAS,2,25,13,12,2
SINALOA,25,MAZATLÁN,012,PICHILINGUE,1,15,8,7,1
SINALOA,25,MAZATLÁN,012,PUERTA DE CANOAS,2,46,29,17,3
SINALOA,25,MAZATLÁN,012,PUERTA DE SAN MARCOS,3,36,15,21,3
SINALOA,25,MAZATLÁN,012,SAN FRANCISQUITO,2,96,47,49,5
SINALOA,25,MAZATLÁN,012,SAN MARCOS,4,193,105,88,20
SINALOA,25,MAZATLÁN,012,SAN PABLO,1,5,1,4,1
SINALOA,25,MAZATLÁN,012,SIQUEROS,4,148,68,80,11
SINALOA,25,MAZATLÁN,012,TELCOYONQUI,2,3,2,1,2
SINALOA,25,MAZATLÁN,012,VERANOS,3,35,18,17,4
SINALOA,25,MAZATLÁN,012,VILLA UNIÓN,23,4165,2100,2065,283
SINALOA,25,MOCORITO,013,AGUA SALADA,2,15,7,8,2
SINALOA,25,MOCORITO,013,AGUAPEPE DE LOS GALLARDO,2,7,3,4,1
SINALOA,25,MOCORITO,013,ALHUEYCITO,2,17,11,6,2
SINALOA,25,MOCORITO,013,BACAMOPA,2,10,7,3,2
SINALOA,25,MOCORITO,013,BATAMOTITA,2,6,3,3,1
SINALOA,25,MOCORITO,013,BEQUILLOS,2,14,10,4,2
SINALOA,25,MOCORITO,013,BOCA DE ARROYO,2,39,24,15,4
SINALOA,25,MOCORITO,013,CAHUINAHUATO,3,28,14,14,3
SINALOA,25,MOCORITO,013,CAIMANERO,3,319,163,156,28
SINALOA,25,MOCORITO,013,CALOMATO,2,11,6,5,2
SINALOA,25,MOCORITO,013,CANUTILLOS,1,8,1,7,1
SINALOA,25,MOCORITO,013,CAPIRATO,3,91,46,45,7
SINALOA,25,MOCORITO,013,CERRO AGUDO,4,267,124,143,29
SINALOA,25,MOCORITO,013,CHICORATO,2,11,4,7,2
SINALOA,25,MOCORITO,013,COLONIA EL ROSARIO (CHAYO) [RESTAURANTE],2,44,20,24,3
SINALOA,25,MOCORITO,013,CONSTANCIO RODRÍGUEZ (LA OTRA BANDA),2,47,25,22,3
SINALOA,25,MOCORITO,013,CORRAL QUEMADO,2,23,17,6,2
SINALOA,25,MOCORITO,013,DIQUE MARIQUITA,1,18,8,10,1
SINALOA,25,MOCORITO,013,EJIDO CALOMATO (CALOMATILLO),3,67,40,27,4
SINALOA,25,MOCORITO,013,EL AGUAJE DE PERICOS,3,49,22,27,4
SINALOA,25,MOCORITO,013,EL BECAL,1,5,3,2,1
SINALOA,25,MOCORITO,013,EL CAPULE,3,22,10,12,3
SINALOA,25,MOCORITO,013,EL CARRIZO,2,18,7,11,2
SINALOA,25,MOCORITO,013,EL CHINAL,2,13,5,8,2
SINALOA,25,MOCORITO,013,EL GALLO,1,12,5,7,1
SINALOA,25,MOCORITO,013,EL GUADARE,2,14,7,7,2
SINALOA,25,MOCORITO,013,EL GUASIMAL,2,21,11,10,2
SINALOA,25,MOCORITO,013,EL LIMÓN,2,10,4,6,2
SINALOA,25,MOCORITO,013,EL MANCHÓN,2,30,17,13,2
SINALOA,25,MOCORITO,013,EL MEZQUITE,4,151,75,76,12
SINALOA,25,MOCORITO,013,EL PALMAR DE LOS LEAL,4,117,60,57,16
SINALOA,25,MOCORITO,013,EL PLATANAR,2,18,11,7,2
SINALOA,25,MOCORITO,013,EL POCHOTE,1,8,4,4,1
SINALOA,25,MOCORITO,013,EL POTRERO DE LAS PERDICES,3,12,6,6,3
SINALOA,25,MOCORITO,013,EL POTRERO GRANDE,2,6,2,4,1
SINALOA,25,MOCORITO,013,EL PROGRESO (EL JALÓN),2,72,30,42,4
SINALOA,25,MOCORITO,013,EL RECODO,2,5,4,1,1
SINALOA,25,MOCORITO,013,EL SABINITO,2,18,9,9,2
SINALOA,25,MOCORITO,013,EL SALTO,3,37,12,25,3
SINALOA,25,MOCORITO,013,EL SALTO (DE CAPIRATO),2,12,5,7,2
SINALOA,25,MOCORITO,013,EL SAUCE DE LOS GÁMEZ,3,49,22,27,5
SINALOA,25,MOCORITO,013,EL TULE,3,33,14,19,4
SINALOA,25,MOCORITO,013,EL VALLE DE LEYVA SOLANO (EL VALLE),4,256,126,130,23
SINALOA,25,MOCORITO,013,EL ZAPOTE DE LOS MOYA,2,29,9,20,3
SINALOA,25,MOCORITO,013,ESTACIÓN RETES,2,25,16,9,2
SINALOA,25,MOCORITO,013,GUAMUCHILERA SEGUNDA,2,143,71,72,8
SINALOA,25,MOCORITO,013,GUAMÚCHILES ALTOS,2,3,2,1,1
SINALOA,25,MOCORITO,013,HIGUERA DE LOS VEGA,3,220,103,117,19
SINALOA,25,MOCORITO,013,JUAN ESCUTIA,2,61,27,34,4
SINALOA,25,MOCORITO,013,LA BEBELAMA,1,4,1,3,1
SINALOA,25,MOCORITO,013,LA CALERA DE CAPIRATO,2,19,6,13,2
SINALOA,25,MOCORITO,013,LA CASCADA,3,29,15,14,3
SINALOA,25,MOCORITO,013,LA COFRADÍA DE CAPIRATO,3,80,38,42,6
SINALOA,25,MOCORITO,013,LA COFRADÍA DE SOTO,3,89,37,52,6
SINALOA,25,MOCORITO,013,LA HIGUERA CAÍDA,2,9,7,2,1
SINALOA,25,MOCORITO,013,LA HUERTA,2,32,17,15,3
SINALOA,25,MOCORITO,013,LA JOYA DE LOS LÓPEZ,2,13,8,5,2
SINALOA,25,MOCORITO,013,LA LADRILLERA,1,24,13,11,1
SINALOA,25,MOCORITO,013,LA LAGUNA DE LOS BOJÓRQUEZ,2,20,12,8,2
SINALOA,25,MOCORITO,013,LA MISIÓN,2,22,11,11,2
SINALOA,25,MOCORITO,013,LA NORIA DE ABAJO,2,31,14,17,3
SINALOA,25,MOCORITO,013,LA NORIA DE ARRIBA,3,43,21,22,4
SINALOA,25,MOCORITO,013,LA PIONILLA,1,6,3,3,1
SINALOA,25,MOCORITO,013,LA TASAJERA,2,12,7,5,2
SINALOA,25,MOCORITO,013,LA VAINILLA,3,30,14,16,4
SINALOA,25,MOCORITO,013,LAS AGUAMITAS,2,43,20,23,2
SINALOA,25,MOCORITO,013,LAS JUNTAS,2,24,8,16,2
SINALOA,25,MOCORITO,013,LAS MILPAS DE LOS GONZÁLEZ,2,10,6,4,1
SINALOA,25,MOCORITO,013,LAS TAHONAS,2,17,12,5,2
SINALOA,25,MOCORITO,013,LO DE FÉLIX,2,18,11,7,2
SINALOA,25,MOCORITO,013,LO DE GABRIEL,2,22,14,8,2
SINALOA,25,MOCORITO,013,LOMA REDONDA,1,6,5,1,1
SINALOA,25,MOCORITO,013,LOMAS BLANCAS,2,39,17,22,3
SINALOA,25,MOCORITO,013,LOS ALTOS DE JALISCO,2,13,6,7,2
SINALOA,25,MOCORITO,013,LOS CHINOS,3,35,20,15,4
SINALOA,25,MOCORITO,013,LOS LETREROS,2,9,3,6,2
SINALOA,25,MOCORITO,013,MAJADA DE ABAJO,3,107,60,47,7
SINALOA,25,MOCORITO,013,MELCHOR OCAMPO,2,208,107,101,9
SINALOA,25,MOCORITO,013,MEZQUITE GORDO,1,7,2,5,1
SINALOA,25,MOCORITO,013,MOCORITO,14,2226,1195,1031,183
SINALOA,25,MOCORITO,013,OPUS DEI (EL DIQUE),1,19,8,11,2
SINALOA,25,MOCORITO,013,PALMA DE LOS ROCHA,2,8,2,6,1
SINALOA,25,MOCORITO,013,PALMARITO DE LA SIERRA,3,26,11,15,3
SINALOA,25,MOCORITO,013,PALMARITO MINERAL,2,31,16,15,2
SINALOA,25,MOCORITO,013,PALO DE ASTA,3,22,11,11,2
SINALOA,25,MOCORITO,013,PERICOS,7,1639,836,803,99
SINALOA,25,MOCORITO,013,POTRERILLOS,2,21,12,9,2
SINALOA,25,MOCORITO,013,POTRERO DE LOS GASTÉLUM,3,51,28,23,6
SINALOA,25,MOCORITO,013,POTRERO DE LOS SÁNCHEZ (ESTACIÓN TECHA),3,190,97,93,13
SINALOA,25,MOCORITO,013,RANCHO VIEJO,5,161,93,68,11
SINALOA,25,MOCORITO,013,RECOVECO,4,932,550,382,70
SINALOA,25,MOCORITO,013,ROSA MORADA,2,44,19,25,3
SINALOA,25,MOCORITO,013,SAN BENITO,4,130,59,71,17
SINALOA,25,MOCORITO,013,SAN FRANCISCO (EL CRUCERO),2,18,10,8,2
SINALOA,25,MOCORITO,013,SANTA ROSALÍA,4,79,40,39,9
SINALOA,25,MOCORITO,013,SANTIAGO DE COMANITO (COMANITO),4,138,69,69,9
SINALOA,25,MOCORITO,013,TECOMATE,2,28,16,12,2
SINALOA,25,MOCORITO,013,TEPANTITA,2,43,21,22,3
SINALOA,25,MOCORITO,013,TERRERO DE LOS PACHECO,3,31,21,10,3
SINALOA,25,MOCORITO,013,TIERRITAS BLANCAS,1,5,4,1,1
SINALOA,25,MOCORITO,013,TOBORA,1,1,1,0,1
SINALOA,25,MOCORITO,013,ZAPOTILLO,3,93,50,43,7
SINALOA,25,ROSARIO,014,AGUA CALIENTE DE LOS PANALES,3,57,31,26,4
SINALOA,25,ROSARIO,014,AGUA VERDE,6,1179,568,611,83
SINALOA,25,ROSARIO,014,APODERADO,2,246,127,119,13
SINALOA,25,ROSARIO,014,BUENAVISTA,2,37,20,17,4
SINALOA,25,ROSARIO,014,CACALOTÁN,3,297,155,142,27
SINALOA,25,ROSARIO,014,CAJÓN VERDE,4,136,63,73,8
SINALOA,25,ROSARIO,014,CHAMETLA,4,374,197,177,36
SINALOA,25,ROSARIO,014,CHARCO HONDO,4,131,70,61,10
SINALOA,25,ROSARIO,014,CHELE,4,160,83,77,14
SINALOA,25,ROSARIO,014,CHILILLOS,3,177,83,94,5
SINALOA,25,ROSARIO,014,COPALES,2,38,15,23,3
SINALOA,25,ROSARIO,014,CORRAL DE PIEDRAS,3,24,10,14,3
SINALOA,25,ROSARIO,014,CRUZ PEDREGOZA,2,68,35,33,5
SINALOA,25,ROSARIO,014,DURANGUITO,2,10,3,7,2
SINALOA,25,ROSARIO,014,EJIDO CAJÓN OJO DE AGUA NÚMERO DOS,2,342,177,165,14
SINALOA,25,ROSARIO,014,EJIDO FRANCISCO VILLA (LAS GARZAS),2,52,24,28,3
SINALOA,25,ROSARIO,014,EJIDO GREGORIO VÁZQUEZ MORENO (SAN JOACHÍN),3,252,126,126,12
SINALOA,25,ROSARIO,014,EJIDO PONCE,3,127,61,66,8
SINALOA,25,ROSARIO,014,EL EJIDO TABLÓN NÚMERO UNO (LAS CRUCES CUATAS),4,198,110,88,13
SINALOA,25,ROSARIO,014,EL MATADERO,3,117,54,63,8
SINALOA,25,ROSARIO,014,EL PORTEZUELO,2,17,10,7,2
SINALOA,25,ROSARIO,014,EL POZOLE,4,668,325,343,55
SINALOA,25,ROSARIO,014,EL ROSARIO,31,5331,2666,2665,393
SINALOA,25,ROSARIO,014,EL TABLÓN NÚMERO DOS,2,23,9,14,2
SINALOA,25,ROSARIO,014,EL VALAMO,2,12,4,8,2
SINALOA,25,ROSARIO,014,EL ZOPILOTE,2,51,25,26,3
SINALOA,25,ROSARIO,014,EMILIANO ZAPATA,2,68,33,35,4
SINALOA,25,ROSARIO,014,ESTACIÓN ROSARIO,2,10,5,5,1
SINALOA,25,ROSARIO,014,HACIENDA EL TAMARINDO,3,111,55,56,7
SINALOA,25,ROSARIO,014,JALPA NÚMERO DOS,3,30,19,11,3
SINALOA,25,ROSARIO,014,LA CANOA,2,7,3,4,1
SINALOA,25,ROSARIO,014,LA GUÁSIMA,4,293,139,154,15
SINALOA,25,ROSARIO,014,LA RASTRA,4,175,94,81,11
SINALOA,25,ROSARIO,014,LA REFORMA,2,23,12,11,2
SINALOA,25,ROSARIO,014,LAGUNA DE BELTRANES,2,66,45,21,4
SINALOA,25,ROSARIO,014,LAS HABITAS,2,62,32,30,4
SINALOA,25,ROSARIO,014,LAS HIGUERAS,3,103,53,50,6
SINALOA,25,ROSARIO,014,LOMA BLANCA,1,6,5,1,1
SINALOA,25,ROSARIO,014,LOMA DE POTRERILLOS,1,21,7,14,2
SINALOA,25,ROSARIO,014,LOMA DEL ZORRILLO,2,31,14,17,3
SINALOA,25,ROSARIO,014,LOMA VERDE,2,16,7,9,2
SINALOA,25,ROSARIO,014,LOS POZOS,5,444,250,194,58
SINALOA,25,ROSARIO,014,MALOYA,2,27,13,14,2
SINALOA,25,ROSARIO,014,MATATÁN,4,211,92,119,22
SINALOA,25,ROSARIO,014,MONTEALTO,2,41,15,26,2
SINALOA,25,ROSARIO,014,NIEBLAS,3,63,38,25,6
SINALOA,25,ROSARIO,014,OJITOS,3,103,49,54,7
SINALOA,25,ROSARIO,014,OJO DE AGUA DE OSUNA,2,61,27,34,3
SINALOA,25,ROSARIO,014,OTATES,3,62,32,30,4
SINALOA,25,ROSARIO,014,PALOS BLANCOS,2,15,7,8,2
SINALOA,25,ROSARIO,014,PLOMOSAS,2,20,8,12,2
SINALOA,25,ROSARIO,014,POTRERILLOS,3,247,126,121,20
SINALOA,25,ROSARIO,014,POTRERO DE LOS LAURELES,3,36,13,23,3
SINALOA,25,ROSARIO,014,POZOS LABRADOS,2,13,6,7,2
SINALOA,25,ROSARIO,014,RINCÓN DE HIGUERAS,1,8,4,4,1
SINALOA,25,ROSARIO,014,SAN MARCO OTATITÁN,2,13,2,11,2
SINALOA,25,ROSARIO,014,SANTA MARÍA (SANTA MARÍA DE GRACIA),3,63,25,38,3
SINALOA,25,ROSARIO,014,TABLÓN VIEJO,3,88,41,47,5
SINALOA,25,ROSARIO,014,TEODORO BELTRÁN (LA HACIENDA),2,154,78,76,8
SINALOA,25,ROSARIO,014,TEPEHUAJE,2,11,7,4,2
SINALOA,25,SALVADOR ALVARADO,015,ÁLAMO DE LOS MONTOYA,2,57,26,31,4
SINALOA,25,SALVADOR ALVARADO,015,BUENAVISTA,3,60,28,32,4
SINALOA,25,SALVADOR ALVARADO,015,CACALOTITA,3,30,13,17,3
SINALOA,25,SALVADOR ALVARADO,015,CAITIME,4,117,55,62,18
SINALOA,25,SALVADOR ALVARADO,015,CAMPO PÉNJAMO,2,23,15,8,2
SINALOA,25,SALVADOR ALVARADO,015,CARRICITOS,1,4,1,3,1
SINALOA,25,SALVADOR ALVARADO,015,CIÉNEGA DE CASAL,4,86,46,40,9
SINALOA,25,SALVADOR ALVARADO,015,COLONIA 15 DE SEPTIEMBRE,3,65,26,39,6
SINALOA,25,SALVADOR ALVARADO,015,COLONIA 20 DE NOVIEMBRE,2,26,11,15,3
SINALOA,25,SALVADOR ALVARADO,015,COLONIA VEINTISIETE DE NOVIEMBRE,3,36,14,22,4
SINALOA,25,SALVADOR ALVARADO,015,CRUZ BLANCA,3,131,71,60,9
SINALOA,25,SALVADOR ALVARADO,015,EL GUAYACÁN,2,24,11,13,2
SINALOA,25,SALVADOR ALVARADO,015,EL SALITRE,3,120,62,58,13
SINALOA,25,SALVADOR ALVARADO,015,EL TABALLAL,4,146,63,83,10
SINALOA,25,SALVADOR ALVARADO,015,EMILIO ÁLVAREZ IBARRA (LAS GOLONDRINAS),2,18,11,7,2
SINALOA,25,SALVADOR ALVARADO,015,GABRIEL LEYVA VELÁZQUEZ (LA ESCALERA),3,88,49,39,8
SINALOA,25,SALVADOR ALVARADO,015,GUAMÚCHIL,89,19065,9678,9387,1250
SINALOA,25,SALVADOR ALVARADO,015,GUSTAVO DÍAZ ORDAZ,2,43,17,26,2
SINALOA,25,SALVADOR ALVARADO,015,LAS CABEZAS,4,70,29,41,8
SINALOA,25,SALVADOR ALVARADO,015,LOS CHINOS,2,18,8,10,2
SINALOA,25,SALVADOR ALVARADO,015,LUCIO BLANCO,2,29,16,13,2
SINALOA,25,SALVADOR ALVARADO,015,RODOLFO SÁNCHEZ TABOADA (LAS LAGUNITAS),2,26,11,15,3
SINALOA,25,SALVADOR ALVARADO,015,SAN MARTÍN,1,8,5,3,1
SINALOA,25,SALVADOR ALVARADO,015,TERRERO DE LOS GUERRERO,2,5,2,3,1
SINALOA,25,SALVADOR ALVARADO,015,TORO MANCHADO,2,11,3,8,2
SINALOA,25,SALVADOR ALVARADO,015,VENUSTIANO CARRANZA (TRES PALMAS),2,23,12,11,2
SINALOA,25,SALVADOR ALVARADO,015,VILLA BENITO JUÁREZ,7,995,520,475,71
SINALOA,25,SALVADOR ALVARADO,015,YACOCHITO,2,13,5,8,2
SINALOA,25,SAN IGNACIO,016,ACATITÁN,2,24,11,13,2
SINALOA,25,SAN IGNACIO,016,AJOYA,3,141,74,67,7
SINALOA,25,SAN IGNACIO,016,BARRAS DE PIAXTLA,3,68,37,31,5
SINALOA,25,SAN IGNACIO,016,CABAZÁN,2,31,16,15,3
SINALOA,25,SAN IGNACIO,016,CAMINO REAL DE PIAXTLA,3,75,37,38,11
SINALOA,25,SAN IGNACIO,016,CAMPANILLAS,2,4,3,1,1
SINALOA,25,SAN IGNACIO,016,CHACUALTITA (COLOMPO),2,3,2,1,2
SINALOA,25,SAN IGNACIO,016,CONTRAESTACA,1,19,9,10,1
SINALOA,25,SAN IGNACIO,016,COYOTITÁN,4,480,222,258,39
SINALOA,25,SAN IGNACIO,016,CRUCERO DE PIAXTLA (LA CACHAROLA),2,27,8,19,2
SINALOA,25,SAN IGNACIO,016,DIMAS (ESTACIÓN DIMAS),5,990,495,495,63
SINALOA,25,SAN IGNACIO,016,DURANGUITO,4,119,54,65,10
SINALOA,25,SAN IGNACIO,016,EL AGUAJE DE LO DEVOTA,2,4,2,2,1
SINALOA,25,SAN IGNACIO,016,EL CAJÓN DE PIAXTLA,2,26,15,11,2
SINALOA,25,SAN IGNACIO,016,EL CAPULE,3,20,10,10,2
SINALOA,25,SAN IGNACIO,016,EL CARMEN,2,3,2,1,1
SINALOA,25,SAN IGNACIO,016,EL CARRIZAL,2,6,3,3,1
SINALOA,25,SAN IGNACIO,016,EL CHACO,3,5,3,2,2
SINALOA,25,SAN IGNACIO,016,EL LIMÓN DE LOS PERAZA,2,7,2,5,1
SINALOA,25,SAN IGNACIO,016,EL LODAZAL,2,17,7,10,2
SINALOA,25,SAN IGNACIO,016,EL PATOLE,4,133,79,54,7
SINALOA,25,SAN IGNACIO,016,EL PLATANAR,2,32,14,18,2
SINALOA,25,SAN IGNACIO,016,EL POZOLE,1,15,5,10,1
SINALOA,25,SAN IGNACIO,016,EL SAUZ,3,5,4,1,2
SINALOA,25,SAN IGNACIO,016,EL TULE,2,20,10,10,2
SINALOA,25,SAN IGNACIO,016,GÜILLAPA,2,7,3,4,1
SINALOA,25,SAN IGNACIO,016,IXPALINO,2,33,15,18,3
SINALOA,25,SAN IGNACIO,016,JINETES,2,7,1,6,1
SINALOA,25,SAN IGNACIO,016,LA CAÑA,2,22,12,10,3
SINALOA,25,SAN IGNACIO,016,LA CHICAYOTA (CHILACAYOTAS),3,44,23,21,4
SINALOA,25,SAN IGNACIO,016,LA LABOR,4,90,47,43,8
SINALOA,25,SAN IGNACIO,016,LA QUEBRADA DE LOS SANDOVAL,2,4,3,1,1
SINALOA,25,SAN IGNACIO,016,LA TASAJERA,2,9,6,3,1
SINALOA,25,SAN IGNACIO,016,LAS LOMAS DEL PEDREGAL,2,29,18,11,3
SINALOA,25,SAN IGNACIO,016,LAS PILAS,2,9,5,4,1
SINALOA,25,SAN IGNACIO,016,LO DE PONCE,3,50,23,27,4
SINALOA,25,SAN IGNACIO,016,LOS HUMAYES,2,29,11,18,2
SINALOA,25,SAN IGNACIO,016,LOS PLATANITOS,3,16,8,8,2
SINALOA,25,SAN IGNACIO,016,PIAXTLA DE ABAJO,4,481,233,248,35
SINALOA,25,SAN IGNACIO,016,PIAXTLA DE ARRIBA,2,49,20,29,3
SINALOA,25,SAN IGNACIO,016,SAN AGUSTÍN,3,20,8,12,4
SINALOA,25,SAN IGNACIO,016,SAN IGNACIO,11,1407,728,679,98
SINALOA,25,SAN IGNACIO,016,SAN JAVIER,4,73,37,36,9
SINALOA,25,SAN IGNACIO,016,SAN JUAN,4,136,62,74,12
SINALOA,25,SAN IGNACIO,016,TACUITAPA,1,7,2,5,1
SINALOA,25,SAN IGNACIO,016,VADO HONDO,3,44,22,22,4
SINALOA,25,SINALOA,017,AGUA BLANCA,4,118,49,69,6
SINALOA,25,SINALOA,017,AGUA CALIENTE DE CEBADA (LA CHUREA),4,199,104,95,10
SINALOA,25,SINALOA,017,AGUA CALIENTE DE COTA,2,7,3,4,1
SINALOA,25,SINALOA,017,AGUA FRÍA,3,49,16,33,4
SINALOA,25,SINALOA,017,ALFONSO G. CALDERÓN VELARDE,5,498,238,260,42
SINALOA,25,SINALOA,017,ALFREDO V. BONFIL (SIETE EJIDOS),4,316,167,149,27
SINALOA,25,SINALOA,017,ARROYO DE AGUA,3,9,3,6,2
SINALOA,25,SINALOA,017,BABURÍA,2,163,78,85,10
SINALOA,25,SINALOA,017,BACUBIRITO,5,341,166,175,27
SINALOA,25,SINALOA,017,BACURATO,2,28,11,17,2
SINALOA,25,SINALOA,017,BAROMENA,3,32,17,15,3
SINALOA,25,SINALOA,017,BUCHINARI,2,31,15,16,2
SINALOA,25,SINALOA,017,BUENAVISTA,2,89,41,48,5
SINALOA,25,SINALOA,017,BURAGÜE,2,11,8,3,1
SINALOA,25,SINALOA,017,CABRERA DE BONES Y OLIVOS,2,57,28,29,4
SINALOA,25,SINALOA,017,CABRERA DE GÁMEZ,1,6,3,3,1
SINALOA,25,SINALOA,017,CABRERA DE INZUNZA,2,32,19,13,2
SINALOA,25,SINALOA,017,CABRERA DE LIMONES,2,114,48,66,6
SINALOA,25,SINALOA,017,CACALOTÁN,1,9,2,7,1
SINALOA,25,SINALOA,017,CAMPO SEIS,2,47,19,28,3
SINALOA,25,SINALOA,017,CAÑADA VERDE,2,19,6,13,3
SINALOA,25,SINALOA,017,CARRIZALEJO,2,19,13,6,2
SINALOA,25,SINALOA,017,CASAS NUEVAS,4,129,72,57,9
SINALOA,25,SINALOA,017,CHACOAPANA,3,28,18,10,4
SINALOA,25,SINALOA,017,CHICURA,1,1,0,1,1
SINALOA,25,SINALOA,017,COLONIA 6 DE MAYO,2,189,96,93,9
SINALOA,25,SINALOA,017,CONCENTRACIÓN 5 DE FEBRERO,3,296,152,144,15
SINALOA,25,SINALOA,017,CORONADO,3,27,15,12,3
SINALOA,25,SINALOA,017,CUATRO CAMINOS,2,4,3,1,1
SINALOA,25,SINALOA,017,CUBIRI DE LA CAPILLA,1,45,25,20,3
SINALOA,25,SINALOA,017,CUBIRI DE LA CUESTA,3,150,69,81,10
SINALOA,25,SINALOA,017,CUBIRI DE LA LOMA,2,78,40,38,4
SINALOA,25,SINALOA,017,CUBIRI DE LA MÁQUINA,2,93,48,45,6
SINALOA,25,SINALOA,017,CUBIRI DE PORTELAS,3,332,175,157,32
SINALOA,25,SINALOA,017,EJIDO BATAMOTE,1,165,78,87,6
SINALOA,25,SINALOA,017,EJIDO CEFERINO PAREDES,2,56,29,27,3
SINALOA,25,SINALOA,017,EJIDO EL MAQUIPO,2,151,81,70,9
SINALOA,25,SINALOA,017,EJIDO FRANCISCO J. MÚGICA,1,12,6,6,1
SINALOA,25,SINALOA,017,EL AGUAJITO,3,24,11,13,3
SINALOA,25,SINALOA,017,EL ALAMITO,2,65,43,22,3
SINALOA,25,SINALOA,017,EL ÁLAMO,2,12,3,9,1
SINALOA,25,SINALOA,017,EL AMAPAL,3,21,9,12,3
SINALOA,25,SINALOA,017,EL ARRAYANAL,1,3,2,1,1
SINALOA,25,SINALOA,017,EL CAIMÁN (MARGEN DERECHO),3,191,91,100,25
SINALOA,25,SINALOA,017,EL CAIMÁN (MARGEN IZQUIERDO),3,47,19,28,3
SINALOA,25,SINALOA,017,EL CAMPITO [CAMPO ZAMORA],1,46,24,22,3
SINALOA,25,SINALOA,017,EL CHAPOTE,2,14,4,10,2
SINALOA,25,SINALOA,017,EL COCHE,3,37,17,20,4
SINALOA,25,SINALOA,017,EL COCHI,1,6,2,4,1
SINALOA,25,SINALOA,017,EL COYOTE,2,87,41,46,4
SINALOA,25,SINALOA,017,EL DERRUMBADERO,2,7,4,3,1
SINALOA,25,SINALOA,017,EL GARBANZO,2,31,12,19,2
SINALOA,25,SINALOA,017,EL GATAL,2,21,13,8,2
SINALOA,25,SINALOA,017,EL GATAL DE OCORONI,3,152,80,72,10
SINALOA,25,SINALOA,017,EL JUNCO,2,18,8,10,2
SINALOA,25,SINALOA,017,EL LIMÓN,2,14,8,6,2
SINALOA,25,SINALOA,017,EL MACAPULE,2,31,17,14,2
SINALOA,25,SINALOA,017,EL MELÓN,3,11,6,5,2
SINALOA,25,SINALOA,017,EL MEZQUITE,4,182,105,77,9
SINALOA,25,SINALOA,017,EL MEZQUITILLO,2,46,24,22,3
SINALOA,25,SINALOA,017,EL NOROTO,2,17,10,7,2
SINALOA,25,SINALOA,017,EL OPOCHI,2,194,93,101,9
SINALOA,25,SINALOA,017,EL PALMAR DE LOS SEPÚLVEDA,4,144,78,66,16
SINALOA,25,SINALOA,017,EL PALOTAL,2,34,23,11,3
SINALOA,25,SINALOA,017,EL PASO,2,7,2,5,1
SINALOA,25,SINALOA,017,EL PERIHUETE,2,17,9,8,2
SINALOA,25,SINALOA,017,EL PLATANITO,5,50,23,27,5
SINALOA,25,SINALOA,017,EL POTRERO DE SOTO,4,179,88,91,10
SINALOA,25,SINALOA,017,EL POTRERO DE VARGAS,3,20,8,12,3
SINALOA,25,SINALOA,017,EL POZO,2,12,3,9,2
SINALOA,25,SINALOA,017,EL PUEBLITO,1,15,5,10,1
SINALOA,25,SINALOA,017,EL PUEBLITO (EL REALITO),2,93,43,50,6
SINALOA,25,SINALOA,017,EL RANCHITO DE LOS LÓPEZ,4,26,10,16,4
SINALOA,25,SINALOA,017,EL SABINAL,1,6,1,5,1
SINALOA,25,SINALOA,017,EL SAUCITO,1,5,2,3,1
SINALOA,25,SINALOA,017,EL TABLÓN,2,5,4,1,1
SINALOA,25,SINALOA,017,EL TALAYOTE,1,5,4,1,1
SINALOA,25,SINALOA,017,EL TERRERO,2,10,7,3,2
SINALOA,25,SINALOA,017,EL TERRERO COLORADO,3,5,3,2,2
SINALOA,25,SINALOA,017,EL VERANITO,3,52,20,32,4
SINALOA,25,SINALOA,017,EL ZAPOTE,2,39,22,17,2
SINALOA,25,SINALOA,017,ESTACIÓN NARANJO,12,1915,972,943,139
SINALOA,25,SINALOA,017,GABRIEL LEYVA VELÁZQUEZ (MEZQUITE ALTO),5,527,266,261,44
SINALOA,25,SINALOA,017,GALLO NUEVO,3,25,8,17,3
SINALOA,25,SINALOA,017,GENARO ESTRADA,5,841,421,420,50
SINALOA,25,SINALOA,017,GÜERA,1,5,2,3,1
SINALOA,25,SINALOA,017,HACIENDA DE LOS CEBALLOS,3,21,11,10,3
SINALOA,25,SINALOA,017,JOSÉ MARÍA MORELOS Y PAVÓN,2,16,9,7,2
SINALOA,25,SINALOA,017,LA ACEITUNA,3,42,17,25,4
SINALOA,25,SINALOA,017,LA BOCATOMA,1,5,0,5,1
SINALOA,25,SINALOA,017,LA CAÑADA,3,33,15,18,3
SINALOA,25,SINALOA,017,LA CEBOLLA,1,10,5,5,1
SINALOA,25,SINALOA,017,LA CUEVITA,2,56,27,29,4
SINALOA,25,SINALOA,017,LA ESTANCIA,2,4,1,3,1
SINALOA,25,SINALOA,017,LA GUAMUCHILERA,2,39,14,25,3
SINALOA,25,SINALOA,017,LA HIGUERITA DE LOS MIRANDA (LA HIGUERITA),2,44,28,16,3
SINALOA,25,SINALOA,017,LA HUERTA,3,46,25,21,5
SINALOA,25,SINALOA,017,LA JOYA,1,2,1,1,1
SINALOA,25,SINALOA,017,LA LOMA DE LUGO,2,54,20,34,3
SINALOA,25,SINALOA,017,LA MESA,3,26,11,15,3
SINALOA,25,SINALOA,017,LA MESA DEL GALLO,2,22,14,8,2
SINALOA,25,SINALOA,017,LA NUEVA ESTANCIA,2,9,5,4,2
SINALOA,25,SINALOA,017,LA PALMA,1,16,6,10,1
SINALOA,25,SINALOA,017,LA PEÑA,2,3,3,0,1
SINALOA,25,SINALOA,017,LA PLAYA,2,23,11,12,2
SINALOA,25,SINALOA,017,LA PLAYITA DE CASILLAS,4,227,114,113,13
SINALOA,25,SINALOA,017,LA POZA,2,12,7,5,2
SINALOA,25,SINALOA,017,LA PRESITA,2,139,73,66,8
SINALOA,25,SINALOA,017,LA TASAJERA,2,4,2,2,1
SINALOA,25,SINALOA,017,LA TUNA,3,46,23,23,4
SINALOA,25,SINALOA,017,LAGUNA DE LOS VALDEZ,1,4,2,2,1
SINALOA,25,SINALOA,017,LAS BAYAS,3,25,12,13,3
SINALOA,25,SINALOA,017,LAS CUEVAS,2,15,5,10,2
SINALOA,25,SINALOA,017,LAS HUAPACAS,3,55,23,32,4
SINALOA,25,SINALOA,017,LAS LAJAS,2,21,7,14,2
SINALOA,25,SINALOA,017,LAS LAJITAS,2,9,3,6,2
SINALOA,25,SINALOA,017,LAS PLAYAS,2,72,37,35,3
SINALOA,25,SINALOA,017,LAS TATEMAS,1,20,9,11,1
SINALOA,25,SINALOA,017,LAS TUNAS DE ABAJO,3,72,37,35,5
SINALOA,25,SINALOA,017,LAS TUNAS DE ARRIBA,3,15,5,10,3
SINALOA,25,SINALOA,017,LICENCIADO BENITO JUÁREZ (PAREDÓN BLANCO),2,48,25,23,3
SINALOA,25,SINALOA,017,LLANO GRANDE,4,496,244,252,32
SINALOA,25,SINALOA,017,LLANOS DE PERAZA,3,66,34,32,6
SINALOA,25,SINALOA,017,LODECÍAS,2,7,3,4,2
SINALOA,25,SINALOA,017,LOMALINDA,1,14,5,9,1
SINALOA,25,SINALOA,017,LOMBARDO TOLEDANO,1,8,5,3,1
SINALOA,25,SINALOA,017,LORENZO F. ROBLES,1,12,7,5,1
SINALOA,25,SINALOA,017,LOS ALISOS DE OLGUÍN,3,58,34,24,5
SINALOA,25,SINALOA,017,LOS CERQUITOS (LA PILA DOS),2,36,13,23,3
SINALOA,25,SINALOA,017,LOS CERRILLOS NÚMERO DOS,2,13,6,7,2
SINALOA,25,SINALOA,017,LOS ÉBANOS,2,10,5,5,2
SINALOA,25,SINALOA,017,LOS HORCONES,1,4,2,2,1
SINALOA,25,SINALOA,017,LOS LAURELES,3,18,4,14,3
SINALOA,25,SINALOA,017,LOS LIMONES,3,18,9,9,3
SINALOA,25,SINALOA,017,LOS MELONES,4,249,120,129,29
SINALOA,25,SINALOA,017,LOS MEZQUITES,3,91,43,48,5
SINALOA,25,SINALOA,017,LOS QUINTERO,2,25,10,15,2
SINALOA,25,SINALOA,017,LOS TASTES,2,46,20,26,3
SINALOA,25,SINALOA,017,LOS TRONCONES (EL AGUAJITO),3,42,19,23,4
SINALOA,25,SINALOA,017,MARIPA,3,309,140,169,26
SINALOA,25,SINALOA,017,MARIPITA,2,45,21,24,3
SINALOA,25,SINALOA,017,MASCAHUILOCHI,2,13,6,7,2
SINALOA,25,SINALOA,017,MATAPÁN DEL LLANO,2,28,17,11,2
SINALOA,25,SINALOA,017,MAZOCARI,3,107,49,58,7
SINALOA,25,SINALOA,017,MELCHOR OCAMPO,2,25,15,10,2
SINALOA,25,SINALOA,017,MESA MORENO,2,6,3,3,1
SINALOA,25,SINALOA,017,NACAVEBA,3,188,94,94,10
SINALOA,25,SINALOA,017,NARANJO SEGUNDO,2,56,28,28,3
SINALOA,25,SINALOA,017,NUEVO TEPOSINA,1,6,3,3,1
SINALOA,25,SINALOA,017,OCURAGÜE,3,59,33,26,5
SINALOA,25,SINALOA,017,PIEDRA BOLA II,1,3,1,2,1
SINALOA,25,SINALOA,017,PLAYA SEGUNDA,2,69,33,36,4
SINALOA,25,SINALOA,017,POROHUI,4,202,99,103,10
SINALOA,25,SINALOA,017,PORTUGUÉS DE NORZAGARAY,3,37,15,22,3
SINALOA,25,SINALOA,017,POTRERO DE BERNAL,1,3,2,1,1
SINALOA,25,SINALOA,017,POTRERO DE LOS FÉLIX,3,27,13,14,3
SINALOA,25,SINALOA,017,PUEBLO VIEJO,2,16,7,9,2
SINALOA,25,SINALOA,017,QUITABOCA,3,29,14,15,3
SINALOA,25,SINALOA,017,RANCHITO DE FIGUEROA,1,13,6,7,4
SINALOA,25,SINALOA,017,RANCHITO DE LLANES,3,38,16,22,3
SINALOA,25,SINALOA,017,RANCHITO LOS CAMACHO,1,7,4,3,1
SINALOA,25,SINALOA,017,RUIZ CORTINES NÚMERO TRES,4,563,276,287,39
SINALOA,25,SINALOA,017,RUIZ CORTINES NÚMERO UNO,2,155,76,79,8
SINALOA,25,SINALOA,017,SAN IGNACIO,2,3,3,0,1
SINALOA,25,SINALOA,017,SAN JOAQUÍN (SAN JOAQUÍN NUEVO),4,213,98,115,19
SINALOA,25,SINALOA,017,SAN JOSÉ DE ALVARADO (SAN JOSÉ NUEVO),2,23,12,11,2
SINALOA,25,SINALOA,017,SAN JOSÉ DE GRACIA,4,312,168,144,15
SINALOA,25,SINALOA,017,SAN JOSÉ DE LAS DELICIAS,5,111,65,46,13
SINALOA,25,SINALOA,017,SAN JOSÉ DE LOS HORNOS,3,49,20,29,3
SINALOA,25,SINALOA,017,SAN JOSÉ DEL ÁLAMO,2,11,3,8,2
SINALOA,25,SINALOA,017,SAN JOSÉ VIEJO,1,13,4,9,1
SINALOA,25,SINALOA,017,SAN MIGUEL DE LOS ORRANTIA,3,51,27,24,5
SINALOA,25,SINALOA,017,SAN MIGUEL DE SAN JOAQUÍN (SAN MIGUEL),2,12,6,6,2
SINALOA,25,SINALOA,017,SAN PABLO MOCHOBAMPO (SAN IGNACIO),3,79,33,46,6
SINALOA,25,SINALOA,017,SAN RAFAEL,2,4,1,3,2
SINALOA,25,SINALOA,017,SAN SEBASTIÁN LÁZARO CÁRDENAS,2,189,85,104,15
SINALOA,25,SINALOA,017,SANTA ANA,3,60,29,31,6
SINALOA,25,SINALOA,017,SANTA MAGDALENA,3,38,17,21,3
SINALOA,25,SINALOA,017,SANTA TERESITA,3,82,43,39,7
SINALOA,25,SINALOA,017,SANTIAGO DE OCORONI,4,732,350,382,58
SINALOA,25,SINALOA,017,SARABIA,3,155,74,81,8
SINALOA,25,SINALOA,017,SEIS DE ENERO,2,15,7,8,2
SINALOA,25,SINALOA,017,SIERRITA DE LOS GERMÁN,3,10,4,6,3
SINALOA,25,SINALOA,017,SINALOA DE LEYVA,11,2870,1433,1437,163
SINALOA,25,SINALOA,017,TECUMENA,2,9,6,3,2
SINALOA,25,SINALOA,017,TEPANTITA DE OCORONI,2,123,65,58,7
SINALOA,25,SINALOA,017,TIERRA BLANCA,1,12,4,8,1
SINALOA,25,SINALOA,017,TOBOBAMPO,4,412,198,214,30
SINALOA,25,SINALOA,017,TODOESTO,2,7,5,2,1
SINALOA,25,SINALOA,017,TRES MARÍAS (LAS VINORAMAS),2,25,13,12,2
SINALOA,25,SINALOA,017,TRES REYES,2,35,19,16,2
SINALOA,25,NAVOLATO,018,AGRÍCOLA AGA JBS,2,26,11,15,4
SINALOA,25,NAVOLATO,018,AGUAPEPITO,3,44,20,24,3
SINALOA,25,NAVOLATO,018,ALTATA,5,702,328,374,70
SINALOA,25,NAVOLATO,018,ALTO DEL VERGEL,1,22,12,10,2
SINALOA,25,NAVOLATO,018,BACHIGUALATILLO,2,33,16,17,2
SINALOA,25,NAVOLATO,018,BACHIMETO,2,161,74,87,8
SINALOA,25,NAVOLATO,018,BACHOCO,3,276,143,133,27
SINALOA,25,NAVOLATO,018,BAINORITOS,1,2,1,1,1
SINALOA,25,NAVOLATO,018,BARICUETO DOS,2,97,43,54,4
SINALOA,25,NAVOLATO,018,BARIOMETO,2,136,69,67,8
SINALOA,25,NAVOLATO,018,BARIOMETO SEGUNDO,2,36,15,21,2
SINALOA,25,NAVOLATO,018,BATAUTO (LAGUNA DE BATAUTO),2,42,25,17,3
SINALOA,25,NAVOLATO,018,CAMPO AGRÍCOLA NUEVO MILENIO,1,12,4,8,2
SINALOA,25,NAVOLATO,018,CAMPO BALBUENA,4,266,128,138,15
SINALOA,25,NAVOLATO,018,CAMPO BERLÍN (BERLÍN),2,54,29,25,3
SINALOA,25,NAVOLATO,018,CAMPO CAMPAÑA,1,11,5,6,3
SINALOA,25,NAVOLATO,018,CAMPO CINCO HERMANOS (EMILIANO ZAPATA),3,116,57,59,5
SINALOA,25,NAVOLATO,018,CAMPO CLOUTHIER,1,17,9,8,2
SINALOA,25,NAVOLATO,018,CAMPO EL DIECISIETE,1,19,5,14,3
SINALOA,25,NAVOLATO,018,CAMPO ESMERALDA,5,255,128,127,15
SINALOA,25,NAVOLATO,018,CAMPO LA 15,3,59,33,26,7
SINALOA,25,NAVOLATO,018,CAMPO LA FERIA,2,14,5,9,5
SINALOA,25,NAVOLATO,018,CAMPO LO DE BELTRÁN,2,79,43,36,4
SINALOA,25,NAVOLATO,018,CAMPO NOGALITOS,4,163,85,78,7
SINALOA,25,NAVOLATO,018,CAMPO NUEVO (EL PUGIDO),2,12,8,4,2
SINALOA,25,NAVOLATO,018,CAMPO PÍA,2,18,13,5,5
SINALOA,25,NAVOLATO,018,CAMPO SAN ARMANDO,1,25,14,11,3
SINALOA,25,NAVOLATO,018,CAMPO SAN ISIDRO,1,4,2,2,1
SINALOA,25,NAVOLATO,018,CAMPO SAN NIKOS,2,24,12,12,4
SINALOA,25,NAVOLATO,018,CAMPO SAN SEVERO,1,16,10,6,4
SINALOA,25,NAVOLATO,018,CAMPO SANTA CECILIA,2,6,4,2,1
SINALOA,25,NAVOLATO,018,CAMPO SOFÍA,2,9,2,7,2
SINALOA,25,NAVOLATO,018,CAMPO VICTORIA,8,668,356,312,29
SINALOA,25,NAVOLATO,018,CAMPO VITAL (COFRADÍA DE LA ESTANCIA NÚMERO DOS),2,20,8,12,2
SINALOA,25,NAVOLATO,018,CAÑADA GUAMUCHILITO,2,26,16,10,2
SINALOA,25,NAVOLATO,018,CASA BLANCA (ÁNGELES DOS),3,110,54,56,7
SINALOA,25,NAVOLATO,018,CINCO DE MAYO,3,54,20,34,5
SINALOA,25,NAVOLATO,018,COFRADÍA DE LA LOMA,2,163,86,77,8
SINALOA,25,NAVOLATO,018,COFRADÍA DE NAVOLATO (COFRADÍA DE LOS ROCHA),2,133,65,68,8
SINALOA,25,NAVOLATO,018,COFRADÍA DE SAN PEDRO (COFRADÍA DE LA ESTANCIA),3,374,181,193,18
SINALOA,25,NAVOLATO,018,COLONIA ENSENADA (TECOMATE),3,103,43,60,12
SINALOA,25,NAVOLATO,018,COLONIA MICHOACANA,3,291,143,148,12
SINALOA,25,NAVOLATO,018,COLONIA MICHOACANA (LUIS VÉLEZ),4,156,80,76,9
SINALOA,25,NAVOLATO,018,COLONIA MORELOS (POZOLE),1,22,15,7,1
SINALOA,25,NAVOLATO,018,COLONIA PRIMAVERA,3,79,44,35,5
SINALOA,25,NAVOLATO,018,CONSTITUYENTES DE SINALOA,2,35,20,15,2
SINALOA,25,NAVOLATO,018,DAUTILLOS,4,334,164,170,26
SINALOA,25,NAVOLATO,018,EJIDO CONVENCIÓN DE AGUASCALIENTES,3,176,98,78,10
SINALOA,25,NAVOLATO,018,EJIDO EL CAIMANCITO,2,43,27,16,3
SINALOA,25,NAVOLATO,018,EJIDO LA PALOMA,2,121,63,58,8
SINALOA,25,NAVOLATO,018,EL BATALLÓN,2,94,50,44,4
SINALOA,25,NAVOLATO,018,EL BLEDAL,2,107,57,50,5
SINALOA,25,NAVOLATO,018,EL BOLSÓN,2,155,82,73,8
SINALOA,25,NAVOLATO,018,EL CAFETAL,1,20,9,11,4
SINALOA,25,NAVOLATO,018,EL CASTILLO,5,533,267,266,36
SINALOA,25,NAVOLATO,018,EL LACO,3,31,10,21,4
SINALOA,25,NAVOLATO,018,EL LIMONCITO,3,373,175,198,28
SINALOA,25,NAVOLATO,018,EL MOLINO,3,207,97,110,11
SINALOA,25,NAVOLATO,018,EL PIZAL,1,9,5,4,1
SINALOA,25,NAVOLATO,018,EL PORTUGUÉS (EL CAMPITO),1,16,5,11,1
SINALOA,25,NAVOLATO,018,EL POTRERO DE SATAYA,4,314,169,145,25
SINALOA,25,NAVOLATO,018,EL REALITO,2,19,10,9,2
SINALOA,25,NAVOLATO,018,EL TANQUE,2,13,5,8,1
SINALOA,25,NAVOLATO,018,EL TETUÁN NUEVO,2,24,15,9,2
SINALOA,25,NAVOLATO,018,EL VERGEL,6,605,313,292,43
SINALOA,25,NAVOLATO,018,GENERAL ÁNGEL FLORES (LA PALMA),15,3008,1480,1528,158
SINALOA,25,NAVOLATO,018,IRAGUATO,2,26,9,17,2
SINALOA,25,NAVOLATO,018,JUAN ALDAMA (EL TIGRE),4,589,277,312,51
SINALOA,25,NAVOLATO,018,LA BANDERA,4,220,116,104,13
SINALOA,25,NAVOLATO,018,LA BEBELAMA DE SAN PEDRO,3,177,88,89,11
SINALOA,25,NAVOLATO,018,LA CAMPIÑA DE SAN PEDRO (LA CAMPIÑA),1,10,4,6,1
SINALOA,25,NAVOLATO,018,LA CAPILLA,1,38,19,19,3
SINALOA,25,NAVOLATO,018,LA CURVA (LA CURVA DE SAN PEDRO),2,175,93,82,8
SINALOA,25,NAVOLATO,018,LA HIGUERITA,2,27,15,12,2
SINALOA,25,NAVOLATO,018,LA LOMA,1,14,7,7,1
SINALOA,25,NAVOLATO,018,LA PIPIMA,2,40,21,19,3
SINALOA,25,NAVOLATO,018,LA SINALOA,2,104,52,52,7
SINALOA,25,NAVOLATO,018,LA VEINTIUNO,1,26,13,13,4
SINALOA,25,NAVOLATO,018,LA VUELTA,3,76,39,37,6
SINALOA,25,NAVOLATO,018,LAGUNA DE SAN PEDRO,2,53,26,27,4
SINALOA,25,NAVOLATO,018,LAS AGUAMITAS,4,291,131,160,16
SINALOA,25,NAVOLATO,018,LAS BEBELAMAS DE SATAYA,1,2,1,1,1
SINALOA,25,NAVOLATO,018,LAS PUENTES (GUADALUPE VICTORIA),4,261,143,118,14
SINALOA,25,NAVOLATO,018,LAS TRANCAS,2,58,32,26,3
SINALOA,25,NAVOLATO,018,LICENCIADO ALFREDO VALDEZ MONTOYA,2,52,22,30,3
SINALOA,25,NAVOLATO,018,LICENCIADO BENITO JUÁREZ (CAMPO GOBIERNO),31,8410,4337,4073,419
SINALOA,25,NAVOLATO,018,LO DE JESÚS [CAMPO ROMERO],3,268,121,147,15
SINALOA,25,NAVOLATO,018,LO DE REYES,3,118,59,59,7
SINALOA,25,NAVOLATO,018,LO DE SAUCEDA,2,205,98,107,7
SINALOA,25,NAVOLATO,018,LO DE VERDUGO,2,99,49,50,7
SINALOA,25,NAVOLATO,018,LOS ALAMITOS,1,8,5,3,1
SINALOA,25,NAVOLATO,018,LOS ARREDONDO (LOS ARREDONDO DE SAN PEDRO),2,49,26,23,3
SINALOA,25,NAVOLATO,018,LOS POCHOTES,2,16,9,7,2
SINALOA,25,NAVOLATO,018,MACARIO GAXIOLA (EL POBLADO),2,21,10,11,2
SINALOA,25,NAVOLATO,018,MONTELARGO,3,15,9,6,2
SINALOA,25,NAVOLATO,018,NAVOLATO,59,10468,5113,5355,655
SINALOA,25,NAVOLATO,018,NINGUNO,1,18,9,9,1
SINALOA,25,NAVOLATO,018,OTAMETO,2,112,38,74,5
SINALOA,25,NAVOLATO,018,PALOS COLORADOS,1,5,1,4,1
SINALOA,25,NAVOLATO,018,PÉNJAMO,1,7,3,4,1
SINALOA,25,NAVOLATO,018,PLAN DE AYALA (EL ZANJÓN),2,23,15,8,2
SINALOA,25,NAVOLATO,018,RÍO VIEJO,2,28,16,12,2
SINALOA,25,NAVOLATO,018,ROSA MORADA,2,50,23,27,3
SINALOA,25,NAVOLATO,018,SACRIFICIO (EL SERRUCHO),2,29,11,18,7
SINALOA,25,NAVOLATO,018,SAN BLAS,4,146,72,74,7
SINALOA,25,NAVOLATO,018,SAN EMILIÓN,2,33,23,10,2
SINALOA,25,NAVOLATO,018,SAN MANUEL,3,36,12,24,3
SINALOA,25,NAVOLATO,018,SAN PEDRO,6,900,440,460,62
SINALOA,25,NAVOLATO,018,SANTA CECILIA,2,14,5,9,2
SINALOA,25,NAVOLATO,018,SANTA ELENA,2,20,13,7,5
SINALOA,25,NAVOLATO,018,SANTA FE,2,4,1,3,2
SINALOA,25,NAVOLATO,018,SANTA MARTHA,6,447,218,229,23
SINALOA,25,NAVOLATO,018,SATAYA,5,554,277,277,98
SINALOA,25,NAVOLATO,018,TOBOLOTO,4,191,94,97,7
SINALOA,25,NAVOLATO,018,VILLA MORELOS (CHAMA),2,48,25,23,3
SINALOA,25,NAVOLATO,018,VILLAMOROS,2,86,45,41,4
SINALOA,25,NAVOLATO,018,YAMETO,3,30,10,20,3
SINALOA,25,NAVOLATO,018,YEBAVITO,3,245,126,119,15
SINALOA,25,ELDORADO,019,CAMPO CHAPO II,2,4,1,3,4
SINALOA,25,ELDORADO,019,CAMPO REBECA,1,8,4,4,1
SINALOA,25,ELDORADO,019,CAMPO SAUCITO DE RITZ,2,17,9,8,9
SINALOA,25,ELDORADO,019,EJIDO LA ARROCERA,2,152,86,66,8
SINALOA,25,ELDORADO,019,EJIDO LA FLOR,2,146,76,70,6
SINALOA,25,ELDORADO,019,EJIDO REBECA DOS (METESACA),2,36,11,25,2
SINALOA,25,ELDORADO,019,EJIDO SAN JOAQUÍN,2,43,18,25,3
SINALOA,25,ELDORADO,019,EL CONCHAL,3,124,62,62,7
SINALOA,25,ELDORADO,019,EL CUERVO,3,70,26,44,5
SINALOA,25,ELDORADO,019,EL HIGUERAL,3,296,145,151,25
SINALOA,25,ELDORADO,019,EL MANGUITO,2,37,19,18,3
SINALOA,25,ELDORADO,019,EL ROSARITO,2,12,7,5,2
SINALOA,25,ELDORADO,019,EL SAUCITO NUEVO,2,45,14,31,3
SINALOA,25,ELDORADO,019,ELDORADO,22,5162,2548,2614,324
SINALOA,25,ELDORADO,019,GUADALUPE VICTORIA (EL ATORÓN),5,606,291,315,56
SINALOA,25,ELDORADO,019,LA CRUZ DE ELDORADO (CRUZ DE NAVITO),2,43,20,23,3
SINALOA,25,ELDORADO,019,LA MOJONERA,2,23,10,13,2
SINALOA,25,ELDORADO,019,LAS ARENITAS,4,588,307,281,32
SINALOA,25,ELDORADO,019,LAS PALMAS,2,9,4,5,1
SINALOA,25,ELDORADO,019,LAS PIEDRITAS,2,132,60,72,8
SINALOA,25,ELDORADO,019,LAS TRES GOTAS DE AGUA,3,162,84,78,9
SINALOA,25,ELDORADO,019,LEOPOLDO SÁNCHEZ CELIS,6,1280,623,657,69
SINALOA,25,ELDORADO,019,NAVITO,2,22,13,9,2
SINALOA,25,ELDORADO,019,NAVOLATILLO,2,16,6,10,2
SINALOA,25,ELDORADO,019,NUEVO HIGUERAL,2,57,27,30,4
SINALOA,25,ELDORADO,019,PORTACELI,4,385,197,188,38
SINALOA,25,ELDORADO,019,SAN DIEGO,3,181,95,86,21
SINALOA,25,ELDORADO,019,SAN MANUEL,2,50,22,28,3
SINALOA,25,ELDORADO,019,SOYATITA (CRUZ SEGUNDA),3,121,51,70,8
SINALOA,25,JUAN JOSÉ RÍOS,020,AGUA DE LAS ARENAS,2,116,55,61,6
SINALOA,25,JUAN JOSÉ RÍOS,020,BABUJAQUI,2,27,17,10,2
SINALOA,25,JUAN JOSÉ RÍOS,020,BACHOCO,5,648,317,331,64
SINALOA,25,JUAN JOSÉ RÍOS,020,CAMPO EL PORVENIR,1,1,0,1,1
SINALOA,25,JUAN JOSÉ RÍOS,020,CAMPO TREINTA Y OCHO,2,50,28,22,3
SINALOA,25,JUAN JOSÉ RÍOS,020,CARRIZO GRANDE,2,22,11,11,2
SINALOA,25,JUAN JOSÉ RÍOS,020,CERRO BATEQUIS,3,14,5,9,2
SINALOA,25,JUAN JOSÉ RÍOS,020,EJIDO BACHOCO NÚMERO DOS (MACOCHÍN),2,14,6,8,2
SINALOA,25,JUAN JOSÉ RÍOS,020,EJIDO CERRO CABEZÓN (EL CHORRITO),2,12,5,7,1
SINALOA,25,JUAN JOSÉ RÍOS,020,EJIDO TREINTA Y OCHITO,4,191,99,92,11
SINALOA,25,JUAN JOSÉ RÍOS,020,EL AMAPAL,2,51,23,28,3
SINALOA,25,JUAN JOSÉ RÍOS,020,EL CERRO CABEZÓN,6,630,322,308,51
SINALOA,25,JUAN JOSÉ RÍOS,020,HÉROES MEXICANOS,2,85,44,41,4
SINALOA,25,JUAN JOSÉ RÍOS,020,JUAN JOSÉ RÍOS,29,7671,3174,4497,537
SINALOA,25,JUAN JOSÉ RÍOS,020,LÁZARO CÁRDENAS (MUELLECITO),4,187,89,98,11
SINALOA,25,JUAN JOSÉ RÍOS,020,PUEBLO NUEVO LUIS ECHEVERRÍA,2,104,51,53,5
SINALOA,25,JUAN JOSÉ RÍOS,020,SANTA CECILIA,2,11,3,8,1
SINALOA,25,JUAN JOSÉ RÍOS,020,TRES GARANTÍAS,4,438,229,209,33
SONORA,26,ACONCHI,001,ACONCHI,3,306,145,161,16
SONORA,26,ACONCHI,001,LA ESTANCIA,2,124,64,60,7
SONORA,26,ACONCHI,001,SAN PABLO (SAN PABLO DE ACONCHI),1,40,18,22,3
SONORA,26,AGUA PRIETA,002,AGUA PRIETA,104,21131,10572,10559,1297
SONORA,26,AGUA PRIETA,002,COLONIA MORELOS,3,50,25,25,5
SONORA,26,AGUA PRIETA,002,EL RUSBAYO,3,36,11,25,3
SONORA,26,AGUA PRIETA,002,FUNDACIÓN BRAZOS DE AMOR,1,10,5,5,1
SONORA,26,ÁLAMOS,003,21 DE MARZO,2,26,16,10,3
SONORA,26,ÁLAMOS,003,AGUA CALIENTE DE ANTERO (AGUA CALIENTE),2,12,4,8,2
SONORA,26,ÁLAMOS,003,ÁLAMOS,17,2800,1434,1366,146
SONORA,26,ÁLAMOS,003,ANÁHUAC,1,4,4,0,1
SONORA,26,ÁLAMOS,003,AQUINAVO,3,20,8,12,3
SONORA,26,ÁLAMOS,003,ARGENTINA,1,5,3,2,1
SONORA,26,ÁLAMOS,003,BABOYAGUI,3,15,6,9,2
SONORA,26,ÁLAMOS,003,BASIROA,4,138,70,68,9
SONORA,26,ÁLAMOS,003,BAVÍCORA,3,20,8,12,2
SONORA,26,ÁLAMOS,003,BURAPACO,1,17,6,11,1
SONORA,26,ÁLAMOS,003,CAMPAMENTO LAS CASITAS (EL MOCÚZARIT),1,1,0,1,1
SONORA,26,ÁLAMOS,003,CASANATE,2,23,8,15,2
SONORA,26,ÁLAMOS,003,CERRO COLORADO (EL COLORADO),2,18,6,12,2
SONORA,26,ÁLAMOS,003,CHORIJOA,3,32,18,14,3
SONORA,26,ÁLAMOS,003,COCHIBAMPO,3,53,31,22,3
SONORA,26,ÁLAMOS,003,COROGÜI,2,8,4,4,2
SONORA,26,ÁLAMOS,003,EL CAJÓN DEL SABINO (EL CAJÓN),4,53,25,28,6
SONORA,26,ÁLAMOS,003,EL CARRIZAL,1,9,2,7,1
SONORA,26,ÁLAMOS,003,EL CHINAL,2,16,6,10,2
SONORA,26,ÁLAMOS,003,EL CHINO (SAN ANTONIO DE LOS CHINOS),4,76,36,40,7
SONORA,26,ÁLAMOS,003,EL CHIRIVO,2,7,1,6,1
SONORA,26,ÁLAMOS,003,EL FRIJOL,2,13,6,7,2
SONORA,26,ÁLAMOS,003,EL GUAMUCHIL,3,53,18,35,4
SONORA,26,ÁLAMOS,003,EL MAQUIPO,4,70,37,33,6
SONORA,26,ÁLAMOS,003,EL MEZQUITAL,1,12,7,5,1
SONORA,26,ÁLAMOS,003,EL MOCÚZARI (CONICÁRIT),5,172,91,81,13
SONORA,26,ÁLAMOS,003,EL PASO,4,33,21,12,4
SONORA,26,ÁLAMOS,003,EL RODEO,2,3,1,2,2
SONORA,26,ÁLAMOS,003,EL SALADO,1,9,6,3,1
SONORA,26,ÁLAMOS,003,EL SAUZ,3,4,1,3,2
SONORA,26,ÁLAMOS,003,EL TABELO (SAN JOSÉ DEL TABELO),3,28,11,17,3
SONORA,26,ÁLAMOS,003,EL TEZAL,3,25,10,15,3
SONORA,26,ÁLAMOS,003,EL VERANITO,3,12,6,6,2
SONORA,26,ÁLAMOS,003,EL ZAPOTE,3,35,15,20,3
SONORA,26,ÁLAMOS,003,FRANCISCO R. SERRANO,3,12,4,8,3
SONORA,26,ÁLAMOS,003,GEROCOA (LAS CANILLAS),1,6,4,2,1
SONORA,26,ÁLAMOS,003,GEROCOA CHICO (LOS PLÁTANOS),3,31,15,16,2
SONORA,26,ÁLAMOS,003,GUAJARAY,3,90,38,52,4
SONORA,26,ÁLAMOS,003,HUICOCHIC,1,7,3,4,1
SONORA,26,ÁLAMOS,003,HUIROCOBA,3,19,9,10,2
SONORA,26,ÁLAMOS,003,JOBEGÜI,2,16,10,6,2
SONORA,26,ÁLAMOS,003,LA ADUANA,3,47,26,21,4
SONORA,26,ÁLAMOS,003,LA CIENEGUITA,2,18,5,13,2
SONORA,26,ÁLAMOS,003,LA ESPERANZA,1,1,0,1,1
SONORA,26,ÁLAMOS,003,LA HIGUERA,3,48,21,27,4
SONORA,26,ÁLAMOS,003,LA LABOR DE SANTA LUCÍA (EL MEZQUITAL),3,37,18,19,3
SONORA,26,ÁLAMOS,003,LA MINA DE LA CRUZ,1,2,0,2,0
SONORA,26,ÁLAMOS,003,LA QUINTERA,3,32,18,14,3
SONORA,26,ÁLAMOS,003,LA UVALAMA,2,12,7,5,2
SONORA,26,ÁLAMOS,003,LA VINATA,1,5,4,1,1
SONORA,26,ÁLAMOS,003,LAS MINITAS,3,19,10,9,3
SONORA,26,ÁLAMOS,003,LOS ALGODONES,1,3,2,1,1
SONORA,26,ÁLAMOS,003,LOS CAMOTES (SAN JOSÉ DEL PALMAR),4,37,18,19,4
SONORA,26,ÁLAMOS,003,LOS CITAHUIS,1,10,6,4,1
SONORA,26,ÁLAMOS,003,LOS ESTRADOS,3,67,28,39,6
SONORA,26,ÁLAMOS,003,LOS MUERTOS,1,7,2,5,1
SONORA,26,ÁLAMOS,003,LOS TANQUES,5,219,106,113,13
SONORA,26,ÁLAMOS,003,MACOYAHUI,1,4,1,3,1
SONORA,26,ÁLAMOS,003,MARANATHA (ARGENTINA),1,3,2,1,1
SONORA,26,ÁLAMOS,003,MASCURAGÜI,2,24,14,10,2
SONORA,26,ÁLAMOS,003,MESA COLORADA,5,223,124,99,14
SONORA,26,ÁLAMOS,003,MEXIQUILLO,3,45,25,20,4
SONORA,26,ÁLAMOS,003,MINAS NUEVAS,3,66,30,36,4
SONORA,26,ÁLAMOS,003,MOCHIBAMPO,2,38,24,14,2
SONORA,26,ÁLAMOS,003,MUNIHUASA,2,19,11,8,2
SONORA,26,ÁLAMOS,003,NAHUIBAMPO,2,16,7,9,2
SONORA,26,ÁLAMOS,003,NUEVO PIEDRAS VERDES,3,60,30,30,4
SONORA,26,ÁLAMOS,003,OSOBAMPO,3,81,39,42,4
SONORA,26,ÁLAMOS,003,POTRERO DE ALCÁNTAR,3,15,8,7,2
SONORA,26,ÁLAMOS,003,POTRERO DE REUTER,1,4,1,3,1
SONORA,26,ÁLAMOS,003,PROVIDENCIA,2,71,36,35,4
SONORA,26,ÁLAMOS,003,RANCHERÍAS,2,33,17,16,2
SONORA,26,ÁLAMOS,003,SABINITO SUR,3,22,11,11,3
SONORA,26,ÁLAMOS,003,SAHUARIVO,1,10,4,6,1
SONORA,26,ÁLAMOS,003,SAN BERNARDO,8,286,147,139,22
SONORA,26,ÁLAMOS,003,SAN RAFAEL DEL SABINO (EL SABINITO),1,1,0,1,1
SONORA,26,ÁLAMOS,003,SAN VICENTE,2,10,5,5,2
SONORA,26,ÁLAMOS,003,TAPIZUELAS,3,45,21,24,4
SONORA,26,ÁLAMOS,003,TECHOBAMPO,4,37,20,17,4
SONORA,26,ÁLAMOS,003,TOJIBAMPO,2,8,4,4,2
SONORA,26,ÁLAMOS,003,VADO CUATE,2,14,7,7,2
SONORA,26,ÁLAMOS,003,YOCOJIGUA,4,57,22,35,4
SONORA,26,ALTAR,004,16 DE SEPTIEMBRE,3,64,37,27,5
SONORA,26,ALTAR,004,ALTAR,12,2095,1045,1050,139
SONORA,26,ALTAR,004,LA OTRA BANDA (COLONIA ORTIZ),2,103,44,59,5
SONORA,26,ALTAR,004,LLANO BLANCO (RANCHO SECO),3,100,54,46,5
SONORA,26,ARIVECHI,005,ARIVECHI,3,106,50,56,12
SONORA,26,ARIVECHI,005,TARACHI,3,73,39,34,5
SONORA,26,ARIZPE,006,ARIZPE,4,296,152,144,18
SONORA,26,ARIZPE,006,BACANUCHI,2,31,16,15,2
SONORA,26,ARIZPE,006,CHINAPA,3,54,30,24,4
SONORA,26,ARIZPE,006,SINOQUIPE,3,52,26,26,4
SONORA,26,ATIL,007,ATIL,3,69,39,30,6
SONORA,26,BACADÉHUACHI,008,BACADÉHUACHI,3,130,64,66,13
SONORA,26,BACANORA,009,BACANORA,3,70,40,30,6
SONORA,26,BACANORA,009,EL DESTACAMENTO,2,19,12,7,2
SONORA,26,BACANORA,009,EL ENCINAL,2,9,0,9,2
SONORA,26,BACERAC,010,BACERAC,4,312,183,129,19
SONORA,26,BACERAC,010,CIÉNEGA DE HORCONES,2,4,1,3,2
SONORA,26,BACERAC,010,SAN JOSÉ DE LOS POZOS,3,11,9,2,2
SONORA,26,BACOACHI,011,BACOACHI,4,282,144,138,15
SONORA,26,BACOACHI,011,UNÁMICHI,1,12,4,8,2
SONORA,26,BÁCUM,012,ATOTONILCO,3,99,52,47,6
SONORA,26,BÁCUM,012,BÁCUM,6,2046,906,1140,105
SONORA,26,BÁCUM,012,BATACONCICA (MUSEO CHOPOCUNI),3,112,60,52,7
SONORA,26,BÁCUM,012,EL JUVANI,2,28,19,9,3
SONORA,26,BÁCUM,012,FRANCISCO JAVIER MINA (CAMPO 60),9,1683,858,825,75
SONORA,26,BÁCUM,012,INDEPENDENCIA (CAMPO 104),3,55,29,26,4
SONORA,26,BÁCUM,012,LA BOMBA (JUAN MALDONADO TETABIATE),2,32,17,15,3
SONORA,26,BÁCUM,012,LOMA DE BÁCUM,5,431,218,213,18
SONORA,26,BÁCUM,012,MIGUEL ALEMÁN (LA NORIA),2,56,28,28,3
SONORA,26,BÁCUM,012,PRIMERO DE MAYO (CAMPO 77),3,341,169,172,17
SONORA,26,BÁCUM,012,SAN JOSÉ DE BÁCUM,4,753,368,385,42
SONORA,26,BÁCUM,012,SANTA TERESA,2,43,26,17,3
SONORA,26,BÁCUM,012,VILLA GUADALUPE,3,93,49,44,6
SONORA,26,BANÁMICHI,013,BANÁMICHI,4,756,391,365,27
SONORA,26,BANÁMICHI,013,LA MORA,1,44,23,21,3
SONORA,26,BANÁMICHI,013,LAS DELICIAS,1,6,3,3,1
SONORA,26,BAVIÁCORA,014,BAVIÁCORA,5,414,210,204,25
SONORA,26,BAVIÁCORA,014,EL MOLINOTE (HACIENDA LA CONCEPCIÓN),1,6,3,3,1
SONORA,26,BAVIÁCORA,014,LA AURORA,2,20,12,8,2
SONORA,26,BAVIÁCORA,014,MAZOCAHUI,2,38,17,21,3
SONORA,26,BAVIÁCORA,014,SAN JOSÉ (SAN JOSÉ DE BAVIÁCORA),2,15,9,6,2
SONORA,26,BAVISPE,015,BAVISPE,3,149,83,66,10
SONORA,26,BAVISPE,015,LA MORA,3,82,39,43,5
SONORA,26,BAVISPE,015,SAN MIGUELITO,3,87,41,46,5
SONORA,26,BENJAMÍN HILL,016,BENJAMÍN HILL,8,1023,504,519,49
SONORA,26,CABORCA,017,15 DE SEPTIEMBRE,2,78,36,42,5
SONORA,26,CABORCA,017,ADOLFO ORIVE DE ALBA,3,111,45,66,7
SONORA,26,CABORCA,017,ALFONSO GARZÓN SANTIVAÑES (ZACATECAS),2,25,8,17,2
SONORA,26,CABORCA,017,ÁLVARO OBREGÓN,3,147,74,73,8
SONORA,26,CABORCA,017,CERRO BLANCO,2,43,23,20,3
SONORA,26,CABORCA,017,DESEMBOQUE,3,110,60,50,10
SONORA,26,CABORCA,017,EJIDO CAJEME DOS,2,34,20,14,3
SONORA,26,CABORCA,017,EL COYOTE,3,400,199,201,19
SONORA,26,CABORCA,017,EL DIAMANTE (LA RETRANCA),3,378,205,173,18
SONORA,26,CABORCA,017,EL PIRUL,1,29,15,14,2
SONORA,26,CABORCA,017,EL SAHUARO,1,7,3,4,1
SONORA,26,CABORCA,017,HEROICA CABORCA,80,16916,8476,8440,950
SONORA,26,CABORCA,017,JESÚS GARCÍA,3,89,43,46,6
SONORA,26,CABORCA,017,JOSÉ MARÍA MORELOS,2,80,40,40,4
SONORA,26,CABORCA,017,JOSEFA ORTIZ DE DOMÍNGUEZ,3,50,21,29,5
SONORA,26,CABORCA,017,JUAN ÁLVAREZ,3,23,9,14,5
SONORA,26,CABORCA,017,LA ALAMEDA (CORTÁZAR),2,98,53,45,5
SONORA,26,CABORCA,017,LA ALMITA,3,114,50,64,7
SONORA,26,CABORCA,017,LA MOCHOMERA (LA MORENA),3,61,29,32,4
SONORA,26,CABORCA,017,LA PRIMAVERA,3,42,26,16,4
SONORA,26,CABORCA,017,LÁZARO CÁRDENAS,1,16,11,5,1
SONORA,26,CABORCA,017,PLUTARCO ELÍAS CALLES (LA Y GRIEGA),8,2154,1076,1078,90
SONORA,26,CABORCA,017,POBLADO SAN FELIPE,2,158,70,88,7
SONORA,26,CABORCA,017,PUERTO LOBOS,3,72,30,42,4
SONORA,26,CABORCA,017,RODOLFO CAMPODÓNICO,2,25,14,11,3
SONORA,26,CABORCA,017,SALOMÓN QUIHUIS,1,14,6,8,1
SONORA,26,CABORCA,017,SAN ISIDRO,2,42,24,18,3
SONORA,26,CABORCA,017,SAN PEDRO,2,38,22,16,3
SONORA,26,CABORCA,017,SANTA EDUWIGES (LA CACHORA),2,79,42,37,4
SONORA,26,CABORCA,017,SIEMPRE VIVA,3,249,130,119,11
SONORA,26,CABORCA,017,ÚLTIMO ESFUERZO,3,118,58,60,8
SONORA,26,CABORCA,017,URES,2,44,21,23,3
SONORA,26,CABORCA,017,VIÑEDOS VIVA,3,141,70,71,7
SONORA,26,CAJEME,018,31 DE OCTUBRE,3,265,126,139,22
SONORA,26,CAJEME,018,ALLENDE (EL DIECIOCHO),3,334,173,161,27
SONORA,26,CAJEME,018,ALTOS DE JECOPACO,2,135,68,67,7
SONORA,26,CAJEME,018,AMPLIACIÓN LADRILLERA,1,10,5,5,1
SONORA,26,CAJEME,018,ANTONIO ROSALES,4,389,181,208,22
SONORA,26,CAJEME,018,BENITO JUÁREZ,1,11,8,3,1
SONORA,26,CAJEME,018,BUENAVISTA,3,74,36,38,4
SONORA,26,CAJEME,018,CAMPO VEINTIOCHO,2,33,15,18,3
SONORA,26,CAJEME,018,CIUDAD OBREGÓN,408,88197,44048,44149,6852
SONORA,26,CAJEME,018,CÓCORIT,10,1226,595,631,84
SONORA,26,CAJEME,018,CUAUHTÉMOC (CAMPO CINCO),5,473,227,246,24
SONORA,26,CAJEME,018,CUMURIPA,3,39,16,23,4
SONORA,26,CAJEME,018,DÍAZ ORDAZ,1,11,3,8,1
SONORA,26,CAJEME,018,EJIDO BENITO JUÁREZ (BLOQUE 1816),1,5,1,4,1
SONORA,26,CAJEME,018,EJIDO TEPEYAC (CAMPO DOS),2,185,105,80,8
SONORA,26,CAJEME,018,EL HENEQUÉN,2,5,3,2,2
SONORA,26,CAJEME,018,EL OLVIDO,3,129,60,69,9
SONORA,26,CAJEME,018,EL PORVENIR,1,7,5,2,1
SONORA,26,CAJEME,018,ESPERANZA,36,6827,3403,3424,429
SONORA,26,CAJEME,018,ESTACIÓN CORRAL,4,351,177,174,17
SONORA,26,CAJEME,018,FAMILIA CORDERO,1,10,5,5,1
SONORA,26,CAJEME,018,FRANCISCO I. MADERO (CAMPO 30),2,124,69,55,7
SONORA,26,CAJEME,018,FRANCISCO VILLA,4,264,131,133,13
SONORA,26,CAJEME,018,GUADALUPE VICTORIA,3,48,17,31,5
SONORA,26,CAJEME,018,JESÚS ALATORRE (KILÓMETRO SIETE),2,9,3,6,2
SONORA,26,CAJEME,018,KILÓMETRO NUEVE (EL PUEBLITO),3,63,31,32,4
SONORA,26,CAJEME,018,LA CARABINA,2,39,20,19,3
SONORA,26,CAJEME,018,LA LADRILLERA CANAL ALTO,2,31,12,19,3
SONORA,26,CAJEME,018,LA TINAJERA,3,76,37,39,5
SONORA,26,CAJEME,018,LAS ARENERAS,2,47,18,29,3
SONORA,26,CAJEME,018,LOMA DE CORRAL (LOMAS DE EST. CORRAL),2,32,13,19,3
SONORA,26,CAJEME,018,LOMA DE GUAMÚCHIL,4,410,189,221,17
SONORA,26,CAJEME,018,LOS HORNOS,4,186,93,93,13
SONORA,26,CAJEME,018,MARTE R. GÓMEZ (TOBARITO),10,1964,974,990,135
SONORA,26,CAJEME,018,MORA VILLALOBOS (CAMPO 29),3,235,93,142,11
SONORA,26,CAJEME,018,MORELOS DOS,2,29,13,16,4
SONORA,26,CAJEME,018,MORELOS UNO,2,76,46,30,6
SONORA,26,CAJEME,018,NUEVA CASA DE TERAS,2,14,8,6,2
SONORA,26,CAJEME,018,PASCUAL V. AYÓN,1,6,3,3,1
SONORA,26,CAJEME,018,PROGRESO (CAMPO 47),2,149,70,79,8
SONORA,26,CAJEME,018,PROVIDENCIA,6,2562,1467,1095,168
SONORA,26,CAJEME,018,PUEBLO YAQUI,12,2996,1464,1532,135
SONORA,26,CAJEME,018,PUENTE DE PICOS,3,45,22,23,4
SONORA,26,CAJEME,018,QUETCHEHUECA,5,734,365,369,45
SONORA,26,CAJEME,018,ROBLES CASTILLO (ÁLVARO OBREGÓN),1,72,37,35,3
SONORA,26,CAJEME,018,SONORA PROGRESISTA,2,52,25,27,3
SONORA,26,CAJEME,018,TAJIMAROA,2,68,31,37,5
SONORA,26,CAJEME,018,TESOPOBAMPO,3,102,47,55,7
SONORA,26,CAJEME,018,VICENTE GUERRERO (EL PORTÓN),3,233,115,118,11
SONORA,26,CAJEME,018,YUCURIBAMPO,3,119,60,59,9
SONORA,26,CANANEA,019,CUITACA,3,69,31,38,8
SONORA,26,CANANEA,019,HEROICA CIUDAD DE CANANEA,63,10765,5328,5437,627
SONORA,26,CANANEA,019,IGNACIO ZARAGOZA (LA MESA),1,15,6,9,3
SONORA,26,CANANEA,019,JOSÉ MARÍA MORELOS Y PAVÓN (SAUCEDA),2,21,11,10,2
SONORA,26,CANANEA,019,VICENTE GUERRERO,2,30,14,16,2
SONORA,26,CARBÓ,020,CARBÓ,6,1041,511,530,46
SONORA,26,LA COLORADA,021,COBACHI,3,14,5,9,3
SONORA,26,LA COLORADA,021,EL PORVENIR,1,1,1,0,1
SONORA,26,LA COLORADA,021,ESTACIÓN TORRES (ESTACIÓN SERDÁN),2,18,10,8,2
SONORA,26,LA COLORADA,021,LA COLORADA,3,71,43,28,5
SONORA,26,LA COLORADA,021,LOS HORCONES (WALDEN DOS),2,22,6,16,1
SONORA,26,LA COLORADA,021,SAN JOSÉ DE PIMAS,2,6,4,2,2
SONORA,26,LA COLORADA,021,TECORIPA,4,171,94,77,11
SONORA,26,CUCURPE,022,CUCURPE,3,109,56,53,7
SONORA,26,CUMPAS,023,CUMPAS,5,618,304,314,34
SONORA,26,CUMPAS,023,JÉCORI,3,58,27,31,4
SONORA,26,CUMPAS,023,KILÓMETRO CINCO (ÁLVARO OBREGÓN),1,2,1,1,1
SONORA,26,CUMPAS,023,LA COLONIA,1,52,32,20,3
SONORA,26,CUMPAS,023,LOS HOYOS,3,203,97,106,11
SONORA,26,CUMPAS,023,OJO DE AGUA,3,152,60,92,10
SONORA,26,CUMPAS,023,TEONADEPA,3,24,9,15,3
SONORA,26,DIVISADEROS,024,DIVISADEROS,3,121,53,68,10
SONORA,26,EMPALME,025,ANTONIO ROSALES,3,282,129,153,12
SONORA,26,EMPALME,025,CRUZ DE PIEDRA,3,175,97,78,10
SONORA,26,EMPALME,025,EMPALME,64,9728,4895,4833,752
SONORA,26,EMPALME,025,EMPALME EL ÁGUILA (EL RANCHITO),1,4,1,3,1
SONORA,26,EMPALME,025,JOSÉ MARÍA MORELOS Y PAVÓN (LA ATRAVEZADA),5,1261,639,622,91
SONORA,26,EMPALME,025,JUAN RODRÍGUEZ,3,122,57,65,7
SONORA,26,EMPALME,025,JUNELANCAHUI (EL MEZQUITE),2,65,30,35,4
SONORA,26,EMPALME,025,LA PALMA,3,223,122,101,11
SONORA,26,EMPALME,025,MAYTORENA,3,113,57,56,7
SONORA,26,EMPALME,025,MI PATRIA ES PRIMERO,2,177,76,101,8
SONORA,26,EMPALME,025,SAN FERNANDO DE GUAYMAS,3,138,70,68,8
SONORA,26,EMPALME,025,SANTA MARÍA DE GUAYMAS,4,460,222,238,21
SONORA,26,EMPALME,025,ÚRSULO GALVÁN,2,148,69,79,7
SONORA,26,ETCHOJOA,026,AGUSTÍN MELGAR,1,5,5,0,1
SONORA,26,ETCHOJOA,026,AQUICHOPO,3,121,65,56,8
SONORA,26,ETCHOJOA,026,BACAJAQUÍA,4,135,62,73,8
SONORA,26,ETCHOJOA,026,BACAME NUEVO,5,832,400,432,47
SONORA,26,ETCHOJOA,026,BACAME VIEJO,1,6,6,0,1
SONORA,26,ETCHOJOA,026,BACHOCO EL ALTO,3,37,19,18,3
SONORA,26,ETCHOJOA,026,BACOBAMPO,8,1658,872,786,94
SONORA,26,ETCHOJOA,026,BASCONCOBE,8,2007,939,1068,168
SONORA,26,ETCHOJOA,026,BAYAJORIT,3,127,64,63,6
SONORA,26,ETCHOJOA,026,BAYNORILLO,4,173,69,104,8
SONORA,26,ETCHOJOA,026,BUAYSIACOBE,8,1301,648,653,55
SONORA,26,ETCHOJOA,026,BURABAMPO,2,45,15,30,3
SONORA,26,ETCHOJOA,026,CAMPANICHACA,4,70,30,40,4
SONORA,26,ETCHOJOA,026,CAMPO LEÓN,3,42,19,23,4
SONORA,26,ETCHOJOA,026,CAMPO NÚMERO 13,2,44,22,22,2
SONORA,26,ETCHOJOA,026,CAMPO NÚMERO 18,1,8,4,4,1
SONORA,26,ETCHOJOA,026,CAURAJAQUI,3,88,39,49,4
SONORA,26,ETCHOJOA,026,CHUCARIT,2,125,60,65,7
SONORA,26,ETCHOJOA,026,CUADRILÁTERO NUEVE,1,34,13,21,2
SONORA,26,ETCHOJOA,026,EL BABURO,2,18,10,8,2
SONORA,26,ETCHOJOA,026,EL CAMPITO (CAMPO NÚMERO TRES),2,29,13,16,3
SONORA,26,ETCHOJOA,026,EL CAPUSARIT,1,49,27,22,2
SONORA,26,ETCHOJOA,026,EL CENTENARIO,3,112,51,61,5
SONORA,26,ETCHOJOA,026,EL CHAPOTE,2,58,25,33,3
SONORA,26,ETCHOJOA,026,EL CHORI (EL CHOYA),2,34,21,13,3
SONORA,26,ETCHOJOA,026,EL HUITCHACA,3,136,59,77,8
SONORA,26,ETCHOJOA,026,EL JUCHICA,1,11,6,5,1
SONORA,26,ETCHOJOA,026,EL MEZQUITAL DE BURABAMPO,1,7,5,2,1
SONORA,26,ETCHOJOA,026,EL NUEVO RETIRO,1,8,7,1,1
SONORA,26,ETCHOJOA,026,EL QUINTO,1,285,189,96,25
SONORA,26,ETCHOJOA,026,EL QUINTO VIEJO (EL CULEBRÓN),1,9,5,4,1
SONORA,26,ETCHOJOA,026,EL RODEO,3,301,152,149,13
SONORA,26,ETCHOJOA,026,EL SALITRAL,2,60,35,25,4
SONORA,26,ETCHOJOA,026,ESPAÑA (CAMPO NÚMERO UNO),2,34,19,15,3
SONORA,26,ETCHOJOA,026,ETCHOJOA,14,2210,1125,1085,127
SONORA,26,ETCHOJOA,026,GUAYABITAS (LA SÁBILA),2,34,19,15,4
SONORA,26,ETCHOJOA,026,GUAYPARÍN,7,532,228,304,21
SONORA,26,ETCHOJOA,026,GUAYTANA,3,75,36,39,4
SONORA,26,ETCHOJOA,026,HUIROACHACA,4,178,78,100,10
SONORA,26,ETCHOJOA,026,INICIACIÓN NÚMERO 2 [GRANJA],1,7,1,6,1
SONORA,26,ETCHOJOA,026,JITONHUECA,3,202,93,109,11
SONORA,26,ETCHOJOA,026,LA BOCANA,4,383,188,195,17
SONORA,26,ETCHOJOA,026,LA ESCONDIDA,1,9,4,5,1
SONORA,26,ETCHOJOA,026,LA LÍNEA (LA LÍNEA DE BASCONCOBE),1,22,8,14,1
SONORA,26,ETCHOJOA,026,LA VASCONIA (DEL APELLIDO VASCO),2,107,46,61,6
SONORA,26,ETCHOJOA,026,LAS CUCAS,2,8,5,3,2
SONORA,26,ETCHOJOA,026,LAS GUAYABAS,4,131,62,69,7
SONORA,26,ETCHOJOA,026,LAS MAYAS (COLONIA AGRÍCOLA BASCONCOBE),2,17,6,11,2
SONORA,26,ETCHOJOA,026,LAS PLAYITAS,3,120,48,72,6
SONORA,26,ETCHOJOA,026,LÁZARO CÁRDENAS (MAYOJUSÁLIT),1,16,8,8,1
SONORA,26,ETCHOJOA,026,LOS VIEJOS,2,28,13,15,2
SONORA,26,ETCHOJOA,026,MABEJAQUI,3,80,47,33,5
SONORA,26,ETCHOJOA,026,MACOCHÍN,1,10,5,5,1
SONORA,26,ETCHOJOA,026,MAYOCAHUI,3,69,33,36,4
SONORA,26,ETCHOJOA,026,MIL HECTÁREAS,1,24,10,14,2
SONORA,26,ETCHOJOA,026,MOCHIPACO,3,166,81,85,9
SONORA,26,ETCHOJOA,026,MOCHIPACO NUEVO,1,17,7,10,1
SONORA,26,ETCHOJOA,026,MOCOCHOPO (YEMOVARI),2,29,13,16,2
SONORA,26,ETCHOJOA,026,MOCORÚA,4,141,75,66,7
SONORA,26,ETCHOJOA,026,NAVOLATO,3,275,129,146,14
SONORA,26,ETCHOJOA,026,SAHUARAL,5,597,303,294,27
SONORA,26,ETCHOJOA,026,SAN PEDRO NUEVO,2,459,226,233,51
SONORA,26,ETCHOJOA,026,SAN PEDRO VIEJO,4,398,202,196,29
SONORA,26,ETCHOJOA,026,SEBAMPO,4,202,100,102,12
SONORA,26,ETCHOJOA,026,TALAMANTE (COLONIA TALAMANTE),2,44,24,20,3
SONORA,26,ETCHOJOA,026,TEJABANES VIEJOS,2,13,5,8,2
SONORA,26,ETCHOJOA,026,TIRISCOHUASA,3,54,25,29,4
SONORA,26,ETCHOJOA,026,VILLA TRES CRUCES,4,214,96,118,10
SONORA,26,FRONTERAS,027,CUCHUTA,1,202,96,106,6
SONORA,26,FRONTERAS,027,CUQUIARACHI,1,6,4,2,1
SONORA,26,FRONTERAS,027,ESQUEDA,10,1886,930,956,105
SONORA,26,FRONTERAS,027,FRONTERAS,4,243,133,110,15
SONORA,26,FRONTERAS,027,TURICACHI,2,52,27,25,4
SONORA,26,GRANADOS,028,GRANADOS,3,265,128,137,18
SONORA,26,GUAYMAS,029,ADOLFO DE LA HUERTA,2,6,2,4,1
SONORA,26,GUAYMAS,029,BABOJORI,3,42,29,13,3
SONORA,26,GUAYMAS,029,BAUGO (GUÁSIMAS),2,54,34,20,3
SONORA,26,GUAYMAS,029,CÁRDENAS,1,84,37,47,4
SONORA,26,GUAYMAS,029,CASA AZUL,3,96,46,50,6
SONORA,26,GUAYMAS,029,CASAS BLANCAS,3,106,54,52,6
SONORA,26,GUAYMAS,029,CHUMAMPACO,2,16,6,10,2
SONORA,26,GUAYMAS,029,COMPUERTAS,2,44,22,22,3
SONORA,26,GUAYMAS,029,EDMUNDO SÁNCHEZ (EL CHORIZO),2,32,16,16,2
SONORA,26,GUAYMAS,029,EL CASTILLO,2,55,27,28,3
SONORA,26,GUAYMAS,029,EL PESCADO,1,6,3,3,1
SONORA,26,GUAYMAS,029,EL SAHUARAL,3,117,57,60,6
SONORA,26,GUAYMAS,029,EL YAQUI,2,20,11,9,2
SONORA,26,GUAYMAS,029,ESTACIÓN OROZ (OROZ),3,82,41,41,5
SONORA,26,GUAYMAS,029,FRANCISCO MÁRQUEZ,5,311,146,165,14
SONORA,26,GUAYMAS,029,GENERAL ÁLVARO OBREGÓN,1,8,5,3,1
SONORA,26,GUAYMAS,029,GENERAL ESTEBAN BACA CALDERÓN (EL HECHO),1,4,1,3,1
SONORA,26,GUAYMAS,029,GENERAL FELIPE ÁNGELES,1,83,38,45,4
SONORA,26,GUAYMAS,029,GENERAL LÁZARO CÁRDENAS,3,89,45,44,6
SONORA,26,GUAYMAS,029,GENERAL MARIANO ESCOBEDO,1,6,2,4,1
SONORA,26,GUAYMAS,029,GUADALUPE VICTORIA,2,24,9,15,2
SONORA,26,GUAYMAS,029,GUÁSIMAS (DE BELEM),5,573,295,278,26
SONORA,26,GUAYMAS,029,GUASIMITAS,3,43,17,26,4
SONORA,26,GUAYMAS,029,HEROICA GUAYMAS,143,30289,15054,15235,2366
SONORA,26,GUAYMAS,029,HUIRIBIS,3,81,42,39,4
SONORA,26,GUAYMAS,029,LA CUADRITA,2,33,14,19,3
SONORA,26,GUAYMAS,029,LA ESCONDIDA (GUADALUPE DE GUAYMAS),3,339,164,175,16
SONORA,26,GUAYMAS,029,LA MANGA (CAMPO PESQUERO LA MANGA),3,50,29,21,4
SONORA,26,GUAYMAS,029,LA MISA,3,54,26,28,4
SONORA,26,GUAYMAS,029,LA SALVACIÓN,2,91,40,51,5
SONORA,26,GUAYMAS,029,LENCHO,2,27,13,14,2
SONORA,26,GUAYMAS,029,LOS LIMONES,2,11,4,7,1
SONORA,26,GUAYMAS,029,NICOLÁS BRAVO,3,58,30,28,5
SONORA,26,GUAYMAS,029,NUEVO SAN FRANCISCO,3,28,10,18,3
SONORA,26,GUAYMAS,029,ORTÍZ,3,257,129,128,12
SONORA,26,GUAYMAS,029,PIMIENTA,2,5,3,2,1
SONORA,26,GUAYMAS,029,PITAHAYA (BELEM),3,77,30,47,6
SONORA,26,GUAYMAS,029,PÓTAM,11,1658,837,821,87
SONORA,26,GUAYMAS,029,PROFESOR GRACIANO SÁNCHEZ,2,85,41,44,4
SONORA,26,GUAYMAS,029,RAHUM,4,142,71,71,7
SONORA,26,GUAYMAS,029,SAN CARLOS (SAN CARLOS NUEVO GUAYMAS),3,304,137,167,13
SONORA,26,GUAYMAS,029,SAN JOSÉ DE GUAYMAS,4,310,157,153,16
SONORA,26,GUAYMAS,029,SANTA CLARA,3,384,191,193,18
SONORA,26,GUAYMAS,029,TÓRIM,4,321,141,180,16
SONORA,26,GUAYMAS,029,TRIUNFO SANTA ROSA,4,287,146,141,13
SONORA,26,GUAYMAS,029,VÍCAM (SWITCH),18,2695,1352,1343,161
SONORA,26,GUAYMAS,029,VÍCAM PUEBLO,5,720,430,290,23
SONORA,26,HERMOSILLO,030,ALEJANDRO CARRILLO MARCOR,3,376,187,189,16
SONORA,26,HERMOSILLO,030,BAHÍA DE KINO,8,1833,902,931,75
SONORA,26,HERMOSILLO,030,CAMPO DEL CARMEN,1,13,6,7,1
SONORA,26,HERMOSILLO,030,CARMEN DOLORES,2,52,28,24,4
SONORA,26,HERMOSILLO,030,CRUCERO (CUATRO Y VEINTISÉIS),1,9,3,6,1
SONORA,26,HERMOSILLO,030,EL ALAMITO BUENAVISTA (EL TRONCONAL),2,190,93,97,9
SONORA,26,HERMOSILLO,030,EL AZAHAR,3,484,229,255,17
SONORA,26,HERMOSILLO,030,EL CHOYUDO (LOS JAPONESES),4,115,62,53,9
SONORA,26,HERMOSILLO,030,EL JOJOBAL,2,6,4,2,2
SONORA,26,HERMOSILLO,030,EL REALITO,2,16,11,5,2
SONORA,26,HERMOSILLO,030,EL SAUCITO,2,57,23,34,4
SONORA,26,HERMOSILLO,030,EL TAZAJAL,3,326,165,161,15
SONORA,26,HERMOSILLO,030,EL TRIUNFO,3,898,447,451,40
SONORA,26,HERMOSILLO,030,EL ZACATÓN,3,122,68,54,9
SONORA,26,HERMOSILLO,030,FLORESTA,2,19,9,10,2
SONORA,26,HERMOSILLO,030,HERMOSILLO,980,256620,130599,126021,15761
SONORA,26,HERMOSILLO,030,LA HABANA NÚMERO DOS,1,50,22,28,2
SONORA,26,HERMOSILLO,030,LA HABANA TRES,2,33,15,18,2
SONORA,26,HERMOSILLO,030,LA PALMA,1,36,22,14,2
SONORA,26,HERMOSILLO,030,LA PEAÑA,1,12,6,6,1
SONORA,26,HERMOSILLO,030,LA PEAÑA NUEVA,2,66,32,34,4
SONORA,26,HERMOSILLO,030,LA VICTORIA,14,2365,1110,1255,338
SONORA,26,HERMOSILLO,030,LA YUTA,3,181,96,85,10
SONORA,26,HERMOSILLO,030,LAS PALMITAS,1,150,70,80,6
SONORA,26,HERMOSILLO,030,LOS PAÑUELOS,1,14,10,4,1
SONORA,26,HERMOSILLO,030,LOS POCITOS,2,92,37,55,5
SONORA,26,HERMOSILLO,030,MANUEL ÁVILA CAMACHO,3,84,38,46,6
SONORA,26,HERMOSILLO,030,MESA DEL SERI,4,204,109,95,12
SONORA,26,HERMOSILLO,030,MIGUEL ALEMÁN (LA DOCE),29,8095,4110,3985,318
SONORA,26,HERMOSILLO,030,MINEROS DE PILARES,3,137,69,68,9
SONORA,26,HERMOSILLO,030,MOLINO DE CAMOU (SAN ISIDRO),4,300,153,147,16
SONORA,26,HERMOSILLO,030,PLAN DE AYALA,4,272,137,135,14
SONORA,26,HERMOSILLO,030,PUERTO ARTURO,3,12,6,6,2
SONORA,26,HERMOSILLO,030,PUNTA CHUECA,5,185,97,88,13
SONORA,26,HERMOSILLO,030,RANCHO SONORA,2,18,12,6,2
SONORA,26,HERMOSILLO,030,ROSARIO PERLETTE,3,12,9,3,3
SONORA,26,HERMOSILLO,030,SAHUÍMERO,2,2,1,1,3
SONORA,26,HERMOSILLO,030,SALVADOR ALVARADO,1,14,10,4,1
SONORA,26,HERMOSILLO,030,SAN ARMANDO,1,120,61,59,6
SONORA,26,HERMOSILLO,030,SAN BARTOLO,2,22,8,14,2
SONORA,26,HERMOSILLO,030,SAN FRANCISCO DE BATUC,1,25,13,12,2
SONORA,26,HERMOSILLO,030,SAN JUANICO,1,11,6,5,1
SONORA,26,HERMOSILLO,030,SAN LUIS,3,124,66,58,6
SONORA,26,HERMOSILLO,030,SAN MIGUEL,2,8,5,3,2
SONORA,26,HERMOSILLO,030,SAN PEDRO O EL SAUCITO (SAN PEDRO EL SAUCITO),5,1075,529,546,56
SONORA,26,HERMOSILLO,030,SANTA AURELIA,1,9,3,6,1
SONORA,26,HERMOSILLO,030,SANTA EDUWIGES (RADIO),3,18,7,11,3
SONORA,26,HERMOSILLO,030,SANTA ELENA,2,29,17,12,3
SONORA,26,HERMOSILLO,030,SANTA EMILIA,1,25,12,13,2
SONORA,26,HERMOSILLO,030,SANTA INÉS UNO (EL CAPITÁN),2,21,9,12,3
SONORA,26,HERMOSILLO,030,SANTA MÓNICA,2,52,23,29,3
SONORA,26,HERMOSILLO,030,SANTA ROSITA,1,21,8,13,2
SONORA,26,HERMOSILLO,030,TOPAHUE,1,6,4,2,1
SONORA,26,HERMOSILLO,030,VALLE GRANDE,1,12,6,6,1
SONORA,26,HERMOSILLO,030,ZAMORA,3,253,106,147,11
SONORA,26,HUACHINERA,031,ARIBABI,3,58,27,31,5
SONORA,26,HUACHINERA,031,HUACHINERA,3,140,62,78,9
SONORA,26,HUÁSABAS,032,HUÁSABAS,3,163,68,95,15
SONORA,26,HUATABAMPO,033,10 DE ABRIL,2,35,14,21,3
SONORA,26,HUATABAMPO,033,24 DE FEBRERO,3,329,165,164,46
SONORA,26,HUATABAMPO,033,ADOLFO LÓPEZ MATEOS,2,36,18,18,3
SONORA,26,HUATABAMPO,033,AGIABAMPO NÚMERO DOS (EL CAMPITO),3,108,59,49,6
SONORA,26,HUATABAMPO,033,AGIABAMPO UNO,6,531,242,289,32
SONORA,26,HUATABAMPO,033,ÁLVARO OBREGÓN,3,65,36,29,4
SONORA,26,HUATABAMPO,033,AQUICHOPO,1,5,2,3,1
SONORA,26,HUATABAMPO,033,BABURO,3,90,51,39,5
SONORA,26,HUATABAMPO,033,BACAPACO,2,31,11,20,3
SONORA,26,HUATABAMPO,033,BACHANTAHUI,4,291,127,164,15
SONORA,26,HUATABAMPO,033,BACHIMOJAQUI,2,14,6,8,2
SONORA,26,HUATABAMPO,033,BACHOCO,4,61,27,34,6
SONORA,26,HUATABAMPO,033,BENITO JUÁREZ,3,47,31,16,4
SONORA,26,HUATABAMPO,033,BUIYARUMO,3,42,24,18,4
SONORA,26,HUATABAMPO,033,CAMAHUIROA,2,42,17,25,2
SONORA,26,HUATABAMPO,033,CAMPO DIECINUEVE,2,59,29,30,3
SONORA,26,HUATABAMPO,033,CHAPULTEPEC,2,33,21,12,3
SONORA,26,HUATABAMPO,033,CHICHIBOJORO,2,21,9,12,2
SONORA,26,HUATABAMPO,033,CHIJUBAMPO,3,27,16,11,3
SONORA,26,HUATABAMPO,033,CITAVÁRO,3,158,72,86,19
SONORA,26,HUATABAMPO,033,COLONIA MACÍAS,2,16,3,13,2
SONORA,26,HUATABAMPO,033,EL ALTO SAN CRISTÓBAL,2,26,14,12,2
SONORA,26,HUATABAMPO,033,EL CARO,4,102,51,51,6
SONORA,26,HUATABAMPO,033,EL NACAPUL,2,18,13,5,2
SONORA,26,HUATABAMPO,033,EL PORVENIR,1,8,6,2,1
SONORA,26,HUATABAMPO,033,EL RIÍTO,2,49,26,23,3
SONORA,26,HUATABAMPO,033,EL RIÍTO DE MAZARAY (RIÍTO MUERTO),3,78,37,41,4
SONORA,26,HUATABAMPO,033,EL SUFRAGIO,3,41,19,22,3
SONORA,26,HUATABAMPO,033,EL TÁBARE,2,51,26,25,5
SONORA,26,HUATABAMPO,033,EMILIANO ZAPATA UNO,1,90,50,40,5
SONORA,26,HUATABAMPO,033,ETCHOROPO,1,157,82,75,6
SONORA,26,HUATABAMPO,033,FRANCISCO SARABIA,3,140,65,75,15
SONORA,26,HUATABAMPO,033,GUADALUPE VICTORIA,2,42,22,20,3
SONORA,26,HUATABAMPO,033,HUATABAMPO,46,8048,3951,4097,527
SONORA,26,HUATABAMPO,033,INSURGENTES DE PUEBLO YAQUI,2,33,13,20,3
SONORA,26,HUATABAMPO,033,JAMBIOLABAMPO DOS (LOS POLLOS),2,9,4,5,2
SONORA,26,HUATABAMPO,033,JAMBIOLABAMPO UNO,2,10,4,6,2
SONORA,26,HUATABAMPO,033,JUAN DE LA BARRERA,3,137,70,67,10
SONORA,26,HUATABAMPO,033,JUAN ESCUTIA,2,17,8,9,2
SONORA,26,HUATABAMPO,033,JULIANTABAMPO,1,6,1,5,1
SONORA,26,HUATABAMPO,033,JÚPARE,6,772,385,387,40
SONORA,26,HUATABAMPO,033,LA ARENITA,1,11,6,5,1
SONORA,26,HUATABAMPO,033,LA COCHERA,1,6,4,2,1
SONORA,26,HUATABAMPO,033,LA CUCHILLA DE SAN ANTONIO,1,11,6,5,1
SONORA,26,HUATABAMPO,033,LA CUCHILLA DEL ETCHOROPO,1,5,2,3,1
SONORA,26,HUATABAMPO,033,LA ESCALERA,2,76,46,30,4
SONORA,26,HUATABAMPO,033,LA ESQUINA,2,120,61,59,6
SONORA,26,HUATABAMPO,033,LA PRIMAVERA,2,41,21,20,3
SONORA,26,HUATABAMPO,033,LA REFORMA,2,34,20,14,3
SONORA,26,HUATABAMPO,033,LA ROSITA,2,18,9,9,2
SONORA,26,HUATABAMPO,033,LA SÁBILA,2,78,35,43,3
SONORA,26,HUATABAMPO,033,LA UNIÓN,5,605,300,305,26
SONORA,26,HUATABAMPO,033,LAS ÁNIMAS,1,11,7,4,1
SONORA,26,HUATABAMPO,033,LAS BOCAS,6,371,172,199,18
SONORA,26,HUATABAMPO,033,LAS MAMIAS,3,46,21,25,4
SONORA,26,HUATABAMPO,033,LAS MILPAS,4,131,65,66,8
SONORA,26,HUATABAMPO,033,LAS PARRAS,3,120,56,64,8
SONORA,26,HUATABAMPO,033,LAS PARRITAS (EL CHANGUITO),2,23,11,12,3
SONORA,26,HUATABAMPO,033,LOMA DE ETCHOROPO,8,720,357,363,50
SONORA,26,HUATABAMPO,033,LOMA DE MORONCÁRIT,1,43,18,25,2
SONORA,26,HUATABAMPO,033,LOS BUITBORES,2,64,31,33,3
SONORA,26,HUATABAMPO,033,LOS TOLTECAS,2,30,14,16,2
SONORA,26,HUATABAMPO,033,LUIS ECHEVERRÍA ZUNO,3,64,31,33,4
SONORA,26,HUATABAMPO,033,MANUEL CAUDILLO,2,21,12,9,2
SONORA,26,HUATABAMPO,033,MAYO FUERTE,3,43,20,23,3
SONORA,26,HUATABAMPO,033,MELCHOR OCAMPO,3,86,37,49,4
SONORA,26,HUATABAMPO,033,MOCHIBAMPO,2,139,67,72,8
SONORA,26,HUATABAMPO,033,MORELOS,2,15,3,12,2
SONORA,26,HUATABAMPO,033,MORONCÁRIT,4,370,174,196,17
SONORA,26,HUATABAMPO,033,NAVOBAXIA,4,163,87,76,9
SONORA,26,HUATABAMPO,033,ORABA,2,15,10,5,2
SONORA,26,HUATABAMPO,033,POZO DULCE,5,317,165,152,17
SONORA,26,HUATABAMPO,033,PUEBLO VIEJO,2,66,38,28,4
SONORA,26,HUATABAMPO,033,SAHUARAL DE OTERO (SAHUARAL DE ABAJO),3,173,83,90,10
SONORA,26,HUATABAMPO,033,SAN ANTONIO,4,116,60,56,7
SONORA,26,HUATABAMPO,033,SIREBAMPO,4,156,74,82,8
SONORA,26,HUATABAMPO,033,SONORA SINALOA (BAMOCHA),1,6,6,0,1
SONORA,26,HUATABAMPO,033,TIERRA Y LIBERTAD,1,6,3,3,1
SONORA,26,HUATABAMPO,033,TOROCOBA,4,71,37,34,5
SONORA,26,HUATABAMPO,033,TOROCOBAMPO,1,14,5,9,1
SONORA,26,HUATABAMPO,033,TOTOLIBOQUI,3,59,33,26,4
SONORA,26,HUATABAMPO,033,UNIFICACIÓN CAMPESINA (COLA SECA),1,7,3,4,1
SONORA,26,HUATABAMPO,033,VENUSTIANO CARRANZA,2,121,53,68,7
SONORA,26,HUATABAMPO,033,YAVARITOS,4,124,60,64,7
SONORA,26,HUATABAMPO,033,YAVAROS (ISLA LAS VIEJAS),8,1029,484,545,79
SONORA,26,HUATABAMPO,033,ZAMICARIT,2,47,24,23,3
SONORA,26,HUÉPAC,034,HUÉPAC,3,238,115,123,18
SONORA,26,IMURIS,035,CAMPO CARRETERO,2,181,104,77,8
SONORA,26,IMURIS,035,CERRO BLANCO,1,190,89,101,8
SONORA,26,IMURIS,035,EL CRUCERO,1,107,50,57,6
SONORA,26,IMURIS,035,ESTACIÓN CUMERAL,1,13,5,8,1
SONORA,26,IMURIS,035,IMURIS,16,2244,1088,1156,113
SONORA,26,IMURIS,035,INVERNADERO CRIS-P (CASAS VERDES),2,70,29,41,4
SONORA,26,IMURIS,035,LA ESTACIÓN,2,181,97,84,8
SONORA,26,IMURIS,035,LA MESA,2,44,22,22,3
SONORA,26,IMURIS,035,LAS VIGUITAS,1,34,12,22,2
SONORA,26,IMURIS,035,LOS JANOS,1,41,17,24,2
SONORA,26,IMURIS,035,TERRENATE,2,30,14,16,2
SONORA,26,MAGDALENA,036,EL MEZQUITE,1,9,3,6,1
SONORA,26,MAGDALENA,036,EL TASÍCURI,2,85,45,40,5
SONORA,26,MAGDALENA,036,GUTIÉRREZ (LA CEBOLLA),3,40,19,21,4
SONORA,26,MAGDALENA,036,LA MESA DE BEDOLLA,1,36,18,18,2
SONORA,26,MAGDALENA,036,MAGDALENA DE KINO,49,9002,4614,4388,657
SONORA,26,MAGDALENA,036,SAN IGNACIO,3,85,44,41,8
SONORA,26,MAGDALENA,036,SAN LORENZO,1,13,6,7,1
SONORA,26,MAZATÁN,037,MAZATÁN,4,247,124,123,23
SONORA,26,MOCTEZUMA,038,EL LLANO,2,9,6,3,2
SONORA,26,MOCTEZUMA,038,MOCTEZUMA,9,1909,975,934,94
SONORA,26,MOCTEZUMA,038,SAN PATRICIO DE LA MESA,1,21,11,10,2
SONORA,26,NACO,039,CUAUHTÉMOC,4,57,20,37,7
SONORA,26,NACO,039,NACO,6,1262,668,594,49
SONORA,26,NÁCORI CHICO,040,BUENA VISTA,1,18,9,9,1
SONORA,26,NÁCORI CHICO,040,EL SAUZ,3,33,22,11,3
SONORA,26,NÁCORI CHICO,040,LA MESA TRES RÍOS,3,75,38,37,5
SONORA,26,NÁCORI CHICO,040,NÁCORI CHICO,4,201,101,100,13
SONORA,26,NACOZARI DE GARCÍA,041,LA CASETA DOS (LA CARIDAD),4,833,416,417,43
SONORA,26,NACOZARI DE GARCÍA,041,NACOZARI DE GARCÍA,15,2612,1267,1345,144
SONORA,26,NAVOJOA,042,5 DE JUNIO,3,56,21,35,4
SONORA,26,NAVOJOA,042,AGIABAMPO,2,14,7,7,2
SONORA,26,NAVOJOA,042,ANTONIO ROSALES (LAS ÁNIMAS),1,6,3,3,1
SONORA,26,NAVOJOA,042,BACABACHI,4,496,240,256,46
SONORA,26,NAVOJOA,042,BARRIO CANTÚA,3,17,8,9,3
SONORA,26,NAVOJOA,042,BASIABAMPO,1,2,0,2,1
SONORA,26,NAVOJOA,042,BATAYAQUI,3,20,10,10,3
SONORA,26,NAVOJOA,042,BEMELABAMPO,2,16,8,8,2
SONORA,26,NAVOJOA,042,BUÁRAJE VIEJO,2,38,23,15,3
SONORA,26,NAVOJOA,042,BUENAVISTA,2,36,19,17,3
SONORA,26,NAVOJOA,042,BUIYACUSI,2,88,31,57,4
SONORA,26,NAVOJOA,042,CAMOA,2,16,9,7,2
SONORA,26,NAVOJOA,042,CAPOHUIZA,2,121,57,64,7
SONORA,26,NAVOJOA,042,CHIBUCÚ,2,93,45,48,5
SONORA,26,NAVOJOA,042,CHIHUAHUITA,3,84,34,50,5
SONORA,26,NAVOJOA,042,CHINOTAHUECA,3,137,68,69,11
SONORA,26,NAVOJOA,042,CHIRAJOBAMPO,2,171,92,79,9
SONORA,26,NAVOJOA,042,CHOACALLE,3,92,47,45,5
SONORA,26,NAVOJOA,042,CUCAJAQUI,3,97,53,44,7
SONORA,26,NAVOJOA,042,CUCHILLA DE BAHUISES,2,23,16,7,2
SONORA,26,NAVOJOA,042,EL CHAPOTE,3,36,18,18,4
SONORA,26,NAVOJOA,042,EL DÁTIL,2,41,18,23,3
SONORA,26,NAVOJOA,042,EL JIJIRI,2,81,42,39,4
SONORA,26,NAVOJOA,042,EL JOPO,2,26,15,11,2
SONORA,26,NAVOJOA,042,EL RECODO,4,233,108,125,14
SONORA,26,NAVOJOA,042,EL SABINITO DE TESIA (TESIA Y SUS ANEXOS),2,21,12,9,2
SONORA,26,NAVOJOA,042,EL SANEAL,4,282,133,149,13
SONORA,26,NAVOJOA,042,EL SIFÓN (SIFÓN CANAL ALTO),3,62,34,28,4
SONORA,26,NAVOJOA,042,EL SIVIRAL,3,277,133,144,14
SONORA,26,NAVOJOA,042,EL TABLÓN,1,8,5,3,1
SONORA,26,NAVOJOA,042,ETCHOHUAQUILA,3,191,85,106,11
SONORA,26,NAVOJOA,042,FRANCISCO I. MADERO DOS,2,34,18,16,2
SONORA,26,NAVOJOA,042,FUNDICIÓN,4,297,137,160,15
SONORA,26,NAVOJOA,042,GENERAL GABRIEL LEYVA SOLANO (GABRIEL LEYVA),3,31,16,15,3
SONORA,26,NAVOJOA,042,GUADALUPE DE JUÁREZ,4,342,163,179,16
SONORA,26,NAVOJOA,042,GUAYMITAS,2,189,98,91,8
SONORA,26,NAVOJOA,042,HUEBAMPO,4,53,26,27,5
SONORA,26,NAVOJOA,042,JOAQUÍN AMARO,3,73,33,40,4
SONORA,26,NAVOJOA,042,JOPOPACO,2,43,19,24,3
SONORA,26,NAVOJOA,042,JOSTAHUECA,2,38,19,19,3
SONORA,26,NAVOJOA,042,JUSIBAMPO,2,25,12,13,3
SONORA,26,NAVOJOA,042,KUTANTAKA,2,36,18,18,2
SONORA,26,NAVOJOA,042,LA LAGUNA DE TESIA,2,32,12,20,2
SONORA,26,NAVOJOA,042,LA PERA,2,39,21,18,3
SONORA,26,NAVOJOA,042,LA POTABLE,2,17,9,8,2
SONORA,26,NAVOJOA,042,LAS PILAS,1,5,3,2,1
SONORA,26,NAVOJOA,042,LICENCIADO LUIS ECHEVERRÍA ÁLVAREZ,3,37,21,16,3
SONORA,26,NAVOJOA,042,LOMA DEL REFUGIO,3,104,54,50,7
SONORA,26,NAVOJOA,042,LOS BAHUISES,3,169,79,90,9
SONORA,26,NAVOJOA,042,LOS BUAYUMS,4,247,123,124,13
SONORA,26,NAVOJOA,042,LOS LIMONES,2,29,15,14,2
SONORA,26,NAVOJOA,042,MASIACA,4,532,274,258,32
SONORA,26,NAVOJOA,042,MEZQUITAL DE BUIYACUSI,3,147,73,74,9
SONORA,26,NAVOJOA,042,MEZQUITAL DE TESIA,2,45,24,21,3
SONORA,26,NAVOJOA,042,MUSUABAMPO,2,27,14,13,3
SONORA,26,NAVOJOA,042,NACHUQUIS (SAN ANTONIO NACHUQUIS),4,304,136,168,16
SONORA,26,NAVOJOA,042,NAVOJOA,171,38633,20136,18497,2876
SONORA,26,NAVOJOA,042,NAVOMORA,2,3,1,2,1
SONORA,26,NAVOJOA,042,PALO BLANCO,1,13,9,4,1
SONORA,26,NAVOJOA,042,PUEBLO MAYO,4,555,269,286,25
SONORA,26,NAVOJOA,042,PUNTA DE LA LAGUNA,2,31,14,17,3
SONORA,26,NAVOJOA,042,RANCHO CAMARGO,3,121,67,54,7
SONORA,26,NAVOJOA,042,RANCHO DEL PADRE,4,116,60,56,7
SONORA,26,NAVOJOA,042,ROSALES,4,617,293,324,25
SONORA,26,NAVOJOA,042,SAN ANTONIO DE LOS IBARRA (SAN ANTONIO),3,29,13,16,3
SONORA,26,NAVOJOA,042,SAN JOSÉ MASIACA,3,97,45,52,6
SONORA,26,NAVOJOA,042,SAN PEDRITO,1,9,1,8,1
SONORA,26,NAVOJOA,042,SANTA BÁRBARA,2,9,3,6,1
SONORA,26,NAVOJOA,042,SANTA MARÍA DEL BUARAJE,4,351,177,174,16
SONORA,26,NAVOJOA,042,SANTA ROSA,2,14,6,8,2
SONORA,26,NAVOJOA,042,SAPOCHOPO,1,17,8,9,1
SONORA,26,NAVOJOA,042,SAPOMORA,2,88,40,48,6
SONORA,26,NAVOJOA,042,SAUCOBE,2,7,3,4,1
SONORA,26,NAVOJOA,042,SIBACOBE,3,76,33,43,5
SONORA,26,NAVOJOA,042,SINAHUISA,4,207,104,103,13
SONORA,26,NAVOJOA,042,TEACHIVE,3,52,22,30,4
SONORA,26,NAVOJOA,042,TESIA,2,126,68,58,7
SONORA,26,NAVOJOA,042,TETAPECHE,4,122,50,72,9
SONORA,26,NAVOJOA,042,TIERRA BLANCA,5,590,280,310,28
SONORA,26,NAVOJOA,042,TRES HERMANOS,3,29,12,17,3
SONORA,26,NOGALES,043,AGUA ZARCA (FERROCARRIL),7,2312,1120,1192,77
SONORA,26,NOGALES,043,CÍBUTA,5,294,150,144,14
SONORA,26,NOGALES,043,HEROICA NOGALES,298,66680,32920,33760,3735
SONORA,26,NOGALES,043,MASCAREÑA (CASAS DEL FERROCARRIL),3,198,96,102,10
SONORA,26,ÓNAVAS,044,ÓNAVAS,4,80,36,44,9
SONORA,26,OPODEPE,045,MERÉSICHIC,3,23,12,11,3
SONORA,26,OPODEPE,045,OPODEPE,3,48,23,25,4
SONORA,26,OPODEPE,045,QUEROBABI,4,309,143,166,17
SONORA,26,OPODEPE,045,TUAPE,3,22,8,14,3
SONORA,26,OQUITOA,046,OQUITOA,3,33,21,12,4
SONORA,26,PITIQUITO,047,DESEMBOQUE DE LOS SERIS (EL DESEMBOQUE),5,102,55,47,8
SONORA,26,PITIQUITO,047,FÉLIX GÓMEZ (EL DIPO),1,4,2,2,1
SONORA,26,PITIQUITO,047,LA ESTACIÓN (ESTACIÓN PITIQUITO),2,22,13,9,3
SONORA,26,PITIQUITO,047,PITIQUITO,7,1073,564,509,71
SONORA,26,PITIQUITO,047,PUERTO LIBERTAD,5,690,316,374,29
SONORA,26,PITIQUITO,047,SANTA MATILDE,1,9,6,3,1
SONORA,26,PUERTO PEÑASCO,048,PUERTO PEÑASCO,77,18342,9257,9085,1059
SONORA,26,QUIRIEGO,049,BACHIMPA,1,2,0,2,1
SONORA,26,QUIRIEGO,049,BACUSA,2,27,16,11,2
SONORA,26,QUIRIEGO,049,BATACOSA,3,62,32,30,4
SONORA,26,QUIRIEGO,049,CÁBORA,3,99,54,45,6
SONORA,26,QUIRIEGO,049,EL FRIJOLAR,2,14,8,6,2
SONORA,26,QUIRIEGO,049,EL TANQUE,2,11,4,7,2
SONORA,26,QUIRIEGO,049,GENERAL PABLO MACÍAS (LOS VACITOS),1,5,4,1,1
SONORA,26,QUIRIEGO,049,GOIJAQUÍA,2,17,11,6,2
SONORA,26,QUIRIEGO,049,LOS BAJÍOS (EJIDO LOS CONEJOS),3,64,30,34,4
SONORA,26,QUIRIEGO,049,QUIRIEGO,4,428,216,212,21
SONORA,26,QUIRIEGO,049,TEPAHUI,3,56,21,35,3
SONORA,26,RAYÓN,050,LA PAZ (LA PAZ DE RAYÓN),1,15,9,6,1
SONORA,26,RAYÓN,050,RAYÓN,3,190,78,112,15
SONORA,26,RAYÓN,050,TRES ÁLAMOS,2,8,2,6,1
SONORA,26,ROSARIO,051,CEDROS,3,50,25,25,4
SONORA,26,ROSARIO,051,CUBA,3,40,16,24,4
SONORA,26,ROSARIO,051,EL SAUZ,1,8,4,4,1
SONORA,26,ROSARIO,051,LA DURA (LA CONCENTRACIÓN),1,4,3,1,1
SONORA,26,ROSARIO,051,LA ESTRELLA,3,46,22,24,4
SONORA,26,ROSARIO,051,LOS BAJÍOS (RANCHITOS DE LOS MORALES),1,4,2,2,1
SONORA,26,ROSARIO,051,NURI,3,62,32,30,4
SONORA,26,ROSARIO,051,PAREDONES,3,25,8,17,3
SONORA,26,ROSARIO,051,RÍO CHICO (REAL DE OSTIMURI),3,16,7,9,3
SONORA,26,ROSARIO,051,ROSARIO,9,757,363,394,44
SONORA,26,ROSARIO,051,TACUPETO,2,5,1,4,1
SONORA,26,ROSARIO,051,TARAHUMARIS,2,10,8,2,2
SONORA,26,SAHUARIPA,052,GUISAMOPA,1,6,4,2,1
SONORA,26,SAHUARIPA,052,MATARACHI,3,110,64,46,6
SONORA,26,SAHUARIPA,052,NATORA (SAN JOSÉ DE NATORA),3,17,6,11,2
SONORA,26,SAHUARIPA,052,SAHUARIPA,8,1040,495,545,54
SONORA,26,SAHUARIPA,052,SANTO TOMÁS,2,16,11,5,2
SONORA,26,SAHUARIPA,052,SEGUADEHUACHI,2,14,6,8,3
SONORA,26,SAHUARIPA,052,TRIGO DE CORODEPE,1,7,2,5,1
SONORA,26,SAHUARIPA,052,VALLE DE TACUPETO,3,47,24,23,4
SONORA,26,SAN FELIPE DE JESÚS,053,SAN FELIPE DE JESÚS,3,68,28,40,5
SONORA,26,SAN JAVIER,054,SAN JAVIER,3,92,46,46,7
SONORA,26,SAN LUIS RÍO COLORADO,055,EL BARROTE,2,83,43,40,4
SONORA,26,SAN LUIS RÍO COLORADO,055,EL FRONTERIZO,2,69,28,41,4
SONORA,26,SAN LUIS RÍO COLORADO,055,EMILIANO ZAPATA,1,59,24,35,3
SONORA,26,SAN LUIS RÍO COLORADO,055,GOLFO DE SANTA CLARA,5,1003,507,496,43
SONORA,26,SAN LUIS RÍO COLORADO,055,INDEPENDENCIA,2,219,110,109,9
SONORA,26,SAN LUIS RÍO COLORADO,055,INGENIERO LUIS B. SÁNCHEZ,6,1785,873,912,86
SONORA,26,SAN LUIS RÍO COLORADO,055,ISLITA,4,624,313,311,28
SONORA,26,SAN LUIS RÍO COLORADO,055,JUÁREZ LEYES DE REFORMA,1,4,1,3,1
SONORA,26,SAN LUIS RÍO COLORADO,055,LA GRULLITA,4,531,257,274,20
SONORA,26,SAN LUIS RÍO COLORADO,055,LAGUNITAS,4,385,192,193,16
SONORA,26,SAN LUIS RÍO COLORADO,055,MESA RICA,3,199,102,97,11
SONORA,26,SAN LUIS RÍO COLORADO,055,MONUMENTOS,2,40,22,18,2
SONORA,26,SAN LUIS RÍO COLORADO,055,NUEVO LEÓN,2,29,17,12,2
SONORA,26,SAN LUIS RÍO COLORADO,055,NUEVO MICHOACÁN (ESTACIÓN RIÍTO),3,423,198,225,21
SONORA,26,SAN LUIS RÍO COLORADO,055,POZAS DE ARVIZU (LA RESERVA),1,27,15,12,1
SONORA,26,SAN LUIS RÍO COLORADO,055,RÍO NORTE,2,110,51,59,6
SONORA,26,SAN LUIS RÍO COLORADO,055,SAN LUIS RÍO COLORADO,161,41596,20950,20646,2573
SONORA,26,SAN MIGUEL DE HORCASITAS,056,EL TORREÓN,1,10,4,6,1
SONORA,26,SAN MIGUEL DE HORCASITAS,056,LOS ÁNGELES (LA FÁBRICA DE LOS ÁNGELES),1,14,8,6,1
SONORA,26,SAN MIGUEL DE HORCASITAS,056,PESQUEIRA,11,2225,1113,1112,114
SONORA,26,SAN MIGUEL DE HORCASITAS,056,PUEBLO NUEVO,3,80,46,34,5
SONORA,26,SAN MIGUEL DE HORCASITAS,056,SAN MIGUEL DE HORCASITAS,3,63,33,30,5
SONORA,26,SAN PEDRO DE LA CUEVA,057,NUEVO TEPUPA,2,13,6,7,2
SONORA,26,SAN PEDRO DE LA CUEVA,057,SAN JOSÉ DE BATUC (BATUQUITO),2,25,12,13,3
SONORA,26,SAN PEDRO DE LA CUEVA,057,SAN PEDRO DE LA CUEVA,4,191,83,108,18
SONORA,26,SANTA ANA,058,EL CLARO,2,46,18,28,5
SONORA,26,SANTA ANA,058,EL PANTANITO,1,14,5,9,1
SONORA,26,SANTA ANA,058,ESTACIÓN LLANO,3,213,100,113,11
SONORA,26,SANTA ANA,058,LA CARLEÑA,1,9,5,4,1
SONORA,26,SANTA ANA,058,LA POLVADERA,2,16,5,11,2
SONORA,26,SANTA ANA,058,SANTA ANA,22,3576,1903,1673,223
SONORA,26,SANTA ANA,058,SANTA ANA VIEJO,2,142,71,71,8
SONORA,26,SANTA ANA,058,SANTA MARTHA,2,27,12,15,3
SONORA,26,SANTA ANA,058,SANTA RITA,2,177,81,96,8
SONORA,26,SANTA CRUZ,059,MIGUEL HIDALGO (SAN LÁZARO),6,202,105,97,13
SONORA,26,SANTA CRUZ,059,SANTA CRUZ,4,264,119,145,14
SONORA,26,SÁRIC,060,LOS CHIRRIONES,3,41,15,26,4
SONORA,26,SÁRIC,060,SÁRIC,3,137,63,74,8
SONORA,26,SÁRIC,060,SÁSABE,4,149,86,63,12
SONORA,26,SOYOPA,061,EL NOVILLO (CAMPAMENTO EL ÁGUILA),3,56,29,27,5
SONORA,26,SOYOPA,061,REBEICO,3,32,16,16,3
SONORA,26,SOYOPA,061,SAN ANTONIO DE LA HUERTA,3,69,29,40,5
SONORA,26,SOYOPA,061,SOYOPA,2,13,5,8,2
SONORA,26,SOYOPA,061,TÓNICHI,3,31,13,18,4
SONORA,26,SUAQUI GRANDE,062,SUAQUI GRANDE,4,258,119,139,16
SONORA,26,TEPACHE,063,TEPACHE,3,158,79,79,11
SONORA,26,TRINCHERAS,064,EL OCUCA,3,55,29,26,4
SONORA,26,TRINCHERAS,064,TRINCHERAS,4,222,118,104,13
SONORA,26,TUBUTAMA,065,LA REFORMA,2,15,6,9,2
SONORA,26,TUBUTAMA,065,LA SANGRE (LA SANGRE NUEVA),3,91,40,51,7
SONORA,26,TUBUTAMA,065,SAN MANUEL (SAN MANUEL OCUCA),3,47,15,32,4
SONORA,26,TUBUTAMA,065,TUBUTAMA,4,121,55,66,8
SONORA,26,URES,066,EL SAUZ (SAUZ DE URES),1,7,4,3,1
SONORA,26,URES,066,EL SEGURO,2,12,7,5,2
SONORA,26,URES,066,GUADALUPE (GUADALUPE DE URES),3,258,126,132,17
SONORA,26,URES,066,HEROICA CIUDAD DE URES,6,929,447,482,79
SONORA,26,URES,066,LA POZA,3,6,4,2,2
SONORA,26,URES,066,PUEBLO DE ÁLAMOS,3,63,28,35,5
SONORA,26,URES,066,PUERTA DEL SOL,3,22,12,10,3
SONORA,26,URES,066,RANCHO VIEJO,3,21,9,12,3
SONORA,26,URES,066,SAN PEDRO DE URES (SAN PEDRO),2,189,85,104,8
SONORA,26,URES,066,SAN RAFAEL,2,18,5,13,2
SONORA,26,URES,066,SANTIAGO DE URES (SANTIAGO),1,8,4,4,1
SONORA,26,VILLA HIDALGO,067,SAN JUAN DEL RÍO,3,30,12,18,4
SONORA,26,VILLA HIDALGO,067,VILLA HIDALGO,3,139,65,74,14
SONORA,26,VILLA PESQUEIRA,068,ADIVINO,2,27,6,21,3
SONORA,26,VILLA PESQUEIRA,068,NACORI GRANDE,2,12,4,8,2
SONORA,26,VILLA PESQUEIRA,068,VILLA PESQUEIRA (MÁTAPE),3,63,22,41,5
SONORA,26,YÉCORA,069,EL KIPUR,4,103,47,56,6
SONORA,26,YÉCORA,069,GUADALUPE DE TAYOPA,3,28,15,13,3
SONORA,26,YÉCORA,069,LA CONCEPCIÓN,2,8,1,7,2
SONORA,26,YÉCORA,069,LA QUEMA,3,14,4,10,2
SONORA,26,YÉCORA,069,MAYCOBA,5,181,85,96,12
SONORA,26,YÉCORA,069,MESA DEL CAMPANERO (MESA DE LOS FRAIJO),3,15,7,8,3
SONORA,26,YÉCORA,069,PIMAS (JUAN DIEGO DE LOS PIMAS),3,127,61,66,8
SONORA,26,YÉCORA,069,SANTA ANA,2,6,3,3,2
SONORA,26,YÉCORA,069,SANTA ROSA (SANTA ROSA DE LIMA),3,25,14,11,3
SONORA,26,YÉCORA,069,TEPOCA,3,11,2,9,3
SONORA,26,YÉCORA,069,YÉCORA,8,619,327,292,39
SONORA,26,GENERAL PLUTARCO ELÍAS CALLES,070,ADOLFO LÓPEZ MATEOS,3,53,30,23,4
SONORA,26,GENERAL PLUTARCO ELÍAS CALLES,070,EL DESIERTO DE SONORA,3,214,110,104,11
SONORA,26,GENERAL PLUTARCO ELÍAS CALLES,070,LA NARIZ,3,43,19,24,3
SONORA,26,GENERAL PLUTARCO ELÍAS CALLES,070,MORELIA,2,22,17,5,2
SONORA,26,GENERAL PLUTARCO ELÍAS CALLES,070,QUITOVAC,1,7,0,7,1
SONORA,26,GENERAL PLUTARCO ELÍAS CALLES,070,SONOYTA,17,3244,1627,1617,157
SONORA,26,GENERAL PLUTARCO ELÍAS CALLES,070,VALDEZ,3,38,20,18,3
SONORA,26,BENITO JUÁREZ,071,ACEITUNITAS (SUBE Y BAJA),2,105,52,53,6
SONORA,26,BENITO JUÁREZ,071,AGUA BLANCA,3,180,90,90,8
SONORA,26,BENITO JUÁREZ,071,BATEVITO (COLONIA IRRIGACIÓN),3,43,26,17,5
SONORA,26,BENITO JUÁREZ,071,JECOPACO,3,208,108,100,19
SONORA,26,BENITO JUÁREZ,071,PAREDÓN COLORADO (PAREDÓN VIEJO),5,728,365,363,45
SONORA,26,BENITO JUÁREZ,071,PAREDONCITO,7,521,266,255,27
SONORA,26,BENITO JUÁREZ,071,VILLA JUÁREZ,18,3686,1983,1703,263
SONORA,26,SAN IGNACIO RÍO MUERTO,072,BACHOMOBAMPO,3,37,18,19,3
SONORA,26,SAN IGNACIO RÍO MUERTO,072,BAHÍA DE LOBOS,8,884,432,452,42
SONORA,26,SAN IGNACIO RÍO MUERTO,072,DEMETRIO VALLEJO,1,5,3,2,1
SONORA,26,SAN IGNACIO RÍO MUERTO,072,EL BATEVE,3,50,26,24,4
SONORA,26,SAN IGNACIO RÍO MUERTO,072,EMILIANO ZAPATA,1,5,4,1,1
SONORA,26,SAN IGNACIO RÍO MUERTO,072,LA DEMOCRACIA,3,58,24,34,4
SONORA,26,SAN IGNACIO RÍO MUERTO,072,PUEBLO NUEVO (LA CUCHILLA),2,37,16,21,3
SONORA,26,SAN IGNACIO RÍO MUERTO,072,SAN IGNACIO RÍO MUERTO,13,1844,906,938,99
SONORA,26,SAN IGNACIO RÍO MUERTO,072,SAN ISIDRO (EL POLVORÓN),3,65,29,36,4
SONORA,26,SAN IGNACIO RÍO MUERTO,072,SINGAPUR,3,62,28,34,4
SONORA,26,SAN IGNACIO RÍO MUERTO,072,TETABIATE,4,160,73,87,7
TABASCO,27,BALANCÁN,001,ADOLFO LÓPEZ MATEOS,2,40,26,14,2
TABASCO,27,BALANCÁN,001,AGRICULTORES DEL NORTE 1RA. SECCIÓN,3,74,39,35,5
TABASCO,27,BALANCÁN,001,AGRICULTORES DEL NORTE 2DA. SECCIÓN,2,15,8,7,2
TABASCO,27,BALANCÁN,001,APATZINGÁN,4,447,214,233,19
TABASCO,27,BALANCÁN,001,ARROYO EL TRIUNFO 1RA. SECCIÓN,3,256,123,133,11
TABASCO,27,BALANCÁN,001,ARROYO EL TRIUNFO 2DA. SECCIÓN,2,60,28,32,3
TABASCO,27,BALANCÁN,001,ASUNCIÓN,2,23,11,12,2
TABASCO,27,BALANCÁN,001,BALANCÁN,22,6157,3090,3067,360
TABASCO,27,BALANCÁN,001,BUENAVISTA,2,14,7,7,2
TABASCO,27,BALANCÁN,001,BUENAVISTA VEINTITRÉS,3,142,73,69,6
TABASCO,27,BALANCÁN,001,CAPITÁN FELIPE CASTELLANOS DÍAZ (SAN PEDRO),6,518,258,260,24
TABASCO,27,BALANCÁN,001,CARLOS A. MADRAZO BECERRA,3,59,34,25,4
TABASCO,27,BALANCÁN,001,CAUDILLOS DEL SUR,3,43,27,16,3
TABASCO,27,BALANCÁN,001,CHACABITA,3,20,6,14,3
TABASCO,27,BALANCÁN,001,CIBAL DE LA GLORIA,3,35,19,16,3
TABASCO,27,BALANCÁN,001,CONSTITUCIÓN,3,186,84,102,8
TABASCO,27,BALANCÁN,001,CUYOS DE CAOBA,3,113,64,49,5
TABASCO,27,BALANCÁN,001,EL ÁGUILA,4,345,163,182,17
TABASCO,27,BALANCÁN,001,EL BARÍ,2,30,16,14,3
TABASCO,27,BALANCÁN,001,EL BILÍN,2,11,7,4,2
TABASCO,27,BALANCÁN,001,EL CAPULÍN,4,259,134,125,13
TABASCO,27,BALANCÁN,001,EL CHAMIZAL,3,145,73,72,7
TABASCO,27,BALANCÁN,001,EL CIBALITO,2,99,60,39,5
TABASCO,27,BALANCÁN,001,EL FAUSTINO,3,31,13,18,3
TABASCO,27,BALANCÁN,001,EL LIMÓN,3,107,53,54,6
TABASCO,27,BALANCÁN,001,EL MICAL,5,420,205,215,18
TABASCO,27,BALANCÁN,001,EL NARANJITO,3,101,51,50,6
TABASCO,27,BALANCÁN,001,EL PICHI,3,183,93,90,9
TABASCO,27,BALANCÁN,001,EL PÍPILA,3,110,46,64,6
TABASCO,27,BALANCÁN,001,EL RAMONAL,3,140,78,62,7
TABASCO,27,BALANCÁN,001,EL SILENCIO,2,24,10,14,2
TABASCO,27,BALANCÁN,001,EL TRIUNFO,7,1655,785,870,70
TABASCO,27,BALANCÁN,001,EMILIANO ZAPATA SALAZAR,3,37,20,17,4
TABASCO,27,BALANCÁN,001,FRANCISCO I. MADERO 1RA. SECCIÓN,3,148,75,73,6
TABASCO,27,BALANCÁN,001,FRANCISCO I. MADERO 2DA. SECCIÓN,2,56,27,29,3
TABASCO,27,BALANCÁN,001,FRANCISCO VILLA,3,135,69,66,6
TABASCO,27,BALANCÁN,001,GENERAL LUIS FELIPE DOMÍNGUEZ SUÁREZ,3,244,114,130,12
TABASCO,27,BALANCÁN,001,GUAJIMALPA 2DA. SECCIÓN,1,11,6,5,1
TABASCO,27,BALANCÁN,001,INGENIERO MARIO CALCÁNEO SÁNCHEZ,3,88,44,44,4
TABASCO,27,BALANCÁN,001,ISLA MISSICAB,2,24,11,13,2
TABASCO,27,BALANCÁN,001,ISLA SEBASTOPOL,3,23,13,10,2
TABASCO,27,BALANCÁN,001,JAHUACTAL,3,30,8,22,4
TABASCO,27,BALANCÁN,001,JERUSALÉM - BELÉN,2,64,33,31,3
TABASCO,27,BALANCÁN,001,JOLOCHERO,4,287,141,146,15
TABASCO,27,BALANCÁN,001,JOSÉ NARCISO ROVIROSA,1,6,2,4,1
TABASCO,27,BALANCÁN,001,LA CUCHILLA,4,173,88,85,10
TABASCO,27,BALANCÁN,001,LA HULERÍA,4,286,135,151,16
TABASCO,27,BALANCÁN,001,LA REVANCHA,2,36,21,15,2
TABASCO,27,BALANCÁN,001,LA TRINIDAD,1,4,2,2,1
TABASCO,27,BALANCÁN,001,LAGUNA COLORADA,2,16,7,9,2
TABASCO,27,BALANCÁN,001,LAS CUMBRES,2,5,3,2,1
TABASCO,27,BALANCÁN,001,LAS TABLAS,3,13,4,9,3
TABASCO,27,BALANCÁN,001,LAS TARIMAS,2,43,17,26,3
TABASCO,27,BALANCÁN,001,LEONA VICARIO,6,174,97,77,11
TABASCO,27,BALANCÁN,001,LICENCIADO GUSTAVO DÍAZ ORDAZ,3,22,10,12,3
TABASCO,27,BALANCÁN,001,LOS CENOTES,4,432,211,221,18
TABASCO,27,BALANCÁN,001,MACTÚN,3,219,93,126,10
TABASCO,27,BALANCÁN,001,MIGUEL HIDALGO 2DA. SECCIÓN,1,11,5,6,1
TABASCO,27,BALANCÁN,001,MIGUEL HIDALGO SACAOLAS,3,134,65,69,7
TABASCO,27,BALANCÁN,001,MIGUEL HIDALGO Y COSTILLA,3,128,63,65,6
TABASCO,27,BALANCÁN,001,MISSICAB,3,61,32,29,4
TABASCO,27,BALANCÁN,001,MISSICAB (LA PITA),4,249,127,122,12
TABASCO,27,BALANCÁN,001,MULTÉ,3,293,152,141,12
TABASCO,27,BALANCÁN,001,NETZAHUALCÓYOTL (SANTA ANA),4,480,223,257,24
TABASCO,27,BALANCÁN,001,NICOLÁS BRAVO (SAN NICOLÁS),2,41,21,20,3
TABASCO,27,BALANCÁN,001,OJO DE AGUA,3,183,92,91,8
TABASCO,27,BALANCÁN,001,PAN DURO,2,23,10,13,2
TABASCO,27,BALANCÁN,001,PARAÍSO (EL TINTO),3,163,87,76,9
TABASCO,27,BALANCÁN,001,PLAN DE GUADALUPE,2,9,5,4,2
TABASCO,27,BALANCÁN,001,PLAN DE GUADALUPE SECCIÓN CENTRAL,3,69,33,36,5
TABASCO,27,BALANCÁN,001,PRESIDENTE ADOLFO LÓPEZ MATEOS,3,163,69,94,8
TABASCO,27,BALANCÁN,001,QUETZALCÓATL (CUATRO POBLADOS),3,559,284,275,42
TABASCO,27,BALANCÁN,001,REFORMA (PROVINCIA),3,137,81,56,6
TABASCO,27,BALANCÁN,001,SAN ELPIDIO (BANCO DE GRAVA),1,35,16,19,1
TABASCO,27,BALANCÁN,001,SAN JOAQUÍN 1RA. SECCIÓN,3,42,15,27,3
TABASCO,27,BALANCÁN,001,SAN JOSÉ,1,6,1,5,1
TABASCO,27,BALANCÁN,001,SAN JUAN,3,107,59,48,7
TABASCO,27,BALANCÁN,001,SANTA CRUZ,6,226,116,110,13
TABASCO,27,BALANCÁN,001,TARIMAS (EMILIANO ZAPATA),4,171,84,87,9
TABASCO,27,BALANCÁN,001,TIERRA Y LIBERTAD,3,36,18,18,4
TABASCO,27,BALANCÁN,001,ÚLTIMO ESFUERZO,1,19,8,11,1
TABASCO,27,BALANCÁN,001,UQUINA Y LA LOMA,1,18,9,9,1
TABASCO,27,BALANCÁN,001,VICENTE GUERRERO,4,218,98,120,12
TABASCO,27,BALANCÁN,001,VICENTE GUERRERO SECCIÓN CUBA,1,3,1,2,1
TABASCO,27,BALANCÁN,001,VICENTE LOMBARDO TOLEDANO,3,85,36,49,4
TABASCO,27,CÁRDENAS,002,5 DE MAYO,2,46,22,24,3
TABASCO,27,CÁRDENAS,002,ARROYO HONDO (SAN ROSENDO),2,39,16,23,3
TABASCO,27,CÁRDENAS,002,ARROYO HONDO 1RA. SECCIÓN (SANTA TERESA A),3,583,268,315,19
TABASCO,27,CÁRDENAS,002,ARROYO HONDO 2DA. SECCIÓN SANTA TERESA B,3,417,208,209,15
TABASCO,27,CÁRDENAS,002,ARROYO HONDO ABEJONAL,3,422,185,237,16
TABASCO,27,CÁRDENAS,002,AZUCENA 1RA. SECCIÓN,2,133,65,68,6
TABASCO,27,CÁRDENAS,002,AZUCENA 2DA. SECCIÓN,6,1198,618,580,43
TABASCO,27,CÁRDENAS,002,AZUCENA 3RA. SECCIÓN (EL TRIUNFO),4,342,171,171,13
TABASCO,27,CÁRDENAS,002,AZUCENA 4TA. SECCIÓN (TORNO ALEGRE),4,443,236,207,19
TABASCO,27,CÁRDENAS,002,AZUCENA 5TA. SECCIÓN (EL APOMPAL),2,124,66,58,5
TABASCO,27,CÁRDENAS,002,AZUCENA 6TA. SECCIÓN,2,57,29,28,3
TABASCO,27,CÁRDENAS,002,AZUCENA 7MA. SECCIÓN (EL LECHUGAL),2,86,34,52,4
TABASCO,27,CÁRDENAS,002,AZUCENITA 1RA. SECCIÓN B,2,134,78,56,6
TABASCO,27,CÁRDENAS,002,BAJÍO 1RA. SECCIÓN A (PERIFÉRICO SUR),1,16,7,9,1
TABASCO,27,CÁRDENAS,002,BENITO JUÁREZ (CAMPO MAGALLANES),7,1553,759,794,61
TABASCO,27,CÁRDENAS,002,BUENAVISTA 1RA. SECCIÓN,3,179,94,85,8
TABASCO,27,CÁRDENAS,002,BUENAVISTA 2DA. SECCIÓN,2,44,20,24,3
TABASCO,27,CÁRDENAS,002,CALZADA 1RA. SECCIÓN NORTE A,4,381,191,190,17
TABASCO,27,CÁRDENAS,002,CALZADA 1RA. SECCIÓN SUR,1,64,34,30,3
TABASCO,27,CÁRDENAS,002,CALZADA 2DA. SECCIÓN,3,458,230,228,17
TABASCO,27,CÁRDENAS,002,CAMPO NUEVO,3,93,48,45,6
TABASCO,27,CÁRDENAS,002,CÁRDENAS,113,28483,14255,14228,1800
TABASCO,27,CÁRDENAS,002,CÁRDENAS 2DA. SECCIÓN,2,56,22,34,3
TABASCO,27,CÁRDENAS,002,CARLOS ALBERTO WILSON GÓMEZ,3,201,91,110,9
TABASCO,27,CÁRDENAS,002,CELIA GONZÁLEZ DE ROVIROSA,2,103,38,65,5
TABASCO,27,CÁRDENAS,002,CHICOZAPOTE 1RA. SECCIÓN,3,155,70,85,8
TABASCO,27,CÁRDENAS,002,CHICOZAPOTE 2DA. SECCIÓN (EL RETIRO),3,262,135,127,11
TABASCO,27,CÁRDENAS,002,CONGREGACIÓN REYES HEROLES,2,96,45,51,4
TABASCO,27,CÁRDENAS,002,CORONEL ANDRÉS SÁNCHEZ MAGALLANES,8,1540,763,777,64
TABASCO,27,CÁRDENAS,002,CUAUHTÉMOC (W-65),2,22,12,10,2
TABASCO,27,CÁRDENAS,002,CUAUHTEMOCZÍN,4,380,171,209,17
TABASCO,27,CÁRDENAS,002,CUAUHTEMOCZÍN 2DA. SECCIÓN,2,25,9,16,2
TABASCO,27,CÁRDENAS,002,DE LOS SANTOS,2,228,131,97,9
TABASCO,27,CÁRDENAS,002,EL ALACRÁN,3,159,73,86,9
TABASCO,27,CÁRDENAS,002,EL ALACRÁN (MANATINERO),2,101,52,49,4
TABASCO,27,CÁRDENAS,002,EL BAJÍO 1RA. SECCIÓN,5,1714,824,890,160
TABASCO,27,CÁRDENAS,002,EL BAJÍO 2DA. SECCIÓN,2,302,143,159,10
TABASCO,27,CÁRDENAS,002,EL BARÍ 1RA. SECCIÓN,3,165,89,76,7
TABASCO,27,CÁRDENAS,002,EL BRONCE,2,42,26,16,3
TABASCO,27,CÁRDENAS,002,EL CAPRICHO,3,25,15,10,2
TABASCO,27,CÁRDENAS,002,EL CARMEN,2,21,12,9,2
TABASCO,27,CÁRDENAS,002,EL CHOCHO (BOCA DEL RÍO),3,75,34,41,4
TABASCO,27,CÁRDENAS,002,EL GOLPE,5,519,237,282,20
TABASCO,27,CÁRDENAS,002,EL JOBO (PUNTA BRAVA),2,45,27,18,3
TABASCO,27,CÁRDENAS,002,EL MINGO,2,65,25,40,3
TABASCO,27,CÁRDENAS,002,EL PARNASO,2,119,58,61,5
TABASCO,27,CÁRDENAS,002,EL PORVENIR,3,174,88,86,8
TABASCO,27,CÁRDENAS,002,EL YUCATECO (PAYLEBOT 2DA. SECCIÓN),3,177,94,83,8
TABASCO,27,CÁRDENAS,002,ENCRUCIJADA 1RA. SECCIÓN RINCÓN BRUJO,3,134,67,67,6
TABASCO,27,CÁRDENAS,002,ENCRUCIJADA 2DA. SECCIÓN (LOS GARCÍA),2,103,48,55,4
TABASCO,27,CÁRDENAS,002,ENCRUCIJADA 3RA. SECCIÓN (LAS CALZADAS),4,904,431,473,59
TABASCO,27,CÁRDENAS,002,ENCRUCIJADA 4TA. SECCIÓN A,1,13,5,8,1
TABASCO,27,CÁRDENAS,002,ENCRUCIJADA 4TA. SECCIÓN B (LA LUCHA),3,195,96,99,8
TABASCO,27,CÁRDENAS,002,ENCRUCIJADA 5TA. SECCIÓN,4,386,192,194,15
TABASCO,27,CÁRDENAS,002,FRANCISCO TRUJILLO GURRÍA,2,104,49,55,4
TABASCO,27,CÁRDENAS,002,GENERAL FRANCISCO VILLA,2,76,38,38,3
TABASCO,27,CÁRDENAS,002,HABANERO 1RA. SECCIÓN,3,133,66,67,6
TABASCO,27,CÁRDENAS,002,HABANERO 1RA. SECCIÓN (VENUSTIANO CARRANZA),3,412,188,224,17
TABASCO,27,CÁRDENAS,002,HABANERO 2DA. SECCIÓN (EL CASTAÑO),2,54,32,22,3
TABASCO,27,CÁRDENAS,002,IGNACIO GUTIÉRREZ GÓMEZ (SAN FELIPE),5,1308,643,665,70
TABASCO,27,CÁRDENAS,002,IGNACIO ZARAGOZA,1,19,10,9,1
TABASCO,27,CÁRDENAS,002,INGENIO PRESIDENTE BENITO JUÁREZ,4,701,372,329,35
TABASCO,27,CÁRDENAS,002,ISLAS ENCANTADAS 1RA. SECCIÓN (EL ZAPOTE),2,96,53,43,4
TABASCO,27,CÁRDENAS,002,JUAN ESCUTIA,2,28,19,9,3
TABASCO,27,CÁRDENAS,002,JULIÁN MONTEJO VELÁZQUEZ,2,27,14,13,2
TABASCO,27,CÁRDENAS,002,LA PENÍNSULA,3,501,250,251,20
TABASCO,27,CÁRDENAS,002,LAS CALZADAS,1,12,6,6,1
TABASCO,27,CÁRDENAS,002,LAS COLORADAS 1RA. SECCIÓN,2,58,37,21,4
TABASCO,27,CÁRDENAS,002,LAS COLORADAS 2DA. SECCIÓN (AMPLIACIÓN LAS ALDEAS),3,246,119,127,10
TABASCO,27,CÁRDENAS,002,LAS COLORADAS 2DA. SECCIÓN B,2,25,13,12,2
TABASCO,27,CÁRDENAS,002,LAS ESPERANZAS,3,60,29,31,4
TABASCO,27,CÁRDENAS,002,LAS FLORES (LA PALMA),2,76,45,31,3
TABASCO,27,CÁRDENAS,002,LAS LIMAS,1,17,7,10,1
TABASCO,27,CÁRDENAS,002,LAS NUEVAS ESPERANZAS,3,115,59,56,6
TABASCO,27,CÁRDENAS,002,LEY FEDERAL DE LA REFORMA AGRARIA (SAN RAMÓN),2,73,38,35,3
TABASCO,27,CÁRDENAS,002,LUIS DONALDO COLOSIO MURRIETA,2,86,44,42,4
TABASCO,27,CÁRDENAS,002,MELCHOR OCAMPO,3,372,195,177,16
TABASCO,27,CÁRDENAS,002,MIGUEL HIDALGO 1RA. SECCIÓN,3,402,167,235,33
TABASCO,27,CÁRDENAS,002,MIGUEL HIDALGO 2DA. SECCIÓN A (EL EDÉN),2,1404,712,692,57
TABASCO,27,CÁRDENAS,002,MIGUEL HIDALGO 2DA. SECCIÓN B (LA NATIVIDAD),2,320,158,162,13
TABASCO,27,CÁRDENAS,002,MIGUEL HIDALGO ZAPOTAL 2DA. SECCIÓN,2,91,43,48,3
TABASCO,27,CÁRDENAS,002,NARANJEÑO 1RA. SECCIÓN (COLONIA LA FE),2,66,28,38,4
TABASCO,27,CÁRDENAS,002,NARANJEÑO 2DA. SECCIÓN A,3,175,80,95,7
TABASCO,27,CÁRDENAS,002,NARANJEÑO 2DA. SECCIÓN B,2,112,55,57,5
TABASCO,27,CÁRDENAS,002,NARANJEÑO 3RA. SECCIÓN,2,101,45,56,4
TABASCO,27,CÁRDENAS,002,NUEVA ESPERANZA,3,280,138,142,11
TABASCO,27,CÁRDENAS,002,NUEVA ZELANDIA (EL INGENIO),2,7,2,5,2
TABASCO,27,CÁRDENAS,002,OJOSHAL,3,83,43,40,4
TABASCO,27,CÁRDENAS,002,PASO Y PLAYA,3,578,286,292,21
TABASCO,27,CÁRDENAS,002,PAYLEBOT,3,184,88,96,9
TABASCO,27,CÁRDENAS,002,PEDRO SÁNCHEZ MAGALLANES,3,536,290,246,55
TABASCO,27,CÁRDENAS,002,POBLADO C-09 LICENCIADO FRANCISCO I. MADERO,5,1233,591,642,50
TABASCO,27,CÁRDENAS,002,POBLADO C-10 GENERAL LÁZARO CÁRDENAS DEL RÍO,5,1198,603,595,71
TABASCO,27,CÁRDENAS,002,POBLADO C-11 JOSÉ MARÍA MORELOS Y PAVÓN,4,751,372,379,28
TABASCO,27,CÁRDENAS,002,POBLADO C-14 GENERAL PLUTARCO ELÍAS CALLES,3,536,239,297,23
TABASCO,27,CÁRDENAS,002,POBLADO C-15 ADOLFO LÓPEZ MATEOS,4,661,355,306,26
TABASCO,27,CÁRDENAS,002,POBLADO C-16 GENERAL EMILIANO ZAPATA,4,1010,483,527,35
TABASCO,27,CÁRDENAS,002,POBLADO C-17 INDEPENDENCIA,5,942,439,503,37
TABASCO,27,CÁRDENAS,002,POBLADO C-20 MIGUEL HIDALGO Y COSTILLA,4,783,401,382,27
TABASCO,27,CÁRDENAS,002,POBLADO C-21 LICENCIADO BENITO JUÁREZ GARCÍA,3,572,278,294,25
TABASCO,27,CÁRDENAS,002,POBLADO C-22 LICENCIADO JOSÉ MARÍA PINO SUÁREZ,4,828,397,431,32
TABASCO,27,CÁRDENAS,002,POBLADO C-22 LICENCIADO JOSÉ MARÍA PINO SUÁREZ UNO,1,397,209,188,55
TABASCO,27,CÁRDENAS,002,POBLADO C-23 GENERAL VENUSTIANO CARRANZA,3,608,331,277,23
TABASCO,27,CÁRDENAS,002,POBLADO C-27 INGENIERO EDUARDO CHÁVEZ RAMÍREZ,2,416,220,196,17
TABASCO,27,CÁRDENAS,002,POBLADO C-28 CORONEL GREGORIO MÉNDEZ MAGAÑA,6,2277,1121,1156,84
TABASCO,27,CÁRDENAS,002,POBLADO C-29 GENERAL VICENTE GUERRERO,4,1225,601,624,76
TABASCO,27,CÁRDENAS,002,POBLADO C-33 20 DE NOVIEMBRE,3,665,329,336,22
TABASCO,27,CÁRDENAS,002,POZA REDONDA 1RA. SECCIÓN,6,257,119,138,12
TABASCO,27,CÁRDENAS,002,POZA REDONDA 2DA. SECCIÓN,3,249,129,120,9
TABASCO,27,CÁRDENAS,002,POZA REDONDA 3RA. SECCIÓN,2,124,68,56,5
TABASCO,27,CÁRDENAS,002,RÍO SECO 1RA. SECCIÓN,1,307,146,161,35
TABASCO,27,CÁRDENAS,002,RÍO SECO 2DA. SECCIÓN (NORTE 10),2,57,30,27,3
TABASCO,27,CÁRDENAS,002,RÍO SECO 2DA. SECCIÓN A,1,50,21,29,2
TABASCO,27,CÁRDENAS,002,RÍO SECO 2DA. SECCIÓN B,2,231,113,118,8
TABASCO,27,CÁRDENAS,002,RÍO SECO 2DA. SECCIÓN C,1,20,8,12,1
TABASCO,27,CÁRDENAS,002,RUBÉN JARAMILLO LAZO,2,100,51,49,4
TABASCO,27,CÁRDENAS,002,SAN PEDRO,2,9,5,4,2
TABASCO,27,CÁRDENAS,002,SAN RAFAEL,2,45,24,21,3
TABASCO,27,CÁRDENAS,002,SANTA ISIDRA,3,44,22,22,5
TABASCO,27,CÁRDENAS,002,SANTA ROSALÍA (MIGUEL HIDALGO 2DA. SECCIÓN),5,915,451,464,35
TABASCO,27,CÁRDENAS,002,SANTANA 1RA. SECCIÓN A,3,579,270,309,21
TABASCO,27,CÁRDENAS,002,SANTANA 1RA. SECCIÓN B,1,21,10,11,1
TABASCO,27,CÁRDENAS,002,SANTANA 2DA. SECCIÓN A,4,425,213,212,17
TABASCO,27,CÁRDENAS,002,SANTANA 2DA. SECCIÓN B (LA PALMA),3,424,218,206,17
TABASCO,27,CÁRDENAS,002,SANTANA 2DA. SECCIÓN C,2,59,24,35,3
TABASCO,27,CÁRDENAS,002,SANTANA 3RA. SECCIÓN A (EL FILERO),2,98,49,49,4
TABASCO,27,CÁRDENAS,002,SANTANA 3RA. SECCIÓN B,1,6,4,2,1
TABASCO,27,CÁRDENAS,002,SANTANA 4TA. SECCIÓN,2,119,47,72,5
TABASCO,27,CÁRDENAS,002,SANTANA 5TA. SECCIÓN (EL ESPINO),2,102,49,53,4
TABASCO,27,CÁRDENAS,002,SANTUARIO 1RA. SECCIÓN,4,336,177,159,13
TABASCO,27,CÁRDENAS,002,SANTUARIO 2DA. SECCIÓN,3,618,312,306,23
TABASCO,27,CÁRDENAS,002,SANTUARIO 3RA. SECCIÓN (PIEDRAS NEGRAS),2,170,82,88,7
TABASCO,27,CÁRDENAS,002,SANTUARIO 4TA. SECCIÓN,2,52,25,27,3
TABASCO,27,CÁRDENAS,002,SANTUARIO 5TA. SECCIÓN BUENA VISTA,1,47,20,27,2
TABASCO,27,CÁRDENAS,002,SINALOA 1RA. SECCIÓN,2,128,63,65,6
TABASCO,27,CÁRDENAS,002,SINALOA 2DA. SECCIÓN (ARJONA),2,96,49,47,4
TABASCO,27,CÁRDENAS,002,TÍO MONCHO,2,32,16,16,3
TABASCO,27,CÁRDENAS,002,ZAPOTAL 1RA. SECCIÓN,2,101,48,53,5
TABASCO,27,CÁRDENAS,002,ZAPOTAL 2DA. SECCIÓN,2,111,53,58,5
TABASCO,27,CÁRDENAS,002,ZAPOTAL 3RA. SECCIÓN,3,416,213,203,18
TABASCO,27,CENTLA,003,ADOLFO LÓPEZ MATEOS,4,610,307,303,62
TABASCO,27,CENTLA,003,ÁLVARO OBREGÓN (SANTA CRUZ),4,675,323,352,24
TABASCO,27,CENTLA,003,ÁLVARO OBREGÓN 2DA. SECCIÓN (EL LECHUGAL),1,91,53,38,4
TABASCO,27,CENTLA,003,ARROYO POLO 2DA. SECCIÓN,3,245,130,115,9
TABASCO,27,CENTLA,003,ARROYO POLO 3RA. SECCIÓN,2,48,18,30,3
TABASCO,27,CENTLA,003,AUGUSTO GÓMEZ VILLANUEVA,2,6,4,2,1
TABASCO,27,CENTLA,003,BARRA DE SAN PEDRO,3,160,76,84,8
TABASCO,27,CENTLA,003,BENITO JUÁREZ,7,956,479,477,37
TABASCO,27,CENTLA,003,BOCA DE CHILAPA,4,479,222,257,17
TABASCO,27,CENTLA,003,BOCA DE PANTOJA,3,172,85,87,8
TABASCO,27,CENTLA,003,BOCA GRANDE 1RA. SECCIÓN,3,14,7,7,2
TABASCO,27,CENTLA,003,BOCA GRANDE 2DA. SECCIÓN (PAQUILLALITO),3,16,8,8,2
TABASCO,27,CENTLA,003,BUENA VISTA,3,184,101,83,9
TABASCO,27,CENTLA,003,CAÑAVERAL,2,60,25,35,3
TABASCO,27,CENTLA,003,CAÑAVERAL CORCOVADO,3,28,11,17,3
TABASCO,27,CENTLA,003,CAPARROSO,4,399,196,203,15
TABASCO,27,CENTLA,003,CARLOS A. MADRAZO,3,166,75,91,9
TABASCO,27,CENTLA,003,CARLOS ROVIROSA 1RA. SECCIÓN,2,140,73,67,5
TABASCO,27,CENTLA,003,CARLOS ROVIROSA 2DA. SECCIÓN,3,52,26,26,3
TABASCO,27,CENTLA,003,CHICHICASTLE 1RA. SECCIÓN,8,474,238,236,20
TABASCO,27,CENTLA,003,CHICHICASTLE 2DA. SECCIÓN,3,81,42,39,5
TABASCO,27,CENTLA,003,CHICHICASTLE 3RA. SECCIÓN,2,7,3,4,1
TABASCO,27,CENTLA,003,CHICOZAPOTE 1RA. SECCIÓN,2,6,2,4,1
TABASCO,27,CENTLA,003,CHICOZAPOTE 2DA. SECCIÓN,2,131,62,69,5
TABASCO,27,CENTLA,003,CHILAPA 1RA. SECCIÓN (MARGEN DERECHA),3,31,12,19,3
TABASCO,27,CENTLA,003,CHILAPA 1RA. SECCIÓN (MARGEN IZQUIERDA),2,110,57,53,5
TABASCO,27,CENTLA,003,CHILAPA 2DA. SECCIÓN,2,63,33,30,3
TABASCO,27,CENTLA,003,CHILAPA 2DA. SECCIÓN (CAÑAVERALITO),3,16,7,9,2
TABASCO,27,CENTLA,003,CONSTANCIA Y VENECIA,5,620,301,319,46
TABASCO,27,CENTLA,003,CUAUHTÉMOC,5,969,476,493,43
TABASCO,27,CENTLA,003,EL BELLOTE,4,374,168,206,16
TABASCO,27,CENTLA,003,EL BOSQUE,3,27,12,15,3
TABASCO,27,CENTLA,003,EL CARMEN 1RA. SECCIÓN,2,50,24,26,3
TABASCO,27,CENTLA,003,EL CARMEN 2DA. SECCIÓN,2,42,19,23,2
TABASCO,27,CENTLA,003,EL FAISÁN,2,47,25,22,3
TABASCO,27,CENTLA,003,EL GUAJUCO,3,124,60,64,6
TABASCO,27,CENTLA,003,EL LIMÓN (DE VICENTE GUERRERO),3,123,65,58,6
TABASCO,27,CENTLA,003,EL LIMÓN DE SIMÓN SARLAT,2,17,8,9,2
TABASCO,27,CENTLA,003,EL PALMAR,2,23,14,9,2
TABASCO,27,CENTLA,003,EL PORVENIR,2,48,26,22,3
TABASCO,27,CENTLA,003,EL PORVENIR (DE QUINTÍN ARAUZ),2,8,5,3,1
TABASCO,27,CENTLA,003,EL TRIUNFO,2,4,3,1,1
TABASCO,27,CENTLA,003,EL VERGEL DE ALLENDE,1,12,9,3,1
TABASCO,27,CENTLA,003,EMILIANO ZAPATA,2,40,22,18,2
TABASCO,27,CENTLA,003,ESCOBAS (CHILAPA ESCOBA),3,119,54,65,7
TABASCO,27,CENTLA,003,FELIPE CARRILLO PUERTO (CENTRO),3,399,201,198,15
TABASCO,27,CENTLA,003,FELIPE CARRILLO PUERTO NORTE (CARRILLITO),2,89,50,39,4
TABASCO,27,CENTLA,003,FELIPE CARRILLO PUERTO SUR (CARRILLÓN),2,120,63,57,6
TABASCO,27,CENTLA,003,FRANCISCO I. MADERO,7,935,485,450,38
TABASCO,27,CENTLA,003,FRANCISCO VILLA,3,129,57,72,8
TABASCO,27,CENTLA,003,FRANCISCO VILLA (GUANO SOLO),2,99,51,48,5
TABASCO,27,CENTLA,003,FRONTERA,33,10276,5099,5177,726
TABASCO,27,CENTLA,003,FRONTERITA,4,382,167,215,18
TABASCO,27,CENTLA,003,GARCÍA,1,13,7,6,1
TABASCO,27,CENTLA,003,GOBERNADOR CRUZ,3,542,276,266,19
TABASCO,27,CENTLA,003,GREGORIO MÉNDEZ MAGAÑA,4,376,191,185,17
TABASCO,27,CENTLA,003,HABLAN LOS HECHOS (SANTA ROSA),2,17,9,8,2
TABASCO,27,CENTLA,003,IGNACIO ALLENDE,6,1911,832,1079,96
TABASCO,27,CENTLA,003,IGNACIO ZARAGOZA,3,646,283,363,26
TABASCO,27,CENTLA,003,JALAPITA,3,210,99,111,11
TABASCO,27,CENTLA,003,JOSÉ MARÍA MORELOS Y PAVÓN,2,95,51,44,5
TABASCO,27,CENTLA,003,JOSÉ MARÍA MORELOS Y PAVÓN (TINTALILLO),2,17,9,8,2
TABASCO,27,CENTLA,003,LA ESTRELLA,3,266,128,138,12
TABASCO,27,CENTLA,003,LA MONTAÑA,3,72,39,33,4
TABASCO,27,CENTLA,003,LA PIMIENTA,3,187,89,98,10
TABASCO,27,CENTLA,003,LA SÁBANA,4,479,240,239,23
TABASCO,27,CENTLA,003,LA UNIÓN,2,147,68,79,6
TABASCO,27,CENTLA,003,LA VICTORIA,3,314,160,154,14
TABASCO,27,CENTLA,003,LAS PALMAS,2,18,5,13,2
TABASCO,27,CENTLA,003,LAS PORFÍAS,2,39,15,24,2
TABASCO,27,CENTLA,003,LAS TIJERAS,2,58,28,30,4
TABASCO,27,CENTLA,003,LÁZARO CÁRDENAS,3,287,129,158,12
TABASCO,27,CENTLA,003,LÁZARO CÁRDENAS (EL GUAO),3,9,5,4,2
TABASCO,27,CENTLA,003,LEANDRO ROVIROSA WADE 1RA. SECCIÓN,3,96,48,48,4
TABASCO,27,CENTLA,003,LEANDRO ROVIROSA WADE 2DA. SECCIÓN,3,218,107,111,10
TABASCO,27,CENTLA,003,LIBERTAD DE ALLENDE,5,270,134,136,12
TABASCO,27,CENTLA,003,LOS ÍDOLOS (MARGEN DERECHA),1,42,25,17,2
TABASCO,27,CENTLA,003,LOS ÍDOLOS MARGEN IZQUIERDA,1,58,25,33,2
TABASCO,27,CENTLA,003,LUIS ECHEVERRÍA ÁLVAREZ,2,20,7,13,2
TABASCO,27,CENTLA,003,MIGUEL HIDALGO,2,10,3,7,2
TABASCO,27,CENTLA,003,MIGUEL HIDALGO 1RA. SECCIÓN,3,153,87,66,9
TABASCO,27,CENTLA,003,MIGUEL HIDALGO 2DA. SECCIÓN,3,168,99,69,9
TABASCO,27,CENTLA,003,MIXTECA 1RA. SECCIÓN,2,8,4,4,1
TABASCO,27,CENTLA,003,MIXTECA 2DA. SECCIÓN,4,125,66,59,8
TABASCO,27,CENTLA,003,MIXTECA 3RA. SECCIÓN,3,50,25,25,4
TABASCO,27,CENTLA,003,NIÑOS HÉROES,3,116,52,64,6
TABASCO,27,CENTLA,003,NUEVA ESPERANZA (SAN PEDRITO),2,39,18,21,3
TABASCO,27,CENTLA,003,NUEVA ESPERANZA DE QUINTÍN ARÁUZ,1,21,12,9,1
TABASCO,27,CENTLA,003,NUEVO CENTLA,4,253,125,128,13
TABASCO,27,CENTLA,003,PASO DE TABASQUILLO,3,133,60,73,7
TABASCO,27,CENTLA,003,POTRERILLO,3,151,75,76,6
TABASCO,27,CENTLA,003,QUINTÍN ARÁUZ,5,553,274,279,27
TABASCO,27,CENTLA,003,RIBERA ALTA 1RA. SECCIÓN,3,137,75,62,6
TABASCO,27,CENTLA,003,RIBERA ALTA 2DA. SECCIÓN,3,132,51,81,6
TABASCO,27,CENTLA,003,RIBERA ALTA 2DA. SECCIÓN (SALSIPUEDES),3,85,46,39,5
TABASCO,27,CENTLA,003,RIBERA ALTA 3RA. SECCIÓN,5,268,129,139,11
TABASCO,27,CENTLA,003,RIBERA ALTA DE CUAUHTÉMOC,3,207,113,94,10
TABASCO,27,CENTLA,003,RIBERA ALTA SALSIPUEDES (SALSIPUEDES),2,29,18,11,2
TABASCO,27,CENTLA,003,RÓMULO CACHÓN PONCE (HORMIGUERO),2,5,2,3,1
TABASCO,27,CENTLA,003,SAN JOSÉ DE SIMÓN SARLAT,2,134,61,73,6
TABASCO,27,CENTLA,003,SAN JOSÉ DE SIMÓN SARLAT (EL COCO),1,7,4,3,1
TABASCO,27,CENTLA,003,SAN JOSÉ DEL CARMEN,2,76,43,33,4
TABASCO,27,CENTLA,003,SAN JUAN,2,170,79,91,7
TABASCO,27,CENTLA,003,SAN JUANITO DE TRES BRAZOS,2,8,3,5,1
TABASCO,27,CENTLA,003,SAN ROMÁN,2,35,19,16,2
TABASCO,27,CENTLA,003,SIMÓN SARLAT,7,1529,747,782,62
TABASCO,27,CENTLA,003,TABASQUILLO 1RA. SECCIÓN,2,82,35,47,3
TABASCO,27,CENTLA,003,TABASQUILLO 2DA. SECCIÓN,2,23,9,14,3
TABASCO,27,CENTLA,003,TASAJERA,3,29,12,17,3
TABASCO,27,CENTLA,003,TEMBLADERAS,2,20,12,8,2
TABASCO,27,CENTLA,003,TRES BRAZOS,3,149,70,79,8
TABASCO,27,CENTLA,003,VEINTISIETE DE FEBRERO,3,83,43,40,4
TABASCO,27,CENTLA,003,VICENTE GUERRERO,13,4055,2130,1925,189
TABASCO,27,CENTRO,004,ACACHAPAN Y COLMENA 1RA. SECCIÓN,7,1035,503,532,48
TABASCO,27,CENTRO,004,ACACHAPAN Y COLMENA 2DA. SECCIÓN (EL MALUCO),2,80,41,39,4
TABASCO,27,CENTRO,004,ACACHAPAN Y COLMENA 2DA. SECCIÓN (LA ARENA),4,107,55,52,7
TABASCO,27,CENTRO,004,ACACHAPAN Y COLMENA 3RA. SECCIÓN,9,359,150,209,23
TABASCO,27,CENTRO,004,ACACHAPAN Y COLMENA 4TA. SECCIÓN,2,102,45,57,5
TABASCO,27,CENTRO,004,ACACHAPAN Y COLMENA 5TA. SECCIÓN,2,73,33,40,4
TABASCO,27,CENTRO,004,ALVARADO (COLIMA),2,26,12,14,2
TABASCO,27,CENTRO,004,ALVARADO GUARDACOSTA,2,60,28,32,3
TABASCO,27,CENTRO,004,ALVARADO JIMBAL,3,290,146,144,14
TABASCO,27,CENTRO,004,ALVARADO SANTA IRENE 2DA. SECCIÓN (EL TAIZAL),2,57,31,26,4
TABASCO,27,CENTRO,004,ANACLETO CANABAL 1RA. SECCIÓN,3,625,304,321,22
TABASCO,27,CENTRO,004,ANACLETO CANABAL 2DA. SECCIÓN,6,872,427,445,35
TABASCO,27,CENTRO,004,ANACLETO CANABAL 3RA. SECCIÓN,5,389,184,205,36
TABASCO,27,CENTRO,004,ANACLETO CANABAL 4TA. SECCIÓN,2,143,78,65,6
TABASCO,27,CENTRO,004,ANICETO,2,203,105,98,8
TABASCO,27,CENTRO,004,AZTLÁN 1RA. SECCIÓN,3,134,66,68,6
TABASCO,27,CENTRO,004,AZTLÁN 1RA. SECCIÓN (LA PIEDAD),2,15,10,5,2
TABASCO,27,CENTRO,004,AZTLÁN 2DA. SECCIÓN (EL CORCHO),4,209,102,107,11
TABASCO,27,CENTRO,004,AZTLÁN 3RA. SECCIÓN (CORCHO Y CHILAPILLA),2,25,12,13,2
TABASCO,27,CENTRO,004,AZTLÁN 3RA. SECCIÓN (JAHUACTE),2,22,13,9,2
TABASCO,27,CENTRO,004,AZTLÁN 4TA. SECCIÓN (CORCHO Y CHILAPILLA),5,236,100,136,12
TABASCO,27,CENTRO,004,AZTLÁN 5TA. SECCIÓN (PALOMILLAL),5,153,75,78,9
TABASCO,27,CENTRO,004,BARRANCAS Y AMATE 2DA. SECCIÓN,2,18,6,12,2
TABASCO,27,CENTRO,004,BARRANCAS Y AMATE 3RA. SECCIÓN,4,325,154,171,14
TABASCO,27,CENTRO,004,BARRANCAS Y GUANAL GONZÁLEZ,2,88,41,47,3
TABASCO,27,CENTRO,004,BARRANCAS Y GUANAL LÓPEZ PORTILLO,2,103,51,52,5
TABASCO,27,CENTRO,004,BARRANCAS Y GUANAL TINTILLO,3,119,53,66,6
TABASCO,27,CENTRO,004,BICENTENARIO,5,1102,544,558,40
TABASCO,27,CENTRO,004,BOCA DE AZTLÁN 2DA. SECCIÓN,3,62,28,34,4
TABASCO,27,CENTRO,004,BOCA GRANDE EL ESPINO,1,3,0,3,1
TABASCO,27,CENTRO,004,BOQUERÓN 1RA. SECCIÓN (SAN PEDRO),3,810,385,425,26
TABASCO,27,CENTRO,004,BOQUERÓN 2DA. SECCIÓN (EL BARQUILLO),4,519,266,253,49
TABASCO,27,CENTRO,004,BOQUERÓN 3RA. SECCIÓN (EL GUANAL),2,250,131,119,9
TABASCO,27,CENTRO,004,BOQUERÓN 4TA. SECCIÓN (LAGUNA NUEVA),3,292,139,153,10
TABASCO,27,CENTRO,004,BOQUERÓN 5TA. SECCIÓN (LA LAGARTERA),3,61,27,34,4
TABASCO,27,CENTRO,004,BUENA VISTA 1RA. SECCIÓN,5,1472,743,729,64
TABASCO,27,CENTRO,004,BUENA VISTA 2DA. SECCIÓN,5,813,383,430,30
TABASCO,27,CENTRO,004,BUENA VISTA 3RA. SECCIÓN (BOCA DE ESCOBA),1,25,10,15,1
TABASCO,27,CENTRO,004,BUENA VISTA RÍO NUEVO 1RA. SECCIÓN,5,741,382,359,25
TABASCO,27,CENTRO,004,BUENA VISTA RÍO NUEVO 2DA. SECCIÓN,7,1154,579,575,48
TABASCO,27,CENTRO,004,BUENA VISTA RÍO NUEVO 3RA. SECCIÓN,7,831,410,421,30
TABASCO,27,CENTRO,004,BUENA VISTA RÍO NUEVO 4TA. SECCIÓN,3,549,281,268,18
TABASCO,27,CENTRO,004,CHIQUIGUAO 1RA. SECCIÓN,2,65,34,31,3
TABASCO,27,CENTRO,004,CHIQUIGUAO 2DA. SECCIÓN (CHIQUIGUAÍTO),2,57,26,31,4
TABASCO,27,CENTRO,004,COCOYOL (SOCIALISTA),4,277,139,138,11
TABASCO,27,CENTRO,004,COLONIA AGRARIA (LA ISLA),2,211,97,114,9
TABASCO,27,CENTRO,004,CONSTITUCIÓN,3,517,272,245,22
TABASCO,27,CENTRO,004,CORONEL TRACONIS (GUERRERO 3RA. SECCIÓN),7,1850,1026,824,196
TABASCO,27,CENTRO,004,CORONEL TRACONIS (SAN FRANCISCO 4TA. SECCIÓN),3,40,18,22,3
TABASCO,27,CENTRO,004,CORONEL TRACONIS 1RA. SECCIÓN (LA ISLA),2,20,8,12,2
TABASCO,27,CENTRO,004,CORONEL TRACONIS 2DA. SECCIÓN (EL ZAPOTE),1,11,7,4,1
TABASCO,27,CENTRO,004,CORREGIDORA ORTIZ 1RA. SECCIÓN,3,591,291,300,24
TABASCO,27,CENTRO,004,CORREGIDORA ORTIZ 2DA. SECCIÓN,2,63,31,32,3
TABASCO,27,CENTRO,004,CORREGIDORA ORTIZ 3RA. SECCIÓN (SAN PEDRITO),7,689,337,352,26
TABASCO,27,CENTRO,004,CORREGIDORA ORTIZ 5TA. SECCIÓN,5,338,180,158,14
TABASCO,27,CENTRO,004,DIECISÉIS DE SEPTIEMBRE,3,165,88,77,8
TABASCO,27,CENTRO,004,DOS MONTES,7,1333,625,708,101
TABASCO,27,CENTRO,004,EL ALAMBRADO,3,212,111,101,10
TABASCO,27,CENTRO,004,EL BAJÍO,2,55,30,25,3
TABASCO,27,CENTRO,004,EL CENSO,1,21,8,13,1
TABASCO,27,CENTRO,004,EL COROZAL,3,180,94,86,8
TABASCO,27,CENTRO,004,EL ESPINO,3,110,43,67,5
TABASCO,27,CENTRO,004,EL MANZANO,2,286,136,150,11
TABASCO,27,CENTRO,004,EL ZAPOTAL,2,85,39,46,3
TABASCO,27,CENTRO,004,EMILIANO ZAPATA,2,128,65,63,6
TABASCO,27,CENTRO,004,ESTANCIA,6,528,250,278,21
TABASCO,27,CENTRO,004,ESTANCIA VIEJA 1RA. SECCIÓN,3,355,184,171,14
TABASCO,27,CENTRO,004,ESTANCIA VIEJA 2DA. SECCIÓN,2,62,31,31,3
TABASCO,27,CENTRO,004,ESTANZUELA 1RA. SECCIÓN,5,432,214,218,17
TABASCO,27,CENTRO,004,ESTANZUELA 2DA. SECCIÓN,2,16,7,9,2
TABASCO,27,CENTRO,004,FLORES DEL TRÓPICO,1,55,25,30,3
TABASCO,27,CENTRO,004,FRACCIONAMIENTO OCUILTZAPOTLÁN DOS,3,552,279,273,20
TABASCO,27,CENTRO,004,FRANCISCO I. MADERO 1RA. SECCIÓN,2,87,35,52,4
TABASCO,27,CENTRO,004,GAVIOTAS SUR (EL CEDRAL),2,227,109,118,8
TABASCO,27,CENTRO,004,GONZÁLEZ 1RA. SECCIÓN,9,3851,2033,1818,285
TABASCO,27,CENTRO,004,GONZÁLEZ 2DA. SECCIÓN,4,504,256,248,20
TABASCO,27,CENTRO,004,GONZÁLEZ 3RA. SECCIÓN,2,256,131,125,10
TABASCO,27,CENTRO,004,GONZÁLEZ 4TA. SECCIÓN,2,200,93,107,8
TABASCO,27,CENTRO,004,GUAPINOL,13,2273,1113,1160,140
TABASCO,27,CENTRO,004,GUINEO 1RA. SECCIÓN,2,294,131,163,12
TABASCO,27,CENTRO,004,GUINEO 2DA. SECCIÓN,3,210,92,118,27
TABASCO,27,CENTRO,004,HUESO DE PUERCO,3,154,74,80,7
TABASCO,27,CENTRO,004,ISMATE Y CHILAPILLA 1RA. SECCIÓN,3,118,60,58,6
TABASCO,27,CENTRO,004,ISMATE Y CHILAPILLA 1RA. SECCIÓN (SAN ANTONIO),2,18,5,13,2
TABASCO,27,CENTRO,004,ISMATE Y CHILAPILLA 2DA. SECCIÓN,2,23,12,11,2
TABASCO,27,CENTRO,004,ISMATE Y CHILAPILLA 2DA. SECCIÓN JAHUACTILLO,3,18,12,6,2
TABASCO,27,CENTRO,004,IXTACOMITÁN 1RA. SECCIÓN,3,534,293,241,18
TABASCO,27,CENTRO,004,IXTACOMITÁN 2DA. SECCIÓN,2,166,79,87,9
TABASCO,27,CENTRO,004,IXTACOMITÁN 3RA. SECCIÓN,2,66,34,32,3
TABASCO,27,CENTRO,004,IXTACOMITÁN 4TA. SECCIÓN,3,35,20,15,3
TABASCO,27,CENTRO,004,IXTACOMITÁN 5TA. SECCIÓN,2,100,49,51,4
TABASCO,27,CENTRO,004,JOLOCHERO (BOCA DE CULEBRA),3,96,36,60,4
TABASCO,27,CENTRO,004,JOLOCHERO 2DA. SECCIÓN,6,663,333,330,27
TABASCO,27,CENTRO,004,LA CEIBA,4,375,186,189,15
TABASCO,27,CENTRO,004,LA CRUZ DEL BAJÍO,2,278,135,143,11
TABASCO,27,CENTRO,004,LA CRUZ DEL BAJÍO (LA SOLEDAD),1,15,10,5,2
TABASCO,27,CENTRO,004,LA HUASTECA 1RA. SECCIÓN,4,637,303,334,20
TABASCO,27,CENTRO,004,LA HUASTECA 2DA. SECCIÓN (ALVARADO LA RAYA),2,189,72,117,8
TABASCO,27,CENTRO,004,LA LIMA,8,1091,528,563,50
TABASCO,27,CENTRO,004,LA LOMA,2,76,40,36,4
TABASCO,27,CENTRO,004,LA MANGA,3,227,118,109,10
TABASCO,27,CENTRO,004,LA MANGA 2DA. SECCIÓN (EL JOBAL),2,166,92,74,6
TABASCO,27,CENTRO,004,LA PALMA,2,209,99,110,8
TABASCO,27,CENTRO,004,LA VUELTA (LA JAGUA),4,284,139,145,13
TABASCO,27,CENTRO,004,LA VUELTA 1RA. SECCIÓN (LA GLORIA),1,13,3,10,1
TABASCO,27,CENTRO,004,LAGARTERA 1RA. SECCIÓN,2,192,81,111,8
TABASCO,27,CENTRO,004,LAGARTERA 2DA. SECCIÓN,2,144,68,76,6
TABASCO,27,CENTRO,004,LAS MATILLAS 4TA. SECCIÓN,2,67,33,34,3
TABASCO,27,CENTRO,004,LAS MATILLAS 4TA. SECCIÓN (SAN ANTONIO),2,25,10,15,3
TABASCO,27,CENTRO,004,LÁZARO CÁRDENAS 1RA. SECCIÓN,4,524,253,271,20
TABASCO,27,CENTRO,004,LÁZARO CÁRDENAS 2DA. SECCIÓN,16,4410,2252,2158,400
TABASCO,27,CENTRO,004,LUIS GIL PÉREZ,5,1862,913,949,71
TABASCO,27,CENTRO,004,MACULTEPEC,8,2709,1366,1343,120
TABASCO,27,CENTRO,004,MEDELLÍN Y MADERO 2DA. SECCIÓN,4,715,360,355,29
TABASCO,27,CENTRO,004,MEDELLÍN Y MADERO 3RA. SECCIÓN,1,27,14,13,2
TABASCO,27,CENTRO,004,MEDELLÍN Y MADERO 4TA. SECCIÓN,3,424,204,220,16
TABASCO,27,CENTRO,004,MEDELLÍN Y PIGUA 2DA. SECCIÓN,2,86,41,45,4
TABASCO,27,CENTRO,004,MEDELLÍN Y PIGUA 3RA. SECCIÓN,4,861,458,403,30
TABASCO,27,CENTRO,004,MEDELLÍN Y PIGUA 4TA. SECCIÓN (EL AGUACATE),1,19,6,13,1
TABASCO,27,CENTRO,004,MIGUEL HIDALGO 2DA. SECCIÓN (LA GUAIRA),2,69,30,39,3
TABASCO,27,CENTRO,004,MIRAFLORES 1RA. SECCIÓN,2,54,29,25,3
TABASCO,27,CENTRO,004,MIRAFLORES 1RA. SECCIÓN (ARROYO GRANDE),2,64,28,36,3
TABASCO,27,CENTRO,004,MIRAFLORES 2DA. SECCIÓN,3,160,74,86,7
TABASCO,27,CENTRO,004,MIRAFLORES 3RA. SECCIÓN,3,182,93,89,9
TABASCO,27,CENTRO,004,MIRAMAR,4,349,159,190,13
TABASCO,27,CENTRO,004,OCUILTZAPOTLÁN,18,4329,1985,2344,203
TABASCO,27,CENTRO,004,PABLO L. SIDAR,3,320,151,169,12
TABASCO,27,CENTRO,004,PABLO L. SIDAR (LA AURORA),2,26,12,14,2
TABASCO,27,CENTRO,004,PABLO L. SIDAR (MIRAMAR),2,29,16,13,2
TABASCO,27,CENTRO,004,PAJONAL,3,151,86,65,8
TABASCO,27,CENTRO,004,PARRILLA,12,1417,671,746,226
TABASCO,27,CENTRO,004,PARRILLA II,12,6617,3063,3554,443
TABASCO,27,CENTRO,004,PASO REAL DE LA VICTORIA,2,225,108,117,8
TABASCO,27,CENTRO,004,PLÁTANO Y CACAO 1RA. SECCIÓN,4,365,192,173,14
TABASCO,27,CENTRO,004,PLÁTANO Y CACAO 2DA. SECCIÓN (LA ISLA),7,1371,702,669,56
TABASCO,27,CENTRO,004,PLÁTANO Y CACAO 3RA. SECCIÓN,2,124,55,69,5
TABASCO,27,CENTRO,004,PLÁTANO Y CACAO 4TA. SECCIÓN,2,70,36,34,4
TABASCO,27,CENTRO,004,PLAYAS DEL ROSARIO (SUBTENIENTE GARCÍA),16,3422,1708,1714,153
TABASCO,27,CENTRO,004,PLUTARCO ELÍAS CALLES (CURA HUESO),2,172,80,92,9
TABASCO,27,CENTRO,004,PLUTARCO ELÍAS CALLES (LA MAJAHUA),2,37,16,21,3
TABASCO,27,CENTRO,004,PUEBLO NUEVO DE LAS RAÍCES,3,336,174,162,15
TABASCO,27,CENTRO,004,RIBERA DE LAS RAÍCES,1,5,1,4,1
TABASCO,27,CENTRO,004,RÍO TINTO 1RA. SECCIÓN,2,138,68,70,6
TABASCO,27,CENTRO,004,RÍO TINTO 2DA. SECCIÓN,2,120,61,59,4
TABASCO,27,CENTRO,004,RÍO TINTO 3RA. SECCIÓN,2,99,51,48,5
TABASCO,27,CENTRO,004,RÍO VIEJO 1RA. SECCIÓN,8,1523,770,753,57
TABASCO,27,CENTRO,004,RÍO VIEJO 2DA. SECCIÓN,2,349,164,185,15
TABASCO,27,CENTRO,004,RÍO VIEJO 3RA. SECCIÓN,2,31,14,17,2
TABASCO,27,CENTRO,004,ROVIROSA,3,144,80,64,7
TABASCO,27,CENTRO,004,SABANAS NUEVAS,1,8,3,5,1
TABASCO,27,CENTRO,004,SANTA CATALINA (SAN MARCOS),2,51,21,30,3
TABASCO,27,CENTRO,004,TAMULTÉ DE LAS SABANAS,13,3517,1833,1684,140
TABASCO,27,CENTRO,004,TIERRA AMARILLA 3RA. SECCIÓN,2,114,65,49,6
TABASCO,27,CENTRO,004,TOCOAL,3,495,252,243,18
TABASCO,27,CENTRO,004,TORNO LARGO 1RA. SECCIÓN,2,66,33,33,3
TABASCO,27,CENTRO,004,TORNO LARGO 2DA. SECCIÓN,3,241,112,129,11
TABASCO,27,CENTRO,004,TORNO LARGO 3RA. SECCIÓN (SABANILLA),2,62,31,31,3
TABASCO,27,CENTRO,004,TUMBULUSHAL,3,1742,615,1127,92
TABASCO,27,CENTRO,004,VILLA EL CIELO,6,1954,932,1022,67
TABASCO,27,CENTRO,004,VILLA UNIÓN,3,1898,942,956,95
TABASCO,27,CENTRO,004,VILLAHERMOSA,522,144276,76157,68119,9244
TABASCO,27,COMALCALCO,005,ALDAMA,8,3007,1497,1510,147
TABASCO,27,COMALCALCO,005,ALDAMA 2DA. SECCIÓN (FERNANDO SEGOVIA),2,107,52,55,4
TABASCO,27,COMALCALCO,005,ALDAMA 3RA. SECCIÓN (HUAPACALITO),2,137,65,72,5
TABASCO,27,COMALCALCO,005,ALDAMA 4TA. SECCIÓN (EL NARANJITO),2,69,34,35,3
TABASCO,27,COMALCALCO,005,ARENA 1RA. SECCIÓN,5,812,388,424,28
TABASCO,27,COMALCALCO,005,ARENA 2DA. SECCIÓN,5,724,346,378,25
TABASCO,27,COMALCALCO,005,ARENA 3RA. SECCIÓN,2,148,66,82,6
TABASCO,27,COMALCALCO,005,ARENA 4TA. SECCIÓN,2,70,37,33,3
TABASCO,27,COMALCALCO,005,ARENA 5TA. SECCIÓN,2,216,125,91,8
TABASCO,27,COMALCALCO,005,ARENA 6TA. SECCIÓN (LA BOLSA),2,278,136,142,9
TABASCO,27,COMALCALCO,005,ARROYO HONDO 1RA. SECCIÓN (GUÁCIMO),4,444,204,240,18
TABASCO,27,COMALCALCO,005,ARROYO HONDO 2DA. SECCIÓN,2,231,124,107,9
TABASCO,27,COMALCALCO,005,ARROYO HONDO 3RA. SECCIÓN,3,469,245,224,19
TABASCO,27,COMALCALCO,005,ARROYO HONDO 4TA. SECCIÓN,3,266,130,136,11
TABASCO,27,COMALCALCO,005,BELISARIO DOMÍNGUEZ,2,121,51,70,5
TABASCO,27,COMALCALCO,005,CARLOS GREENE,4,1394,692,702,98
TABASCO,27,COMALCALCO,005,CARLOS GREENE 1RA. SECCIÓN DOS (COLONIA JIMÉNEZ),1,20,10,10,1
TABASCO,27,COMALCALCO,005,CARLOS GREENE 1RA. SECCIÓN TRES (COLONIA EL LIMÓN),2,120,59,61,5
TABASCO,27,COMALCALCO,005,CARLOS GREENE 2DA. SECCIÓN,2,214,103,111,8
TABASCO,27,COMALCALCO,005,CARLOS GREENE 3RA. SECCIÓN,2,157,70,87,7
TABASCO,27,COMALCALCO,005,CARLOS GREENE 4TA. SECCIÓN,2,87,42,45,4
TABASCO,27,COMALCALCO,005,CARLOS PELLICER CÁMARA,2,13,6,7,2
TABASCO,27,COMALCALCO,005,CENTRO TULAR 1RA. SECCIÓN,3,258,109,149,12
TABASCO,27,COMALCALCO,005,CENTRO TULAR 2DA. SECCIÓN,2,192,90,102,8
TABASCO,27,COMALCALCO,005,CHAMPA DE CUPILCO,2,198,96,102,8
TABASCO,27,COMALCALCO,005,CHICHICAPA,9,2273,1119,1154,91
TABASCO,27,COMALCALCO,005,CHICOZAPOTE,2,96,53,43,5
TABASCO,27,COMALCALCO,005,COCOHITAL,6,1007,497,510,44
TABASCO,27,COMALCALCO,005,COMALCALCO,84,18389,9324,9065,1099
TABASCO,27,COMALCALCO,005,CUPILCO,4,756,376,380,26
TABASCO,27,COMALCALCO,005,CUXCUXAPA,3,154,80,74,7
TABASCO,27,COMALCALCO,005,EMILIANO ZAPATA 1RA. SECCIÓN,3,437,202,235,20
TABASCO,27,COMALCALCO,005,EMILIANO ZAPATA 2DA. SECCIÓN,2,100,33,67,4
TABASCO,27,COMALCALCO,005,FRANCISCO I. MADERO 1RA. SECCIÓN,2,249,118,131,9
TABASCO,27,COMALCALCO,005,FRANCISCO I. MADERO 2DA. SECCIÓN,3,287,148,139,12
TABASCO,27,COMALCALCO,005,FRANCISCO TRUJILLO GURRÍA,4,337,168,169,14
TABASCO,27,COMALCALCO,005,GOBERNADORES,1,173,80,93,6
TABASCO,27,COMALCALCO,005,GREGORIO MÉNDEZ 1RA. SECCIÓN,2,365,187,178,16
TABASCO,27,COMALCALCO,005,GREGORIO MÉNDEZ 2DA. SECCIÓN,2,308,157,151,10
TABASCO,27,COMALCALCO,005,GREGORIO MÉNDEZ 3RA. SECCIÓN,3,336,175,161,14
TABASCO,27,COMALCALCO,005,GREGORIO MÉNDEZ 4TA. SECCIÓN (EL SANTIAGO),2,43,19,24,3
TABASCO,27,COMALCALCO,005,GUATEMALÁN,2,91,53,38,4
TABASCO,27,COMALCALCO,005,GUAYO 1RA. SECCIÓN,6,661,314,347,28
TABASCO,27,COMALCALCO,005,GUAYO 2DA. SECCIÓN,2,117,55,62,5
TABASCO,27,COMALCALCO,005,GUAYO 3RA. SECCIÓN,2,72,31,41,3
TABASCO,27,COMALCALCO,005,HERMENEGILDO GALEANA,3,162,78,84,9
TABASCO,27,COMALCALCO,005,IGNACIO GUTIÉRREZ GÓMEZ,3,425,203,222,18
TABASCO,27,COMALCALCO,005,IGNACIO ZARAGOZA 1RA. SECCIÓN,3,358,178,180,13
TABASCO,27,COMALCALCO,005,IGNACIO ZARAGOZA 2DA. SECCIÓN,2,77,37,40,4
TABASCO,27,COMALCALCO,005,IGNACIO ZARAGOZA 3RA. SECCIÓN,2,174,89,85,9
TABASCO,27,COMALCALCO,005,IGNACIO ZARAGOZA 4TA. SECCIÓN (SAN ANDRÉS),2,84,45,39,3
TABASCO,27,COMALCALCO,005,INDEPENDENCIA 1RA. SECCIÓN,2,322,158,164,12
TABASCO,27,COMALCALCO,005,INDEPENDENCIA 2DA. SECCIÓN,4,616,295,321,20
TABASCO,27,COMALCALCO,005,INDEPENDENCIA 3RA. SECCIÓN,2,108,58,50,4
TABASCO,27,COMALCALCO,005,JESÚS CARRANZA,2,88,46,42,3
TABASCO,27,COMALCALCO,005,JOSÉ MARÍA PINO SUÁREZ 1RA. SECCIÓN,5,845,426,419,37
TABASCO,27,COMALCALCO,005,JOSÉ MARÍA PINO SUÁREZ 2DA. SECCIÓN,2,225,119,106,8
TABASCO,27,COMALCALCO,005,JOSÉ MARÍA PINO SUÁREZ 3RA. SECCIÓN (CORINTO),3,154,83,71,7
TABASCO,27,COMALCALCO,005,LAGARTERA,5,792,388,404,29
TABASCO,27,COMALCALCO,005,LÁZARO CÁRDENAS 1RA. SECCIÓN,5,564,264,300,23
TABASCO,27,COMALCALCO,005,LÁZARO CÁRDENAS 2DA. SECCIÓN (EL RETIRO),3,220,109,111,9
TABASCO,27,COMALCALCO,005,LÁZARO CÁRDENAS 3RA. SECCIÓN,4,269,133,136,12
TABASCO,27,COMALCALCO,005,LEÓN ZÁRATE 1RA. SECCIÓN,4,705,336,369,26
TABASCO,27,COMALCALCO,005,LEÓN ZÁRATE 2DA. SECCIÓN,1,143,68,75,6
TABASCO,27,COMALCALCO,005,MIGUEL HIDALGO,8,1226,601,625,43
TABASCO,27,COMALCALCO,005,NORTE 1RA. SECCIÓN (BUENA VISTA),2,94,44,50,4
TABASCO,27,COMALCALCO,005,NORTE 1RA. SECCIÓN (SAN JULIÁN),4,189,86,103,8
TABASCO,27,COMALCALCO,005,NORTE 2DA. SECCIÓN,2,246,140,106,9
TABASCO,27,COMALCALCO,005,NOVILLERO 4TA. SECCIÓN,2,116,50,66,5
TABASCO,27,COMALCALCO,005,OCCIDENTE 1RA. SECCIÓN,3,381,171,210,15
TABASCO,27,COMALCALCO,005,OCCIDENTE 2DA. SECCIÓN,3,427,217,210,15
TABASCO,27,COMALCALCO,005,OCCIDENTE 3RA. SECCIÓN,3,3280,1251,2029,110
TABASCO,27,COMALCALCO,005,OCCIDENTE 4TA. SECCIÓN,2,256,127,129,8
TABASCO,27,COMALCALCO,005,OCCIDENTE VILLA ALDAMA,1,5,2,3,1
TABASCO,27,COMALCALCO,005,ORIENTE,2,67,36,31,3
TABASCO,27,COMALCALCO,005,ORIENTE 1RA. SECCIÓN,5,308,151,157,14
TABASCO,27,COMALCALCO,005,ORIENTE 1RA. SECCIÓN (SANTO DOMINGO),3,2058,958,1100,69
TABASCO,27,COMALCALCO,005,ORIENTE 2DA. SECCIÓN (SAN CAYETANO),3,482,238,244,18
TABASCO,27,COMALCALCO,005,ORIENTE 3RA. SECCIÓN,3,192,94,98,8
TABASCO,27,COMALCALCO,005,ORIENTE 4TA. SECCIÓN (TRIPA CIEGA),2,91,48,43,4
TABASCO,27,COMALCALCO,005,ORIENTE 5TA. SECCIÓN (LA CANDELARIA),2,77,39,38,4
TABASCO,27,COMALCALCO,005,ORIENTE 6TA. SECCIÓN (LOS MULATOS),4,684,324,360,42
TABASCO,27,COMALCALCO,005,PASO DE CUPILCO,5,666,332,334,24
TABASCO,27,COMALCALCO,005,PATASTAL 1RA. SECCIÓN,3,339,181,158,14
TABASCO,27,COMALCALCO,005,PATASTAL 2DA. SECCIÓN,2,168,80,88,8
TABASCO,27,COMALCALCO,005,PATASTAL 3RA. SECCIÓN,2,48,19,29,3
TABASCO,27,COMALCALCO,005,POTRERILLO,2,258,125,133,10
TABASCO,27,COMALCALCO,005,PROGRESO TULAR 1RA. SECCIÓN,3,230,98,132,10
TABASCO,27,COMALCALCO,005,PROGRESO TULAR 2DA. SECCIÓN,2,202,98,104,8
TABASCO,27,COMALCALCO,005,REYES HERNÁNDEZ 1RA. SECCIÓN,2,236,125,111,9
TABASCO,27,COMALCALCO,005,REYES HERNÁNDEZ 2DA. SECCIÓN,5,655,330,325,27
TABASCO,27,COMALCALCO,005,SAN FERNANDO (PUEBLO NUEVO),2,79,38,41,3
TABASCO,27,COMALCALCO,005,SANTA LUCÍA CHICHICAPA (FRACCIONAMIENTO LA QUINTA),2,258,126,132,9
TABASCO,27,COMALCALCO,005,SARGENTO LÓPEZ 1RA. SECCIÓN,4,744,353,391,27
TABASCO,27,COMALCALCO,005,SARGENTO LÓPEZ 2DA. SECCIÓN (EL CHUZO),3,264,132,132,9
TABASCO,27,COMALCALCO,005,SARGENTO LÓPEZ 3RA. SECCIÓN (SAN JORGE),2,51,27,24,3
TABASCO,27,COMALCALCO,005,SARGENTO LÓPEZ 4TA. SECCIÓN,2,45,21,24,3
TABASCO,27,COMALCALCO,005,SUR 1RA. SECCIÓN,2,310,145,165,12
TABASCO,27,COMALCALCO,005,SUR 2DA. SECCIÓN (LA TRINIDAD),2,137,75,62,7
TABASCO,27,COMALCALCO,005,SUR 3RA. SECCIÓN (EL ZAPOTE),2,222,113,109,9
TABASCO,27,COMALCALCO,005,SUR 4TA. SECCIÓN,3,2113,1399,714,122
TABASCO,27,COMALCALCO,005,SUR 5TA. SECCIÓN,1,46,18,28,2
TABASCO,27,COMALCALCO,005,SUR ALDAMA,2,102,60,42,4
TABASCO,27,COMALCALCO,005,TECOLUTILLA,16,4401,2248,2153,211
TABASCO,27,COMALCALCO,005,TECOLUTILLA (RIBERITA),2,57,25,32,3
TABASCO,27,COMALCALCO,005,TÍO MONCHO (URANIA FRANYUTTI DE VÁZQUEZ),1,23,14,9,1
TABASCO,27,COMALCALCO,005,TRÁNSITO TULAR,2,229,107,122,8
TABASCO,27,COMALCALCO,005,USPÍ,2,122,54,68,4
TABASCO,27,COMALCALCO,005,ZAPOTAL 1RA. SECCIÓN,2,253,113,140,8
TABASCO,27,COMALCALCO,005,ZAPOTAL 2DA. SECCIÓN,3,656,326,330,25
TABASCO,27,COMALCALCO,005,ZAPOTAL 3RA. SECCIÓN,2,107,55,52,5
TABASCO,27,CUNDUACÁN,006,ADOLFO RUIZ CORTINES (MORELITOS),2,166,80,86,7
TABASCO,27,CUNDUACÁN,006,ALIANZA PARA LA PRODUCCIÓN,2,50,21,29,3
TABASCO,27,CUNDUACÁN,006,AMADO GÓMEZ,3,432,207,225,16
TABASCO,27,CUNDUACÁN,006,AMADO GÓMEZ 2DA. SECCIÓN,2,115,68,47,5
TABASCO,27,CUNDUACÁN,006,ANTA Y CÚLICO (SANTA RITA),2,94,44,50,4
TABASCO,27,CUNDUACÁN,006,BENITO JUÁREZ,2,41,16,25,3
TABASCO,27,CUNDUACÁN,006,BUENAVENTURA,2,169,97,72,8
TABASCO,27,CUNDUACÁN,006,BUENOS AIRES,2,77,34,43,4
TABASCO,27,CUNDUACÁN,006,CARLOS ROVIROSA (TULIPÁN),6,1756,913,843,104
TABASCO,27,CUNDUACÁN,006,CASA BLANCA 1RA. SECCIÓN,1,42,20,22,2
TABASCO,27,CUNDUACÁN,006,CASA BLANCA 2DA. SECCIÓN,2,156,76,80,7
TABASCO,27,CUNDUACÁN,006,CEIBA 1RA. SECCIÓN (JAHUACTAL),3,481,232,249,18
TABASCO,27,CUNDUACÁN,006,COLIMA,4,67,27,40,5
TABASCO,27,CUNDUACÁN,006,CUCUYULAPA,4,1367,682,685,55
TABASCO,27,CUNDUACÁN,006,CUCUYULAPA 2DA. SECCIÓN (PUENTE SAMARIA),2,78,35,43,4
TABASCO,27,CUNDUACÁN,006,CÚLICO 1RA. SECCIÓN,4,562,282,280,20
TABASCO,27,CUNDUACÁN,006,CÚLICO 2DA. SECCIÓN,2,396,205,191,17
TABASCO,27,CUNDUACÁN,006,CUMUAPA 1RA. SECCIÓN,3,757,382,375,26
TABASCO,27,CUNDUACÁN,006,CUMUAPA 2DA. SECCIÓN,3,552,287,265,20
TABASCO,27,CUNDUACÁN,006,CUNDUACÁN,42,17225,8004,9221,1018
TABASCO,27,CUNDUACÁN,006,CUNDUACÁN (EL MOTÉ),3,351,159,192,14
TABASCO,27,CUNDUACÁN,006,CUNDUACÁN (SAN PEDRO),2,77,30,47,4
TABASCO,27,CUNDUACÁN,006,DIECISÉIS DE SEPTIEMBRE,1,10,8,2,1
TABASCO,27,CUNDUACÁN,006,DOS CEIBAS,5,410,207,203,17
TABASCO,27,CUNDUACÁN,006,EL CARMEN (CUMUAPA),2,91,45,46,4
TABASCO,27,CUNDUACÁN,006,EL PALMAR,3,170,86,84,9
TABASCO,27,CUNDUACÁN,006,EL TULAR,2,361,192,169,14
TABASCO,27,CUNDUACÁN,006,EL TUNAL,3,120,59,61,6
TABASCO,27,CUNDUACÁN,006,EMILIANO ZAPATA (SAN MATEO),4,47,24,23,4
TABASCO,27,CUNDUACÁN,006,ENRIQUE GONZÁLEZ PEDRERO,1,14,5,9,1
TABASCO,27,CUNDUACÁN,006,FELIPE CARRILLO PUERTO,4,612,285,327,24
TABASCO,27,CUNDUACÁN,006,FELIPE CARRILLO PUERTO (AMPLIACIÓN SAN FELIPITO),2,94,44,50,4
TABASCO,27,CUNDUACÁN,006,FELIPE GALVÁN,2,132,64,68,6
TABASCO,27,CUNDUACÁN,006,GENERAL FRANCISCO J. MÚJICA,2,49,29,20,3
TABASCO,27,CUNDUACÁN,006,GREGORIO MÉNDEZ,4,975,456,519,37
TABASCO,27,CUNDUACÁN,006,HUACAPA Y AMESTOY,4,241,115,126,10
TABASCO,27,CUNDUACÁN,006,HUAPACAL 1RA. SECCIÓN,4,187,87,100,9
TABASCO,27,CUNDUACÁN,006,HUAPACAL 2DA. SECCIÓN,3,70,30,40,4
TABASCO,27,CUNDUACÁN,006,HUIMANGO,8,821,390,431,31
TABASCO,27,CUNDUACÁN,006,HUIMANGO 1RA. SECCIÓN,2,229,116,113,9
TABASCO,27,CUNDUACÁN,006,HUIMANGO 1RA. SECCIÓN (EL DREN),2,190,86,104,7
TABASCO,27,CUNDUACÁN,006,HUIMANGO 1RA. SECCIÓN (LA ESPERANZA),2,63,32,31,3
TABASCO,27,CUNDUACÁN,006,HUIMANGO 2DA. SECCIÓN,1,47,22,25,2
TABASCO,27,CUNDUACÁN,006,HUIMANGO 2DA. SECCIÓN (LA MONA),4,754,381,373,25
TABASCO,27,CUNDUACÁN,006,HUIMANGO 3RA. SECCIÓN (LOS CERROS),3,291,149,142,11
TABASCO,27,CUNDUACÁN,006,IGNACIO ZARAGOZA,2,106,52,54,5
TABASCO,27,CUNDUACÁN,006,JOSÉ MARÍA MORELOS Y PAVÓN (MORELITOS),1,25,14,11,2
TABASCO,27,CUNDUACÁN,006,JOSÉ MARÍA PINO SUÁREZ,4,413,196,217,16
TABASCO,27,CUNDUACÁN,006,LA CHONITA,2,258,135,123,10
TABASCO,27,CUNDUACÁN,006,LA ISLA,1,5,2,3,1
TABASCO,27,CUNDUACÁN,006,LA LUCHA,4,430,214,216,17
TABASCO,27,CUNDUACÁN,006,LA PIEDRA 1RA. SECCIÓN,2,60,28,32,3
TABASCO,27,CUNDUACÁN,006,LA PIEDRA 2DA. SECCIÓN,4,539,259,280,20
TABASCO,27,CUNDUACÁN,006,LA PIEDRA 2DA. SECCIÓN (LA CANDELARIA),1,9,2,7,1
TABASCO,27,CUNDUACÁN,006,LA PIEDRA 3RA. SECCIÓN,4,251,129,122,10
TABASCO,27,CUNDUACÁN,006,LA PIEDRA 4TA. SECCIÓN,3,233,106,127,9
TABASCO,27,CUNDUACÁN,006,LA PLAYITA,3,620,297,323,22
TABASCO,27,CUNDUACÁN,006,LAGUNA DE CUCUYULAPA,3,273,139,134,12
TABASCO,27,CUNDUACÁN,006,LIBERTAD,7,1832,902,930,69
TABASCO,27,CUNDUACÁN,006,LIBERTAD 2DA. SECCIÓN,2,221,117,104,8
TABASCO,27,CUNDUACÁN,006,LIBERTAD 3RA. SECCIÓN (MONTE GRANDE),2,125,63,62,6
TABASCO,27,CUNDUACÁN,006,LIBERTAD 4TA. SECCIÓN (VICENTE GUERRERO),2,71,39,32,3
TABASCO,27,CUNDUACÁN,006,LIBERTAD 5TA. SECCIÓN,2,52,27,25,3
TABASCO,27,CUNDUACÁN,006,LIBERTAD 6TA. SECCIÓN (LOS MARTÍNEZ),2,52,23,29,3
TABASCO,27,CUNDUACÁN,006,LOS AGUILARES,2,69,34,35,4
TABASCO,27,CUNDUACÁN,006,LOS CEDROS,2,55,25,30,3
TABASCO,27,CUNDUACÁN,006,LOS CERROS,1,6,3,3,1
TABASCO,27,CUNDUACÁN,006,MANTILLA,3,312,161,151,13
TABASCO,27,CUNDUACÁN,006,MARÍN,3,269,131,138,11
TABASCO,27,CUNDUACÁN,006,MARÍN (RAMPA DE PANUNCIO),2,79,41,38,3
TABASCO,27,CUNDUACÁN,006,MARIO BARRUETA GARCÍA,2,57,24,33,4
TABASCO,27,CUNDUACÁN,006,MIAHUATLÁN (SAN GREGORIO),2,64,37,27,3
TABASCO,27,CUNDUACÁN,006,MIAHUATLÁN (SAN NICOLÁS),2,16,7,9,2
TABASCO,27,CUNDUACÁN,006,MIAHUATLÁN 1RA. SECCIÓN,2,81,44,37,3
TABASCO,27,CUNDUACÁN,006,MIAHUATLÁN 2DA. SECCIÓN,3,179,93,86,8
TABASCO,27,CUNDUACÁN,006,MONTERREY,4,384,184,200,14
TABASCO,27,CUNDUACÁN,006,MORELOS PIEDRA 3RA. SECCIÓN,3,484,240,244,18
TABASCO,27,CUNDUACÁN,006,NICOLÁS BRAVO,3,183,88,95,7
TABASCO,27,CUNDUACÁN,006,NUEVA ESPERANZA,2,41,21,20,3
TABASCO,27,CUNDUACÁN,006,ONCE DE FEBRERO 1RA. SECCIÓN,4,679,338,341,28
TABASCO,27,CUNDUACÁN,006,ONCE DE FEBRERO 2DA. SECCIÓN,2,57,35,22,3
TABASCO,27,CUNDUACÁN,006,OSCAR GÓMEZ SÁUZ,2,46,17,29,3
TABASCO,27,CUNDUACÁN,006,PECHUCALCO,2,178,77,101,8
TABASCO,27,CUNDUACÁN,006,PECHUCALCO 2DA. SECCIÓN (LAS CRUCES),2,281,150,131,10
TABASCO,27,CUNDUACÁN,006,PLÁTANO 1RA. SECCIÓN,2,74,40,34,4
TABASCO,27,CUNDUACÁN,006,PLÁTANO 2DA. SECCIÓN,2,28,12,16,2
TABASCO,27,CUNDUACÁN,006,RANCHO NUEVO,3,288,141,147,12
TABASCO,27,CUNDUACÁN,006,REFORMA,3,520,238,282,21
TABASCO,27,CUNDUACÁN,006,RÍO SECO 1RA. SECCIÓN,2,184,66,118,9
TABASCO,27,CUNDUACÁN,006,RÍO SECO 2DA. SECCIÓN (SANTIAGUITO),2,55,30,25,3
TABASCO,27,CUNDUACÁN,006,RÍO SECO 3RA. SECCIÓN (LA PLAYITA),2,76,39,37,3
TABASCO,27,CUNDUACÁN,006,SAN BENITO LA BOLSA (TIERRA Y LIBERTAD),1,18,7,11,2
TABASCO,27,CUNDUACÁN,006,SAN ELIGIO,4,98,53,45,6
TABASCO,27,CUNDUACÁN,006,SAN PEDRO CUMUAPA,2,83,37,46,4
TABASCO,27,CUNDUACÁN,006,SAN RAFAEL,2,39,15,24,3
TABASCO,27,CUNDUACÁN,006,SANTA ISABEL,2,90,35,55,4
TABASCO,27,CUNDUACÁN,006,SANTA LUCÍA,2,156,66,90,6
TABASCO,27,CUNDUACÁN,006,SANTO TOMÁS,2,102,61,41,5
TABASCO,27,CUNDUACÁN,006,TIERRA Y LIBERTAD,2,282,128,154,11
TABASCO,27,CUNDUACÁN,006,YOLOXÓCHITL (ESCOBILLAL),2,40,19,21,3
TABASCO,27,CUNDUACÁN,006,YOLOXÓCHITL 1RA. SECCIÓN,2,27,16,11,2
TABASCO,27,CUNDUACÁN,006,YOLOXÓCHITL 2DA. SECCIÓN,5,585,280,305,20
TABASCO,27,CUNDUACÁN,006,YOLOXÓCHITL 2DA. SECCIÓN (SAN SEVERO),3,162,86,76,8
TABASCO,27,CUNDUACÁN,006,YOLOXÓCHITL 3RA. SECCIÓN,7,464,234,230,32
TABASCO,27,EMILIANO ZAPATA,007,AGUACATE,3,37,15,22,3
TABASCO,27,EMILIANO ZAPATA,007,BOCA DE CHACAMAX,2,12,4,8,1
TABASCO,27,EMILIANO ZAPATA,007,CHABLÉ,5,1048,508,540,49
TABASCO,27,EMILIANO ZAPATA,007,CHACAMA,4,274,145,129,14
TABASCO,27,EMILIANO ZAPATA,007,CONCEPCIÓN,2,14,7,7,2
TABASCO,27,EMILIANO ZAPATA,007,COROZAL,1,6,3,3,1
TABASCO,27,EMILIANO ZAPATA,007,EMILIANO ZAPATA,29,6761,3402,3359,430
TABASCO,27,EMILIANO ZAPATA,007,EMILIANO ZAPATA (SECCIÓN EL AVISPERO),2,34,16,18,2
TABASCO,27,EMILIANO ZAPATA,007,EMILIANO ZAPATA (SECCIÓN JOBAL),2,74,40,34,3
TABASCO,27,EMILIANO ZAPATA,007,EMILIANO ZAPATA (SECCIÓN POCHOTE),3,71,30,41,4
TABASCO,27,EMILIANO ZAPATA,007,GREGORIO MÉNDEZ MAGAÑA (PÉNJAMO),4,355,172,183,38
TABASCO,27,EMILIANO ZAPATA,007,LA ISLA,2,21,8,13,2
TABASCO,27,EMILIANO ZAPATA,007,LA PITA,4,35,15,20,5
TABASCO,27,EMILIANO ZAPATA,007,NUEVO CHABLÉ,2,82,41,41,4
TABASCO,27,EMILIANO ZAPATA,007,NUEVO POCHOTE,3,50,20,30,3
TABASCO,27,EMILIANO ZAPATA,007,PASO DE SAN ROMÁN,3,19,8,11,3
TABASCO,27,EMILIANO ZAPATA,007,POCVICUC,2,18,8,10,2
TABASCO,27,EMILIANO ZAPATA,007,REFORMA,2,8,5,3,1
TABASCO,27,EMILIANO ZAPATA,007,RÍO FINAL,2,8,5,3,1
TABASCO,27,EMILIANO ZAPATA,007,TRES LETRAS,2,48,21,27,3
TABASCO,27,EMILIANO ZAPATA,007,ÚLTIMO ESFUERZO,2,17,9,8,1
TABASCO,27,HUIMANGUILLO,008,AGAPITO DOMÍNGUEZ CANABAL,2,71,32,39,3
TABASCO,27,HUIMANGUILLO,008,ALTO AMACOHÍTE 3RA. SECCIÓN,3,95,52,43,5
TABASCO,27,HUIMANGUILLO,008,AMACOHÍTE 2DA. SECCIÓN,2,15,5,10,2
TABASCO,27,HUIMANGUILLO,008,AQUILES SERDÁN 1RA. SECCIÓN,2,88,46,42,4
TABASCO,27,HUIMANGUILLO,008,AQUILES SERDÁN 2DA. SECCIÓN (AZUCENITA),3,28,19,9,3
TABASCO,27,HUIMANGUILLO,008,ARRIBA Y ADELANTE,2,18,12,6,2
TABASCO,27,HUIMANGUILLO,008,AUREO L. CALLES,3,73,33,40,4
TABASCO,27,HUIMANGUILLO,008,BENITO JUÁREZ,3,174,97,77,8
TABASCO,27,HUIMANGUILLO,008,BENITO JUÁREZ 1RA. SECCIÓN,4,144,71,73,7
TABASCO,27,HUIMANGUILLO,008,BENITO JUÁREZ 2DA. SECCIÓN (MONTE ALEGRE),2,83,38,45,3
TABASCO,27,HUIMANGUILLO,008,BLASILLO 1RA. SECCIÓN (NICOLÁS BRAVO),5,750,344,406,26
TABASCO,27,HUIMANGUILLO,008,BLASILLO 2DA. SECCIÓN (OTATES),3,217,108,109,10
TABASCO,27,HUIMANGUILLO,008,BLASILLO 4TA. SECCIÓN,2,72,35,37,3
TABASCO,27,HUIMANGUILLO,008,C-25 (ISIDRO CORTÉS RUEDA),3,673,330,343,26
TABASCO,27,HUIMANGUILLO,008,C-26 (GENERAL PEDRO C. COLORADO),3,616,299,317,29
TABASCO,27,HUIMANGUILLO,008,C-31 (GENERAL FRANCISCO VILLA),5,1171,585,586,43
TABASCO,27,HUIMANGUILLO,008,C-32 (LICENCIADO FRANCISCO TRUJILLO GURRÍA),4,1118,577,541,46
TABASCO,27,HUIMANGUILLO,008,C-34 (LICENCIADO BENITO JUÁREZ GARCÍA),5,1184,542,642,91
TABASCO,27,HUIMANGUILLO,008,C-40 (ERNESTO AGUIRRE COLORADO),4,1008,499,509,36
TABASCO,27,HUIMANGUILLO,008,C-41 (LICENCIADO CARLOS A. MADRAZO),5,1536,752,784,65
TABASCO,27,HUIMANGUILLO,008,CAOBANAL 1RA. SECCIÓN (LA VICTORIA),3,224,98,126,30
TABASCO,27,HUIMANGUILLO,008,CAOBANAL 1RA. SECCIÓN (MEZCALAPA),3,378,185,193,19
TABASCO,27,HUIMANGUILLO,008,CAOBANAL 2DA. SECCIÓN (PEDRO SÁNCHEZ MAGALLANES),2,92,42,50,4
TABASCO,27,HUIMANGUILLO,008,CARLOS A. MADRAZO,2,7,3,4,1
TABASCO,27,HUIMANGUILLO,008,CENTRAL FOURNIER 1RA. SECCIÓN (EL COLETO),2,87,45,42,4
TABASCO,27,HUIMANGUILLO,008,CENTRAL FOURNIER 2DA. SECCIÓN,1,21,13,8,1
TABASCO,27,HUIMANGUILLO,008,CHICOACÁN,6,296,145,151,14
TABASCO,27,HUIMANGUILLO,008,CHICOACÁN (AMPLIACIÓN),2,56,27,29,3
TABASCO,27,HUIMANGUILLO,008,CHIMALAPA 1RA. SECCIÓN,1,24,14,10,1
TABASCO,27,HUIMANGUILLO,008,CHIMALAPA 2DA. SECCIÓN,3,204,94,110,8
TABASCO,27,HUIMANGUILLO,008,CHONTALPA (ESTACIÓN CHONTALPA),9,2429,1228,1201,94
TABASCO,27,HUIMANGUILLO,008,CUAUHTÉMOC,2,36,18,18,3
TABASCO,27,HUIMANGUILLO,008,CUAUHTÉMOC Y PALMIRA,2,15,6,9,2
TABASCO,27,HUIMANGUILLO,008,ECONOMÍA,6,196,99,97,10
TABASCO,27,HUIMANGUILLO,008,EDUARDO ALDAY HERNÁNDEZ,2,39,19,20,2
TABASCO,27,HUIMANGUILLO,008,EL CABRITO,2,34,12,22,3
TABASCO,27,HUIMANGUILLO,008,EL COMPLEJO,2,89,43,46,3
TABASCO,27,HUIMANGUILLO,008,EL DESECHO 1RA. SECCIÓN,2,389,200,189,15
TABASCO,27,HUIMANGUILLO,008,EL DESECHO 2DA. SECCIÓN,2,55,26,29,3
TABASCO,27,HUIMANGUILLO,008,EL DORADO,4,288,131,157,14
TABASCO,27,HUIMANGUILLO,008,EL ENCOMENDERO,3,128,67,61,6
TABASCO,27,HUIMANGUILLO,008,EL GUANAL,3,118,54,64,6
TABASCO,27,HUIMANGUILLO,008,EL PARAÍSO,2,8,5,3,1
TABASCO,27,HUIMANGUILLO,008,EL PUENTE,2,91,40,51,3
TABASCO,27,HUIMANGUILLO,008,EL PUENTE 1RA. SECCIÓN,2,192,87,105,8
TABASCO,27,HUIMANGUILLO,008,EL SUSPIRO,2,70,40,30,3
TABASCO,27,HUIMANGUILLO,008,EMILIANO ZAPATA (CHICHONAL DE LA BOYERÍA),2,37,19,18,2
TABASCO,27,HUIMANGUILLO,008,EMILIANO ZAPATA (KILÓMETRO 4),2,57,31,26,4
TABASCO,27,HUIMANGUILLO,008,ENRIQUE RODRÍGUEZ CANO,6,98,38,60,7
TABASCO,27,HUIMANGUILLO,008,ESCOBEDO,2,6,2,4,1
TABASCO,27,HUIMANGUILLO,008,ESPERANZA DEL BAJÍO,3,30,12,18,3
TABASCO,27,HUIMANGUILLO,008,ESTACIÓN MARTÍNEZ GAYTÁN,1,24,5,19,1
TABASCO,27,HUIMANGUILLO,008,ESTACIÓN ZANAPA,2,115,54,61,4
TABASCO,27,HUIMANGUILLO,008,FRANCISCO I. MADERO,3,142,79,63,6
TABASCO,27,HUIMANGUILLO,008,FRANCISCO J. MÚJICA,4,262,131,131,11
TABASCO,27,HUIMANGUILLO,008,FRANCISCO J. SANTAMARÍA 1RA. SECCIÓN,2,165,77,88,6
TABASCO,27,HUIMANGUILLO,008,FRANCISCO MARTÍNEZ GAYTÁN,4,399,190,209,16
TABASCO,27,HUIMANGUILLO,008,FRANCISCO RUEDA,4,518,234,284,26
TABASCO,27,HUIMANGUILLO,008,FRANCISCO SARABIA,1,7,4,3,1
TABASCO,27,HUIMANGUILLO,008,FRANCISCO TRUJILLO GURRÍA,2,10,3,7,2
TABASCO,27,HUIMANGUILLO,008,FRANCISCO VILLA,3,61,24,37,3
TABASCO,27,HUIMANGUILLO,008,GILBERTO FLORES MUÑOZ,3,132,69,63,6
TABASCO,27,HUIMANGUILLO,008,GILBERTO FLORES MUÑOZ 2DA. SECCIÓN,2,13,7,6,2
TABASCO,27,HUIMANGUILLO,008,GREGORIO MÉNDEZ MAGAÑA,3,62,28,34,4
TABASCO,27,HUIMANGUILLO,008,GUADALUPE VICTORIA,4,379,193,186,18
TABASCO,27,HUIMANGUILLO,008,GUERRERO,2,39,20,19,2
TABASCO,27,HUIMANGUILLO,008,GÜIRAL Y GONZÁLEZ 1RA. SECCIÓN,3,198,103,95,9
TABASCO,27,HUIMANGUILLO,008,GÜIRAL Y GONZÁLEZ 2DA. SECCIÓN,2,60,25,35,4
TABASCO,27,HUIMANGUILLO,008,GUSTAVO DÍAZ ORDAZ 1RA. SECCIÓN,3,66,30,36,4
TABASCO,27,HUIMANGUILLO,008,GUSTAVO DÍAZ ORDAZ 2DA. SECCIÓN,2,44,12,32,3
TABASCO,27,HUIMANGUILLO,008,GUSTAVO DÍAZ ORDAZ 3RA. SECCIÓN,3,109,52,57,7
TABASCO,27,HUIMANGUILLO,008,HUAPACAL 1RA. SECCIÓN,4,602,306,296,22
TABASCO,27,HUIMANGUILLO,008,HUAPACAL 2DA. SECCIÓN,4,157,71,86,8
TABASCO,27,HUIMANGUILLO,008,HUIMANGUILLO,47,10289,5360,4929,592
TABASCO,27,HUIMANGUILLO,008,IGNACIO ALLENDE,1,15,8,7,1
TABASCO,27,HUIMANGUILLO,008,IGNACIO ALLENDE (CHAPINGO),2,24,13,11,3
TABASCO,27,HUIMANGUILLO,008,IGNACIO GUTIÉRREZ 1RA. SECCIÓN,3,172,79,93,6
TABASCO,27,HUIMANGUILLO,008,IGNACIO GUTIÉRREZ 2DA. SECCIÓN,2,120,47,73,4
TABASCO,27,HUIMANGUILLO,008,IGNACIO GUTIÉRREZ 3RA. SECCIÓN,2,104,54,50,4
TABASCO,27,HUIMANGUILLO,008,IGNACIO GUTIÉRREZ 4TA. SECCIÓN,3,55,26,29,5
TABASCO,27,HUIMANGUILLO,008,IGNACIO GUTIÉRREZ 5TA. SECCIÓN,2,97,39,58,4
TABASCO,27,HUIMANGUILLO,008,JOSÉ MARÍA MORELOS Y PAVÓN,4,265,139,126,13
TABASCO,27,HUIMANGUILLO,008,JOSÉ MARÍA PINO SUÁREZ,3,80,41,39,5
TABASCO,27,HUIMANGUILLO,008,JOSÉ MARÍA PINO SUÁREZ 1RA. SECCIÓN,5,273,144,129,16
TABASCO,27,HUIMANGUILLO,008,JOSÉ MARÍA PINO SUÁREZ 2DA. SECCIÓN,1,23,10,13,1
TABASCO,27,HUIMANGUILLO,008,JOSÉ MERCEDES GAMAS 1RA. SECCIÓN,3,233,119,114,9
TABASCO,27,HUIMANGUILLO,008,JOSÉ MERCEDES GAMAS 2DA. SECCIÓN,3,62,38,24,5
TABASCO,27,HUIMANGUILLO,008,JOSÉ NARCISO ROVIROSA,3,88,39,49,5
TABASCO,27,HUIMANGUILLO,008,LA ARENA 1RA. SECCIÓN,1,14,10,4,2
TABASCO,27,HUIMANGUILLO,008,LA ARENA 2DA. SECCIÓN,3,114,61,53,5
TABASCO,27,HUIMANGUILLO,008,LA CANDELARIA,4,173,82,91,9
TABASCO,27,HUIMANGUILLO,008,LA CEIBA 1RA. SECCIÓN,1,15,6,9,1
TABASCO,27,HUIMANGUILLO,008,LA CEIBA 1RA. SECCIÓN (RUIZ CORTÍNES),2,41,19,22,2
TABASCO,27,HUIMANGUILLO,008,LA CEIBA 2DA. SECCIÓN,3,112,57,55,6
TABASCO,27,HUIMANGUILLO,008,LA ESPERANZA,3,170,82,88,8
TABASCO,27,HUIMANGUILLO,008,LA FLORIDA,2,8,6,2,1
TABASCO,27,HUIMANGUILLO,008,LA LUCHA,2,85,42,43,4
TABASCO,27,HUIMANGUILLO,008,LA LUZ,2,90,40,50,4
TABASCO,27,HUIMANGUILLO,008,LA SOLEDAD 1RA. SECCIÓN,2,21,12,9,2
TABASCO,27,HUIMANGUILLO,008,LA TRINIDAD,3,46,22,24,5
TABASCO,27,HUIMANGUILLO,008,LA VENCEDORA,2,65,33,32,3
TABASCO,27,HUIMANGUILLO,008,LA VENTA,16,3902,1824,2078,185
TABASCO,27,HUIMANGUILLO,008,LAGUNA DE LOS LIMONES,2,64,34,30,4
TABASCO,27,HUIMANGUILLO,008,LAS FLORES,4,135,51,84,14
TABASCO,27,HUIMANGUILLO,008,LAS GRANJAS,2,32,13,19,2
TABASCO,27,HUIMANGUILLO,008,LAS PIEDRAS,2,43,21,22,3
TABASCO,27,HUIMANGUILLO,008,LÁZARO CÁRDENAS DEL RÍO,3,78,43,35,4
TABASCO,27,HUIMANGUILLO,008,LIBERTAD,4,800,392,408,97
TABASCO,27,HUIMANGUILLO,008,LICENCIADO ANTONIO ZAMORA ARRIOJA,2,74,38,36,3
TABASCO,27,HUIMANGUILLO,008,LOS NARANJOS,2,20,15,5,2
TABASCO,27,HUIMANGUILLO,008,LOS NARANJOS 1RA. SECCIÓN (CAMPECHITO),3,376,183,193,15
TABASCO,27,HUIMANGUILLO,008,LOS NARANJOS 2DA. SECCIÓN,2,63,29,34,3
TABASCO,27,HUIMANGUILLO,008,LOS NARANJOS 3RA. SECCIÓN,2,9,1,8,2
TABASCO,27,HUIMANGUILLO,008,LOS NARANJOS 4TA. SECCIÓN,1,4,2,2,1
TABASCO,27,HUIMANGUILLO,008,MACAYO Y NARANJO 1RA. SECCIÓN,2,73,38,35,3
TABASCO,27,HUIMANGUILLO,008,MACAYO Y NARANJO 2DA. SECCIÓN,3,127,67,60,6
TABASCO,27,HUIMANGUILLO,008,MACAYO Y NARANJO 3RA. SECCIÓN (SAN AGUSTÍN),2,40,17,23,3
TABASCO,27,HUIMANGUILLO,008,MALPASITO,3,112,60,52,6
TABASCO,27,HUIMANGUILLO,008,MANUEL ANDRADE DÍAZ,3,48,22,26,3
TABASCO,27,HUIMANGUILLO,008,MANUEL SÁNCHEZ MÁRMOL,4,199,104,95,10
TABASCO,27,HUIMANGUILLO,008,MARCELINO INORRUETA DE LA FUENTE,3,100,47,53,5
TABASCO,27,HUIMANGUILLO,008,MECATEPEC,3,604,311,293,31
TABASCO,27,HUIMANGUILLO,008,MIGUEL ALEMÁN VALDEZ,1,61,28,33,3
TABASCO,27,HUIMANGUILLO,008,MIGUEL HIDALGO Y COSTILLA,2,71,31,40,3
TABASCO,27,HUIMANGUILLO,008,MONTE DE ORO 1RA. SECCIÓN,3,480,238,242,20
TABASCO,27,HUIMANGUILLO,008,MONTE DE ORO 2DA. SECCIÓN,2,116,45,71,5
TABASCO,27,HUIMANGUILLO,008,MONTE DE ORO 3RA. SECCIÓN,2,54,26,28,4
TABASCO,27,HUIMANGUILLO,008,NUEVO MÉXICO,3,24,10,14,2
TABASCO,27,HUIMANGUILLO,008,NUEVO PROGRESO,3,141,79,62,6
TABASCO,27,HUIMANGUILLO,008,OCUAPAN,6,951,446,505,39
TABASCO,27,HUIMANGUILLO,008,OSTITÁN 1RA. SECCIÓN,2,87,48,39,4
TABASCO,27,HUIMANGUILLO,008,OSTITÁN 2DA. SECCIÓN,3,214,109,105,9
TABASCO,27,HUIMANGUILLO,008,OTRA BANDA 1RA. SECCIÓN,1,51,26,25,2
TABASCO,27,HUIMANGUILLO,008,OTRA BANDA 2DA. SECCIÓN,5,315,155,160,13
TABASCO,27,HUIMANGUILLO,008,OTRA BANDA 3RA. SECCIÓN,1,14,5,9,1
TABASCO,27,HUIMANGUILLO,008,PALO MULATO (ZAPOTAL),5,1106,555,551,65
TABASCO,27,HUIMANGUILLO,008,PAREDÓN 1RA. SECCIÓN,3,185,94,91,7
TABASCO,27,HUIMANGUILLO,008,PAREDÓN 1RA. SECCIÓN (EL PORVENIR),2,23,9,14,2
TABASCO,27,HUIMANGUILLO,008,PAREDÓN 1RA. SECCIÓN (LA ISLA),2,27,10,17,2
TABASCO,27,HUIMANGUILLO,008,PAREDÓN 2DA. SECCIÓN,2,62,26,36,3
TABASCO,27,HUIMANGUILLO,008,PAREDÓN 3RA. SECCIÓN,2,14,8,6,1
TABASCO,27,HUIMANGUILLO,008,PASO DE LA MINA 1RA. SECCIÓN,5,309,135,174,13
TABASCO,27,HUIMANGUILLO,008,PASO DE LA MINA 2DA. SECCIÓN (BARRIAL),6,641,323,318,22
TABASCO,27,HUIMANGUILLO,008,PASO DE LA MINA 3RA. SECCIÓN,2,270,127,143,10
TABASCO,27,HUIMANGUILLO,008,PASO DEL ROSARIO,2,83,47,36,4
TABASCO,27,HUIMANGUILLO,008,PEDREGAL MOCTEZUMA 1RA. SECCIÓN,4,178,84,94,9
TABASCO,27,HUIMANGUILLO,008,PEDREGAL MOCTEZUMA 2DA. SECCIÓN,2,57,25,32,3
TABASCO,27,HUIMANGUILLO,008,PEDREGAL MOCTEZUMA 2DA. SECCIÓN (LEYVA),3,172,81,91,8
TABASCO,27,HUIMANGUILLO,008,PEDREGALITO 1RA. SECCIÓN,2,71,27,44,3
TABASCO,27,HUIMANGUILLO,008,PEDREGALITO 1RA. SECCIÓN (VICENTE GUERRERO),2,27,10,17,2
TABASCO,27,HUIMANGUILLO,008,PEDRO C. COLORADO 1RA. SECCIÓN,1,24,8,16,1
TABASCO,27,HUIMANGUILLO,008,PEDRO C. COLORADO 3RA. SECCIÓN,1,11,6,5,1
TABASCO,27,HUIMANGUILLO,008,PEJELAGARTERO 1RA. SECCIÓN (CHICHONAL),3,39,24,15,3
TABASCO,27,HUIMANGUILLO,008,PEJELAGARTERO 1RA. SECCIÓN (EL ARROYITO),2,77,42,35,4
TABASCO,27,HUIMANGUILLO,008,PEJELAGARTERO 1RA. SECCIÓN (EL FILERO),2,16,9,7,2
TABASCO,27,HUIMANGUILLO,008,PEJELAGARTERO 1RA. SECCIÓN (GPE. VICTORIA),2,70,28,42,4
TABASCO,27,HUIMANGUILLO,008,PEJELAGARTERO 1RA. SECCIÓN (LOS PINOS),3,353,181,172,14
TABASCO,27,HUIMANGUILLO,008,PEJELAGARTERO 1RA. SECCIÓN (NUEVO PROGRESO),2,96,34,62,5
TABASCO,27,HUIMANGUILLO,008,PEJELAGARTERO 1RA. SECCIÓN (PLATAFORMA),4,580,286,294,23
TABASCO,27,HUIMANGUILLO,008,PEJELAGARTERO 2DA. SECCIÓN,5,290,123,167,14
TABASCO,27,HUIMANGUILLO,008,PEJELAGARTERO 2DA. SECCIÓN (JAHUACTE),2,22,12,10,2
TABASCO,27,HUIMANGUILLO,008,PEJELAGARTERO 2DA. SECCIÓN (NUEVA REFORMA),2,19,8,11,2
TABASCO,27,HUIMANGUILLO,008,PICO DE ORO 1RA. SECCIÓN,6,297,132,165,14
TABASCO,27,HUIMANGUILLO,008,PICO DE ORO 3RA. SECCIÓN,2,100,55,45,4
TABASCO,27,HUIMANGUILLO,008,PICO DE ORO 4TA. SECCIÓN (PEJELAGARTERITO),2,101,43,58,4
TABASCO,27,HUIMANGUILLO,008,RAFAEL MARTÍNEZ DE ESCOBAR,2,39,19,20,3
TABASCO,27,HUIMANGUILLO,008,RANCHO ALEGRE,2,28,14,14,2
TABASCO,27,HUIMANGUILLO,008,RANCHO NUEVO,2,19,12,7,1
TABASCO,27,HUIMANGUILLO,008,RÍO PEDREGAL,2,32,14,18,2
TABASCO,27,HUIMANGUILLO,008,RÍO SECO Y MONTAÑA 1RA. SECCIÓN,3,112,55,57,5
TABASCO,27,HUIMANGUILLO,008,RÍO SECO Y MONTAÑA 2DA. SECCIÓN,10,478,215,263,21
TABASCO,27,HUIMANGUILLO,008,RÍO SECO Y MONTAÑA 3RA. SECCIÓN (AMPLIACIÓN),1,33,14,19,2
TABASCO,27,HUIMANGUILLO,008,RÍO SECO Y MONTAÑA 3RA. SECCIÓN (CHINAL),3,225,105,120,11
TABASCO,27,HUIMANGUILLO,008,ROBERTO MADRAZO PINTADO,3,54,26,28,4
TABASCO,27,HUIMANGUILLO,008,SAMARIA,1,51,24,27,2
TABASCO,27,HUIMANGUILLO,008,SAN FERNANDO,2,159,90,69,7
TABASCO,27,HUIMANGUILLO,008,SAN MANUEL,4,494,254,240,24
TABASCO,27,HUIMANGUILLO,008,SAN MANUEL TENERIFE,2,164,78,86,7
TABASCO,27,HUIMANGUILLO,008,TECOMINOACÁN,4,805,383,422,31
TABASCO,27,HUIMANGUILLO,008,TEMBLADERA (PASO VIEJO),2,5,0,5,2
TABASCO,27,HUIMANGUILLO,008,TIERRA COLORADA 1RA. SECCIÓN,3,146,66,80,7
TABASCO,27,HUIMANGUILLO,008,TIERRA COLORADA 2DA. SECCIÓN (SILBARÁN),2,68,35,33,3
TABASCO,27,HUIMANGUILLO,008,TIERRA COLORADA 3RA. SECCIÓN,2,88,46,42,4
TABASCO,27,HUIMANGUILLO,008,TIERRA COLORADA 4TA. SECCIÓN,2,10,5,5,1
TABASCO,27,HUIMANGUILLO,008,TIERRA NUEVA 1RA. SECCIÓN,3,103,56,47,5
TABASCO,27,HUIMANGUILLO,008,TIERRA NUEVA 1RA. SECCIÓN (LAS PALMAS),2,125,65,60,5
TABASCO,27,HUIMANGUILLO,008,TIERRA NUEVA 2DA. SECCIÓN,3,400,204,196,15
TABASCO,27,HUIMANGUILLO,008,TIERRA NUEVA 3RA. SECCIÓN,4,671,328,343,27
TABASCO,27,HUIMANGUILLO,008,TIERRA NUEVA 4TA. SECCIÓN,3,134,73,61,6
TABASCO,27,HUIMANGUILLO,008,TRES BOCAS 1RA. SECCIÓN,3,253,125,128,12
TABASCO,27,HUIMANGUILLO,008,TRES BOCAS 2DA. SECCIÓN (EL ZAPOTAL),2,109,57,52,6
TABASCO,27,HUIMANGUILLO,008,TRES BOCAS 3RA. SECCIÓN,3,204,91,113,14
TABASCO,27,HUIMANGUILLO,008,UNIDAD MODELO SÁBANA LARGA,2,33,12,21,2
TABASCO,27,HUIMANGUILLO,008,VENUSTIANO CARRANZA,3,96,52,44,6
TABASCO,27,HUIMANGUILLO,008,VIEJA GUARDIA AGRARISTA,2,30,22,8,2
TABASCO,27,HUIMANGUILLO,008,VILLA DE GUADALUPE,2,38,19,19,3
TABASCO,27,HUIMANGUILLO,008,VILLA FLORES 1RA. SECCIÓN,2,241,119,122,9
TABASCO,27,HUIMANGUILLO,008,VILLA FLORES 2DA. SECCIÓN,2,86,41,45,3
TABASCO,27,HUIMANGUILLO,008,ZANAPA 1RA. SECCIÓN,4,210,97,113,12
TABASCO,27,HUIMANGUILLO,008,ZANAPA 2DA. SECCIÓN (EL TUMBO),2,63,23,40,4
TABASCO,27,HUIMANGUILLO,008,ZAPOTAL 1RA. SECCIÓN (SAN MIGUEL),3,448,212,236,18
TABASCO,27,HUIMANGUILLO,008,ZAPOTAL 3RA. SECCIÓN (EL CORCHAL),2,54,35,19,3
TABASCO,27,HUIMANGUILLO,008,ZAPOTAL 4TA. SECCIÓN (ZAPOTALITO),2,107,50,57,5
TABASCO,27,HUIMANGUILLO,008,ZAPOTAL 5TA. SECCIÓN,3,129,61,68,6
TABASCO,27,HUIMANGUILLO,008,ZAPOTAL SAN MIGUEL 1RA. SECCIÓN RAMAL UNO,2,39,13,26,4
TABASCO,27,JALAPA,009,AQUILES SERDÁN 1RA. SECCIÓN,4,534,251,283,23
TABASCO,27,JALAPA,009,AQUILES SERDÁN 2DA. SECCIÓN,2,81,45,36,4
TABASCO,27,JALAPA,009,AQUILES SERDÁN 3RA. SECCIÓN (SAN ROMÁN),3,178,83,95,8
TABASCO,27,JALAPA,009,AQUILES SERDÁN 4TA. SECCIÓN,2,46,21,25,3
TABASCO,27,JALAPA,009,AQUILES SERDÁN 5TA. SECCIÓN,2,23,9,14,2
TABASCO,27,JALAPA,009,ASTAPA,3,233,110,123,10
TABASCO,27,JALAPA,009,BENITO GONZÁLEZ,3,532,260,272,22
TABASCO,27,JALAPA,009,CALICANTO (RINCONADA),1,8,6,2,1
TABASCO,27,JALAPA,009,CALICANTO 1RA. SECCIÓN,2,51,24,27,3
TABASCO,27,JALAPA,009,CALICANTO 2DA. SECCIÓN,3,158,70,88,7
TABASCO,27,JALAPA,009,CALICANTO 3RA. SECCIÓN,3,41,18,23,3
TABASCO,27,JALAPA,009,CHICHONAL 1RA. SECCIÓN,5,281,146,135,15
TABASCO,27,JALAPA,009,CHICHONAL 2DA. SECCIÓN,2,41,21,20,3
TABASCO,27,JALAPA,009,CHICHONAL 3RA. SECCIÓN (LA CAPILLA),2,78,36,42,4
TABASCO,27,JALAPA,009,CHIPILINAR 1RA. SECCIÓN,3,226,123,103,11
TABASCO,27,JALAPA,009,CHIPILINAR 1RA. SECCIÓN LA LIMA,1,7,5,2,1
TABASCO,27,JALAPA,009,CHIPILINAR 2DA. SECCIÓN (CONTRERAS),2,69,37,32,3
TABASCO,27,JALAPA,009,CHIPILINAR 3RA. SECCIÓN,2,141,73,68,5
TABASCO,27,JALAPA,009,CHIPILINAR 4TA. SECCIÓN,2,78,39,39,4
TABASCO,27,JALAPA,009,EL DORADO,2,53,26,27,3
TABASCO,27,JALAPA,009,EMILIANO ZAPATA,2,99,43,56,4
TABASCO,27,JALAPA,009,FRANCISCO J. SANTAMARÍA (CACAO),4,841,378,463,61
TABASCO,27,JALAPA,009,GUANAL 1RA. SECCIÓN,2,103,45,58,5
TABASCO,27,JALAPA,009,GUANAL 2DA. SECCIÓN,3,190,79,111,8
TABASCO,27,JALAPA,009,GUANAL 3RA. SECCIÓN (GUANALITO),2,88,43,45,3
TABASCO,27,JALAPA,009,HUAPACAL 1RA. SECCIÓN,2,47,23,24,3
TABASCO,27,JALAPA,009,HUAPACAL 2DA. SECCIÓN,2,14,5,9,2
TABASCO,27,JALAPA,009,JAHUACAPA,2,33,16,17,2
TABASCO,27,JALAPA,009,JALAPA,13,2156,1053,1103,100
TABASCO,27,JALAPA,009,LA UNIÓN (CLAVO DE LA VICTORIA),1,25,12,13,1
TABASCO,27,JALAPA,009,LOMAS DE VIDAL,2,52,23,29,2
TABASCO,27,JALAPA,009,MÉRIDA Y GUARUMO,1,17,9,8,1
TABASCO,27,JALAPA,009,MONTAÑA,4,77,32,45,5
TABASCO,27,JALAPA,009,PROGRESO,2,25,14,11,2
TABASCO,27,JALAPA,009,PUYACATENGO SUR,1,10,2,8,1
TABASCO,27,JALAPA,009,SAN JUAN EL ALTO 1RA. SECCIÓN,2,59,32,27,3
TABASCO,27,JALAPA,009,SAN JUAN EL ALTO 2DA. SECCIÓN,3,238,118,120,11
TABASCO,27,JALAPA,009,SAN MARCOS,2,68,32,36,3
TABASCO,27,JALAPA,009,SAN MIGUEL ADENTRO 1RA. SECCIÓN,2,80,40,40,4
TABASCO,27,JALAPA,009,SAN MIGUEL ADENTRO 2DA. SECCIÓN,2,54,22,32,3
TABASCO,27,JALAPA,009,SAN MIGUEL AFUERA,6,721,339,382,27
TABASCO,27,JALAPA,009,SANTO DOMINGO 1RA. SECCIÓN (EL LLANO),2,69,31,38,3
TABASCO,27,JALAPA,009,TEQUILA,2,53,34,19,3
TABASCO,27,JALAPA,009,TEQUILA 1RA. SECCIÓN (LA AURORA),3,566,270,296,37
TABASCO,27,JALAPA,009,TEQUILA 2DA. SECCIÓN,2,34,16,18,2
TABASCO,27,JALAPA,009,TEQUILA 3RA. SECCIÓN (INDEPENDENCIA),2,33,22,11,2
TABASCO,27,JALAPA,009,VÍCTOR FERNÁNDEZ MANERO 2DA. SECCIÓN (SAN MIGUEL),4,255,119,136,12
TABASCO,27,JALAPA,009,VÍCTOR FERNÁNDEZ MANERO 3RA. SECCIÓN (SAN ISIDRO),2,46,21,25,3
TABASCO,27,JALPA DE MÉNDEZ,010,AMATITÁN,2,384,193,191,16
TABASCO,27,JALPA DE MÉNDEZ,010,AYAPA,12,2238,1085,1153,77
TABASCO,27,JALPA DE MÉNDEZ,010,BENITO JUÁREZ 1RA. SECCIÓN,2,148,77,71,6
TABASCO,27,JALPA DE MÉNDEZ,010,BENITO JUÁREZ 2DA. SECCIÓN,4,698,323,375,27
TABASCO,27,JALPA DE MÉNDEZ,010,BENITO JUÁREZ 3RA. SECCIÓN,2,178,87,91,8
TABASCO,27,JALPA DE MÉNDEZ,010,BOQUIAPA,2,210,114,96,8
TABASCO,27,JALPA DE MÉNDEZ,010,CHACALAPA 1RA. SECCIÓN,3,401,172,229,17
TABASCO,27,JALPA DE MÉNDEZ,010,CHACALAPA 2DA. SECCIÓN (SAN MANUEL),2,133,55,78,6
TABASCO,27,JALPA DE MÉNDEZ,010,EL CAMPO PETROLERO MECOACÁN,2,98,43,55,5
TABASCO,27,JALPA DE MÉNDEZ,010,EL CARMEN,2,112,60,52,4
TABASCO,27,JALPA DE MÉNDEZ,010,EL JUNCAL,2,43,30,13,2
TABASCO,27,JALPA DE MÉNDEZ,010,EL NOVILLERO,2,100,49,51,4
TABASCO,27,JALPA DE MÉNDEZ,010,EL PÚLPITO,2,65,33,32,4
TABASCO,27,JALPA DE MÉNDEZ,010,EL RECREO,3,200,96,104,9
TABASCO,27,JALPA DE MÉNDEZ,010,EL RÍO,2,394,201,193,15
TABASCO,27,JALPA DE MÉNDEZ,010,GREGORIO MÉNDEZ,3,420,206,214,16
TABASCO,27,JALPA DE MÉNDEZ,010,HERMENEGILDO GALEANA 1RA. SECCIÓN,2,224,116,108,8
TABASCO,27,JALPA DE MÉNDEZ,010,HERMENEGILDO GALEANA 2DA. SECCIÓN,4,733,353,380,35
TABASCO,27,JALPA DE MÉNDEZ,010,HUAPACAL 1RA. SECCIÓN,4,303,154,149,13
TABASCO,27,JALPA DE MÉNDEZ,010,HUAPACAL 2DA. SECCIÓN (PUNTA BRAVA),5,380,172,208,16
TABASCO,27,JALPA DE MÉNDEZ,010,IQUINUAPA,4,682,310,372,52
TABASCO,27,JALPA DE MÉNDEZ,010,IQUINUAPA (EL CLAVO),2,362,177,185,14
TABASCO,27,JALPA DE MÉNDEZ,010,JALPA DE MÉNDEZ,23,6666,3432,3234,382
TABASCO,27,JALPA DE MÉNDEZ,010,JALUPA,5,1413,677,736,58
TABASCO,27,JALPA DE MÉNDEZ,010,LA CEIBA,2,104,40,64,5
TABASCO,27,JALPA DE MÉNDEZ,010,LA CONCEPCIÓN,2,84,41,43,3
TABASCO,27,JALPA DE MÉNDEZ,010,LA CRUZ,2,230,103,127,8
TABASCO,27,JALPA DE MÉNDEZ,010,LA ENSENADA,2,21,14,7,2
TABASCO,27,JALPA DE MÉNDEZ,010,LA PERA,2,626,309,317,24
TABASCO,27,JALPA DE MÉNDEZ,010,LA TRINIDAD,2,214,97,117,8
TABASCO,27,JALPA DE MÉNDEZ,010,MECOACÁN,3,798,383,415,27
TABASCO,27,JALPA DE MÉNDEZ,010,MECOACÁN 2DA. SECCIÓN (SAN LORENZO),5,734,368,366,27
TABASCO,27,JALPA DE MÉNDEZ,010,NABOR CORNELIO ÁLVAREZ,3,98,44,54,4
TABASCO,27,JALPA DE MÉNDEZ,010,NICOLÁS BRAVO,4,459,212,247,18
TABASCO,27,JALPA DE MÉNDEZ,010,PUEBLO VIEJO,2,215,106,109,9
TABASCO,27,JALPA DE MÉNDEZ,010,REFORMA 1RA. SECCIÓN,2,96,48,48,5
TABASCO,27,JALPA DE MÉNDEZ,010,REFORMA 2DA. SECCIÓN (SANTA MARÍA),3,424,201,223,15
TABASCO,27,JALPA DE MÉNDEZ,010,REFORMA 3RA. SECCIÓN (EL GUANO),2,104,47,57,4
TABASCO,27,JALPA DE MÉNDEZ,010,RIBERA ALTA,3,1026,608,418,69
TABASCO,27,JALPA DE MÉNDEZ,010,SAN HIPÓLITO,2,124,55,69,5
TABASCO,27,JALPA DE MÉNDEZ,010,SAN NICOLÁS,2,72,34,38,3
TABASCO,27,JALPA DE MÉNDEZ,010,SANTA LUCÍA,2,191,100,91,8
TABASCO,27,JALPA DE MÉNDEZ,010,SANTUARIO 1RA. SECCIÓN,2,103,59,44,5
TABASCO,27,JALPA DE MÉNDEZ,010,SANTUARIO 2DA. SECCIÓN,3,256,128,128,10
TABASCO,27,JALPA DE MÉNDEZ,010,SOYATACO,6,1867,860,1007,121
TABASCO,27,JALPA DE MÉNDEZ,010,TIERRA ADENTRO 1RA. SECCIÓN,4,323,147,176,15
TABASCO,27,JALPA DE MÉNDEZ,010,TIERRA ADENTRO 2DA. SECCIÓN,2,94,39,55,5
TABASCO,27,JALPA DE MÉNDEZ,010,TIERRA ADENTRO 3RA. SECCIÓN (EL VIGÍA),1,11,5,6,1
TABASCO,27,JALPA DE MÉNDEZ,010,TIERRAS PELEADAS (TIERRAS AMIGAS),1,24,11,13,1
TABASCO,27,JALPA DE MÉNDEZ,010,VICENTE GUERRERO 1RA. SECCIÓN,4,806,406,400,29
TABASCO,27,JALPA DE MÉNDEZ,010,VICENTE GUERRERO 2DA. SECCIÓN,2,79,38,41,3
TABASCO,27,JONUTA,011,BOCA DE SAN ANTONIO,4,165,74,91,8
TABASCO,27,JONUTA,011,BOCA DE SAN GERÓNIMO,4,367,199,168,17
TABASCO,27,JONUTA,011,BOCA DE SAN GERÓNIMO (SAN GERÓNIMO),2,20,10,10,2
TABASCO,27,JONUTA,011,CAMPO NUEVO,3,48,21,27,3
TABASCO,27,JONUTA,011,CARLOS PELLICER CÁMARA (BAJO AMATITÁN),1,21,13,8,1
TABASCO,27,JONUTA,011,CHANERO,2,58,25,33,3
TABASCO,27,JONUTA,011,CHANERO RÍO,2,6,4,2,1
TABASCO,27,JONUTA,011,CHINAL,2,59,35,24,3
TABASCO,27,JONUTA,011,CIRILO Y NARVÁEZ,1,5,2,3,1
TABASCO,27,JONUTA,011,COCOYOLAR (RÍO CHICO),2,22,13,9,2
TABASCO,27,JONUTA,011,CONSTITUCIÓN DE 1917 (JONUTILLA),4,134,76,58,6
TABASCO,27,JONUTA,011,CORCOBAO,2,6,3,3,1
TABASCO,27,JONUTA,011,COROZAL,3,155,72,83,7
TABASCO,27,JONUTA,011,COROZAL RÍO,1,8,5,3,1
TABASCO,27,JONUTA,011,CUYO DE GUADALUPE,2,45,25,20,2
TABASCO,27,JONUTA,011,EL AGUACATAL,2,32,15,17,2
TABASCO,27,JONUTA,011,EL BAJÍO (EL CARIBAL),2,11,7,4,2
TABASCO,27,JONUTA,011,EL BARRIAL,2,112,52,60,5
TABASCO,27,JONUTA,011,EL BARRIALITO (EL PICHAL),3,20,7,13,3
TABASCO,27,JONUTA,011,EL BEJUCAL,3,115,50,65,6
TABASCO,27,JONUTA,011,EL CAOBA,2,10,2,8,2
TABASCO,27,JONUTA,011,EL CHOCHAL,3,20,12,8,2
TABASCO,27,JONUTA,011,EL PIÑAL,2,14,7,7,2
TABASCO,27,JONUTA,011,EL PORVENIR 1RA. SECCIÓN,2,71,37,34,3
TABASCO,27,JONUTA,011,EL SACRIFICIO,2,135,60,75,5
TABASCO,27,JONUTA,011,EL SITIO,2,29,13,16,3
TABASCO,27,JONUTA,011,EL TUCUYAL,2,18,11,7,2
TABASCO,27,JONUTA,011,ELPIDIO SÁNCHEZ,2,39,18,21,3
TABASCO,27,JONUTA,011,ESPERANZA,5,51,24,27,5
TABASCO,27,JONUTA,011,ESQUIPULAS,3,70,42,28,4
TABASCO,27,JONUTA,011,FEDERICO ÁLVAREZ 1RA. SECCIÓN A,1,47,21,26,3
TABASCO,27,JONUTA,011,FEDERICO ÁLVAREZ 1RA. SECCIÓN B,2,72,41,31,3
TABASCO,27,JONUTA,011,FEDERICO ÁLVAREZ 2DA. SECCIÓN,1,4,1,3,1
TABASCO,27,JONUTA,011,FRANCISCO J. MÚJICA,2,31,17,14,2
TABASCO,27,JONUTA,011,GUARDA TIERRA,2,59,30,29,3
TABASCO,27,JONUTA,011,GÜIRO ARRANCADO,4,76,33,43,5
TABASCO,27,JONUTA,011,HIDALGO Y TAMARINDO,3,29,18,11,3
TABASCO,27,JONUTA,011,ISLA HELVA DE GUADALUPE,3,29,16,13,3
TABASCO,27,JONUTA,011,JONUTA,11,2265,1117,1148,116
TABASCO,27,JONUTA,011,JOSÉ MARÍA PINO SUÁREZ (SAN PEDRO),4,255,117,138,12
TABASCO,27,JONUTA,011,LA FRUTILLA,2,15,4,11,2
TABASCO,27,JONUTA,011,LA GUAYABA (ALTO AMATITÁN),4,241,114,127,11
TABASCO,27,JONUTA,011,LAS PALMAS,2,10,4,6,1
TABASCO,27,JONUTA,011,LAS PETRONAS,3,52,30,22,3
TABASCO,27,JONUTA,011,LAS PUERCAS (PLAYA LARGA 3RA. SECCIÓN),2,12,6,6,1
TABASCO,27,JONUTA,011,LÁZARO CÁRDENAS,3,24,12,12,3
TABASCO,27,JONUTA,011,LOS BUCHECOS,2,41,22,19,2
TABASCO,27,JONUTA,011,LOS GILES,2,28,16,12,2
TABASCO,27,JONUTA,011,LOS PÁJAROS,4,309,135,174,12
TABASCO,27,JONUTA,011,LOS PÁJAROS (EL PORVENIR),3,23,8,15,3
TABASCO,27,JONUTA,011,MONTE GRANDE,6,860,413,447,37
TABASCO,27,JONUTA,011,MONTE GRANDE (EL PASTAL),2,15,7,8,2
TABASCO,27,JONUTA,011,MONTE GRANDE (NUEVO MUNDO),2,8,5,3,1
TABASCO,27,JONUTA,011,PLAYA CHIQUITA 1RA. SECCIÓN A,3,162,81,81,9
TABASCO,27,JONUTA,011,PLAYA CHIQUITA EL CUYO,1,15,5,10,1
TABASCO,27,JONUTA,011,PLAYA LARGA,4,438,213,225,17
TABASCO,27,JONUTA,011,PRUDENCIO LÓPEZ ARIAS,2,10,2,8,2
TABASCO,27,JONUTA,011,PUEBLO NUEVO,3,108,57,51,6
TABASCO,27,JONUTA,011,RIBERA BAJA 1RA. SECCIÓN A,2,53,21,32,3
TABASCO,27,JONUTA,011,RIBERA BAJA 1RA. SECCIÓN B,2,8,3,5,1
TABASCO,27,JONUTA,011,SAN CRISTÓBAL,2,49,28,21,3
TABASCO,27,JONUTA,011,SAN GERONIMITO,2,29,11,18,2
TABASCO,27,JONUTA,011,SAN JOSÉ,4,393,206,187,15
TABASCO,27,JONUTA,011,SAN MIGUEL,1,10,2,8,1
TABASCO,27,JONUTA,011,SANTA RITA 1RA. SECCIÓN,4,147,70,77,9
TABASCO,27,JONUTA,011,SANTA RITA 2DA. SECCIÓN,2,41,19,22,2
TABASCO,27,JONUTA,011,TOMÁS GARRIDO CANABAL (EL RINCÓN),2,5,2,3,1
TABASCO,27,JONUTA,011,TORNO DE LA BOLA,2,15,7,8,2
TABASCO,27,JONUTA,011,TORNO LARGO 1RA. SECCIÓN (EL GÜIRAL),2,76,44,32,4
TABASCO,27,JONUTA,011,TORNO LARGO 1RA. SECCIÓN A (BENITO JUÁREZ),5,245,123,122,11
TABASCO,27,JONUTA,011,TORNO LARGO 1RA. SECCIÓN B,1,15,6,9,1
TABASCO,27,JONUTA,011,TORNO LARGO 2DA. SECCIÓN,4,200,92,108,10
TABASCO,27,JONUTA,011,TORNO LARGO 3RA. SECCIÓN,1,10,7,3,1
TABASCO,27,JONUTA,011,TRINIDAD Y CATALINA 1RA. SECCIÓN,5,39,20,19,5
TABASCO,27,JONUTA,011,TRINIDAD Y CATALINA 2DA. SECCIÓN,1,21,12,9,1
TABASCO,27,JONUTA,011,TRINIDAD Y CATALINA 3RA. SECCIÓN,1,15,8,7,2
TABASCO,27,JONUTA,011,TUMBO CHINAL,2,15,10,5,2
TABASCO,27,JONUTA,011,VENUSTIANO CARRANZA (EL PAJONAL),2,65,30,35,3
TABASCO,27,JONUTA,011,ZAPOTAL 1RA. SECCIÓN B,6,197,99,98,11
TABASCO,27,JONUTA,011,ZAPOTAL 2DA. SECCIÓN,2,59,26,33,3
TABASCO,27,MACUSPANA,012,ABASOLO,2,214,102,112,9
TABASCO,27,MACUSPANA,012,ABASOLO 1RA. SECCIÓN,2,39,25,14,2
TABASCO,27,MACUSPANA,012,ABASOLO 2DA. SECCIÓN,2,57,30,27,4
TABASCO,27,MACUSPANA,012,ADOLFO LÓPEZ MATEOS (CORRAL NUEVO),2,80,34,46,4
TABASCO,27,MACUSPANA,012,ALCALDE MAYOR,4,309,146,163,15
TABASCO,27,MACUSPANA,012,ALLENDE ALTO 1RA. SECCIÓN,2,27,14,13,2
TABASCO,27,MACUSPANA,012,ALLENDE BAJO 1RA. SECCIÓN (SAN JOAQUÍN),3,22,12,10,3
TABASCO,27,MACUSPANA,012,ALLENDE BAJO 2DA. SECCIÓN,3,148,78,70,7
TABASCO,27,MACUSPANA,012,ALTO TULIJÁ 1RA. SECCIÓN (LECHUGAL),2,56,29,27,3
TABASCO,27,MACUSPANA,012,ALTO TULIJÁ 2DA. SECCIÓN (PAREDÓN),2,44,20,24,2
TABASCO,27,MACUSPANA,012,ALTOTULIJÁ SECCIÓN CHINAL,3,70,38,32,5
TABASCO,27,MACUSPANA,012,ÁLVARO OBREGÓN,3,55,25,30,4
TABASCO,27,MACUSPANA,012,ANDRÉS GARCÍA,2,36,10,26,2
TABASCO,27,MACUSPANA,012,AQUILES SERDÁN (SAN FERNANDO),7,1788,876,912,82
TABASCO,27,MACUSPANA,012,ARROYO HONDO (VICENTE GUERRERO 2DA. SECCIÓN),2,92,48,44,4
TABASCO,27,MACUSPANA,012,BAJO ALLENDE 1RA. SECCIÓN,2,15,6,9,2
TABASCO,27,MACUSPANA,012,BAJO TULIJÁ,2,33,18,15,2
TABASCO,27,MACUSPANA,012,BARRIAL,3,94,45,49,6
TABASCO,27,MACUSPANA,012,BAYONA,2,21,11,10,2
TABASCO,27,MACUSPANA,012,BELÉN,7,967,468,499,40
TABASCO,27,MACUSPANA,012,BELÉN MONTE LARGO 3RA. SECCIÓN (TRONCHADERO),2,9,5,4,1
TABASCO,27,MACUSPANA,012,BENITO JUÁREZ,2,66,33,33,4
TABASCO,27,MACUSPANA,012,BENITO JUÁREZ (SAN CARLOS),23,5648,2685,2963,230
TABASCO,27,MACUSPANA,012,BITZAL 1RA. SECCIÓN,3,109,55,54,6
TABASCO,27,MACUSPANA,012,BITZAL 2DA. SECCIÓN,2,18,6,12,2
TABASCO,27,MACUSPANA,012,BITZAL 3RA. SECCIÓN,2,6,2,4,2
TABASCO,27,MACUSPANA,012,BITZAL 5TA. SECCIÓN,2,63,33,30,4
TABASCO,27,MACUSPANA,012,BITZAL 6TA. SECCIÓN,4,204,96,108,11
TABASCO,27,MACUSPANA,012,BITZAL 7MA. SECCIÓN,2,65,39,26,3
TABASCO,27,MACUSPANA,012,BONANZA 1RA. SECCIÓN,4,377,175,202,30
TABASCO,27,MACUSPANA,012,BONANZA 2DA. SECCIÓN,3,91,44,47,6
TABASCO,27,MACUSPANA,012,BUENA VISTA (APASCO),4,616,312,304,35
TABASCO,27,MACUSPANA,012,BUENA VISTA (PUXCATÁN),2,168,77,91,6
TABASCO,27,MACUSPANA,012,BUERGOS,3,175,84,91,8
TABASCO,27,MACUSPANA,012,CACAHUATALILLO,3,206,102,104,11
TABASCO,27,MACUSPANA,012,CARLOS GREENE 1RA. SECCIÓN,1,18,8,10,1
TABASCO,27,MACUSPANA,012,CARMEN SERDÁN,5,112,54,58,7
TABASCO,27,MACUSPANA,012,CASTRO Y GÜIRO,2,10,3,7,2
TABASCO,27,MACUSPANA,012,CELIA GONZÁLEZ DE ROVIROSA,3,33,19,14,3
TABASCO,27,MACUSPANA,012,CHILAPILLA 2DA. SECCIÓN,2,11,3,8,1
TABASCO,27,MACUSPANA,012,CHIQUIHUITE,2,22,10,12,2
TABASCO,27,MACUSPANA,012,CHIVALITO 2DA. SECCIÓN,3,151,75,76,8
TABASCO,27,MACUSPANA,012,CHIVALITO 4TA. SECCIÓN,3,104,34,70,11
TABASCO,27,MACUSPANA,012,CLEMENTE REYES 1RA. SECCIÓN,2,12,7,5,2
TABASCO,27,MACUSPANA,012,CLEMENTE REYES 2DA. SECCIÓN,2,40,17,23,3
TABASCO,27,MACUSPANA,012,CLEMENTE REYES 2DA. SECCIÓN (CANTEMOC),2,26,12,14,3
TABASCO,27,MACUSPANA,012,CORRALILLO 1RA. SECCIÓN,2,12,5,7,2
TABASCO,27,MACUSPANA,012,CORRALILLO 1RA. SECCIÓN (NOPALAPA),4,142,71,71,8
TABASCO,27,MACUSPANA,012,CORRALILLO 2DA. SECCIÓN (LA PRINCESA),2,56,26,30,3
TABASCO,27,MACUSPANA,012,CUAUHTÉMOC,2,20,11,9,2
TABASCO,27,MACUSPANA,012,EL BAYO 1RA. SECCIÓN (GRANADA),2,77,39,38,3
TABASCO,27,MACUSPANA,012,EL BAYO 2DA. SECCIÓN,2,120,63,57,5
TABASCO,27,MACUSPANA,012,EL CHINALITO,2,40,20,20,2
TABASCO,27,MACUSPANA,012,EL CONGO,4,514,227,287,23
TABASCO,27,MACUSPANA,012,EL PORVENIR,2,22,10,12,2
TABASCO,27,MACUSPANA,012,EL REGOCIJO,2,61,28,33,3
TABASCO,27,MACUSPANA,012,EL TRIUNFO 1RA. SECCIÓN,2,162,80,82,7
TABASCO,27,MACUSPANA,012,EL TRIUNFO 2DA. SECCIÓN,4,371,164,207,15
TABASCO,27,MACUSPANA,012,EL TRIUNFO 3RA. SECCIÓN,3,108,66,42,6
TABASCO,27,MACUSPANA,012,EL VENADITO,3,17,6,11,3
TABASCO,27,MACUSPANA,012,EMILIANO ZAPATA 1RA. SECCIÓN,2,97,49,48,4
TABASCO,27,MACUSPANA,012,EMILIANO ZAPATA 2DA. SECCIÓN,2,134,67,67,5
TABASCO,27,MACUSPANA,012,FRANCISCO BATES,1,14,7,7,1
TABASCO,27,MACUSPANA,012,FRANCISCO I. MADERO ALTO 1RA. SECCIÓN,3,218,106,112,9
TABASCO,27,MACUSPANA,012,FRANCISCO I. MADERO BAJO,2,39,22,17,3
TABASCO,27,MACUSPANA,012,FRANCISCO JAVIER MINA (EL COCO),3,136,57,79,6
TABASCO,27,MACUSPANA,012,GREGORIO MÉNDEZ 1RA. SECCIÓN,2,85,46,39,4
TABASCO,27,MACUSPANA,012,GREGORIO MÉNDEZ 2DA. SECCIÓN (PATAZTAL),4,278,123,155,13
TABASCO,27,MACUSPANA,012,GUACAMAYA,2,20,12,8,2
TABASCO,27,MACUSPANA,012,GUADALUPE VICTORIA,3,20,9,11,3
TABASCO,27,MACUSPANA,012,GUILLERMO PRIETO,3,71,28,43,5
TABASCO,27,MACUSPANA,012,GUSTAVO A. MADERO,3,18,10,8,3
TABASCO,27,MACUSPANA,012,HERMENEGILDO GALEANA (CHIVEROS),2,37,20,17,2
TABASCO,27,MACUSPANA,012,IGNACIO MANUEL ALTAMIRANO 1RA. SECCIÓN,3,126,58,68,6
TABASCO,27,MACUSPANA,012,IGNACIO MANUEL ALTAMIRANO 2DA. SECCIÓN,2,65,34,31,3
TABASCO,27,MACUSPANA,012,IGNACIO ZARAGOZA (LOS ATEOS),2,42,14,28,3
TABASCO,27,MACUSPANA,012,JOSÉ COLOMO,3,199,95,104,9
TABASCO,27,MACUSPANA,012,JOSÉ LÓPEZ PORTILLO,2,68,40,28,3
TABASCO,27,MACUSPANA,012,JOSÉ MARÍA PINO SUÁREZ,3,441,215,226,16
TABASCO,27,MACUSPANA,012,LA CEIBA,2,187,91,96,7
TABASCO,27,MACUSPANA,012,LA CURVA,7,598,276,322,37
TABASCO,27,MACUSPANA,012,LA ESCALERA,3,311,157,154,12
TABASCO,27,MACUSPANA,012,LA ISLA 1RA. SECCIÓN,2,67,41,26,4
TABASCO,27,MACUSPANA,012,LA ISLA 2DA. SECCIÓN,2,51,26,25,3
TABASCO,27,MACUSPANA,012,LA PROVIDENCIA,2,48,20,28,3
TABASCO,27,MACUSPANA,012,LA UNIÓN,3,595,303,292,29
TABASCO,27,MACUSPANA,012,LAS CAMPANAS,2,36,18,18,3
TABASCO,27,MACUSPANA,012,LAS FERIAS,3,215,109,106,11
TABASCO,27,MACUSPANA,012,LAS LOMAS DE CAPARROSO,2,14,6,8,2
TABASCO,27,MACUSPANA,012,LÁZARO CÁRDENAS 2DA. SECCIÓN,1,8,5,3,1
TABASCO,27,MACUSPANA,012,LERDO DE TEJADA 1RA. SECCIÓN,3,1212,393,819,63
TABASCO,27,MACUSPANA,012,LERDO DE TEJADA 2DA. SECCIÓN,2,166,74,92,6
TABASCO,27,MACUSPANA,012,LICENCIADO JUAN CÉSAR BECERRA BATES,3,32,19,13,3
TABASCO,27,MACUSPANA,012,LÍMBANO BLANDÍN 1RA. SECCIÓN,4,698,344,354,29
TABASCO,27,MACUSPANA,012,LIMÓN 1RA. SECCIÓN SECTOR B,3,46,20,26,3
TABASCO,27,MACUSPANA,012,LIMÓN 1RA. SECCIÓN SECTOR C,1,19,10,9,1
TABASCO,27,MACUSPANA,012,LIMÓN 2DA. SECCIÓN SECTOR A,3,94,54,40,5
TABASCO,27,MACUSPANA,012,LIMÓN 2DA. SECCIÓN SECTOR B,2,21,9,12,2
TABASCO,27,MACUSPANA,012,LINDA VISTA,3,104,55,49,6
TABASCO,27,MACUSPANA,012,LOS ARBOLITOS,1,16,9,7,1
TABASCO,27,MACUSPANA,012,LOS GÜIROS,2,5,2,3,1
TABASCO,27,MACUSPANA,012,LOS GURRÍA,2,12,1,11,2
TABASCO,27,MACUSPANA,012,LOS NARANJOS 1RA. SECCIÓN,2,6,1,5,1
TABASCO,27,MACUSPANA,012,LOS NARANJOS 2DA. SECCIÓN,3,32,14,18,3
TABASCO,27,MACUSPANA,012,MACUSPANA,48,10852,5325,5527,645
TABASCO,27,MACUSPANA,012,MALUCO 2DA. SECCIÓN (JUAN VAQUERO),3,48,22,26,3
TABASCO,27,MACUSPANA,012,MARIANO MATAMOROS,4,92,47,45,5
TABASCO,27,MACUSPANA,012,MELCHOR OCAMPO 1RA. SECCIÓN,4,228,104,124,11
TABASCO,27,MACUSPANA,012,MELCHOR OCAMPO 2DA. SECCIÓN,3,189,81,108,9
TABASCO,27,MACUSPANA,012,MELCHOR OCAMPO 3RA. SECCIÓN,3,197,95,102,8
TABASCO,27,MACUSPANA,012,MIGUEL ALLENDE,2,15,9,6,1
TABASCO,27,MACUSPANA,012,MIGUEL HIDALGO 1RA. SECCIÓN,3,110,61,49,6
TABASCO,27,MACUSPANA,012,MIGUEL HIDALGO 2DA. SECCIÓN,2,44,21,23,2
TABASCO,27,MACUSPANA,012,MIGUEL ORRICO DE LOS LLANOS,3,85,37,48,5
TABASCO,27,MACUSPANA,012,MONTE ADENTRO,2,67,34,33,3
TABASCO,27,MACUSPANA,012,MONTE LARGO 1RA. SECCIÓN,6,219,100,119,12
TABASCO,27,MACUSPANA,012,MORELOS,6,495,237,258,28
TABASCO,27,MACUSPANA,012,NABOR CORNELIO,2,30,13,17,2
TABASCO,27,MACUSPANA,012,NARCISO MENDOZA (CHILAPILLA 1RA. SECCIÓN),3,36,17,19,4
TABASCO,27,MACUSPANA,012,NARCISO MENDOZA 1RA. SECCIÓN,3,19,9,10,2
TABASCO,27,MACUSPANA,012,NARCISO MENDOZA 2DA. SECCIÓN,2,49,25,24,3
TABASCO,27,MACUSPANA,012,NICOLÁS BRAVO,3,409,206,203,15
TABASCO,27,MACUSPANA,012,NUEVA DIVISIÓN DEL BAYO (GUATEMALA),2,346,184,162,14
TABASCO,27,MACUSPANA,012,NUEVA ESPERANZA,3,192,85,107,8
TABASCO,27,MACUSPANA,012,NUEVO PROGRESO (LA CANDELARIA),2,61,28,33,3
TABASCO,27,MACUSPANA,012,OTATAL,1,4,2,2,1
TABASCO,27,MACUSPANA,012,PALOMAS,4,530,234,296,20
TABASCO,27,MACUSPANA,012,PARAÍSO,2,40,15,25,3
TABASCO,27,MACUSPANA,012,PEDRO A. GONZÁLEZ,3,91,50,41,5
TABASCO,27,MACUSPANA,012,PEDRO C. COLORADO 1RA. SECCIÓN,5,245,111,134,11
TABASCO,27,MACUSPANA,012,PEMEX (CIUDAD PEMEX),9,2468,1177,1291,93
TABASCO,27,MACUSPANA,012,PICHALITO,3,23,14,9,3
TABASCO,27,MACUSPANA,012,PITAHAYA,2,17,9,8,2
TABASCO,27,MACUSPANA,012,PROFESOR CAPARROSO 1RA. SECCIÓN,3,159,74,85,7
TABASCO,27,MACUSPANA,012,PROFESOR CAPARROSO 2DA. SECCIÓN,3,263,132,131,12
TABASCO,27,MACUSPANA,012,RAMÓN GRANDE,4,449,231,218,20
TABASCO,27,MACUSPANA,012,REFORMA 1RA. SECCIÓN,2,10,6,4,1
TABASCO,27,MACUSPANA,012,ROVIROSA,3,59,25,34,4
TABASCO,27,MACUSPANA,012,SAN ANTONIO,2,240,122,118,10
TABASCO,27,MACUSPANA,012,SAN FRANCISCO,3,102,48,54,5
TABASCO,27,MACUSPANA,012,SAN JOSÉ,2,48,29,19,3
TABASCO,27,MACUSPANA,012,SAN JUAN BAUTISTA,3,143,74,69,8
TABASCO,27,MACUSPANA,012,SANTA LUCÍA,1,35,24,11,1
TABASCO,27,MACUSPANA,012,SANTOS DEGOLLADO 1RA. SECCIÓN (EL BAYO),2,57,37,20,3
TABASCO,27,MACUSPANA,012,SANTOS DEGOLLADO 2DA. SECCIÓN,2,32,12,20,2
TABASCO,27,MACUSPANA,012,SANTUARIO 1RA. SECCIÓN (ESTACIÓN MACUSPANA),3,161,84,77,8
TABASCO,27,MACUSPANA,012,SANTUARIO 2DA. SECCIÓN,2,26,10,16,2
TABASCO,27,MACUSPANA,012,SIMÓN SARLAT,4,180,91,89,8
TABASCO,27,MACUSPANA,012,SIMÓN SARLAT 2DA. SECCIÓN (SAN MARTÍN),3,88,40,48,5
TABASCO,27,MACUSPANA,012,SITIO NUEVO,2,43,23,20,2
TABASCO,27,MACUSPANA,012,TEPETITÁN,4,467,239,228,47
TABASCO,27,MACUSPANA,012,TIERRA COLORADA,3,202,91,111,9
TABASCO,27,MACUSPANA,012,TIERRA COLORADA (VICENTE GUERRERO 3RA. SECCIÓN),3,61,35,26,4
TABASCO,27,MACUSPANA,012,TOMÁS GARRIDO CANABAL,2,81,41,40,4
TABASCO,27,MACUSPANA,012,TRINIDAD MALPICA HERNÁNDEZ,3,173,84,89,9
TABASCO,27,MACUSPANA,012,UNIÓN Y LIBERTAD,5,321,176,145,16
TABASCO,27,MACUSPANA,012,VEINTE DE NOVIEMBRE,6,399,206,193,17
TABASCO,27,MACUSPANA,012,VENUSTIANO CARRANZA (LA ALIANZA),4,447,206,241,17
TABASCO,27,MACUSPANA,012,VERNET 1RA. SECCIÓN,3,93,44,49,4
TABASCO,27,MACUSPANA,012,VERNET 1RA. SECCIÓN (LOS VENADOS),2,3,0,3,2
TABASCO,27,MACUSPANA,012,VERNET 2DA. SECCIÓN,4,370,174,196,17
TABASCO,27,MACUSPANA,012,VERNET 3RA. SECCIÓN,5,589,294,295,25
TABASCO,27,MACUSPANA,012,VERNET 4TA. SECCIÓN (JUAN SALAS),2,127,54,73,6
TABASCO,27,MACUSPANA,012,VERNET 5TA. SECCIÓN (COROZAL),2,65,37,28,3
TABASCO,27,MACUSPANA,012,VERNET 6TA. SECCIÓN (SAN LORENZO),2,12,7,5,2
TABASCO,27,MACUSPANA,012,VERNET SIERRA DE GUADALUPE,2,6,2,4,1
TABASCO,27,MACUSPANA,012,VICENTE GUERRERO 1RA. SECCIÓN,3,67,34,33,5
TABASCO,27,MACUSPANA,012,VIRGINIO CHAN 1RA. SECCIÓN,2,25,15,10,2
TABASCO,27,MACUSPANA,012,VIRGINIO CHAN 2DA. SECCIÓN,1,15,5,10,1
TABASCO,27,MACUSPANA,012,VIRGINIO CHAN 3RA. SECCIÓN,2,20,8,12,2
TABASCO,27,MACUSPANA,012,XICOTENCATL,2,51,25,26,4
TABASCO,27,MACUSPANA,012,ZOPO NORTE,3,248,118,130,11
TABASCO,27,MACUSPANA,012,ZOPO SUR,2,37,22,15,2
TABASCO,27,NACAJUCA,013,ARROYO,4,238,118,120,11
TABASCO,27,NACAJUCA,013,BANDERAS (GUATACALCA 2DA. SECCIÓN),5,319,152,167,14
TABASCO,27,NACAJUCA,013,BELÉN,3,56,31,25,3
TABASCO,27,NACAJUCA,013,BOSQUE DE SALOYA,8,2398,1163,1235,95
TABASCO,27,NACAJUCA,013,BRISAS DEL CARRIZAL,3,521,262,259,20
TABASCO,27,NACAJUCA,013,CANTEMOC 1RA. SECCIÓN,4,214,108,106,11
TABASCO,27,NACAJUCA,013,CANTEMOC 2DA. SECCIÓN,1,26,14,12,1
TABASCO,27,NACAJUCA,013,CHICOZAPOTE,4,265,122,143,12
TABASCO,27,NACAJUCA,013,CORRIENTE 1RA. SECCIÓN,2,136,71,65,6
TABASCO,27,NACAJUCA,013,EL CEDRO,6,931,433,498,48
TABASCO,27,NACAJUCA,013,EL CHIFLÓN,3,91,42,49,4
TABASCO,27,NACAJUCA,013,EL COMETA,2,7,2,5,1
TABASCO,27,NACAJUCA,013,EL GUANAL,2,16,11,5,2
TABASCO,27,NACAJUCA,013,EL GUÁSIMO,3,332,155,177,14
TABASCO,27,NACAJUCA,013,EL HORMIGUERO,2,59,30,29,3
TABASCO,27,NACAJUCA,013,EL PASTAL,3,124,57,67,6
TABASCO,27,NACAJUCA,013,EL SITIO,3,81,45,36,4
TABASCO,27,NACAJUCA,013,EL TIGRE,3,1397,667,730,46
TABASCO,27,NACAJUCA,013,EL ZAPOTE,3,329,150,179,14
TABASCO,27,NACAJUCA,013,GUATACALCA,9,1802,859,943,70
TABASCO,27,NACAJUCA,013,GUAYTALPA,2,147,77,70,8
TABASCO,27,NACAJUCA,013,ISLA GUADALUPE,3,162,88,74,8
TABASCO,27,NACAJUCA,013,JIMÉNEZ,5,691,347,344,29
TABASCO,27,NACAJUCA,013,JUAN DIEGO,1,12,5,7,1
TABASCO,27,NACAJUCA,013,LA CRUZ DE NACAJUCA,2,138,71,67,7
TABASCO,27,NACAJUCA,013,LA CRUZ DE OLCUATITÁN,3,80,32,48,4
TABASCO,27,NACAJUCA,013,LA CRUZ DEL SANDIAL,3,234,118,116,10
TABASCO,27,NACAJUCA,013,LA LOMA,3,148,77,71,8
TABASCO,27,NACAJUCA,013,LA SELVA,3,1055,500,555,33
TABASCO,27,NACAJUCA,013,LIBERTAD,1,133,66,67,7
TABASCO,27,NACAJUCA,013,LOMITAS,5,1035,519,516,38
TABASCO,27,NACAJUCA,013,MANUEL BUENDÍA TÉLLEZ GIRÓN,2,307,134,173,10
TABASCO,27,NACAJUCA,013,MAZATEUPA,5,1103,545,558,50
TABASCO,27,NACAJUCA,013,NACAJUCA,15,4747,2516,2231,285
TABASCO,27,NACAJUCA,013,OLCUATITÁN,3,424,205,219,19
TABASCO,27,NACAJUCA,013,OXIACAQUE,6,1036,501,535,50
TABASCO,27,NACAJUCA,013,PALMIRA,3,452,215,237,30
TABASCO,27,NACAJUCA,013,POMOCA,13,4618,2335,2283,161
TABASCO,27,NACAJUCA,013,RIVERA ALTA,2,1327,473,854,17
TABASCO,27,NACAJUCA,013,SALOYA 1RA. SECCIÓN,3,587,286,301,22
TABASCO,27,NACAJUCA,013,SALOYA 2DA. SECCIÓN,2,527,271,256,18
TABASCO,27,NACAJUCA,013,SALVADOR ALLENDE,1,19,7,12,1
TABASCO,27,NACAJUCA,013,SAMARKANDA,3,709,351,358,26
TABASCO,27,NACAJUCA,013,SAN ISIDRO 1RA. SECCIÓN,3,249,128,121,11
TABASCO,27,NACAJUCA,013,SAN ISIDRO 2DA. SECCIÓN,3,124,58,66,6
TABASCO,27,NACAJUCA,013,SAN JOSÉ PAJONAL,3,55,27,28,4
TABASCO,27,NACAJUCA,013,SAN MARCOS,4,460,244,216,22
TABASCO,27,NACAJUCA,013,SAN SIMÓN,3,281,143,138,14
TABASCO,27,NACAJUCA,013,SANDIAL,3,684,325,359,24
TABASCO,27,NACAJUCA,013,SIMÓN BOLÍVAR,3,114,62,52,5
TABASCO,27,NACAJUCA,013,TAPOTZINGO,6,1640,832,808,96
TABASCO,27,NACAJUCA,013,TAXCO,3,210,104,106,9
TABASCO,27,NACAJUCA,013,TECOLUTA 1RA. SECCIÓN,5,458,224,234,19
TABASCO,27,NACAJUCA,013,TECOLUTA 2DA. SECCIÓN,3,252,123,129,13
TABASCO,27,NACAJUCA,013,TUCTA,3,412,196,216,17
TABASCO,27,NACAJUCA,013,VAINILLA,2,158,77,81,7
TABASCO,27,PARAÍSO,014,ANDRÉS GARCÍA (LA ISLA),3,161,81,80,8
TABASCO,27,PARAÍSO,014,AQUILES SERDÁN,6,420,201,219,19
TABASCO,27,PARAÍSO,014,BARRA DE TUPILCO,2,67,35,32,3
TABASCO,27,PARAÍSO,014,CHILTEPEC (PUERTO CHILTEPEC),3,579,287,292,25
TABASCO,27,PARAÍSO,014,CHILTEPEC (SECCIÓN BANCO),2,235,112,123,9
TABASCO,27,PARAÍSO,014,CHILTEPEC (SECCIÓN PÉNJAMO),2,118,62,56,4
TABASCO,27,PARAÍSO,014,CHILTEPEC (SECCIÓN TANQUE),4,677,338,339,31
TABASCO,27,PARAÍSO,014,EL BELLOTE (MIGUEL DE LA MADRID),2,173,99,74,6
TABASCO,27,PARAÍSO,014,EL ESCRIBANO,2,241,117,124,8
TABASCO,27,PARAÍSO,014,FRANCISCO I. MADERO,1,10,2,8,1
TABASCO,27,PARAÍSO,014,FRANCISCO I. MADERO (MADERO),3,590,281,309,22
TABASCO,27,PARAÍSO,014,FRANCISCO I. MADERO 2DA. SECCIÓN,3,913,448,465,36
TABASCO,27,PARAÍSO,014,GUANO SOLO (EL COQUITO),2,146,77,69,6
TABASCO,27,PARAÍSO,014,JOSÉ MARÍA MORELOS Y PAVÓN (EL BELLOTE),2,347,163,184,14
TABASCO,27,PARAÍSO,014,LA UNIÓN 1RA. SECCIÓN (AMATILLO),2,76,34,42,3
TABASCO,27,PARAÍSO,014,LA UNIÓN 2DA. SECCIÓN,4,441,207,234,17
TABASCO,27,PARAÍSO,014,LA UNIÓN 3RA. SECCIÓN,2,85,41,44,4
TABASCO,27,PARAÍSO,014,LAS FLORES 1RA. SECCIÓN,2,248,132,116,9
TABASCO,27,PARAÍSO,014,LAS FLORES 2DA. SECCIÓN,3,261,129,132,9
TABASCO,27,PARAÍSO,014,LAS FLORES 3RA. SECCIÓN (EL CERRO),3,494,211,283,19
TABASCO,27,PARAÍSO,014,LIBERTAD 1RA. SECCIÓN (EL CHIVERO),3,425,212,213,18
TABASCO,27,PARAÍSO,014,LIBERTAD 2DA. SECCIÓN,2,308,146,162,12
TABASCO,27,PARAÍSO,014,MOCTEZUMA (FRANCISCO I. MADERO 3RA. SECCIÓN),2,427,215,212,13
TABASCO,27,PARAÍSO,014,MOCTEZUMA 1RA. SECCIÓN,7,858,428,430,45
TABASCO,27,PARAÍSO,014,MOCTEZUMA 2DA. SECCIÓN,3,480,233,247,17
TABASCO,27,PARAÍSO,014,MOCTEZUMA 3RA. SECCIÓN,2,126,63,63,6
TABASCO,27,PARAÍSO,014,MONTE ADENTRO,4,1931,892,1039,120
TABASCO,27,PARAÍSO,014,NICOLÁS BRAVO,3,474,226,248,18
TABASCO,27,PARAÍSO,014,NICOLÁS BRAVO 2DA. SECCIÓN (LA GLORIA),2,48,26,22,3
TABASCO,27,PARAÍSO,014,NICOLÁS BRAVO 3RA. SECCIÓN,3,428,198,230,17
TABASCO,27,PARAÍSO,014,NICOLÁS BRAVO 4TA. SECCIÓN (TILAPA),2,64,33,31,3
TABASCO,27,PARAÍSO,014,NICOLÁS BRAVO 5TA. SECCIÓN (PUNTA BRAVA),2,234,113,121,10
TABASCO,27,PARAÍSO,014,NUEVO TORNO LARGO,2,284,152,132,9
TABASCO,27,PARAÍSO,014,OCCIDENTE (SAN FRANCISCO),3,294,158,136,12
TABASCO,27,PARAÍSO,014,ORIENTE (HORMIGUERO),2,32,15,17,2
TABASCO,27,PARAÍSO,014,ORIENTE (SAN CAYETANO),2,258,113,145,9
TABASCO,27,PARAÍSO,014,ORIENTE 1RA. SECCIÓN,2,175,81,94,8
TABASCO,27,PARAÍSO,014,ORIENTE 2DA. SECCIÓN (PALMA HUACA),4,374,173,201,15
TABASCO,27,PARAÍSO,014,PARAÍSO,46,12480,6199,6281,880
TABASCO,27,PARAÍSO,014,POTRERITOS,4,450,231,219,18
TABASCO,27,PARAÍSO,014,PUERTO CEIBA,3,829,372,457,32
TABASCO,27,PARAÍSO,014,PUERTO CEIBA (CARRIZAL),3,166,87,79,8
TABASCO,27,PARAÍSO,014,QUINTÍN ARAUZ,4,308,148,160,22
TABASCO,27,PARAÍSO,014,QUINTÍN ARÁUZ UNO,1,472,228,244,14
TABASCO,27,TACOTALPA,015,AGUA BLANCA,3,120,55,65,6
TABASCO,27,TACOTALPA,015,AGUA ESCONDIDA,3,77,29,48,5
TABASCO,27,TACOTALPA,015,ARROYO CHISPA,3,61,28,33,4
TABASCO,27,TACOTALPA,015,ARROYO CIEGO 1RA. SECCIÓN,2,6,2,4,1
TABASCO,27,TACOTALPA,015,ARROYO SECO MIRAFLORES,3,202,100,102,8
TABASCO,27,TACOTALPA,015,BENITO JUÁREZ,3,42,17,25,3
TABASCO,27,TACOTALPA,015,BUENA VISTA 1RA. SECCIÓN,2,37,19,18,2
TABASCO,27,TACOTALPA,015,BUENOS AIRES,3,87,40,47,4
TABASCO,27,TACOTALPA,015,CARIDAD GUERRERO,4,101,52,49,6
TABASCO,27,TACOTALPA,015,CEIBA 1RA. SECCIÓN (ESTACIÓN FERROCARRIL),2,25,12,13,2
TABASCO,27,TACOTALPA,015,CEIBA 2DA. SECCIÓN (SAN LUIS),2,94,42,52,4
TABASCO,27,TACOTALPA,015,CEIBITA 1RA. SECCIÓN,4,519,261,258,39
TABASCO,27,TACOTALPA,015,CEIBITA 2DA. SECCIÓN,2,46,19,27,3
TABASCO,27,TACOTALPA,015,CERRO BLANCO 1RA. SECCIÓN,2,25,10,15,2
TABASCO,27,TACOTALPA,015,CERRO BLANCO 2DA. SECCIÓN,4,148,76,72,7
TABASCO,27,TACOTALPA,015,CERRO BLANCO 3RA. SECCIÓN,2,39,19,20,2
TABASCO,27,TACOTALPA,015,CERRO BLANCO 4TA. SECCIÓN,4,177,100,77,8
TABASCO,27,TACOTALPA,015,CERRO BLANCO 5TA. SECCIÓN,4,139,64,75,7
TABASCO,27,TACOTALPA,015,CUAUHTÉMOC BARREAL,4,245,126,119,11
TABASCO,27,TACOTALPA,015,CUITLÁHUAC,4,240,108,132,10
TABASCO,27,TACOTALPA,015,CUVIAC,3,75,31,44,4
TABASCO,27,TACOTALPA,015,DIVISIÓN DEL NORTE,3,15,9,6,3
TABASCO,27,TACOTALPA,015,EL LIMÓN,3,85,36,49,4
TABASCO,27,TACOTALPA,015,EL PARAÍSO,2,14,6,8,2
TABASCO,27,TACOTALPA,015,EMILIANO ZAPATA,3,88,42,46,5
TABASCO,27,TACOTALPA,015,FRANCISCO I. MADERO 1RA. SECCIÓN,4,83,44,39,6
TABASCO,27,TACOTALPA,015,FRANCISCO I. MADERO 2DA. SECCIÓN,4,378,184,194,17
TABASCO,27,TACOTALPA,015,GRACIANO SÁNCHEZ,2,45,22,23,3
TABASCO,27,TACOTALPA,015,GRAN PODER,2,21,8,13,2
TABASCO,27,TACOTALPA,015,GUAYAL,5,385,193,192,19
TABASCO,27,TACOTALPA,015,JOSÉ MARÍA MORELOS Y PAVÓN,3,125,54,71,5
TABASCO,27,TACOTALPA,015,LA CUESTA,2,14,6,8,1
TABASCO,27,TACOTALPA,015,LA CUMBRE,3,50,28,22,3
TABASCO,27,TACOTALPA,015,LA PILA,2,19,10,9,2
TABASCO,27,TACOTALPA,015,LA RAYA 1RA. SECCIÓN (NAVA),2,23,5,18,2
TABASCO,27,TACOTALPA,015,LA RAYA 2DA. SECCIÓN (SANTA CRUZ),2,12,6,6,1
TABASCO,27,TACOTALPA,015,LA RAYA ZARAGOZA,5,550,269,281,25
TABASCO,27,TACOTALPA,015,LÁZARO CÁRDENAS (MADRIGAL 3RA. SECCIÓN),4,382,176,206,16
TABASCO,27,TACOTALPA,015,LIBERTAD,5,378,181,197,20
TABASCO,27,TACOTALPA,015,LOMAS ALEGRES 1RA. SECCIÓN,4,466,206,260,18
TABASCO,27,TACOTALPA,015,LOMAS ALEGRES 2DA. SECCIÓN (CASTAÑAL),2,64,27,37,4
TABASCO,27,TACOTALPA,015,LOMAS ALEGRES 3RA. SECCIÓN (SAN ANTONIO),2,68,33,35,3
TABASCO,27,TACOTALPA,015,LOMAS ALEGRES 4TA. SECCIÓN (EL HULAR),2,33,16,17,2
TABASCO,27,TACOTALPA,015,MADRIGAL 4TA. SECCIÓN,3,12,6,6,2
TABASCO,27,TACOTALPA,015,MADRIGAL 5TA. SECCIÓN,2,26,12,14,2
TABASCO,27,TACOTALPA,015,MEXIQUITO,3,93,37,56,4
TABASCO,27,TACOTALPA,015,NOYPAC,3,61,34,27,4
TABASCO,27,TACOTALPA,015,NUEVA ESPERANZA,2,22,12,10,2
TABASCO,27,TACOTALPA,015,NUEVO MADERO,2,47,17,30,3
TABASCO,27,TACOTALPA,015,OXOLOTÁN,7,1809,995,814,106
TABASCO,27,TACOTALPA,015,PALO QUEMADO,5,136,65,71,8
TABASCO,27,TACOTALPA,015,PASAMONOS,4,161,86,75,7
TABASCO,27,TACOTALPA,015,POANÁ,2,52,24,28,3
TABASCO,27,TACOTALPA,015,POCHITOCAL 1RA. SECCIÓN (LA PALMA),2,109,53,56,5
TABASCO,27,TACOTALPA,015,POCHITOCAL 1RA. SECCIÓN (TILA Y TORONJO),3,211,100,111,8
TABASCO,27,TACOTALPA,015,POCHITOCAL 2DA. SECCIÓN,2,55,27,28,3
TABASCO,27,TACOTALPA,015,POCHITOCAL 3RA. SECCIÓN,4,131,68,63,9
TABASCO,27,TACOTALPA,015,POCHITOCAL 4TA. SECCIÓN (SAN MIGUEL JUÁREZ),2,35,19,16,2
TABASCO,27,TACOTALPA,015,POMOCA,4,155,77,78,8
TABASCO,27,TACOTALPA,015,POMOQUITA,3,86,43,43,4
TABASCO,27,TACOTALPA,015,PUXCATÁN,5,491,242,249,19
TABASCO,27,TACOTALPA,015,PUYACATENGO 1RA. SECCIÓN (CEIBA),2,52,23,29,3
TABASCO,27,TACOTALPA,015,PUYACATENGO 2DA. SECCIÓN (CEIBA),4,222,107,115,10
TABASCO,27,TACOTALPA,015,REFORMA (MADRIGAL 2DA. SECCIÓN),2,59,33,26,3
TABASCO,27,TACOTALPA,015,SAN MANUEL,2,40,16,24,3
TABASCO,27,TACOTALPA,015,SAN RAMÓN,2,115,59,56,5
TABASCO,27,TACOTALPA,015,SANTA ROSA 1RA. SECCIÓN,3,206,98,108,10
TABASCO,27,TACOTALPA,015,SANTA ROSA 2DA. SECCIÓN (ESTACIÓN POANÁ),4,157,85,72,9
TABASCO,27,TACOTALPA,015,TACOTALPA,12,2426,1229,1197,133
TABASCO,27,TACOTALPA,015,TAPIJULAPA,9,1036,493,543,45
TABASCO,27,TACOTALPA,015,TOMÁS GARRIDO CANABAL,4,124,66,58,7
TABASCO,27,TACOTALPA,015,VILLA LUZ,3,29,15,14,3
TABASCO,27,TACOTALPA,015,XICOTÉNCATL,5,583,272,311,24
TABASCO,27,TACOTALPA,015,YAJALÓN RÍO SECO,3,62,33,29,4
TABASCO,27,TACOTALPA,015,ZUNÚ Y PATASTAL,4,231,112,119,9
TABASCO,27,TEAPA,016,ANDRÉS QUINTANA ROO,2,204,105,99,8
TABASCO,27,TEAPA,016,ANDRÉS QUINTANA ROO 1RA. SECCIÓN,3,24,9,15,3
TABASCO,27,TEAPA,016,ARCADIO ZENTELLA,4,180,83,97,10
TABASCO,27,TEAPA,016,CHAPULTEPEC,2,135,71,64,6
TABASCO,27,TEAPA,016,COLONIA MUNICIPAL,2,81,39,42,3
TABASCO,27,TEAPA,016,COLORADO (BENITO JUÁREZ),2,97,46,51,4
TABASCO,27,TEAPA,016,EUREKA Y BELÉN,4,421,201,220,17
TABASCO,27,TEAPA,016,FRANCISCO JAVIER MINA (ARGENTINA),3,1455,581,874,75
TABASCO,27,TEAPA,016,HERMENEGILDO GALEANA,4,412,208,204,17
TABASCO,27,TEAPA,016,HERMENEGILDO GALEANA 1RA. SECCIÓN (MEXIQUITO),2,17,9,8,2
TABASCO,27,TEAPA,016,HERMENEGILDO GALEANA 2DA. SECCIÓN,3,33,14,19,9
TABASCO,27,TEAPA,016,IGNACIO ALLENDE 2DA. SECCIÓN,4,359,176,183,15
TABASCO,27,TEAPA,016,IGNACIO ALLENDE 3RA. SECCIÓN,2,56,32,24,3
TABASCO,27,TEAPA,016,IGNACIO LÓPEZ RAYÓN 1RA. SECCIÓN,2,72,29,43,3
TABASCO,27,TEAPA,016,IGNACIO LÓPEZ RAYÓN 2DA. SECCIÓN,2,27,13,14,2
TABASCO,27,TEAPA,016,JOSÉ MARÍA MORELOS Y PAVÓN (JUAN GÓMEZ),2,54,29,25,2
TABASCO,27,TEAPA,016,JOSÉ MARÍA MORELOS Y PAVÓN (LAS DELICIAS),3,254,133,121,10
TABASCO,27,TEAPA,016,JOSÉ MARÍA MORELOS Y PAVÓN (SAN ANTONIO LAS ÁNIMAS),2,33,18,15,2
TABASCO,27,TEAPA,016,JOSÉ MARÍA MORELOS Y PAVÓN (SANTA RITA),2,17,6,11,2
TABASCO,27,TEAPA,016,JOSÉ MARÍA MORELOS Y PAVÓN 1RA. SECCIÓN,2,36,19,17,2
TABASCO,27,TEAPA,016,JOSÉ MARÍA MORELOS Y PAVÓN 2DA. SECCIÓN,3,72,31,41,6
TABASCO,27,TEAPA,016,JUAN ALDAMA,6,1124,562,562,42
TABASCO,27,TEAPA,016,LAS LILIAS,2,104,60,44,4
TABASCO,27,TEAPA,016,MANUEL BUELTA 2DA. SECCIÓN,2,37,19,18,3
TABASCO,27,TEAPA,016,MANUEL BUELTA Y RAYÓN,4,425,194,231,19
TABASCO,27,TEAPA,016,MARIANO PEDRERO 2DA. SECCIÓN,2,7,3,4,1
TABASCO,27,TEAPA,016,MARIANO PEDRERO 3RA. SECCIÓN,2,58,25,33,3
TABASCO,27,TEAPA,016,MIGUEL HIDALGO 1RA. SECCIÓN (LAS GARDENIAS),3,140,79,61,13
TABASCO,27,TEAPA,016,MIGUEL HIDALGO 2DA. SECCIÓN (FCO. SARABIA),3,358,173,185,13
TABASCO,27,TEAPA,016,MIGUEL HIDALGO 2DA. SECCIÓN (SAN JOAQUÍN),2,27,13,14,3
TABASCO,27,TEAPA,016,MINA Y MATAMOROS (LA TRINIDAD),3,48,25,23,3
TABASCO,27,TEAPA,016,MINA Y MATAMOROS (SAN PABLO TAMBOREL),2,45,23,22,2
TABASCO,27,TEAPA,016,NICOLÁS BRAVO 1RA. SECCIÓN,2,33,19,14,2
TABASCO,27,TEAPA,016,NICOLÁS BRAVO 2DA. SECCIÓN,3,141,66,75,7
TABASCO,27,TEAPA,016,SAN JOSÉ PUYACATENGO (CHAPINGO),1,32,14,18,21
TABASCO,27,TEAPA,016,TEAPA,31,7364,3716,3648,333
TABASCO,27,TEAPA,016,VICENTE GUERRERO (GUANAL),3,212,96,116,9
TABASCO,27,TEAPA,016,VICENTE GUERRERO (LAS NIEVES),2,168,90,78,7
TABASCO,27,TEAPA,016,VICENTE GUERRERO (LERMA),2,372,179,193,14
TABASCO,27,TEAPA,016,VICENTE GUERRERO (SAN LORENZO),2,113,54,59,5
TABASCO,27,TENOSIQUE,017,ACATLIPA,3,201,84,117,8
TABASCO,27,TENOSIQUE,017,ADOLFO LÓPEZ MATEOS,3,104,51,53,6
TABASCO,27,TENOSIQUE,017,ÁLVARO OBREGÓN,2,153,78,75,6
TABASCO,27,TENOSIQUE,017,ARENA DE HIDALGO,5,373,163,210,20
TABASCO,27,TENOSIQUE,017,BELLA VISTA,2,9,1,8,1
TABASCO,27,TENOSIQUE,017,BENITO JUÁREZ,4,277,141,136,12
TABASCO,27,TENOSIQUE,017,BENITO JUÁREZ 1RA. SECCIÓN,2,28,15,13,3
TABASCO,27,TENOSIQUE,017,BENITO JUÁREZ 2DA. SECCIÓN,2,32,14,18,2
TABASCO,27,TENOSIQUE,017,BOCA DEL CERRO,4,190,104,86,10
TABASCO,27,TENOSIQUE,017,CANITZÁN,2,51,23,28,3
TABASCO,27,TENOSIQUE,017,CARLOS PELLICER CÁMARA,3,66,33,33,4
TABASCO,27,TENOSIQUE,017,CENTRO USUMACINTA,2,68,39,29,3
TABASCO,27,TENOSIQUE,017,CERTEZA,2,155,74,81,7
TABASCO,27,TENOSIQUE,017,CHACULJÍ,2,16,9,7,2
TABASCO,27,TENOSIQUE,017,CORREGIDORA ORTIZ DE DOMÍNGUEZ,2,77,37,40,4
TABASCO,27,TENOSIQUE,017,CORTIJO NUEVO 1RA. SECCIÓN,2,56,25,31,3
TABASCO,27,TENOSIQUE,017,CORTIJO NUEVO 2DA. SECCIÓN,2,34,17,17,2
TABASCO,27,TENOSIQUE,017,CRISÓFORO CHIÑAS,3,58,25,33,5
TABASCO,27,TENOSIQUE,017,EL BEJUCAL,2,56,23,33,3
TABASCO,27,TENOSIQUE,017,EL COPO,2,12,5,7,2
TABASCO,27,TENOSIQUE,017,EL FAISÁN 1RA. SECCIÓN,2,37,23,14,2
TABASCO,27,TENOSIQUE,017,EL FAISÁN 2DA. SECCIÓN,2,29,9,20,2
TABASCO,27,TENOSIQUE,017,EL MARTILLO,2,7,5,2,2
TABASCO,27,TENOSIQUE,017,EL PALMAR,3,222,100,122,11
TABASCO,27,TENOSIQUE,017,EL PEDREGAL,2,93,45,48,5
TABASCO,27,TENOSIQUE,017,EL RECREO,2,33,13,20,2
TABASCO,27,TENOSIQUE,017,EL REPASTO,4,204,82,122,12
TABASCO,27,TENOSIQUE,017,EL ROBLAR,2,22,12,10,2
TABASCO,27,TENOSIQUE,017,EL XOTAL 1RA. SECCIÓN,2,10,6,4,1
TABASCO,27,TENOSIQUE,017,EL XOTAL 2DA. SECCIÓN,2,39,14,25,2
TABASCO,27,TENOSIQUE,017,EMILIANO ZAPATA 2DA. SECCIÓN (EL CARMEN),3,134,71,63,7
TABASCO,27,TENOSIQUE,017,EMILIANO ZAPATA 3RA. SECCIÓN (LOS CEDROS),3,40,23,17,3
TABASCO,27,TENOSIQUE,017,ESPERANZA NORTE (EL VEINTE),2,57,28,29,3
TABASCO,27,TENOSIQUE,017,ESTAPILLA,3,252,146,106,19
TABASCO,27,TENOSIQUE,017,ESTAPILLA 2DA. SECCIÓN,2,4,2,2,1
TABASCO,27,TENOSIQUE,017,FRANCISCO I. MADERO CORTAZAR,2,50,28,22,3
TABASCO,27,TENOSIQUE,017,FRANCISCO I. MADERO RÍOS,1,6,0,6,1
TABASCO,27,TENOSIQUE,017,FRANCISCO VILLA,2,60,23,37,3
TABASCO,27,TENOSIQUE,017,GREGORIO MÉNDEZ,2,29,12,17,2
TABASCO,27,TENOSIQUE,017,GUADALUPE VICTORIA,2,50,16,34,3
TABASCO,27,TENOSIQUE,017,GUAYACÁN,4,161,77,84,8
TABASCO,27,TENOSIQUE,017,HERMENEGILDO GALEANA,3,23,13,10,3
TABASCO,27,TENOSIQUE,017,ICORSA,1,46,24,22,2
TABASCO,27,TENOSIQUE,017,IGNACIO ALLENDE,3,287,161,126,14
TABASCO,27,TENOSIQUE,017,IGNACIO ZARAGOZA,4,133,57,76,7
TABASCO,27,TENOSIQUE,017,INDEPENDENCIA,2,53,26,27,3
TABASCO,27,TENOSIQUE,017,JAVIER ROJO GÓMEZ,3,123,54,69,6
TABASCO,27,TENOSIQUE,017,JOSÉ MARÍA PINO SUÁREZ 1RA. SECCIÓN,2,60,32,28,3
TABASCO,27,TENOSIQUE,017,JOSÉ MARÍA PINO SUÁREZ 2DA. SECCIÓN,3,22,8,14,2
TABASCO,27,TENOSIQUE,017,LA ESTANCIA,2,44,30,14,2
TABASCO,27,TENOSIQUE,017,LA ISLA,3,152,67,85,7
TABASCO,27,TENOSIQUE,017,LA PALMA,3,55,27,28,4
TABASCO,27,TENOSIQUE,017,LA ÚLTIMA LUCHA,1,9,2,7,1
TABASCO,27,TENOSIQUE,017,LOS RIELES DE SAN JOSÉ,2,58,29,29,4
TABASCO,27,TENOSIQUE,017,LUCIO BLANCO,3,30,13,17,3
TABASCO,27,TENOSIQUE,017,LUIS ECHEVERRÍA ÁLVAREZ 1RA. SECCIÓN,2,24,10,14,2
TABASCO,27,TENOSIQUE,017,MIGUEL HIDALGO,2,35,19,16,2
TABASCO,27,TENOSIQUE,017,NICOLÁS BRAVO,3,61,28,33,5
TABASCO,27,TENOSIQUE,017,NIÑOS HÉROES,2,28,18,10,2
TABASCO,27,TENOSIQUE,017,NUEVA ESPERANZA,3,114,51,63,6
TABASCO,27,TENOSIQUE,017,NUEVA JERUSALÉN,3,35,17,18,4
TABASCO,27,TENOSIQUE,017,NUEVO MÉXICO,3,125,61,64,6
TABASCO,27,TENOSIQUE,017,NUEVO PROGRESO,2,6,4,2,1
TABASCO,27,TENOSIQUE,017,PLAN DE SAN ANTONIO,2,15,9,6,2
TABASCO,27,TENOSIQUE,017,POMONÁ 1RA. SECCIÓN,2,105,61,44,5
TABASCO,27,TENOSIQUE,017,POMONÁ 2DA. SECCIÓN,2,9,4,5,2
TABASCO,27,TENOSIQUE,017,PUNTA DE MONTAÑA,2,10,3,7,1
TABASCO,27,TENOSIQUE,017,RANCHO GRANDE,2,61,33,28,3
TABASCO,27,TENOSIQUE,017,REDENCIÓN DEL CAMPESINO,4,365,168,197,37
TABASCO,27,TENOSIQUE,017,REFORMA AGRARIA,3,67,26,41,4
TABASCO,27,TENOSIQUE,017,REYES MORALES,1,4,3,1,1
TABASCO,27,TENOSIQUE,017,SAN CARLOS,1,33,16,17,2
TABASCO,27,TENOSIQUE,017,SAN FRANCISCO,2,61,39,22,3
TABASCO,27,TENOSIQUE,017,SAN ISIDRO GUASIVÁN,4,242,123,119,11
TABASCO,27,TENOSIQUE,017,SAN ISIDRO LAS POZAS,2,22,11,11,2
TABASCO,27,TENOSIQUE,017,SAN MARCOS,2,43,22,21,3
TABASCO,27,TENOSIQUE,017,SANTA CRUZ,3,163,80,83,7
TABASCO,27,TENOSIQUE,017,SANTA ELENA,3,40,10,30,3
TABASCO,27,TENOSIQUE,017,SANTA LUCÍA,2,36,14,22,3
TABASCO,27,TENOSIQUE,017,SANTA ROSA,3,55,23,32,4
TABASCO,27,TENOSIQUE,017,SANTO TOMÁS,4,299,169,130,13
TABASCO,27,TENOSIQUE,017,SUEÑOS DE ORO,5,976,536,440,44
TABASCO,27,TENOSIQUE,017,TATA LÁZARO,2,13,7,6,2
TABASCO,27,TENOSIQUE,017,TENOSIQUE 1RA. SECCIÓN (EL MOOL),2,5,2,3,1
TABASCO,27,TENOSIQUE,017,TENOSIQUE DE PINO SUÁREZ,44,9847,4943,4904,555
TABASCO,27,TENOSIQUE,017,USUMACINTA,4,243,124,119,12
TABASCO,27,TENOSIQUE,017,VETERANOS DE LA REVOLUCIÓN,1,4,2,2,1
TAMAULIPAS,28,ABASOLO,001,ABASOLO,9,1435,728,707,111
TAMAULIPAS,28,ABASOLO,001,ABASOLO (ABASOLITO),1,1,1,0,1
TAMAULIPAS,28,ABASOLO,001,DELICIAS,2,18,8,10,2
TAMAULIPAS,28,ABASOLO,001,GENERAL GILDARDO MAGAÑA,3,45,17,28,5
TAMAULIPAS,28,ABASOLO,001,GUADALUPE VICTORIA,5,304,157,147,25
TAMAULIPAS,28,ABASOLO,001,GUÍA DEL PORVENIR,3,34,13,21,5
TAMAULIPAS,28,ABASOLO,001,JESÚS RAMÍREZ,2,11,7,4,2
TAMAULIPAS,28,ABASOLO,001,MODELO,3,64,23,41,6
TAMAULIPAS,28,ABASOLO,001,NICOLÁS BRAVO (PALO ALTO),4,191,91,100,15
TAMAULIPAS,28,ABASOLO,001,NUEVO MORELOS (ADOLFO LÓPEZ MATEOS),3,137,75,62,11
TAMAULIPAS,28,ABASOLO,001,ÚRSULO GALVÁN,2,4,2,2,1
TAMAULIPAS,28,ALDAMA,002,ADOLFO LÓPEZ MATEOS (JARAMILLO),2,39,20,19,3
TAMAULIPAS,28,ALDAMA,002,ALDAMA,22,3788,1933,1855,290
TAMAULIPAS,28,ALDAMA,002,ALTO DEL CHINO,1,4,3,1,1
TAMAULIPAS,28,ALDAMA,002,ANTONIO VILLARREAL,4,100,52,48,10
TAMAULIPAS,28,ALDAMA,002,BARRA DEL TORDO,4,219,123,96,16
TAMAULIPAS,28,ALDAMA,002,BENITO JUÁREZ (LA NEGRITA),2,13,5,8,1
TAMAULIPAS,28,ALDAMA,002,BENITO JUÁREZ (LAS COLORADAS),4,152,65,87,10
TAMAULIPAS,28,ALDAMA,002,BUENAVISTA,3,79,39,40,6
TAMAULIPAS,28,ALDAMA,002,CINCO DE FEBRERO,2,23,13,10,3
TAMAULIPAS,28,ALDAMA,002,EL CARRIZAL (CARRERA TORRES),3,57,22,35,5
TAMAULIPAS,28,ALDAMA,002,EL CARRIZAL PRIMERO,2,18,5,13,2
TAMAULIPAS,28,ALDAMA,002,EL CARRIZAL SEGUNDO,3,51,25,26,6
TAMAULIPAS,28,ALDAMA,002,EL CARRIZO DE OPICHÁN,3,34,23,11,3
TAMAULIPAS,28,ALDAMA,002,EL CHIJOLITO,2,15,6,9,2
TAMAULIPAS,28,ALDAMA,002,EL JOBO,1,25,13,12,2
TAMAULIPAS,28,ALDAMA,002,EL LUCERO,2,63,31,32,4
TAMAULIPAS,28,ALDAMA,002,EL NACIMIENTO,3,113,50,63,7
TAMAULIPAS,28,ALDAMA,002,EL OLIVO,3,24,10,14,3
TAMAULIPAS,28,ALDAMA,002,EL OLIVO (EL ADEME),2,22,13,9,3
TAMAULIPAS,28,ALDAMA,002,EL PAISAJITO,2,24,11,13,3
TAMAULIPAS,28,ALDAMA,002,EL PICHIJUMO,1,13,7,6,1
TAMAULIPAS,28,ALDAMA,002,EL PLOMO,2,16,9,7,2
TAMAULIPAS,28,ALDAMA,002,EL REAL VIEJO,2,6,3,3,1
TAMAULIPAS,28,ALDAMA,002,EL ROSAL,2,16,9,7,2
TAMAULIPAS,28,ALDAMA,002,EL SOMBRERITO,3,50,32,18,5
TAMAULIPAS,28,ALDAMA,002,EL VIDAL,3,26,15,11,3
TAMAULIPAS,28,ALDAMA,002,FRANCISCO I. MADERO,4,201,94,107,13
TAMAULIPAS,28,ALDAMA,002,FRANCISCO VILLA (PANCHO VILLA),4,80,37,43,9
TAMAULIPAS,28,ALDAMA,002,GUADALUPE VICTORIA (TRES PIEDRAS),2,17,5,12,2
TAMAULIPAS,28,ALDAMA,002,HIGINIO TANGUMA,4,124,58,66,10
TAMAULIPAS,28,ALDAMA,002,LA AZUFROSA (EL HIGUERÓN),2,27,12,15,3
TAMAULIPAS,28,ALDAMA,002,LA CABECERA,2,24,11,13,2
TAMAULIPAS,28,ALDAMA,002,LA COLMENA,2,40,21,19,3
TAMAULIPAS,28,ALDAMA,002,LA GLORIA,2,26,9,17,3
TAMAULIPAS,28,ALDAMA,002,LA MURALLA,2,30,23,7,2
TAMAULIPAS,28,ALDAMA,002,LA PASADITA,2,14,8,6,2
TAMAULIPAS,28,ALDAMA,002,LAS ALAZANAS,2,27,13,14,3
TAMAULIPAS,28,ALDAMA,002,LAS FLORES,2,36,17,19,3
TAMAULIPAS,28,ALDAMA,002,LAS YUCAS,2,11,6,5,2
TAMAULIPAS,28,ALDAMA,002,LOS ÁNGELES,1,3,0,3,1
TAMAULIPAS,28,ALDAMA,002,MARIANO MATAMOROS DOS,3,71,34,37,6
TAMAULIPAS,28,ALDAMA,002,MORÓN,3,104,48,56,10
TAMAULIPAS,28,ALDAMA,002,NUEVO AMANECER (LOS ENCINOS),2,17,6,11,2
TAMAULIPAS,28,ALDAMA,002,NUEVO PROGRESO (LA GAVIOTA),3,189,98,91,16
TAMAULIPAS,28,ALDAMA,002,PALO SANTO,1,7,2,5,1
TAMAULIPAS,28,ALDAMA,002,PASO HONDO,2,60,32,28,5
TAMAULIPAS,28,ALDAMA,002,PIEDRAS NEGRAS,3,42,18,24,5
TAMAULIPAS,28,ALDAMA,002,POZA DE GRANADILLAS,2,32,13,19,3
TAMAULIPAS,28,ALDAMA,002,RAMÓN CORONA,2,19,7,12,2
TAMAULIPAS,28,ALDAMA,002,RANCHO DE PIEDRA,2,44,20,24,3
TAMAULIPAS,28,ALDAMA,002,RANCHO NUEVO,2,28,12,16,2
TAMAULIPAS,28,ALDAMA,002,REAL DE ALAMITOS,2,15,11,4,2
TAMAULIPAS,28,ALDAMA,002,REVOLUCIÓN,2,7,6,1,1
TAMAULIPAS,28,ALDAMA,002,SAN ESTEBAN,2,34,19,15,3
TAMAULIPAS,28,ALDAMA,002,SAN RAFAEL,2,18,7,11,2
TAMAULIPAS,28,ALDAMA,002,SAN VICENTE,2,31,20,11,3
TAMAULIPAS,28,ALDAMA,002,SANTA JULIA,2,27,12,15,3
TAMAULIPAS,28,ALDAMA,002,SANTA MARÍA,2,11,5,6,2
TAMAULIPAS,28,ALTAMIRA,003,AGUA DE CASTILLA,2,54,27,27,5
TAMAULIPAS,28,ALTAMIRA,003,ALTAMIRA,139,33685,16620,17065,2526
TAMAULIPAS,28,ALTAMIRA,003,AMPLIACIÓN SAN ANTONIO (EL PLÁTANO),2,9,5,4,2
TAMAULIPAS,28,ALTAMIRA,003,AQUILES SERDÁN (EL BARRANCO),3,160,88,72,10
TAMAULIPAS,28,ALTAMIRA,003,BENITO JUÁREZ,4,324,169,155,18
TAMAULIPAS,28,ALTAMIRA,003,CERVANTES,3,87,44,43,6
TAMAULIPAS,28,ALTAMIRA,003,CHAPOPOTE,2,35,19,16,3
TAMAULIPAS,28,ALTAMIRA,003,CUAUHTÉMOC,7,1932,1016,916,75
TAMAULIPAS,28,ALTAMIRA,003,CÚEZ DE PALMAS ALTAS,3,41,19,22,4
TAMAULIPAS,28,ALTAMIRA,003,CÚEZ ORTEÑO,1,32,8,24,2
TAMAULIPAS,28,ALTAMIRA,003,EL CONTADERO,2,33,16,17,2
TAMAULIPAS,28,ALTAMIRA,003,EL FUERTE,3,125,57,68,9
TAMAULIPAS,28,ALTAMIRA,003,EL POTOSÍ,2,4,2,2,1
TAMAULIPAS,28,ALTAMIRA,003,EL REPECHO,2,63,22,41,4
TAMAULIPAS,28,ALTAMIRA,003,EL SATÉLITE (EL CERRITO),1,6,4,2,1
TAMAULIPAS,28,ALTAMIRA,003,ESTEROS,2,294,135,159,13
TAMAULIPAS,28,ALTAMIRA,003,FRANCISCO MEDRANO,3,150,75,75,9
TAMAULIPAS,28,ALTAMIRA,003,JOSÉ MARÍA LUIS MORA (LAS MARGARITAS),3,130,67,63,7
TAMAULIPAS,28,ALTAMIRA,003,JOSÉ MARÍA MORELOS (LAS CUATROCIENTAS),2,27,11,16,3
TAMAULIPAS,28,ALTAMIRA,003,LA COLONIA (ESTACIÓN COLONIAS),3,263,143,120,14
TAMAULIPAS,28,ALTAMIRA,003,LA PEDRERA,7,1422,689,733,63
TAMAULIPAS,28,ALTAMIRA,003,LAS TRES B,2,23,13,10,2
TAMAULIPAS,28,ALTAMIRA,003,LLANO GRANDE (LILIANA ORTA DE HERNÁNDEZ),2,17,7,10,2
TAMAULIPAS,28,ALTAMIRA,003,LOMAS DEL REAL,4,263,117,146,16
TAMAULIPAS,28,ALTAMIRA,003,MACLOVIO HERRERA (MIRADORES),4,351,169,182,17
TAMAULIPAS,28,ALTAMIRA,003,MARIANO MATAMOROS,3,82,40,42,8
TAMAULIPAS,28,ALTAMIRA,003,MARTÍN A. MARTÍNEZ (LOS POTREROS),3,70,35,35,5
TAMAULIPAS,28,ALTAMIRA,003,MATA DEL ABRA,3,114,57,57,7
TAMAULIPAS,28,ALTAMIRA,003,MIRAMAR,112,22460,10943,11517,1164
TAMAULIPAS,28,ALTAMIRA,003,PROVIDENCIA Y NARANJOS,3,27,14,13,3
TAMAULIPAS,28,ALTAMIRA,003,RICARDO FLORES MAGÓN,4,459,207,252,21
TAMAULIPAS,28,ALTAMIRA,003,RÍO TAMIAHUA,2,195,93,102,9
TAMAULIPAS,28,ALTAMIRA,003,SAN ANTONIO,2,20,10,10,2
TAMAULIPAS,28,ALTAMIRA,003,SAN CARLITOS,2,3,0,3,1
TAMAULIPAS,28,ALTAMIRA,003,SANTA AMALIA,2,203,94,109,9
TAMAULIPAS,28,ALTAMIRA,003,SANTA JUANA,3,54,22,32,5
TAMAULIPAS,28,ALTAMIRA,003,SANTA PAULA,1,3,1,2,1
TAMAULIPAS,28,ALTAMIRA,003,TORNO LARGO,1,11,3,8,1
TAMAULIPAS,28,ALTAMIRA,003,TRES DE MAYO (MATA NEGRA),2,69,27,42,4
TAMAULIPAS,28,ALTAMIRA,003,VUELTA DE LAS YEGUAS,3,76,46,30,5
TAMAULIPAS,28,ANTIGUO MORELOS,004,ADOLFO LÓPEZ MATEOS,1,12,8,4,1
TAMAULIPAS,28,ANTIGUO MORELOS,004,ANTIGUO MORELOS,6,1027,511,516,90
TAMAULIPAS,28,ANTIGUO MORELOS,004,CONSTITUCIÓN DE 1917 NÚMERO 1,2,7,2,5,1
TAMAULIPAS,28,ANTIGUO MORELOS,004,EL REFUGIO,2,11,6,5,2
TAMAULIPAS,28,ANTIGUO MORELOS,004,EL SALVADOR,3,98,53,45,9
TAMAULIPAS,28,ANTIGUO MORELOS,004,EL SAUZ,3,61,30,31,5
TAMAULIPAS,28,ANTIGUO MORELOS,004,FORTINES Y EMILIANO ZAPATA (FORTINES),4,295,145,150,15
TAMAULIPAS,28,ANTIGUO MORELOS,004,GUADALUPE MAINERO,1,14,8,6,1
TAMAULIPAS,28,ANTIGUO MORELOS,004,LAS FLORES,3,22,11,11,3
TAMAULIPAS,28,ANTIGUO MORELOS,004,LAS PINTAS,2,6,3,3,1
TAMAULIPAS,28,ANTIGUO MORELOS,004,MÉXICO LIBRE,3,128,69,59,9
TAMAULIPAS,28,ANTIGUO MORELOS,004,MORELOS (LA LOMA),2,39,17,22,2
TAMAULIPAS,28,ANTIGUO MORELOS,004,PLAN DE SAN LUIS,2,20,9,11,2
TAMAULIPAS,28,ANTIGUO MORELOS,004,PRAXEDIS GUERRERO (EL PACHÓN),3,90,50,40,7
TAMAULIPAS,28,ANTIGUO MORELOS,004,PUEBLO VIEJO,2,46,19,27,3
TAMAULIPAS,28,ANTIGUO MORELOS,004,SAN ISIDRO DEL PONIENTE,1,11,6,5,1
TAMAULIPAS,28,ANTIGUO MORELOS,004,SAN PEDRO DE LOS COYOTES,1,4,1,3,1
TAMAULIPAS,28,BURGOS,005,ALTO DEL COYOTE,3,32,10,22,3
TAMAULIPAS,28,BURGOS,005,BURGOS,6,514,264,250,27
TAMAULIPAS,28,BURGOS,005,CÁNDIDO AGUILAR,3,72,38,34,6
TAMAULIPAS,28,BURGOS,005,EL BECERRO,2,9,4,5,1
TAMAULIPAS,28,BURGOS,005,EL CHARCO,2,21,12,9,2
TAMAULIPAS,28,BURGOS,005,EL DIVISADERO,2,6,5,1,1
TAMAULIPAS,28,BURGOS,005,EL HUIZACHE,2,12,8,4,2
TAMAULIPAS,28,BURGOS,005,EL MULATO,1,15,9,6,1
TAMAULIPAS,28,BURGOS,005,EL PEDREGAL,1,12,5,7,1
TAMAULIPAS,28,BURGOS,005,EMILIANO ZAPATA (LAS AMARILLAS),2,20,10,10,2
TAMAULIPAS,28,BURGOS,005,FRANCISCO I. MADERO,2,3,0,3,1
TAMAULIPAS,28,BURGOS,005,LABORES DE LA PAZ (LAS LABORES),1,4,2,2,1
TAMAULIPAS,28,BURGOS,005,LABORES DE LA PAZ (LOS DE ARRIBA),1,29,13,16,2
TAMAULIPAS,28,BURGOS,005,LAS MARGARITAS,1,15,7,8,1
TAMAULIPAS,28,BURGOS,005,LAS ROSILLAS,1,6,4,2,1
TAMAULIPAS,28,BURGOS,005,LÁZARO CÁRDENAS (RANCHO NUEVO),3,79,32,47,6
TAMAULIPAS,28,BURGOS,005,MACLOVIO HERRERA,2,7,4,3,1
TAMAULIPAS,28,BURGOS,005,SAN ISIDRO,2,15,6,9,2
TAMAULIPAS,28,BUSTAMANTE,006,BUSTAMANTE,4,439,212,227,26
TAMAULIPAS,28,BUSTAMANTE,006,CALABACILLAS,3,182,86,96,11
TAMAULIPAS,28,BUSTAMANTE,006,EL AGUACATE,4,212,115,97,14
TAMAULIPAS,28,BUSTAMANTE,006,EL CARACOL (LOS CARACOLES),3,40,21,19,3
TAMAULIPAS,28,BUSTAMANTE,006,EL LLANO Y ANEXAS (EL LLANO),3,94,53,41,5
TAMAULIPAS,28,BUSTAMANTE,006,EL MACUATE,3,48,22,26,4
TAMAULIPAS,28,BUSTAMANTE,006,FELIPE ÁNGELES (EL GAVILÁN),2,126,69,57,9
TAMAULIPAS,28,BUSTAMANTE,006,GABINO VÁZQUEZ (SANTA EFIGENIA),2,10,7,3,2
TAMAULIPAS,28,BUSTAMANTE,006,JOYA DEL QUIOTE,3,23,12,11,3
TAMAULIPAS,28,BUSTAMANTE,006,LA HIGUERA,3,25,14,11,3
TAMAULIPAS,28,BUSTAMANTE,006,LA JOYA DE HERRERA,2,44,19,25,3
TAMAULIPAS,28,BUSTAMANTE,006,LA LOMA RASA,2,19,12,7,2
TAMAULIPAS,28,BUSTAMANTE,006,LAS ALBERCAS,3,108,58,50,7
TAMAULIPAS,28,BUSTAMANTE,006,LAS ANTONIAS,3,66,33,33,4
TAMAULIPAS,28,BUSTAMANTE,006,LAS FLORES,3,73,40,33,5
TAMAULIPAS,28,BUSTAMANTE,006,LOS TANQUES,2,6,4,2,1
TAMAULIPAS,28,BUSTAMANTE,006,MAGDALENO AGUILAR (SAN VICENTE),3,98,50,48,6
TAMAULIPAS,28,BUSTAMANTE,006,NUEVO PROGRESO (LAS ÁNIMAS),2,35,19,16,2
TAMAULIPAS,28,BUSTAMANTE,006,PLUTARCO ELÍAS CALLES (JOYA DEL MAGUEY),3,45,21,24,4
TAMAULIPAS,28,BUSTAMANTE,006,SAN ANTONIO DE PADUA,4,122,61,61,10
TAMAULIPAS,28,BUSTAMANTE,006,SAN MIGUEL DE WALDO,2,49,21,28,3
TAMAULIPAS,28,BUSTAMANTE,006,SAN NICOLÁS,3,36,20,16,3
TAMAULIPAS,28,CAMARGO,007,CAMARGO (ESTRADEÑO DOS),1,16,9,7,1
TAMAULIPAS,28,CAMARGO,007,CIUDAD CAMARGO,14,2175,1110,1065,108
TAMAULIPAS,28,CAMARGO,007,COMALES,3,626,304,322,31
TAMAULIPAS,28,CAMARGO,007,EL AZÚCAR,1,7,3,4,1
TAMAULIPAS,28,CAMARGO,007,EL GONZALEÑO,1,32,10,22,1
TAMAULIPAS,28,CAMARGO,007,ESTACIÓN CAMARGO,2,36,16,20,3
TAMAULIPAS,28,CAMARGO,007,GUARDADOS DE ABAJO,2,56,31,25,4
TAMAULIPAS,28,CAMARGO,007,LÓPEZ Y NUEVO CADILLO,2,46,22,24,3
TAMAULIPAS,28,CAMARGO,007,LOS FRESNOS,2,27,13,14,3
TAMAULIPAS,28,CAMARGO,007,NUEVO CAMARGO,1,32,14,18,2
TAMAULIPAS,28,CAMARGO,007,NUEVO CAMARGO (VILLANUEVA),2,39,21,18,3
TAMAULIPAS,28,CAMARGO,007,PUERTECITOS,2,17,10,7,2
TAMAULIPAS,28,CAMARGO,007,RANCHERÍAS,3,123,64,59,7
TAMAULIPAS,28,CAMARGO,007,SAN FRANCISCO,3,122,60,62,8
TAMAULIPAS,28,CAMARGO,007,SANTA ROSALÍA,1,19,9,10,1
TAMAULIPAS,28,CAMARGO,007,TEPEHUAJE,2,22,13,9,2
TAMAULIPAS,28,CASAS,008,ADOLFO LÓPEZ MATEOS,2,17,8,9,2
TAMAULIPAS,28,CASAS,008,BUENAVISTA,2,9,2,7,2
TAMAULIPAS,28,CASAS,008,CASAS,4,319,161,158,32
TAMAULIPAS,28,CASAS,008,CINCO DE FEBRERO,2,27,11,16,2
TAMAULIPAS,28,CASAS,008,DIECINUEVE DE ABRIL,1,8,3,5,1
TAMAULIPAS,28,CASAS,008,EDUARDO BENAVIDES (EL ALMAGRE),2,13,8,5,2
TAMAULIPAS,28,CASAS,008,EL AMPARO,2,28,11,17,3
TAMAULIPAS,28,CASAS,008,EL NOGALITO,2,3,1,2,1
TAMAULIPAS,28,CASAS,008,JACINTO CANEK,2,33,15,18,3
TAMAULIPAS,28,CASAS,008,LA GUADALUPANA (LAS ADJUNTAS),2,3,2,1,1
TAMAULIPAS,28,CASAS,008,LAJILLA DEL NORTE,2,50,24,26,4
TAMAULIPAS,28,CASAS,008,LÁZARO CÁRDENAS,4,117,60,57,10
TAMAULIPAS,28,CASAS,008,LOS ALGODONES,1,5,2,3,1
TAMAULIPAS,28,CASAS,008,LOS ÁNGELES (FELIPE ÁNGELES) [EJIDO],3,21,8,13,3
TAMAULIPAS,28,CASAS,008,NUEVO SAN FRANCISCO,4,48,18,30,7
TAMAULIPAS,28,CASAS,008,PRAXEDIS BALBOA,1,6,2,4,1
TAMAULIPAS,28,CASAS,008,SAN ANTONIO EL GRANDE,2,8,4,4,1
TAMAULIPAS,28,CASAS,008,SAN FRANCISCO (ESTACIÓN SAN FRANCISCO),3,39,18,21,5
TAMAULIPAS,28,CASAS,008,SAN VICENTE,1,1,0,1,0
TAMAULIPAS,28,CASAS,008,SUBIDA DE PALMAS,2,3,2,1,1
TAMAULIPAS,28,CIUDAD MADERO,009,CIUDAD MADERO,293,49499,23524,25975,3495
TAMAULIPAS,28,CRUILLAS,010,CRUILLAS,5,242,118,124,17
TAMAULIPAS,28,CRUILLAS,010,EL BARRANCO,3,54,26,28,5
TAMAULIPAS,28,CRUILLAS,010,EL BRASIL (LA NORIA),2,5,1,4,2
TAMAULIPAS,28,CRUILLAS,010,LA LOBERA,2,30,22,8,3
TAMAULIPAS,28,CRUILLAS,010,LA UNIÓN,2,35,15,20,3
TAMAULIPAS,28,GÓMEZ FARÍAS,011,ALFREDO V. BONFIL (EL PAPALOTE),3,22,6,16,3
TAMAULIPAS,28,GÓMEZ FARÍAS,011,ALTA CIMA,3,32,16,16,3
TAMAULIPAS,28,GÓMEZ FARÍAS,011,AMÉRICO VILLARREAL,2,12,2,10,2
TAMAULIPAS,28,GÓMEZ FARÍAS,011,BENITO JUÁREZ (LA RIBERA),2,76,30,46,5
TAMAULIPAS,28,GÓMEZ FARÍAS,011,EL AZTECA,4,97,36,61,9
TAMAULIPAS,28,GÓMEZ FARÍAS,011,EL NACIMIENTO,2,18,9,9,2
TAMAULIPAS,28,GÓMEZ FARÍAS,011,EL OJO DE AGUA,2,30,13,17,3
TAMAULIPAS,28,GÓMEZ FARÍAS,011,EL RIACHUELO,2,17,11,6,2
TAMAULIPAS,28,GÓMEZ FARÍAS,011,EL VENADITO,2,58,25,33,4
TAMAULIPAS,28,GÓMEZ FARÍAS,011,EMILIANO ZAPATA,2,56,19,37,4
TAMAULIPAS,28,GÓMEZ FARÍAS,011,GÓMEZ FARÍAS,3,274,145,129,24
TAMAULIPAS,28,GÓMEZ FARÍAS,011,GUADALUPE VICTORIA,3,49,19,30,5
TAMAULIPAS,28,GÓMEZ FARÍAS,011,HÉROES DE CHAPULTEPEC,1,13,6,7,1
TAMAULIPAS,28,GÓMEZ FARÍAS,011,LA ESPERANZA,1,14,6,8,1
TAMAULIPAS,28,GÓMEZ FARÍAS,011,LA TAXQUEÑA,2,38,22,16,3
TAMAULIPAS,28,GÓMEZ FARÍAS,011,LOMA ALTA (LOMA ALTA DE GÓMEZ FARÍAS),6,807,412,395,92
TAMAULIPAS,28,GÓMEZ FARÍAS,011,NUEVO PENSAR DEL CAMPESINO,2,34,15,19,3
TAMAULIPAS,28,GÓMEZ FARÍAS,011,PLAN DE GUADALUPE,3,50,18,32,7
TAMAULIPAS,28,GÓMEZ FARÍAS,011,POBLADO 601,3,76,37,39,6
TAMAULIPAS,28,GÓMEZ FARÍAS,011,RAÚL VELA GARCÍA (LAS ADELAS),2,19,11,8,2
TAMAULIPAS,28,GÓMEZ FARÍAS,011,SABINAS Y SAUCILLO,2,21,8,13,2
TAMAULIPAS,28,GÓMEZ FARÍAS,011,SAN JOSÉ,3,14,4,10,2
TAMAULIPAS,28,GÓMEZ FARÍAS,011,SAN PEDRITO,2,43,21,22,3
TAMAULIPAS,28,GÓMEZ FARÍAS,011,SEGUNDA AMPLIACIÓN DEL OJO DE AGUA,2,21,10,11,2
TAMAULIPAS,28,GONZÁLEZ,012,ADOLFO RUIZ CORTINES,3,75,42,33,6
TAMAULIPAS,28,GONZÁLEZ,012,ATIZAPÁN DE ZARAGOZA,3,62,33,29,6
TAMAULIPAS,28,GONZÁLEZ,012,AURELIANO CABALLERO,3,56,43,13,5
TAMAULIPAS,28,GONZÁLEZ,012,EL BERNAL,1,41,21,20,2
TAMAULIPAS,28,GONZÁLEZ,012,EL CENTAURO,3,72,28,44,6
TAMAULIPAS,28,GONZÁLEZ,012,EL MEZQUITAL,3,9,5,4,2
TAMAULIPAS,28,GONZÁLEZ,012,EL PROGRESO,3,46,25,21,6
TAMAULIPAS,28,GONZÁLEZ,012,ESTACIÓN MANUEL (ÚRSULO GALVÁN),12,2180,1120,1060,108
TAMAULIPAS,28,GONZÁLEZ,012,FELIPE CARRILLO PUERTO,1,11,5,6,1
TAMAULIPAS,28,GONZÁLEZ,012,FORTÍN AGRARIO (ESTACIÓN CALLES),1,3,0,3,1
TAMAULIPAS,28,GONZÁLEZ,012,FRANCISCO I. MADERO DOS,5,344,184,160,18
TAMAULIPAS,28,GONZÁLEZ,012,GONZÁLEZ,16,2891,1513,1378,174
TAMAULIPAS,28,GONZÁLEZ,012,GONZÁLEZ [EJIDO],2,95,50,45,7
TAMAULIPAS,28,GONZÁLEZ,012,GRACIANO SÁNCHEZ,6,942,464,478,44
TAMAULIPAS,28,GONZÁLEZ,012,GUSTAVO DÍAZ ORDAZ,2,20,13,7,2
TAMAULIPAS,28,GONZÁLEZ,012,INDEPENDENCIA Y REVOLUCIÓN,2,7,6,1,1
TAMAULIPAS,28,GONZÁLEZ,012,LA GLORIA,3,40,12,28,5
TAMAULIPAS,28,GONZÁLEZ,012,LA REFORMA,3,105,53,52,7
TAMAULIPAS,28,GONZÁLEZ,012,LA TORRECILLA,2,4,3,1,2
TAMAULIPAS,28,GONZÁLEZ,012,LAS ÁGUILAS DEL BERNAL,1,12,3,9,1
TAMAULIPAS,28,GONZÁLEZ,012,LÓPEZ RAYÓN,5,429,225,204,23
TAMAULIPAS,28,GONZÁLEZ,012,MAGISCATZIN,3,189,90,99,15
TAMAULIPAS,28,GONZÁLEZ,012,NICOLÁS BRAVO,3,42,16,26,4
TAMAULIPAS,28,GONZÁLEZ,012,NUEVO QUINTERO,3,97,47,50,8
TAMAULIPAS,28,GONZÁLEZ,012,ROSILLO,1,8,4,4,1
TAMAULIPAS,28,GONZÁLEZ,012,SAN ANTONIO NOGALAR,1,9,3,6,1
TAMAULIPAS,28,GONZÁLEZ,012,SAN ANTONIO RAYÓN,3,246,124,122,11
TAMAULIPAS,28,GONZÁLEZ,012,SAN FERNANDO,2,19,8,11,2
TAMAULIPAS,28,GONZÁLEZ,012,SAN PEDRO,3,48,21,27,5
TAMAULIPAS,28,GONZÁLEZ,012,SANTA FE,3,229,117,112,13
TAMAULIPAS,28,GONZÁLEZ,012,TAMAHOLIPA,2,34,17,17,3
TAMAULIPAS,28,GONZÁLEZ,012,VENUSTIANO CARRANZA DOS,3,115,67,48,8
TAMAULIPAS,28,GONZÁLEZ,012,VENUSTIANO CARRANZA UNO,3,50,23,27,6
TAMAULIPAS,28,GÜÉMEZ,013,ACATLÁN (PLUTARCO ELÍAS CALLES),2,27,13,14,2
TAMAULIPAS,28,GÜÉMEZ,013,AMPLIACIÓN EL REFUGIO (EL CHAMIZAL),2,48,26,22,4
TAMAULIPAS,28,GÜÉMEZ,013,BALCONCITOS,2,135,77,58,8
TAMAULIPAS,28,GÜÉMEZ,013,CEYLÁN,1,2,1,1,1
TAMAULIPAS,28,GÜÉMEZ,013,CONSTITUCIÓN DEL DIECISIETE,3,68,37,31,6
TAMAULIPAS,28,GÜÉMEZ,013,EL ALAMITO,2,103,47,56,7
TAMAULIPAS,28,GÜÉMEZ,013,EL CARMEN,2,74,27,47,6
TAMAULIPAS,28,GÜÉMEZ,013,EL CERRITO NUEVO,2,70,41,29,5
TAMAULIPAS,28,GÜÉMEZ,013,EL OLMO,1,8,4,4,1
TAMAULIPAS,28,GÜÉMEZ,013,EL PORVENIR,2,21,9,12,3
TAMAULIPAS,28,GÜÉMEZ,013,EL PROGRESO,2,23,7,16,3
TAMAULIPAS,28,GÜÉMEZ,013,EL ROBLE,4,142,82,60,11
TAMAULIPAS,28,GÜÉMEZ,013,EL RUSIO (MARTÍNEZ),2,39,21,18,3
TAMAULIPAS,28,GÜÉMEZ,013,ESFUERZO DEL CAMPESINO,1,28,13,15,2
TAMAULIPAS,28,GÜÉMEZ,013,GRACIANO SÁNCHEZ,3,143,71,72,9
TAMAULIPAS,28,GÜÉMEZ,013,GUADALUPE VICTORIA,2,117,59,58,8
TAMAULIPAS,28,GÜÉMEZ,013,GÜÉMEZ,4,502,229,273,37
TAMAULIPAS,28,GÜÉMEZ,013,LA DIANA,2,26,12,14,3
TAMAULIPAS,28,GÜÉMEZ,013,LA ESPERANZA,1,3,2,1,1
TAMAULIPAS,28,GÜÉMEZ,013,LA PARRITA,2,36,18,18,3
TAMAULIPAS,28,GÜÉMEZ,013,LA ROSITA,3,13,5,8,3
TAMAULIPAS,28,GÜÉMEZ,013,LA SAN JUANA,2,119,54,65,9
TAMAULIPAS,28,GÜÉMEZ,013,LAS CRUCITAS,2,109,48,61,7
TAMAULIPAS,28,GÜÉMEZ,013,LOS SAN PEDROS [EJIDO],2,4,1,3,1
TAMAULIPAS,28,GÜÉMEZ,013,LUZ DEL CAMPESINO (CORONA),3,60,21,39,5
TAMAULIPAS,28,GÜÉMEZ,013,MIRAFLORES,4,153,62,91,12
TAMAULIPAS,28,GÜÉMEZ,013,PLAN DE AYALA,2,69,30,39,5
TAMAULIPAS,28,GÜÉMEZ,013,RANCHO NUEVO (LAS CHINAS),2,4,0,4,1
TAMAULIPAS,28,GÜÉMEZ,013,REVOLUCIÓN VERDE,3,36,19,17,5
TAMAULIPAS,28,GÜÉMEZ,013,RICARDO FLORES MAGÓN,1,8,2,6,1
TAMAULIPAS,28,GÜÉMEZ,013,SAN CAYETANO,3,340,174,166,21
TAMAULIPAS,28,GÜÉMEZ,013,SAN JOSÉ DE LAS FLORES,5,848,526,322,90
TAMAULIPAS,28,GÜÉMEZ,013,SAN JUANITO,1,60,28,32,5
TAMAULIPAS,28,GÜÉMEZ,013,SANTA ROSA,2,50,26,24,4
TAMAULIPAS,28,GÜÉMEZ,013,SERVANDO CANALES,3,123,63,60,10
TAMAULIPAS,28,GÜÉMEZ,013,VIENTO LIBRE,3,77,35,42,6
TAMAULIPAS,28,GUERRERO,014,NUEVA CIUDAD GUERRERO,7,598,299,299,37
TAMAULIPAS,28,GUSTAVO DÍAZ ORDAZ,015,BUENAVISTA,2,38,17,21,2
TAMAULIPAS,28,GUSTAVO DÍAZ ORDAZ,015,CIUDAD GUSTAVO DÍAZ ORDAZ,17,2720,1366,1354,205
TAMAULIPAS,28,GUSTAVO DÍAZ ORDAZ,015,IDEAL DEL CAMPESINO,1,38,24,14,2
TAMAULIPAS,28,GUSTAVO DÍAZ ORDAZ,015,LOS VILLARREALES,2,34,16,18,3
TAMAULIPAS,28,GUSTAVO DÍAZ ORDAZ,015,LUCIO BLANCO,3,86,44,42,5
TAMAULIPAS,28,GUSTAVO DÍAZ ORDAZ,015,LUIS ECHEVERRÍA ÁLVAREZ,3,17,8,9,3
TAMAULIPAS,28,GUSTAVO DÍAZ ORDAZ,015,MIGUEL HIDALGO,3,16,10,6,3
TAMAULIPAS,28,GUSTAVO DÍAZ ORDAZ,015,PIEDRAS,3,11,3,8,3
TAMAULIPAS,28,GUSTAVO DÍAZ ORDAZ,015,SAN VICENTE DEL POTRERO (BERTHA DÁVILA LÓPEZ),1,15,9,6,1
TAMAULIPAS,28,GUSTAVO DÍAZ ORDAZ,015,VALADECES,4,694,359,335,33
TAMAULIPAS,28,GUSTAVO DÍAZ ORDAZ,015,VALADECES [EJIDO],1,6,3,3,1
TAMAULIPAS,28,GUSTAVO DÍAZ ORDAZ,015,VENECIA,3,53,27,26,4
TAMAULIPAS,28,HIDALGO,016,BARBOSA,2,23,10,13,3
TAMAULIPAS,28,HIDALGO,016,BENITO JUÁREZ (MONFORT),4,145,81,64,10
TAMAULIPAS,28,HIDALGO,016,BUENOS AIRES,2,11,6,5,2
TAMAULIPAS,28,HIDALGO,016,CINCO DE MAYO,2,10,3,7,3
TAMAULIPAS,28,HIDALGO,016,COLONIA MILITAR AGRÍCOLA Y GANADERA (EL BURRO PINTO),2,3,2,1,1
TAMAULIPAS,28,HIDALGO,016,CRUZ Y CARMEN,2,43,19,24,4
TAMAULIPAS,28,HIDALGO,016,CRUZ Y CRUZ,3,129,62,67,10
TAMAULIPAS,28,HIDALGO,016,EL CHORRO (EL CHORRITO),2,17,9,8,2
TAMAULIPAS,28,HIDALGO,016,EL DESENGAÑO (LA PEÑITA),1,16,5,11,2
TAMAULIPAS,28,HIDALGO,016,EL PENSAMIENTO LIBRE,2,5,2,3,2
TAMAULIPAS,28,HIDALGO,016,EL SAUZ,3,45,17,28,5
TAMAULIPAS,28,HIDALGO,016,ESTACIÓN CARRIZOS,3,23,10,13,3
TAMAULIPAS,28,HIDALGO,016,ESTACIÓN LA CRUZ,3,32,11,21,3
TAMAULIPAS,28,HIDALGO,016,ESTACIÓN SANTA ENGRACIA,12,1608,825,783,94
TAMAULIPAS,28,HIDALGO,016,EX-HACIENDA DE LA MESA,2,5,5,0,1
TAMAULIPAS,28,HIDALGO,016,GENERAL JULIÁN CERDA,2,14,7,7,2
TAMAULIPAS,28,HIDALGO,016,GUADALUPE VICTORIA,2,14,4,10,2
TAMAULIPAS,28,HIDALGO,016,HIDALGO,7,994,510,484,67
TAMAULIPAS,28,HIDALGO,016,IGNACIO ALLENDE (ESTACIÓN ADELAIDA),2,2,1,1,1
TAMAULIPAS,28,HIDALGO,016,INDEPENDENCIA,3,66,33,33,6
TAMAULIPAS,28,HIDALGO,016,LA AURORA,2,77,37,40,7
TAMAULIPAS,28,HIDALGO,016,LA CRUCITA (LA PIRAGUA),2,14,5,9,2
TAMAULIPAS,28,HIDALGO,016,LA ESPERANZA,1,2,0,2,1
TAMAULIPAS,28,HIDALGO,016,LA PASTA,2,4,2,2,1
TAMAULIPAS,28,HIDALGO,016,LA TRINIDAD,2,13,5,8,2
TAMAULIPAS,28,HIDALGO,016,LAS MARGARITAS,1,38,15,23,2
TAMAULIPAS,28,HIDALGO,016,LOS ÁNGELES,4,60,31,29,11
TAMAULIPAS,28,HIDALGO,016,MARIANO ESCOBEDO,2,3,2,1,1
TAMAULIPAS,28,HIDALGO,016,MARROQUÍN,1,17,8,9,2
TAMAULIPAS,28,HIDALGO,016,NARCISO MENDOZA,2,22,12,10,2
TAMAULIPAS,28,HIDALGO,016,OYAMA,4,175,71,104,15
TAMAULIPAS,28,HIDALGO,016,PALO ALTO,2,17,6,11,2
TAMAULIPAS,28,HIDALGO,016,PURIFICACIÓN (PEÑUELAS),2,22,13,9,3
TAMAULIPAS,28,HIDALGO,016,RANCHO NUEVO,2,9,1,8,2
TAMAULIPAS,28,HIDALGO,016,SAN ANTONIO,3,67,29,38,7
TAMAULIPAS,28,HIDALGO,016,SAN FRANCISCO,3,40,19,21,6
TAMAULIPAS,28,HIDALGO,016,SAN ISIDRO,2,15,5,10,2
TAMAULIPAS,28,HIDALGO,016,SAN JUAN DEL SALTO,1,14,2,12,1
TAMAULIPAS,28,HIDALGO,016,SAN JUANA,2,20,10,10,2
TAMAULIPAS,28,HIDALGO,016,SAN PEDRO,3,23,9,14,3
TAMAULIPAS,28,HIDALGO,016,SANTA CLEOTILDE,1,12,10,2,1
TAMAULIPAS,28,HIDALGO,016,SANTA CRUZ,2,10,6,4,2
TAMAULIPAS,28,HIDALGO,016,SANTA FE,2,20,5,15,2
TAMAULIPAS,28,JAUMAVE,017,ÁVILA Y URBINA (LA MECA),3,73,38,35,6
TAMAULIPAS,28,JAUMAVE,017,CINCO DE MAYO,2,28,12,16,3
TAMAULIPAS,28,JAUMAVE,017,COMPUERTAS,2,238,128,110,14
TAMAULIPAS,28,JAUMAVE,017,CONRADO CASTILLO (LA MAROMA),2,50,23,27,3
TAMAULIPAS,28,JAUMAVE,017,EL ATRAVESAÑO,1,6,4,2,1
TAMAULIPAS,28,JAUMAVE,017,EL CARRIZO,3,47,20,27,5
TAMAULIPAS,28,JAUMAVE,017,EL HIGUERÓN,2,30,6,24,3
TAMAULIPAS,28,JAUMAVE,017,EL INGENIO (LOS ADOBES),2,19,9,10,3
TAMAULIPAS,28,JAUMAVE,017,EL SAUZ,1,15,8,7,1
TAMAULIPAS,28,JAUMAVE,017,EL SOTOL,2,33,18,15,3
TAMAULIPAS,28,JAUMAVE,017,FRANCISCO I. MADERO (MAGUEYES),3,40,19,21,4
TAMAULIPAS,28,JAUMAVE,017,FRANCISCO MEDRANO (LAS PILAS),1,29,11,18,2
TAMAULIPAS,28,JAUMAVE,017,JAUMAVE,7,2237,1241,996,148
TAMAULIPAS,28,JAUMAVE,017,JOSÉ MARÍA MORELOS (EL NOPAL),3,160,79,81,11
TAMAULIPAS,28,JAUMAVE,017,LA INDEPENDENCIA (LAS MORITAS),3,95,49,46,8
TAMAULIPAS,28,JAUMAVE,017,LA REFORMA,2,35,17,18,3
TAMAULIPAS,28,JAUMAVE,017,LA UNIÓN,3,43,21,22,6
TAMAULIPAS,28,JAUMAVE,017,MAGDALENO AGUILAR (SANTIAGUILLO),3,36,19,17,5
TAMAULIPAS,28,JAUMAVE,017,MATÍAS GARCÍA (LA HACIENDA),3,150,68,82,11
TAMAULIPAS,28,JAUMAVE,017,MONTERREDONDO,3,54,24,30,4
TAMAULIPAS,28,JAUMAVE,017,PADRÓN Y JUÁREZ (LA PUENTE),4,167,81,86,11
TAMAULIPAS,28,JAUMAVE,017,PLAN DE AYALA (LAS CALABAZAS),2,19,6,13,2
TAMAULIPAS,28,JAUMAVE,017,RANCHO NUEVO (CAÑITAS),3,93,52,41,7
TAMAULIPAS,28,JAUMAVE,017,REDENCIÓN DEL CAMPESINO (PALOMAS),1,4,1,3,1
TAMAULIPAS,28,JAUMAVE,017,SAN ANTONIO,2,208,89,119,13
TAMAULIPAS,28,JAUMAVE,017,SAN FRANCISCO DE ZORRILLA,2,21,8,13,2
TAMAULIPAS,28,JAUMAVE,017,SAN JOSÉ DE SALAMANCA,2,32,12,20,3
TAMAULIPAS,28,JAUMAVE,017,SAN JUAN DE ORIENTE,3,105,58,47,7
TAMAULIPAS,28,JAUMAVE,017,SAN JUANITO,3,114,65,49,8
TAMAULIPAS,28,JAUMAVE,017,SAN LORENCITO (SAN LORENZO),2,55,26,29,4
TAMAULIPAS,28,JAUMAVE,017,SAN VICENTE,2,19,10,9,3
TAMAULIPAS,28,JAUMAVE,017,SEIS DE ENERO,2,10,7,3,2
TAMAULIPAS,28,JIMÉNEZ,018,ALLENDE,3,129,66,63,14
TAMAULIPAS,28,JIMÉNEZ,018,BENITO JUÁREZ (EL TEPEYAC),2,15,7,8,2
TAMAULIPAS,28,JIMÉNEZ,018,CAMPESINOS INSURGENTES (EL TÍO BETO),3,10,2,8,3
TAMAULIPAS,28,JIMÉNEZ,018,JOSÉ SILVA SÁNCHEZ,2,12,6,6,2
TAMAULIPAS,28,JIMÉNEZ,018,JUAN BÁEZ GUERRA,2,11,2,9,2
TAMAULIPAS,28,JIMÉNEZ,018,LA ESPERANZA (LA POLVAREDA),1,6,4,2,1
TAMAULIPAS,28,JIMÉNEZ,018,LA FE DEL GOLFO,3,22,9,13,2
TAMAULIPAS,28,JIMÉNEZ,018,LA LIBERTAD CAMPESINA,3,39,23,16,5
TAMAULIPAS,28,JIMÉNEZ,018,LOS LAURELES,1,4,2,2,1
TAMAULIPAS,28,JIMÉNEZ,018,MARIANO ESCOBEDO (LA AZUFROSA),2,23,11,12,2
TAMAULIPAS,28,JIMÉNEZ,018,NUEVA ERA,1,5,3,2,1
TAMAULIPAS,28,JIMÉNEZ,018,SANTANDER JIMÉNEZ,8,945,462,483,62
TAMAULIPAS,28,JIMÉNEZ,018,SOR JUANA INÉS DE LA CRUZ,2,13,5,8,2
TAMAULIPAS,28,LLERA,019,ADOLFO LÓPEZ MATEOS,2,26,15,11,3
TAMAULIPAS,28,LLERA,019,ADOLFO RUIZ CORTINES,2,25,11,14,2
TAMAULIPAS,28,LLERA,019,AMPLIACIÓN LAS MINAS (JUAN PARRAS),1,3,2,1,1
TAMAULIPAS,28,LLERA,019,CAPITÁN EMILIO CARRANZA (FORLÓN),2,42,24,18,3
TAMAULIPAS,28,LLERA,019,CASA DEL CAMPESINO (LA CLEMENTINA),2,62,27,35,3
TAMAULIPAS,28,LLERA,019,CONRADO CASTILLO,1,3,0,3,1
TAMAULIPAS,28,LLERA,019,DOS DE OCTUBRE,2,22,9,13,2
TAMAULIPAS,28,LLERA,019,EL AQUICHAL (EL PINTO),2,13,7,6,2
TAMAULIPAS,28,LLERA,019,EL CIPRÉS,1,5,3,2,1
TAMAULIPAS,28,LLERA,019,EL CIPRÉS (SANTA ROSA),3,11,4,7,2
TAMAULIPAS,28,LLERA,019,EL ÉBANO,2,19,12,7,3
TAMAULIPAS,28,LLERA,019,EL GUAYABO,1,9,3,6,1
TAMAULIPAS,28,LLERA,019,EL NUEVO ENCINO (EL ENCINO),4,229,119,110,19
TAMAULIPAS,28,LLERA,019,EL NUEVO PARAÍSO,2,29,11,18,3
TAMAULIPAS,28,LLERA,019,EL PEÑÓN,1,4,3,1,1
TAMAULIPAS,28,LLERA,019,EL PRADO,2,36,18,18,3
TAMAULIPAS,28,LLERA,019,EMILIANO ZAPATA,4,291,143,148,46
TAMAULIPAS,28,LLERA,019,EMILIO PORTES GIL,1,4,1,3,1
TAMAULIPAS,28,LLERA,019,FELIPE CARRILLO PUERTO,2,10,6,4,2
TAMAULIPAS,28,LLERA,019,FRANCISCO CASTELLANOS,1,4,3,1,1
TAMAULIPAS,28,LLERA,019,FRANCISCO VILLA,2,75,33,42,6
TAMAULIPAS,28,LLERA,019,GENERAL PEDRO JOSÉ MÉNDEZ,2,51,26,25,4
TAMAULIPAS,28,LLERA,019,IGNACIO ZARAGOZA,4,328,175,153,32
TAMAULIPAS,28,LLERA,019,JOSÉ SILVA SÁNCHEZ,1,12,6,6,1
TAMAULIPAS,28,LLERA,019,LA ALBERCA,1,7,4,3,1
TAMAULIPAS,28,LLERA,019,LA ANGOSTURA,2,6,4,2,1
TAMAULIPAS,28,LLERA,019,LA INDEPENDENCIA,2,56,30,26,3
TAMAULIPAS,28,LLERA,019,LA LIBERTAD,2,47,21,26,4
TAMAULIPAS,28,LLERA,019,LA MORITA,2,40,19,21,4
TAMAULIPAS,28,LLERA,019,LAS COMPUERTAS,3,79,47,32,6
TAMAULIPAS,28,LLERA,019,LAS TORTUGAS [NUEVO CENTRO DE POBLACIÓN],2,16,7,9,2
TAMAULIPAS,28,LLERA,019,LLERA DE CANALES,6,964,467,497,75
TAMAULIPAS,28,LLERA,019,MARIANO ESCOBEDO,2,56,16,40,4
TAMAULIPAS,28,LLERA,019,PORVENIR DEL CAMPESINO (LA PURÍSIMA),1,6,3,3,1
TAMAULIPAS,28,LLERA,019,PRIMERO DE ABRIL,2,37,21,16,4
TAMAULIPAS,28,LLERA,019,RANCHO NUEVO DEL SUR,2,20,13,7,2
TAMAULIPAS,28,LLERA,019,SAN ISIDRO,3,68,32,36,5
TAMAULIPAS,28,LLERA,019,SAN MIGUEL DEL OLIVO [CONGREGACIÓN],2,4,0,4,1
TAMAULIPAS,28,LLERA,019,SAN PEDRO DE LA COLINA (EL RANCHITO),2,6,3,3,1
TAMAULIPAS,28,LLERA,019,SAN RAFAEL,3,226,114,112,20
TAMAULIPAS,28,LLERA,019,SANTA INÉS,2,36,11,25,3
TAMAULIPAS,28,LLERA,019,SANTA ISABEL (SARTENEJOS),1,12,6,6,1
TAMAULIPAS,28,LLERA,019,VOZ CAMPESINA (PROVIDENCIA),2,47,23,24,3
TAMAULIPAS,28,MAINERO,020,EMILIANO ZAPATA,2,26,11,15,4
TAMAULIPAS,28,MAINERO,020,EMILIO VÁZQUEZ GÓMEZ (AGUA FRÍA),2,6,5,1,1
TAMAULIPAS,28,MAINERO,020,FRANCISCO I. MADERO,2,5,2,3,1
TAMAULIPAS,28,MAINERO,020,JOSÉ DELGADO,1,3,0,3,0
TAMAULIPAS,28,MAINERO,020,JOSÉ GUADALUPE MAINERO,2,16,8,8,2
TAMAULIPAS,28,MAINERO,020,JOSÉ MARÍA PINO SUÁREZ,2,15,7,8,2
TAMAULIPAS,28,MAINERO,020,LA CIENEGUITA,1,3,2,1,1
TAMAULIPAS,28,MAINERO,020,LA GLORIA,2,3,1,2,1
TAMAULIPAS,28,MAINERO,020,LAS MORENITAS,2,7,3,4,1
TAMAULIPAS,28,MAINERO,020,LAS PUENTES,1,3,1,2,1
TAMAULIPAS,28,MAINERO,020,MAGUEYES,3,120,55,65,10
TAMAULIPAS,28,MAINERO,020,VILLA MAINERO,4,172,83,89,14
TAMAULIPAS,28,EL MANTE,021,BELLAVISTA,2,32,19,13,3
TAMAULIPAS,28,EL MANTE,021,BENITO JUÁREZ,2,49,18,31,4
TAMAULIPAS,28,EL MANTE,021,CAMOTERO NÚMERO DOS,3,144,70,74,11
TAMAULIPAS,28,EL MANTE,021,CELAYA,5,308,142,166,38
TAMAULIPAS,28,EL MANTE,021,CINCO DE MAYO,3,77,41,36,6
TAMAULIPAS,28,EL MANTE,021,CIUDAD MANTE,124,21293,10885,10408,1817
TAMAULIPAS,28,EL MANTE,021,DIECIOCHO DE MARZO,2,48,20,28,4
TAMAULIPAS,28,EL MANTE,021,DIECISÉIS DE SEPTIEMBRE (EL NUEVE),2,9,5,4,2
TAMAULIPAS,28,EL MANTE,021,DIVISIÓN DEL NORTE,3,157,89,68,11
TAMAULIPAS,28,EL MANTE,021,EL ABRA,5,511,248,263,28
TAMAULIPAS,28,EL MANTE,021,EL ABRA (OJO DE AGUA),2,56,26,30,4
TAMAULIPAS,28,EL MANTE,021,EL LIMÓN,8,564,271,293,42
TAMAULIPAS,28,EL MANTE,021,EL NARANJO,1,13,7,6,1
TAMAULIPAS,28,EL MANTE,021,EL OLÍMPICO,2,19,11,8,2
TAMAULIPAS,28,EL MANTE,021,EL REFUGIO,1,9,6,3,1
TAMAULIPAS,28,EL MANTE,021,EL TRIUNFO NÚMERO UNO,2,24,13,11,2
TAMAULIPAS,28,EL MANTE,021,EMILIANO ZAPATA,2,29,11,18,3
TAMAULIPAS,28,EL MANTE,021,FAJA DE ORO,3,56,29,27,6
TAMAULIPAS,28,EL MANTE,021,FELIPE ÁNGELES,2,17,10,7,2
TAMAULIPAS,28,EL MANTE,021,GENERAL JESÚS GONZÁLEZ ORTEGA,2,6,4,2,1
TAMAULIPAS,28,EL MANTE,021,GUAYALEJO NÚMERO 2,1,2,0,2,1
TAMAULIPAS,28,EL MANTE,021,IGNACIO ALLENDE,2,23,6,17,2
TAMAULIPAS,28,EL MANTE,021,IGNACIO MANUEL ALTAMIRANO,3,88,39,49,6
TAMAULIPAS,28,EL MANTE,021,JOSÉ MARÍA MORELOS,2,33,10,23,2
TAMAULIPAS,28,EL MANTE,021,LA MORA,3,62,33,29,5
TAMAULIPAS,28,EL MANTE,021,LA NUEVA UNIÓN,2,18,9,9,2
TAMAULIPAS,28,EL MANTE,021,LA REFORMA,2,3,3,0,1
TAMAULIPAS,28,EL MANTE,021,LA VEGA (LA PEPA),1,6,2,4,1
TAMAULIPAS,28,EL MANTE,021,LADRILLERA DE LA CHACA,2,19,9,10,3
TAMAULIPAS,28,EL MANTE,021,LAS ÁNIMAS,2,23,7,16,2
TAMAULIPAS,28,EL MANTE,021,LÁZARO CÁRDENAS DOS,3,65,30,35,6
TAMAULIPAS,28,EL MANTE,021,LOS AZTECAS,3,410,194,216,27
TAMAULIPAS,28,EL MANTE,021,LOS GENERALES,2,33,12,21,3
TAMAULIPAS,28,EL MANTE,021,MAGDALENO AGUILAR,4,106,53,53,7
TAMAULIPAS,28,EL MANTE,021,MIGUEL HIDALGO,1,12,7,5,1
TAMAULIPAS,28,EL MANTE,021,NUEVA APOLONIA,5,446,224,222,22
TAMAULIPAS,28,EL MANTE,021,NUEVO TANTOÁN,4,417,206,211,21
TAMAULIPAS,28,EL MANTE,021,PLAN DE AYALA,5,251,124,127,17
TAMAULIPAS,28,EL MANTE,021,QUINTERO,5,248,116,132,17
TAMAULIPAS,28,EL MANTE,021,RICARDO FLORES MAGÓN,2,10,4,6,1
TAMAULIPAS,28,EL MANTE,021,SAN MIGUEL DE LA MORA,2,37,18,19,3
TAMAULIPAS,28,EL MANTE,021,SANTA CLARA (NÚMERO UNO),1,32,13,19,3
TAMAULIPAS,28,EL MANTE,021,SANTA CLARA NÚMERO DOS,2,30,14,16,3
TAMAULIPAS,28,EL MANTE,021,TANCHIPA,2,29,15,14,2
TAMAULIPAS,28,EL MANTE,021,TANTOYUQUITA,2,126,67,59,7
TAMAULIPAS,28,EL MANTE,021,TIERRA Y LIBERTAD,2,41,19,22,3
TAMAULIPAS,28,EL MANTE,021,TRIUNFO NÚMERO DOS,3,136,69,67,10
TAMAULIPAS,28,EL MANTE,021,VEINTE DE NOVIEMBRE,1,3,2,1,1
TAMAULIPAS,28,MATAMOROS,022,AMPLIACIÓN LA TIJERITA SECCIÓN 3 Y 4,1,11,9,2,1
TAMAULIPAS,28,MATAMOROS,022,CINCO DE MAYO,1,25,12,13,2
TAMAULIPAS,28,MATAMOROS,022,EL CAPOTE,2,51,25,26,3
TAMAULIPAS,28,MATAMOROS,022,EL CONTROL,7,545,270,275,32
TAMAULIPAS,28,MATAMOROS,022,EL EBANITO,3,234,113,121,16
TAMAULIPAS,28,MATAMOROS,022,EL GALANEÑO,4,802,379,423,85
TAMAULIPAS,28,MATAMOROS,022,EL HUIZACHAL,2,13,5,8,2
TAMAULIPAS,28,MATAMOROS,022,EL LONGOREÑO,4,596,282,314,24
TAMAULIPAS,28,MATAMOROS,022,EL MOQUETITO,4,206,108,98,16
TAMAULIPAS,28,MATAMOROS,022,EL RANCHITO Y REFUGIO (EL REFUGIO),4,281,143,138,14
TAMAULIPAS,28,MATAMOROS,022,EL REALITO,1,7,2,5,1
TAMAULIPAS,28,MATAMOROS,022,EL SABINITO,1,7,2,5,1
TAMAULIPAS,28,MATAMOROS,022,EL SABINO,1,24,9,15,3
TAMAULIPAS,28,MATAMOROS,022,EL TAHUACHAL,2,41,21,20,3
TAMAULIPAS,28,MATAMOROS,022,ESTACIÓN SANDOVAL,3,234,133,101,20
TAMAULIPAS,28,MATAMOROS,022,FRANCISCO I. MADERO,3,115,58,57,7
TAMAULIPAS,28,MATAMOROS,022,GUADALUPE,2,109,51,58,7
TAMAULIPAS,28,MATAMOROS,022,HEROICA MATAMOROS,511,126990,64167,62823,7725
TAMAULIPAS,28,MATAMOROS,022,ISLA LA MANO DE LEÓN,3,30,14,16,4
TAMAULIPAS,28,MATAMOROS,022,JUANILLO,3,231,109,122,42
TAMAULIPAS,28,MATAMOROS,022,LA BARRANCA,1,20,6,14,2
TAMAULIPAS,28,MATAMOROS,022,LA BARTOLINA,3,79,31,48,6
TAMAULIPAS,28,MATAMOROS,022,LA BRIGADA,1,15,7,8,1
TAMAULIPAS,28,MATAMOROS,022,LA CAPILLA,3,144,69,75,7
TAMAULIPAS,28,MATAMOROS,022,LA GLORIA,2,64,27,37,7
TAMAULIPAS,28,MATAMOROS,022,LA JARITA SUR,3,101,51,50,7
TAMAULIPAS,28,MATAMOROS,022,LA SIERRITA,3,56,22,34,6
TAMAULIPAS,28,MATAMOROS,022,LA SOLEDAD (ASUNCIÓN ÁLVAREZ),1,23,11,12,3
TAMAULIPAS,28,MATAMOROS,022,LA TIJERITA,3,59,25,34,7
TAMAULIPAS,28,MATAMOROS,022,LA VANGUARDIA,2,51,29,22,4
TAMAULIPAS,28,MATAMOROS,022,LA VENADA,3,517,235,282,31
TAMAULIPAS,28,MATAMOROS,022,LAGUNA HONDA,3,47,28,19,5
TAMAULIPAS,28,MATAMOROS,022,LAS BAYITAS,1,8,1,7,1
TAMAULIPAS,28,MATAMOROS,022,LAS HIGUERILLAS,4,703,331,372,28
TAMAULIPAS,28,MATAMOROS,022,LAS RUSIAS (CRISTÓBAL LOZANO),3,49,25,24,9
TAMAULIPAS,28,MATAMOROS,022,LOS NOGALES,1,7,4,3,1
TAMAULIPAS,28,MATAMOROS,022,LOS TIMONES,2,57,30,27,4
TAMAULIPAS,28,MATAMOROS,022,MAR THOMA,2,14,12,2,2
TAMAULIPAS,28,MATAMOROS,022,MOGOTE DE SANTIAGO,1,12,7,5,1
TAMAULIPAS,28,MATAMOROS,022,PACHECO,2,47,26,21,4
TAMAULIPAS,28,MATAMOROS,022,PRESIDENTE CÁRDENAS (VILLA CÁRDENAS),3,453,242,211,53
TAMAULIPAS,28,MATAMOROS,022,PRIMER CAMPO PESQUERO,3,76,34,42,5
TAMAULIPAS,28,MATAMOROS,022,PRISCILIANO DELGADO,2,18,8,10,2
TAMAULIPAS,28,MATAMOROS,022,PROGRESO AGRARIO (SANTA LIBRADA),2,79,34,45,4
TAMAULIPAS,28,MATAMOROS,022,RAMÍREZ,3,471,235,236,29
TAMAULIPAS,28,MATAMOROS,022,RANCHO VIEJO,1,30,15,15,2
TAMAULIPAS,28,MATAMOROS,022,REVOLUCIÓN,3,73,32,41,5
TAMAULIPAS,28,MATAMOROS,022,RÍO RICO,2,24,12,12,2
TAMAULIPAS,28,MATAMOROS,022,SAN ANDRÉS,1,25,16,9,1
TAMAULIPAS,28,MATAMOROS,022,SAN LORENZO,2,28,14,14,2
TAMAULIPAS,28,MATAMOROS,022,SAN LUISITO,1,59,28,31,4
TAMAULIPAS,28,MATAMOROS,022,SANTA ADELAIDA,4,364,157,207,17
TAMAULIPAS,28,MATAMOROS,022,SOLISEÑO,3,85,36,49,6
TAMAULIPAS,28,MATAMOROS,022,VENUSTIANO CARRANZA,1,13,8,5,1
TAMAULIPAS,28,MATAMOROS,022,VILLANUEVA,2,60,25,35,4
TAMAULIPAS,28,MATAMOROS,022,VILLAVERDE,2,16,6,10,2
TAMAULIPAS,28,MATAMOROS,022,VISTA HERMOSA,2,66,34,32,4
TAMAULIPAS,28,MÉNDEZ,023,AMÉRICO VILLARREAL GUERRA,1,28,15,13,2
TAMAULIPAS,28,MÉNDEZ,023,COMAS ALTAS,1,3,1,2,1
TAMAULIPAS,28,MÉNDEZ,023,EL LOBO (LA ESCONDIDA),2,26,12,14,2
TAMAULIPAS,28,MÉNDEZ,023,EMILIO PORTES GIL (SAN FELIPE),2,19,11,8,2
TAMAULIPAS,28,MÉNDEZ,023,ESPIADEROS DOS (CHAPEÑO DOS),1,21,11,10,2
TAMAULIPAS,28,MÉNDEZ,023,GUADALUPE,2,19,12,7,3
TAMAULIPAS,28,MÉNDEZ,023,HUGO PEDRO GONZÁLEZ,1,14,6,8,1
TAMAULIPAS,28,MÉNDEZ,023,JUAN SARABIA,2,15,7,8,2
TAMAULIPAS,28,MÉNDEZ,023,LA PURÍSIMA,1,25,10,15,2
TAMAULIPAS,28,MÉNDEZ,023,LUIS ECHEVERRÍA ÁLVAREZ,2,45,24,21,4
TAMAULIPAS,28,MÉNDEZ,023,MÉNDEZ,4,312,145,167,20
TAMAULIPAS,28,MÉNDEZ,023,PEDRO JOSÉ MÉNDEZ,4,157,78,79,12
TAMAULIPAS,28,MÉNDEZ,023,PEDRO JOSÉ MÉNDEZ (SAN PEDRO DE LOS GUTIÉRREZ),2,5,2,3,2
TAMAULIPAS,28,MÉNDEZ,023,SAN LORENZO DE CÁRDENAS GONZÁLEZ,3,82,36,46,7
TAMAULIPAS,28,MÉNDEZ,023,SANTA RITA,2,25,16,9,2
TAMAULIPAS,28,MIER,024,MIER,7,765,387,378,45
TAMAULIPAS,28,MIGUEL ALEMÁN,025,ARCABUZ,3,50,31,19,4
TAMAULIPAS,28,MIGUEL ALEMÁN,025,CIUDAD MIGUEL ALEMÁN,40,4398,2267,2131,375
TAMAULIPAS,28,MIGUEL ALEMÁN,025,GUARDADOS DE ARRIBA,2,64,30,34,3
TAMAULIPAS,28,MIGUEL ALEMÁN,025,LOS ÁNGELES,3,183,86,97,11
TAMAULIPAS,28,MIGUEL ALEMÁN,025,LOS GUERRA,6,500,221,279,46
TAMAULIPAS,28,MIQUIHUANA,026,ALTAMIRA,2,5,4,1,2
TAMAULIPAS,28,MIQUIHUANA,026,ESTANQUE DE LOS EGUÍA,2,24,12,12,2
TAMAULIPAS,28,MIQUIHUANA,026,ESTANQUE DE LOS WALLE,2,23,12,11,2
TAMAULIPAS,28,MIQUIHUANA,026,LA PEÑA,3,144,70,74,10
TAMAULIPAS,28,MIQUIHUANA,026,MIQUIHUANA,5,540,275,265,34
TAMAULIPAS,28,MIQUIHUANA,026,SAN JOSÉ DEL LLANO,3,183,94,89,12
TAMAULIPAS,28,MIQUIHUANA,026,SERVANDO CANALES (LA ARENA),2,6,3,3,1
TAMAULIPAS,28,MIQUIHUANA,026,VALLE HERMOSO,2,4,4,0,1
TAMAULIPAS,28,NUEVO LAREDO,027,EL BAYITO,1,681,332,349,17
TAMAULIPAS,28,NUEVO LAREDO,027,EL CAMPANARIO Y ORADEL,4,1029,534,495,32
TAMAULIPAS,28,NUEVO LAREDO,027,LA CRUZ,1,15,10,5,1
TAMAULIPAS,28,NUEVO LAREDO,027,NUEVO LAREDO,455,104882,53236,51646,6010
TAMAULIPAS,28,NUEVO MORELOS,028,AMPLIACIÓN DE LA REFORMA,2,41,20,21,3
TAMAULIPAS,28,NUEVO MORELOS,028,EL JORDÁN,1,15,8,7,1
TAMAULIPAS,28,NUEVO MORELOS,028,EL PARAÍSO,2,11,6,5,2
TAMAULIPAS,28,NUEVO MORELOS,028,EMILIANO ZAPATA,2,12,4,8,2
TAMAULIPAS,28,NUEVO MORELOS,028,FRANCISCO VILLA,2,20,12,8,2
TAMAULIPAS,28,NUEVO MORELOS,028,NUEVO MORELOS,8,688,317,371,37
TAMAULIPAS,28,NUEVO MORELOS,028,SANTA CRUZ DEL TORO,3,151,66,85,9
TAMAULIPAS,28,OCAMPO,029,ADOLFO LÓPEZ MATEOS (CHAMAL NUEVO),4,294,127,167,24
TAMAULIPAS,28,OCAMPO,029,ALTAMIRA,1,7,1,6,1
TAMAULIPAS,28,OCAMPO,029,CHAMAL VIEJO,2,61,30,31,4
TAMAULIPAS,28,OCAMPO,029,COAHUILA,2,22,12,10,2
TAMAULIPAS,28,OCAMPO,029,EL PENSIL,3,194,91,103,12
TAMAULIPAS,28,OCAMPO,029,EL TIGRE,2,28,15,13,3
TAMAULIPAS,28,OCAMPO,029,ELIGIO TREVIÑO (EL BEJUCO),3,14,4,10,3
TAMAULIPAS,28,OCAMPO,029,FRANCISCO MEDRANO (LA MORITA),3,64,31,33,5
TAMAULIPAS,28,OCAMPO,029,LA ESPERANZA,1,34,17,17,2
TAMAULIPAS,28,OCAMPO,029,LA MURALLA,2,45,20,25,3
TAMAULIPAS,28,OCAMPO,029,LA SOLEDAD,1,12,8,4,1
TAMAULIPAS,28,OCAMPO,029,LAS CANOAS,3,68,29,39,7
TAMAULIPAS,28,OCAMPO,029,LAS FLORES,2,22,8,14,2
TAMAULIPAS,28,OCAMPO,029,LIBRADO RIVERA (PROVIDENCIA),1,8,3,5,1
TAMAULIPAS,28,OCAMPO,029,LORENZO VARGAS,1,17,8,9,1
TAMAULIPAS,28,OCAMPO,029,NICOLÁS BRAVO,3,52,26,26,4
TAMAULIPAS,28,OCAMPO,029,OCAMPO,11,1536,739,797,108
TAMAULIPAS,28,OCAMPO,029,PASO REAL DE MORELOS (LA PUENTE),1,9,3,6,1
TAMAULIPAS,28,OCAMPO,029,PRÁXEDIS G. GUERRERO (CALLEJONES),2,19,9,10,2
TAMAULIPAS,28,OCAMPO,029,PRÁXEDIS G. GUERRERO (LA LAJA),3,86,42,44,7
TAMAULIPAS,28,OCAMPO,029,PROTASIO F. GUERRA (CORRALES),2,24,8,16,2
TAMAULIPAS,28,OCAMPO,029,PUEBLO VIEJO,2,31,15,16,2
TAMAULIPAS,28,OCAMPO,029,RANCHO NUEVO (LEE TAYLOR),1,4,4,0,1
TAMAULIPAS,28,OCAMPO,029,RICARDO FLORES MAGÓN,4,229,112,117,16
TAMAULIPAS,28,OCAMPO,029,SAN LORENZO (LAS BAYAS),1,1,1,0,1
TAMAULIPAS,28,OCAMPO,029,SAN LORENZO EL GRANDE,3,5,3,2,2
TAMAULIPAS,28,OCAMPO,029,SANTA MARÍA DE GUADALUPE (LA COLONIA),3,56,27,29,4
TAMAULIPAS,28,OCAMPO,029,TANLAJÁS (LA ALHAJILLA),3,28,16,12,3
TAMAULIPAS,28,OCAMPO,029,VEINTE DE NOVIEMBRE (LAS POZAS),2,23,16,7,2
TAMAULIPAS,28,PADILLA,030,BARRETAL,7,1008,485,523,59
TAMAULIPAS,28,PADILLA,030,CAMPOAMOR,2,22,7,15,2
TAMAULIPAS,28,PADILLA,030,CINCO DE MAYO,3,341,176,165,63
TAMAULIPAS,28,PADILLA,030,CONRADO CASTILLO,4,93,51,42,7
TAMAULIPAS,28,PADILLA,030,CORPUS CHRISTI,2,56,22,34,5
TAMAULIPAS,28,PADILLA,030,JOSÉ LÓPEZ PORTILLO,1,10,5,5,1
TAMAULIPAS,28,PADILLA,030,JOSÉ SILVA SÁNCHEZ,1,7,3,4,1
TAMAULIPAS,28,PADILLA,030,LA CONCEPCIÓN,2,39,20,19,4
TAMAULIPAS,28,PADILLA,030,LA SOLEDAD,3,541,301,240,122
TAMAULIPAS,28,PADILLA,030,LOS BRASILES,2,42,20,22,4
TAMAULIPAS,28,PADILLA,030,LOUISIANA,2,9,5,4,2
TAMAULIPAS,28,PADILLA,030,MARTE R. GÓMEZ,2,58,28,30,5
TAMAULIPAS,28,PADILLA,030,NUEVA VILLA DE PADILLA,7,1062,506,556,81
TAMAULIPAS,28,PADILLA,030,NUEVO SAN JUAN,1,11,7,4,1
TAMAULIPAS,28,PADILLA,030,PLAN DE AYALA,4,66,31,35,9
TAMAULIPAS,28,PADILLA,030,QUINCE DE FEBRERO,3,32,21,11,3
TAMAULIPAS,28,PADILLA,030,SAN PATRICIO,2,35,20,15,3
TAMAULIPAS,28,PADILLA,030,SANTA JUANA,2,39,25,14,3
TAMAULIPAS,28,PADILLA,030,VICENTE GUERRERO (EL TABLERO),2,58,24,34,4
TAMAULIPAS,28,PALMILLAS,031,EL LLANO DE AZUAS,3,45,27,18,6
TAMAULIPAS,28,PALMILLAS,031,EL NARANJO (EL NARANJITO),2,15,7,8,2
TAMAULIPAS,28,PALMILLAS,031,LOS ARRIEROS,3,7,3,4,2
TAMAULIPAS,28,PALMILLAS,031,PALMILLAS,4,344,173,171,17
TAMAULIPAS,28,PALMILLAS,031,SAN JOSÉ DE PALMILLAS,1,6,4,2,1
TAMAULIPAS,28,PALMILLAS,031,SAN VICENTE,2,11,2,9,1
TAMAULIPAS,28,PALMILLAS,031,SEIS DE ABRIL,2,26,11,15,2
TAMAULIPAS,28,REYNOSA,032,ALFREDO V. BONFIL (PERIQUITOS),4,637,293,344,32
TAMAULIPAS,28,REYNOSA,032,ANZALDÚAS (ESTACIÓN ANZALDÚAS),2,19,8,11,2
TAMAULIPAS,28,REYNOSA,032,ARGÜELLES,2,152,80,72,8
TAMAULIPAS,28,REYNOSA,032,CONGREGACIÓN GARZA (CHARCO ESCONDIDO),1,3,3,0,1
TAMAULIPAS,28,REYNOSA,032,CORRALES,1,5,2,3,1
TAMAULIPAS,28,REYNOSA,032,DIECISÉIS DE SEPTIEMBRE NÚMERO UNO,3,24,12,12,3
TAMAULIPAS,28,REYNOSA,032,DIVISIÓN DEL NORTE,2,9,4,5,2
TAMAULIPAS,28,REYNOSA,032,DOROTEO ARANGO,3,120,62,58,8
TAMAULIPAS,28,REYNOSA,032,EL GRULLO,3,41,19,22,4
TAMAULIPAS,28,REYNOSA,032,EL GUERREÑO,2,93,28,65,7
TAMAULIPAS,28,REYNOSA,032,EL GUERREÑO (BRECHA 100 Y 102 CON KILÓMETRO 23 Y 26 NORTE),1,15,6,9,3
TAMAULIPAS,28,REYNOSA,032,EL SIFÓN,1,5,4,1,1
TAMAULIPAS,28,REYNOSA,032,FRANCISCO GONZÁLEZ VILLARREAL,2,28,19,9,2
TAMAULIPAS,28,REYNOSA,032,GENERAL PEDRO MARÍA ANAYA,2,17,10,7,2
TAMAULIPAS,28,REYNOSA,032,LA AZUFROSA,2,11,9,2,1
TAMAULIPAS,28,REYNOSA,032,LA RETAMA,4,766,393,373,29
TAMAULIPAS,28,REYNOSA,032,LAS ANACUAS,2,12,6,6,2
TAMAULIPAS,28,REYNOSA,032,LICENCIADO GALO ÁLVAREZ,3,21,11,10,3
TAMAULIPAS,28,REYNOSA,032,LLORONA NUEVA,2,11,5,6,2
TAMAULIPAS,28,REYNOSA,032,LOS ALTOS (EL ALTO),3,88,44,44,5
TAMAULIPAS,28,REYNOSA,032,LOS CAVAZOS,5,795,386,409,36
TAMAULIPAS,28,REYNOSA,032,MANUEL CAVAZOS LERMA,2,12,3,9,2
TAMAULIPAS,28,REYNOSA,032,NUEVA LIBERTAD CAMPESINA DOS,1,6,2,4,1
TAMAULIPAS,28,REYNOSA,032,PALO BLANCO,1,13,9,4,2
TAMAULIPAS,28,REYNOSA,032,PANCHO VILLA (FRANCISCO VILLA),2,43,22,21,3
TAMAULIPAS,28,REYNOSA,032,REFORMA AGRARIA,2,77,42,35,5
TAMAULIPAS,28,REYNOSA,032,REYNOSA,859,193304,97750,95554,10047
TAMAULIPAS,28,REYNOSA,032,REYNOSA DÍAZ,4,135,65,70,8
TAMAULIPAS,28,REYNOSA,032,RODOLFO MARTÍN ROCHA (MARTÍN ROCHA),3,108,54,54,7
TAMAULIPAS,28,REYNOSA,032,SANTA ANA [EJIDO],2,18,9,9,3
TAMAULIPAS,28,REYNOSA,032,SANTA ROSA,1,21,6,15,1
TAMAULIPAS,28,REYNOSA,032,SANTO NIÑO,3,84,48,36,4
TAMAULIPAS,28,REYNOSA,032,TLAXCALA DE XICOTÉNCATL,3,13,9,4,2
TAMAULIPAS,28,REYNOSA,032,VAMOS TAMAULIPAS,2,417,208,209,20
TAMAULIPAS,28,RÍO BRAVO,033,AMPLIACIÓN RÍO BRAVO,4,199,82,117,16
TAMAULIPAS,28,RÍO BRAVO,033,ATIZAPÁN DE ZARAGOZA,3,69,36,33,6
TAMAULIPAS,28,RÍO BRAVO,033,BUENAVISTA (CHARCO AZUL),3,74,39,35,6
TAMAULIPAS,28,RÍO BRAVO,033,CÁNDIDO AGUILAR,3,93,50,43,14
TAMAULIPAS,28,RÍO BRAVO,033,CENTENARIO DE LA CONSTITUCIÓN,1,12,4,8,1
TAMAULIPAS,28,RÍO BRAVO,033,CIUDAD RÍO BRAVO,145,26908,13528,13380,1760
TAMAULIPAS,28,RÍO BRAVO,033,CONQUISTA CAMPESINA,3,65,21,44,10
TAMAULIPAS,28,RÍO BRAVO,033,CRISTÓBAL COLÓN,1,9,3,6,1
TAMAULIPAS,28,RÍO BRAVO,033,EBANITO NUEVO,2,40,20,20,3
TAMAULIPAS,28,RÍO BRAVO,033,EL ROSARIO,2,41,24,17,3
TAMAULIPAS,28,RÍO BRAVO,033,EMILIANO ZAPATA,3,34,15,19,3
TAMAULIPAS,28,RÍO BRAVO,033,EMILIO PORTES GIL,2,61,29,32,6
TAMAULIPAS,28,RÍO BRAVO,033,ESTACIÓN CANALES,3,63,30,33,7
TAMAULIPAS,28,RÍO BRAVO,033,GENERAL GUADALUPE MAINERO,3,77,35,42,6
TAMAULIPAS,28,RÍO BRAVO,033,GENERAL PEDRO OCHOA,3,63,29,34,11
TAMAULIPAS,28,RÍO BRAVO,033,LA ARGÜELLEÑA,2,7,3,4,1
TAMAULIPAS,28,RÍO BRAVO,033,LA POSTA,3,76,30,46,5
TAMAULIPAS,28,RÍO BRAVO,033,LA SOLEDAD,3,103,45,58,6
TAMAULIPAS,28,RÍO BRAVO,033,LA ZACATECANA,2,33,14,19,3
TAMAULIPAS,28,RÍO BRAVO,033,LAS FLORES,1,244,123,121,10
TAMAULIPAS,28,RÍO BRAVO,033,LAS PALMAS,1,2,1,1,1
TAMAULIPAS,28,RÍO BRAVO,033,LOS ÁNGELES,1,18,10,8,1
TAMAULIPAS,28,RÍO BRAVO,033,MANUEL PARREÑO,2,25,13,12,3
TAMAULIPAS,28,RÍO BRAVO,033,MARIO SOUZA,2,7,3,4,2
TAMAULIPAS,28,RÍO BRAVO,033,NUEVA INDEPENDENCIA (LA CULECA),2,59,36,23,6
TAMAULIPAS,28,RÍO BRAVO,033,NUEVO PRIMERO DE MAYO (RAMIRO MARTÍNEZ),1,98,45,53,13
TAMAULIPAS,28,RÍO BRAVO,033,NUEVO PROGRESO,11,1798,881,917,74
TAMAULIPAS,28,RÍO BRAVO,033,RAÚL MUÑIZ,1,6,3,3,1
TAMAULIPAS,28,RÍO BRAVO,033,SAN CAYETANO (BRECHA 116 CON KILÓMETRO 1 SUR),1,12,4,8,1
TAMAULIPAS,28,RÍO BRAVO,033,SAN LUISITO,2,9,5,4,1
TAMAULIPAS,28,RÍO BRAVO,033,SANTA APOLONIA,4,363,184,179,28
TAMAULIPAS,28,RÍO BRAVO,033,SEIS DE ENERO,3,53,19,34,5
TAMAULIPAS,28,RÍO BRAVO,033,VERACRUZ Y PROGRESO,3,79,43,36,5
TAMAULIPAS,28,RÍO BRAVO,033,VICENTE GUERRERO,2,47,19,28,4
TAMAULIPAS,28,SAN CARLOS,034,CORRALEJO,2,15,10,5,2
TAMAULIPAS,28,SAN CARLOS,034,EL BARRANCO AZUL,3,87,37,50,8
TAMAULIPAS,28,SAN CARLOS,034,EL CARRICITO (CARRICITO DE LOS RETA),1,12,7,5,1
TAMAULIPAS,28,SAN CARLOS,034,EL CARRIZO DE URIEGAS,2,9,3,6,2
TAMAULIPAS,28,SAN CARLOS,034,EL DIVISADERO,1,6,2,4,1
TAMAULIPAS,28,SAN CARLOS,034,EL GAVILÁN,3,31,12,19,3
TAMAULIPAS,28,SAN CARLOS,034,EL REFUGIO,2,22,8,14,2
TAMAULIPAS,28,SAN CARLOS,034,EL SAUCILLO,5,189,92,97,12
TAMAULIPAS,28,SAN CARLOS,034,GRACIANO SÁNCHEZ,1,11,5,6,1
TAMAULIPAS,28,SAN CARLOS,034,LA AURORA,2,4,2,2,1
TAMAULIPAS,28,SAN CARLOS,034,LA GARITA,2,15,8,7,2
TAMAULIPAS,28,SAN CARLOS,034,LA GAVIA,3,51,26,25,5
TAMAULIPAS,28,SAN CARLOS,034,LA GLORIA,2,4,3,1,1
TAMAULIPAS,28,SAN CARLOS,034,LA LIBERTAD,2,14,7,7,2
TAMAULIPAS,28,SAN CARLOS,034,LA NUEVA UNIÓN,2,36,20,16,3
TAMAULIPAS,28,SAN CARLOS,034,LA UNIÓN MORALES,2,13,6,7,2
TAMAULIPAS,28,SAN CARLOS,034,LOS ANGELITOS (ÁNGELES),2,22,15,7,2
TAMAULIPAS,28,SAN CARLOS,034,LOS QUIOTES,3,25,11,14,3
TAMAULIPAS,28,SAN CARLOS,034,LOS VERGELES,3,17,10,7,3
TAMAULIPAS,28,SAN CARLOS,034,MAGUEYES,4,111,50,61,14
TAMAULIPAS,28,SAN CARLOS,034,MANUEL LÓPEZ (SAN ANTONIO),3,32,15,17,3
TAMAULIPAS,28,SAN CARLOS,034,MARMOLEJO,2,13,5,8,2
TAMAULIPAS,28,SAN CARLOS,034,NORBERTO TREVIÑO ZAPATA (SANTA TERESA),2,16,7,9,2
TAMAULIPAS,28,SAN CARLOS,034,NUEVO CAMACHO,2,19,11,8,2
TAMAULIPAS,28,SAN CARLOS,034,NUEVO PRAXEDIS BALBOA,3,27,10,17,3
TAMAULIPAS,28,SAN CARLOS,034,NUEVO SAN ANTONIO,2,22,11,11,2
TAMAULIPAS,28,SAN CARLOS,034,PROFESOR GRACIANO SÁNCHEZ,3,46,22,24,3
TAMAULIPAS,28,SAN CARLOS,034,PUERTO RICO,3,70,29,41,6
TAMAULIPAS,28,SAN CARLOS,034,REDENCIÓN DEL CAMPESINO,2,17,9,8,2
TAMAULIPAS,28,SAN CARLOS,034,RINCÓN MURILLO (RANCHO VIEJO),1,10,7,3,1
TAMAULIPAS,28,SAN CARLOS,034,SAN CARLOS,4,290,149,141,24
TAMAULIPAS,28,SAN CARLOS,034,SAN FRANCISCO,2,3,2,1,1
TAMAULIPAS,28,SAN CARLOS,034,SAN MIGUEL,2,5,2,3,1
TAMAULIPAS,28,SAN CARLOS,034,SAN RAFAEL,2,20,8,12,2
TAMAULIPAS,28,SAN CARLOS,034,VÍCTOR MANUEL BUENO,2,18,8,10,2
TAMAULIPAS,28,SAN FERNANDO,035,ÁGUILA AZTECA,2,51,28,23,4
TAMAULIPAS,28,SAN FERNANDO,035,ALFREDO V. BONFIL (LUIS ECHEVERRÍA),3,180,89,91,11
TAMAULIPAS,28,SAN FERNANDO,035,AMPLIACIÓN LOS VERGELES,2,28,10,18,3
TAMAULIPAS,28,SAN FERNANDO,035,BENITO JUÁREZ,2,33,13,20,3
TAMAULIPAS,28,SAN FERNANDO,035,CARBONERAS (LA CARBONERA),6,642,329,313,38
TAMAULIPAS,28,SAN FERNANDO,035,CARVAJAL,3,227,103,124,13
TAMAULIPAS,28,SAN FERNANDO,035,DIVISIÓN DEL NORTE (LAGUNA SECA),2,98,52,46,6
TAMAULIPAS,28,SAN FERNANDO,035,EL BARRANCÓN DEL TÍO BLAS (EL BARRANCÓN),3,167,84,83,8
TAMAULIPAS,28,SAN FERNANDO,035,EL CORTINEÑO,1,3,1,2,1
TAMAULIPAS,28,SAN FERNANDO,035,EMILIANO ZAPATA (AMPLIACIÓN SAN GERMÁN),3,123,47,76,9
TAMAULIPAS,28,SAN FERNANDO,035,GENERAL FRANCISCO GONZÁLEZ VILLARREAL (SAN JUAN),5,451,223,228,40
TAMAULIPAS,28,SAN FERNANDO,035,GENERAL FRANCISCO J. MÚJICA (LA POZA),3,108,52,56,8
TAMAULIPAS,28,SAN FERNANDO,035,GENERAL FRANCISCO VILLA,5,967,505,462,79
TAMAULIPAS,28,SAN FERNANDO,035,GUADALUPE VICTORIA (EL NORTEÑO),3,149,71,78,11
TAMAULIPAS,28,SAN FERNANDO,035,GUADALUPE VICTORIA (LAS ADJUNTAS),2,4,2,2,1
TAMAULIPAS,28,SAN FERNANDO,035,JUAN ANTONIO,2,19,13,6,2
TAMAULIPAS,28,SAN FERNANDO,035,LA CARRETA DOS,4,153,82,71,11
TAMAULIPAS,28,SAN FERNANDO,035,LA CARRETA UNO,3,37,18,19,4
TAMAULIPAS,28,SAN FERNANDO,035,LA FLORIDA (LA FLORIDA DEL SUR),1,8,5,3,1
TAMAULIPAS,28,SAN FERNANDO,035,LA JOYA,2,27,12,15,2
TAMAULIPAS,28,SAN FERNANDO,035,LA LIBERTAD DE SAN FERNANDO [NUEVO CENTRO DE POBLACIÓN],2,13,10,3,2
TAMAULIPAS,28,SAN FERNANDO,035,LA LOMA,2,117,50,67,8
TAMAULIPAS,28,SAN FERNANDO,035,LA LOMITA [NUEVO CENTRO DE POBLACIÓN AGRÍCOLA],2,127,56,71,7
TAMAULIPAS,28,SAN FERNANDO,035,LA MEDIA LUNA,2,6,3,3,2
TAMAULIPAS,28,SAN FERNANDO,035,LAGUNA DE SAN JUAN,3,89,50,39,7
TAMAULIPAS,28,SAN FERNANDO,035,LAS ESCOBAS,1,15,11,4,1
TAMAULIPAS,28,SAN FERNANDO,035,LAS NORIAS (SAN JOSÉ DE BUENAVISTA),3,60,28,32,5
TAMAULIPAS,28,SAN FERNANDO,035,LAVADEROS,1,10,4,6,1
TAMAULIPAS,28,SAN FERNANDO,035,LOS ÉBANOS,1,3,1,2,1
TAMAULIPAS,28,SAN FERNANDO,035,LOS VERGELES,2,40,16,24,3
TAMAULIPAS,28,SAN FERNANDO,035,MIGUEL HIDALGO UNO,3,97,44,53,7
TAMAULIPAS,28,SAN FERNANDO,035,NUEVO TLAXCALA XICOTÉNCATL,2,12,10,2,1
TAMAULIPAS,28,SAN FERNANDO,035,PALO SOLO,4,106,54,52,10
TAMAULIPAS,28,SAN FERNANDO,035,PALOS BLANCOS,2,14,6,8,2
TAMAULIPAS,28,SAN FERNANDO,035,PASO HONDO,1,7,2,5,1
TAMAULIPAS,28,SAN FERNANDO,035,PUERTO RICO,2,25,12,13,2
TAMAULIPAS,28,SAN FERNANDO,035,PUNTA DE ALAMBRE (PUENTE DE ALAMBRE),2,87,43,44,6
TAMAULIPAS,28,SAN FERNANDO,035,PUNTA DE PIEDRA,2,80,35,45,4
TAMAULIPAS,28,SAN FERNANDO,035,SAN FERNANDO,44,7415,3701,3714,439
TAMAULIPAS,28,SAN FERNANDO,035,SAN FRANCISCO,2,21,8,13,2
TAMAULIPAS,28,SAN FERNANDO,035,SAN GERMÁN,3,242,115,127,17
TAMAULIPAS,28,SAN FERNANDO,035,SAN GERMÁN (EL DURAZNO),1,92,48,44,8
TAMAULIPAS,28,SAN FERNANDO,035,SAN GILBERTO,2,16,6,10,2
TAMAULIPAS,28,SAN FERNANDO,035,SAN LORENZO,2,36,18,18,4
TAMAULIPAS,28,SAN FERNANDO,035,SANTA RITA (ESCUADRÓN 201),2,21,10,11,2
TAMAULIPAS,28,SAN FERNANDO,035,SANTA TERESA,1,11,4,7,1
TAMAULIPAS,28,SAN FERNANDO,035,VEINTE DE NOVIEMBRE,1,12,5,7,1
TAMAULIPAS,28,SAN NICOLÁS,036,CARRICITOS,1,3,3,0,1
TAMAULIPAS,28,SAN NICOLÁS,036,EL PALMAR,3,19,6,13,3
TAMAULIPAS,28,SAN NICOLÁS,036,FLECHADORES,3,66,32,34,5
TAMAULIPAS,28,SAN NICOLÁS,036,LAS VÍRGENES (CORTA CAMINOS),1,14,3,11,1
TAMAULIPAS,28,SAN NICOLÁS,036,LAS VÍRGENES (MOCTEZUMA),1,7,3,4,1
TAMAULIPAS,28,SAN NICOLÁS,036,LAURO VILLAR,2,13,5,8,1
TAMAULIPAS,28,SAN NICOLÁS,036,SAN NICOLÁS,4,72,34,38,7
TAMAULIPAS,28,SOTO LA MARINA,037,ALBERTO CARRERA TORRES,2,6,1,5,1
TAMAULIPAS,28,SOTO LA MARINA,037,BENITO JUÁREZ (EL CARACOL),2,15,6,9,2
TAMAULIPAS,28,SOTO LA MARINA,037,BERNARDO GUTIÉRREZ DE LARA,2,16,9,7,2
TAMAULIPAS,28,SOTO LA MARINA,037,CINCO DE MAYO,2,19,10,9,2
TAMAULIPAS,28,SOTO LA MARINA,037,DIEZ DE ABRIL,2,43,19,24,4
TAMAULIPAS,28,SOTO LA MARINA,037,DIEZ DE MAYO (LA ESPUELA),2,18,5,13,2
TAMAULIPAS,28,SOTO LA MARINA,037,EL AUXILIO,1,17,5,12,1
TAMAULIPAS,28,SOTO LA MARINA,037,EL CARRIZO,3,82,26,56,4
TAMAULIPAS,28,SOTO LA MARINA,037,EL ESMERIL (EL PORVENIR),3,96,50,46,8
TAMAULIPAS,28,SOTO LA MARINA,037,EL SABINITO,3,52,27,25,5
TAMAULIPAS,28,SOTO LA MARINA,037,EL SALADITO,1,3,2,1,1
TAMAULIPAS,28,SOTO LA MARINA,037,EL SOCIALISTA,2,4,3,1,1
TAMAULIPAS,28,SOTO LA MARINA,037,FRANCISCO VILLA (EL TANQUE),2,32,11,21,3
TAMAULIPAS,28,SOTO LA MARINA,037,GUADALUPE ADAME,2,26,11,15,3
TAMAULIPAS,28,SOTO LA MARINA,037,GUAYABAS,3,17,6,11,2
TAMAULIPAS,28,SOTO LA MARINA,037,JOSÉ DE ESCANDÓN Y HELGUERA,1,15,9,6,1
TAMAULIPAS,28,SOTO LA MARINA,037,JOSÉ SILVA SÁNCHEZ,1,19,8,11,1
TAMAULIPAS,28,SOTO LA MARINA,037,LA ENCARNACIÓN,2,16,8,8,2
TAMAULIPAS,28,SOTO LA MARINA,037,LA ESPERANZA,1,6,4,2,1
TAMAULIPAS,28,SOTO LA MARINA,037,LA LOBERA (DOCTOR RAFAEL VILLARREAL),2,20,9,11,5
TAMAULIPAS,28,SOTO LA MARINA,037,LA PEÑA,3,41,23,18,4
TAMAULIPAS,28,SOTO LA MARINA,037,LA PEÑITA,2,22,10,12,2
TAMAULIPAS,28,SOTO LA MARINA,037,LA PESCA,7,649,338,311,67
TAMAULIPAS,28,SOTO LA MARINA,037,LA PIEDRA,3,75,40,35,7
TAMAULIPAS,28,SOTO LA MARINA,037,LA ZAMORINA,3,61,28,33,6
TAMAULIPAS,28,SOTO LA MARINA,037,LAS ENRAMADAS,3,37,19,18,6
TAMAULIPAS,28,SOTO LA MARINA,037,LAS TUNAS,4,202,104,98,12
TAMAULIPAS,28,SOTO LA MARINA,037,LAVADEROS,3,84,43,41,9
TAMAULIPAS,28,SOTO LA MARINA,037,LOS BELLOS,2,20,8,12,2
TAMAULIPAS,28,SOTO LA MARINA,037,MIGUEL DE LA MADRID (EL CANAL),2,69,26,43,5
TAMAULIPAS,28,SOTO LA MARINA,037,NOMBRE DE DIOS,1,16,7,9,1
TAMAULIPAS,28,SOTO LA MARINA,037,OCHO DE MAYO,2,16,7,9,2
TAMAULIPAS,28,SOTO LA MARINA,037,PIEDRAS DE LUMBRE,1,2,0,2,1
TAMAULIPAS,28,SOTO LA MARINA,037,PLAN DE AYALA [EJIDO],2,19,8,11,2
TAMAULIPAS,28,SOTO LA MARINA,037,POBLADORES DE MÉXICO,2,20,14,6,2
TAMAULIPAS,28,SOTO LA MARINA,037,SAN JOSÉ DE LAS RUSIAS,1,16,7,9,1
TAMAULIPAS,28,SOTO LA MARINA,037,SANTA ISABEL,3,8,3,5,2
TAMAULIPAS,28,SOTO LA MARINA,037,SANTO DOMINGO DEL CHARCO LARGO,1,15,9,6,1
TAMAULIPAS,28,SOTO LA MARINA,037,SOTO LA MARINA,18,2629,1327,1302,222
TAMAULIPAS,28,SOTO LA MARINA,037,TAMPIQUITO,1,39,20,19,4
TAMAULIPAS,28,SOTO LA MARINA,037,TAMPIQUITO (SOTO LA MARINA),3,342,160,182,16
TAMAULIPAS,28,SOTO LA MARINA,037,TEPEHUAJE,2,7,4,3,1
TAMAULIPAS,28,SOTO LA MARINA,037,TRES DE ABRIL (NOCHE BUENA),3,69,38,31,7
TAMAULIPAS,28,SOTO LA MARINA,037,VERDE GRANDE,2,5,3,2,1
TAMAULIPAS,28,SOTO LA MARINA,037,VISTA HERMOSA,3,85,44,41,6
TAMAULIPAS,28,TAMPICO,038,CRUZ GRANDE (CRUZ DE LOS RÍOS),1,21,10,11,1
TAMAULIPAS,28,TAMPICO,038,LA ISLETA (RÍO TAMESÍ),1,3,3,0,1
TAMAULIPAS,28,TAMPICO,038,TAMPICO,459,97185,53348,43837,8940
TAMAULIPAS,28,TULA,039,ALBERTO CARRERA TORRES (LA RANA),2,21,12,9,2
TAMAULIPAS,28,TULA,039,ALFONSO TERRONES BENÍTEZ (PRESA RAMIREÑA),3,159,87,72,11
TAMAULIPAS,28,TULA,039,ÁLVARO OBREGÓN (LA NORIA),3,187,89,98,12
TAMAULIPAS,28,TULA,039,AMADORES,1,12,5,7,1
TAMAULIPAS,28,TULA,039,AQUILES SERDÁN,3,29,12,17,3
TAMAULIPAS,28,TULA,039,CELSO HUERTA,2,28,10,18,3
TAMAULIPAS,28,TULA,039,CERRO MOCHO,3,19,11,8,2
TAMAULIPAS,28,TULA,039,CIENEGUILLA,3,461,241,220,18
TAMAULIPAS,28,TULA,039,CIENEGUITA,2,7,5,2,2
TAMAULIPAS,28,TULA,039,CINCO DE MAYO (CEBOLLITAS),2,28,13,15,3
TAMAULIPAS,28,TULA,039,CIUDAD TULA,17,2630,1307,1323,145
TAMAULIPAS,28,TULA,039,COLONIA AGRÍCOLA Y GANADERA (LAS CRUCES),3,66,39,27,7
TAMAULIPAS,28,TULA,039,CONGREGACIÓN DE JAIMEZ,2,30,18,12,2
TAMAULIPAS,28,TULA,039,CRISTÓBAL COLÓN (VALLE DE CIENEGUILLA),3,65,24,41,4
TAMAULIPAS,28,TULA,039,CRUCITAS (FRANCISCO VILLA),3,12,8,4,2
TAMAULIPAS,28,TULA,039,CRUZ VERDE,1,5,2,3,1
TAMAULIPAS,28,TULA,039,DIECISÉIS DE SEPTIEMBRE,3,25,10,15,2
TAMAULIPAS,28,TULA,039,EL BOLUDO,3,64,37,27,5
TAMAULIPAS,28,TULA,039,EL CARMEN,1,7,1,6,1
TAMAULIPAS,28,TULA,039,EL CRISPÍN (SAN CRISPÍN),3,11,7,4,2
TAMAULIPAS,28,TULA,039,EL GAVIAL,3,27,12,15,3
TAMAULIPAS,28,TULA,039,EL PEÑÓN,1,15,6,9,1
TAMAULIPAS,28,TULA,039,EL REFUGIO,2,12,5,7,2
TAMAULIPAS,28,TULA,039,EL REFUGIO (LA UNIÓN),3,99,54,45,7
TAMAULIPAS,28,TULA,039,EL SAUZ,2,20,13,7,2
TAMAULIPAS,28,TULA,039,EL TANQUITO,3,28,15,13,3
TAMAULIPAS,28,TULA,039,EMILIANO ZAPATA (LA VIGA),3,166,81,85,11
TAMAULIPAS,28,TULA,039,EMILIO VÁZQUEZ GÓMEZ,3,115,54,61,8
TAMAULIPAS,28,TULA,039,EMPERADORES AZTECAS,2,10,3,7,2
TAMAULIPAS,28,TULA,039,FRANCISCO I. MADERO,1,68,36,32,4
TAMAULIPAS,28,TULA,039,FRANCISCO MEDRANO (LA HIGUERILLA),2,15,7,8,2
TAMAULIPAS,28,TULA,039,FRANCISCO MEDRANO (RANCHO NUEVO DEL NORTE),1,11,7,4,1
TAMAULIPAS,28,TULA,039,FRANCISCO VILLA (EL XICHU),3,83,36,47,6
TAMAULIPAS,28,TULA,039,GALLITOS,3,13,2,11,3
TAMAULIPAS,28,TULA,039,GALLOS GRANDES,3,45,20,25,5
TAMAULIPAS,28,TULA,039,GAZMONES,2,15,10,5,2
TAMAULIPAS,28,TULA,039,GUADALUPE VICTORIA (RANCHO NUEVO),2,10,6,4,1
TAMAULIPAS,28,TULA,039,JOSÉ MARÍA MORELOS (MORELOS),3,37,19,18,3
TAMAULIPAS,28,TULA,039,JOYA DE MARAVILLAS,1,6,3,3,1
TAMAULIPAS,28,TULA,039,JOYA DEL BERRENDO,3,37,20,17,3
TAMAULIPAS,28,TULA,039,JUAN SARABIA (LA HIGUERA),3,52,29,23,4
TAMAULIPAS,28,TULA,039,LA LAGUNA,3,58,32,26,5
TAMAULIPAS,28,TULA,039,LA PRESA DE RAMOS,2,18,10,8,2
TAMAULIPAS,28,TULA,039,LA TAPONA,3,94,44,50,7
TAMAULIPAS,28,TULA,039,LÁZARO CÁRDENAS (CERRO GORDO),4,250,106,144,14
TAMAULIPAS,28,TULA,039,LUCIO VÁZQUEZ (EL CHARQUITO),2,49,26,23,3
TAMAULIPAS,28,TULA,039,MAGDALENO CEDILLO (EL CORONEL),4,447,228,219,26
TAMAULIPAS,28,TULA,039,MAMALEÓN (MAMÁ LEÓN),4,224,116,108,16
TAMAULIPAS,28,TULA,039,MESA DE LA LIBERTAD,2,9,1,8,2
TAMAULIPAS,28,TULA,039,MIGUEL HIDALGO (COLORADO),5,96,48,48,11
TAMAULIPAS,28,TULA,039,NICOLÁS MEDRANO (EL ABRA),2,33,19,14,2
TAMAULIPAS,28,TULA,039,NUEVO PADILLA,3,54,28,26,4
TAMAULIPAS,28,TULA,039,PEDRO RUIZ MOLINA,2,28,15,13,3
TAMAULIPAS,28,TULA,039,PROVIDENCIA,2,18,4,14,2
TAMAULIPAS,28,TULA,039,RANCHO NUEVO,2,12,4,8,2
TAMAULIPAS,28,TULA,039,RICARDO GARCÍA (LA PRESITA),2,29,15,14,3
TAMAULIPAS,28,TULA,039,SALITRILLO,3,155,66,89,9
TAMAULIPAS,28,TULA,039,SAN ANTONIO DE NAHOLA (SAN ANTONIO),2,13,6,7,2
TAMAULIPAS,28,TULA,039,SAN FRANCISCO (NUEVO CENTRO),1,14,9,5,1
TAMAULIPAS,28,TULA,039,SAN JOSÉ DE LAS FLORES,2,20,10,10,2
TAMAULIPAS,28,TULA,039,SAN JUAN,2,35,22,13,3
TAMAULIPAS,28,TULA,039,SAN MIGUEL DEL CARMEN (SAN MIGUEL),3,56,31,25,4
TAMAULIPAS,28,TULA,039,SAN PABLO,3,33,18,15,3
TAMAULIPAS,28,TULA,039,SAN PEDRO,2,4,3,1,1
TAMAULIPAS,28,TULA,039,SAN RAFAEL,3,149,67,82,11
TAMAULIPAS,28,TULA,039,SANTA ANA DE NAHOLA,4,324,161,163,22
TAMAULIPAS,28,TULA,039,SANTA MARÍA DE ATOCHA,2,7,3,4,2
TAMAULIPAS,28,TULA,039,TANQUE BLANCO,4,453,247,206,47
TAMAULIPAS,28,TULA,039,TIERRAS BLANCAS (CINCO DE MAYO),3,120,58,62,8
TAMAULIPAS,28,TULA,039,VEINTE DE NOVIEMBRE (EL REFUGIO),3,46,25,21,4
TAMAULIPAS,28,TULA,039,VERDOLAGA,3,90,44,46,7
TAMAULIPAS,28,VALLE HERMOSO,040,18 DE MARZO (BRECHA 110 ENTRE SUR 82 Y SUR 88),2,19,7,12,2
TAMAULIPAS,28,VALLE HERMOSO,040,18 DE MARZO (BRECHA 116 ENTRE KILÓMETRO 96 Y 97),1,7,3,4,1
TAMAULIPAS,28,VALLE HERMOSO,040,AMPLIACIÓN AQUILES SERDÁN,2,17,7,10,2
TAMAULIPAS,28,VALLE HERMOSO,040,ANÁHUAC,6,725,352,373,42
TAMAULIPAS,28,VALLE HERMOSO,040,AQUILES SERDÁN,3,57,28,29,6
TAMAULIPAS,28,VALLE HERMOSO,040,BRECHA 128 ENTRE SUR 82 A SUR 82.6,1,18,9,9,1
TAMAULIPAS,28,VALLE HERMOSO,040,COLONIA AGRÍCOLA ANÁHUAC [CARRETERA ESTATAL 53 ENTRE SUR 60 Y SUR 70],1,25,10,15,2
TAMAULIPAS,28,VALLE HERMOSO,040,EL REALITO,5,579,286,293,40
TAMAULIPAS,28,VALLE HERMOSO,040,EL TERRALVA,1,18,7,11,1
TAMAULIPAS,28,VALLE HERMOSO,040,EMPALME,2,180,86,94,10
TAMAULIPAS,28,VALLE HERMOSO,040,ENSENADA,3,121,64,57,9
TAMAULIPAS,28,VALLE HERMOSO,040,IGNACIO MANUEL ALTAMIRANO,3,192,85,107,18
TAMAULIPAS,28,VALLE HERMOSO,040,JOSÉ DELGADO,2,39,21,18,3
TAMAULIPAS,28,VALLE HERMOSO,040,LA FLORIDA,1,8,2,6,1
TAMAULIPAS,28,VALLE HERMOSO,040,LIBERACIÓN DEL CAMPESINO,2,18,9,9,2
TAMAULIPAS,28,VALLE HERMOSO,040,MAGUEYES (BRECHA 128 CON KILÓMETRO 84),1,4,3,1,1
TAMAULIPAS,28,VALLE HERMOSO,040,"MAGUEYES (POZO 4) [COLONIA AGRÍCOLA, CARRETERA ESTATAL 53, ENTRE SUR 73 Y SUR 78]",2,38,23,15,3
TAMAULIPAS,28,VALLE HERMOSO,040,PIEDRAS PINTAS,1,6,3,3,1
TAMAULIPAS,28,VALLE HERMOSO,040,RICARDO FLORES MAGÓN (BRECHA 118 SUR 82.4 Y SUR 85.3),1,12,3,9,1
TAMAULIPAS,28,VALLE HERMOSO,040,VALLE HERMOSO,83,12784,6478,6306,945
TAMAULIPAS,28,VICTORIA,041,ALIANZA DE CABALLEROS,3,236,114,122,18
TAMAULIPAS,28,VICTORIA,041,ALTO DE ESTACIÓN CABALLEROS,1,120,66,54,28
TAMAULIPAS,28,VICTORIA,041,AQUILES SERDÁN,2,137,62,75,7
TAMAULIPAS,28,VICTORIA,041,BENITO JUÁREZ,2,121,56,65,8
TAMAULIPAS,28,VICTORIA,041,CIUDAD VICTORIA,458,97997,49646,48351,7418
TAMAULIPAS,28,VICTORIA,041,CONGREGACIÓN CABALLEROS,2,139,79,60,8
TAMAULIPAS,28,VICTORIA,041,DIECIOCHO DE MARZO,2,26,13,13,3
TAMAULIPAS,28,VICTORIA,041,EL HUIZACHAL (JOYA VERDE),3,10,6,4,2
TAMAULIPAS,28,VICTORIA,041,EL OLIVO,4,345,183,162,18
TAMAULIPAS,28,VICTORIA,041,EL OLMO (RANCHO NUEVO DEL CASTILLO),2,90,43,47,6
TAMAULIPAS,28,VICTORIA,041,EL REFUGIO,2,55,27,28,5
TAMAULIPAS,28,VICTORIA,041,ESTACIÓN CARBONERO,2,17,9,8,2
TAMAULIPAS,28,VICTORIA,041,FUERTE DE PORTES GIL,2,45,24,21,4
TAMAULIPAS,28,VICTORIA,041,HUIZACHAL,1,1,1,0,1
TAMAULIPAS,28,VICTORIA,041,JUAN RINCÓN,4,244,120,124,19
TAMAULIPAS,28,VICTORIA,041,LA BOCA DE JUAN CAPITÁN,3,34,13,21,4
TAMAULIPAS,28,VICTORIA,041,LA CRUCITA,2,24,11,13,2
TAMAULIPAS,28,VICTORIA,041,LA LIBERTAD,2,229,110,119,12
TAMAULIPAS,28,VICTORIA,041,LA MISIÓN,2,164,84,80,9
TAMAULIPAS,28,VICTORIA,041,LA PEÑITA,2,87,49,38,6
TAMAULIPAS,28,VICTORIA,041,LA PRESA,3,354,164,190,28
TAMAULIPAS,28,VICTORIA,041,LABORCITAS,2,90,40,50,9
TAMAULIPAS,28,VICTORIA,041,LÁZARO CÁRDENAS,2,38,16,22,3
TAMAULIPAS,28,VICTORIA,041,LOS OLIVOS,1,105,48,57,7
TAMAULIPAS,28,VICTORIA,041,MANUEL ÁVILA CAMACHO,4,214,93,121,15
TAMAULIPAS,28,VICTORIA,041,MARIPOSAS Y MAHUIRAS,2,63,31,32,5
TAMAULIPAS,28,VICTORIA,041,OTILIO MONTAÑO,2,53,23,30,3
TAMAULIPAS,28,VICTORIA,041,RANCHO NUEVO,2,65,28,37,5
TAMAULIPAS,28,VICTORIA,041,RANCHO NUEVO DE ARCE,2,35,18,17,3
TAMAULIPAS,28,VICTORIA,041,SAN JUAN Y EL RANCHITO,2,53,26,27,3
TAMAULIPAS,28,VICTORIA,041,SANTA ANA,3,56,31,25,5
TAMAULIPAS,28,VICTORIA,041,SANTA CLARA,3,23,10,13,3
TAMAULIPAS,28,VICTORIA,041,SANTA LIBRADA,4,174,87,87,12
TAMAULIPAS,28,VICTORIA,041,TIERRA NUEVA,3,82,39,43,7
TAMAULIPAS,28,VILLAGRÁN,042,ÁLVARO OBREGÓN,2,17,8,9,2
TAMAULIPAS,28,VILLAGRÁN,042,BRÍGIDO MALDONADO,1,20,9,11,1
TAMAULIPAS,28,VILLAGRÁN,042,CAMPOAMOR,2,18,8,10,2
TAMAULIPAS,28,VILLAGRÁN,042,CANDELARIO REYES (SAN JOSÉ),1,3,1,2,1
TAMAULIPAS,28,VILLAGRÁN,042,CANDELARIO REYES (SAN MIGUEL),1,2,2,0,1
TAMAULIPAS,28,VILLAGRÁN,042,CERRITOS,2,3,0,3,1
TAMAULIPAS,28,VILLAGRÁN,042,GARZA VALDEZ,4,167,75,92,12
TAMAULIPAS,28,VILLAGRÁN,042,GENERAL JESÚS CARRANZA (SABINITOS),2,24,13,11,3
TAMAULIPAS,28,VILLAGRÁN,042,GENERAL LUCIO BLANCO,3,134,56,78,11
TAMAULIPAS,28,VILLAGRÁN,042,GUADALUPE DE SAN LÁZARO (GUADALUPE),3,86,40,46,5
TAMAULIPAS,28,VILLAGRÁN,042,GUADALUPE VICTORIA,2,29,18,11,3
TAMAULIPAS,28,VILLAGRÁN,042,JESÚS GONZÁLEZ ORTEGA,3,48,19,29,4
TAMAULIPAS,28,VILLAGRÁN,042,JOSÉ MARÍA MORELOS (SAN JUAN),3,32,16,16,3
TAMAULIPAS,28,VILLAGRÁN,042,LA PEÑA,2,12,6,6,1
TAMAULIPAS,28,VILLAGRÁN,042,LA PURÍSIMA FLOREÑA,1,7,1,6,1
TAMAULIPAS,28,VILLAGRÁN,042,LOS CHARCOS,2,21,11,10,2
TAMAULIPAS,28,VILLAGRÁN,042,MAGDALENO AGUILAR,2,12,8,4,2
TAMAULIPAS,28,VILLAGRÁN,042,MARTE R. GÓMEZ (PATOL),3,48,25,23,6
TAMAULIPAS,28,VILLAGRÁN,042,MIGUEL HIDALGO,2,17,7,10,2
TAMAULIPAS,28,VILLAGRÁN,042,RANCHERÍA JUÁREZ (JUÁREZ),2,7,3,4,1
TAMAULIPAS,28,VILLAGRÁN,042,REDENCIÓN DEL CAMPESINO,1,5,2,3,1
TAMAULIPAS,28,VILLAGRÁN,042,SAN LÁZARO,2,28,12,16,3
TAMAULIPAS,28,VILLAGRÁN,042,SANTA MARÍA,2,5,2,3,1
TAMAULIPAS,28,VILLAGRÁN,042,VILLAGRÁN,4,397,198,199,38
TAMAULIPAS,28,XICOTÉNCATL,043,ADOLFO LÓPEZ MATEOS (EL JOPOY),2,6,3,3,2
TAMAULIPAS,28,XICOTÉNCATL,043,ÁGUILAS DE LA VICTORIA,2,41,28,13,3
TAMAULIPAS,28,XICOTÉNCATL,043,ALIANZA AGRARIA,2,47,19,28,4
TAMAULIPAS,28,XICOTÉNCATL,043,AMPLIACIÓN LA GLORIA,2,11,4,7,2
TAMAULIPAS,28,XICOTÉNCATL,043,BENITO JUÁREZ,3,101,57,44,5
TAMAULIPAS,28,XICOTÉNCATL,043,CARRERA TORRES,2,13,6,7,1
TAMAULIPAS,28,XICOTÉNCATL,043,DOCTOR NORBERTO TREVIÑO ZAPATA,1,16,11,5,1
TAMAULIPAS,28,XICOTÉNCATL,043,EL AZÚCAR,2,16,7,9,2
TAMAULIPAS,28,XICOTÉNCATL,043,EL CONEJO,1,5,3,2,1
TAMAULIPAS,28,XICOTÉNCATL,043,EL CONEJO (EL CONEJITO),1,5,3,2,1
TAMAULIPAS,28,XICOTÉNCATL,043,EL MIRADOR,2,11,8,3,2
TAMAULIPAS,28,XICOTÉNCATL,043,EMILIANO ZAPATA,3,129,57,72,12
TAMAULIPAS,28,XICOTÉNCATL,043,FELIPE ÁNGELES,2,18,8,10,2
TAMAULIPAS,28,XICOTÉNCATL,043,FÉLIX CABAÑAS,2,25,12,13,3
TAMAULIPAS,28,XICOTÉNCATL,043,FRANCISCO CASTELLANOS,2,18,9,9,2
TAMAULIPAS,28,XICOTÉNCATL,043,FRANCISCO VILLA,3,136,62,74,10
TAMAULIPAS,28,XICOTÉNCATL,043,INDUSTRIAL [COLONIA],1,2,1,1,1
TAMAULIPAS,28,XICOTÉNCATL,043,J. GUADALUPE RODRÍGUEZ,2,7,2,5,2
TAMAULIPAS,28,XICOTÉNCATL,043,JOSÉ ASCENSIÓN RODRÍGUEZ MARTÍNEZ (LAS AMARILLAS),3,60,24,36,6
TAMAULIPAS,28,XICOTÉNCATL,043,LA NUEVA REFORMA,1,9,4,5,1
TAMAULIPAS,28,XICOTÉNCATL,043,LA PRESA,2,6,3,3,2
TAMAULIPAS,28,XICOTÉNCATL,043,LOS KIKOS,2,22,12,10,2
TAMAULIPAS,28,XICOTÉNCATL,043,LUCIO BLANCO,2,16,8,8,2
TAMAULIPAS,28,XICOTÉNCATL,043,MANUEL CASTAÑOS VALIENTE (EL SETENTA),2,24,10,14,3
TAMAULIPAS,28,XICOTÉNCATL,043,MÁRTIRES DE RÍO BLANCO (LA REFORMA),2,46,20,26,3
TAMAULIPAS,28,XICOTÉNCATL,043,MELCHOR OCAMPO,1,26,14,12,2
TAMAULIPAS,28,XICOTÉNCATL,043,MIGUEL ALEMÁN,2,19,8,11,2
TAMAULIPAS,28,XICOTÉNCATL,043,MOCTEZUMA,2,27,14,13,3
TAMAULIPAS,28,XICOTÉNCATL,043,NARCISO MENDOZA NÚMERO DOS,1,3,1,2,1
TAMAULIPAS,28,XICOTÉNCATL,043,NARCISO MENDOZA UNO,2,7,3,4,2
TAMAULIPAS,28,XICOTÉNCATL,043,PRAXEDIS BALBOA (LA POZA),2,12,7,5,2
TAMAULIPAS,28,XICOTÉNCATL,043,PRIMERA UNIDAD EJIDO XICOTÉNCATL (ZOYATE),1,3,2,1,1
TAMAULIPAS,28,XICOTÉNCATL,043,PRIMERO DE MAYO,6,710,367,343,49
TAMAULIPAS,28,XICOTÉNCATL,043,SAN MANUEL,2,12,5,7,2
TAMAULIPAS,28,XICOTÉNCATL,043,SANTA ANITA,2,12,6,6,1
TAMAULIPAS,28,XICOTÉNCATL,043,SANTA MARTHA,3,8,4,4,2
TAMAULIPAS,28,XICOTÉNCATL,043,SEGUNDA UNIDAD XICOTÉNCATL (EL AQUICHE),4,237,112,125,17
TAMAULIPAS,28,XICOTÉNCATL,043,SERVANDO CANALES DOS (LA LOMA),2,7,5,2,2
TAMAULIPAS,28,XICOTÉNCATL,043,TRANCAS Y SAUZAL (SAUZAL),2,27,16,11,2
TAMAULIPAS,28,XICOTÉNCATL,043,TRIUNFO DEL PORVENIR,2,11,5,6,2
TAMAULIPAS,28,XICOTÉNCATL,043,VICENTE GUERRERO,1,14,7,7,1
TAMAULIPAS,28,XICOTÉNCATL,043,XICOTÉNCATL,16,2658,1339,1319,143
TLAXCALA,29,AMAXAC DE GUERRERO,001,AMAXAC DE GUERRERO,16,2875,1253,1622,323
TLAXCALA,29,AMAXAC DE GUERRERO,001,SAN DAMIÁN TLACOCALPAN,2,67,34,33,5
TLAXCALA,29,APETATITLÁN DE ANTONIO CARVAJAL,002,APETATITLÁN,16,2850,1388,1462,205
TLAXCALA,29,APETATITLÁN DE ANTONIO CARVAJAL,002,BELÉN ATZITZIMITITLÁN,4,349,173,176,20
TLAXCALA,29,APETATITLÁN DE ANTONIO CARVAJAL,002,SAN MATÍAS TEPETOMATITLÁN,4,472,229,243,24
TLAXCALA,29,APETATITLÁN DE ANTONIO CARVAJAL,002,TECOLOTLA,2,186,80,106,8
TLAXCALA,29,APETATITLÁN DE ANTONIO CARVAJAL,002,TLATEMPAN,10,2758,1559,1199,208
TLAXCALA,29,ATLANGATEPEC,003,ATLANGATEPEC,3,183,92,91,12
TLAXCALA,29,ATLANGATEPEC,003,COLONIA AGRÍCOLA SAN LUIS,2,17,11,6,2
TLAXCALA,29,ATLANGATEPEC,003,COLONIA BENITO JUÁREZ (TEZOYO),3,85,41,44,7
TLAXCALA,29,ATLANGATEPEC,003,COLONIA LOMA BONITA,1,15,7,8,1
TLAXCALA,29,ATLANGATEPEC,003,LA TRASQUILA,2,45,28,17,3
TLAXCALA,29,ATLANGATEPEC,003,SAN PEDRO ECATEPEC,3,278,134,144,12
TLAXCALA,29,ATLANGATEPEC,003,SANTA CLARA OZUMBA,3,93,45,48,6
TLAXCALA,29,ATLANGATEPEC,003,SANTA MARÍA TEPETZALA,1,8,4,4,1
TLAXCALA,29,ATLANGATEPEC,003,SANTIAGO VILLALTA,2,76,30,46,5
TLAXCALA,29,ATLANGATEPEC,003,VILLA DE LAS FLORES,2,44,18,26,4
TLAXCALA,29,ATLANGATEPEC,003,XALNENE [RANCHO],2,210,108,102,9
TLAXCALA,29,ATLANGATEPEC,003,ZUMPANGO,4,328,148,180,17
TLAXCALA,29,ATLTZAYANCA,004,ATLZAYANCA,12,1620,836,784,109
TLAXCALA,29,ATLTZAYANCA,004,COLONIA DELICIAS,2,78,34,44,4
TLAXCALA,29,ATLTZAYANCA,004,COLONIA NAZARETH,2,15,7,8,2
TLAXCALA,29,ATLTZAYANCA,004,CONCEPCIÓN HIDALGO,3,836,395,441,31
TLAXCALA,29,ATLTZAYANCA,004,CORAZÓN DE JESÚS [RANCHO],1,24,12,12,2
TLAXCALA,29,ATLTZAYANCA,004,FELIPE CARRILLO PUERTO,4,315,163,152,16
TLAXCALA,29,ATLTZAYANCA,004,LA GARITA,1,18,8,10,2
TLAXCALA,29,ATLTZAYANCA,004,LA SOLEDAD LOMA DE OCOTLA [RANCHERÍA],2,10,8,2,1
TLAXCALA,29,ATLTZAYANCA,004,LÁZARO CÁRDENAS,2,90,44,46,6
TLAXCALA,29,ATLTZAYANCA,004,LOMA DE JUNGUITO,2,30,17,13,3
TLAXCALA,29,ATLTZAYANCA,004,MESA REDONDA,3,37,12,25,4
TLAXCALA,29,ATLTZAYANCA,004,MIAHUAPAN EL ALTO,2,4,2,2,1
TLAXCALA,29,ATLTZAYANCA,004,MIAHUAPAN EL BAJO,2,25,13,12,3
TLAXCALA,29,ATLTZAYANCA,004,NEXNOPALA,5,69,31,38,6
TLAXCALA,29,ATLTZAYANCA,004,RANCHERÍA DE POCITOS,5,254,136,118,13
TLAXCALA,29,ATLTZAYANCA,004,SAN ANTONIO TECOPILCO,2,52,27,25,4
TLAXCALA,29,ATLTZAYANCA,004,SAN JERÓNIMO ZACUALPAN,1,4,2,2,1
TLAXCALA,29,ATLTZAYANCA,004,SAN JOSÉ BUENAVISTA,2,37,13,24,3
TLAXCALA,29,ATLTZAYANCA,004,SAN JOSÉ MIRAVALLE,1,17,8,9,2
TLAXCALA,29,ATLTZAYANCA,004,SAN JOSÉ PILANCÓN,3,76,33,43,6
TLAXCALA,29,ATLTZAYANCA,004,SAN JUAN OCOTITLA,3,57,19,38,5
TLAXCALA,29,ATLTZAYANCA,004,SANTA CRUZ POCITOS,4,622,318,304,27
TLAXCALA,29,ATLTZAYANCA,004,SANTA MARÍA LAS CUEVAS,3,213,112,101,11
TLAXCALA,29,ATLTZAYANCA,004,XALTITLA,3,67,33,34,5
TLAXCALA,29,ATLTZAYANCA,004,XARERO XALTITLA,2,6,4,2,1
TLAXCALA,29,APIZACO,005,CERRITO DE GUADALUPE,7,1001,508,493,59
TLAXCALA,29,APIZACO,005,CIUDAD DE APIZACO,121,16893,8524,8369,1281
TLAXCALA,29,APIZACO,005,COLONIA SAN ISIDRO,2,276,138,138,13
TLAXCALA,29,APIZACO,005,GUADALUPE TEXCALAC,3,334,170,164,19
TLAXCALA,29,APIZACO,005,JOSÉ MARÍA MORELOS,3,283,130,153,13
TLAXCALA,29,APIZACO,005,SAN LUIS APIZAQUITO,5,437,192,245,43
TLAXCALA,29,APIZACO,005,SANTA ANITA HUILOAC,12,2940,1542,1398,223
TLAXCALA,29,APIZACO,005,SANTA MARÍA TEXCALAC,15,2591,1276,1315,144
TLAXCALA,29,CALPULALPAN,006,EL MIRADOR,2,702,337,365,24
TLAXCALA,29,CALPULALPAN,006,HEROICA CIUDAD DE CALPULALPAN,37,9512,4923,4589,561
TLAXCALA,29,CALPULALPAN,006,LA PALMA,2,8,1,7,1
TLAXCALA,29,CALPULALPAN,006,LA SOLEDAD,3,319,157,162,11
TLAXCALA,29,CALPULALPAN,006,LA VENTA,3,21,7,14,3
TLAXCALA,29,CALPULALPAN,006,MAZAPA,3,341,160,181,16
TLAXCALA,29,CALPULALPAN,006,NCPE GUSTAVO DÍAZ ORDAZ,2,77,41,36,4
TLAXCALA,29,CALPULALPAN,006,SAN CRISTÓBAL ZACACALCO,2,135,63,72,6
TLAXCALA,29,CALPULALPAN,006,SAN FELIPE SULTEPEC,3,308,144,164,14
TLAXCALA,29,CALPULALPAN,006,SAN MARCOS GUAQUILPAN,3,252,120,132,12
TLAXCALA,29,CALPULALPAN,006,SAN MATEO ATICPAC,3,198,87,111,10
TLAXCALA,29,CALPULALPAN,006,SANTA ISABEL MIXTITLÁN,3,22,12,10,2
TLAXCALA,29,CALPULALPAN,006,SANTIAGO CUAULA,4,771,387,384,33
TLAXCALA,29,EL CARMEN TEQUEXQUITLA,007,BARRIO DE GUADALUPE,2,173,88,85,8
TLAXCALA,29,EL CARMEN TEQUEXQUITLA,007,COLONIA VICENTE GUERRERO,2,48,24,24,3
TLAXCALA,29,EL CARMEN TEQUEXQUITLA,007,LA SOLEDAD,3,154,74,80,8
TLAXCALA,29,EL CARMEN TEQUEXQUITLA,007,OCOTLÁN TEMALACAYUCAN,3,18,10,8,2
TLAXCALA,29,EL CARMEN TEQUEXQUITLA,007,VILLA DE EL CARMEN TEQUEXQUITLA,20,3591,1814,1777,177
TLAXCALA,29,CUAPIAXTLA,008,COLONIA DEL VALLE,2,27,14,13,3
TLAXCALA,29,CUAPIAXTLA,008,COLONIA IGNACIO ALLENDE,3,424,221,203,20
TLAXCALA,29,CUAPIAXTLA,008,COLONIA JOSÉ MARÍA MORELOS,2,134,57,77,7
TLAXCALA,29,CUAPIAXTLA,008,COLONIA LOMA BONITA,2,39,16,23,3
TLAXCALA,29,CUAPIAXTLA,008,COLONIA MANUEL ÁVILA CAMACHO,3,73,41,32,6
TLAXCALA,29,CUAPIAXTLA,008,CUAPIAXTLA,15,2938,1499,1439,180
TLAXCALA,29,CUAPIAXTLA,008,LA GRANJA (CAMINO A FRANCO),1,39,21,18,3
TLAXCALA,29,CUAPIAXTLA,008,PLAN DE AYALA,3,97,49,48,6
TLAXCALA,29,CUAPIAXTLA,008,SAN FRANCISCO CUEXCONTZI,4,346,170,176,14
TLAXCALA,29,CUAPIAXTLA,008,SANTA BEATRIZ LA NUEVA,2,43,24,19,3
TLAXCALA,29,CUAXOMULCO,009,COXTLA,2,62,32,30,5
TLAXCALA,29,CUAXOMULCO,009,CUAXOMULCO,7,637,305,332,31
TLAXCALA,29,CUAXOMULCO,009,SAN LORENZO XALTELULCO,2,178,86,92,7
TLAXCALA,29,CUAXOMULCO,009,SAN MIGUEL BUENAVISTA,3,89,39,50,7
TLAXCALA,29,CUAXOMULCO,009,ZACAMOLPA,2,80,42,38,5
TLAXCALA,29,CHIAUTEMPAN,010,SAN ANTOÑOTLA,2,6,2,4,2
TLAXCALA,29,CHIAUTEMPAN,010,SAN BARTOLOMÉ CUAHUIXMATLAC,6,909,435,474,62
TLAXCALA,29,CHIAUTEMPAN,010,SAN PEDRO MUÑOZTLA,3,566,282,284,24
TLAXCALA,29,CHIAUTEMPAN,010,SAN PEDRO TLALCUAPAN DE NICOLÁS BRAVO,8,1296,628,668,80
TLAXCALA,29,CHIAUTEMPAN,010,SAN PEDRO XOCHITEOTLA,4,725,373,352,44
TLAXCALA,29,CHIAUTEMPAN,010,SAN RAFAEL TEPATLAXCO,3,283,150,133,17
TLAXCALA,29,CHIAUTEMPAN,010,SANTA ANA CHIAUTEMPAN,81,15058,7492,7566,1042
TLAXCALA,29,CHIAUTEMPAN,010,SANTA CRUZ TETELA,2,242,113,129,10
TLAXCALA,29,MUÑOZ DE DOMINGO ARENAS,011,EJIDO MUÑOZ,2,29,20,9,3
TLAXCALA,29,MUÑOZ DE DOMINGO ARENAS,011,GUADALUPE CUAUHTÉMOC,2,91,49,42,5
TLAXCALA,29,MUÑOZ DE DOMINGO ARENAS,011,MUÑOZ,4,500,243,257,30
TLAXCALA,29,MUÑOZ DE DOMINGO ARENAS,011,SAN ISIDRO CHIPILA,3,53,30,23,4
TLAXCALA,29,MUÑOZ DE DOMINGO ARENAS,011,SAN JOSÉ CUAMANTZINGO,4,327,163,164,17
TLAXCALA,29,ESPAÑITA,012,ÁLVARO OBREGÓN,2,32,18,14,3
TLAXCALA,29,ESPAÑITA,012,BARRIO DE TORRES,2,60,33,27,3
TLAXCALA,29,ESPAÑITA,012,ESPAÑITA,6,880,444,436,37
TLAXCALA,29,ESPAÑITA,012,FRANCISCO I. MADERO EL VIEJO,2,11,4,7,1
TLAXCALA,29,ESPAÑITA,012,LA CONCEPCIÓN,1,21,10,11,2
TLAXCALA,29,ESPAÑITA,012,LA CONSTANCIA,2,63,36,27,3
TLAXCALA,29,ESPAÑITA,012,LA MAGDALENA CUEXTOTITLA,3,250,120,130,12
TLAXCALA,29,ESPAÑITA,012,LA REFORMA,3,82,40,42,7
TLAXCALA,29,ESPAÑITA,012,LAS PILAS,2,14,6,8,1
TLAXCALA,29,ESPAÑITA,012,MIGUEL ALDAMA,3,50,26,24,4
TLAXCALA,29,ESPAÑITA,012,SAN AGUSTÍN,2,6,3,3,1
TLAXCALA,29,ESPAÑITA,012,SAN FRANCISCO MITEPEC,3,357,190,167,22
TLAXCALA,29,ESPAÑITA,012,SAN JUAN MITEPEC,2,84,40,44,4
TLAXCALA,29,ESPAÑITA,012,SAN MIGUEL,1,19,11,8,2
TLAXCALA,29,ESPAÑITA,012,SAN MIGUEL EL PIÑÓN,2,52,26,26,5
TLAXCALA,29,ESPAÑITA,012,SAN MIGUEL PIPIYOLA,4,154,63,91,10
TLAXCALA,29,ESPAÑITA,012,VICENTE GUERRERO,3,168,96,72,12
TLAXCALA,29,HUAMANTLA,013,AMPLIACIÓN FELIPE CARRILLO PUERTO,2,26,12,14,3
TLAXCALA,29,HUAMANTLA,013,BENITO JUÁREZ,6,1389,703,686,50
TLAXCALA,29,HUAMANTLA,013,COLONIA ACASILLADOS SAN MARTÍN NOTARIO,1,51,25,26,3
TLAXCALA,29,HUAMANTLA,013,COLONIA AGRÍCOLA SAN MARTÍN NOTARIO,1,10,3,7,1
TLAXCALA,29,HUAMANTLA,013,COLONIA ALTAMIRA GUADALUPE,2,66,27,39,6
TLAXCALA,29,HUAMANTLA,013,COLONIA CHAPULTEPEC,3,217,104,113,13
TLAXCALA,29,HUAMANTLA,013,COLONIA CUAUHTÉMOC,3,199,98,101,11
TLAXCALA,29,HUAMANTLA,013,COLONIA EL VALLE,3,106,51,55,7
TLAXCALA,29,HUAMANTLA,013,COLONIA FRANCISCO I. MADERO LA MESA,2,29,13,16,3
TLAXCALA,29,HUAMANTLA,013,COLONIA FRANCISCO I. MADERO TECÓAC,1,40,19,21,3
TLAXCALA,29,HUAMANTLA,013,COLONIA FRANCISCO VILLA TECÓAC,2,188,100,88,9
TLAXCALA,29,HUAMANTLA,013,COLONIA HERMENEGILDO GALEANA,3,325,163,162,13
TLAXCALA,29,HUAMANTLA,013,EL CARMEN XALPATLAHUAYA,5,2711,1291,1420,147
TLAXCALA,29,HUAMANTLA,013,EL MOLINO [RANCHERÍA],3,34,16,18,4
TLAXCALA,29,HUAMANTLA,013,EX-HACIENDA SANTO DOMINGO,2,27,11,16,2
TLAXCALA,29,HUAMANTLA,013,FRACCIÓN LA NATIVIDAD,1,19,9,10,1
TLAXCALA,29,HUAMANTLA,013,GENERAL FRANCISCO VILLA,4,330,147,183,17
TLAXCALA,29,HUAMANTLA,013,HUAMANTLA,78,16720,8402,8318,953
TLAXCALA,29,HUAMANTLA,013,IGNACIO ZARAGOZA,7,2114,1046,1068,100
TLAXCALA,29,HUAMANTLA,013,JOSÉ MARÍA MORELOS,3,255,124,131,12
TLAXCALA,29,HUAMANTLA,013,LA LIMA [RANCHERÍA],2,33,16,17,3
TLAXCALA,29,HUAMANTLA,013,LÁZARO CÁRDENAS,3,369,191,178,15
TLAXCALA,29,HUAMANTLA,013,LOS PILARES,5,411,201,210,20
TLAXCALA,29,HUAMANTLA,013,NCP JOSÉ MARÍA MORELOS,2,55,30,25,4
TLAXCALA,29,HUAMANTLA,013,NCP SAN JOSÉ TEACALCO,2,40,15,25,3
TLAXCALA,29,HUAMANTLA,013,RANCHERÍA DE TORRES,3,68,33,35,5
TLAXCALA,29,HUAMANTLA,013,SAN ANTONIO ATENCO,1,132,73,59,5
TLAXCALA,29,HUAMANTLA,013,SAN DIEGO XALPATLAHUAYA,2,42,20,22,3
TLAXCALA,29,HUAMANTLA,013,SAN FRANCISCO TECÓAC [COLONIA],2,49,19,30,4
TLAXCALA,29,HUAMANTLA,013,SAN JOSÉ XICOHTÉNCATL,8,1536,758,778,58
TLAXCALA,29,HUAMANTLA,013,SAN MARTÍN NOTARIO,2,20,11,9,3
TLAXCALA,29,HUAMANTLA,013,SANTA ANA RÍOS,2,8,4,4,1
TLAXCALA,29,HUEYOTLIPAN,014,COLONIA ADOLFO LÓPEZ MATEOS,3,160,91,69,9
TLAXCALA,29,HUEYOTLIPAN,014,HUEYOTLIPAN,10,2736,1341,1395,121
TLAXCALA,29,HUEYOTLIPAN,014,IGNACIO ZARAGOZA,3,397,193,204,17
TLAXCALA,29,HUEYOTLIPAN,014,SAN ANDRÉS CUAXIMALA,2,35,16,19,3
TLAXCALA,29,HUEYOTLIPAN,014,SAN ANTONIO TECHALOTE,2,68,25,43,4
TLAXCALA,29,HUEYOTLIPAN,014,SAN DIEGO RECOBA,2,98,43,55,4
TLAXCALA,29,HUEYOTLIPAN,014,SAN LORENZO TECHALOTE,2,26,14,12,3
TLAXCALA,29,HUEYOTLIPAN,014,SAN MANUEL TLALPAN,2,16,6,10,2
TLAXCALA,29,HUEYOTLIPAN,014,SAN SIMEÓN XIPETZINCO,4,615,285,330,30
TLAXCALA,29,HUEYOTLIPAN,014,SANTA MARÍA IXCOTLA,3,103,45,58,8
TLAXCALA,29,HUEYOTLIPAN,014,SANTIAGO TLALPAN,3,139,70,69,8
TLAXCALA,29,IXTACUIXTLA DE MARIANO MATAMOROS,015,ALPOTZONGA DE LIRA Y ORTEGA,3,196,100,96,11
TLAXCALA,29,IXTACUIXTLA DE MARIANO MATAMOROS,015,ESPÍRITU SANTO,2,105,51,54,7
TLAXCALA,29,IXTACUIXTLA DE MARIANO MATAMOROS,015,LA CARIDAD CUAXONACAYO,2,70,35,35,3
TLAXCALA,29,IXTACUIXTLA DE MARIANO MATAMOROS,015,LA SOLEDAD,2,32,18,14,3
TLAXCALA,29,IXTACUIXTLA DE MARIANO MATAMOROS,015,LA TRINIDAD TENEXYECAC,3,553,286,267,28
TLAXCALA,29,IXTACUIXTLA DE MARIANO MATAMOROS,015,LA VIRGEN,2,23,13,10,3
TLAXCALA,29,IXTACUIXTLA DE MARIANO MATAMOROS,015,SAN ANTONIO ATOTONILCO,5,1270,615,655,78
TLAXCALA,29,IXTACUIXTLA DE MARIANO MATAMOROS,015,SAN ANTONIO TECÓAC,2,100,47,53,6
TLAXCALA,29,IXTACUIXTLA DE MARIANO MATAMOROS,015,SAN ANTONIO TIZOSTOC,3,275,127,148,12
TLAXCALA,29,IXTACUIXTLA DE MARIANO MATAMOROS,015,SAN DIEGO XOCOYUCAN,7,1739,770,969,80
TLAXCALA,29,IXTACUIXTLA DE MARIANO MATAMOROS,015,SAN GABRIEL POPOCATLA,4,250,125,125,12
TLAXCALA,29,IXTACUIXTLA DE MARIANO MATAMOROS,015,SAN JUAN NEPOPUALCO,2,44,25,19,3
TLAXCALA,29,IXTACUIXTLA DE MARIANO MATAMOROS,015,SAN MARCOS JILOTEPEC,3,72,27,45,6
TLAXCALA,29,IXTACUIXTLA DE MARIANO MATAMOROS,015,SAN MIGUEL LA PRESA,2,44,22,22,3
TLAXCALA,29,IXTACUIXTLA DE MARIANO MATAMOROS,015,SANTA CRUZ EL PORVENIR,3,205,88,117,12
TLAXCALA,29,IXTACUIXTLA DE MARIANO MATAMOROS,015,SANTA INÉS TECUEXCOMAC,2,370,178,192,18
TLAXCALA,29,IXTACUIXTLA DE MARIANO MATAMOROS,015,SANTA JUSTINA ECATEPEC,4,785,384,401,46
TLAXCALA,29,IXTACUIXTLA DE MARIANO MATAMOROS,015,SANTA ROSA DE LIMA,2,43,22,21,3
TLAXCALA,29,IXTACUIXTLA DE MARIANO MATAMOROS,015,SANTIAGO XOCHIMILCO,2,63,22,41,4
TLAXCALA,29,IXTACUIXTLA DE MARIANO MATAMOROS,015,VILLA MARIANO MATAMOROS,14,3360,1741,1619,295
TLAXCALA,29,IXTENCO,016,IXTENCO,11,2241,1152,1089,137
TLAXCALA,29,MAZATECOCHCO DE JOSÉ MARÍA MORELOS,017,MAZATECOCHCO,13,3279,1587,1692,135
TLAXCALA,29,CONTLA DE JUAN CUAMATZI,018,CONTLA,33,7908,4015,3893,505
TLAXCALA,29,CONTLA DE JUAN CUAMATZI,018,IXTLAHUACA,3,91,44,47,5
TLAXCALA,29,CONTLA DE JUAN CUAMATZI,018,LA LUZ [BARRIO],1,174,92,82,6
TLAXCALA,29,CONTLA DE JUAN CUAMATZI,018,OCOTLÁN TEPATLAXCO,2,133,68,65,7
TLAXCALA,29,CONTLA DE JUAN CUAMATZI,018,SAN FELIPE CUAUHTENCO,6,726,359,367,40
TLAXCALA,29,CONTLA DE JUAN CUAMATZI,018,SAN JOSÉ AZTATLA,4,516,255,261,23
TLAXCALA,29,CONTLA DE JUAN CUAMATZI,018,SANTA MARÍA AQUIÁHUAC,2,71,39,32,3
TLAXCALA,29,TEPETITLA DE LARDIZÁBAL,019,GUADALUPE VICTORIA,2,375,183,192,16
TLAXCALA,29,TEPETITLA DE LARDIZÁBAL,019,SAN JUAN MOLINO,1,135,77,58,62
TLAXCALA,29,TEPETITLA DE LARDIZÁBAL,019,SAN MATEO AYECAC,2,427,213,214,16
TLAXCALA,29,TEPETITLA DE LARDIZÁBAL,019,TEPETITLA,9,2194,1056,1138,128
TLAXCALA,29,TEPETITLA DE LARDIZÁBAL,019,VILLA ALTA,8,1711,901,810,107
TLAXCALA,29,SANCTÓRUM DE LÁZARO CÁRDENAS,020,FRANCISCO VILLA,6,930,454,476,39
TLAXCALA,29,SANCTÓRUM DE LÁZARO CÁRDENAS,020,NCP ÁLVARO OBREGÓN,1,85,39,46,4
TLAXCALA,29,SANCTÓRUM DE LÁZARO CÁRDENAS,020,SANCTÓRUM,6,1141,568,573,67
TLAXCALA,29,NANACAMILPA DE MARIANO ARISTA,021,CIUDAD DE NANACAMILPA,11,2657,1352,1305,139
TLAXCALA,29,NANACAMILPA DE MARIANO ARISTA,021,COLONIA TEPUENTE,3,53,26,27,4
TLAXCALA,29,NANACAMILPA DE MARIANO ARISTA,021,DOMINGO ARENAS (LA CALERA),2,67,35,32,4
TLAXCALA,29,NANACAMILPA DE MARIANO ARISTA,021,FRANCISCO I. MADERO,4,1040,535,505,193
TLAXCALA,29,NANACAMILPA DE MARIANO ARISTA,021,MIGUEL LIRA Y ORTEGA,2,226,113,113,9
TLAXCALA,29,NANACAMILPA DE MARIANO ARISTA,021,SAN FELIPE HIDALGO,3,399,206,193,17
TLAXCALA,29,ACUAMANALA DE MIGUEL HIDALGO,022,ACUAMANALA,6,1048,527,521,53
TLAXCALA,29,ACUAMANALA DE MIGUEL HIDALGO,022,GUADALUPE HIDALGO,2,185,99,86,8
TLAXCALA,29,ACUAMANALA DE MIGUEL HIDALGO,022,OLEXTLA DE JUÁREZ,2,155,79,76,8
TLAXCALA,29,NATÍVITAS,023,EX-HACIENDA SANTA ELENA,2,16,8,8,2
TLAXCALA,29,NATÍVITAS,023,GUADALUPE VICTORIA,2,151,68,83,8
TLAXCALA,29,NATÍVITAS,023,JESÚS TEPACTEPEC,1,83,48,35,4
TLAXCALA,29,NATÍVITAS,023,NATÍVITAS,9,1792,898,894,146
TLAXCALA,29,NATÍVITAS,023,SAN BERNABÉ CAPULA,3,387,197,190,13
TLAXCALA,29,NATÍVITAS,023,SAN FRANCISCO TENEXYECAC,2,212,111,101,8
TLAXCALA,29,NATÍVITAS,023,SAN JOSÉ ATOYATENCO,2,302,141,161,13
TLAXCALA,29,NATÍVITAS,023,SAN MIGUEL ANALCO,3,305,156,149,13
TLAXCALA,29,NATÍVITAS,023,SAN MIGUEL DEL MILAGRO,2,127,56,71,8
TLAXCALA,29,NATÍVITAS,023,SAN MIGUEL TLALE,1,20,13,7,2
TLAXCALA,29,NATÍVITAS,023,SAN MIGUEL XOCHITECATITLA,3,479,241,238,25
TLAXCALA,29,NATÍVITAS,023,SAN RAFAEL TENANYECAC,2,416,209,207,18
TLAXCALA,29,NATÍVITAS,023,SAN VICENTE XILOXOCHITLA,4,444,227,217,25
TLAXCALA,29,NATÍVITAS,023,SANTA CLARA ATOYAC,2,11,7,4,2
TLAXCALA,29,NATÍVITAS,023,SANTIAGO MICHAC,5,666,342,324,43
TLAXCALA,29,NATÍVITAS,023,SANTO TOMÁS LA CONCORDIA,2,488,249,239,21
TLAXCALA,29,PANOTLA,024,CAMINO A SAN MIGUEL,1,10,6,4,1
TLAXCALA,29,PANOTLA,024,JESÚS ACATITLA,2,154,85,69,8
TLAXCALA,29,PANOTLA,024,PANOTLA,22,4197,2538,1659,371
TLAXCALA,29,PANOTLA,024,SAN AMBROSIO TEXANTLA,2,49,27,22,4
TLAXCALA,29,PANOTLA,024,SAN FRANCISCO TEMETZONTLA,3,449,216,233,30
TLAXCALA,29,PANOTLA,024,SAN JORGE TEZOQUIPAN,6,2203,1148,1055,245
TLAXCALA,29,PANOTLA,024,SAN MATEO HUEXOYUCAN,5,217,104,113,14
TLAXCALA,29,PANOTLA,024,SAN TADEO HUILOAPAN,4,831,408,423,46
TLAXCALA,29,PANOTLA,024,SANTA CATALINA APATLAHCO,2,8,5,3,1
TLAXCALA,29,PANOTLA,024,SANTA CRUZ TECHACHALCO,2,157,70,87,8
TLAXCALA,29,SAN PABLO DEL MONTE,025,ACOPILCO,2,16,8,8,2
TLAXCALA,29,SAN PABLO DEL MONTE,025,AHUASHUAME,1,24,9,15,2
TLAXCALA,29,SAN PABLO DEL MONTE,025,CACAMILA SAN ANTONIO,3,24,6,18,3
TLAXCALA,29,SAN PABLO DEL MONTE,025,CIUDAD DE SAN PABLO DEL MONTE,65,17132,8559,8573,927
TLAXCALA,29,SAN PABLO DEL MONTE,025,HUEYRASTRUJO,1,12,5,7,1
TLAXCALA,29,SAN PABLO DEL MONTE,025,MOXONTITLA,2,11,5,6,1
TLAXCALA,29,SAN PABLO DEL MONTE,025,POPOZOTZI,1,31,17,14,2
TLAXCALA,29,SAN PABLO DEL MONTE,025,SAN ISIDRO BUEN SUCESO,11,2251,1074,1177,98
TLAXCALA,29,SAN PABLO DEL MONTE,025,TEPECHIHUATL,1,30,13,17,2
TLAXCALA,29,SAN PABLO DEL MONTE,025,TETZACUAL,3,14,7,7,2
TLAXCALA,29,SAN PABLO DEL MONTE,025,XAHUÉN VARGAS,1,30,13,17,2
TLAXCALA,29,SAN PABLO DEL MONTE,025,XAHUENTLATEMPA,2,26,16,10,2
TLAXCALA,29,SANTA CRUZ TLAXCALA,026,GUADALUPE TLACHCO,7,1022,494,528,74
TLAXCALA,29,SANTA CRUZ TLAXCALA,026,JESÚS HUITZNÁHUAC,2,253,137,116,11
TLAXCALA,29,SANTA CRUZ TLAXCALA,026,SAN MIGUEL CONTLA,13,1222,638,584,137
TLAXCALA,29,SANTA CRUZ TLAXCALA,026,SANTA CRUZ TLAXCALA,20,2626,1331,1295,190
TLAXCALA,29,SANTA CRUZ TLAXCALA,026,TETZOTZOCOLA,1,21,9,12,2
TLAXCALA,29,SANTA CRUZ TLAXCALA,026,XAMISTLA,3,10,5,5,2
TLAXCALA,29,TENANCINGO,027,EL PUENTE,2,52,28,24,3
TLAXCALA,29,TENANCINGO,027,TENANCINGO,14,2774,1397,1377,126
TLAXCALA,29,TEOLOCHOLCO,028,ACXOTLA DEL MONTE,4,509,243,266,23
TLAXCALA,29,TEOLOCHOLCO,028,CUAXINCA,3,151,75,76,8
TLAXCALA,29,TEOLOCHOLCO,028,EL CARMEN AZTAMA,3,516,246,270,27
TLAXCALA,29,TEOLOCHOLCO,028,TEOLOCHOLCO,33,4826,2359,2467,284
TLAXCALA,29,TEOLOCHOLCO,028,TEPIZILA,2,11,9,2,2
TLAXCALA,29,TEPEYANCO,029,COLONIA GUERRERO,2,240,123,117,11
TLAXCALA,29,TEPEYANCO,029,LA AURORA,2,124,59,65,8
TLAXCALA,29,TEPEYANCO,029,LAS ÁGUILAS [COLONIA],1,5,1,4,1
TLAXCALA,29,TEPEYANCO,029,SAN COSME ATLAMAXAC,2,318,170,148,15
TLAXCALA,29,TEPEYANCO,029,SAN PEDRO XALCALTZINCO,5,6598,2451,4147,262
TLAXCALA,29,TEPEYANCO,029,SANTIAGO TLACOCHCALCO,3,205,101,104,13
TLAXCALA,29,TEPEYANCO,029,TEPEYANCO,7,1816,924,892,115
TLAXCALA,29,TERRENATE,030,CERRITO DE GUADALUPE,1,3,0,3,1
TLAXCALA,29,TERRENATE,030,CORTESCO,2,5,2,3,1
TLAXCALA,29,TERRENATE,030,EL CAPULÍN [COLONIA],3,155,76,79,8
TLAXCALA,29,TERRENATE,030,EL OCOTE (LAS POZAS) [RANCHO],1,20,9,11,2
TLAXCALA,29,TERRENATE,030,EL RINCÓN [RANCHERÍA],1,3,2,1,1
TLAXCALA,29,TERRENATE,030,GUADALUPE [RANCHO],2,6,1,5,1
TLAXCALA,29,TERRENATE,030,GUADALUPE VICTORIA,3,208,105,103,11
TLAXCALA,29,TERRENATE,030,LOS AMELES (ACOLCO),3,58,27,31,4
TLAXCALA,29,TERRENATE,030,NICOLÁS BRAVO,4,493,236,257,21
TLAXCALA,29,TERRENATE,030,SAN JOSÉ VILLARREAL,4,356,193,163,16
TLAXCALA,29,TERRENATE,030,SAN JUAN VILLARREAL [RANCHO],2,11,4,7,2
TLAXCALA,29,TERRENATE,030,SANTA ANA [RANCHO],2,7,4,3,1
TLAXCALA,29,TERRENATE,030,TERRENATE,8,1861,912,949,107
TLAXCALA,29,TERRENATE,030,TOLUCA DE GUADALUPE,4,745,367,378,32
TLAXCALA,29,TETLA DE LA SOLIDARIDAD,031,CAPULAC,3,274,120,154,12
TLAXCALA,29,TETLA DE LA SOLIDARIDAD,031,EJIDO DE APIZAQUITO,2,4,1,3,2
TLAXCALA,29,TETLA DE LA SOLIDARIDAD,031,JOSÉ MARÍA MORELOS Y PAVÓN,3,167,73,94,9
TLAXCALA,29,TETLA DE LA SOLIDARIDAD,031,PLAN DE AYALA,3,75,38,37,6
TLAXCALA,29,TETLA DE LA SOLIDARIDAD,031,SAN BARTOLOMÉ MATLALOHCAN,5,547,264,283,33
TLAXCALA,29,TETLA DE LA SOLIDARIDAD,031,SAN FRANCISCO ATEXCATZINCO,10,1775,897,878,93
TLAXCALA,29,TETLA DE LA SOLIDARIDAD,031,SAN GREGORIO,2,4,1,3,1
TLAXCALA,29,TETLA DE LA SOLIDARIDAD,031,SAN ISIDRO,1,15,10,5,1
TLAXCALA,29,TETLA DE LA SOLIDARIDAD,031,SAN ISIDRO PIEDRAS NEGRAS,1,39,19,20,2
TLAXCALA,29,TETLA DE LA SOLIDARIDAD,031,SANTA FE LA TROJE,2,67,31,36,4
TLAXCALA,29,TETLA DE LA SOLIDARIDAD,031,TETLA,25,5867,2918,2949,276
TLAXCALA,29,TETLATLAHUCA,032,SAN ANDRÉS CUAMILPA,2,137,62,75,7
TLAXCALA,29,TETLATLAHUCA,032,SAN BARTOLOMÉ TENANGO,1,71,40,31,3
TLAXCALA,29,TETLATLAHUCA,032,SANTA ANA PORTALES,3,136,69,67,8
TLAXCALA,29,TETLATLAHUCA,032,SANTA CRUZ AQUIAHUAC,5,608,290,318,41
TLAXCALA,29,TETLATLAHUCA,032,SANTA CRUZ CAPULINARES,2,14,7,7,2
TLAXCALA,29,TETLATLAHUCA,032,TETLATLAHUCA,6,957,467,490,59
TLAXCALA,29,TLAXCALA,033,OCOTLÁN,15,2225,1188,1037,169
TLAXCALA,29,TLAXCALA,033,PUEBLO HEROICO DE LA TRINIDAD TEPEHITEC,5,640,318,322,59
TLAXCALA,29,TLAXCALA,033,SAN BUENAVENTURA ATEMPAN,8,310,165,145,47
TLAXCALA,29,TLAXCALA,033,SAN DIEGO METEPEC,1,140,68,72,6
TLAXCALA,29,TLAXCALA,033,SAN ESTEBAN TIZATLÁN,9,1072,542,530,109
TLAXCALA,29,TLAXCALA,033,SAN GABRIEL CUAUHTLA,7,1038,502,536,71
TLAXCALA,29,TLAXCALA,033,SAN HIPÓLITO CHIMALPA,2,264,133,131,13
TLAXCALA,29,TLAXCALA,033,SAN LUCAS CUAUHTELULPAN,3,243,119,124,12
TLAXCALA,29,TLAXCALA,033,SAN SEBASTIÁN ATLAHAPA,7,923,423,500,63
TLAXCALA,29,TLAXCALA,033,SANTA MARÍA ACUITLAPILCO,11,1482,754,728,88
TLAXCALA,29,TLAXCALA,033,SANTA MARÍA IXTULCO,11,1344,659,685,114
TLAXCALA,29,TLAXCALA,033,TLAXCALA DE XICOHTÉNCATL,134,31670,18272,13398,3040
TLAXCALA,29,TLAXCO,034,ACOPINALCO DEL PEÑÓN,5,532,267,265,26
TLAXCALA,29,TLAXCO,034,CAPILLA DE TEPEYAHUALCO,3,64,37,27,6
TLAXCALA,29,TLAXCO,034,CASA BLANCA,3,111,46,65,5
TLAXCALA,29,TLAXCO,034,COMISIÓN FEDERAL DE ELECTRICIDAD-LA MARTINICA,3,67,33,34,4
TLAXCALA,29,TLAXCO,034,EL MIRADOR,1,24,11,13,2
TLAXCALA,29,TLAXCO,034,EL ROSARIO,6,888,449,439,54
TLAXCALA,29,TLAXCO,034,EX-HACIENDA SAN MIGUEL MIMIAHUAPAN,4,449,183,266,31
TLAXCALA,29,TLAXCO,034,GRACIANO SÁNCHEZ,3,70,31,39,6
TLAXCALA,29,TLAXCO,034,GUADALUPE HUEXOTITLA,2,12,8,4,2
TLAXCALA,29,TLAXCO,034,JOSÉ MARÍA MORELOS BUENAVISTA,5,812,429,383,69
TLAXCALA,29,TLAXCO,034,LA CIÉNEGA,3,55,27,28,5
TLAXCALA,29,TLAXCO,034,LA HERRADURA,2,42,18,24,2
TLAXCALA,29,TLAXCO,034,LA MAGDALENA SOLTEPEC,3,113,63,50,8
TLAXCALA,29,TLAXCO,034,LA PALMA,4,144,72,72,10
TLAXCALA,29,TLAXCO,034,LA ROSA,1,15,6,9,1
TLAXCALA,29,TLAXCO,034,LAGUNILLA,5,446,226,220,21
TLAXCALA,29,TLAXCO,034,LAS MESAS,2,27,13,14,3
TLAXCALA,29,TLAXCO,034,LAS VIGAS,3,66,27,39,7
TLAXCALA,29,TLAXCO,034,LOS CAPULINES,3,25,15,10,4
TLAXCALA,29,TLAXCO,034,LOS LAURELES,2,18,7,11,2
TLAXCALA,29,TLAXCO,034,MAGUEY CENIZO,2,20,11,9,2
TLAXCALA,29,TLAXCO,034,MARIANO MATAMOROS,3,235,121,114,19
TLAXCALA,29,TLAXCO,034,MÁXIMO ROJAS XALÓSTOC,2,124,66,58,6
TLAXCALA,29,TLAXCO,034,MAZAQUIÁHUAC,2,45,22,23,3
TLAXCALA,29,TLAXCO,034,NCPE LA HERRADURA,2,5,2,3,1
TLAXCALA,29,TLAXCO,034,OJO DE AGUA,2,48,22,26,4
TLAXCALA,29,TLAXCO,034,SAN ANTONIO CHAPULTEPEC,2,8,4,4,1
TLAXCALA,29,TLAXCO,034,SAN ANTONIO HUEXOTITLA,3,123,61,62,8
TLAXCALA,29,TLAXCO,034,SAN JOSÉ ATOTONILCO,5,1012,519,493,47
TLAXCALA,29,TLAXCO,034,SAN JOSÉ TEPEYAHUALCO,3,221,93,128,11
TLAXCALA,29,TLAXCO,034,SAN LORENZO SOLTEPEC,4,241,110,131,16
TLAXCALA,29,TLAXCO,034,SAN PEDRO LA CUEVA,2,42,18,24,3
TLAXCALA,29,TLAXCO,034,SANTA FE,2,14,7,7,2
TLAXCALA,29,TLAXCO,034,SANTA MARÍA ZOTOLUCA,3,86,38,48,6
TLAXCALA,29,TLAXCO,034,TECOMALUCAN,3,166,72,94,8
TLAXCALA,29,TLAXCO,034,TITICHILCO,3,40,20,20,4
TLAXCALA,29,TLAXCO,034,TLAQUEXPA,3,12,3,9,2
TLAXCALA,29,TLAXCO,034,TLAXCO,34,5811,2975,2836,343
TLAXCALA,29,TLAXCO,034,UNIÓN EJIDAL TIERRA Y LIBERTAD,4,928,440,488,60
TLAXCALA,29,TOCATLÁN,035,TOCATLÁN,11,1678,798,880,92
TLAXCALA,29,TOTOLAC,036,ACXOTLA DEL RÍO,2,104,51,53,5
TLAXCALA,29,TOTOLAC,036,LA CANDELARIA TEOTLALPAN,3,138,45,93,22
TLAXCALA,29,TOTOLAC,036,LA TRINIDAD CHIMALPA,1,83,43,40,4
TLAXCALA,29,TOTOLAC,036,LOS REYES QUIAHUIXTLÁN,2,255,124,131,13
TLAXCALA,29,TOTOLAC,036,SAN FRANCISCO OCOTELULCO,1,194,94,100,10
TLAXCALA,29,TOTOLAC,036,SAN JUAN TOTOLAC,9,1801,847,954,110
TLAXCALA,29,TOTOLAC,036,SAN MIGUEL TLAMAHUCO,1,136,59,77,6
TLAXCALA,29,TOTOLAC,036,SANTIAGO TEPETICPAC,3,309,133,176,17
TLAXCALA,29,TOTOLAC,036,ZARAGOZA,5,590,300,290,40
TLAXCALA,29,ZILTLALTÉPEC DE TRINIDAD SÁNCHEZ SANTOS,037,COLONIA FRANCISCO JAVIER MINA,3,219,123,96,11
TLAXCALA,29,ZILTLALTÉPEC DE TRINIDAD SÁNCHEZ SANTOS,037,SAN JUAN BAUTISTA MIER,3,134,65,69,8
TLAXCALA,29,ZILTLALTÉPEC DE TRINIDAD SÁNCHEZ SANTOS,037,ZITLALTÉPEC,11,1659,807,852,98
TLAXCALA,29,TZOMPANTEPEC,038,SAN ANDRÉS AHUASHUATEPEC,24,8347,3537,4810,514
TLAXCALA,29,TZOMPANTEPEC,038,SAN JUAN QUETZALCOAPAN,3,197,96,101,11
TLAXCALA,29,TZOMPANTEPEC,038,SAN MATEO INOPHIL,2,52,24,28,4
TLAXCALA,29,TZOMPANTEPEC,038,TZOMPANTEPEC,10,638,306,332,33
TLAXCALA,29,TZOMPANTEPEC,038,XALTIANQUISCO,3,265,137,128,13
TLAXCALA,29,XALOZTOC,039,COLONIA JOSÉ LÓPEZ PORTILLO,1,37,14,23,2
TLAXCALA,29,XALOZTOC,039,COLONIA VELAZCO,2,156,78,78,8
TLAXCALA,29,XALOZTOC,039,COLONIA VENUSTIANO CARRANZA,1,128,60,68,6
TLAXCALA,29,XALOZTOC,039,EL JAGÜEY PRIETO,1,28,17,11,2
TLAXCALA,29,XALOZTOC,039,GUADALUPE TEXMOLAC,1,569,272,297,42
TLAXCALA,29,XALOZTOC,039,SAN PEDRO TLACOTEPEC,3,500,237,263,23
TLAXCALA,29,XALOZTOC,039,SANTA CRUZ ZACATZONTETLA,1,597,306,291,38
TLAXCALA,29,XALOZTOC,039,XALOZTOC,23,4547,2268,2279,207
TLAXCALA,29,XALTOCAN,040,CUATLA,2,107,50,57,5
TLAXCALA,29,XALTOCAN,040,LA ASCENSIÓN HUITZCOLOTEPEC,2,121,57,64,8
TLAXCALA,29,XALTOCAN,040,LA RETAMA,2,5,3,2,1
TLAXCALA,29,XALTOCAN,040,LAS MESAS [COLONIA],2,10,3,7,1
TLAXCALA,29,XALTOCAN,040,SAN JOSÉ TEXOPA,2,45,22,23,4
TLAXCALA,29,XALTOCAN,040,SAN SIMÓN TLATLAHUQUITEPEC,6,978,512,466,44
TLAXCALA,29,XALTOCAN,040,SANTA BÁRBARA ACUICUIZCATEPEC,2,99,44,55,7
TLAXCALA,29,XALTOCAN,040,TOPILCO DE JUÁREZ,2,216,116,100,12
TLAXCALA,29,XALTOCAN,040,XALTOCAN,6,829,416,413,60
TLAXCALA,29,PAPALOTLA DE XICOHTÉNCATL,041,PAPALOTLA,39,8530,4221,4309,476
TLAXCALA,29,PAPALOTLA DE XICOHTÉNCATL,041,SAN DIEGO BUENAVISTA,2,19,9,10,1
TLAXCALA,29,PAPALOTLA DE XICOHTÉNCATL,041,SAN MARCOS CONTLA,4,738,365,373,35
TLAXCALA,29,PAPALOTLA DE XICOHTÉNCATL,041,XALTONAC,1,22,12,10,1
TLAXCALA,29,XICOHTZINCO,042,XICOHTZINCO,27,3948,1867,2081,289
TLAXCALA,29,YAUHQUEMEHCAN,043,BARRIO DE ATENCINGO,2,29,16,13,3
TLAXCALA,29,YAUHQUEMEHCAN,043,CHIMALPA,1,13,6,7,1
TLAXCALA,29,YAUHQUEMEHCAN,043,CUARTA SECCIÓN,1,9,8,1,1
TLAXCALA,29,YAUHQUEMEHCAN,043,EL ROSARIO OCOTOXCO,2,160,83,77,8
TLAXCALA,29,YAUHQUEMEHCAN,043,HUALCALTZINCO,2,320,160,160,14
TLAXCALA,29,YAUHQUEMEHCAN,043,SAN BENITO XALTOCAN,13,1065,538,527,68
TLAXCALA,29,YAUHQUEMEHCAN,043,SAN DIONISIO YAUHQUEMEHCAN,12,1238,614,624,59
TLAXCALA,29,YAUHQUEMEHCAN,043,SAN FRANCISCO TLACUILOHCAN,3,276,124,152,13
TLAXCALA,29,YAUHQUEMEHCAN,043,SAN JOSÉ TEPOXTLA,2,33,13,20,3
TLAXCALA,29,YAUHQUEMEHCAN,043,SAN JOSÉ TETEL,6,1043,490,553,54
TLAXCALA,29,YAUHQUEMEHCAN,043,SANTA MARÍA ATLIHUETZIAN,8,885,431,454,64
TLAXCALA,29,YAUHQUEMEHCAN,043,SANTA ÚRSULA ZIMATEPEC,10,1698,826,872,134
TLAXCALA,29,ZACATELCO,044,DOMINGO ARENAS,2,46,21,25,3
TLAXCALA,29,ZACATELCO,044,SANTA ELENA,1,118,59,59,5
TLAXCALA,29,ZACATELCO,044,ZACATELCO,73,14500,7874,6626,989
TLAXCALA,29,BENITO JUÁREZ,045,BENITO JUÁREZ,11,1621,848,773,72
TLAXCALA,29,EMILIANO ZAPATA,046,AHILITLA,1,3,1,2,1
TLAXCALA,29,EMILIANO ZAPATA,046,COLONIA GUSTAVO DÍAZ ORDAZ,4,391,203,188,17
TLAXCALA,29,EMILIANO ZAPATA,046,EMILIANO ZAPATA,5,933,482,451,39
TLAXCALA,29,EMILIANO ZAPATA,046,LAS PALOMAS [RANCHO],2,11,6,5,2
TLAXCALA,29,LÁZARO CÁRDENAS,047,LÁZARO CÁRDENAS,5,1073,555,518,53
TLAXCALA,29,LÁZARO CÁRDENAS,047,SAN JOSÉ DE LA LAGUNA,2,52,25,27,4
TLAXCALA,29,LA MAGDALENA TLALTELULCO,048,LA MAGDALENA TLALTELULCO,25,4167,2096,2071,232
TLAXCALA,29,SAN DAMIÁN TEXÓLOC,049,SAN DAMIÁN TEXÓLOC,6,1110,518,592,54
TLAXCALA,29,SAN FRANCISCO TETLANOHCAN,050,SAN FRANCISCO TETLANOHCAN,15,3088,1534,1554,233
TLAXCALA,29,SAN JERÓNIMO ZACUALPAN,051,SAN JERÓNIMO ZACUALPAN,8,2839,1452,1387,286
TLAXCALA,29,SAN JOSÉ TEACALCO,052,ALTOS DE MESA,2,14,5,9,2
TLAXCALA,29,SAN JOSÉ TEACALCO,052,COLONIA ECOLÓGICA,2,8,3,5,1
TLAXCALA,29,SAN JOSÉ TEACALCO,052,EL ENCINAL DOS DE MAYO,2,7,3,4,1
TLAXCALA,29,SAN JOSÉ TEACALCO,052,SAN JOSÉ TEACALCO,9,1420,698,722,79
TLAXCALA,29,SAN JOSÉ TEACALCO,052,SAN LUIS,2,21,10,11,3
TLAXCALA,29,SAN JUAN HUACTZINCO,053,SAN JUAN HUACTZINCO,9,1805,929,876,104
TLAXCALA,29,SAN LORENZO AXOCOMANITLA,054,SAN LORENZO AXOCOMANITLA,6,1140,549,591,58
TLAXCALA,29,SAN LUCAS TECOPILCO,055,SAN LUCAS TECOPILCO,6,840,379,461,70
TLAXCALA,29,SANTA ANA NOPALUCAN,056,SANTA ANA NOPALUCAN,10,2407,1141,1266,139
TLAXCALA,29,SANTA APOLONIA TEACALCO,057,SANTA APOLONIA TEACALCO,7,2445,1236,1209,220
TLAXCALA,29,SANTA CATARINA AYOMETLA,058,SANTA CATARINA AYOMETLA,11,1987,994,993,104
TLAXCALA,29,SANTA CRUZ QUILEHTLA,059,AYOMETITLA,2,410,216,194,16
TLAXCALA,29,SANTA CRUZ QUILEHTLA,059,SANTA CRUZ QUILEHTLA,6,1475,705,770,69
TLAXCALA,29,SANTA ISABEL XILOXOXTLA,060,SANTA ISABEL XILOXOXTLA,7,949,476,473,74
VERACRUZ DE IGNACIO DE LA LLAVE,30,ACAJETE,001,ACAJETE,4,326,151,175,26
VERACRUZ DE IGNACIO DE LA LLAVE,30,ACAJETE,001,ACOCOTA,3,208,100,108,13
VERACRUZ DE IGNACIO DE LA LLAVE,30,ACAJETE,001,BARRANQUILLAS,2,25,13,12,3
VERACRUZ DE IGNACIO DE LA LLAVE,30,ACAJETE,001,DOS VEREDAS,3,91,55,36,6
VERACRUZ DE IGNACIO DE LA LLAVE,30,ACAJETE,001,EL ENCINAL DOS,2,70,26,44,4
VERACRUZ DE IGNACIO DE LA LLAVE,30,ACAJETE,001,EL MIRADOR,1,6,4,2,1
VERACRUZ DE IGNACIO DE LA LLAVE,30,ACAJETE,001,EL RODEO,1,51,26,25,5
VERACRUZ DE IGNACIO DE LA LLAVE,30,ACAJETE,001,EL SAUCAL,2,28,17,11,3
VERACRUZ DE IGNACIO DE LA LLAVE,30,ACAJETE,001,EL ZAPOTAL,1,16,6,10,1
VERACRUZ DE IGNACIO DE LA LLAVE,30,ACAJETE,001,LA JOYA,4,460,238,222,27
VERACRUZ DE IGNACIO DE LA LLAVE,30,ACAJETE,001,LA JOYA CHICA,2,19,7,12,3
VERACRUZ DE IGNACIO DE LA LLAVE,30,ACAJETE,001,MAZATEPEC,4,448,224,224,26
VERACRUZ DE IGNACIO DE LA LLAVE,30,ACAJETE,001,MESA DE LA YERBA,3,115,62,53,8
VERACRUZ DE IGNACIO DE LA LLAVE,30,ACAJETE,001,PATA MOLE,3,53,28,25,4
VERACRUZ DE IGNACIO DE LA LLAVE,30,ACAJETE,001,PLAN DE SEDEÑO,2,74,33,41,6
VERACRUZ DE IGNACIO DE LA LLAVE,30,ACAJETE,001,PUENTECILLAS,3,119,67,52,9
VERACRUZ DE IGNACIO DE LA LLAVE,30,ACAJETE,001,TIERRA PRIETA,1,14,6,8,1
VERACRUZ DE IGNACIO DE LA LLAVE,30,ACAJETE,001,VEGA DE PIXQUIAC,2,11,4,7,1
VERACRUZ DE IGNACIO DE LA LLAVE,30,ACATLÁN,002,ACATLÁN,5,692,335,357,36
VERACRUZ DE IGNACIO DE LA LLAVE,30,ACATLÁN,002,PLAN DEL PINO (PLAN DEL COYOTE),1,4,2,2,1
VERACRUZ DE IGNACIO DE LA LLAVE,30,ACATLÁN,002,VEINTICUATRO,1,4,2,2,1
VERACRUZ DE IGNACIO DE LA LLAVE,30,ACAYUCAN,003,ACAYUCAN,94,15961,7922,8039,1153
VERACRUZ DE IGNACIO DE LA LLAVE,30,ACAYUCAN,003,AGUAPINOLE (CUAPINOLE),4,161,73,88,9
VERACRUZ DE IGNACIO DE LA LLAVE,30,ACAYUCAN,003,ALFREDO CUADRA I. PIÑA,3,69,33,36,6
VERACRUZ DE IGNACIO DE LA LLAVE,30,ACAYUCAN,003,APAXTA,1,21,10,11,2
VERACRUZ DE IGNACIO DE LA LLAVE,30,ACAYUCAN,003,CABAÑAS,2,43,14,29,3
VERACRUZ DE IGNACIO DE LA LLAVE,30,ACAYUCAN,003,CAMPO DE ÁGUILA,2,79,29,50,6
VERACRUZ DE IGNACIO DE LA LLAVE,30,ACAYUCAN,003,CASCAJAL DEL RÍO (CASCAJALILLO),3,69,29,40,6
VERACRUZ DE IGNACIO DE LA LLAVE,30,ACAYUCAN,003,COLONIA HIDALGO,4,582,274,308,31
VERACRUZ DE IGNACIO DE LA LLAVE,30,ACAYUCAN,003,COMEJÉN,4,251,109,142,17
VERACRUZ DE IGNACIO DE LA LLAVE,30,ACAYUCAN,003,CONGREGACIÓN HIDALGO,5,484,241,243,28
VERACRUZ DE IGNACIO DE LA LLAVE,30,ACAYUCAN,003,CORRAL NUEVO,8,581,285,296,47
VERACRUZ DE IGNACIO DE LA LLAVE,30,ACAYUCAN,003,DEHESA,6,887,417,470,44
VERACRUZ DE IGNACIO DE LA LLAVE,30,ACAYUCAN,003,EL HATO,4,244,118,126,16
VERACRUZ DE IGNACIO DE LA LLAVE,30,ACAYUCAN,003,EL NUEVO PRINCIPIO,2,15,6,9,2
VERACRUZ DE IGNACIO DE LA LLAVE,30,ACAYUCAN,003,EL TRIUNFO,1,5,4,1,1
VERACRUZ DE IGNACIO DE LA LLAVE,30,ACAYUCAN,003,EL ZAPOTE,2,23,12,11,2
VERACRUZ DE IGNACIO DE LA LLAVE,30,ACAYUCAN,003,EMILIANO ZAPATA,2,12,6,6,1
VERACRUZ DE IGNACIO DE LA LLAVE,30,ACAYUCAN,003,ESPERANZA MALOTA,4,186,113,73,16
VERACRUZ DE IGNACIO DE LA LLAVE,30,ACAYUCAN,003,FREDEPO,1,24,10,14,2
VERACRUZ DE IGNACIO DE LA LLAVE,30,ACAYUCAN,003,GAVILANES (CIRILO VÁZQUEZ LAGUNES),2,65,32,33,6
VERACRUZ DE IGNACIO DE LA LLAVE,30,ACAYUCAN,003,GRAN BRETAÑA,2,28,15,13,3
VERACRUZ DE IGNACIO DE LA LLAVE,30,ACAYUCAN,003,IXHUAPAN,3,203,101,102,15
VERACRUZ DE IGNACIO DE LA LLAVE,30,ACAYUCAN,003,IXTAGAPA,4,348,159,189,26
VERACRUZ DE IGNACIO DE LA LLAVE,30,ACAYUCAN,003,LA PEÑA,1,18,8,10,1
VERACRUZ DE IGNACIO DE LA LLAVE,30,ACAYUCAN,003,LA SABANA,2,13,7,6,2
VERACRUZ DE IGNACIO DE LA LLAVE,30,ACAYUCAN,003,LA UNIÓN,2,8,1,7,1
VERACRUZ DE IGNACIO DE LA LLAVE,30,ACAYUCAN,003,LAGUNA DE CABEZO,3,15,8,7,3
VERACRUZ DE IGNACIO DE LA LLAVE,30,ACAYUCAN,003,LAS LAGUNAS,3,68,26,42,4
VERACRUZ DE IGNACIO DE LA LLAVE,30,ACAYUCAN,003,LOMA DEL VIDRIO,2,33,24,9,2
VERACRUZ DE IGNACIO DE LA LLAVE,30,ACAYUCAN,003,MICHAPAN,2,23,13,10,2
VERACRUZ DE IGNACIO DE LA LLAVE,30,ACAYUCAN,003,MICHAPAN PASO REAL,3,137,68,69,7
VERACRUZ DE IGNACIO DE LA LLAVE,30,ACAYUCAN,003,MONTE GRANDE,2,62,33,29,4
VERACRUZ DE IGNACIO DE LA LLAVE,30,ACAYUCAN,003,NUEVO POBLADO VISTA HERMOSA,3,118,49,69,6
VERACRUZ DE IGNACIO DE LA LLAVE,30,ACAYUCAN,003,NUEVO QUIAMOLOAPAN,2,44,20,24,3
VERACRUZ DE IGNACIO DE LA LLAVE,30,ACAYUCAN,003,NUEVOS ÓRGANOS (EL MIRADOR),1,13,7,6,1
VERACRUZ DE IGNACIO DE LA LLAVE,30,ACAYUCAN,003,PASO LIMÓN,3,85,35,50,8
VERACRUZ DE IGNACIO DE LA LLAVE,30,ACAYUCAN,003,PITALILLO,4,119,57,62,9
VERACRUZ DE IGNACIO DE LA LLAVE,30,ACAYUCAN,003,QUIAMOLOAPAN,4,237,121,116,19
VERACRUZ DE IGNACIO DE LA LLAVE,30,ACAYUCAN,003,SAN ÁNGEL,1,104,47,57,6
VERACRUZ DE IGNACIO DE LA LLAVE,30,ACAYUCAN,003,SAN BARTOLO,2,13,5,8,3
VERACRUZ DE IGNACIO DE LA LLAVE,30,ACAYUCAN,003,SAN LUIS,2,49,15,34,2
VERACRUZ DE IGNACIO DE LA LLAVE,30,ACAYUCAN,003,SAN MARTÍN,1,57,28,29,4
VERACRUZ DE IGNACIO DE LA LLAVE,30,ACAYUCAN,003,SAN MIGUEL,3,134,54,80,8
VERACRUZ DE IGNACIO DE LA LLAVE,30,ACAYUCAN,003,SANTA RITA LAUREL,4,137,68,69,12
VERACRUZ DE IGNACIO DE LA LLAVE,30,ACAYUCAN,003,TECUANAPA,2,105,47,58,8
VERACRUZ DE IGNACIO DE LA LLAVE,30,ACAYUCAN,003,TIERRA COLORADA,3,134,59,75,8
VERACRUZ DE IGNACIO DE LA LLAVE,30,ACAYUCAN,003,VISTA HERMOSA,2,44,21,23,3
VERACRUZ DE IGNACIO DE LA LLAVE,30,ACAYUCAN,003,XALAPA CALERÍA,2,35,12,23,4
VERACRUZ DE IGNACIO DE LA LLAVE,30,ACTOPAN,004,ACTOPAN,8,1334,669,665,113
VERACRUZ DE IGNACIO DE LA LLAVE,30,ACTOPAN,004,ARROYO DE PIEDRA,2,27,11,16,3
VERACRUZ DE IGNACIO DE LA LLAVE,30,ACTOPAN,004,BALDERAS,1,7,3,4,1
VERACRUZ DE IGNACIO DE LA LLAVE,30,ACTOPAN,004,BOCANITA DE LA ESPERANZA,1,9,4,5,1
VERACRUZ DE IGNACIO DE LA LLAVE,30,ACTOPAN,004,BUENAVISTA,4,168,87,81,12
VERACRUZ DE IGNACIO DE LA LLAVE,30,ACTOPAN,004,BUENOS AIRES,1,18,13,5,2
VERACRUZ DE IGNACIO DE LA LLAVE,30,ACTOPAN,004,CASA DE TEJA,1,11,6,5,1
VERACRUZ DE IGNACIO DE LA LLAVE,30,ACTOPAN,004,CERRO GORDO,3,181,80,101,14
VERACRUZ DE IGNACIO DE LA LLAVE,30,ACTOPAN,004,CHICUASÉN,4,285,140,145,18
VERACRUZ DE IGNACIO DE LA LLAVE,30,ACTOPAN,004,COYOLES,1,14,5,9,1
VERACRUZ DE IGNACIO DE LA LLAVE,30,ACTOPAN,004,COYOLILLO,5,433,214,219,25
VERACRUZ DE IGNACIO DE LA LLAVE,30,ACTOPAN,004,EL APARTADERO,1,12,5,7,1
VERACRUZ DE IGNACIO DE LA LLAVE,30,ACTOPAN,004,EL ESPINAL,1,3,2,1,1
VERACRUZ DE IGNACIO DE LA LLAVE,30,ACTOPAN,004,EL FARALLÓN,4,124,63,61,25
VERACRUZ DE IGNACIO DE LA LLAVE,30,ACTOPAN,004,EL GUARUMBO,2,52,19,33,4
VERACRUZ DE IGNACIO DE LA LLAVE,30,ACTOPAN,004,EL JÍCARO,2,14,8,6,2
VERACRUZ DE IGNACIO DE LA LLAVE,30,ACTOPAN,004,EL OJITAL,2,43,25,18,5
VERACRUZ DE IGNACIO DE LA LLAVE,30,ACTOPAN,004,EL OJITE,1,10,6,4,1
VERACRUZ DE IGNACIO DE LA LLAVE,30,ACTOPAN,004,EL PARAÍSO,2,33,17,16,3
VERACRUZ DE IGNACIO DE LA LLAVE,30,ACTOPAN,004,EL PORVENIR,1,9,6,3,1
VERACRUZ DE IGNACIO DE LA LLAVE,30,ACTOPAN,004,EL VIEJÓN NUEVO,1,31,13,18,2
VERACRUZ DE IGNACIO DE LA LLAVE,30,ACTOPAN,004,EL VIEJÓN VIEJO,2,136,71,65,9
VERACRUZ DE IGNACIO DE LA LLAVE,30,ACTOPAN,004,EL ZETAL,1,7,2,5,1
VERACRUZ DE IGNACIO DE LA LLAVE,30,ACTOPAN,004,FLOR BLANCA,2,60,30,30,5
VERACRUZ DE IGNACIO DE LA LLAVE,30,ACTOPAN,004,HORNITOS,3,146,82,64,11
VERACRUZ DE IGNACIO DE LA LLAVE,30,ACTOPAN,004,LA CAÑA,2,18,10,8,2
VERACRUZ DE IGNACIO DE LA LLAVE,30,ACTOPAN,004,LA ESPERANZA,5,230,117,113,17
VERACRUZ DE IGNACIO DE LA LLAVE,30,ACTOPAN,004,LA LUZ,2,17,9,8,2
VERACRUZ DE IGNACIO DE LA LLAVE,30,ACTOPAN,004,LLANO DE LUNA,1,8,2,6,1
VERACRUZ DE IGNACIO DE LA LLAVE,30,ACTOPAN,004,LLANO DE ZÁRATE,1,9,3,6,1
VERACRUZ DE IGNACIO DE LA LLAVE,30,ACTOPAN,004,LOS BAÑOS,1,4,3,1,1
VERACRUZ DE IGNACIO DE LA LLAVE,30,ACTOPAN,004,LOS FRAILES,2,17,6,11,2
VERACRUZ DE IGNACIO DE LA LLAVE,30,ACTOPAN,004,LOS ÍDOLOS,4,230,117,113,20
VERACRUZ DE IGNACIO DE LA LLAVE,30,ACTOPAN,004,LOS OTATES,4,154,71,83,16
VERACRUZ DE IGNACIO DE LA LLAVE,30,ACTOPAN,004,MATA DE CAÑA,2,6,2,4,1
VERACRUZ DE IGNACIO DE LA LLAVE,30,ACTOPAN,004,MOZOMBOA,4,464,252,212,32
VERACRUZ DE IGNACIO DE LA LLAVE,30,ACTOPAN,004,OMIQUILA,2,20,9,11,3
VERACRUZ DE IGNACIO DE LA LLAVE,30,ACTOPAN,004,PALMAS DE ABAJO,3,120,57,63,11
VERACRUZ DE IGNACIO DE LA LLAVE,30,ACTOPAN,004,PASO DE LA MILPA,3,71,34,37,7
VERACRUZ DE IGNACIO DE LA LLAVE,30,ACTOPAN,004,PASO DE VARAS,2,28,10,18,3
VERACRUZ DE IGNACIO DE LA LLAVE,30,ACTOPAN,004,PASO DEL CEDRO,3,115,56,59,8
VERACRUZ DE IGNACIO DE LA LLAVE,30,ACTOPAN,004,PLAN DE LA HIGUERA (EL TOCHE),3,32,9,23,4
VERACRUZ DE IGNACIO DE LA LLAVE,30,ACTOPAN,004,RANCHITO DE LAS ÁNIMAS,2,79,49,30,6
VERACRUZ DE IGNACIO DE LA LLAVE,30,ACTOPAN,004,SAN ISIDRO,4,273,154,119,18
VERACRUZ DE IGNACIO DE LA LLAVE,30,ACTOPAN,004,SAN JOSÉ PASTORÍAS,2,57,24,33,4
VERACRUZ DE IGNACIO DE LA LLAVE,30,ACTOPAN,004,SAN JUAN VILLA RICA,3,49,21,28,5
VERACRUZ DE IGNACIO DE LA LLAVE,30,ACTOPAN,004,SAN NICOLÁS (SAN NICOLÁS DE TOLENTINO),2,59,25,34,5
VERACRUZ DE IGNACIO DE LA LLAVE,30,ACTOPAN,004,SANTA ROSA (GENERAL PINZÓN),4,287,147,140,21
VERACRUZ DE IGNACIO DE LA LLAVE,30,ACTOPAN,004,SOYACUAUTLA,3,140,73,67,9
VERACRUZ DE IGNACIO DE LA LLAVE,30,ACTOPAN,004,TINAJITAS,4,493,237,256,33
VERACRUZ DE IGNACIO DE LA LLAVE,30,ACTOPAN,004,TOTOLAPAN,3,33,17,16,4
VERACRUZ DE IGNACIO DE LA LLAVE,30,ACTOPAN,004,TRAPICHE DEL ROSARIO,4,381,191,190,22
VERACRUZ DE IGNACIO DE LA LLAVE,30,ACTOPAN,004,VILLA NUEVA,3,57,29,28,6
VERACRUZ DE IGNACIO DE LA LLAVE,30,ACTOPAN,004,VISTA HERMOSA,2,38,22,16,3
VERACRUZ DE IGNACIO DE LA LLAVE,30,ACULA,005,ABREVADERO,1,34,21,13,3
VERACRUZ DE IGNACIO DE LA LLAVE,30,ACULA,005,ACULA,5,653,349,304,33
VERACRUZ DE IGNACIO DE LA LLAVE,30,ACULA,005,ATZIZINTLA,1,19,10,9,2
VERACRUZ DE IGNACIO DE LA LLAVE,30,ACULA,005,CERRO DE LAS FLORES,2,68,36,32,5
VERACRUZ DE IGNACIO DE LA LLAVE,30,ACULA,005,CIÉNEGA DE LOS CABALLOS,1,3,1,2,1
VERACRUZ DE IGNACIO DE LA LLAVE,30,ACULA,005,EL TALLADERO,1,24,11,13,2
VERACRUZ DE IGNACIO DE LA LLAVE,30,ACULA,005,POZA HONDA,4,67,26,41,5
VERACRUZ DE IGNACIO DE LA LLAVE,30,ACULA,005,SAN MIGUEL XÓCHITL (SAN MIGUEL EL SOLDADO),3,68,36,32,7
VERACRUZ DE IGNACIO DE LA LLAVE,30,ACULTZINGO,006,ACATLA,3,269,145,124,15
VERACRUZ DE IGNACIO DE LA LLAVE,30,ACULTZINGO,006,ACULTZINGO,9,1611,808,803,77
VERACRUZ DE IGNACIO DE LA LLAVE,30,ACULTZINGO,006,AGUACHINOLA,2,139,72,67,8
VERACRUZ DE IGNACIO DE LA LLAVE,30,ACULTZINGO,006,ATITLA (BARRIO DE GUADALUPE),1,36,14,22,2
VERACRUZ DE IGNACIO DE LA LLAVE,30,ACULTZINGO,006,BARRIO DE GUADALUPE,3,174,93,81,9
VERACRUZ DE IGNACIO DE LA LLAVE,30,ACULTZINGO,006,COATEPEC DE ARRIBA,4,126,68,58,9
VERACRUZ DE IGNACIO DE LA LLAVE,30,ACULTZINGO,006,COLONIA LA CUESTA,1,10,9,1,1
VERACRUZ DE IGNACIO DE LA LLAVE,30,ACULTZINGO,006,COMUNIDAD LA JAROCHITA,2,12,6,6,2
VERACRUZ DE IGNACIO DE LA LLAVE,30,ACULTZINGO,006,COXOLITLA DE ABAJO,3,483,256,227,21
VERACRUZ DE IGNACIO DE LA LLAVE,30,ACULTZINGO,006,COXOLITLA DE ARRIBA,3,175,92,83,10
VERACRUZ DE IGNACIO DE LA LLAVE,30,ACULTZINGO,006,CUMBRES DE ACULTZINGO,2,24,8,16,2
VERACRUZ DE IGNACIO DE LA LLAVE,30,ACULTZINGO,006,EL AHUITZIQUE,3,33,18,15,3
VERACRUZ DE IGNACIO DE LA LLAVE,30,ACULTZINGO,006,EL POTRERO,3,345,174,171,20
VERACRUZ DE IGNACIO DE LA LLAVE,30,ACULTZINGO,006,EL SUMIDERO,2,13,4,9,2
VERACRUZ DE IGNACIO DE LA LLAVE,30,ACULTZINGO,006,IXTACAHUATLA,2,29,14,15,2
VERACRUZ DE IGNACIO DE LA LLAVE,30,ACULTZINGO,006,LINDA VISTA,2,85,45,40,4
VERACRUZ DE IGNACIO DE LA LLAVE,30,ACULTZINGO,006,MACUALTZINGO,1,20,10,10,1
VERACRUZ DE IGNACIO DE LA LLAVE,30,ACULTZINGO,006,OJO DE AGUA DE ABAJO (LA MESA),2,50,34,16,4
VERACRUZ DE IGNACIO DE LA LLAVE,30,ACULTZINGO,006,OJO DE AGUA DE ARRIBA,2,17,10,7,2
VERACRUZ DE IGNACIO DE LA LLAVE,30,ACULTZINGO,006,PINOTLA,1,13,10,3,1
VERACRUZ DE IGNACIO DE LA LLAVE,30,ACULTZINGO,006,PRÓSPERO PINEDA,2,92,35,57,5
VERACRUZ DE IGNACIO DE LA LLAVE,30,ACULTZINGO,006,PUENTE DE GUADALUPE,2,223,117,106,10
VERACRUZ DE IGNACIO DE LA LLAVE,30,ACULTZINGO,006,PUERTO DEL AIRE,1,4,0,4,1
VERACRUZ DE IGNACIO DE LA LLAVE,30,ACULTZINGO,006,SIERRA DE AGUA,2,73,33,40,4
VERACRUZ DE IGNACIO DE LA LLAVE,30,ACULTZINGO,006,TECAMALUCAN,6,742,351,391,44
VERACRUZ DE IGNACIO DE LA LLAVE,30,ACULTZINGO,006,TLAPEXTITLA,2,43,20,23,3
VERACRUZ DE IGNACIO DE LA LLAVE,30,ACULTZINGO,006,VAQUERÍA,3,81,37,44,6
VERACRUZ DE IGNACIO DE LA LLAVE,30,ACULTZINGO,006,VISTA HERMOSA,4,189,96,93,12
VERACRUZ DE IGNACIO DE LA LLAVE,30,CAMARÓN DE TEJEDA,007,CAMARÓN DE TEJEDA,5,539,277,262,28
VERACRUZ DE IGNACIO DE LA LLAVE,30,CAMARÓN DE TEJEDA,007,CORRAL SAN JUAN,2,21,11,10,2
VERACRUZ DE IGNACIO DE LA LLAVE,30,CAMARÓN DE TEJEDA,007,EL MORAL,3,24,20,4,3
VERACRUZ DE IGNACIO DE LA LLAVE,30,CAMARÓN DE TEJEDA,007,LA JUNTA,2,5,1,4,1
VERACRUZ DE IGNACIO DE LA LLAVE,30,CAMARÓN DE TEJEDA,007,LA MESTIZA,3,121,65,56,9
VERACRUZ DE IGNACIO DE LA LLAVE,30,CAMARÓN DE TEJEDA,007,LA SIRENA,2,11,5,6,2
VERACRUZ DE IGNACIO DE LA LLAVE,30,CAMARÓN DE TEJEDA,007,LOMA PEDREGOSA,1,18,11,7,1
VERACRUZ DE IGNACIO DE LA LLAVE,30,CAMARÓN DE TEJEDA,007,MATA DE AGUA,4,132,61,71,10
VERACRUZ DE IGNACIO DE LA LLAVE,30,CAMARÓN DE TEJEDA,007,PASCUAL (RANCHO NUEVO),2,8,1,7,1
VERACRUZ DE IGNACIO DE LA LLAVE,30,CAMARÓN DE TEJEDA,007,PLAN DE OROS,2,25,13,12,2
VERACRUZ DE IGNACIO DE LA LLAVE,30,CAMARÓN DE TEJEDA,007,RINCÓN DE BARRABÁS,4,259,147,112,14
VERACRUZ DE IGNACIO DE LA LLAVE,30,CAMARÓN DE TEJEDA,007,SAN AGUSTÍN,2,24,10,14,3
VERACRUZ DE IGNACIO DE LA LLAVE,30,CAMARÓN DE TEJEDA,007,SANTEHUAXQUE,1,11,5,6,1
VERACRUZ DE IGNACIO DE LA LLAVE,30,ALPATLÁHUAC,008,ACAPIXTLA,2,14,5,9,2
VERACRUZ DE IGNACIO DE LA LLAVE,30,ALPATLÁHUAC,008,ACOLCO,3,191,100,91,11
VERACRUZ DE IGNACIO DE LA LLAVE,30,ALPATLÁHUAC,008,AGUA DE ORO,3,59,30,29,6
VERACRUZ DE IGNACIO DE LA LLAVE,30,ALPATLÁHUAC,008,ALPATLÁHUAC,4,604,287,317,31
VERACRUZ DE IGNACIO DE LA LLAVE,30,ALPATLÁHUAC,008,ATEOPA,2,73,34,39,4
VERACRUZ DE IGNACIO DE LA LLAVE,30,ALPATLÁHUAC,008,AYAHUALULCO,8,679,347,332,63
VERACRUZ DE IGNACIO DE LA LLAVE,30,ALPATLÁHUAC,008,COCALZINGO,3,151,63,88,8
VERACRUZ DE IGNACIO DE LA LLAVE,30,ALPATLÁHUAC,008,EL ÁGUILA,1,5,2,3,1
VERACRUZ DE IGNACIO DE LA LLAVE,30,ALPATLÁHUAC,008,IXTAQUILITLA (EL RINCÓN),4,180,106,74,12
VERACRUZ DE IGNACIO DE LA LLAVE,30,ALPATLÁHUAC,008,LA VENTANA (LA HUISTLA),3,54,31,23,3
VERACRUZ DE IGNACIO DE LA LLAVE,30,ALPATLÁHUAC,008,LOMA DE BUENOS AIRES,1,9,5,4,1
VERACRUZ DE IGNACIO DE LA LLAVE,30,ALPATLÁHUAC,008,MALACATEPEC,3,147,69,78,9
VERACRUZ DE IGNACIO DE LA LLAVE,30,ALPATLÁHUAC,008,MESA DE BUENAVISTA,2,56,28,28,3
VERACRUZ DE IGNACIO DE LA LLAVE,30,ALPATLÁHUAC,008,NUEVA VIDA,2,49,26,23,3
VERACRUZ DE IGNACIO DE LA LLAVE,30,ALPATLÁHUAC,008,RANCHO ALEGRE,3,48,23,25,5
VERACRUZ DE IGNACIO DE LA LLAVE,30,ALPATLÁHUAC,008,RANCHO NUEVO,1,23,16,7,2
VERACRUZ DE IGNACIO DE LA LLAVE,30,ALPATLÁHUAC,008,SAN JOSÉ TEACALCO,2,78,48,30,4
VERACRUZ DE IGNACIO DE LA LLAVE,30,ALPATLÁHUAC,008,SAN MARTÍN CABALLERO,1,15,7,8,1
VERACRUZ DE IGNACIO DE LA LLAVE,30,ALPATLÁHUAC,008,TEANQUISCO,2,38,19,19,4
VERACRUZ DE IGNACIO DE LA LLAVE,30,ALPATLÁHUAC,008,TECUANAPILLA,4,80,40,40,5
VERACRUZ DE IGNACIO DE LA LLAVE,30,ALPATLÁHUAC,008,TEXOPA,1,5,2,3,2
VERACRUZ DE IGNACIO DE LA LLAVE,30,ALPATLÁHUAC,008,UNIÓN CRUZ VERDE,1,7,2,5,1
VERACRUZ DE IGNACIO DE LA LLAVE,30,ALPATLÁHUAC,008,XICOLA,2,56,28,28,5
VERACRUZ DE IGNACIO DE LA LLAVE,30,ALTO LUCERO DE GUTIÉRREZ BARRIOS,009,ALTAMIRANO,1,20,13,7,2
VERACRUZ DE IGNACIO DE LA LLAVE,30,ALTO LUCERO DE GUTIÉRREZ BARRIOS,009,ALTO DEL TIZAR,3,73,37,36,6
VERACRUZ DE IGNACIO DE LA LLAVE,30,ALTO LUCERO DE GUTIÉRREZ BARRIOS,009,ALTO LUCERO,8,1608,859,749,133
VERACRUZ DE IGNACIO DE LA LLAVE,30,ALTO LUCERO DE GUTIÉRREZ BARRIOS,009,BLANCA ESPUMA,4,250,133,117,17
VERACRUZ DE IGNACIO DE LA LLAVE,30,ALTO LUCERO DE GUTIÉRREZ BARRIOS,009,CERRILLOS DE DÍAZ,3,105,47,58,10
VERACRUZ DE IGNACIO DE LA LLAVE,30,ALTO LUCERO DE GUTIÉRREZ BARRIOS,009,CRUZ BLANCA,2,7,3,4,2
VERACRUZ DE IGNACIO DE LA LLAVE,30,ALTO LUCERO DE GUTIÉRREZ BARRIOS,009,EL ABAZAL,3,70,38,32,7
VERACRUZ DE IGNACIO DE LA LLAVE,30,ALTO LUCERO DE GUTIÉRREZ BARRIOS,009,EL CAFETAL,4,280,145,135,18
VERACRUZ DE IGNACIO DE LA LLAVE,30,ALTO LUCERO DE GUTIÉRREZ BARRIOS,009,EL LIMÓN,1,3,3,0,1
VERACRUZ DE IGNACIO DE LA LLAVE,30,ALTO LUCERO DE GUTIÉRREZ BARRIOS,009,EL MADROÑO,2,16,9,7,2
VERACRUZ DE IGNACIO DE LA LLAVE,30,ALTO LUCERO DE GUTIÉRREZ BARRIOS,009,EL PEDREGAL,3,51,23,28,5
VERACRUZ DE IGNACIO DE LA LLAVE,30,ALTO LUCERO DE GUTIÉRREZ BARRIOS,009,EL RUBÍ,1,20,7,13,1
VERACRUZ DE IGNACIO DE LA LLAVE,30,ALTO LUCERO DE GUTIÉRREZ BARRIOS,009,JACALES,2,28,17,11,3
VERACRUZ DE IGNACIO DE LA LLAVE,30,ALTO LUCERO DE GUTIÉRREZ BARRIOS,009,LA PALMILLA,1,4,2,2,1
VERACRUZ DE IGNACIO DE LA LLAVE,30,ALTO LUCERO DE GUTIÉRREZ BARRIOS,009,LA REFORMA,4,205,97,108,16
VERACRUZ DE IGNACIO DE LA LLAVE,30,ALTO LUCERO DE GUTIÉRREZ BARRIOS,009,MESA DE 24,3,49,23,26,6
VERACRUZ DE IGNACIO DE LA LLAVE,30,ALTO LUCERO DE GUTIÉRREZ BARRIOS,009,MESA DE GUADALUPE,5,696,341,355,43
VERACRUZ DE IGNACIO DE LA LLAVE,30,ALTO LUCERO DE GUTIÉRREZ BARRIOS,009,MESA DE SOMBREROS,1,13,8,5,1
VERACRUZ DE IGNACIO DE LA LLAVE,30,ALTO LUCERO DE GUTIÉRREZ BARRIOS,009,MESA DEL RODEO,2,19,7,12,2
VERACRUZ DE IGNACIO DE LA LLAVE,30,ALTO LUCERO DE GUTIÉRREZ BARRIOS,009,MONTE VERDE,3,168,80,88,12
VERACRUZ DE IGNACIO DE LA LLAVE,30,ALTO LUCERO DE GUTIÉRREZ BARRIOS,009,OJO ZARCO,2,25,11,14,2
VERACRUZ DE IGNACIO DE LA LLAVE,30,ALTO LUCERO DE GUTIÉRREZ BARRIOS,009,PALMA SOLA,9,844,402,442,55
VERACRUZ DE IGNACIO DE LA LLAVE,30,ALTO LUCERO DE GUTIÉRREZ BARRIOS,009,POTRERO ALTO,2,15,11,4,2
VERACRUZ DE IGNACIO DE LA LLAVE,30,ALTO LUCERO DE GUTIÉRREZ BARRIOS,009,PROVIDENCIA,2,52,27,25,3
VERACRUZ DE IGNACIO DE LA LLAVE,30,ALTO LUCERO DE GUTIÉRREZ BARRIOS,009,RANCHO NUEVO,3,90,42,48,7
VERACRUZ DE IGNACIO DE LA LLAVE,30,ALTO LUCERO DE GUTIÉRREZ BARRIOS,009,RINCÓN DE NEGROS,2,7,3,4,1
VERACRUZ DE IGNACIO DE LA LLAVE,30,ALTO LUCERO DE GUTIÉRREZ BARRIOS,009,SABANETAS,3,21,10,11,3
VERACRUZ DE IGNACIO DE LA LLAVE,30,ALTO LUCERO DE GUTIÉRREZ BARRIOS,009,SAN ISIDRO LA PEÑA,2,32,12,20,3
VERACRUZ DE IGNACIO DE LA LLAVE,30,ALTO LUCERO DE GUTIÉRREZ BARRIOS,009,SANTA ANA,4,243,130,113,18
VERACRUZ DE IGNACIO DE LA LLAVE,30,ALTO LUCERO DE GUTIÉRREZ BARRIOS,009,SANTANDER,2,28,18,10,3
VERACRUZ DE IGNACIO DE LA LLAVE,30,ALTO LUCERO DE GUTIÉRREZ BARRIOS,009,TECUÁN,2,5,2,3,1
VERACRUZ DE IGNACIO DE LA LLAVE,30,ALTO LUCERO DE GUTIÉRREZ BARRIOS,009,TIERRA BLANCA,3,96,48,48,8
VERACRUZ DE IGNACIO DE LA LLAVE,30,ALTO LUCERO DE GUTIÉRREZ BARRIOS,009,TOPILITO DE ZARAGOZA,1,20,13,7,2
VERACRUZ DE IGNACIO DE LA LLAVE,30,ALTO LUCERO DE GUTIÉRREZ BARRIOS,009,TOPILTEPEC,2,16,6,10,2
VERACRUZ DE IGNACIO DE LA LLAVE,30,ALTO LUCERO DE GUTIÉRREZ BARRIOS,009,VAINILLAS,1,5,3,2,2
VERACRUZ DE IGNACIO DE LA LLAVE,30,ALTO LUCERO DE GUTIÉRREZ BARRIOS,009,VAQUERÍA,2,31,19,12,3
VERACRUZ DE IGNACIO DE LA LLAVE,30,ALTO LUCERO DE GUTIÉRREZ BARRIOS,009,VILLA CANDELARIA,3,51,22,29,5
VERACRUZ DE IGNACIO DE LA LLAVE,30,ALTO LUCERO DE GUTIÉRREZ BARRIOS,009,XOMOTLA,3,120,67,53,9
VERACRUZ DE IGNACIO DE LA LLAVE,30,ALTOTONGA,010,ADOLFO MORENO,6,555,283,272,29
VERACRUZ DE IGNACIO DE LA LLAVE,30,ALTOTONGA,010,AGUA SANTA,1,4,3,1,1
VERACRUZ DE IGNACIO DE LA LLAVE,30,ALTOTONGA,010,AHUEYAHUALCO,5,664,343,321,33
VERACRUZ DE IGNACIO DE LA LLAVE,30,ALTOTONGA,010,ALSESECA,1,37,20,17,2
VERACRUZ DE IGNACIO DE LA LLAVE,30,ALTOTONGA,010,ALTOTONGA,38,6470,3349,3121,395
VERACRUZ DE IGNACIO DE LA LLAVE,30,ALTOTONGA,010,ARROYO CHICO,1,6,3,3,1
VERACRUZ DE IGNACIO DE LA LLAVE,30,ALTOTONGA,010,BELISARIO DOMÍNGUEZ,3,48,23,25,5
VERACRUZ DE IGNACIO DE LA LLAVE,30,ALTOTONGA,010,BUEN AMIGO,2,5,1,4,1
VERACRUZ DE IGNACIO DE LA LLAVE,30,ALTOTONGA,010,BUENA VISTA,2,91,42,49,6
VERACRUZ DE IGNACIO DE LA LLAVE,30,ALTOTONGA,010,CHAMPILICO,3,228,106,122,11
VERACRUZ DE IGNACIO DE LA LLAVE,30,ALTOTONGA,010,CHICHICAPA,4,248,125,123,16
VERACRUZ DE IGNACIO DE LA LLAVE,30,ALTOTONGA,010,COAHUIXTEPEC,3,76,29,47,6
VERACRUZ DE IGNACIO DE LA LLAVE,30,ALTOTONGA,010,COLONIA 3 DE MAYO,2,29,16,13,3
VERACRUZ DE IGNACIO DE LA LLAVE,30,ALTOTONGA,010,COLONIA EJIDAL GUADALUPE VICTORIA,3,52,25,27,5
VERACRUZ DE IGNACIO DE LA LLAVE,30,ALTOTONGA,010,COMALES,3,28,12,16,3
VERACRUZ DE IGNACIO DE LA LLAVE,30,ALTOTONGA,010,COXOLICO,1,8,4,4,1
VERACRUZ DE IGNACIO DE LA LLAVE,30,ALTOTONGA,010,CRUZ VERDE,1,10,5,5,1
VERACRUZ DE IGNACIO DE LA LLAVE,30,ALTOTONGA,010,DOCTOR DANIEL GUZMÁN,3,78,41,37,6
VERACRUZ DE IGNACIO DE LA LLAVE,30,ALTOTONGA,010,EL PARAÍSO,1,4,1,3,1
VERACRUZ DE IGNACIO DE LA LLAVE,30,ALTOTONGA,010,EL RINCÓN,1,24,17,7,3
VERACRUZ DE IGNACIO DE LA LLAVE,30,ALTOTONGA,010,EL RINCÓN (PRIMERA SECCIÓN),1,18,8,10,1
VERACRUZ DE IGNACIO DE LA LLAVE,30,ALTOTONGA,010,ENCINAL,1,14,7,7,1
VERACRUZ DE IGNACIO DE LA LLAVE,30,ALTOTONGA,010,EQUIMITA,2,10,6,4,1
VERACRUZ DE IGNACIO DE LA LLAVE,30,ALTOTONGA,010,FRANCISCO JAVIER GÓMEZ,3,258,132,126,12
VERACRUZ DE IGNACIO DE LA LLAVE,30,ALTOTONGA,010,GUADALUPE VICTORIA,1,11,6,5,1
VERACRUZ DE IGNACIO DE LA LLAVE,30,ALTOTONGA,010,GUTIÉRREZ ZAMORA,4,498,251,247,27
VERACRUZ DE IGNACIO DE LA LLAVE,30,ALTOTONGA,010,IGNACIO ZARAGOZA PRIMERA SECCIÓN,2,240,122,118,11
VERACRUZ DE IGNACIO DE LA LLAVE,30,ALTOTONGA,010,IGNACIO ZARAGOZA SEGUNDA SECCIÓN,5,326,160,166,20
VERACRUZ DE IGNACIO DE LA LLAVE,30,ALTOTONGA,010,IGNACIO ZARAGOZA TERCERA SECCIÓN,1,92,50,42,6
VERACRUZ DE IGNACIO DE LA LLAVE,30,ALTOTONGA,010,JUAN MARCOS (SAN JOSÉ BUENAVISTA),6,414,212,202,27
VERACRUZ DE IGNACIO DE LA LLAVE,30,ALTOTONGA,010,LA BARRANCA,5,122,63,59,10
VERACRUZ DE IGNACIO DE LA LLAVE,30,ALTOTONGA,010,LA ESTANZUELA,4,258,140,118,14
VERACRUZ DE IGNACIO DE LA LLAVE,30,ALTOTONGA,010,LA PRENSA,3,82,37,45,4
VERACRUZ DE IGNACIO DE LA LLAVE,30,ALTOTONGA,010,LA VEGA (ÚRSULO GALVÁN),3,51,20,31,4
VERACRUZ DE IGNACIO DE LA LLAVE,30,ALTOTONGA,010,LA VENTILLA,3,152,64,88,7
VERACRUZ DE IGNACIO DE LA LLAVE,30,ALTOTONGA,010,LAS TRUCHAS,4,123,65,58,8
VERACRUZ DE IGNACIO DE LA LLAVE,30,ALTOTONGA,010,LERDO CHIQUITO,1,13,8,5,1
VERACRUZ DE IGNACIO DE LA LLAVE,30,ALTOTONGA,010,LERDO DE TEJADA,2,87,44,43,5
VERACRUZ DE IGNACIO DE LA LLAVE,30,ALTOTONGA,010,LIMONCILLO,1,4,1,3,1
VERACRUZ DE IGNACIO DE LA LLAVE,30,ALTOTONGA,010,LIMONTITA,2,61,31,30,3
VERACRUZ DE IGNACIO DE LA LLAVE,30,ALTOTONGA,010,LOS OLMOS (SECCIÓN DOCTOR DANIEL GUZMÁN),3,35,18,17,3
VERACRUZ DE IGNACIO DE LA LLAVE,30,ALTOTONGA,010,MAGUEYITOS,3,123,59,64,10
VERACRUZ DE IGNACIO DE LA LLAVE,30,ALTOTONGA,010,MALACATEPEC,4,114,64,50,8
VERACRUZ DE IGNACIO DE LA LLAVE,30,ALTOTONGA,010,MAZAPA,2,35,21,14,3
VERACRUZ DE IGNACIO DE LA LLAVE,30,ALTOTONGA,010,MECACALCO,4,221,115,106,13
VERACRUZ DE IGNACIO DE LA LLAVE,30,ALTOTONGA,010,MEXCALTECO,3,76,34,42,6
VERACRUZ DE IGNACIO DE LA LLAVE,30,ALTOTONGA,010,PASTOR VERGARA,3,72,33,39,5
VERACRUZ DE IGNACIO DE LA LLAVE,30,ALTOTONGA,010,PAXTEPEC,1,7,5,2,1
VERACRUZ DE IGNACIO DE LA LLAVE,30,ALTOTONGA,010,PLAN DE ARENAS,2,17,8,9,2
VERACRUZ DE IGNACIO DE LA LLAVE,30,ALTOTONGA,010,QUILATE ANTIGUO,5,170,85,85,10
VERACRUZ DE IGNACIO DE LA LLAVE,30,ALTOTONGA,010,QUILATE NUEVO,1,12,6,6,1
VERACRUZ DE IGNACIO DE LA LLAVE,30,ALTOTONGA,010,RANCHO NUEVO,2,19,12,7,2
VERACRUZ DE IGNACIO DE LA LLAVE,30,ALTOTONGA,010,RICARDO FLORES MAGÓN,3,95,57,38,6
VERACRUZ DE IGNACIO DE LA LLAVE,30,ALTOTONGA,010,RÍO VASCO,3,63,34,29,4
VERACRUZ DE IGNACIO DE LA LLAVE,30,ALTOTONGA,010,RÍO VASCO II,1,7,5,2,1
VERACRUZ DE IGNACIO DE LA LLAVE,30,ALTOTONGA,010,SAN FELIPE,2,71,35,36,4
VERACRUZ DE IGNACIO DE LA LLAVE,30,ALTOTONGA,010,SAN JOSÉ BUENAVISTA,6,213,114,99,13
VERACRUZ DE IGNACIO DE LA LLAVE,30,ALTOTONGA,010,SAN JOSÉ TEPOZOTECO,3,221,108,113,11
VERACRUZ DE IGNACIO DE LA LLAVE,30,ALTOTONGA,010,SAN MIGUEL TLALPOALAN,6,512,248,264,29
VERACRUZ DE IGNACIO DE LA LLAVE,30,ALTOTONGA,010,SAN PEDRO TEPOZOTECO,2,97,47,50,4
VERACRUZ DE IGNACIO DE LA LLAVE,30,ALTOTONGA,010,SANTA CRUZ TEPOZOTECO,4,329,149,180,15
VERACRUZ DE IGNACIO DE LA LLAVE,30,ALTOTONGA,010,SANTA ROSA,3,15,4,11,2
VERACRUZ DE IGNACIO DE LA LLAVE,30,ALTOTONGA,010,SECCIÓN PLAN DE LIMÓN,3,34,15,19,4
VERACRUZ DE IGNACIO DE LA LLAVE,30,ALTOTONGA,010,TATEMPA,3,57,30,27,7
VERACRUZ DE IGNACIO DE LA LLAVE,30,ALTOTONGA,010,TEMIMILCO,6,204,123,81,13
VERACRUZ DE IGNACIO DE LA LLAVE,30,ALTOTONGA,010,TEPIOLULCO,3,61,28,33,5
VERACRUZ DE IGNACIO DE LA LLAVE,30,ALTOTONGA,010,TEXACAXCO,2,36,16,20,3
VERACRUZ DE IGNACIO DE LA LLAVE,30,ALTOTONGA,010,TEZAHUAPAN DE JUÁREZ,5,442,214,228,22
VERACRUZ DE IGNACIO DE LA LLAVE,30,ALTOTONGA,010,TIOCUAUTLA,5,136,70,66,9
VERACRUZ DE IGNACIO DE LA LLAVE,30,ALTOTONGA,010,VEGA CHICA,2,17,7,10,2
VERACRUZ DE IGNACIO DE LA LLAVE,30,ALTOTONGA,010,VEGA DE SAN PEDRO,2,32,17,15,3
VERACRUZ DE IGNACIO DE LA LLAVE,30,ALTOTONGA,010,VEINTIUNO DE AGOSTO,3,294,153,141,14
VERACRUZ DE IGNACIO DE LA LLAVE,30,ALTOTONGA,010,XALTEPEC,2,14,8,6,2
VERACRUZ DE IGNACIO DE LA LLAVE,30,ALTOTONGA,010,XOAMPOLCO,3,240,131,109,12
VERACRUZ DE IGNACIO DE LA LLAVE,30,ALTOTONGA,010,XOCOTLA,2,94,49,45,5
VERACRUZ DE IGNACIO DE LA LLAVE,30,ALTOTONGA,010,ZOATZINGO,2,82,44,38,6
VERACRUZ DE IGNACIO DE LA LLAVE,30,ALVARADO,011,ALVARADO,61,8416,4033,4383,792
VERACRUZ DE IGNACIO DE LA LLAVE,30,ALVARADO,011,AMADO NERVO,2,16,8,8,2
VERACRUZ DE IGNACIO DE LA LLAVE,30,ALVARADO,011,ANTÓN LIZARDO,10,2496,927,1569,200
VERACRUZ DE IGNACIO DE LA LLAVE,30,ALVARADO,011,ARBOLILLO,4,166,80,86,18
VERACRUZ DE IGNACIO DE LA LLAVE,30,ALVARADO,011,BASANTA,2,8,2,6,1
VERACRUZ DE IGNACIO DE LA LLAVE,30,ALVARADO,011,BUEN PAÍS,2,31,10,21,2
VERACRUZ DE IGNACIO DE LA LLAVE,30,ALVARADO,011,CALA LARGA,1,9,4,5,1
VERACRUZ DE IGNACIO DE LA LLAVE,30,ALVARADO,011,CAMARONERA,2,35,18,17,3
VERACRUZ DE IGNACIO DE LA LLAVE,30,ALVARADO,011,CHOCOTÁN,1,12,6,6,2
VERACRUZ DE IGNACIO DE LA LLAVE,30,ALVARADO,011,CIÉNEGA DEL SUR,1,5,2,3,1
VERACRUZ DE IGNACIO DE LA LLAVE,30,ALVARADO,011,CONEJO BLANCO (CONEJOS),1,16,8,8,1
VERACRUZ DE IGNACIO DE LA LLAVE,30,ALVARADO,011,CONSTANZA,1,5,1,4,1
VERACRUZ DE IGNACIO DE LA LLAVE,30,ALVARADO,011,COSTA DE LA PALMA,3,105,49,56,7
VERACRUZ DE IGNACIO DE LA LLAVE,30,ALVARADO,011,COSTA DE SAN JUAN,2,11,4,7,1
VERACRUZ DE IGNACIO DE LA LLAVE,30,ALVARADO,011,EL BAYO,3,110,52,58,9
VERACRUZ DE IGNACIO DE LA LLAVE,30,ALVARADO,011,EL CONCHAL,2,51,25,26,6
VERACRUZ DE IGNACIO DE LA LLAVE,30,ALVARADO,011,EL FARO,1,71,34,37,7
VERACRUZ DE IGNACIO DE LA LLAVE,30,ALVARADO,011,EL HATO,2,25,14,11,2
VERACRUZ DE IGNACIO DE LA LLAVE,30,ALVARADO,011,EL NANCHAL,2,28,12,16,3
VERACRUZ DE IGNACIO DE LA LLAVE,30,ALVARADO,011,EL ZAPOTE,5,312,173,139,18
VERACRUZ DE IGNACIO DE LA LLAVE,30,ALVARADO,011,LA AGUADA,2,39,15,24,3
VERACRUZ DE IGNACIO DE LA LLAVE,30,ALVARADO,011,LA BOCA DEL ESTERO,2,4,2,2,1
VERACRUZ DE IGNACIO DE LA LLAVE,30,ALVARADO,011,LA MOJARRA,1,16,3,13,1
VERACRUZ DE IGNACIO DE LA LLAVE,30,ALVARADO,011,LA PALMA,2,17,12,5,2
VERACRUZ DE IGNACIO DE LA LLAVE,30,ALVARADO,011,LA PIEDRA,4,144,62,82,12
VERACRUZ DE IGNACIO DE LA LLAVE,30,ALVARADO,011,LAS BARRANCAS,2,30,19,11,3
VERACRUZ DE IGNACIO DE LA LLAVE,30,ALVARADO,011,LAS ESCOLLERAS,1,37,16,21,4
VERACRUZ DE IGNACIO DE LA LLAVE,30,ALVARADO,011,LOS MÉDANOS DE BUENA VISTA,2,38,22,16,3
VERACRUZ DE IGNACIO DE LA LLAVE,30,ALVARADO,011,LUIS MARTÍNEZ (EL CANAL),2,35,16,19,5
VERACRUZ DE IGNACIO DE LA LLAVE,30,ALVARADO,011,MACUILE,2,15,6,9,2
VERACRUZ DE IGNACIO DE LA LLAVE,30,ALVARADO,011,MANDINGA Y CARDÓN,2,36,17,19,5
VERACRUZ DE IGNACIO DE LA LLAVE,30,ALVARADO,011,MANDINGA Y MATOZA,8,700,349,351,59
VERACRUZ DE IGNACIO DE LA LLAVE,30,ALVARADO,011,MATA DE UVA,3,111,51,60,7
VERACRUZ DE IGNACIO DE LA LLAVE,30,ALVARADO,011,MORAL Y MOSQUITERO,2,32,13,19,3
VERACRUZ DE IGNACIO DE LA LLAVE,30,ALVARADO,011,PASO EL PLATANAR,1,3,0,3,1
VERACRUZ DE IGNACIO DE LA LLAVE,30,ALVARADO,011,PASO NACIONAL,5,353,159,194,34
VERACRUZ DE IGNACIO DE LA LLAVE,30,ALVARADO,011,PASO SALINAS,1,8,1,7,1
VERACRUZ DE IGNACIO DE LA LLAVE,30,ALVARADO,011,PLAYA DE LA LIBERTAD,2,128,61,67,9
VERACRUZ DE IGNACIO DE LA LLAVE,30,ALVARADO,011,PLAZA DE ARMAS,3,23,10,13,3
VERACRUZ DE IGNACIO DE LA LLAVE,30,ALVARADO,011,PUNTA DE ARENAS,1,5,4,1,2
VERACRUZ DE IGNACIO DE LA LLAVE,30,ALVARADO,011,PUNTA GRANDE,2,32,11,21,3
VERACRUZ DE IGNACIO DE LA LLAVE,30,ALVARADO,011,RINCÓN DE LA PALMA,4,99,44,55,9
VERACRUZ DE IGNACIO DE LA LLAVE,30,ALVARADO,011,SALINAS,5,274,136,138,22
VERACRUZ DE IGNACIO DE LA LLAVE,30,AMATITLÁN,012,AMATITLÁN,4,204,100,104,15
VERACRUZ DE IGNACIO DE LA LLAVE,30,AMATITLÁN,012,BOCA DEL RÍO,2,31,14,17,3
VERACRUZ DE IGNACIO DE LA LLAVE,30,AMATITLÁN,012,CHICHIMECO,2,8,5,3,1
VERACRUZ DE IGNACIO DE LA LLAVE,30,AMATITLÁN,012,DOS BOCAS,3,151,67,84,11
VERACRUZ DE IGNACIO DE LA LLAVE,30,AMATITLÁN,012,EL CORTE,5,265,129,136,16
VERACRUZ DE IGNACIO DE LA LLAVE,30,AMATITLÁN,012,EL MULATO,3,98,45,53,7
VERACRUZ DE IGNACIO DE LA LLAVE,30,AMATITLÁN,012,JOBO CHICO (MAGUEY),2,19,10,9,2
VERACRUZ DE IGNACIO DE LA LLAVE,30,AMATITLÁN,012,JUAN DE LA LUZ ENRÍQUEZ (LOS TENATES),2,32,13,19,3
VERACRUZ DE IGNACIO DE LA LLAVE,30,AMATITLÁN,012,LA VUELTA DE ZOPELICAN,2,34,15,19,3
VERACRUZ DE IGNACIO DE LA LLAVE,30,AMATITLÁN,012,LAS PALOMAS,2,27,11,16,4
VERACRUZ DE IGNACIO DE LA LLAVE,30,AMATITLÁN,012,LOS PINOS (BUENA ESPERANZA),1,4,3,1,1
VERACRUZ DE IGNACIO DE LA LLAVE,30,AMATITLÁN,012,RANCHO ALEGRE,2,27,12,15,3
VERACRUZ DE IGNACIO DE LA LLAVE,30,AMATITLÁN,012,RANCHO NUEVO (LOS CERROS),3,123,56,67,9
VERACRUZ DE IGNACIO DE LA LLAVE,30,AMATITLÁN,012,VARAS PRIETAS,2,15,5,10,2
VERACRUZ DE IGNACIO DE LA LLAVE,30,AMATITLÁN,012,ZACAPEXCO,4,92,41,51,9
VERACRUZ DE IGNACIO DE LA LLAVE,30,NARANJOS AMATLÁN,013,AMATLÁN,4,251,131,120,18
VERACRUZ DE IGNACIO DE LA LLAVE,30,NARANJOS AMATLÁN,013,BUENOS AIRES,2,13,6,7,2
VERACRUZ DE IGNACIO DE LA LLAVE,30,NARANJOS AMATLÁN,013,CERVANTES,2,36,20,16,5
VERACRUZ DE IGNACIO DE LA LLAVE,30,NARANJOS AMATLÁN,013,COLONIA EL TRÉBOL,1,8,4,4,1
VERACRUZ DE IGNACIO DE LA LLAVE,30,NARANJOS AMATLÁN,013,EL LLANO (OCAMPO),2,6,1,5,1
VERACRUZ DE IGNACIO DE LA LLAVE,30,NARANJOS AMATLÁN,013,EL OJITAL,1,5,3,2,1
VERACRUZ DE IGNACIO DE LA LLAVE,30,NARANJOS AMATLÁN,013,ESCOBAL,1,14,9,5,1
VERACRUZ DE IGNACIO DE LA LLAVE,30,NARANJOS AMATLÁN,013,GALEANA,3,71,31,40,9
VERACRUZ DE IGNACIO DE LA LLAVE,30,NARANJOS AMATLÁN,013,LA AZTECA,1,3,2,1,1
VERACRUZ DE IGNACIO DE LA LLAVE,30,NARANJOS AMATLÁN,013,LA EMPALIZADA,1,9,3,6,2
VERACRUZ DE IGNACIO DE LA LLAVE,30,NARANJOS AMATLÁN,013,MELCHOR OCAMPO,3,39,16,23,6
VERACRUZ DE IGNACIO DE LA LLAVE,30,NARANJOS AMATLÁN,013,NARANJOS,47,6241,3264,2977,507
VERACRUZ DE IGNACIO DE LA LLAVE,30,NARANJOS AMATLÁN,013,NUEVA ESPERANZA,3,19,6,13,2
VERACRUZ DE IGNACIO DE LA LLAVE,30,NARANJOS AMATLÁN,013,OJO DE BREA,2,12,6,6,2
VERACRUZ DE IGNACIO DE LA LLAVE,30,NARANJOS AMATLÁN,013,RANCHO NUEVO,2,88,43,45,5
VERACRUZ DE IGNACIO DE LA LLAVE,30,NARANJOS AMATLÁN,013,SAN BENITO,1,16,6,10,2
VERACRUZ DE IGNACIO DE LA LLAVE,30,NARANJOS AMATLÁN,013,SOLEDAD CHIQUITA,2,25,11,14,3
VERACRUZ DE IGNACIO DE LA LLAVE,30,NARANJOS AMATLÁN,013,TOTOMOXTEPEC,2,6,4,2,2
VERACRUZ DE IGNACIO DE LA LLAVE,30,NARANJOS AMATLÁN,013,ZARAGOZA,3,48,24,24,7
VERACRUZ DE IGNACIO DE LA LLAVE,30,AMATLÁN DE LOS REYES,014,AMATLÁN DE LOS REYES,8,1703,875,828,91
VERACRUZ DE IGNACIO DE LA LLAVE,30,AMATLÁN DE LOS REYES,014,ATOYAQUILLO,2,52,15,37,4
VERACRUZ DE IGNACIO DE LA LLAVE,30,AMATLÁN DE LOS REYES,014,CACAHUATAL,4,330,165,165,19
VERACRUZ DE IGNACIO DE LA LLAVE,30,AMATLÁN DE LOS REYES,014,CAÑADA BLANCA,3,89,48,41,6
VERACRUZ DE IGNACIO DE LA LLAVE,30,AMATLÁN DE LOS REYES,014,COLONIA EMILIANO ZAPATA,2,75,33,42,4
VERACRUZ DE IGNACIO DE LA LLAVE,30,AMATLÁN DE LOS REYES,014,COLONIA JOSÉ MARÍA MORELOS (SANTA ANA),1,16,5,11,2
VERACRUZ DE IGNACIO DE LA LLAVE,30,AMATLÁN DE LOS REYES,014,COLONIA LA SELVA,2,23,11,12,3
VERACRUZ DE IGNACIO DE LA LLAVE,30,AMATLÁN DE LOS REYES,014,COLONIA LA TOMA,2,44,23,21,3
VERACRUZ DE IGNACIO DE LA LLAVE,30,AMATLÁN DE LOS REYES,014,COLONIA LAS GARDENIAS,2,27,16,11,2
VERACRUZ DE IGNACIO DE LA LLAVE,30,AMATLÁN DE LOS REYES,014,COLONIA SAN FRANCISCO,2,419,204,215,19
VERACRUZ DE IGNACIO DE LA LLAVE,30,AMATLÁN DE LOS REYES,014,CRUZ DE LOS NARANJOS,2,19,6,13,2
VERACRUZ DE IGNACIO DE LA LLAVE,30,AMATLÁN DE LOS REYES,014,EL MORAL,1,6,5,1,1
VERACRUZ DE IGNACIO DE LA LLAVE,30,AMATLÁN DE LOS REYES,014,EL OTATE,4,143,70,73,9
VERACRUZ DE IGNACIO DE LA LLAVE,30,AMATLÁN DE LOS REYES,014,GUADALUPE (LA PATRONA),4,491,237,254,27
VERACRUZ DE IGNACIO DE LA LLAVE,30,AMATLÁN DE LOS REYES,014,IGNACIO ZARAGOZA,1,13,6,7,2
VERACRUZ DE IGNACIO DE LA LLAVE,30,AMATLÁN DE LOS REYES,014,LA LOMA,1,19,9,10,2
VERACRUZ DE IGNACIO DE LA LLAVE,30,AMATLÁN DE LOS REYES,014,LOS ÁNGELES,2,39,20,19,3
VERACRUZ DE IGNACIO DE LA LLAVE,30,AMATLÁN DE LOS REYES,014,MANUEL LEÓN (SAN JOSÉ DE GRACIA),3,278,137,141,20
VERACRUZ DE IGNACIO DE LA LLAVE,30,AMATLÁN DE LOS REYES,014,OJO CHICO,2,116,57,59,6
VERACRUZ DE IGNACIO DE LA LLAVE,30,AMATLÁN DE LOS REYES,014,OJO DE AGUA GRANDE,1,29,14,15,2
VERACRUZ DE IGNACIO DE LA LLAVE,30,AMATLÁN DE LOS REYES,014,OJO DE AGUA GRANDE (CALIFORNIA),3,98,53,45,7
VERACRUZ DE IGNACIO DE LA LLAVE,30,AMATLÁN DE LOS REYES,014,PARADA LA CONCHA,1,33,10,23,2
VERACRUZ DE IGNACIO DE LA LLAVE,30,AMATLÁN DE LOS REYES,014,PARAJE NUEVO,7,736,343,393,43
VERACRUZ DE IGNACIO DE LA LLAVE,30,AMATLÁN DE LOS REYES,014,PEÑUELA,7,1970,936,1034,127
VERACRUZ DE IGNACIO DE LA LLAVE,30,AMATLÁN DE LOS REYES,014,POTRERO VIEJO,5,671,326,345,40
VERACRUZ DE IGNACIO DE LA LLAVE,30,AMATLÁN DE LOS REYES,014,SAN ANTONIO FRATERNIDAD,3,143,63,80,11
VERACRUZ DE IGNACIO DE LA LLAVE,30,AMATLÁN DE LOS REYES,014,SAN PEDRO LA PESCA,2,35,17,18,3
VERACRUZ DE IGNACIO DE LA LLAVE,30,AMATLÁN DE LOS REYES,014,SAN RAFAEL RÍO SECO,3,264,141,123,19
VERACRUZ DE IGNACIO DE LA LLAVE,30,AMATLÁN DE LOS REYES,014,TORRECILLAS,1,48,22,26,4
VERACRUZ DE IGNACIO DE LA LLAVE,30,AMATLÁN DE LOS REYES,014,TRAPICHE VIEJO,2,124,64,60,8
VERACRUZ DE IGNACIO DE LA LLAVE,30,AMATLÁN DE LOS REYES,014,VENTA PARADA,2,40,14,26,3
VERACRUZ DE IGNACIO DE LA LLAVE,30,ANGEL R. CABADA,015,ÁNGEL R. CABADA,18,2186,1089,1097,140
VERACRUZ DE IGNACIO DE LA LLAVE,30,ANGEL R. CABADA,015,ARROYO GRANDE DE ABAJO,1,3,1,2,1
VERACRUZ DE IGNACIO DE LA LLAVE,30,ANGEL R. CABADA,015,ARROYO GRANDE DE ARRIBA (COLONIA FRANCISCO I. MADERO),2,52,20,32,3
VERACRUZ DE IGNACIO DE LA LLAVE,30,ANGEL R. CABADA,015,BRAZO DE LA PALMA (EL RINCÓN CALIENTE),4,126,55,71,10
VERACRUZ DE IGNACIO DE LA LLAVE,30,ANGEL R. CABADA,015,CAÑA AMARILLA,1,4,3,1,1
VERACRUZ DE IGNACIO DE LA LLAVE,30,ANGEL R. CABADA,015,CERRO PRIETO,1,16,10,6,1
VERACRUZ DE IGNACIO DE LA LLAVE,30,ANGEL R. CABADA,015,CHIMALPAY,2,37,13,24,3
VERACRUZ DE IGNACIO DE LA LLAVE,30,ANGEL R. CABADA,015,CHONEGAL,3,158,76,82,10
VERACRUZ DE IGNACIO DE LA LLAVE,30,ANGEL R. CABADA,015,EL ESCOBILLAL,2,79,36,43,5
VERACRUZ DE IGNACIO DE LA LLAVE,30,ANGEL R. CABADA,015,EL JOBO,2,3,3,0,2
VERACRUZ DE IGNACIO DE LA LLAVE,30,ANGEL R. CABADA,015,EL PANATLÁN,2,55,29,26,4
VERACRUZ DE IGNACIO DE LA LLAVE,30,ANGEL R. CABADA,015,EL PARAÍSO,1,20,7,13,1
VERACRUZ DE IGNACIO DE LA LLAVE,30,ANGEL R. CABADA,015,EL PORVENIR,4,185,100,85,18
VERACRUZ DE IGNACIO DE LA LLAVE,30,ANGEL R. CABADA,015,EL PROGRESO MAJAHUAL,3,74,32,42,7
VERACRUZ DE IGNACIO DE LA LLAVE,30,ANGEL R. CABADA,015,EL SALTILLO CARACOLAR,2,30,13,17,3
VERACRUZ DE IGNACIO DE LA LLAVE,30,ANGEL R. CABADA,015,FRACCIONAMIENTO LOS IDOLOS,2,16,8,8,2
VERACRUZ DE IGNACIO DE LA LLAVE,30,ANGEL R. CABADA,015,IXHUAPAN,2,24,14,10,3
VERACRUZ DE IGNACIO DE LA LLAVE,30,ANGEL R. CABADA,015,LA ESPERANZA,1,52,20,32,4
VERACRUZ DE IGNACIO DE LA LLAVE,30,ANGEL R. CABADA,015,LA FLORIDA,3,87,42,45,10
VERACRUZ DE IGNACIO DE LA LLAVE,30,ANGEL R. CABADA,015,LA GLORIA,1,3,1,2,1
VERACRUZ DE IGNACIO DE LA LLAVE,30,ANGEL R. CABADA,015,LA MOJARRA,2,29,10,19,3
VERACRUZ DE IGNACIO DE LA LLAVE,30,ANGEL R. CABADA,015,LA PERLA DE MICHAPAN,2,26,14,12,2
VERACRUZ DE IGNACIO DE LA LLAVE,30,ANGEL R. CABADA,015,LA PROVIDENCIA,2,69,30,39,4
VERACRUZ DE IGNACIO DE LA LLAVE,30,ANGEL R. CABADA,015,LA PUNTILLA,2,10,5,5,2
VERACRUZ DE IGNACIO DE LA LLAVE,30,ANGEL R. CABADA,015,LA ZAMARIA,1,17,9,8,2
VERACRUZ DE IGNACIO DE LA LLAVE,30,ANGEL R. CABADA,015,LAGUNA COLORADA (ANEXO A LOS LIRIOS),1,11,6,5,1
VERACRUZ DE IGNACIO DE LA LLAVE,30,ANGEL R. CABADA,015,LAGUNA COLORADA (ANEXO PLAN DE LOS NARANJOS),1,16,8,8,2
VERACRUZ DE IGNACIO DE LA LLAVE,30,ANGEL R. CABADA,015,LAGUNA DE MAJAHUAL (RÍO DE CAÑAS),3,95,53,42,7
VERACRUZ DE IGNACIO DE LA LLAVE,30,ANGEL R. CABADA,015,LAGUNA DEL MARQUEZ,2,18,9,9,2
VERACRUZ DE IGNACIO DE LA LLAVE,30,ANGEL R. CABADA,015,LAGUNA VERDE (LA ESPERANZA),2,25,14,11,3
VERACRUZ DE IGNACIO DE LA LLAVE,30,ANGEL R. CABADA,015,LOS LIRIOS,6,191,96,95,12
VERACRUZ DE IGNACIO DE LA LLAVE,30,ANGEL R. CABADA,015,LOS PLANES,1,6,2,4,1
VERACRUZ DE IGNACIO DE LA LLAVE,30,ANGEL R. CABADA,015,PASO DEL INGENIO,3,96,53,43,7
VERACRUZ DE IGNACIO DE LA LLAVE,30,ANGEL R. CABADA,015,PLAN DE LOS NARANJOS,5,109,51,58,13
VERACRUZ DE IGNACIO DE LA LLAVE,30,ANGEL R. CABADA,015,SAN JUAN DE LOS REYES (LUIS VALENZUELA),4,425,203,222,26
VERACRUZ DE IGNACIO DE LA LLAVE,30,ANGEL R. CABADA,015,SUCHAPAN,2,6,3,3,1
VERACRUZ DE IGNACIO DE LA LLAVE,30,ANGEL R. CABADA,015,TECOLAPAN,4,418,205,213,28
VERACRUZ DE IGNACIO DE LA LLAVE,30,ANGEL R. CABADA,015,TULA,4,175,83,92,17
VERACRUZ DE IGNACIO DE LA LLAVE,30,ANGEL R. CABADA,015,TULAPILLA (EJIDO TULAPILLA),1,12,5,7,1
VERACRUZ DE IGNACIO DE LA LLAVE,30,ANGEL R. CABADA,015,ZANJA GRANDE DE ABAJO,1,5,2,3,1
VERACRUZ DE IGNACIO DE LA LLAVE,30,LA ANTIGUA,016,EL HATILLO,2,79,40,39,7
VERACRUZ DE IGNACIO DE LA LLAVE,30,LA ANTIGUA,016,JOSÉ CARDEL,46,5703,2978,2725,467
VERACRUZ DE IGNACIO DE LA LLAVE,30,LA ANTIGUA,016,JOSÉ INGENIEROS (SAN VICENTE),2,26,15,11,3
VERACRUZ DE IGNACIO DE LA LLAVE,30,LA ANTIGUA,016,LA ANTIGUA,3,104,55,49,9
VERACRUZ DE IGNACIO DE LA LLAVE,30,LA ANTIGUA,016,LA POSTA,1,17,8,9,3
VERACRUZ DE IGNACIO DE LA LLAVE,30,LA ANTIGUA,016,LA PUREZA,4,222,106,116,13
VERACRUZ DE IGNACIO DE LA LLAVE,30,LA ANTIGUA,016,LOMA IGUANA,2,34,12,22,2
VERACRUZ DE IGNACIO DE LA LLAVE,30,LA ANTIGUA,016,NICOLÁS BLANCO (SAN PANCHO),3,233,111,122,14
VERACRUZ DE IGNACIO DE LA LLAVE,30,LA ANTIGUA,016,PLAYA ORIENTE,1,20,12,8,2
VERACRUZ DE IGNACIO DE LA LLAVE,30,LA ANTIGUA,016,SALMORAL,4,560,271,289,36
VERACRUZ DE IGNACIO DE LA LLAVE,30,APAZAPAN,017,AGUA CALIENTE,4,169,77,92,16
VERACRUZ DE IGNACIO DE LA LLAVE,30,APAZAPAN,017,APAZAPAN,4,146,85,61,12
VERACRUZ DE IGNACIO DE LA LLAVE,30,APAZAPAN,017,CERRO COLORADO (ESTACIÓN APAZAPÁN),3,168,73,95,11
VERACRUZ DE IGNACIO DE LA LLAVE,30,APAZAPAN,017,CHAHUAPAN,3,185,100,85,11
VERACRUZ DE IGNACIO DE LA LLAVE,30,APAZAPAN,017,NUEVO AMELCO,2,56,30,26,5
VERACRUZ DE IGNACIO DE LA LLAVE,30,APAZAPAN,017,TIGRILLOS,3,87,39,48,9
VERACRUZ DE IGNACIO DE LA LLAVE,30,AQUILA,018,AQUILA,3,179,85,94,10
VERACRUZ DE IGNACIO DE LA LLAVE,30,AQUILA,018,ATIOPA,4,114,63,51,6
VERACRUZ DE IGNACIO DE LA LLAVE,30,AQUILA,018,CUMBRES DE AQUILA,3,146,82,64,7
VERACRUZ DE IGNACIO DE LA LLAVE,30,AQUILA,018,LA LAGUNILLA,2,27,16,11,3
VERACRUZ DE IGNACIO DE LA LLAVE,30,AQUILA,018,TEBERNAL,1,11,5,6,1
VERACRUZ DE IGNACIO DE LA LLAVE,30,ASTACINGA,019,ACATITLA,3,176,77,99,11
VERACRUZ DE IGNACIO DE LA LLAVE,30,ASTACINGA,019,ACUAYUCAN,3,210,99,111,13
VERACRUZ DE IGNACIO DE LA LLAVE,30,ASTACINGA,019,ASTACINGA,4,560,284,276,26
VERACRUZ DE IGNACIO DE LA LLAVE,30,ASTACINGA,019,BUENA VISTA,2,152,85,67,8
VERACRUZ DE IGNACIO DE LA LLAVE,30,ASTACINGA,019,CHOAPA,2,37,20,17,4
VERACRUZ DE IGNACIO DE LA LLAVE,30,ASTACINGA,019,COMOLICA,2,76,41,35,5
VERACRUZ DE IGNACIO DE LA LLAVE,30,ASTACINGA,019,CUATIPANCA,2,110,58,52,5
VERACRUZ DE IGNACIO DE LA LLAVE,30,ASTACINGA,019,CUAUHTLA,2,83,41,42,4
VERACRUZ DE IGNACIO DE LA LLAVE,30,ASTACINGA,019,CUAUHTZOYUCA,2,26,17,9,2
VERACRUZ DE IGNACIO DE LA LLAVE,30,ASTACINGA,019,HUAPANGO,2,87,38,49,3
VERACRUZ DE IGNACIO DE LA LLAVE,30,ASTACINGA,019,MEXCALTITLA,2,46,29,17,2
VERACRUZ DE IGNACIO DE LA LLAVE,30,ASTACINGA,019,MOYOAPAN,2,58,26,32,4
VERACRUZ DE IGNACIO DE LA LLAVE,30,ASTACINGA,019,TECPANTZACUALCO,2,17,7,10,2
VERACRUZ DE IGNACIO DE LA LLAVE,30,ASTACINGA,019,TEPANTLA,3,167,80,87,10
VERACRUZ DE IGNACIO DE LA LLAVE,30,ASTACINGA,019,TEPEPA,2,26,18,8,3
VERACRUZ DE IGNACIO DE LA LLAVE,30,ASTACINGA,019,XAYACATEPEC,2,39,23,16,3
VERACRUZ DE IGNACIO DE LA LLAVE,30,ATLAHUILCO,020,ABALOMA CUAUTLA,2,45,21,24,3
VERACRUZ DE IGNACIO DE LA LLAVE,30,ATLAHUILCO,020,ACULTZINAPA (SAN MIGUELITO),3,289,138,151,14
VERACRUZ DE IGNACIO DE LA LLAVE,30,ATLAHUILCO,020,AMEYALA,1,22,6,16,2
VERACRUZ DE IGNACIO DE LA LLAVE,30,ATLAHUILCO,020,ATETECOCHCO,2,41,17,24,3
VERACRUZ DE IGNACIO DE LA LLAVE,30,ATLAHUILCO,020,ATEZOC,2,19,12,7,3
VERACRUZ DE IGNACIO DE LA LLAVE,30,ATLAHUILCO,020,ATLAHUILAPA,2,90,38,52,5
VERACRUZ DE IGNACIO DE LA LLAVE,30,ATLAHUILCO,020,ATLAHUILCO,4,360,196,164,18
VERACRUZ DE IGNACIO DE LA LLAVE,30,ATLAHUILCO,020,ATLEHUAYA,2,68,37,31,3
VERACRUZ DE IGNACIO DE LA LLAVE,30,ATLAHUILCO,020,CAPULTITLA EYITEPEC,3,29,16,13,3
VERACRUZ DE IGNACIO DE LA LLAVE,30,ATLAHUILCO,020,CUAUTLAMANCA,2,52,20,32,3
VERACRUZ DE IGNACIO DE LA LLAVE,30,ATLAHUILCO,020,EL RINCÓN,3,115,67,48,6
VERACRUZ DE IGNACIO DE LA LLAVE,30,ATLAHUILCO,020,LOMA BUENA VISTA,2,54,24,30,4
VERACRUZ DE IGNACIO DE LA LLAVE,30,ATLAHUILCO,020,LOMA HOTEMPA,3,63,33,30,6
VERACRUZ DE IGNACIO DE LA LLAVE,30,ATLAHUILCO,020,LOMA LINDA,1,15,10,5,1
VERACRUZ DE IGNACIO DE LA LLAVE,30,ATLAHUILCO,020,LOMA LOS PINOS,2,18,9,9,2
VERACRUZ DE IGNACIO DE LA LLAVE,30,ATLAHUILCO,020,LOS PINOS,2,72,37,35,4
VERACRUZ DE IGNACIO DE LA LLAVE,30,ATLAHUILCO,020,MACUILQUILA,2,56,25,31,3
VERACRUZ DE IGNACIO DE LA LLAVE,30,ATLAHUILCO,020,OCOTLAJAPA,3,24,12,12,3
VERACRUZ DE IGNACIO DE LA LLAVE,30,ATLAHUILCO,020,OCOTLAMANCA,2,30,16,14,3
VERACRUZ DE IGNACIO DE LA LLAVE,30,ATLAHUILCO,020,QUECHULINGO,3,93,54,39,7
VERACRUZ DE IGNACIO DE LA LLAVE,30,ATLAHUILCO,020,RINCÓN DE TEPEXITITLA,3,45,27,18,3
VERACRUZ DE IGNACIO DE LA LLAVE,30,ATLAHUILCO,020,TAMBOLA (TAMPOLA),2,24,11,13,2
VERACRUZ DE IGNACIO DE LA LLAVE,30,ATLAHUILCO,020,TEPEXITITLA,2,32,17,15,3
VERACRUZ DE IGNACIO DE LA LLAVE,30,ATLAHUILCO,020,TERRERO,3,165,78,87,7
VERACRUZ DE IGNACIO DE LA LLAVE,30,ATLAHUILCO,020,TICONCA,2,61,27,34,3
VERACRUZ DE IGNACIO DE LA LLAVE,30,ATLAHUILCO,020,TLAXCANTITLA,2,78,36,42,4
VERACRUZ DE IGNACIO DE LA LLAVE,30,ATLAHUILCO,020,TLAXITLA,1,3,1,2,1
VERACRUZ DE IGNACIO DE LA LLAVE,30,ATLAHUILCO,020,UITZIQUIAPA,2,53,24,29,3
VERACRUZ DE IGNACIO DE LA LLAVE,30,ATLAHUILCO,020,VISTA HERMOSA,3,228,108,120,16
VERACRUZ DE IGNACIO DE LA LLAVE,30,ATLAHUILCO,020,XIBTLA,2,94,48,46,8
VERACRUZ DE IGNACIO DE LA LLAVE,30,ATLAHUILCO,020,XOCHITEPEC,2,21,7,14,2
VERACRUZ DE IGNACIO DE LA LLAVE,30,ATLAHUILCO,020,ZACAMILOLA,5,278,156,122,17
VERACRUZ DE IGNACIO DE LA LLAVE,30,ATLAHUILCO,020,ZACATLA (TLALTOLOMPA),3,52,25,27,4
VERACRUZ DE IGNACIO DE LA LLAVE,30,ATLAHUILCO,020,ZACATLAMANCA,3,80,46,34,7
VERACRUZ DE IGNACIO DE LA LLAVE,30,ATLAHUILCO,020,ZIHUATEO,2,60,28,32,3
VERACRUZ DE IGNACIO DE LA LLAVE,30,ATOYAC,021,ALTA LUZ,2,4,2,2,2
VERACRUZ DE IGNACIO DE LA LLAVE,30,ATOYAC,021,ARROYO HONDO,2,17,8,9,2
VERACRUZ DE IGNACIO DE LA LLAVE,30,ATOYAC,021,ATOYAC,5,546,274,272,27
VERACRUZ DE IGNACIO DE LA LLAVE,30,ATOYAC,021,BOCA DEL MONTE,1,11,4,7,1
VERACRUZ DE IGNACIO DE LA LLAVE,30,ATOYAC,021,BUENOS AIRES,1,12,10,2,1
VERACRUZ DE IGNACIO DE LA LLAVE,30,ATOYAC,021,CABALLO BLANCO,3,38,24,14,3
VERACRUZ DE IGNACIO DE LA LLAVE,30,ATOYAC,021,COLONIA AGRÍCOLA TLACORANCHO,2,12,5,7,1
VERACRUZ DE IGNACIO DE LA LLAVE,30,ATOYAC,021,COLONIA GUADALUPE,1,5,2,3,1
VERACRUZ DE IGNACIO DE LA LLAVE,30,ATOYAC,021,CORRAL DE PIEDRA,2,134,61,73,8
VERACRUZ DE IGNACIO DE LA LLAVE,30,ATOYAC,021,EJIDO TLACORANCHO,1,4,1,3,1
VERACRUZ DE IGNACIO DE LA LLAVE,30,ATOYAC,021,EL ÁGUILA,1,39,21,18,2
VERACRUZ DE IGNACIO DE LA LLAVE,30,ATOYAC,021,EL ALBIÓN,1,15,9,6,1
VERACRUZ DE IGNACIO DE LA LLAVE,30,ATOYAC,021,EL MIRADOR,2,48,30,18,3
VERACRUZ DE IGNACIO DE LA LLAVE,30,ATOYAC,021,EL ZAPOTE,1,32,12,20,2
VERACRUZ DE IGNACIO DE LA LLAVE,30,ATOYAC,021,ENTRADA A CABALLO BLANCO (EL TÚNEL),2,12,4,8,2
VERACRUZ DE IGNACIO DE LA LLAVE,30,ATOYAC,021,GENERAL MIGUEL ALEMÁN (POTRERO NUEVO),16,2437,1182,1255,209
VERACRUZ DE IGNACIO DE LA LLAVE,30,ATOYAC,021,LA ANGOSTURA,1,20,9,11,1
VERACRUZ DE IGNACIO DE LA LLAVE,30,ATOYAC,021,LA AURORA,1,11,3,8,1
VERACRUZ DE IGNACIO DE LA LLAVE,30,ATOYAC,021,LA CHARCA,3,112,59,53,7
VERACRUZ DE IGNACIO DE LA LLAVE,30,ATOYAC,021,LA ESPERANZA,3,21,10,11,3
VERACRUZ DE IGNACIO DE LA LLAVE,30,ATOYAC,021,MANZANILLO,4,178,101,77,7
VERACRUZ DE IGNACIO DE LA LLAVE,30,ATOYAC,021,MIRAFLORES,2,38,19,19,2
VERACRUZ DE IGNACIO DE LA LLAVE,30,ATOYAC,021,PROGRESO,3,114,53,61,7
VERACRUZ DE IGNACIO DE LA LLAVE,30,ATOYAC,021,RANCHO MARÍA,2,15,7,8,2
VERACRUZ DE IGNACIO DE LA LLAVE,30,ATZACAN,022,ATZACAN,9,1839,938,901,87
VERACRUZ DE IGNACIO DE LA LLAVE,30,ATZACAN,022,CAPIZAYO,3,139,62,77,7
VERACRUZ DE IGNACIO DE LA LLAVE,30,ATZACAN,022,CONTLA,3,177,94,83,9
VERACRUZ DE IGNACIO DE LA LLAVE,30,ATZACAN,022,DOS RÍOS (TOCUILA),5,1108,548,560,53
VERACRUZ DE IGNACIO DE LA LLAVE,30,ATZACAN,022,HUACAPAN,2,50,23,27,3
VERACRUZ DE IGNACIO DE LA LLAVE,30,ATZACAN,022,LA SIDRA,3,400,193,207,19
VERACRUZ DE IGNACIO DE LA LLAVE,30,ATZACAN,022,LÁZARO CÁRDENAS,2,22,13,9,2
VERACRUZ DE IGNACIO DE LA LLAVE,30,ATZACAN,022,MATLALAPA,3,79,36,43,6
VERACRUZ DE IGNACIO DE LA LLAVE,30,ATZACAN,022,REVOLUCIÓN,3,73,35,38,7
VERACRUZ DE IGNACIO DE LA LLAVE,30,ATZACAN,022,RINCÓN GRANDE,3,198,103,95,13
VERACRUZ DE IGNACIO DE LA LLAVE,30,ATZACAN,022,ROSA BLANCA,2,37,18,19,3
VERACRUZ DE IGNACIO DE LA LLAVE,30,ATZACAN,022,SAN JOSÉ,3,60,27,33,4
VERACRUZ DE IGNACIO DE LA LLAVE,30,ATZALAN,023,AGUILERA,1,5,2,3,1
VERACRUZ DE IGNACIO DE LA LLAVE,30,ATZALAN,023,AHUATENO,3,94,37,57,7
VERACRUZ DE IGNACIO DE LA LLAVE,30,ATZALAN,023,AHUATEPEC,3,128,56,72,7
VERACRUZ DE IGNACIO DE LA LLAVE,30,ATZALAN,023,ALMANZA,4,200,99,101,14
VERACRUZ DE IGNACIO DE LA LLAVE,30,ATZALAN,023,ALSESECA EL CHICO,2,17,7,10,3
VERACRUZ DE IGNACIO DE LA LLAVE,30,ATZALAN,023,ALSESECA EL GRANDE,2,36,16,20,4
VERACRUZ DE IGNACIO DE LA LLAVE,30,ATZALAN,023,ARROYO COLORADO,3,94,37,57,8
VERACRUZ DE IGNACIO DE LA LLAVE,30,ATZALAN,023,ATENCO,2,39,14,25,3
VERACRUZ DE IGNACIO DE LA LLAVE,30,ATZALAN,023,ATZALAN,7,762,371,391,50
VERACRUZ DE IGNACIO DE LA LLAVE,30,ATZALAN,023,AZOTILLO,2,42,26,16,3
VERACRUZ DE IGNACIO DE LA LLAVE,30,ATZALAN,023,BARRANCONES,4,106,54,52,8
VERACRUZ DE IGNACIO DE LA LLAVE,30,ATZALAN,023,BERNAVÉS,2,9,3,6,3
VERACRUZ DE IGNACIO DE LA LLAVE,30,ATZALAN,023,BUENA VISTA,5,335,158,177,20
VERACRUZ DE IGNACIO DE LA LLAVE,30,ATZALAN,023,BUENOS AIRES,1,2,1,1,1
VERACRUZ DE IGNACIO DE LA LLAVE,30,ATZALAN,023,CERRO DE BARRERAS,3,38,20,18,4
VERACRUZ DE IGNACIO DE LA LLAVE,30,ATZALAN,023,CERRO DE SAN FRANCISCO,1,13,4,9,1
VERACRUZ DE IGNACIO DE LA LLAVE,30,ATZALAN,023,CERRO DEL CANDELERO (HUIPANGUILLO),2,26,15,11,2
VERACRUZ DE IGNACIO DE LA LLAVE,30,ATZALAN,023,CHACHALACA,3,74,41,33,6
VERACRUZ DE IGNACIO DE LA LLAVE,30,ATZALAN,023,CHAPARRO GRANDE,3,60,26,34,4
VERACRUZ DE IGNACIO DE LA LLAVE,30,ATZALAN,023,CHILACAYOTE,2,13,5,8,2
VERACRUZ DE IGNACIO DE LA LLAVE,30,ATZALAN,023,COCHOTA,2,31,11,20,3
VERACRUZ DE IGNACIO DE LA LLAVE,30,ATZALAN,023,COLONIA JOSÉ PREZA,2,16,6,10,1
VERACRUZ DE IGNACIO DE LA LLAVE,30,ATZALAN,023,COPALILLO I,5,105,48,57,9
VERACRUZ DE IGNACIO DE LA LLAVE,30,ATZALAN,023,CORONILLO,2,18,9,9,2
VERACRUZ DE IGNACIO DE LA LLAVE,30,ATZALAN,023,COYOMICO,1,14,5,9,1
VERACRUZ DE IGNACIO DE LA LLAVE,30,ATZALAN,023,CRUZ GORDA,1,5,1,4,1
VERACRUZ DE IGNACIO DE LA LLAVE,30,ATZALAN,023,CUATRO CAMINOS,1,34,17,17,3
VERACRUZ DE IGNACIO DE LA LLAVE,30,ATZALAN,023,CUAUHTÉMOC,2,57,20,37,6
VERACRUZ DE IGNACIO DE LA LLAVE,30,ATZALAN,023,CUAUZAPOTITÁN,4,260,123,137,14
VERACRUZ DE IGNACIO DE LA LLAVE,30,ATZALAN,023,CUEVA SANTA,3,120,53,67,7
VERACRUZ DE IGNACIO DE LA LLAVE,30,ATZALAN,023,EL ANAYAL,1,9,6,3,1
VERACRUZ DE IGNACIO DE LA LLAVE,30,ATZALAN,023,EL ARENAL,1,12,7,5,1
VERACRUZ DE IGNACIO DE LA LLAVE,30,ATZALAN,023,EL AZOTAL,4,200,93,107,12
VERACRUZ DE IGNACIO DE LA LLAVE,30,ATZALAN,023,EL CAMPAMENTO,4,311,168,143,15
VERACRUZ DE IGNACIO DE LA LLAVE,30,ATZALAN,023,EL EQUIMITE,1,9,3,6,1
VERACRUZ DE IGNACIO DE LA LLAVE,30,ATZALAN,023,EL FORTÍN,2,22,10,12,3
VERACRUZ DE IGNACIO DE LA LLAVE,30,ATZALAN,023,EL OLMO,2,22,10,12,2
VERACRUZ DE IGNACIO DE LA LLAVE,30,ATZALAN,023,EL OLVIDO,2,34,18,16,3
VERACRUZ DE IGNACIO DE LA LLAVE,30,ATZALAN,023,EL PIMIENTO,3,27,17,10,6
VERACRUZ DE IGNACIO DE LA LLAVE,30,ATZALAN,023,EL POZÓN,1,6,4,2,1
VERACRUZ DE IGNACIO DE LA LLAVE,30,ATZALAN,023,EL PROGRESO,3,92,37,55,6
VERACRUZ DE IGNACIO DE LA LLAVE,30,ATZALAN,023,EL RINCÓN,1,9,4,5,1
VERACRUZ DE IGNACIO DE LA LLAVE,30,ATZALAN,023,EL RODEO,3,17,10,7,3
VERACRUZ DE IGNACIO DE LA LLAVE,30,ATZALAN,023,EL TACONAZO,2,18,5,13,2
VERACRUZ DE IGNACIO DE LA LLAVE,30,ATZALAN,023,EL TESORO,2,37,12,25,3
VERACRUZ DE IGNACIO DE LA LLAVE,30,ATZALAN,023,EL ZAPOTE,3,49,27,22,5
VERACRUZ DE IGNACIO DE LA LLAVE,30,ATZALAN,023,HUATAMIMILO,1,13,9,4,1
VERACRUZ DE IGNACIO DE LA LLAVE,30,ATZALAN,023,ICTZICTIC,4,188,94,94,11
VERACRUZ DE IGNACIO DE LA LLAVE,30,ATZALAN,023,INDEPENDENCIA,2,39,19,20,3
VERACRUZ DE IGNACIO DE LA LLAVE,30,ATZALAN,023,IXTATAHUÍA,2,22,8,14,2
VERACRUZ DE IGNACIO DE LA LLAVE,30,ATZALAN,023,JAVIER ROJO GÓMEZ (NOVARA),3,75,34,41,8
VERACRUZ DE IGNACIO DE LA LLAVE,30,ATZALAN,023,LA CASCADA,1,17,5,12,2
VERACRUZ DE IGNACIO DE LA LLAVE,30,ATZALAN,023,LA CHIVERÍA,2,18,8,10,2
VERACRUZ DE IGNACIO DE LA LLAVE,30,ATZALAN,023,LA CUADRADA,2,6,3,3,1
VERACRUZ DE IGNACIO DE LA LLAVE,30,ATZALAN,023,LA ESPERANZA,1,14,7,7,1
VERACRUZ DE IGNACIO DE LA LLAVE,30,ATZALAN,023,LA FLORIDA,2,59,28,31,6
VERACRUZ DE IGNACIO DE LA LLAVE,30,ATZALAN,023,LA LOMA,1,7,4,3,1
VERACRUZ DE IGNACIO DE LA LLAVE,30,ATZALAN,023,LA NORIA (ARRIERAL),3,94,42,52,7
VERACRUZ DE IGNACIO DE LA LLAVE,30,ATZALAN,023,LA PALMA,5,89,45,44,8
VERACRUZ DE IGNACIO DE LA LLAVE,30,ATZALAN,023,LA REFORMA,2,24,12,12,3
VERACRUZ DE IGNACIO DE LA LLAVE,30,ATZALAN,023,LAGARTOS,1,17,8,9,1
VERACRUZ DE IGNACIO DE LA LLAVE,30,ATZALAN,023,LOMA BONITA,2,26,9,17,3
VERACRUZ DE IGNACIO DE LA LLAVE,30,ATZALAN,023,LOMA DE LAS FLORES,1,12,2,10,1
VERACRUZ DE IGNACIO DE LA LLAVE,30,ATZALAN,023,LOMA DEL RAYO,2,34,18,16,3
VERACRUZ DE IGNACIO DE LA LLAVE,30,ATZALAN,023,MACUILTEPEC,2,38,12,26,3
VERACRUZ DE IGNACIO DE LA LLAVE,30,ATZALAN,023,MOYOTA,1,5,3,2,1
VERACRUZ DE IGNACIO DE LA LLAVE,30,ATZALAN,023,NAPOALA,4,329,173,156,17
VERACRUZ DE IGNACIO DE LA LLAVE,30,ATZALAN,023,NARANJAL,1,3,2,1,1
VERACRUZ DE IGNACIO DE LA LLAVE,30,ATZALAN,023,NARANJILLO,5,109,49,60,9
VERACRUZ DE IGNACIO DE LA LLAVE,30,ATZALAN,023,NORBERTO AGUIRRE PALANCARES,3,73,38,35,6
VERACRUZ DE IGNACIO DE LA LLAVE,30,ATZALAN,023,OJO DE AGUA,2,12,5,7,2
VERACRUZ DE IGNACIO DE LA LLAVE,30,ATZALAN,023,OLOPIOTA,3,60,28,32,5
VERACRUZ DE IGNACIO DE LA LLAVE,30,ATZALAN,023,PAHUA HUECA,4,358,190,168,19
VERACRUZ DE IGNACIO DE LA LLAVE,30,ATZALAN,023,PALMARCILLO,3,142,67,75,9
VERACRUZ DE IGNACIO DE LA LLAVE,30,ATZALAN,023,PAPALOCUAUTLA,4,51,29,22,6
VERACRUZ DE IGNACIO DE LA LLAVE,30,ATZALAN,023,PEÑAS DE ALMANZA,3,76,34,42,8
VERACRUZ DE IGNACIO DE LA LLAVE,30,ATZALAN,023,PETOLOYA II,1,2,2,0,0
VERACRUZ DE IGNACIO DE LA LLAVE,30,ATZALAN,023,PIEDRA GRANDE,2,30,14,16,3
VERACRUZ DE IGNACIO DE LA LLAVE,30,ATZALAN,023,PILARES,2,49,27,22,4
VERACRUZ DE IGNACIO DE LA LLAVE,30,ATZALAN,023,PINO SOLO,1,11,5,6,1
VERACRUZ DE IGNACIO DE LA LLAVE,30,ATZALAN,023,PINOLILLO,1,4,1,3,1
VERACRUZ DE IGNACIO DE LA LLAVE,30,ATZALAN,023,PLAN DE ARROYOS,5,1007,486,521,48
VERACRUZ DE IGNACIO DE LA LLAVE,30,ATZALAN,023,PLAN DE LA LUZ,1,5,3,2,1
VERACRUZ DE IGNACIO DE LA LLAVE,30,ATZALAN,023,PLAN DE LAS ÁNIMAS,2,12,5,7,2
VERACRUZ DE IGNACIO DE LA LLAVE,30,ATZALAN,023,PLAN DE LIMÓN,1,9,4,5,1
VERACRUZ DE IGNACIO DE LA LLAVE,30,ATZALAN,023,POCHOTITA,2,16,9,7,2
VERACRUZ DE IGNACIO DE LA LLAVE,30,ATZALAN,023,POMPEYA,3,179,87,92,11
VERACRUZ DE IGNACIO DE LA LLAVE,30,ATZALAN,023,RANCHO NUEVO,2,29,9,20,2
VERACRUZ DE IGNACIO DE LA LLAVE,30,ATZALAN,023,SAN ANTONIO,3,66,31,35,4
VERACRUZ DE IGNACIO DE LA LLAVE,30,ATZALAN,023,SAN BARTOLO,2,23,13,10,3
VERACRUZ DE IGNACIO DE LA LLAVE,30,ATZALAN,023,SAN ISIDRO,2,24,8,16,3
VERACRUZ DE IGNACIO DE LA LLAVE,30,ATZALAN,023,SAN ISIDRO (EL BARRANCO),2,22,14,8,2
VERACRUZ DE IGNACIO DE LA LLAVE,30,ATZALAN,023,SAN PEDRO ALTEPEPAN,6,159,91,68,11
VERACRUZ DE IGNACIO DE LA LLAVE,30,ATZALAN,023,SAN PEDRO BUENAVISTA,3,54,21,33,5
VERACRUZ DE IGNACIO DE LA LLAVE,30,ATZALAN,023,SAN SALVADOR,3,69,39,30,4
VERACRUZ DE IGNACIO DE LA LLAVE,30,ATZALAN,023,SANTA CRUZ,2,51,26,25,3
VERACRUZ DE IGNACIO DE LA LLAVE,30,ATZALAN,023,SANTA ELENA,1,6,2,4,1
VERACRUZ DE IGNACIO DE LA LLAVE,30,ATZALAN,023,SANTA ROSA (EL EDÉN),2,12,9,3,2
VERACRUZ DE IGNACIO DE LA LLAVE,30,ATZALAN,023,SANTIAGO,5,298,138,160,21
VERACRUZ DE IGNACIO DE LA LLAVE,30,ATZALAN,023,SANTO DOMINGO (ARROYO NEGRO),5,101,44,57,7
VERACRUZ DE IGNACIO DE LA LLAVE,30,ATZALAN,023,SEIS DE MAYO,1,5,2,3,1
VERACRUZ DE IGNACIO DE LA LLAVE,30,ATZALAN,023,SOMPAZOL,3,83,37,46,6
VERACRUZ DE IGNACIO DE LA LLAVE,30,ATZALAN,023,TALLOHUAYA,1,22,14,8,1
VERACRUZ DE IGNACIO DE LA LLAVE,30,ATZALAN,023,TAMOLOTES,1,16,10,6,1
VERACRUZ DE IGNACIO DE LA LLAVE,30,ATZALAN,023,TATEMPA,2,32,17,15,3
VERACRUZ DE IGNACIO DE LA LLAVE,30,ATZALAN,023,TATZALLANALA,2,31,19,12,3
VERACRUZ DE IGNACIO DE LA LLAVE,30,ATZALAN,023,TAZOLAPA,3,81,35,46,7
VERACRUZ DE IGNACIO DE LA LLAVE,30,ATZALAN,023,TEPANAPA,1,12,8,4,1
VERACRUZ DE IGNACIO DE LA LLAVE,30,ATZALAN,023,TEPETZINTLA,3,35,18,17,4
VERACRUZ DE IGNACIO DE LA LLAVE,30,ATZALAN,023,TEPEYCAN,3,50,26,24,5
VERACRUZ DE IGNACIO DE LA LLAVE,30,ATZALAN,023,TEXCAPA,2,40,17,23,3
VERACRUZ DE IGNACIO DE LA LLAVE,30,ATZALAN,023,TIERRA NUEVA,4,295,154,141,17
VERACRUZ DE IGNACIO DE LA LLAVE,30,ATZALAN,023,TILZAPOTA,2,52,21,31,4
VERACRUZ DE IGNACIO DE LA LLAVE,30,ATZALAN,023,TINAJAS,1,23,11,12,2
VERACRUZ DE IGNACIO DE LA LLAVE,30,ATZALAN,023,TLACOLULA,2,47,26,21,3
VERACRUZ DE IGNACIO DE LA LLAVE,30,ATZALAN,023,TOMATA (ANEXO PILARES),3,149,80,69,9
VERACRUZ DE IGNACIO DE LA LLAVE,30,ATZALAN,023,TOXTEPEC,2,34,20,14,3
VERACRUZ DE IGNACIO DE LA LLAVE,30,ATZALAN,023,TOXTIXTACA,2,5,4,1,1
VERACRUZ DE IGNACIO DE LA LLAVE,30,ATZALAN,023,VEGA DEL RÍO DE SAN PEDRO,3,50,23,27,4
VERACRUZ DE IGNACIO DE LA LLAVE,30,ATZALAN,023,VISTA HERMOSA,2,44,21,23,3
VERACRUZ DE IGNACIO DE LA LLAVE,30,ATZALAN,023,XICOTES,1,10,5,5,1
VERACRUZ DE IGNACIO DE LA LLAVE,30,ATZALAN,023,XIOCUILAPA,2,36,19,17,3
VERACRUZ DE IGNACIO DE LA LLAVE,30,ATZALAN,023,XONTAXPAN,2,20,11,9,2
VERACRUZ DE IGNACIO DE LA LLAVE,30,ATZALAN,023,ZAPOTAL,1,59,31,28,3
VERACRUZ DE IGNACIO DE LA LLAVE,30,ATZALAN,023,ZAPOTE REDONDO,4,108,58,50,9
VERACRUZ DE IGNACIO DE LA LLAVE,30,ATZALAN,023,ZAPOTITLÁN,5,342,171,171,18
VERACRUZ DE IGNACIO DE LA LLAVE,30,TLALTETELA,024,AMATITLA,3,40,15,25,4
VERACRUZ DE IGNACIO DE LA LLAVE,30,TLALTETELA,024,AXOCUAPAN (SAN BARTOLO),3,128,56,72,9
VERACRUZ DE IGNACIO DE LA LLAVE,30,TLALTETELA,024,AXOYATLA,3,94,45,49,7
VERACRUZ DE IGNACIO DE LA LLAVE,30,TLALTETELA,024,BUENA VISTA,3,70,36,34,5
VERACRUZ DE IGNACIO DE LA LLAVE,30,TLALTETELA,024,CHICHICLA,2,19,8,11,2
VERACRUZ DE IGNACIO DE LA LLAVE,30,TLALTETELA,024,COETZALA,2,43,22,21,3
VERACRUZ DE IGNACIO DE LA LLAVE,30,TLALTETELA,024,EJIDO EMILIANO ZAPATA,1,28,9,19,1
VERACRUZ DE IGNACIO DE LA LLAVE,30,TLALTETELA,024,EL DURAZNILLO,1,4,0,4,1
VERACRUZ DE IGNACIO DE LA LLAVE,30,TLALTETELA,024,EL SEPARO,2,12,2,10,2
VERACRUZ DE IGNACIO DE LA LLAVE,30,TLALTETELA,024,EL TRÓPICO,2,18,9,9,2
VERACRUZ DE IGNACIO DE LA LLAVE,30,TLALTETELA,024,KUAPOL,2,29,16,13,3
VERACRUZ DE IGNACIO DE LA LLAVE,30,TLALTETELA,024,LA CRUZ,2,43,22,21,3
VERACRUZ DE IGNACIO DE LA LLAVE,30,TLALTETELA,024,LA LAJA,1,6,2,4,1
VERACRUZ DE IGNACIO DE LA LLAVE,30,TLALTETELA,024,LA REPRESA,3,22,7,15,3
VERACRUZ DE IGNACIO DE LA LLAVE,30,TLALTETELA,024,MONTE CHICO,2,87,43,44,6
VERACRUZ DE IGNACIO DE LA LLAVE,30,TLALTETELA,024,OHUAPAN,5,442,232,210,24
VERACRUZ DE IGNACIO DE LA LLAVE,30,TLALTETELA,024,PASO LIMÓN,2,48,28,20,3
VERACRUZ DE IGNACIO DE LA LLAVE,30,TLALTETELA,024,PINILLO,4,377,186,191,22
VERACRUZ DE IGNACIO DE LA LLAVE,30,TLALTETELA,024,POCHOTLA,1,10,4,6,1
VERACRUZ DE IGNACIO DE LA LLAVE,30,TLALTETELA,024,POXTLA,6,208,110,98,12
VERACRUZ DE IGNACIO DE LA LLAVE,30,TLALTETELA,024,RANCHO VIEJO,2,37,20,17,2
VERACRUZ DE IGNACIO DE LA LLAVE,30,TLALTETELA,024,RINCÓN DE POXTLA,3,84,42,42,6
VERACRUZ DE IGNACIO DE LA LLAVE,30,TLALTETELA,024,RINCÓN TONINGO,1,16,10,6,2
VERACRUZ DE IGNACIO DE LA LLAVE,30,TLALTETELA,024,TEOPANAPA,2,10,4,6,1
VERACRUZ DE IGNACIO DE LA LLAVE,30,TLALTETELA,024,TLALTETELA,8,1306,685,621,67
VERACRUZ DE IGNACIO DE LA LLAVE,30,TLALTETELA,024,TONINGO,4,96,46,50,6
VERACRUZ DE IGNACIO DE LA LLAVE,30,TLALTETELA,024,XOTLA,3,47,22,25,6
VERACRUZ DE IGNACIO DE LA LLAVE,30,TLALTETELA,024,ZAYACATLA,2,17,12,5,2
VERACRUZ DE IGNACIO DE LA LLAVE,30,AYAHUALULCO,025,ALTAMIRADA,3,216,105,111,13
VERACRUZ DE IGNACIO DE LA LLAVE,30,AYAHUALULCO,025,APANTEOPAN,4,426,221,205,23
VERACRUZ DE IGNACIO DE LA LLAVE,30,AYAHUALULCO,025,AYAHUALULCO,7,588,295,293,37
VERACRUZ DE IGNACIO DE LA LLAVE,30,AYAHUALULCO,025,CALZONTEPEC,4,168,87,81,10
VERACRUZ DE IGNACIO DE LA LLAVE,30,AYAHUALULCO,025,CASA BLANCA,1,10,6,4,1
VERACRUZ DE IGNACIO DE LA LLAVE,30,AYAHUALULCO,025,CETLALPAN,3,150,63,87,10
VERACRUZ DE IGNACIO DE LA LLAVE,30,AYAHUALULCO,025,CRUZ VERDE,2,42,20,22,3
VERACRUZ DE IGNACIO DE LA LLAVE,30,AYAHUALULCO,025,EL CIPRÉS,3,115,54,61,8
VERACRUZ DE IGNACIO DE LA LLAVE,30,AYAHUALULCO,025,EL NARANJITO,1,8,4,4,1
VERACRUZ DE IGNACIO DE LA LLAVE,30,AYAHUALULCO,025,EL TRIUNFO,3,408,202,206,19
VERACRUZ DE IGNACIO DE LA LLAVE,30,AYAHUALULCO,025,LA TOMA,2,178,86,92,10
VERACRUZ DE IGNACIO DE LA LLAVE,30,AYAHUALULCO,025,LOMA DEL CAPULÍN,2,40,25,15,3
VERACRUZ DE IGNACIO DE LA LLAVE,30,AYAHUALULCO,025,LOS ALTOS,6,997,516,481,46
VERACRUZ DE IGNACIO DE LA LLAVE,30,AYAHUALULCO,025,MAZAZONTIPAN,3,94,44,50,5
VERACRUZ DE IGNACIO DE LA LLAVE,30,AYAHUALULCO,025,OCOTEPEC,2,126,58,68,7
VERACRUZ DE IGNACIO DE LA LLAVE,30,AYAHUALULCO,025,PLAN DE LA CRUZ,2,31,18,13,3
VERACRUZ DE IGNACIO DE LA LLAVE,30,AYAHUALULCO,025,RINCONADA (XONCHIQUITL),4,279,144,135,15
VERACRUZ DE IGNACIO DE LA LLAVE,30,AYAHUALULCO,025,SAN ANTONIO XOQUITLA,5,258,129,129,21
VERACRUZ DE IGNACIO DE LA LLAVE,30,AYAHUALULCO,025,SAN FRANCISCO,3,104,47,57,6
VERACRUZ DE IGNACIO DE LA LLAVE,30,AYAHUALULCO,025,SAN GABRIEL,1,4,1,3,1
VERACRUZ DE IGNACIO DE LA LLAVE,30,AYAHUALULCO,025,SAN ISIDRO,3,113,54,59,11
VERACRUZ DE IGNACIO DE LA LLAVE,30,AYAHUALULCO,025,SAN JOSÉ AGUAZUELAS,3,72,38,34,4
VERACRUZ DE IGNACIO DE LA LLAVE,30,AYAHUALULCO,025,TLALCONTENO,4,315,175,140,17
VERACRUZ DE IGNACIO DE LA LLAVE,30,AYAHUALULCO,025,XOCOTEPEC,4,374,196,178,28
VERACRUZ DE IGNACIO DE LA LLAVE,30,AYAHUALULCO,025,XOLOLOYAN,4,474,251,223,30
VERACRUZ DE IGNACIO DE LA LLAVE,30,BANDERILLA,026,BANDERILLA,32,7725,3971,3754,801
VERACRUZ DE IGNACIO DE LA LLAVE,30,BANDERILLA,026,LA HACIENDITA,4,654,352,302,38
VERACRUZ DE IGNACIO DE LA LLAVE,30,BANDERILLA,026,XALTEPEC,3,155,68,87,11
VERACRUZ DE IGNACIO DE LA LLAVE,30,BENITO JUÁREZ,027,AHUATITLA,2,23,8,15,2
VERACRUZ DE IGNACIO DE LA LLAVE,30,BENITO JUÁREZ,027,AMECATIPA,3,51,32,19,4
VERACRUZ DE IGNACIO DE LA LLAVE,30,BENITO JUÁREZ,027,ATLALCO,2,43,24,19,3
VERACRUZ DE IGNACIO DE LA LLAVE,30,BENITO JUÁREZ,027,ATOSKA,2,57,28,29,6
VERACRUZ DE IGNACIO DE LA LLAVE,30,BENITO JUÁREZ,027,AZOQUITIPA,3,34,13,21,4
VERACRUZ DE IGNACIO DE LA LLAVE,30,BENITO JUÁREZ,027,BENITO JUÁREZ,6,1104,566,538,62
VERACRUZ DE IGNACIO DE LA LLAVE,30,BENITO JUÁREZ,027,CALACO,3,119,57,62,10
VERACRUZ DE IGNACIO DE LA LLAVE,30,BENITO JUÁREZ,027,CHICHILZÓQUITL,2,66,35,31,3
VERACRUZ DE IGNACIO DE LA LLAVE,30,BENITO JUÁREZ,027,CHILA,2,33,16,17,4
VERACRUZ DE IGNACIO DE LA LLAVE,30,BENITO JUÁREZ,027,COACHUMO COMÚN,3,90,38,52,7
VERACRUZ DE IGNACIO DE LA LLAVE,30,BENITO JUÁREZ,027,CUEXCONTITLA,1,15,8,7,1
VERACRUZ DE IGNACIO DE LA LLAVE,30,BENITO JUÁREZ,027,DOROTEO ARANGO,1,9,5,4,1
VERACRUZ DE IGNACIO DE LA LLAVE,30,BENITO JUÁREZ,027,EJIDO COACHUMO,2,21,5,16,2
VERACRUZ DE IGNACIO DE LA LLAVE,30,BENITO JUÁREZ,027,EL ESTERO CHICO,2,23,10,13,3
VERACRUZ DE IGNACIO DE LA LLAVE,30,BENITO JUÁREZ,027,EL PARAJE,2,15,5,10,2
VERACRUZ DE IGNACIO DE LA LLAVE,30,BENITO JUÁREZ,027,EL TERRERO,3,52,27,25,5
VERACRUZ DE IGNACIO DE LA LLAVE,30,BENITO JUÁREZ,027,FLORES MAGÓN,2,16,12,4,2
VERACRUZ DE IGNACIO DE LA LLAVE,30,BENITO JUÁREZ,027,HUEYCUATITLA,3,106,54,52,10
VERACRUZ DE IGNACIO DE LA LLAVE,30,BENITO JUÁREZ,027,HUILOAPA,2,30,17,13,3
VERACRUZ DE IGNACIO DE LA LLAVE,30,BENITO JUÁREZ,027,IXTACAHUAYO,4,100,52,48,9
VERACRUZ DE IGNACIO DE LA LLAVE,30,BENITO JUÁREZ,027,LA LIMA,1,9,3,6,1
VERACRUZ DE IGNACIO DE LA LLAVE,30,BENITO JUÁREZ,027,LA REFORMA,3,103,53,50,8
VERACRUZ DE IGNACIO DE LA LLAVE,30,BENITO JUÁREZ,027,LA REVANCHA,2,52,25,27,4
VERACRUZ DE IGNACIO DE LA LLAVE,30,BENITO JUÁREZ,027,OTLAMALÁCATL,3,147,77,70,14
VERACRUZ DE IGNACIO DE LA LLAVE,30,BENITO JUÁREZ,027,OTLATEMPA,1,16,9,7,1
VERACRUZ DE IGNACIO DE LA LLAVE,30,BENITO JUÁREZ,027,PAHUATITLA,1,15,7,8,2
VERACRUZ DE IGNACIO DE LA LLAVE,30,BENITO JUÁREZ,027,PALMA REAL,4,210,85,125,15
VERACRUZ DE IGNACIO DE LA LLAVE,30,BENITO JUÁREZ,027,PALTZOQUITEMPA,3,81,33,48,6
VERACRUZ DE IGNACIO DE LA LLAVE,30,BENITO JUÁREZ,027,PILPUERTA,3,78,36,42,8
VERACRUZ DE IGNACIO DE LA LLAVE,30,BENITO JUÁREZ,027,PRIMO VERDAD (SAN MIGUEL),4,233,98,135,13
VERACRUZ DE IGNACIO DE LA LLAVE,30,BENITO JUÁREZ,027,RANCHO NUEVO,1,20,6,14,1
VERACRUZ DE IGNACIO DE LA LLAVE,30,BENITO JUÁREZ,027,TENANTITLA,4,275,144,131,24
VERACRUZ DE IGNACIO DE LA LLAVE,30,BENITO JUÁREZ,027,TLALMAYA,3,23,11,12,4
VERACRUZ DE IGNACIO DE LA LLAVE,30,BENITO JUÁREZ,027,TLALTZINTLA,2,16,7,9,2
VERACRUZ DE IGNACIO DE LA LLAVE,30,BENITO JUÁREZ,027,TLAMAYA,1,7,2,5,1
VERACRUZ DE IGNACIO DE LA LLAVE,30,BENITO JUÁREZ,027,TLATLAPANGO CHICO,3,59,23,36,6
VERACRUZ DE IGNACIO DE LA LLAVE,30,BENITO JUÁREZ,027,TLATLAPANGO GRANDE,2,91,50,41,8
VERACRUZ DE IGNACIO DE LA LLAVE,30,BENITO JUÁREZ,027,TOLACO,1,20,5,15,1
VERACRUZ DE IGNACIO DE LA LLAVE,30,BENITO JUÁREZ,027,TOLICO DE ZAPATA,1,16,9,7,1
VERACRUZ DE IGNACIO DE LA LLAVE,30,BENITO JUÁREZ,027,XOCHIOLOCO,2,54,27,27,5
VERACRUZ DE IGNACIO DE LA LLAVE,30,BENITO JUÁREZ,027,YUPILTITLA,3,91,54,37,8
VERACRUZ DE IGNACIO DE LA LLAVE,30,BOCA DEL RÍO,028,BOCA DEL RÍO,258,44685,22923,21762,3968
VERACRUZ DE IGNACIO DE LA LLAVE,30,BOCA DEL RÍO,028,PASO COLORADO,2,102,50,52,6
VERACRUZ DE IGNACIO DE LA LLAVE,30,BOCA DEL RÍO,028,SAN JOSÉ NOVILLERO,5,436,205,231,28
VERACRUZ DE IGNACIO DE LA LLAVE,30,BOCA DEL RÍO,028,VERACRUZ,1,64,28,36,6
VERACRUZ DE IGNACIO DE LA LLAVE,30,CALCAHUALCO,029,ACATÍCPAC,2,44,20,24,3
VERACRUZ DE IGNACIO DE LA LLAVE,30,CALCAHUALCO,029,ACOMULCO,2,45,22,23,3
VERACRUZ DE IGNACIO DE LA LLAVE,30,CALCAHUALCO,029,AHUATEPEC,2,22,9,13,2
VERACRUZ DE IGNACIO DE LA LLAVE,30,CALCAHUALCO,029,AHUIHUIXTLA,3,166,72,94,10
VERACRUZ DE IGNACIO DE LA LLAVE,30,CALCAHUALCO,029,ATOTONILCO,3,120,59,61,8
VERACRUZ DE IGNACIO DE LA LLAVE,30,CALCAHUALCO,029,BARRANCA DE JAMAPA,3,51,20,31,4
VERACRUZ DE IGNACIO DE LA LLAVE,30,CALCAHUALCO,029,BUENA VISTA,3,62,35,27,5
VERACRUZ DE IGNACIO DE LA LLAVE,30,CALCAHUALCO,029,CALCAHUALCO,4,419,207,212,21
VERACRUZ DE IGNACIO DE LA LLAVE,30,CALCAHUALCO,029,CRUZ VERDE,3,261,126,135,16
VERACRUZ DE IGNACIO DE LA LLAVE,30,CALCAHUALCO,029,DOS CAMINOS,2,69,38,31,5
VERACRUZ DE IGNACIO DE LA LLAVE,30,CALCAHUALCO,029,EL RINCÓN DE ATOTONILCO,3,66,36,30,5
VERACRUZ DE IGNACIO DE LA LLAVE,30,CALCAHUALCO,029,EL TERRERO,1,11,7,4,1
VERACRUZ DE IGNACIO DE LA LLAVE,30,CALCAHUALCO,029,EXCOLA,4,341,182,159,22
VERACRUZ DE IGNACIO DE LA LLAVE,30,CALCAHUALCO,029,ITZAPA,2,26,16,10,3
VERACRUZ DE IGNACIO DE LA LLAVE,30,CALCAHUALCO,029,LA MESA DE ATOTONILCO,3,122,70,52,7
VERACRUZ DE IGNACIO DE LA LLAVE,30,CALCAHUALCO,029,MAQUILIXHUATLA,1,17,8,9,1
VERACRUZ DE IGNACIO DE LA LLAVE,30,CALCAHUALCO,029,MAQUIXTLA,3,110,51,59,8
VERACRUZ DE IGNACIO DE LA LLAVE,30,CALCAHUALCO,029,NUEVA VAQUERÍA,3,162,78,84,10
VERACRUZ DE IGNACIO DE LA LLAVE,30,CALCAHUALCO,029,NUEVO JACAL,2,94,54,40,4
VERACRUZ DE IGNACIO DE LA LLAVE,30,CALCAHUALCO,029,SAN FRANCISCO,3,112,56,56,7
VERACRUZ DE IGNACIO DE LA LLAVE,30,CALCAHUALCO,029,SAN JOSÉ XITECO,2,22,8,14,2
VERACRUZ DE IGNACIO DE LA LLAVE,30,CALCAHUALCO,029,SAN MIGUEL TLACOTIOPA,4,158,80,78,10
VERACRUZ DE IGNACIO DE LA LLAVE,30,CALCAHUALCO,029,SAN MIGUEL XITECO,4,66,28,38,6
VERACRUZ DE IGNACIO DE LA LLAVE,30,CALCAHUALCO,029,TECPANQUIAHUAC,1,9,6,3,1
VERACRUZ DE IGNACIO DE LA LLAVE,30,CALCAHUALCO,029,TECUANAPA,3,236,116,120,12
VERACRUZ DE IGNACIO DE LA LLAVE,30,CALCAHUALCO,029,TEOPANTITLA,3,47,27,20,4
VERACRUZ DE IGNACIO DE LA LLAVE,30,CALCAHUALCO,029,TEPETLAPA (SAN ANTONIO TEPETLAPA),3,15,8,7,2
VERACRUZ DE IGNACIO DE LA LLAVE,30,CALCAHUALCO,029,TOTOZINAPA,3,152,78,74,11
VERACRUZ DE IGNACIO DE LA LLAVE,30,CALCAHUALCO,029,XAMATÍCPAC,3,155,82,73,8
VERACRUZ DE IGNACIO DE LA LLAVE,30,CALCAHUALCO,029,XILOMICHI,5,141,72,69,9
VERACRUZ DE IGNACIO DE LA LLAVE,30,CAMERINO Z. MENDOZA,030,BARRIO DE TETZMOLA,1,48,23,25,2
VERACRUZ DE IGNACIO DE LA LLAVE,30,CAMERINO Z. MENDOZA,030,CIUDAD MENDOZA,51,9310,5104,4206,1007
VERACRUZ DE IGNACIO DE LA LLAVE,30,CAMERINO Z. MENDOZA,030,CUESTA ALTA,2,102,59,43,6
VERACRUZ DE IGNACIO DE LA LLAVE,30,CAMERINO Z. MENDOZA,030,LA CUESTA,5,613,299,314,40
VERACRUZ DE IGNACIO DE LA LLAVE,30,CAMERINO Z. MENDOZA,030,LA CUMBRE,2,169,87,82,8
VERACRUZ DE IGNACIO DE LA LLAVE,30,CAMERINO Z. MENDOZA,030,NECOXTLA,6,630,322,308,41
VERACRUZ DE IGNACIO DE LA LLAVE,30,CARRILLO PUERTO,031,ARROYO AZUL,4,272,147,125,14
VERACRUZ DE IGNACIO DE LA LLAVE,30,CARRILLO PUERTO,031,CERRO ALTO,4,178,82,96,9
VERACRUZ DE IGNACIO DE LA LLAVE,30,CARRILLO PUERTO,031,COLONIA DEL VALLE (EL CHICLE),1,32,15,17,2
VERACRUZ DE IGNACIO DE LA LLAVE,30,CARRILLO PUERTO,031,COLONIA ROSALES,1,49,20,29,3
VERACRUZ DE IGNACIO DE LA LLAVE,30,CARRILLO PUERTO,031,EL CALABOZO,2,52,33,19,4
VERACRUZ DE IGNACIO DE LA LLAVE,30,CARRILLO PUERTO,031,EL CRISTO,2,24,12,12,2
VERACRUZ DE IGNACIO DE LA LLAVE,30,CARRILLO PUERTO,031,EL ESPINAL,3,27,16,11,3
VERACRUZ DE IGNACIO DE LA LLAVE,30,CARRILLO PUERTO,031,EL HORNO,1,7,3,4,1
VERACRUZ DE IGNACIO DE LA LLAVE,30,CARRILLO PUERTO,031,EL IZOTAL,1,6,5,1,1
VERACRUZ DE IGNACIO DE LA LLAVE,30,CARRILLO PUERTO,031,EL LAGARTILLO,1,6,1,5,1
VERACRUZ DE IGNACIO DE LA LLAVE,30,CARRILLO PUERTO,031,EL MANGO,1,7,3,4,1
VERACRUZ DE IGNACIO DE LA LLAVE,30,CARRILLO PUERTO,031,EL MIRADOR,2,142,70,72,7
VERACRUZ DE IGNACIO DE LA LLAVE,30,CARRILLO PUERTO,031,EL ÓRGANO,1,18,10,8,1
VERACRUZ DE IGNACIO DE LA LLAVE,30,CARRILLO PUERTO,031,EL PALMAR,3,269,138,131,14
VERACRUZ DE IGNACIO DE LA LLAVE,30,CARRILLO PUERTO,031,EL TAMARINDO,2,45,23,22,3
VERACRUZ DE IGNACIO DE LA LLAVE,30,CARRILLO PUERTO,031,EL TIZATAL,2,25,9,16,2
VERACRUZ DE IGNACIO DE LA LLAVE,30,CARRILLO PUERTO,031,LA ANGOSTURA,1,44,20,24,2
VERACRUZ DE IGNACIO DE LA LLAVE,30,CARRILLO PUERTO,031,LA CRUCETA,1,17,6,11,1
VERACRUZ DE IGNACIO DE LA LLAVE,30,CARRILLO PUERTO,031,LA LAGUNA,3,36,16,20,4
VERACRUZ DE IGNACIO DE LA LLAVE,30,CARRILLO PUERTO,031,LA QUEBRACHA,2,10,7,3,2
VERACRUZ DE IGNACIO DE LA LLAVE,30,CARRILLO PUERTO,031,LA UNIÓN,2,26,11,15,3
VERACRUZ DE IGNACIO DE LA LLAVE,30,CARRILLO PUERTO,031,LAS CUADRAS,2,106,65,41,6
VERACRUZ DE IGNACIO DE LA LLAVE,30,CARRILLO PUERTO,031,LOMA ACATLÁN,1,12,6,6,1
VERACRUZ DE IGNACIO DE LA LLAVE,30,CARRILLO PUERTO,031,LOMA ALTA,1,10,2,8,1
VERACRUZ DE IGNACIO DE LA LLAVE,30,CARRILLO PUERTO,031,LOMA ANGOSTA,4,257,142,115,13
VERACRUZ DE IGNACIO DE LA LLAVE,30,CARRILLO PUERTO,031,LOMA BONITA,1,4,3,1,1
VERACRUZ DE IGNACIO DE LA LLAVE,30,CARRILLO PUERTO,031,LOMA DE ENMEDIO,3,27,10,17,3
VERACRUZ DE IGNACIO DE LA LLAVE,30,CARRILLO PUERTO,031,LOMA DE PIEDRA,3,20,11,9,2
VERACRUZ DE IGNACIO DE LA LLAVE,30,CARRILLO PUERTO,031,LOMA LARGA,1,24,17,7,2
VERACRUZ DE IGNACIO DE LA LLAVE,30,CARRILLO PUERTO,031,LOS AMEYALES,1,13,7,6,1
VERACRUZ DE IGNACIO DE LA LLAVE,30,CARRILLO PUERTO,031,LOS BARBECHOS,2,13,5,8,1
VERACRUZ DE IGNACIO DE LA LLAVE,30,CARRILLO PUERTO,031,LOS CERRITOS,2,26,11,15,3
VERACRUZ DE IGNACIO DE LA LLAVE,30,CARRILLO PUERTO,031,LOS NEGRITOS,1,6,5,1,1
VERACRUZ DE IGNACIO DE LA LLAVE,30,CARRILLO PUERTO,031,LOS TIGRES,2,9,3,6,1
VERACRUZ DE IGNACIO DE LA LLAVE,30,CARRILLO PUERTO,031,MATA DOMINGO,3,41,21,20,4
VERACRUZ DE IGNACIO DE LA LLAVE,30,CARRILLO PUERTO,031,MATA FERRER,2,5,1,4,1
VERACRUZ DE IGNACIO DE LA LLAVE,30,CARRILLO PUERTO,031,MATA GALLINA,2,145,71,74,7
VERACRUZ DE IGNACIO DE LA LLAVE,30,CARRILLO PUERTO,031,MATA MAGUEY,2,18,5,13,2
VERACRUZ DE IGNACIO DE LA LLAVE,30,CARRILLO PUERTO,031,MATA TIGRE,1,46,26,20,3
VERACRUZ DE IGNACIO DE LA LLAVE,30,CARRILLO PUERTO,031,MEXCALA,2,23,10,13,3
VERACRUZ DE IGNACIO DE LA LLAVE,30,CARRILLO PUERTO,031,PALO AMARILLO (MATA PIONCHE),3,77,27,50,5
VERACRUZ DE IGNACIO DE LA LLAVE,30,CARRILLO PUERTO,031,PALO VERDE,2,40,15,25,3
VERACRUZ DE IGNACIO DE LA LLAVE,30,CARRILLO PUERTO,031,PASO DEL POTRO,3,121,66,55,7
VERACRUZ DE IGNACIO DE LA LLAVE,30,CARRILLO PUERTO,031,PICA PICA,2,37,18,19,4
VERACRUZ DE IGNACIO DE LA LLAVE,30,CARRILLO PUERTO,031,RANCHO NUEVO,3,119,59,60,6
VERACRUZ DE IGNACIO DE LA LLAVE,30,CARRILLO PUERTO,031,RANCHO VALDIVIA,2,34,14,20,3
VERACRUZ DE IGNACIO DE LA LLAVE,30,CARRILLO PUERTO,031,RINCÓN VAINILLA,2,15,3,12,2
VERACRUZ DE IGNACIO DE LA LLAVE,30,CARRILLO PUERTO,031,SANTA BÁRBARA,1,38,26,12,3
VERACRUZ DE IGNACIO DE LA LLAVE,30,CARRILLO PUERTO,031,SANTIAGO HUATUSCO,1,33,15,18,2
VERACRUZ DE IGNACIO DE LA LLAVE,30,CARRILLO PUERTO,031,TAMARINDO,6,656,310,346,28
VERACRUZ DE IGNACIO DE LA LLAVE,30,CARRILLO PUERTO,031,TLALNEHUEPAN,1,18,8,10,1
VERACRUZ DE IGNACIO DE LA LLAVE,30,CARRILLO PUERTO,031,TRINIDAD SÁNCHEZ SANTOS,4,399,204,195,23
VERACRUZ DE IGNACIO DE LA LLAVE,30,CATEMACO,032,ADOLFO LÓPEZ MATEOS (EL MARINERO),2,25,13,12,2
VERACRUZ DE IGNACIO DE LA LLAVE,30,CATEMACO,032,AHUATEPEC,2,41,19,22,3
VERACRUZ DE IGNACIO DE LA LLAVE,30,CATEMACO,032,AMPLIACIÓN LIMÓN,3,25,11,14,4
VERACRUZ DE IGNACIO DE LA LLAVE,30,CATEMACO,032,BAJOS DE MIMIAHUA,2,43,15,28,3
VERACRUZ DE IGNACIO DE LA LLAVE,30,CATEMACO,032,BARRA DE SONTECOMAPAN,3,80,40,40,4
VERACRUZ DE IGNACIO DE LA LLAVE,30,CATEMACO,032,BENITO JUÁREZ,3,83,38,45,7
VERACRUZ DE IGNACIO DE LA LLAVE,30,CATEMACO,032,CALPULTÉOLT (EL MORRO),2,8,3,5,2
VERACRUZ DE IGNACIO DE LA LLAVE,30,CATEMACO,032,CATEMACO,46,6294,3087,3207,436
VERACRUZ DE IGNACIO DE LA LLAVE,30,CATEMACO,032,COLONIA EL ÁGUILA,3,62,29,33,6
VERACRUZ DE IGNACIO DE LA LLAVE,30,CATEMACO,032,COXCOAPAN,3,152,68,84,12
VERACRUZ DE IGNACIO DE LA LLAVE,30,CATEMACO,032,COYAME,3,67,38,29,7
VERACRUZ DE IGNACIO DE LA LLAVE,30,CATEMACO,032,DOS AMATES,4,107,61,46,10
VERACRUZ DE IGNACIO DE LA LLAVE,30,CATEMACO,032,DOS ARROYOS,2,16,11,5,2
VERACRUZ DE IGNACIO DE LA LLAVE,30,CATEMACO,032,EL JOBO,3,30,13,17,4
VERACRUZ DE IGNACIO DE LA LLAVE,30,CATEMACO,032,EL RAYITO,2,5,2,3,1
VERACRUZ DE IGNACIO DE LA LLAVE,30,CATEMACO,032,EL REAL,2,55,23,32,3
VERACRUZ DE IGNACIO DE LA LLAVE,30,CATEMACO,032,GUSTAVO DÍAZ ORDAZ,2,36,17,19,3
VERACRUZ DE IGNACIO DE LA LLAVE,30,CATEMACO,032,LA CANDELARIA,4,217,115,102,14
VERACRUZ DE IGNACIO DE LA LLAVE,30,CATEMACO,032,LA MARGARITA,3,48,28,20,5
VERACRUZ DE IGNACIO DE LA LLAVE,30,CATEMACO,032,LA PALMA,4,264,144,120,16
VERACRUZ DE IGNACIO DE LA LLAVE,30,CATEMACO,032,LA PROVIDENCIA,1,16,9,7,1
VERACRUZ DE IGNACIO DE LA LLAVE,30,CATEMACO,032,LA VICTORIA,5,499,236,263,27
VERACRUZ DE IGNACIO DE LA LLAVE,30,CATEMACO,032,LOS MORRITOS (AGUA NACIDA),3,28,15,13,4
VERACRUZ DE IGNACIO DE LA LLAVE,30,CATEMACO,032,MARIO SOUZA,3,118,64,54,8
VERACRUZ DE IGNACIO DE LA LLAVE,30,CATEMACO,032,MAXACAPAN,4,157,78,79,14
VERACRUZ DE IGNACIO DE LA LLAVE,30,CATEMACO,032,MIGUEL HIDALGO (EL APOMPAL),3,102,53,49,5
VERACRUZ DE IGNACIO DE LA LLAVE,30,CATEMACO,032,OJOXAPAN,2,29,11,18,2
VERACRUZ DE IGNACIO DE LA LLAVE,30,CATEMACO,032,PENÍNSULA DE MORENO,3,72,31,41,5
VERACRUZ DE IGNACIO DE LA LLAVE,30,CATEMACO,032,PERLA DE SAN MARTÍN,3,61,33,28,4
VERACRUZ DE IGNACIO DE LA LLAVE,30,CATEMACO,032,POZOLAPAN (CARTAGENA),5,253,116,137,16
VERACRUZ DE IGNACIO DE LA LLAVE,30,CATEMACO,032,RINCÓN LARGO,2,56,29,27,4
VERACRUZ DE IGNACIO DE LA LLAVE,30,CATEMACO,032,SAN JUAN SECO DE VALENCIA,4,292,141,151,17
VERACRUZ DE IGNACIO DE LA LLAVE,30,CATEMACO,032,SAN RAFAEL,2,19,7,12,2
VERACRUZ DE IGNACIO DE LA LLAVE,30,CATEMACO,032,SONTECOMAPAN,5,619,293,326,33
VERACRUZ DE IGNACIO DE LA LLAVE,30,CATEMACO,032,TEBANCA,4,240,113,127,14
VERACRUZ DE IGNACIO DE LA LLAVE,30,CATEMACO,032,TEMOLAPAN,2,16,4,12,2
VERACRUZ DE IGNACIO DE LA LLAVE,30,CATEMACO,032,TEOTEPEC,2,14,6,8,2
VERACRUZ DE IGNACIO DE LA LLAVE,30,CATEMACO,032,TRES DE MAYO,2,38,19,19,3
VERACRUZ DE IGNACIO DE LA LLAVE,30,CATEMACO,032,ZAPOAPAN DE CABAÑAS,4,277,136,141,18
VERACRUZ DE IGNACIO DE LA LLAVE,30,CAZONES DE HERRERA,033,BARRA DE CAZONES,4,256,118,138,16
VERACRUZ DE IGNACIO DE LA LLAVE,30,CAZONES DE HERRERA,033,BARRIO ACOSTA LAGUNES,1,9,5,4,1
VERACRUZ DE IGNACIO DE LA LLAVE,30,CAZONES DE HERRERA,033,BUENAVISTA,3,124,62,62,11
VERACRUZ DE IGNACIO DE LA LLAVE,30,CAZONES DE HERRERA,033,CABELLAL NÚMERO DOS,4,207,105,102,13
VERACRUZ DE IGNACIO DE LA LLAVE,30,CAZONES DE HERRERA,033,CABELLAL NÚMERO UNO,3,103,58,45,11
VERACRUZ DE IGNACIO DE LA LLAVE,30,CAZONES DE HERRERA,033,CAZONES DE HERRERA,12,1746,869,877,88
VERACRUZ DE IGNACIO DE LA LLAVE,30,CAZONES DE HERRERA,033,CERRO VERDE,3,70,36,34,5
VERACRUZ DE IGNACIO DE LA LLAVE,30,CAZONES DE HERRERA,033,CHACA GORDA,2,17,2,15,2
VERACRUZ DE IGNACIO DE LA LLAVE,30,CAZONES DE HERRERA,033,COYOL NORTE,4,127,56,71,11
VERACRUZ DE IGNACIO DE LA LLAVE,30,CAZONES DE HERRERA,033,CRUZ BLANCA NÚMERO DOS,1,22,14,8,3
VERACRUZ DE IGNACIO DE LA LLAVE,30,CAZONES DE HERRERA,033,CRUZ BLANCA NÚMERO UNO,3,257,118,139,12
VERACRUZ DE IGNACIO DE LA LLAVE,30,CAZONES DE HERRERA,033,EL MARINO,2,33,21,12,3
VERACRUZ DE IGNACIO DE LA LLAVE,30,CAZONES DE HERRERA,033,EL RAMAL,2,19,12,7,2
VERACRUZ DE IGNACIO DE LA LLAVE,30,CAZONES DE HERRERA,033,EL SAUCE,3,99,46,53,11
VERACRUZ DE IGNACIO DE LA LLAVE,30,CAZONES DE HERRERA,033,EMILIANO ZAPATA,3,68,28,40,4
VERACRUZ DE IGNACIO DE LA LLAVE,30,CAZONES DE HERRERA,033,GENERAL FELIPE ÁNGELES,1,17,10,7,1
VERACRUZ DE IGNACIO DE LA LLAVE,30,CAZONES DE HERRERA,033,LA CEIBA,4,183,91,92,13
VERACRUZ DE IGNACIO DE LA LLAVE,30,CAZONES DE HERRERA,033,LA CURVA,2,26,14,12,3
VERACRUZ DE IGNACIO DE LA LLAVE,30,CAZONES DE HERRERA,033,LA ENCANTADA,3,82,43,39,6
VERACRUZ DE IGNACIO DE LA LLAVE,30,CAZONES DE HERRERA,033,LA PIEDAD,3,153,69,84,11
VERACRUZ DE IGNACIO DE LA LLAVE,30,CAZONES DE HERRERA,033,LA REFORMA DE HERRERA (KILÓMETRO 19),1,21,13,8,2
VERACRUZ DE IGNACIO DE LA LLAVE,30,CAZONES DE HERRERA,033,LA UNIÓN (KILÓMETRO 31),5,439,228,211,30
VERACRUZ DE IGNACIO DE LA LLAVE,30,CAZONES DE HERRERA,033,LAS PALMAS,2,32,18,14,4
VERACRUZ DE IGNACIO DE LA LLAVE,30,CAZONES DE HERRERA,033,LIMÓN CHIQUITO,3,171,85,86,11
VERACRUZ DE IGNACIO DE LA LLAVE,30,CAZONES DE HERRERA,033,LOS MIGUELES,2,32,20,12,3
VERACRUZ DE IGNACIO DE LA LLAVE,30,CAZONES DE HERRERA,033,MANLIO FABIO ALTAMIRANO (KILÓMETRO 25),4,216,112,104,21
VERACRUZ DE IGNACIO DE LA LLAVE,30,CAZONES DE HERRERA,033,MARCO ANTONIO MUÑOZ (EL CHAPARRAL),1,5,1,4,1
VERACRUZ DE IGNACIO DE LA LLAVE,30,CAZONES DE HERRERA,033,MORISCO NÚMERO UNO (SAN ROMÁN GRANDE),1,7,3,4,1
VERACRUZ DE IGNACIO DE LA LLAVE,30,CAZONES DE HERRERA,033,NARANJOS DE AFUERA (NARANJOS KILÓMETRO 27),1,18,9,9,2
VERACRUZ DE IGNACIO DE LA LLAVE,30,CAZONES DE HERRERA,033,NUEVO TEJAMANIL,3,198,86,112,11
VERACRUZ DE IGNACIO DE LA LLAVE,30,CAZONES DE HERRERA,033,OJO DE AGUA,2,32,16,16,3
VERACRUZ DE IGNACIO DE LA LLAVE,30,CAZONES DE HERRERA,033,PASO DE CAZONES,2,33,19,14,3
VERACRUZ DE IGNACIO DE LA LLAVE,30,CAZONES DE HERRERA,033,PLAN DE LIMÓN,4,292,142,150,17
VERACRUZ DE IGNACIO DE LA LLAVE,30,CAZONES DE HERRERA,033,RANCHO NUEVO,4,399,186,213,19
VERACRUZ DE IGNACIO DE LA LLAVE,30,CAZONES DE HERRERA,033,SAN ROMÁN CHIQUITO (ANEXO MORISCO NÚMERO DOS),2,29,16,13,2
VERACRUZ DE IGNACIO DE LA LLAVE,30,CAZONES DE HERRERA,033,VEGA DE PROGRESO,1,6,2,4,1
VERACRUZ DE IGNACIO DE LA LLAVE,30,CERRO AZUL,034,BUENOS AIRES,1,7,3,4,2
VERACRUZ DE IGNACIO DE LA LLAVE,30,CERRO AZUL,034,CERRO AZUL,47,6460,3095,3365,551
VERACRUZ DE IGNACIO DE LA LLAVE,30,CERRO AZUL,034,CERRO AZUL VIEJO,1,22,7,15,2
VERACRUZ DE IGNACIO DE LA LLAVE,30,CERRO AZUL,034,EJIDO XILITLA,2,13,7,6,2
VERACRUZ DE IGNACIO DE LA LLAVE,30,CERRO AZUL,034,EL MIRADOR,2,74,34,40,7
VERACRUZ DE IGNACIO DE LA LLAVE,30,CERRO AZUL,034,JUAN FELIPE,3,119,51,68,13
VERACRUZ DE IGNACIO DE LA LLAVE,30,CERRO AZUL,034,LA CAMPECHANA,3,63,31,32,7
VERACRUZ DE IGNACIO DE LA LLAVE,30,CERRO AZUL,034,PIEDRA LABRADA,4,112,52,60,11
VERACRUZ DE IGNACIO DE LA LLAVE,30,CERRO AZUL,034,TAMALINILLO,2,13,5,8,2
VERACRUZ DE IGNACIO DE LA LLAVE,30,CITLALTÉPETL,035,CEIBA NUEVA,2,28,9,19,3
VERACRUZ DE IGNACIO DE LA LLAVE,30,CITLALTÉPETL,035,CITLALTÉPEC,7,1037,499,538,75
VERACRUZ DE IGNACIO DE LA LLAVE,30,CITLALTÉPETL,035,EL CIRUELAR,2,40,16,24,4
VERACRUZ DE IGNACIO DE LA LLAVE,30,CITLALTÉPETL,035,EL CRUCERO,2,24,16,8,2
VERACRUZ DE IGNACIO DE LA LLAVE,30,CITLALTÉPETL,035,EL NARANJAL,2,86,47,39,9
VERACRUZ DE IGNACIO DE LA LLAVE,30,CITLALTÉPETL,035,LA CALABAZA,2,31,14,17,3
VERACRUZ DE IGNACIO DE LA LLAVE,30,CITLALTÉPETL,035,LA CEIBA,3,147,77,70,10
VERACRUZ DE IGNACIO DE LA LLAVE,30,CITLALTÉPETL,035,LA MESA TLANCHINOL,2,34,20,14,3
VERACRUZ DE IGNACIO DE LA LLAVE,30,CITLALTÉPETL,035,LA QUEBRADORA,4,42,20,22,5
VERACRUZ DE IGNACIO DE LA LLAVE,30,CITLALTÉPETL,035,LAS SABINAS,3,195,103,92,14
VERACRUZ DE IGNACIO DE LA LLAVE,30,CITLALTÉPETL,035,LOMA LAS VIGAS,1,12,7,5,2
VERACRUZ DE IGNACIO DE LA LLAVE,30,CITLALTÉPETL,035,LOS ALTOS DEL METATE,1,19,11,8,1
VERACRUZ DE IGNACIO DE LA LLAVE,30,CITLALTÉPETL,035,LOS CERRITOS,2,23,14,9,3
VERACRUZ DE IGNACIO DE LA LLAVE,30,CITLALTÉPETL,035,RANCHO NUEVO,3,91,45,46,10
VERACRUZ DE IGNACIO DE LA LLAVE,30,CITLALTÉPETL,035,RINCÓN DEL HIGO,4,232,120,112,14
VERACRUZ DE IGNACIO DE LA LLAVE,30,CITLALTÉPETL,035,SAN JERÓNIMO,2,50,28,22,5
VERACRUZ DE IGNACIO DE LA LLAVE,30,CITLALTÉPETL,035,SAN SEBASTIÁN EL ALTO,2,11,6,5,3
VERACRUZ DE IGNACIO DE LA LLAVE,30,CITLALTÉPETL,035,ZAPUPAL,2,10,7,3,2
VERACRUZ DE IGNACIO DE LA LLAVE,30,COACOATZINTLA,036,CHAPULTEPEC,2,45,23,22,3
VERACRUZ DE IGNACIO DE LA LLAVE,30,COACOATZINTLA,036,COACOATZINTLA,10,1924,936,988,99
VERACRUZ DE IGNACIO DE LA LLAVE,30,COACOATZINTLA,036,CUMBRES DEL CIPRÉS,2,17,7,10,2
VERACRUZ DE IGNACIO DE LA LLAVE,30,COACOATZINTLA,036,EL AGUACATE,2,35,18,17,3
VERACRUZ DE IGNACIO DE LA LLAVE,30,COACOATZINTLA,036,LA VENTANA,1,23,15,8,1
VERACRUZ DE IGNACIO DE LA LLAVE,30,COACOATZINTLA,036,LAS COLES,1,13,8,5,1
VERACRUZ DE IGNACIO DE LA LLAVE,30,COACOATZINTLA,036,LOS PLANES (CERRO GORDO),2,40,19,21,5
VERACRUZ DE IGNACIO DE LA LLAVE,30,COACOATZINTLA,036,METLAPILES,2,12,5,7,2
VERACRUZ DE IGNACIO DE LA LLAVE,30,COACOATZINTLA,036,PAXTEPEC,2,57,23,34,5
VERACRUZ DE IGNACIO DE LA LLAVE,30,COACOATZINTLA,036,PUEBLO VIEJO,3,69,34,35,7
VERACRUZ DE IGNACIO DE LA LLAVE,30,COACOATZINTLA,036,RINCÓN DE CHAPULTEPEC,1,10,5,5,1
VERACRUZ DE IGNACIO DE LA LLAVE,30,COACOATZINTLA,036,TLACHINOLA,2,45,19,26,4
VERACRUZ DE IGNACIO DE LA LLAVE,30,COAHUITLÁN,037,BARRIO DEL TECOLOTE,2,26,15,11,2
VERACRUZ DE IGNACIO DE LA LLAVE,30,COAHUITLÁN,037,COAHUITLÁN,5,680,329,351,33
VERACRUZ DE IGNACIO DE LA LLAVE,30,COAHUITLÁN,037,MACEDONIO ALONSO,5,505,248,257,25
VERACRUZ DE IGNACIO DE LA LLAVE,30,COAHUITLÁN,037,POZA DE LAGARTO,2,15,5,10,2
VERACRUZ DE IGNACIO DE LA LLAVE,30,COAHUITLÁN,037,PROGRESO DE ZARAGOZA,6,839,403,436,44
VERACRUZ DE IGNACIO DE LA LLAVE,30,COATEPEC,038,BELLA ESPERANZA,4,307,135,172,26
VERACRUZ DE IGNACIO DE LA LLAVE,30,COATEPEC,038,CINCO PALOS,3,211,121,90,17
VERACRUZ DE IGNACIO DE LA LLAVE,30,COATEPEC,038,COATEPEC,82,12305,6435,5870,1027
VERACRUZ DE IGNACIO DE LA LLAVE,30,COATEPEC,038,COLONIA OBRERA (LAS PUENTES),2,88,39,49,10
VERACRUZ DE IGNACIO DE LA LLAVE,30,COATEPEC,038,CONSOLAPAN,4,1616,730,886,72
VERACRUZ DE IGNACIO DE LA LLAVE,30,COATEPEC,038,CUAUHTÉMOC,4,251,121,130,24
VERACRUZ DE IGNACIO DE LA LLAVE,30,COATEPEC,038,EL GRANDE,5,194,93,101,20
VERACRUZ DE IGNACIO DE LA LLAVE,30,COATEPEC,038,INGENIO DEL ROSARIO,4,54,28,26,5
VERACRUZ DE IGNACIO DE LA LLAVE,30,COATEPEC,038,LA CONCHA,2,189,82,107,12
VERACRUZ DE IGNACIO DE LA LLAVE,30,COATEPEC,038,LA ISLETA GRANDE,3,59,28,31,8
VERACRUZ DE IGNACIO DE LA LLAVE,30,COATEPEC,038,LA LAGUNA,3,120,63,57,13
VERACRUZ DE IGNACIO DE LA LLAVE,30,COATEPEC,038,LA ORDUÑA,4,256,129,127,21
VERACRUZ DE IGNACIO DE LA LLAVE,30,COATEPEC,038,LA PITAHAYA (CONGREGACIÓN ZONCUANTLA),9,1168,575,593,99
VERACRUZ DE IGNACIO DE LA LLAVE,30,COATEPEC,038,LAS LOMAS,4,387,184,203,25
VERACRUZ DE IGNACIO DE LA LLAVE,30,COATEPEC,038,LEALTAD INSTITUCIONAL,1,5,2,3,1
VERACRUZ DE IGNACIO DE LA LLAVE,30,COATEPEC,038,LOMA ALTA,1,4,2,2,1
VERACRUZ DE IGNACIO DE LA LLAVE,30,COATEPEC,038,MAHUIXTLÁN,5,942,433,509,56
VERACRUZ DE IGNACIO DE LA LLAVE,30,COATEPEC,038,MESA DEL LAUREL,3,22,10,12,3
VERACRUZ DE IGNACIO DE LA LLAVE,30,COATEPEC,038,MUNDO NUEVO,2,39,19,20,2
VERACRUZ DE IGNACIO DE LA LLAVE,30,COATEPEC,038,PACHO VIEJO,8,699,332,367,57
VERACRUZ DE IGNACIO DE LA LLAVE,30,COATEPEC,038,PUENTE SECO (CAMPO VIEJO),1,41,25,16,4
VERACRUZ DE IGNACIO DE LA LLAVE,30,COATEPEC,038,PUERTO RICO,5,105,56,49,12
VERACRUZ DE IGNACIO DE LA LLAVE,30,COATEPEC,038,SAN ALFONSO,2,11,7,4,2
VERACRUZ DE IGNACIO DE LA LLAVE,30,COATEPEC,038,TAPACHAPAN,2,68,31,37,10
VERACRUZ DE IGNACIO DE LA LLAVE,30,COATEPEC,038,TEPEAPULCO,2,28,15,13,3
VERACRUZ DE IGNACIO DE LA LLAVE,30,COATEPEC,038,TIERRA GRANDE,1,7,4,3,1
VERACRUZ DE IGNACIO DE LA LLAVE,30,COATEPEC,038,TUZAMAPAN,8,1496,772,724,84
VERACRUZ DE IGNACIO DE LA LLAVE,30,COATEPEC,038,VAQUERÍA,3,64,30,34,8
VERACRUZ DE IGNACIO DE LA LLAVE,30,COATEPEC,038,ZIMPIZAHUA,3,65,32,33,11
VERACRUZ DE IGNACIO DE LA LLAVE,30,COATZACOALCOS,039,ALLENDE,25,3609,1842,1767,188
VERACRUZ DE IGNACIO DE LA LLAVE,30,COATZACOALCOS,039,CINCO DE MAYO,3,100,51,49,6
VERACRUZ DE IGNACIO DE LA LLAVE,30,COATZACOALCOS,039,COATZACOALCOS,402,61741,30977,30764,5084
VERACRUZ DE IGNACIO DE LA LLAVE,30,COATZACOALCOS,039,COLORADO,3,160,75,85,14
VERACRUZ DE IGNACIO DE LA LLAVE,30,COATZACOALCOS,039,FRACCIONAMIENTO CIUDAD OLMECA,6,1490,702,788,70
VERACRUZ DE IGNACIO DE LA LLAVE,30,COATZACOALCOS,039,FRANCISCO VILLA,1,24,17,7,1
VERACRUZ DE IGNACIO DE LA LLAVE,30,COATZACOALCOS,039,GUILLERMO PRIETO (SANTA ROSA),4,334,175,159,19
VERACRUZ DE IGNACIO DE LA LLAVE,30,COATZACOALCOS,039,LA CANGREJERA (GAVILÁN SUR),1,56,25,31,3
VERACRUZ DE IGNACIO DE LA LLAVE,30,COATZACOALCOS,039,LA CANGREJERA DOS (GAVILÁN SUR AMPLIACIÓN),2,9,4,5,2
VERACRUZ DE IGNACIO DE LA LLAVE,30,COATZACOALCOS,039,LA ESPERANZA,3,108,65,43,8
VERACRUZ DE IGNACIO DE LA LLAVE,30,COATZACOALCOS,039,LAS BARRILLAS,4,559,248,311,32
VERACRUZ DE IGNACIO DE LA LLAVE,30,COATZACOALCOS,039,MUNDO NUEVO,8,1160,550,610,71
VERACRUZ DE IGNACIO DE LA LLAVE,30,COATZACOALCOS,039,PASO A DESNIVEL,1,129,61,68,6
VERACRUZ DE IGNACIO DE LA LLAVE,30,COATZINTLA,040,ARROYO FLORIDO,2,36,17,19,3
VERACRUZ DE IGNACIO DE LA LLAVE,30,COATZINTLA,040,BENITO JUÁREZ,2,67,29,38,5
VERACRUZ DE IGNACIO DE LA LLAVE,30,COATZINTLA,040,COATZINTLA,49,6010,2976,3034,381
VERACRUZ DE IGNACIO DE LA LLAVE,30,COATZINTLA,040,COLONIA MIGUEL HIDALGO,3,128,64,64,10
VERACRUZ DE IGNACIO DE LA LLAVE,30,COATZINTLA,040,CORRALILLOS,4,253,117,136,16
VERACRUZ DE IGNACIO DE LA LLAVE,30,COATZINTLA,040,EL CHOTE,2,50,19,31,7
VERACRUZ DE IGNACIO DE LA LLAVE,30,COATZINTLA,040,EL VIZCAÍNO,3,119,56,63,8
VERACRUZ DE IGNACIO DE LA LLAVE,30,COATZINTLA,040,FURBEROS,3,63,33,30,5
VERACRUZ DE IGNACIO DE LA LLAVE,30,COATZINTLA,040,GONZÁLEZ ORTEGA,3,63,32,31,5
VERACRUZ DE IGNACIO DE LA LLAVE,30,COATZINTLA,040,GUADALUPE VICTORIA,4,205,109,96,16
VERACRUZ DE IGNACIO DE LA LLAVE,30,COATZINTLA,040,LA FLORIDA,1,5,1,4,1
VERACRUZ DE IGNACIO DE LA LLAVE,30,COATZINTLA,040,LA LAJA,3,174,86,88,12
VERACRUZ DE IGNACIO DE LA LLAVE,30,COATZINTLA,040,LAS PALMAS,2,64,39,25,4
VERACRUZ DE IGNACIO DE LA LLAVE,30,COATZINTLA,040,MANUEL MARÍA CONTRERAS,5,452,203,249,29
VERACRUZ DE IGNACIO DE LA LLAVE,30,COATZINTLA,040,PALMA SOLA,6,550,274,276,39
VERACRUZ DE IGNACIO DE LA LLAVE,30,COATZINTLA,040,PALMAR DE ZAPATA,2,19,9,10,3
VERACRUZ DE IGNACIO DE LA LLAVE,30,COATZINTLA,040,RANCHO NUEVO,3,168,73,95,11
VERACRUZ DE IGNACIO DE LA LLAVE,30,COATZINTLA,040,SAN FERNANDO COAPECHAPA,4,149,79,70,12
VERACRUZ DE IGNACIO DE LA LLAVE,30,COATZINTLA,040,SANTA MARÍA,2,70,34,36,7
VERACRUZ DE IGNACIO DE LA LLAVE,30,COATZINTLA,040,TRONCONES Y POTRERILLOS,3,449,214,235,37
VERACRUZ DE IGNACIO DE LA LLAVE,30,COATZINTLA,040,ÚRSULO GALVÁN,2,39,17,22,4
VERACRUZ DE IGNACIO DE LA LLAVE,30,COETZALA,041,COETZALA,4,413,211,202,30
VERACRUZ DE IGNACIO DE LA LLAVE,30,COETZALA,041,COETZAPOTITLA,4,209,104,105,14
VERACRUZ DE IGNACIO DE LA LLAVE,30,COETZALA,041,MIRADOR DE SAN ANTONIO,1,7,5,2,1
VERACRUZ DE IGNACIO DE LA LLAVE,30,COLIPA,042,CERRO DEL AGUACATE,3,173,97,76,9
VERACRUZ DE IGNACIO DE LA LLAVE,30,COLIPA,042,CERRO DEL TIGRE,3,33,19,14,4
VERACRUZ DE IGNACIO DE LA LLAVE,30,COLIPA,042,CERRO GORDO,1,8,4,4,1
VERACRUZ DE IGNACIO DE LA LLAVE,30,COLIPA,042,COLIPA,6,499,242,257,38
VERACRUZ DE IGNACIO DE LA LLAVE,30,COLIPA,042,COLONIA TEODORO A. DEHESA,3,91,45,46,8
VERACRUZ DE IGNACIO DE LA LLAVE,30,COLIPA,042,EL OCOTILLO,3,28,16,12,4
VERACRUZ DE IGNACIO DE LA LLAVE,30,COLIPA,042,EL VENCEDOR,2,23,8,15,3
VERACRUZ DE IGNACIO DE LA LLAVE,30,COLIPA,042,EL ZAPOTAL,2,14,8,6,2
VERACRUZ DE IGNACIO DE LA LLAVE,30,COLIPA,042,LA FLOREÑA,2,23,15,8,3
VERACRUZ DE IGNACIO DE LA LLAVE,30,COLIPA,042,LA PAHUA,1,21,6,15,2
VERACRUZ DE IGNACIO DE LA LLAVE,30,COLIPA,042,LA PIEDRILLA,3,72,33,39,6
VERACRUZ DE IGNACIO DE LA LLAVE,30,COLIPA,042,LAS PARCELAS,1,4,2,2,1
VERACRUZ DE IGNACIO DE LA LLAVE,30,COLIPA,042,PLAN DE SAN LUIS,1,2,0,2,1
VERACRUZ DE IGNACIO DE LA LLAVE,30,COMAPA,043,AGUA SANTA,3,50,24,26,4
VERACRUZ DE IGNACIO DE LA LLAVE,30,COMAPA,043,BOCA DEL MONTE,15,1112,582,530,51
VERACRUZ DE IGNACIO DE LA LLAVE,30,COMAPA,043,CERRITOS,4,316,162,154,16
VERACRUZ DE IGNACIO DE LA LLAVE,30,COMAPA,043,COMALCUAVILT,2,18,6,12,2
VERACRUZ DE IGNACIO DE LA LLAVE,30,COMAPA,043,COMAPA,4,439,240,199,26
VERACRUZ DE IGNACIO DE LA LLAVE,30,COMAPA,043,CORRAL DE PIEDRA (CORRALILLO),3,65,24,41,4
VERACRUZ DE IGNACIO DE LA LLAVE,30,COMAPA,043,EL CIMARRÓN,1,4,1,3,1
VERACRUZ DE IGNACIO DE LA LLAVE,30,COMAPA,043,EL COYOL,3,57,26,31,4
VERACRUZ DE IGNACIO DE LA LLAVE,30,COMAPA,043,EL JOBO (JOBO VIEJO),5,252,135,117,13
VERACRUZ DE IGNACIO DE LA LLAVE,30,COMAPA,043,EL LIMÓN,2,39,16,23,3
VERACRUZ DE IGNACIO DE LA LLAVE,30,COMAPA,043,EL RECUERDO,1,4,4,0,1
VERACRUZ DE IGNACIO DE LA LLAVE,30,COMAPA,043,LA DIVINA PROVIDENCIA,2,12,5,7,2
VERACRUZ DE IGNACIO DE LA LLAVE,30,COMAPA,043,LA LUZ,1,14,8,6,2
VERACRUZ DE IGNACIO DE LA LLAVE,30,COMAPA,043,LA NUEVA REFORMA (LOS VALLEJO),1,22,8,14,1
VERACRUZ DE IGNACIO DE LA LLAVE,30,COMAPA,043,LA PITAHAYA,1,8,5,3,1
VERACRUZ DE IGNACIO DE LA LLAVE,30,COMAPA,043,MATA HIGUERA,2,18,10,8,2
VERACRUZ DE IGNACIO DE LA LLAVE,30,COMAPA,043,MAZAXTLA,2,49,19,30,3
VERACRUZ DE IGNACIO DE LA LLAVE,30,COMAPA,043,MONTE VERDE,2,16,5,11,2
VERACRUZ DE IGNACIO DE LA LLAVE,30,COMAPA,043,PASO CARRETAS,3,27,11,16,4
VERACRUZ DE IGNACIO DE LA LLAVE,30,COMAPA,043,PASO PIMIENTA,3,136,60,76,6
VERACRUZ DE IGNACIO DE LA LLAVE,30,COMAPA,043,POCHOTE NUEVO,3,102,50,52,5
VERACRUZ DE IGNACIO DE LA LLAVE,30,COMAPA,043,POTRERO DE LA CRUZ,2,21,12,9,2
VERACRUZ DE IGNACIO DE LA LLAVE,30,COMAPA,043,RANCHO NUEVO,4,74,30,44,5
VERACRUZ DE IGNACIO DE LA LLAVE,30,COMAPA,043,SAN CRISTÓBAL,3,57,27,30,4
VERACRUZ DE IGNACIO DE LA LLAVE,30,COMAPA,043,SAN FELIPE DE JESÚS,4,137,72,65,10
VERACRUZ DE IGNACIO DE LA LLAVE,30,COMAPA,043,SAN FRANCISCO NACAXTLE,3,199,89,110,11
VERACRUZ DE IGNACIO DE LA LLAVE,30,COMAPA,043,SONORA,4,468,246,222,21
VERACRUZ DE IGNACIO DE LA LLAVE,30,COMAPA,043,TENEXTLA,3,59,24,35,4
VERACRUZ DE IGNACIO DE LA LLAVE,30,COMAPA,043,VISTA HERMOSA,2,28,13,15,3
VERACRUZ DE IGNACIO DE LA LLAVE,30,COMAPA,043,VISTA HERMOSA (LA PITAHAYA),3,47,24,23,4
VERACRUZ DE IGNACIO DE LA LLAVE,30,COMAPA,043,XONOTLA,5,148,77,71,9
VERACRUZ DE IGNACIO DE LA LLAVE,30,CÓRDOBA,044,ACAYOTLA,1,24,12,12,2
VERACRUZ DE IGNACIO DE LA LLAVE,30,CÓRDOBA,044,AEROPISTA,1,22,8,14,1
VERACRUZ DE IGNACIO DE LA LLAVE,30,CÓRDOBA,044,AGUSTÍN MILLÁN,4,275,133,142,14
VERACRUZ DE IGNACIO DE LA LLAVE,30,CÓRDOBA,044,BERLÍN,2,73,38,35,6
VERACRUZ DE IGNACIO DE LA LLAVE,30,CÓRDOBA,044,CERVANTES Y LOZADA (SANTA ROSA),1,6,5,1,1
VERACRUZ DE IGNACIO DE LA LLAVE,30,CÓRDOBA,044,COLONIA AGRÍCOLA SANTA MARÍA,2,82,44,38,4
VERACRUZ DE IGNACIO DE LA LLAVE,30,CÓRDOBA,044,COLORINES,2,287,149,138,16
VERACRUZ DE IGNACIO DE LA LLAVE,30,CÓRDOBA,044,CÓRDOBA,306,43116,22400,20716,3695
VERACRUZ DE IGNACIO DE LA LLAVE,30,CÓRDOBA,044,COSALTEPEC,1,8,5,3,1
VERACRUZ DE IGNACIO DE LA LLAVE,30,CÓRDOBA,044,CUAUHTÉMOC,2,29,13,16,4
VERACRUZ DE IGNACIO DE LA LLAVE,30,CÓRDOBA,044,EL BAJÍO,4,310,158,152,12
VERACRUZ DE IGNACIO DE LA LLAVE,30,CÓRDOBA,044,EL PALENQUE PALOTAL,4,336,157,179,19
VERACRUZ DE IGNACIO DE LA LLAVE,30,CÓRDOBA,044,EL PORVENIR,4,685,341,344,31
VERACRUZ DE IGNACIO DE LA LLAVE,30,CÓRDOBA,044,EL PUEBLITO (CRUCERO NACIONAL),1,56,25,31,4
VERACRUZ DE IGNACIO DE LA LLAVE,30,CÓRDOBA,044,GUADALUPE BARREAL,1,183,92,91,12
VERACRUZ DE IGNACIO DE LA LLAVE,30,CÓRDOBA,044,LA LAGUNILLA,2,66,29,37,4
VERACRUZ DE IGNACIO DE LA LLAVE,30,CÓRDOBA,044,LA LUZ FRANCISCO I. MADERO (SAN ROMÁN),4,1005,500,505,40
VERACRUZ DE IGNACIO DE LA LLAVE,30,CÓRDOBA,044,LA LUZ Y TRINIDAD PALOTAL,1,57,26,31,4
VERACRUZ DE IGNACIO DE LA LLAVE,30,CÓRDOBA,044,LA PALMA (TERCERA MANZANA DEL BARREAL),2,55,26,29,4
VERACRUZ DE IGNACIO DE LA LLAVE,30,CÓRDOBA,044,LOMA CHICA DEL GALLEGO,2,28,17,11,2
VERACRUZ DE IGNACIO DE LA LLAVE,30,CÓRDOBA,044,MARGARITA MORAN VELIZ,1,28,12,16,2
VERACRUZ DE IGNACIO DE LA LLAVE,30,CÓRDOBA,044,MATLAQUIÁHUITL,1,20,8,12,1
VERACRUZ DE IGNACIO DE LA LLAVE,30,CÓRDOBA,044,MIGUEL AGUILAR,3,209,109,100,11
VERACRUZ DE IGNACIO DE LA LLAVE,30,CÓRDOBA,044,OJO DE AGUA (EL GALLEGO),2,56,29,27,4
VERACRUZ DE IGNACIO DE LA LLAVE,30,CÓRDOBA,044,PAREDONES,3,178,90,88,11
VERACRUZ DE IGNACIO DE LA LLAVE,30,CÓRDOBA,044,PUENTE BARRANCA HONDA,1,120,66,54,7
VERACRUZ DE IGNACIO DE LA LLAVE,30,CÓRDOBA,044,QUINTA MANZANA DEL BARREAL,2,57,29,28,5
VERACRUZ DE IGNACIO DE LA LLAVE,30,CÓRDOBA,044,RANCHO QUEMADO (CERRO LA TOTOLA),1,6,3,3,1
VERACRUZ DE IGNACIO DE LA LLAVE,30,CÓRDOBA,044,SAN APARICIO BUENA VISTA,3,60,29,31,5
VERACRUZ DE IGNACIO DE LA LLAVE,30,CÓRDOBA,044,SAN ISIDRO PALOTAL,3,122,67,55,11
VERACRUZ DE IGNACIO DE LA LLAVE,30,CÓRDOBA,044,SAN JOSÉ DE ABAJO [UNIDAD HABITACIONAL],1,11,6,5,2
VERACRUZ DE IGNACIO DE LA LLAVE,30,CÓRDOBA,044,SAN JOSÉ DE TAPIA,5,886,437,449,40
VERACRUZ DE IGNACIO DE LA LLAVE,30,CÓRDOBA,044,SAN JOSÉ LOMA GRANDE,4,253,132,121,15
VERACRUZ DE IGNACIO DE LA LLAVE,30,CÓRDOBA,044,SAN MATÍAS,2,186,84,102,10
VERACRUZ DE IGNACIO DE LA LLAVE,30,CÓRDOBA,044,SAN PEDRO,2,17,10,7,2
VERACRUZ DE IGNACIO DE LA LLAVE,30,CÓRDOBA,044,SAN RAFAEL CALERÍA,4,554,279,275,33
VERACRUZ DE IGNACIO DE LA LLAVE,30,CÓRDOBA,044,SANTA ELENA,4,284,135,149,18
VERACRUZ DE IGNACIO DE LA LLAVE,30,CÓRDOBA,044,SANTA ELENA (CONGREGACIÓN EL BARREAL),2,235,121,114,9
VERACRUZ DE IGNACIO DE LA LLAVE,30,CÓRDOBA,044,TECAMA CALERÍA (SABANA LARGA),4,124,63,61,8
VERACRUZ DE IGNACIO DE LA LLAVE,30,CÓRDOBA,044,TINAJITAS,3,19,10,9,3
VERACRUZ DE IGNACIO DE LA LLAVE,30,CÓRDOBA,044,VEINTE DE NOVIEMBRE,2,166,88,78,9
VERACRUZ DE IGNACIO DE LA LLAVE,30,CÓRDOBA,044,ZACATEPEC,2,50,28,22,4
VERACRUZ DE IGNACIO DE LA LLAVE,30,COSAMALOAPAN DE CARPIO,045,AMPLIACIÓN RAÚL SATURNINO,2,132,65,67,9
VERACRUZ DE IGNACIO DE LA LLAVE,30,COSAMALOAPAN DE CARPIO,045,BENITO JUÁREZ,2,47,19,28,8
VERACRUZ DE IGNACIO DE LA LLAVE,30,COSAMALOAPAN DE CARPIO,045,CALATEPEC (LA HERRADURA),2,33,15,18,2
VERACRUZ DE IGNACIO DE LA LLAVE,30,COSAMALOAPAN DE CARPIO,045,CERRO COLORADO,2,31,10,21,2
VERACRUZ DE IGNACIO DE LA LLAVE,30,COSAMALOAPAN DE CARPIO,045,COSAMALOAPAN,52,7372,3644,3728,551
VERACRUZ DE IGNACIO DE LA LLAVE,30,COSAMALOAPAN DE CARPIO,045,EL BOSQUE,1,8,4,4,1
VERACRUZ DE IGNACIO DE LA LLAVE,30,COSAMALOAPAN DE CARPIO,045,EL COYOL (KILÓMETRO 11),3,45,25,20,6
VERACRUZ DE IGNACIO DE LA LLAVE,30,COSAMALOAPAN DE CARPIO,045,EL MIRADOR,3,70,37,33,7
VERACRUZ DE IGNACIO DE LA LLAVE,30,COSAMALOAPAN DE CARPIO,045,EL PEDREGAL,1,9,4,5,1
VERACRUZ DE IGNACIO DE LA LLAVE,30,COSAMALOAPAN DE CARPIO,045,EL ROBLE,1,14,6,8,1
VERACRUZ DE IGNACIO DE LA LLAVE,30,COSAMALOAPAN DE CARPIO,045,EL SALADERO,2,19,10,9,2
VERACRUZ DE IGNACIO DE LA LLAVE,30,COSAMALOAPAN DE CARPIO,045,ESTACIÓN COCUITE,2,12,10,2,3
VERACRUZ DE IGNACIO DE LA LLAVE,30,COSAMALOAPAN DE CARPIO,045,ESTACIÓN TUXTILLA,2,67,28,39,6
VERACRUZ DE IGNACIO DE LA LLAVE,30,COSAMALOAPAN DE CARPIO,045,FERNANDO LÓPEZ ARIAS,4,154,84,70,10
VERACRUZ DE IGNACIO DE LA LLAVE,30,COSAMALOAPAN DE CARPIO,045,GABINO BARREDA,10,1214,620,594,105
VERACRUZ DE IGNACIO DE LA LLAVE,30,COSAMALOAPAN DE CARPIO,045,GLORIA DE COAPA (EL JOBO),2,33,17,16,3
VERACRUZ DE IGNACIO DE LA LLAVE,30,COSAMALOAPAN DE CARPIO,045,KILÓMETRO VEINTE,1,5,2,3,1
VERACRUZ DE IGNACIO DE LA LLAVE,30,COSAMALOAPAN DE CARPIO,045,LA LAJA,3,40,20,20,4
VERACRUZ DE IGNACIO DE LA LLAVE,30,COSAMALOAPAN DE CARPIO,045,LAS PEÑITAS,3,139,66,73,13
VERACRUZ DE IGNACIO DE LA LLAVE,30,COSAMALOAPAN DE CARPIO,045,LÁZARO CÁRDENAS (TIERRA ALTA),2,19,12,7,2
VERACRUZ DE IGNACIO DE LA LLAVE,30,COSAMALOAPAN DE CARPIO,045,LOS BÁLSAMOS,3,84,44,40,9
VERACRUZ DE IGNACIO DE LA LLAVE,30,COSAMALOAPAN DE CARPIO,045,NOPALTEPEC,6,541,272,269,37
VERACRUZ DE IGNACIO DE LA LLAVE,30,COSAMALOAPAN DE CARPIO,045,NUEVO CALATEPEC (EL ONCE),2,46,21,25,3
VERACRUZ DE IGNACIO DE LA LLAVE,30,COSAMALOAPAN DE CARPIO,045,PARAÍSO NOVILLERO,7,510,282,228,39
VERACRUZ DE IGNACIO DE LA LLAVE,30,COSAMALOAPAN DE CARPIO,045,PASO NUEVO,1,19,10,9,2
VERACRUZ DE IGNACIO DE LA LLAVE,30,COSAMALOAPAN DE CARPIO,045,PLAN BONITO,2,37,23,14,3
VERACRUZ DE IGNACIO DE LA LLAVE,30,COSAMALOAPAN DE CARPIO,045,POBLADO DOS (AMPLIACIÓN PIEDRAS NEGRAS),6,614,307,307,36
VERACRUZ DE IGNACIO DE LA LLAVE,30,COSAMALOAPAN DE CARPIO,045,SAN ANTONIO TEXAS,4,155,66,89,16
VERACRUZ DE IGNACIO DE LA LLAVE,30,COSAMALOAPAN DE CARPIO,045,SAN FRANCISCO (OYOZONTLE),4,162,76,86,15
VERACRUZ DE IGNACIO DE LA LLAVE,30,COSAMALOAPAN DE CARPIO,045,SAN ISIDRO,2,48,23,25,4
VERACRUZ DE IGNACIO DE LA LLAVE,30,COSAMALOAPAN DE CARPIO,045,SANTA CRUZ,2,101,42,59,7
VERACRUZ DE IGNACIO DE LA LLAVE,30,COSAMALOAPAN DE CARPIO,045,VEINTE DE NOVIEMBRE,1,5,1,4,1
VERACRUZ DE IGNACIO DE LA LLAVE,30,COSAUTLÁN DE CARVAJAL,046,CASA QUEMADA,2,62,34,28,6
VERACRUZ DE IGNACIO DE LA LLAVE,30,COSAUTLÁN DE CARVAJAL,046,COABOSTO,2,46,25,21,3
VERACRUZ DE IGNACIO DE LA LLAVE,30,COSAUTLÁN DE CARVAJAL,046,COSAUTLÁN DE CARVAJAL,11,1107,530,577,78
VERACRUZ DE IGNACIO DE LA LLAVE,30,COSAUTLÁN DE CARVAJAL,046,EMILIANO ZAPATA,4,236,111,125,15
VERACRUZ DE IGNACIO DE LA LLAVE,30,COSAUTLÁN DE CARVAJAL,046,HUEHUETECPAN,2,54,33,21,4
VERACRUZ DE IGNACIO DE LA LLAVE,30,COSAUTLÁN DE CARVAJAL,046,JUANANTONTLA,3,49,24,25,4
VERACRUZ DE IGNACIO DE LA LLAVE,30,COSAUTLÁN DE CARVAJAL,046,LA GLORIA,3,47,24,23,4
VERACRUZ DE IGNACIO DE LA LLAVE,30,COSAUTLÁN DE CARVAJAL,046,LA LAGUNILLA,2,28,16,12,4
VERACRUZ DE IGNACIO DE LA LLAVE,30,COSAUTLÁN DE CARVAJAL,046,LA REFORMA,2,66,31,35,5
VERACRUZ DE IGNACIO DE LA LLAVE,30,COSAUTLÁN DE CARVAJAL,046,LAS LOMAS,2,40,27,13,3
VERACRUZ DE IGNACIO DE LA LLAVE,30,COSAUTLÁN DE CARVAJAL,046,LIMONES,5,451,239,212,31
VERACRUZ DE IGNACIO DE LA LLAVE,30,COSAUTLÁN DE CARVAJAL,046,LOMA DE ORO,1,10,1,9,1
VERACRUZ DE IGNACIO DE LA LLAVE,30,COSAUTLÁN DE CARVAJAL,046,MATA REDONDA,2,20,8,12,2
VERACRUZ DE IGNACIO DE LA LLAVE,30,COSAUTLÁN DE CARVAJAL,046,NARANJALES,1,27,8,19,3
VERACRUZ DE IGNACIO DE LA LLAVE,30,COSAUTLÁN DE CARVAJAL,046,NOVILLERO,1,13,7,6,1
VERACRUZ DE IGNACIO DE LA LLAVE,30,COSAUTLÁN DE CARVAJAL,046,PALZOQUITIPAN,2,36,19,17,3
VERACRUZ DE IGNACIO DE LA LLAVE,30,COSAUTLÁN DE CARVAJAL,046,PIEDRA PARADA,4,231,108,123,17
VERACRUZ DE IGNACIO DE LA LLAVE,30,COSAUTLÁN DE CARVAJAL,046,RANCHO NUEVO (AMATITLA),1,5,1,4,1
VERACRUZ DE IGNACIO DE LA LLAVE,30,COSAUTLÁN DE CARVAJAL,046,SAN JOSÉ TLAPÉXCATL,2,36,17,19,3
VERACRUZ DE IGNACIO DE LA LLAVE,30,COSAUTLÁN DE CARVAJAL,046,SAN MIGUEL TLAPÉXCATL,4,174,86,88,12
VERACRUZ DE IGNACIO DE LA LLAVE,30,COSAUTLÁN DE CARVAJAL,046,VAQUERÍA,3,151,68,83,11
VERACRUZ DE IGNACIO DE LA LLAVE,30,COSAUTLÁN DE CARVAJAL,046,XALISCUILO,2,25,13,12,3
VERACRUZ DE IGNACIO DE LA LLAVE,30,COSCOMATEPEC,047,BARRIO SAN JOSÉ,1,29,10,19,2
VERACRUZ DE IGNACIO DE LA LLAVE,30,COSCOMATEPEC,047,COSCOMATEPEC DE BRAVO,25,5129,2622,2507,313
VERACRUZ DE IGNACIO DE LA LLAVE,30,COSCOMATEPEC,047,CUAHUTEPEC LA QUINA,3,136,69,67,8
VERACRUZ DE IGNACIO DE LA LLAVE,30,COSCOMATEPEC,047,CUAUTOLONTITLA,3,101,44,57,7
VERACRUZ DE IGNACIO DE LA LLAVE,30,COSCOMATEPEC,047,CUCHAPA,2,75,44,31,3
VERACRUZ DE IGNACIO DE LA LLAVE,30,COSCOMATEPEC,047,CUIYACHAPA,4,714,373,341,34
VERACRUZ DE IGNACIO DE LA LLAVE,30,COSCOMATEPEC,047,DOS CAMINOS,2,30,17,13,2
VERACRUZ DE IGNACIO DE LA LLAVE,30,COSCOMATEPEC,047,DURAZNILLO,2,46,21,25,3
VERACRUZ DE IGNACIO DE LA LLAVE,30,COSCOMATEPEC,047,EL ARENAL,3,25,13,12,3
VERACRUZ DE IGNACIO DE LA LLAVE,30,COSCOMATEPEC,047,EL ASERRADERO,3,81,38,43,4
VERACRUZ DE IGNACIO DE LA LLAVE,30,COSCOMATEPEC,047,EL DURAZNO,2,43,21,22,3
VERACRUZ DE IGNACIO DE LA LLAVE,30,COSCOMATEPEC,047,EL OLVIDO (SAN FRANCISCO),3,136,73,63,9
VERACRUZ DE IGNACIO DE LA LLAVE,30,COSCOMATEPEC,047,GONZALO VÁZQUEZ VELA,3,247,121,126,13
VERACRUZ DE IGNACIO DE LA LLAVE,30,COSCOMATEPEC,047,HUILOTLA,6,322,176,146,20
VERACRUZ DE IGNACIO DE LA LLAVE,30,COSCOMATEPEC,047,IXTAYUCA (SAN NICOLÁS),3,277,135,142,15
VERACRUZ DE IGNACIO DE LA LLAVE,30,COSCOMATEPEC,047,IXTEPEC,2,67,38,29,3
VERACRUZ DE IGNACIO DE LA LLAVE,30,COSCOMATEPEC,047,LA HACIENDA,1,7,3,4,1
VERACRUZ DE IGNACIO DE LA LLAVE,30,COSCOMATEPEC,047,LÁZARO CÁRDENAS,3,524,266,258,23
VERACRUZ DE IGNACIO DE LA LLAVE,30,COSCOMATEPEC,047,LINDA VISTA,3,45,19,26,4
VERACRUZ DE IGNACIO DE LA LLAVE,30,COSCOMATEPEC,047,MANZANATITLA (EL BOQUERÓN),2,33,20,13,3
VERACRUZ DE IGNACIO DE LA LLAVE,30,COSCOMATEPEC,047,MAQUILIXHUATLA,3,28,14,14,3
VERACRUZ DE IGNACIO DE LA LLAVE,30,COSCOMATEPEC,047,MIRADOR IZOTITLA (MIRADORES),1,9,3,6,1
VERACRUZ DE IGNACIO DE LA LLAVE,30,COSCOMATEPEC,047,MOYOAPAN CHICO,2,89,50,39,5
VERACRUZ DE IGNACIO DE LA LLAVE,30,COSCOMATEPEC,047,MOYOAPAN GRANDE,1,16,9,7,1
VERACRUZ DE IGNACIO DE LA LLAVE,30,COSCOMATEPEC,047,NICANOR ESPEJO,2,110,50,60,7
VERACRUZ DE IGNACIO DE LA LLAVE,30,COSCOMATEPEC,047,POTRERILLO,5,262,133,129,14
VERACRUZ DE IGNACIO DE LA LLAVE,30,COSCOMATEPEC,047,SAN JOSÉ,2,72,36,36,6
VERACRUZ DE IGNACIO DE LA LLAVE,30,COSCOMATEPEC,047,TAMAZOLAPA,3,49,18,31,4
VERACRUZ DE IGNACIO DE LA LLAVE,30,COSCOMATEPEC,047,TECÓAC,2,31,18,13,3
VERACRUZ DE IGNACIO DE LA LLAVE,30,COSCOMATEPEC,047,TENIXTEPEC,7,717,376,341,36
VERACRUZ DE IGNACIO DE LA LLAVE,30,COSCOMATEPEC,047,TETELZINGO,5,1198,586,612,59
VERACRUZ DE IGNACIO DE LA LLAVE,30,COSCOMATEPEC,047,TETLAXCO,3,372,176,196,20
VERACRUZ DE IGNACIO DE LA LLAVE,30,COSCOMATEPEC,047,TLACUILOLOXTLA,1,5,3,2,1
VERACRUZ DE IGNACIO DE LA LLAVE,30,COSCOMATEPEC,047,TLALTENGO,4,241,131,110,13
VERACRUZ DE IGNACIO DE LA LLAVE,30,COSCOMATEPEC,047,TOZONGO,3,211,103,108,11
VERACRUZ DE IGNACIO DE LA LLAVE,30,COSCOMATEPEC,047,TRES AGUAS,2,140,68,72,7
VERACRUZ DE IGNACIO DE LA LLAVE,30,COSCOMATEPEC,047,ÚRSULO GALVÁN,3,86,38,48,7
VERACRUZ DE IGNACIO DE LA LLAVE,30,COSCOMATEPEC,047,XALATLACO,3,265,135,130,16
VERACRUZ DE IGNACIO DE LA LLAVE,30,COSCOMATEPEC,047,XALTENANGO,2,56,28,28,4
VERACRUZ DE IGNACIO DE LA LLAVE,30,COSCOMATEPEC,047,XOCOTLA,8,2208,1124,1084,89
VERACRUZ DE IGNACIO DE LA LLAVE,30,COSCOMATEPEC,047,ZACATLA,4,554,282,272,22
VERACRUZ DE IGNACIO DE LA LLAVE,30,COSCOMATEPEC,047,ZACATLAPA,2,49,24,25,4
VERACRUZ DE IGNACIO DE LA LLAVE,30,COSOLEACAQUE,048,BARRANCAS (BUENOS AIRES),8,596,315,281,34
VERACRUZ DE IGNACIO DE LA LLAVE,30,COSOLEACAQUE,048,CALZADAS (KILÓMETRO 14),4,284,143,141,22
VERACRUZ DE IGNACIO DE LA LLAVE,30,COSOLEACAQUE,048,CANTICAS,3,223,124,99,14
VERACRUZ DE IGNACIO DE LA LLAVE,30,COSOLEACAQUE,048,COACOTLA,12,1388,682,706,84
VERACRUZ DE IGNACIO DE LA LLAVE,30,COSOLEACAQUE,048,COSOLEACAQUE,68,11715,5865,5850,578
VERACRUZ DE IGNACIO DE LA LLAVE,30,COSOLEACAQUE,048,EJIDO LA BOMBA,2,54,27,27,5
VERACRUZ DE IGNACIO DE LA LLAVE,30,COSOLEACAQUE,048,EL ARENAL,2,86,40,46,4
VERACRUZ DE IGNACIO DE LA LLAVE,30,COSOLEACAQUE,048,EL CASCAJAL,2,25,14,11,2
VERACRUZ DE IGNACIO DE LA LLAVE,30,COSOLEACAQUE,048,EL DORADO (AMPLIACIÓN ESTERO DEL PANTANO),1,10,4,6,1
VERACRUZ DE IGNACIO DE LA LLAVE,30,COSOLEACAQUE,048,EL KILÓMETRO DIECISIETE,3,61,24,37,5
VERACRUZ DE IGNACIO DE LA LLAVE,30,COSOLEACAQUE,048,EL LIMÓN,1,5,3,2,1
VERACRUZ DE IGNACIO DE LA LLAVE,30,COSOLEACAQUE,048,EL NARANJITO,3,365,167,198,18
VERACRUZ DE IGNACIO DE LA LLAVE,30,COSOLEACAQUE,048,EL NARANJO,3,381,200,181,19
VERACRUZ DE IGNACIO DE LA LLAVE,30,COSOLEACAQUE,048,EL POTRERILLO,1,5,2,3,1
VERACRUZ DE IGNACIO DE LA LLAVE,30,COSOLEACAQUE,048,ESTERO DEL PANTANO,5,528,265,263,31
VERACRUZ DE IGNACIO DE LA LLAVE,30,COSOLEACAQUE,048,FERNANDO GUTIÉRREZ BARRIOS,2,30,17,13,3
VERACRUZ DE IGNACIO DE LA LLAVE,30,COSOLEACAQUE,048,FRACCIONAMIENTO LAS ARBOLEDAS,1,7,3,4,1
VERACRUZ DE IGNACIO DE LA LLAVE,30,COSOLEACAQUE,048,FRACCIONAMIENTO LOS LIMONES,2,30,12,18,3
VERACRUZ DE IGNACIO DE LA LLAVE,30,COSOLEACAQUE,048,FRACCIONAMIENTO LOS MANGOS,1,179,89,90,8
VERACRUZ DE IGNACIO DE LA LLAVE,30,COSOLEACAQUE,048,FRACCIONAMIENTO LOS PRADOS,1,69,40,29,6
VERACRUZ DE IGNACIO DE LA LLAVE,30,COSOLEACAQUE,048,HERMENEGILDO J. ALDANA,2,30,12,18,2
VERACRUZ DE IGNACIO DE LA LLAVE,30,COSOLEACAQUE,048,JOSÉ F. GUTIÉRREZ,10,934,424,510,55
VERACRUZ DE IGNACIO DE LA LLAVE,30,COSOLEACAQUE,048,LA ESPERANZA,1,22,12,10,2
VERACRUZ DE IGNACIO DE LA LLAVE,30,COSOLEACAQUE,048,LAS JACARANDAS,1,40,21,19,3
VERACRUZ DE IGNACIO DE LA LLAVE,30,COSOLEACAQUE,048,LÁZARO CÁRDENAS,1,9,2,7,2
VERACRUZ DE IGNACIO DE LA LLAVE,30,COSOLEACAQUE,048,LOMA BELLA,1,21,14,7,1
VERACRUZ DE IGNACIO DE LA LLAVE,30,COSOLEACAQUE,048,LOMA DE ACHOTA,2,14,7,7,2
VERACRUZ DE IGNACIO DE LA LLAVE,30,COSOLEACAQUE,048,LOMAS DE CAMALOTAL,1,10,6,4,1
VERACRUZ DE IGNACIO DE LA LLAVE,30,COSOLEACAQUE,048,MINATITLÁN,16,1853,919,934,108
VERACRUZ DE IGNACIO DE LA LLAVE,30,COSOLEACAQUE,048,MONTE ALTO,4,101,48,53,10
VERACRUZ DE IGNACIO DE LA LLAVE,30,COSOLEACAQUE,048,OJO DE AGUA,2,24,9,15,3
VERACRUZ DE IGNACIO DE LA LLAVE,30,COSOLEACAQUE,048,PASO LA LAJILLA,2,37,22,15,3
VERACRUZ DE IGNACIO DE LA LLAVE,30,COSOLEACAQUE,048,PREDIO JARDÍN DE LAS FLORES,1,11,7,4,1
VERACRUZ DE IGNACIO DE LA LLAVE,30,COSOLEACAQUE,048,SAN ANTONIO,4,212,102,110,16
VERACRUZ DE IGNACIO DE LA LLAVE,30,COSOLEACAQUE,048,SAN PEDRO MÁRTIR,9,976,463,513,51
VERACRUZ DE IGNACIO DE LA LLAVE,30,COSOLEACAQUE,048,TULAPAN,2,18,8,10,2
VERACRUZ DE IGNACIO DE LA LLAVE,30,COSOLEACAQUE,048,ZACATAL VICTORIA,2,50,21,29,4
VERACRUZ DE IGNACIO DE LA LLAVE,30,COTAXTLA,049,BAJO GRANDE,3,62,37,25,4
VERACRUZ DE IGNACIO DE LA LLAVE,30,COTAXTLA,049,BAJOS DE TLACHICONAL,3,153,71,82,7
VERACRUZ DE IGNACIO DE LA LLAVE,30,COTAXTLA,049,CERRO ALTO,3,92,55,37,6
VERACRUZ DE IGNACIO DE LA LLAVE,30,COTAXTLA,049,CERRO DEL FRAYLE,4,13,9,4,4
VERACRUZ DE IGNACIO DE LA LLAVE,30,COTAXTLA,049,CHOVERNERO,2,20,8,12,2
VERACRUZ DE IGNACIO DE LA LLAVE,30,COTAXTLA,049,COLONIA EJIDAL,2,66,37,29,5
VERACRUZ DE IGNACIO DE LA LLAVE,30,COTAXTLA,049,COLONIA EL CARMEN,2,22,10,12,2
VERACRUZ DE IGNACIO DE LA LLAVE,30,COTAXTLA,049,COTAXTLA,7,989,499,490,58
VERACRUZ DE IGNACIO DE LA LLAVE,30,COTAXTLA,049,CRUZ DE QUINTERO,1,9,6,3,1
VERACRUZ DE IGNACIO DE LA LLAVE,30,COTAXTLA,049,DOS MATAS,2,54,32,22,4
VERACRUZ DE IGNACIO DE LA LLAVE,30,COTAXTLA,049,EL BOQUETILLO,1,10,3,7,1
VERACRUZ DE IGNACIO DE LA LLAVE,30,COTAXTLA,049,EL COPITE,2,21,9,12,2
VERACRUZ DE IGNACIO DE LA LLAVE,30,COTAXTLA,049,EL JÍCARO,1,23,10,13,2
VERACRUZ DE IGNACIO DE LA LLAVE,30,COTAXTLA,049,EL MORALITO,2,63,29,34,3
VERACRUZ DE IGNACIO DE LA LLAVE,30,COTAXTLA,049,EL NARANJO,1,4,1,3,1
VERACRUZ DE IGNACIO DE LA LLAVE,30,COTAXTLA,049,EL PEDREGAL,1,22,6,16,2
VERACRUZ DE IGNACIO DE LA LLAVE,30,COTAXTLA,049,EL POCHOTE,2,8,5,3,1
VERACRUZ DE IGNACIO DE LA LLAVE,30,COTAXTLA,049,EL SOMBRERETE,1,17,9,8,1
VERACRUZ DE IGNACIO DE LA LLAVE,30,COTAXTLA,049,EL TAMARINDO,2,22,10,12,3
VERACRUZ DE IGNACIO DE LA LLAVE,30,COTAXTLA,049,EL XÚCHITL,2,29,16,13,3
VERACRUZ DE IGNACIO DE LA LLAVE,30,COTAXTLA,049,LA AURORA,2,21,8,13,2
VERACRUZ DE IGNACIO DE LA LLAVE,30,COTAXTLA,049,LA CAPILLA,5,483,240,243,24
VERACRUZ DE IGNACIO DE LA LLAVE,30,COTAXTLA,049,LA CEBADILLA,3,82,35,47,6
VERACRUZ DE IGNACIO DE LA LLAVE,30,COTAXTLA,049,LA MOCARRACA,1,24,11,13,2
VERACRUZ DE IGNACIO DE LA LLAVE,30,COTAXTLA,049,LA TINAJA,5,680,307,373,28
VERACRUZ DE IGNACIO DE LA LLAVE,30,COTAXTLA,049,LAS GUACAMAYAS,1,16,10,6,1
VERACRUZ DE IGNACIO DE LA LLAVE,30,COTAXTLA,049,LAS LIMAS,3,29,9,20,3
VERACRUZ DE IGNACIO DE LA LLAVE,30,COTAXTLA,049,LAS LOMITAS,2,51,25,26,3
VERACRUZ DE IGNACIO DE LA LLAVE,30,COTAXTLA,049,LOMA ALTA,1,5,0,5,1
VERACRUZ DE IGNACIO DE LA LLAVE,30,COTAXTLA,049,LOMA ANGOSTA,2,45,22,23,3
VERACRUZ DE IGNACIO DE LA LLAVE,30,COTAXTLA,049,LOMA BONITA (LA CHICHARRA),2,25,13,12,2
VERACRUZ DE IGNACIO DE LA LLAVE,30,COTAXTLA,049,LOMA DE LOS HOYOS,3,77,41,36,6
VERACRUZ DE IGNACIO DE LA LLAVE,30,COTAXTLA,049,LOS CARRILES,2,46,26,20,3
VERACRUZ DE IGNACIO DE LA LLAVE,30,COTAXTLA,049,MATA ESPINO,1,23,9,14,1
VERACRUZ DE IGNACIO DE LA LLAVE,30,COTAXTLA,049,MATA TAMBOR,2,26,14,12,2
VERACRUZ DE IGNACIO DE LA LLAVE,30,COTAXTLA,049,MATA TEJÓN,3,156,88,68,8
VERACRUZ DE IGNACIO DE LA LLAVE,30,COTAXTLA,049,MECAYUCAN,1,5,4,1,1
VERACRUZ DE IGNACIO DE LA LLAVE,30,COTAXTLA,049,MUNDO NUEVO,2,23,11,12,2
VERACRUZ DE IGNACIO DE LA LLAVE,30,COTAXTLA,049,PALMARILLO,3,90,41,49,7
VERACRUZ DE IGNACIO DE LA LLAVE,30,COTAXTLA,049,PALO AMARILLO,3,26,13,13,3
VERACRUZ DE IGNACIO DE LA LLAVE,30,COTAXTLA,049,PASO ANONA,2,12,4,8,1
VERACRUZ DE IGNACIO DE LA LLAVE,30,COTAXTLA,049,PASO BANCO,1,7,2,5,1
VERACRUZ DE IGNACIO DE LA LLAVE,30,COTAXTLA,049,PASO DE LA VIEJA,2,15,5,10,2
VERACRUZ DE IGNACIO DE LA LLAVE,30,COTAXTLA,049,PASO DEL OBISPO,1,5,2,3,1
VERACRUZ DE IGNACIO DE LA LLAVE,30,COTAXTLA,049,PASO REAL,1,18,8,10,1
VERACRUZ DE IGNACIO DE LA LLAVE,30,COTAXTLA,049,PIEDRA SOLA,1,5,1,4,1
VERACRUZ DE IGNACIO DE LA LLAVE,30,COTAXTLA,049,POTRERILLOS,2,36,18,18,3
VERACRUZ DE IGNACIO DE LA LLAVE,30,COTAXTLA,049,PUEBLO VIEJO,1,12,2,10,1
VERACRUZ DE IGNACIO DE LA LLAVE,30,COTAXTLA,049,RANCHO CUESTA,1,49,21,28,3
VERACRUZ DE IGNACIO DE LA LLAVE,30,COTAXTLA,049,SAN ANTONIO,1,41,20,21,2
VERACRUZ DE IGNACIO DE LA LLAVE,30,COTAXTLA,049,SAN FRANCISCO,1,22,13,9,1
VERACRUZ DE IGNACIO DE LA LLAVE,30,COTAXTLA,049,SAN LUIS,2,57,27,30,3
VERACRUZ DE IGNACIO DE LA LLAVE,30,COTAXTLA,049,SANTA GERTRUDIS,1,7,3,4,1
VERACRUZ DE IGNACIO DE LA LLAVE,30,COTAXTLA,049,SANTA LUCÍA (LAS PLAYAS),3,65,37,28,4
VERACRUZ DE IGNACIO DE LA LLAVE,30,COTAXTLA,049,SANTA RITA,2,18,11,7,2
VERACRUZ DE IGNACIO DE LA LLAVE,30,COTAXTLA,049,VISTA HERMOSA,3,32,14,18,3
VERACRUZ DE IGNACIO DE LA LLAVE,30,COXQUIHUI,050,ADOLFO RUIZ CORTINES,3,192,94,98,12
VERACRUZ DE IGNACIO DE LA LLAVE,30,COXQUIHUI,050,ARENAL,5,221,101,120,17
VERACRUZ DE IGNACIO DE LA LLAVE,30,COXQUIHUI,050,BUENAVISTA DOS,1,15,6,9,1
VERACRUZ DE IGNACIO DE LA LLAVE,30,COXQUIHUI,050,BUENAVISTA UNO (SANTA MARÍA BUENAVISTA),3,35,16,19,5
VERACRUZ DE IGNACIO DE LA LLAVE,30,COXQUIHUI,050,CHIHUIXCRUZ,3,102,39,63,9
VERACRUZ DE IGNACIO DE LA LLAVE,30,COXQUIHUI,050,COLONIA DANTE DELGADO RANNAURO,3,185,91,94,8
VERACRUZ DE IGNACIO DE LA LLAVE,30,COXQUIHUI,050,COLONIA LEGIÓN DE MARÍA,2,42,22,20,3
VERACRUZ DE IGNACIO DE LA LLAVE,30,COXQUIHUI,050,COXQUIHUI,9,1469,721,748,98
VERACRUZ DE IGNACIO DE LA LLAVE,30,COXQUIHUI,050,CUAUHTÉMOC (EL JOBO),3,337,162,175,19
VERACRUZ DE IGNACIO DE LA LLAVE,30,COXQUIHUI,050,JOSÉ MARÍA MORELOS,5,365,172,193,18
VERACRUZ DE IGNACIO DE LA LLAVE,30,COXQUIHUI,050,LA FÁBRICA,2,52,32,20,4
VERACRUZ DE IGNACIO DE LA LLAVE,30,COXQUIHUI,050,LA HIGUERA,2,24,12,12,3
VERACRUZ DE IGNACIO DE LA LLAVE,30,COXQUIHUI,050,LA INDEPENDENCIA,3,71,40,31,5
VERACRUZ DE IGNACIO DE LA LLAVE,30,COXQUIHUI,050,OJITAL,2,29,17,12,2
VERACRUZ DE IGNACIO DE LA LLAVE,30,COXQUIHUI,050,OJITE DE MATAMOROS,4,179,87,92,12
VERACRUZ DE IGNACIO DE LA LLAVE,30,COXQUIHUI,050,PIEDRAS DE AFILAR (EL CAFETAL),2,64,32,32,4
VERACRUZ DE IGNACIO DE LA LLAVE,30,COXQUIHUI,050,SABANAS DE XALOSTOC,4,404,215,189,22
VERACRUZ DE IGNACIO DE LA LLAVE,30,COXQUIHUI,050,SABANETA,5,133,59,74,12
VERACRUZ DE IGNACIO DE LA LLAVE,30,COXQUIHUI,050,TUNCUHUINI (ENCINAL),3,95,52,43,9
VERACRUZ DE IGNACIO DE LA LLAVE,30,COYUTLA,051,ARROYO SECO,1,4,0,4,1
VERACRUZ DE IGNACIO DE LA LLAVE,30,COYUTLA,051,BUENAVISTA,4,135,66,69,11
VERACRUZ DE IGNACIO DE LA LLAVE,30,COYUTLA,051,CALALCO,3,188,98,90,12
VERACRUZ DE IGNACIO DE LA LLAVE,30,COYUTLA,051,CATXIQUILÍN,3,17,11,6,2
VERACRUZ DE IGNACIO DE LA LLAVE,30,COYUTLA,051,CHICUALOQUE,4,333,162,171,16
VERACRUZ DE IGNACIO DE LA LLAVE,30,COYUTLA,051,COLONIA GUADALUPE,5,408,205,203,25
VERACRUZ DE IGNACIO DE LA LLAVE,30,COYUTLA,051,COYUTLA,16,2682,1367,1315,129
VERACRUZ DE IGNACIO DE LA LLAVE,30,COYUTLA,051,CRUZ VERDE,3,127,58,69,7
VERACRUZ DE IGNACIO DE LA LLAVE,30,COYUTLA,051,EL PANORAMA,4,260,129,131,18
VERACRUZ DE IGNACIO DE LA LLAVE,30,COYUTLA,051,EL PASO DE COYUTLA,3,87,43,44,7
VERACRUZ DE IGNACIO DE LA LLAVE,30,COYUTLA,051,EL PIÑAL,2,18,13,5,2
VERACRUZ DE IGNACIO DE LA LLAVE,30,COYUTLA,051,EL PORVENIR,3,25,15,10,2
VERACRUZ DE IGNACIO DE LA LLAVE,30,COYUTLA,051,INDEPENDENCIA,2,49,30,19,3
VERACRUZ DE IGNACIO DE LA LLAVE,30,COYUTLA,051,LA CHACA,5,757,339,418,60
VERACRUZ DE IGNACIO DE LA LLAVE,30,COYUTLA,051,LA LIMA,1,9,0,9,1
VERACRUZ DE IGNACIO DE LA LLAVE,30,COYUTLA,051,LA NUEVA ROSITA,1,11,4,7,1
VERACRUZ DE IGNACIO DE LA LLAVE,30,COYUTLA,051,LA PALMA,3,142,70,72,9
VERACRUZ DE IGNACIO DE LA LLAVE,30,COYUTLA,051,LAS LOMAS,4,498,227,271,27
VERACRUZ DE IGNACIO DE LA LLAVE,30,COYUTLA,051,SAN ANDRECITO,2,49,23,26,3
VERACRUZ DE IGNACIO DE LA LLAVE,30,COYUTLA,051,SAN MARCOS,3,145,68,77,11
VERACRUZ DE IGNACIO DE LA LLAVE,30,COYUTLA,051,TULAPILLA,4,201,106,95,12
VERACRUZ DE IGNACIO DE LA LLAVE,30,CUICHAPA,052,BARRIO GUADALUPE,2,40,18,22,3
VERACRUZ DE IGNACIO DE LA LLAVE,30,CUICHAPA,052,COBOS GARCÍA (SAN NICOLÁS),3,151,69,82,11
VERACRUZ DE IGNACIO DE LA LLAVE,30,CUICHAPA,052,CUICHAPA,8,721,378,343,45
VERACRUZ DE IGNACIO DE LA LLAVE,30,CUICHAPA,052,EJIDO LA LAJA,4,168,88,80,10
VERACRUZ DE IGNACIO DE LA LLAVE,30,CUICHAPA,052,EL ZAPOTE,2,56,26,30,3
VERACRUZ DE IGNACIO DE LA LLAVE,30,CUICHAPA,052,LOMA DEL CARMEN,1,6,3,3,1
VERACRUZ DE IGNACIO DE LA LLAVE,30,CUICHAPA,052,LOS ÁNGELES,2,49,25,24,3
VERACRUZ DE IGNACIO DE LA LLAVE,30,CUICHAPA,052,PROVIDENCIA,8,808,408,400,54
VERACRUZ DE IGNACIO DE LA LLAVE,30,CUICHAPA,052,TOLUQUILLA BUENA VISTA,2,62,31,31,5
VERACRUZ DE IGNACIO DE LA LLAVE,30,CUITLÁHUAC,053,AMPLIACIÓN MANANTIAL,1,11,5,6,1
VERACRUZ DE IGNACIO DE LA LLAVE,30,CUITLÁHUAC,053,COPALILLO,1,33,18,15,2
VERACRUZ DE IGNACIO DE LA LLAVE,30,CUITLÁHUAC,053,CUITLÁHUAC,27,4036,2033,2003,268
VERACRUZ DE IGNACIO DE LA LLAVE,30,CUITLÁHUAC,053,DIVISIÓN DEL NORTE (SANTA ROSA),2,49,22,27,3
VERACRUZ DE IGNACIO DE LA LLAVE,30,CUITLÁHUAC,053,DOS CAMINOS,3,6867,3057,3810,242
VERACRUZ DE IGNACIO DE LA LLAVE,30,CUITLÁHUAC,053,EJIDO CUITLÁHUAC (EJIDO EL CENTRO),1,11,6,5,1
VERACRUZ DE IGNACIO DE LA LLAVE,30,CUITLÁHUAC,053,EL COYOL,2,50,20,30,4
VERACRUZ DE IGNACIO DE LA LLAVE,30,CUITLÁHUAC,053,EL LIMÓN,2,26,12,14,3
VERACRUZ DE IGNACIO DE LA LLAVE,30,CUITLÁHUAC,053,EL MAGUEY,3,291,125,166,15
VERACRUZ DE IGNACIO DE LA LLAVE,30,CUITLÁHUAC,053,EL MANANTIAL,3,177,87,90,10
VERACRUZ DE IGNACIO DE LA LLAVE,30,CUITLÁHUAC,053,EL POLVORÓN,2,165,74,91,8
VERACRUZ DE IGNACIO DE LA LLAVE,30,CUITLÁHUAC,053,EL TAMARINDO,2,39,14,25,3
VERACRUZ DE IGNACIO DE LA LLAVE,30,CUITLÁHUAC,053,IGNACIO VALLARTA NORTE,1,5,3,2,1
VERACRUZ DE IGNACIO DE LA LLAVE,30,CUITLÁHUAC,053,IGNACIO VALLARTA SUR,1,16,9,7,1
VERACRUZ DE IGNACIO DE LA LLAVE,30,CUITLÁHUAC,053,LA PITAHAYA (LA LUZ),1,31,16,15,3
VERACRUZ DE IGNACIO DE LA LLAVE,30,CUITLÁHUAC,053,MATA NARANJO (EL NANCHE),3,207,90,117,13
VERACRUZ DE IGNACIO DE LA LLAVE,30,CUITLÁHUAC,053,PIEDRA GORDA,1,13,4,9,1
VERACRUZ DE IGNACIO DE LA LLAVE,30,CUITLÁHUAC,053,PUENTE QUEBRADO,1,21,9,12,1
VERACRUZ DE IGNACIO DE LA LLAVE,30,CUITLÁHUAC,053,RINCÓN ZAPOTE,1,14,5,9,2
VERACRUZ DE IGNACIO DE LA LLAVE,30,CUITLÁHUAC,053,SAN FRANCISCO (MATA CLARA),3,221,113,108,16
VERACRUZ DE IGNACIO DE LA LLAVE,30,CUITLÁHUAC,053,SAN JOSÉ DE ABAJO,3,211,107,104,13
VERACRUZ DE IGNACIO DE LA LLAVE,30,CUITLÁHUAC,053,SAN RAFAEL,1,9,2,7,1
VERACRUZ DE IGNACIO DE LA LLAVE,30,CUITLÁHUAC,053,TENCHIPE,1,4,0,4,1
VERACRUZ DE IGNACIO DE LA LLAVE,30,CUITLÁHUAC,053,TRAPICHE MEZA,1,79,37,42,4
VERACRUZ DE IGNACIO DE LA LLAVE,30,CHACALTIANGUIS,054,ARROYO CLARO,1,13,5,8,1
VERACRUZ DE IGNACIO DE LA LLAVE,30,CHACALTIANGUIS,054,ARROYO DEL SOLDADO (ARROYO DEL OBISPO),4,121,58,63,14
VERACRUZ DE IGNACIO DE LA LLAVE,30,CHACALTIANGUIS,054,CHACALTIANGUIS,7,681,311,370,45
VERACRUZ DE IGNACIO DE LA LLAVE,30,CHACALTIANGUIS,054,DESVIACIÓN DE SABANETAS,1,8,3,5,1
VERACRUZ DE IGNACIO DE LA LLAVE,30,CHACALTIANGUIS,054,EL ENCANTO,1,5,3,2,1
VERACRUZ DE IGNACIO DE LA LLAVE,30,CHACALTIANGUIS,054,JOACHÍN,3,67,33,34,6
VERACRUZ DE IGNACIO DE LA LLAVE,30,CHACALTIANGUIS,054,LAGUNA DE LAGARTO,4,161,85,76,12
VERACRUZ DE IGNACIO DE LA LLAVE,30,CHACALTIANGUIS,054,LAS MESAS,3,127,56,71,9
VERACRUZ DE IGNACIO DE LA LLAVE,30,CHACALTIANGUIS,054,LAS SABANETAS,4,290,157,133,20
VERACRUZ DE IGNACIO DE LA LLAVE,30,CHACALTIANGUIS,054,MATA DE CAÑA,4,113,58,55,10
VERACRUZ DE IGNACIO DE LA LLAVE,30,CHACALTIANGUIS,054,MOYOTA,3,38,18,20,8
VERACRUZ DE IGNACIO DE LA LLAVE,30,CHACALTIANGUIS,054,PASO DEL CURA,3,95,43,52,6
VERACRUZ DE IGNACIO DE LA LLAVE,30,CHACALTIANGUIS,054,PEPEAPA,1,4,2,2,1
VERACRUZ DE IGNACIO DE LA LLAVE,30,CHACALTIANGUIS,054,SAN ANTONIO,2,39,11,28,3
VERACRUZ DE IGNACIO DE LA LLAVE,30,CHACALTIANGUIS,054,TORNO LARGO,3,46,24,22,6
VERACRUZ DE IGNACIO DE LA LLAVE,30,CHALMA,055,ACATZINTLA,1,24,12,12,4
VERACRUZ DE IGNACIO DE LA LLAVE,30,CHALMA,055,AMATITLÁN DE ABAJO,2,28,11,17,3
VERACRUZ DE IGNACIO DE LA LLAVE,30,CHALMA,055,AQUIXCUATITLA,3,94,43,51,10
VERACRUZ DE IGNACIO DE LA LLAVE,30,CHALMA,055,CACALACA,1,5,1,4,1
VERACRUZ DE IGNACIO DE LA LLAVE,30,CHALMA,055,CHALMA,7,539,282,257,45
VERACRUZ DE IGNACIO DE LA LLAVE,30,CHALMA,055,CHAMIZAL,5,87,43,44,13
VERACRUZ DE IGNACIO DE LA LLAVE,30,CHALMA,055,CHAPOPOTE CHICO (TLACHINOLAPA),7,155,82,73,25
VERACRUZ DE IGNACIO DE LA LLAVE,30,CHALMA,055,CUATEPIXTLA,2,10,4,6,2
VERACRUZ DE IGNACIO DE LA LLAVE,30,CHALMA,055,EL AGUACATE CHICO,2,28,15,13,3
VERACRUZ DE IGNACIO DE LA LLAVE,30,CHALMA,055,EL CERRO,2,16,6,10,3
VERACRUZ DE IGNACIO DE LA LLAVE,30,CHALMA,055,EL PINTOR,6,512,272,240,43
VERACRUZ DE IGNACIO DE LA LLAVE,30,CHALMA,055,LA BARRANCA,2,31,16,15,4
VERACRUZ DE IGNACIO DE LA LLAVE,30,CHALMA,055,LA LAJA,3,45,18,27,6
VERACRUZ DE IGNACIO DE LA LLAVE,30,CHALMA,055,LA PUERTA,2,34,21,13,4
VERACRUZ DE IGNACIO DE LA LLAVE,30,CHALMA,055,LAS PILAS,2,68,31,37,9
VERACRUZ DE IGNACIO DE LA LLAVE,30,CHALMA,055,MESA DEL ANONO,2,33,19,14,3
VERACRUZ DE IGNACIO DE LA LLAVE,30,CHALMA,055,SAN PEDRO COYUTLA,6,420,196,224,27
VERACRUZ DE IGNACIO DE LA LLAVE,30,CHALMA,055,SANTA QUITERÍA,3,58,28,30,5
VERACRUZ DE IGNACIO DE LA LLAVE,30,CHALMA,055,TAXTITLA,2,51,28,23,5
VERACRUZ DE IGNACIO DE LA LLAVE,30,CHALMA,055,TENEXCO,2,35,11,24,5
VERACRUZ DE IGNACIO DE LA LLAVE,30,CHALMA,055,TEPECHICA,1,7,2,5,1
VERACRUZ DE IGNACIO DE LA LLAVE,30,CHALMA,055,ZAPOTITLA,3,21,10,11,4
VERACRUZ DE IGNACIO DE LA LLAVE,30,CHICONAMEL,056,AGUAPANI,3,37,13,24,6
VERACRUZ DE IGNACIO DE LA LLAVE,30,CHICONAMEL,056,CHICONAMEL,6,331,150,181,27
VERACRUZ DE IGNACIO DE LA LLAVE,30,CHICONAMEL,056,CHINTEPEC,3,79,43,36,8
VERACRUZ DE IGNACIO DE LA LLAVE,30,CHICONAMEL,056,EL AGUACATE,2,8,3,5,3
VERACRUZ DE IGNACIO DE LA LLAVE,30,CHICONAMEL,056,EL CEPILLO,3,51,17,34,4
VERACRUZ DE IGNACIO DE LA LLAVE,30,CHICONAMEL,056,EL MIRADOR,3,58,33,25,10
VERACRUZ DE IGNACIO DE LA LLAVE,30,CHICONAMEL,056,EL RINCÓN,1,4,3,1,1
VERACRUZ DE IGNACIO DE LA LLAVE,30,CHICONAMEL,056,EL TIZNADO,1,7,3,4,1
VERACRUZ DE IGNACIO DE LA LLAVE,30,CHICONAMEL,056,HUIZACHAL,1,9,4,5,1
VERACRUZ DE IGNACIO DE LA LLAVE,30,CHICONAMEL,056,HUMOTITLA,2,16,9,7,2
VERACRUZ DE IGNACIO DE LA LLAVE,30,CHICONAMEL,056,LA CUCHILLA CUATOLOL,1,12,7,5,2
VERACRUZ DE IGNACIO DE LA LLAVE,30,CHICONAMEL,056,LA TORTUGA,1,6,3,3,1
VERACRUZ DE IGNACIO DE LA LLAVE,30,CHICONAMEL,056,LOS VENADOS,2,67,27,40,3
VERACRUZ DE IGNACIO DE LA LLAVE,30,CHICONAMEL,056,MOHUIJCO,2,22,10,12,6
VERACRUZ DE IGNACIO DE LA LLAVE,30,CHICONAMEL,056,MOTOLTEPEC,3,115,64,51,11
VERACRUZ DE IGNACIO DE LA LLAVE,30,CHICONAMEL,056,PEÑA (TECHICOL),1,4,0,4,1
VERACRUZ DE IGNACIO DE LA LLAVE,30,CHICONAMEL,056,ROMANTLA,2,36,20,16,5
VERACRUZ DE IGNACIO DE LA LLAVE,30,CHICONAMEL,056,SANTA ROSA,2,20,8,12,4
VERACRUZ DE IGNACIO DE LA LLAVE,30,CHICONAMEL,056,TALTAMAYA,2,41,21,20,3
VERACRUZ DE IGNACIO DE LA LLAVE,30,CHICONAMEL,056,TANCAZAHUELA,4,377,195,182,23
VERACRUZ DE IGNACIO DE LA LLAVE,30,CHICONAMEL,056,VENADOS,2,37,19,18,5
VERACRUZ DE IGNACIO DE LA LLAVE,30,CHICONQUIACO,057,ARROYO COLORADO,4,28,12,16,4
VERACRUZ DE IGNACIO DE LA LLAVE,30,CHICONQUIACO,057,BARRANCA EL MAÍZ,3,10,6,4,2
VERACRUZ DE IGNACIO DE LA LLAVE,30,CHICONQUIACO,057,BUENA VISTA,1,6,2,4,2
VERACRUZ DE IGNACIO DE LA LLAVE,30,CHICONQUIACO,057,CHICONQUIACO,6,1107,540,567,59
VERACRUZ DE IGNACIO DE LA LLAVE,30,CHICONQUIACO,057,CRUZ VERDE,2,19,8,11,2
VERACRUZ DE IGNACIO DE LA LLAVE,30,CHICONQUIACO,057,EL CAPULÍN,3,181,84,97,10
VERACRUZ DE IGNACIO DE LA LLAVE,30,CHICONQUIACO,057,EL CHARQUILLO,1,24,13,11,1
VERACRUZ DE IGNACIO DE LA LLAVE,30,CHICONQUIACO,057,EL CHICHARAL,2,7,4,3,1
VERACRUZ DE IGNACIO DE LA LLAVE,30,CHICONQUIACO,057,EL ESCALANAR,3,115,67,48,8
VERACRUZ DE IGNACIO DE LA LLAVE,30,CHICONQUIACO,057,EL HUÉRFANO,4,413,205,208,19
VERACRUZ DE IGNACIO DE LA LLAVE,30,CHICONQUIACO,057,EL NARANJAL,1,4,2,2,1
VERACRUZ DE IGNACIO DE LA LLAVE,30,CHICONQUIACO,057,EL XUCUYUL,2,25,14,11,3
VERACRUZ DE IGNACIO DE LA LLAVE,30,CHICONQUIACO,057,GALLO DE ORO,3,59,29,30,6
VERACRUZ DE IGNACIO DE LA LLAVE,30,CHICONQUIACO,057,GUTIÉRREZ ZAMORA,3,101,40,61,9
VERACRUZ DE IGNACIO DE LA LLAVE,30,CHICONQUIACO,057,LA CAPILLA,3,69,32,37,5
VERACRUZ DE IGNACIO DE LA LLAVE,30,CHICONQUIACO,057,LA GUACAMAYA,3,29,20,9,2
VERACRUZ DE IGNACIO DE LA LLAVE,30,CHICONQUIACO,057,LA PARRA,3,56,28,28,5
VERACRUZ DE IGNACIO DE LA LLAVE,30,CHICONQUIACO,057,LA SOMBRA,4,207,113,94,12
VERACRUZ DE IGNACIO DE LA LLAVE,30,CHICONQUIACO,057,LA VAQUERÍA,3,75,37,38,5
VERACRUZ DE IGNACIO DE LA LLAVE,30,CHICONQUIACO,057,LAS CRUCES,1,15,11,4,1
VERACRUZ DE IGNACIO DE LA LLAVE,30,CHICONQUIACO,057,LAS PAREDES,3,202,93,109,12
VERACRUZ DE IGNACIO DE LA LLAVE,30,CHICONQUIACO,057,LOMA PLAN,4,106,46,60,10
VERACRUZ DE IGNACIO DE LA LLAVE,30,CHICONQUIACO,057,LOS ARCOS,2,6,4,2,2
VERACRUZ DE IGNACIO DE LA LLAVE,30,CHICONQUIACO,057,LOS NARANJOS,3,81,38,43,6
VERACRUZ DE IGNACIO DE LA LLAVE,30,CHICONQUIACO,057,LOS PINOS,2,8,3,5,2
VERACRUZ DE IGNACIO DE LA LLAVE,30,CHICONQUIACO,057,PLAN DE LA ESTRELLA,3,85,48,37,7
VERACRUZ DE IGNACIO DE LA LLAVE,30,CHICONQUIACO,057,PLAN DEL AGUACERO,1,16,8,8,1
VERACRUZ DE IGNACIO DE LA LLAVE,30,CHICONQUIACO,057,PLANTA DEL PIE,3,81,48,33,6
VERACRUZ DE IGNACIO DE LA LLAVE,30,CHICONQUIACO,057,RANCHO ALARCÓN,1,4,3,1,1
VERACRUZ DE IGNACIO DE LA LLAVE,30,CHICONQUIACO,057,VISTA HERMOSA,2,22,17,5,3
VERACRUZ DE IGNACIO DE LA LLAVE,30,CHICONTEPEC,058,ACATITLA,2,90,40,50,7
VERACRUZ DE IGNACIO DE LA LLAVE,30,CHICONTEPEC,058,ACHUPIL,3,87,48,39,9
VERACRUZ DE IGNACIO DE LA LLAVE,30,CHICONTEPEC,058,AHUATENO,7,1243,593,650,58
VERACRUZ DE IGNACIO DE LA LLAVE,30,CHICONTEPEC,058,AHUATITLA ABAJO,4,163,87,76,13
VERACRUZ DE IGNACIO DE LA LLAVE,30,CHICONTEPEC,058,AHUATITLA ARRIBA,2,49,27,22,7
VERACRUZ DE IGNACIO DE LA LLAVE,30,CHICONTEPEC,058,AHUICA,3,148,75,73,10
VERACRUZ DE IGNACIO DE LA LLAVE,30,CHICONTEPEC,058,AHUIMOL TZIMPIASCO,4,239,117,122,23
VERACRUZ DE IGNACIO DE LA LLAVE,30,CHICONTEPEC,058,AKICHTZINTLA,2,32,15,17,3
VERACRUZ DE IGNACIO DE LA LLAVE,30,CHICONTEPEC,058,ALAHUALTITLA,4,124,50,74,11
VERACRUZ DE IGNACIO DE LA LLAVE,30,CHICONTEPEC,058,ALAXTITLA HUIXNOPALA,2,27,10,17,4
VERACRUZ DE IGNACIO DE LA LLAVE,30,CHICONTEPEC,058,ALAXTITLA IXCACUATITLA,4,132,70,62,7
VERACRUZ DE IGNACIO DE LA LLAVE,30,CHICONTEPEC,058,ALAXTITLA POSTECTITLA,2,12,5,7,2
VERACRUZ DE IGNACIO DE LA LLAVE,30,CHICONTEPEC,058,AMPLIACIÓN PALMA SOLA,2,39,10,29,2
VERACRUZ DE IGNACIO DE LA LLAVE,30,CHICONTEPEC,058,APAXTITLA,2,25,13,12,2
VERACRUZ DE IGNACIO DE LA LLAVE,30,CHICONTEPEC,058,ATENO,2,35,20,15,4
VERACRUZ DE IGNACIO DE LA LLAVE,30,CHICONTEPEC,058,AYACAXTLE,2,51,25,26,7
VERACRUZ DE IGNACIO DE LA LLAVE,30,CHICONTEPEC,058,AYOCO,2,7,4,3,2
VERACRUZ DE IGNACIO DE LA LLAVE,30,CHICONTEPEC,058,BARRIO RANCHO NUEVO TLACOLULA,1,17,8,9,3
VERACRUZ DE IGNACIO DE LA LLAVE,30,CHICONTEPEC,058,BENITO JUÁREZ,1,5,3,2,1
VERACRUZ DE IGNACIO DE LA LLAVE,30,CHICONTEPEC,058,BUENA VISTA,2,25,9,16,2
VERACRUZ DE IGNACIO DE LA LLAVE,30,CHICONTEPEC,058,CALLEJÓN CARRIZALILLO,4,100,46,54,10
VERACRUZ DE IGNACIO DE LA LLAVE,30,CHICONTEPEC,058,CAMOTIPAN,2,35,14,21,3
VERACRUZ DE IGNACIO DE LA LLAVE,30,CHICONTEPEC,058,CAROLINO ANAYA,2,53,31,22,4
VERACRUZ DE IGNACIO DE LA LLAVE,30,CHICONTEPEC,058,CERRO PRIETO,1,8,5,3,1
VERACRUZ DE IGNACIO DE LA LLAVE,30,CHICONTEPEC,058,CHACACUÁHUITL,1,17,10,7,1
VERACRUZ DE IGNACIO DE LA LLAVE,30,CHICONTEPEC,058,CHALAHUIAPA,2,14,3,11,3
VERACRUZ DE IGNACIO DE LA LLAVE,30,CHICONTEPEC,058,CHAMOLA,2,27,15,12,3
VERACRUZ DE IGNACIO DE LA LLAVE,30,CHICONTEPEC,058,CHAPIXTLA,3,21,11,10,3
VERACRUZ DE IGNACIO DE LA LLAVE,30,CHICONTEPEC,058,CHICONTEPEC DE TEJEDA,15,2138,1109,1029,147
VERACRUZ DE IGNACIO DE LA LLAVE,30,CHICONTEPEC,058,COAMIXTEPEC,2,43,19,24,6
VERACRUZ DE IGNACIO DE LA LLAVE,30,CHICONTEPEC,058,CUAHUÍTZIL,2,34,17,17,4
VERACRUZ DE IGNACIO DE LA LLAVE,30,CHICONTEPEC,058,CUATECÓMETL CAMOTIPAN,1,29,18,11,1
VERACRUZ DE IGNACIO DE LA LLAVE,30,CHICONTEPEC,058,CUATECÓMITL BUENAVISTA,3,57,30,27,6
VERACRUZ DE IGNACIO DE LA LLAVE,30,CHICONTEPEC,058,CUATZAPOTITLA,5,173,101,72,11
VERACRUZ DE IGNACIO DE LA LLAVE,30,CHICONTEPEC,058,EJIDO DE TLANEMPA,2,29,11,18,3
VERACRUZ DE IGNACIO DE LA LLAVE,30,CHICONTEPEC,058,EL AGUACATE,1,12,3,9,2
VERACRUZ DE IGNACIO DE LA LLAVE,30,CHICONTEPEC,058,EL CHOTE (SANTA TERESA),3,73,36,37,8
VERACRUZ DE IGNACIO DE LA LLAVE,30,CHICONTEPEC,058,EL CHOTE LA ANTIGUA,2,11,5,6,2
VERACRUZ DE IGNACIO DE LA LLAVE,30,CHICONTEPEC,058,EL COYOLITO,1,9,3,6,1
VERACRUZ DE IGNACIO DE LA LLAVE,30,CHICONTEPEC,058,EL CUARTEL,2,17,13,4,2
VERACRUZ DE IGNACIO DE LA LLAVE,30,CHICONTEPEC,058,EL IXTLE FLORES MAGÓN,1,21,12,9,2
VERACRUZ DE IGNACIO DE LA LLAVE,30,CHICONTEPEC,058,EL IXTLE POSTECTITLA,2,17,9,8,2
VERACRUZ DE IGNACIO DE LA LLAVE,30,CHICONTEPEC,058,EL LINDERO XOQUÍXHUAL,1,14,5,9,1
VERACRUZ DE IGNACIO DE LA LLAVE,30,CHICONTEPEC,058,EL MANANTIAL,2,39,22,17,4
VERACRUZ DE IGNACIO DE LA LLAVE,30,CHICONTEPEC,058,EL MIRADOR,8,245,140,105,24
VERACRUZ DE IGNACIO DE LA LLAVE,30,CHICONTEPEC,058,EL MOLINO,1,7,3,4,2
VERACRUZ DE IGNACIO DE LA LLAVE,30,CHICONTEPEC,058,EL SITIO,2,11,2,9,3
VERACRUZ DE IGNACIO DE LA LLAVE,30,CHICONTEPEC,058,EL TECOMATE,5,295,145,150,17
VERACRUZ DE IGNACIO DE LA LLAVE,30,CHICONTEPEC,058,EL TERRERO,2,20,7,13,3
VERACRUZ DE IGNACIO DE LA LLAVE,30,CHICONTEPEC,058,EL TORDILLO,2,24,9,15,2
VERACRUZ DE IGNACIO DE LA LLAVE,30,CHICONTEPEC,058,EL ZACATAL,4,161,81,80,12
VERACRUZ DE IGNACIO DE LA LLAVE,30,CHICONTEPEC,058,EL ZAPOTAL ESPINAL,2,34,18,16,3
VERACRUZ DE IGNACIO DE LA LLAVE,30,CHICONTEPEC,058,EMILIANO ZAPATA,2,25,11,14,3
VERACRUZ DE IGNACIO DE LA LLAVE,30,CHICONTEPEC,058,FRANCIA NUEVA,3,59,32,27,8
VERACRUZ DE IGNACIO DE LA LLAVE,30,CHICONTEPEC,058,FRANCIA VIEJA,2,16,11,5,3
VERACRUZ DE IGNACIO DE LA LLAVE,30,CHICONTEPEC,058,FRANCISCO VILLA,2,34,17,17,3
VERACRUZ DE IGNACIO DE LA LLAVE,30,CHICONTEPEC,058,GENERAL IGNACIO ZARAGOZA,2,41,22,19,3
VERACRUZ DE IGNACIO DE LA LLAVE,30,CHICONTEPEC,058,GRANADILLA,2,12,6,6,3
VERACRUZ DE IGNACIO DE LA LLAVE,30,CHICONTEPEC,058,HUACANGO,1,7,4,3,1
VERACRUZ DE IGNACIO DE LA LLAVE,30,CHICONTEPEC,058,HUICHINTITLA,3,29,9,20,3
VERACRUZ DE IGNACIO DE LA LLAVE,30,CHICONTEPEC,058,HUITZAPOLI,1,11,2,9,1
VERACRUZ DE IGNACIO DE LA LLAVE,30,CHICONTEPEC,058,HUITZITZILCO,1,3,1,2,1
VERACRUZ DE IGNACIO DE LA LLAVE,30,CHICONTEPEC,058,HUITZTIPA,2,11,3,8,2
VERACRUZ DE IGNACIO DE LA LLAVE,30,CHICONTEPEC,058,HUIZACHE ACHICHIPIC,2,52,22,30,5
VERACRUZ DE IGNACIO DE LA LLAVE,30,CHICONTEPEC,058,IXCACUATITLA,4,227,107,120,26
VERACRUZ DE IGNACIO DE LA LLAVE,30,CHICONTEPEC,058,IXCACUATITLA DE LOS PINOS,1,23,13,10,2
VERACRUZ DE IGNACIO DE LA LLAVE,30,CHICONTEPEC,058,JAGÜEY,2,65,36,29,4
VERACRUZ DE IGNACIO DE LA LLAVE,30,CHICONTEPEC,058,LA ANTIGUA,3,47,22,25,3
VERACRUZ DE IGNACIO DE LA LLAVE,30,CHICONTEPEC,058,LA CEIBA TLACOLULA,2,62,27,35,7
VERACRUZ DE IGNACIO DE LA LLAVE,30,CHICONTEPEC,058,LA CONCEPCIÓN,2,31,15,16,3
VERACRUZ DE IGNACIO DE LA LLAVE,30,CHICONTEPEC,058,LA ESMERALDA,2,41,18,23,4
VERACRUZ DE IGNACIO DE LA LLAVE,30,CHICONTEPEC,058,LA GUÁSIMA,2,19,7,12,2
VERACRUZ DE IGNACIO DE LA LLAVE,30,CHICONTEPEC,058,LA HEREDAD,2,23,11,12,3
VERACRUZ DE IGNACIO DE LA LLAVE,30,CHICONTEPEC,058,LA MESA DE TZAPOTZALA,2,45,21,24,3
VERACRUZ DE IGNACIO DE LA LLAVE,30,CHICONTEPEC,058,LA PAGUA,4,171,86,85,15
VERACRUZ DE IGNACIO DE LA LLAVE,30,CHICONTEPEC,058,LA PIMIENTA,1,8,4,4,1
VERACRUZ DE IGNACIO DE LA LLAVE,30,CHICONTEPEC,058,LA PROVIDENCIA,2,31,16,15,4
VERACRUZ DE IGNACIO DE LA LLAVE,30,CHICONTEPEC,058,LA PUERTA,2,26,15,11,4
VERACRUZ DE IGNACIO DE LA LLAVE,30,CHICONTEPEC,058,LAS GÜIRAS,2,11,6,5,2
VERACRUZ DE IGNACIO DE LA LLAVE,30,CHICONTEPEC,058,LAS PLACETAS,3,108,55,53,9
VERACRUZ DE IGNACIO DE LA LLAVE,30,CHICONTEPEC,058,LAS PUENTES,4,214,101,113,15
VERACRUZ DE IGNACIO DE LA LLAVE,30,CHICONTEPEC,058,LAS SILLETAS,3,26,15,11,5
VERACRUZ DE IGNACIO DE LA LLAVE,30,CHICONTEPEC,058,LÁZARO CÁRDENAS,1,7,3,4,1
VERACRUZ DE IGNACIO DE LA LLAVE,30,CHICONTEPEC,058,LIMONTITLA,1,6,3,3,1
VERACRUZ DE IGNACIO DE LA LLAVE,30,CHICONTEPEC,058,LINDERO ACHUPIL,1,9,2,7,1
VERACRUZ DE IGNACIO DE LA LLAVE,30,CHICONTEPEC,058,LINDERO AGUA FRÍA,3,70,38,32,5
VERACRUZ DE IGNACIO DE LA LLAVE,30,CHICONTEPEC,058,MAGUEY MAGUAQUITE,3,67,29,38,7
VERACRUZ DE IGNACIO DE LA LLAVE,30,CHICONTEPEC,058,MESA DE AHUAYO,2,36,14,22,2
VERACRUZ DE IGNACIO DE LA LLAVE,30,CHICONTEPEC,058,MESA DE CALCOTE,3,40,20,20,4
VERACRUZ DE IGNACIO DE LA LLAVE,30,CHICONTEPEC,058,MESA DE PEDERNALES,2,37,20,17,4
VERACRUZ DE IGNACIO DE LA LLAVE,30,CHICONTEPEC,058,MESA DE TZONÁMATL,4,105,51,54,7
VERACRUZ DE IGNACIO DE LA LLAVE,30,CHICONTEPEC,058,MEXCATLA,2,63,31,32,7
VERACRUZ DE IGNACIO DE LA LLAVE,30,CHICONTEPEC,058,MONTE NEGRO,4,54,30,24,5
VERACRUZ DE IGNACIO DE LA LLAVE,30,CHICONTEPEC,058,NUEVO PARAJE,2,31,16,15,3
VERACRUZ DE IGNACIO DE LA LLAVE,30,CHICONTEPEC,058,OTLATZINTLA,2,36,16,20,4
VERACRUZ DE IGNACIO DE LA LLAVE,30,CHICONTEPEC,058,PALMA REAL TEPENAHUAC,2,31,15,16,3
VERACRUZ DE IGNACIO DE LA LLAVE,30,CHICONTEPEC,058,PALMA SOLA,4,141,64,77,8
VERACRUZ DE IGNACIO DE LA LLAVE,30,CHICONTEPEC,058,PALMA SOLA (ANEXO LA ANTIGUA),1,5,2,3,1
VERACRUZ DE IGNACIO DE LA LLAVE,30,CHICONTEPEC,058,PASO DE TLACOLULA,1,13,5,8,1
VERACRUZ DE IGNACIO DE LA LLAVE,30,CHICONTEPEC,058,PASTORÍA,4,212,99,113,15
VERACRUZ DE IGNACIO DE LA LLAVE,30,CHICONTEPEC,058,PEMUXTITLA,4,209,95,114,19
VERACRUZ DE IGNACIO DE LA LLAVE,30,CHICONTEPEC,058,PEPEYOCAL,2,23,9,14,4
VERACRUZ DE IGNACIO DE LA LLAVE,30,CHICONTEPEC,058,POSTECTITLA,2,19,8,11,3
VERACRUZ DE IGNACIO DE LA LLAVE,30,CHICONTEPEC,058,RANCHO NUEVO,1,11,4,7,1
VERACRUZ DE IGNACIO DE LA LLAVE,30,CHICONTEPEC,058,SAN BENITO,2,25,11,14,3
VERACRUZ DE IGNACIO DE LA LLAVE,30,CHICONTEPEC,058,SASALTITLA,5,212,110,102,17
VERACRUZ DE IGNACIO DE LA LLAVE,30,CHICONTEPEC,058,SAYOLTEPEC,2,14,9,5,3
VERACRUZ DE IGNACIO DE LA LLAVE,30,CHICONTEPEC,058,SOLTEPEC,3,45,25,20,5
VERACRUZ DE IGNACIO DE LA LLAVE,30,CHICONTEPEC,058,TEÁCATL AMATLÁN,2,36,14,22,2
VERACRUZ DE IGNACIO DE LA LLAVE,30,CHICONTEPEC,058,TECERCA VIEJA,2,33,12,21,4
VERACRUZ DE IGNACIO DE LA LLAVE,30,CHICONTEPEC,058,TEMOCTLA,5,158,78,80,11
VERACRUZ DE IGNACIO DE LA LLAVE,30,CHICONTEPEC,058,TENEXCO,1,15,7,8,1
VERACRUZ DE IGNACIO DE LA LLAVE,30,CHICONTEPEC,058,TENEXTITLA,2,23,9,14,2
VERACRUZ DE IGNACIO DE LA LLAVE,30,CHICONTEPEC,058,TEPECXITLA,2,15,10,5,2
VERACRUZ DE IGNACIO DE LA LLAVE,30,CHICONTEPEC,058,TEPEICA IXCACUATITLA,1,5,1,4,1
VERACRUZ DE IGNACIO DE LA LLAVE,30,CHICONTEPEC,058,TEPENAHUAC,1,16,7,9,2
VERACRUZ DE IGNACIO DE LA LLAVE,30,CHICONTEPEC,058,TEPETZINTLA,5,126,55,71,13
VERACRUZ DE IGNACIO DE LA LLAVE,30,CHICONTEPEC,058,TEPEXOCOYO,2,46,26,20,3
VERACRUZ DE IGNACIO DE LA LLAVE,30,CHICONTEPEC,058,TEPONAXTLA,2,24,12,12,2
VERACRUZ DE IGNACIO DE LA LLAVE,30,CHICONTEPEC,058,TEPOXTECO,4,65,35,30,9
VERACRUZ DE IGNACIO DE LA LLAVE,30,CHICONTEPEC,058,TIOCUAYO,3,61,24,37,4
VERACRUZ DE IGNACIO DE LA LLAVE,30,CHICONTEPEC,058,TLACOLULA,8,728,336,392,80
VERACRUZ DE IGNACIO DE LA LLAVE,30,CHICONTEPEC,058,TLAMAYA PEMUXTITLA,2,21,10,11,3
VERACRUZ DE IGNACIO DE LA LLAVE,30,CHICONTEPEC,058,TLANEMPA COMÚN,4,260,130,130,16
VERACRUZ DE IGNACIO DE LA LLAVE,30,CHICONTEPEC,058,TLAQUEXTLA PEMUXTITLA,2,37,18,19,2
VERACRUZ DE IGNACIO DE LA LLAVE,30,CHICONTEPEC,058,TLAQUEXTLA TENEXTITLA,2,32,14,18,4
VERACRUZ DE IGNACIO DE LA LLAVE,30,CHICONTEPEC,058,TLATOLONGO,1,4,2,2,1
VERACRUZ DE IGNACIO DE LA LLAVE,30,CHICONTEPEC,058,TOLONCUITLATLA,2,32,17,15,4
VERACRUZ DE IGNACIO DE LA LLAVE,30,CHICONTEPEC,058,TOPALTEPEC,1,23,10,13,2
VERACRUZ DE IGNACIO DE LA LLAVE,30,CHICONTEPEC,058,TZAPULLO POSTECTITLA,2,18,9,9,2
VERACRUZ DE IGNACIO DE LA LLAVE,30,CHICONTEPEC,058,TZAPULLO TECOMATE,2,13,8,5,2
VERACRUZ DE IGNACIO DE LA LLAVE,30,CHICONTEPEC,058,XAHUAYOCA,1,11,4,7,1
VERACRUZ DE IGNACIO DE LA LLAVE,30,CHICONTEPEC,058,XALATLA,2,19,6,13,2
VERACRUZ DE IGNACIO DE LA LLAVE,30,CHICONTEPEC,058,XALTEPEC,2,35,17,18,2
VERACRUZ DE IGNACIO DE LA LLAVE,30,CHICONTEPEC,058,XIHUICALCO,2,46,25,21,4
VERACRUZ DE IGNACIO DE LA LLAVE,30,CHICONTEPEC,058,XILICO,1,5,2,3,1
VERACRUZ DE IGNACIO DE LA LLAVE,30,CHICONTEPEC,058,XOCHICUATEPEC,2,31,17,14,3
VERACRUZ DE IGNACIO DE LA LLAVE,30,CHICONTEPEC,058,XOCÓCATL,4,102,45,57,7
VERACRUZ DE IGNACIO DE LA LLAVE,30,CHICONTEPEC,058,ZACAHUIZTITLA,1,4,4,0,1
VERACRUZ DE IGNACIO DE LA LLAVE,30,CHICONTEPEC,058,ZACATITLA,2,22,14,8,3
VERACRUZ DE IGNACIO DE LA LLAVE,30,CHICONTEPEC,058,ZAPOTAL (ZAPOTAL MIRADOR),1,4,3,1,1
VERACRUZ DE IGNACIO DE LA LLAVE,30,CHICONTEPEC,058,ZAPOTEMPA,2,32,15,17,3
VERACRUZ DE IGNACIO DE LA LLAVE,30,CHICONTEPEC,058,ZONÁMATL,2,26,13,13,4
VERACRUZ DE IGNACIO DE LA LLAVE,30,CHINAMECA,059,AGUA FRÍA,3,153,72,81,9
VERACRUZ DE IGNACIO DE LA LLAVE,30,CHINAMECA,059,ALTO LUCERO,1,17,5,12,3
VERACRUZ DE IGNACIO DE LA LLAVE,30,CHINAMECA,059,ATEPONTA,3,65,29,36,7
VERACRUZ DE IGNACIO DE LA LLAVE,30,CHINAMECA,059,CHACALAPA,6,486,232,254,29
VERACRUZ DE IGNACIO DE LA LLAVE,30,CHINAMECA,059,CHINAMECA,12,1639,826,813,90
VERACRUZ DE IGNACIO DE LA LLAVE,30,CHINAMECA,059,EL ARENAL,1,63,29,34,5
VERACRUZ DE IGNACIO DE LA LLAVE,30,CHINAMECA,059,EL CHAPOPOTE,2,69,30,39,6
VERACRUZ DE IGNACIO DE LA LLAVE,30,CHINAMECA,059,LA PALMA,1,7,0,7,2
VERACRUZ DE IGNACIO DE LA LLAVE,30,CHINAMECA,059,LAS LOMAS CERRITOS,2,67,34,33,4
VERACRUZ DE IGNACIO DE LA LLAVE,30,CHINAMECA,059,LOS CERRITOS,3,198,103,95,15
VERACRUZ DE IGNACIO DE LA LLAVE,30,CHINAMECA,059,RANCHO NUEVO,2,3,0,3,1
VERACRUZ DE IGNACIO DE LA LLAVE,30,CHINAMECA,059,RANCHO VIEJO,3,78,40,38,6
VERACRUZ DE IGNACIO DE LA LLAVE,30,CHINAMECA,059,SAN JOSÉ TILAPA,2,33,13,20,3
VERACRUZ DE IGNACIO DE LA LLAVE,30,CHINAMECA,059,ZÚÑIGA,2,23,12,11,2
VERACRUZ DE IGNACIO DE LA LLAVE,30,CHINAMPA DE GOROSTIZA,060,AQUILES SERDÁN (RÍO BLANCO),2,25,14,11,3
VERACRUZ DE IGNACIO DE LA LLAVE,30,CHINAMPA DE GOROSTIZA,060,CERRO DE ORO,2,22,7,15,4
VERACRUZ DE IGNACIO DE LA LLAVE,30,CHINAMPA DE GOROSTIZA,060,CHAPOPOTE,1,14,6,8,2
VERACRUZ DE IGNACIO DE LA LLAVE,30,CHINAMPA DE GOROSTIZA,060,CHINAMPA DE GOROSTIZA,9,1157,591,566,60
VERACRUZ DE IGNACIO DE LA LLAVE,30,CHINAMPA DE GOROSTIZA,060,COLONIA LAS FLORES,2,159,69,90,9
VERACRUZ DE IGNACIO DE LA LLAVE,30,CHINAMPA DE GOROSTIZA,060,EJIDO LA MESA,1,9,6,3,1
VERACRUZ DE IGNACIO DE LA LLAVE,30,CHINAMPA DE GOROSTIZA,060,EJIDO NARANJOS,1,5,2,3,0
VERACRUZ DE IGNACIO DE LA LLAVE,30,CHINAMPA DE GOROSTIZA,060,EL CACHO,1,49,23,26,3
VERACRUZ DE IGNACIO DE LA LLAVE,30,CHINAMPA DE GOROSTIZA,060,JUAN CASIANO,2,25,10,15,2
VERACRUZ DE IGNACIO DE LA LLAVE,30,CHINAMPA DE GOROSTIZA,060,JUAN DE DIOS PEZA (SAN FRANCISCO),3,49,28,21,7
VERACRUZ DE IGNACIO DE LA LLAVE,30,CHINAMPA DE GOROSTIZA,060,KILÓMETRO VEINTICUATRO,2,178,80,98,9
VERACRUZ DE IGNACIO DE LA LLAVE,30,CHINAMPA DE GOROSTIZA,060,KILÓMETRO VEINTIDÓS,5,739,376,363,38
VERACRUZ DE IGNACIO DE LA LLAVE,30,CHINAMPA DE GOROSTIZA,060,LA PIMIENTA,4,190,77,113,15
VERACRUZ DE IGNACIO DE LA LLAVE,30,CHINAMPA DE GOROSTIZA,060,LOS ÓRGANOS,4,196,107,89,17
VERACRUZ DE IGNACIO DE LA LLAVE,30,CHINAMPA DE GOROSTIZA,060,MATA DE CAÑA,2,22,11,11,2
VERACRUZ DE IGNACIO DE LA LLAVE,30,CHINAMPA DE GOROSTIZA,060,MATA DE TAMPICO (LA Y GRIEGA),2,38,24,14,4
VERACRUZ DE IGNACIO DE LA LLAVE,30,CHINAMPA DE GOROSTIZA,060,POTRERO DEL LLANO,3,43,28,15,5
VERACRUZ DE IGNACIO DE LA LLAVE,30,CHINAMPA DE GOROSTIZA,060,QUEBRACHE,2,16,8,8,3
VERACRUZ DE IGNACIO DE LA LLAVE,30,CHINAMPA DE GOROSTIZA,060,SALTILLO CHIQUITO,1,6,2,4,1
VERACRUZ DE IGNACIO DE LA LLAVE,30,CHINAMPA DE GOROSTIZA,060,SOLIDARIDAD (CHINAMPA NÚMERO UNO),2,26,12,14,3
VERACRUZ DE IGNACIO DE LA LLAVE,30,LAS CHOAPAS,061,ALFONSO MEDINA,2,16,9,7,2
VERACRUZ DE IGNACIO DE LA LLAVE,30,LAS CHOAPAS,061,ALTO UXPANAPA (EL AMATE),4,157,78,79,9
VERACRUZ DE IGNACIO DE LA LLAVE,30,LAS CHOAPAS,061,AMATÁN,3,120,66,54,6
VERACRUZ DE IGNACIO DE LA LLAVE,30,LAS CHOAPAS,061,ÁNGEL VÁZQUEZ MARTÍNEZ,1,74,35,39,3
VERACRUZ DE IGNACIO DE LA LLAVE,30,LAS CHOAPAS,061,AQUILES SERDÁN,3,107,46,61,5
VERACRUZ DE IGNACIO DE LA LLAVE,30,LAS CHOAPAS,061,ARROYO GRANDE,4,106,45,61,7
VERACRUZ DE IGNACIO DE LA LLAVE,30,LAS CHOAPAS,061,ARROYO LAS CHOLINAS,3,50,28,22,4
VERACRUZ DE IGNACIO DE LA LLAVE,30,LAS CHOAPAS,061,ARROYO MARÍN,2,23,8,15,2
VERACRUZ DE IGNACIO DE LA LLAVE,30,LAS CHOAPAS,061,ARROYO VERDE,2,68,30,38,3
VERACRUZ DE IGNACIO DE LA LLAVE,30,LAS CHOAPAS,061,BARROSA,2,29,16,13,2
VERACRUZ DE IGNACIO DE LA LLAVE,30,LAS CHOAPAS,061,BENITO JUÁREZ,5,249,122,127,15
VERACRUZ DE IGNACIO DE LA LLAVE,30,LAS CHOAPAS,061,CEBADILLA,1,8,3,5,1
VERACRUZ DE IGNACIO DE LA LLAVE,30,LAS CHOAPAS,061,CEIBA BLANCA,3,97,38,59,7
VERACRUZ DE IGNACIO DE LA LLAVE,30,LAS CHOAPAS,061,CERRO DEL HORCÓN,2,30,14,16,3
VERACRUZ DE IGNACIO DE LA LLAVE,30,LAS CHOAPAS,061,CHICUAPILLA,2,23,13,10,2
VERACRUZ DE IGNACIO DE LA LLAVE,30,LAS CHOAPAS,061,CINCO DE MAYO,1,35,22,13,2
VERACRUZ DE IGNACIO DE LA LLAVE,30,LAS CHOAPAS,061,COLONIA CINCO DE MAYO (SEGUNDA SECCIÓN),2,10,3,7,2
VERACRUZ DE IGNACIO DE LA LLAVE,30,LAS CHOAPAS,061,CONSTITUCIÓN MEXICANA,1,9,3,6,1
VERACRUZ DE IGNACIO DE LA LLAVE,30,LAS CHOAPAS,061,CORONEL ADALBERTO TEJEDA (LA REFORMA),4,110,46,64,9
VERACRUZ DE IGNACIO DE LA LLAVE,30,LAS CHOAPAS,061,CUAUHTÉMOC PEDREGAL,5,117,67,50,10
VERACRUZ DE IGNACIO DE LA LLAVE,30,LAS CHOAPAS,061,EFIGENIA CASER,2,7,4,3,1
VERACRUZ DE IGNACIO DE LA LLAVE,30,LAS CHOAPAS,061,EJIDO SAN MARTÍN,2,10,2,8,1
VERACRUZ DE IGNACIO DE LA LLAVE,30,LAS CHOAPAS,061,EL AMATE,2,15,8,7,1
VERACRUZ DE IGNACIO DE LA LLAVE,30,LAS CHOAPAS,061,EL ARROYO DE ENMEDIO,2,19,9,10,2
VERACRUZ DE IGNACIO DE LA LLAVE,30,LAS CHOAPAS,061,EL AZUFRE,1,8,4,4,1
VERACRUZ DE IGNACIO DE LA LLAVE,30,LAS CHOAPAS,061,EL CASTAÑO,2,7,3,4,1
VERACRUZ DE IGNACIO DE LA LLAVE,30,LAS CHOAPAS,061,EL CHICHÓN,3,89,39,50,9
VERACRUZ DE IGNACIO DE LA LLAVE,30,LAS CHOAPAS,061,EL DESENGAÑO,2,25,6,19,2
VERACRUZ DE IGNACIO DE LA LLAVE,30,LAS CHOAPAS,061,EL ENCANTO,2,62,20,42,4
VERACRUZ DE IGNACIO DE LA LLAVE,30,LAS CHOAPAS,061,EL ESFUERZO,3,62,26,36,3
VERACRUZ DE IGNACIO DE LA LLAVE,30,LAS CHOAPAS,061,EL IDEAL,1,5,4,1,1
VERACRUZ DE IGNACIO DE LA LLAVE,30,LAS CHOAPAS,061,EL JOBO,2,33,14,19,2
VERACRUZ DE IGNACIO DE LA LLAVE,30,LAS CHOAPAS,061,EL MAZATE,4,223,102,121,13
VERACRUZ DE IGNACIO DE LA LLAVE,30,LAS CHOAPAS,061,EL MULATO,2,20,8,12,2
VERACRUZ DE IGNACIO DE LA LLAVE,30,LAS CHOAPAS,061,EL NACIMIENTO,2,76,35,41,5
VERACRUZ DE IGNACIO DE LA LLAVE,30,LAS CHOAPAS,061,EL NARANJO,2,52,23,29,3
VERACRUZ DE IGNACIO DE LA LLAVE,30,LAS CHOAPAS,061,EL NUEVO OCOTAL (CERRO DE LOS MARTÍNEZ),1,9,3,6,1
VERACRUZ DE IGNACIO DE LA LLAVE,30,LAS CHOAPAS,061,EL PAJARAL (BAJO GRANDE),2,26,14,12,2
VERACRUZ DE IGNACIO DE LA LLAVE,30,LAS CHOAPAS,061,EL PLAN (HUAPACALITO),3,302,156,146,16
VERACRUZ DE IGNACIO DE LA LLAVE,30,LAS CHOAPAS,061,EL PLAN HUAPACALITO,1,223,110,113,7
VERACRUZ DE IGNACIO DE LA LLAVE,30,LAS CHOAPAS,061,EL PROGRESO,3,64,30,34,4
VERACRUZ DE IGNACIO DE LA LLAVE,30,LAS CHOAPAS,061,EL REMOLINO,2,64,36,28,4
VERACRUZ DE IGNACIO DE LA LLAVE,30,LAS CHOAPAS,061,EL SAHUAYO,1,16,4,12,1
VERACRUZ DE IGNACIO DE LA LLAVE,30,LAS CHOAPAS,061,EL SATÉLITE,2,46,32,14,3
VERACRUZ DE IGNACIO DE LA LLAVE,30,LAS CHOAPAS,061,EL TRIUNFO (NUEVO PRESIDIO),2,22,12,10,2
VERACRUZ DE IGNACIO DE LA LLAVE,30,LAS CHOAPAS,061,EMILIANO ZAPATA,2,175,84,91,10
VERACRUZ DE IGNACIO DE LA LLAVE,30,LAS CHOAPAS,061,EMILIANO ZAPATA MISANTLA,3,56,34,22,3
VERACRUZ DE IGNACIO DE LA LLAVE,30,LAS CHOAPAS,061,ENRIQUE LÓPEZ HUITRÓN,2,22,12,10,3
VERACRUZ DE IGNACIO DE LA LLAVE,30,LAS CHOAPAS,061,ESCUADRÓN 201 SEGUNDO (LA GLORIA),1,32,16,16,1
VERACRUZ DE IGNACIO DE LA LLAVE,30,LAS CHOAPAS,061,FELIPE ÁNGELES,4,232,110,122,13
VERACRUZ DE IGNACIO DE LA LLAVE,30,LAS CHOAPAS,061,FERNANDO LÓPEZ ARIAS (EL ZAPOTE),2,64,34,30,3
VERACRUZ DE IGNACIO DE LA LLAVE,30,LAS CHOAPAS,061,FRANCISCO I. MADERO,1,9,3,6,1
VERACRUZ DE IGNACIO DE LA LLAVE,30,LAS CHOAPAS,061,FRANCISCO I. MADERO (AGUA FRÍA),3,66,34,32,4
VERACRUZ DE IGNACIO DE LA LLAVE,30,LAS CHOAPAS,061,FRANCISCO SARABIA,2,56,27,29,3
VERACRUZ DE IGNACIO DE LA LLAVE,30,LAS CHOAPAS,061,FRANCISCO VILLA,3,96,42,54,6
VERACRUZ DE IGNACIO DE LA LLAVE,30,LAS CHOAPAS,061,GIBRALTAR,1,5,1,4,1
VERACRUZ DE IGNACIO DE LA LLAVE,30,LAS CHOAPAS,061,GRACIANO SÁNCHEZ,3,181,93,88,11
VERACRUZ DE IGNACIO DE LA LLAVE,30,LAS CHOAPAS,061,GUADALUPE VICTORIA,3,49,21,28,3
VERACRUZ DE IGNACIO DE LA LLAVE,30,LAS CHOAPAS,061,GUADALUPE VICTORIA (RANCHO NUEVO),1,18,9,9,1
VERACRUZ DE IGNACIO DE LA LLAVE,30,LAS CHOAPAS,061,GUSTAVO DÍAZ ORDAZ,2,54,24,30,4
VERACRUZ DE IGNACIO DE LA LLAVE,30,LAS CHOAPAS,061,HUEYAPAN,2,16,8,8,2
VERACRUZ DE IGNACIO DE LA LLAVE,30,LAS CHOAPAS,061,IGNACIO LÓPEZ RAYÓN,5,322,142,180,13
VERACRUZ DE IGNACIO DE LA LLAVE,30,LAS CHOAPAS,061,IGNACIO ZARAGOZA (TRONCONADA),4,159,90,69,8
VERACRUZ DE IGNACIO DE LA LLAVE,30,LAS CHOAPAS,061,JOSÉ MARÍA MORELOS Y PAVÓN,1,13,6,7,1
VERACRUZ DE IGNACIO DE LA LLAVE,30,LAS CHOAPAS,061,LA AZTECA,1,4,2,2,1
VERACRUZ DE IGNACIO DE LA LLAVE,30,LAS CHOAPAS,061,LA COQUERA (EL HULEFANTE),1,6,3,3,1
VERACRUZ DE IGNACIO DE LA LLAVE,30,LAS CHOAPAS,061,LA CORDOBESA,2,56,28,28,3
VERACRUZ DE IGNACIO DE LA LLAVE,30,LAS CHOAPAS,061,LA GUADALUPE (EL JABÓN),2,9,4,5,1
VERACRUZ DE IGNACIO DE LA LLAVE,30,LAS CHOAPAS,061,LA LIBERTAD,3,43,19,24,5
VERACRUZ DE IGNACIO DE LA LLAVE,30,LAS CHOAPAS,061,LA NUEVA INDEPENDENCIA,1,11,2,9,1
VERACRUZ DE IGNACIO DE LA LLAVE,30,LAS CHOAPAS,061,LA SAL,2,15,8,7,2
VERACRUZ DE IGNACIO DE LA LLAVE,30,LAS CHOAPAS,061,LAGUNA EL PAJARAL,1,6,4,2,1
VERACRUZ DE IGNACIO DE LA LLAVE,30,LAS CHOAPAS,061,LAGUNA NUEVA,3,29,10,19,4
VERACRUZ DE IGNACIO DE LA LLAVE,30,LAS CHOAPAS,061,LAS CABRAS,2,35,19,16,3
VERACRUZ DE IGNACIO DE LA LLAVE,30,LAS CHOAPAS,061,LAS CHOAPAS,70,10736,5266,5470,697
VERACRUZ DE IGNACIO DE LA LLAVE,30,LAS CHOAPAS,061,LAS FLORES,2,154,74,80,11
VERACRUZ DE IGNACIO DE LA LLAVE,30,LAS CHOAPAS,061,LAS ISABELES,2,47,25,22,3
VERACRUZ DE IGNACIO DE LA LLAVE,30,LAS CHOAPAS,061,LAS MAÑANITAS,1,10,5,5,1
VERACRUZ DE IGNACIO DE LA LLAVE,30,LAS CHOAPAS,061,LAS MARÍAS,1,33,22,11,2
VERACRUZ DE IGNACIO DE LA LLAVE,30,LAS CHOAPAS,061,LAS PALMAS,2,32,13,19,2
VERACRUZ DE IGNACIO DE LA LLAVE,30,LAS CHOAPAS,061,LAS PIEDRAS,3,43,20,23,4
VERACRUZ DE IGNACIO DE LA LLAVE,30,LAS CHOAPAS,061,LÁZARO CÁRDENAS,1,24,11,13,1
VERACRUZ DE IGNACIO DE LA LLAVE,30,LAS CHOAPAS,061,LICENCIADO BENITO JUÁREZ,1,5,4,1,1
VERACRUZ DE IGNACIO DE LA LLAVE,30,LAS CHOAPAS,061,LICENCIADO JOSÉ LÓPEZ PORTILLO,1,9,6,3,1
VERACRUZ DE IGNACIO DE LA LLAVE,30,LAS CHOAPAS,061,LICENCIADO LUIS ECHEVERRÍA ÁLVAREZ (PLAYA SANTA),3,176,81,95,11
VERACRUZ DE IGNACIO DE LA LLAVE,30,LAS CHOAPAS,061,LICENCIADO TRINIDAD GARCÍA DE LA CADENA,2,54,28,26,3
VERACRUZ DE IGNACIO DE LA LLAVE,30,LAS CHOAPAS,061,LINDA TARDE,3,27,17,10,3
VERACRUZ DE IGNACIO DE LA LLAVE,30,LAS CHOAPAS,061,LINDAVISTA,1,24,12,12,1
VERACRUZ DE IGNACIO DE LA LLAVE,30,LAS CHOAPAS,061,LLANO VERDE,1,12,7,5,2
VERACRUZ DE IGNACIO DE LA LLAVE,30,LAS CHOAPAS,061,LOS AZTECAS,2,48,26,22,3
VERACRUZ DE IGNACIO DE LA LLAVE,30,LAS CHOAPAS,061,LOS CONSTITUYENTES II,3,125,60,65,9
VERACRUZ DE IGNACIO DE LA LLAVE,30,LAS CHOAPAS,061,LOS CONSTITUYENTES UNO (SUMIDERO),1,18,11,7,1
VERACRUZ DE IGNACIO DE LA LLAVE,30,LAS CHOAPAS,061,LOS FRAMBOYANES,4,64,31,33,5
VERACRUZ DE IGNACIO DE LA LLAVE,30,LAS CHOAPAS,061,LUIS DONALDO COLOSIO,2,33,18,15,3
VERACRUZ DE IGNACIO DE LA LLAVE,30,LAS CHOAPAS,061,LUIS ECHEVERRÍA,1,24,9,15,2
VERACRUZ DE IGNACIO DE LA LLAVE,30,LAS CHOAPAS,061,MALPASO (MALPASITO),3,85,42,43,3
VERACRUZ DE IGNACIO DE LA LLAVE,30,LAS CHOAPAS,061,MARCELINO GARCÍA BARRAGÁN (MONTE BELLO),1,15,8,7,1
VERACRUZ DE IGNACIO DE LA LLAVE,30,LAS CHOAPAS,061,MIGUEL HIDALGO Y COSTILLA,2,22,14,8,2
VERACRUZ DE IGNACIO DE LA LLAVE,30,LAS CHOAPAS,061,NIÑOS HÉROES,2,54,24,30,3
VERACRUZ DE IGNACIO DE LA LLAVE,30,LAS CHOAPAS,061,NUEVA ESPERANZA,2,32,13,19,3
VERACRUZ DE IGNACIO DE LA LLAVE,30,LAS CHOAPAS,061,NUEVA ESPERANZA (CERRO NANCHITAL),5,475,237,238,25
VERACRUZ DE IGNACIO DE LA LLAVE,30,LAS CHOAPAS,061,NUEVA TABASQUEÑA,4,124,57,67,7
VERACRUZ DE IGNACIO DE LA LLAVE,30,LAS CHOAPAS,061,NUEVO CALETÓN,2,24,9,15,2
VERACRUZ DE IGNACIO DE LA LLAVE,30,LAS CHOAPAS,061,NUEVO CASTREJÓN,5,49,23,26,5
VERACRUZ DE IGNACIO DE LA LLAVE,30,LAS CHOAPAS,061,NUEVO COACOATZINTLA,1,15,6,9,1
VERACRUZ DE IGNACIO DE LA LLAVE,30,LAS CHOAPAS,061,NUEVO IXTACOMITÁN,4,136,65,71,7
VERACRUZ DE IGNACIO DE LA LLAVE,30,LAS CHOAPAS,061,NUEVO PARAÍSO,1,34,20,14,1
VERACRUZ DE IGNACIO DE LA LLAVE,30,LAS CHOAPAS,061,NUEVO PROGRESO,3,74,31,43,7
VERACRUZ DE IGNACIO DE LA LLAVE,30,LAS CHOAPAS,061,NUEVO PROGRESO (NUEVO LEÓN),2,10,5,5,2
VERACRUZ DE IGNACIO DE LA LLAVE,30,LAS CHOAPAS,061,NUEVO SACRIFICIO,1,14,5,9,1
VERACRUZ DE IGNACIO DE LA LLAVE,30,LAS CHOAPAS,061,ONCE DE FEBRERO,1,28,16,12,1
VERACRUZ DE IGNACIO DE LA LLAVE,30,LAS CHOAPAS,061,PEÑA BLANCA,2,13,7,6,1
VERACRUZ DE IGNACIO DE LA LLAVE,30,LAS CHOAPAS,061,PLAN DE IGUALA,3,50,26,24,4
VERACRUZ DE IGNACIO DE LA LLAVE,30,LAS CHOAPAS,061,PLUTARCO ELÍAS CALLES,2,39,20,19,3
VERACRUZ DE IGNACIO DE LA LLAVE,30,LAS CHOAPAS,061,POBLADO LAS PALMAS,1,72,34,38,3
VERACRUZ DE IGNACIO DE LA LLAVE,30,LAS CHOAPAS,061,PRIMITIVO R. VALENCIA,2,19,10,9,2
VERACRUZ DE IGNACIO DE LA LLAVE,30,LAS CHOAPAS,061,PRIVILEGIO,3,94,49,45,4
VERACRUZ DE IGNACIO DE LA LLAVE,30,LAS CHOAPAS,061,PUEBLO VIEJO,4,85,42,43,6
VERACRUZ DE IGNACIO DE LA LLAVE,30,LAS CHOAPAS,061,RAFAEL MURILLO VIDAL,4,145,70,75,7
VERACRUZ DE IGNACIO DE LA LLAVE,30,LAS CHOAPAS,061,RAMOS MILLÁN,3,18,12,6,2
VERACRUZ DE IGNACIO DE LA LLAVE,30,LAS CHOAPAS,061,RANCHO GILBERTO,1,4,4,0,1
VERACRUZ DE IGNACIO DE LA LLAVE,30,LAS CHOAPAS,061,RANCHO NUEVO,2,30,18,12,2
VERACRUZ DE IGNACIO DE LA LLAVE,30,LAS CHOAPAS,061,RANCHO VIEJO,2,19,11,8,2
VERACRUZ DE IGNACIO DE LA LLAVE,30,LAS CHOAPAS,061,REVOLUCIÓN,2,46,28,18,3
VERACRUZ DE IGNACIO DE LA LLAVE,30,LAS CHOAPAS,061,RÍO PEDREGAL,1,15,5,10,1
VERACRUZ DE IGNACIO DE LA LLAVE,30,LAS CHOAPAS,061,RÍO PLAYAS,2,128,56,72,5
VERACRUZ DE IGNACIO DE LA LLAVE,30,LAS CHOAPAS,061,RÍO PLAYAS (LOS ROBLES),1,88,46,42,6
VERACRUZ DE IGNACIO DE LA LLAVE,30,LAS CHOAPAS,061,RIVERA DEL CARMEN,2,32,19,13,3
VERACRUZ DE IGNACIO DE LA LLAVE,30,LAS CHOAPAS,061,SAMARIA (RÍO PLAYAS),2,68,32,36,4
VERACRUZ DE IGNACIO DE LA LLAVE,30,LAS CHOAPAS,061,SAN ANTONIO,3,49,22,27,4
VERACRUZ DE IGNACIO DE LA LLAVE,30,LAS CHOAPAS,061,SAN JOSÉ DEL CARMEN,1,82,31,51,4
VERACRUZ DE IGNACIO DE LA LLAVE,30,LAS CHOAPAS,061,SAN JUAN DE ULÚA,2,55,25,30,3
VERACRUZ DE IGNACIO DE LA LLAVE,30,LAS CHOAPAS,061,SAN LORENZO,2,52,28,24,2
VERACRUZ DE IGNACIO DE LA LLAVE,30,LAS CHOAPAS,061,SAN MARTÍN,1,9,2,7,1
VERACRUZ DE IGNACIO DE LA LLAVE,30,LAS CHOAPAS,061,SAN MIGUEL,1,8,4,4,1
VERACRUZ DE IGNACIO DE LA LLAVE,30,LAS CHOAPAS,061,SAN MIGUEL DE ALLENDE,3,118,62,56,8
VERACRUZ DE IGNACIO DE LA LLAVE,30,LAS CHOAPAS,061,SAN PABLO,1,4,3,1,1
VERACRUZ DE IGNACIO DE LA LLAVE,30,LAS CHOAPAS,061,SANTA TERESA,3,50,25,25,4
VERACRUZ DE IGNACIO DE LA LLAVE,30,LAS CHOAPAS,061,TECOZAUTLA,2,28,13,15,2
VERACRUZ DE IGNACIO DE LA LLAVE,30,LAS CHOAPAS,061,TECUANAPA (VICENTE GUERRERO),3,100,58,42,6
VERACRUZ DE IGNACIO DE LA LLAVE,30,LAS CHOAPAS,061,TIERRA MORADA,2,23,13,10,2
VERACRUZ DE IGNACIO DE LA LLAVE,30,LAS CHOAPAS,061,ÚRSULO GALVÁN,2,46,25,21,3
VERACRUZ DE IGNACIO DE LA LLAVE,30,LAS CHOAPAS,061,VENUSTIANO CARRANZA,2,16,9,7,2
VERACRUZ DE IGNACIO DE LA LLAVE,30,LAS CHOAPAS,061,VICENTE GUERRERO,4,39,15,24,4
VERACRUZ DE IGNACIO DE LA LLAVE,30,LAS CHOAPAS,061,VISTA HERMOSA,2,37,18,19,2
VERACRUZ DE IGNACIO DE LA LLAVE,30,LAS CHOAPAS,061,XOCHITLÁN,3,59,20,39,4
VERACRUZ DE IGNACIO DE LA LLAVE,30,LAS CHOAPAS,061,YUCATECO EL PEDREGAL,4,113,48,65,7
VERACRUZ DE IGNACIO DE LA LLAVE,30,CHOCAMÁN,062,CALAQUIOCO,3,126,60,66,7
VERACRUZ DE IGNACIO DE LA LLAVE,30,CHOCAMÁN,062,CARRIZAL,3,31,14,17,3
VERACRUZ DE IGNACIO DE LA LLAVE,30,CHOCAMÁN,062,CHOCAMÁN,16,2684,1321,1363,130
VERACRUZ DE IGNACIO DE LA LLAVE,30,CHOCAMÁN,062,LA CANTERA (ANALCO),1,5,1,4,1
VERACRUZ DE IGNACIO DE LA LLAVE,30,CHOCAMÁN,062,LA FLOR DEL LLANO (ROSA MÍSTICA),1,10,4,6,1
VERACRUZ DE IGNACIO DE LA LLAVE,30,CHOCAMÁN,062,RINCÓN PINTOR,2,163,76,87,8
VERACRUZ DE IGNACIO DE LA LLAVE,30,CHOCAMÁN,062,SAN JOSÉ NERIA,3,125,58,67,8
VERACRUZ DE IGNACIO DE LA LLAVE,30,CHOCAMÁN,062,TEPEXILOTLA,2,36,16,20,2
VERACRUZ DE IGNACIO DE LA LLAVE,30,CHOCAMÁN,062,TETLA,5,727,373,354,35
VERACRUZ DE IGNACIO DE LA LLAVE,30,CHOCAMÁN,062,XONOTZINTLA,2,118,65,53,6
VERACRUZ DE IGNACIO DE LA LLAVE,30,CHONTLA,063,ARRANCA ESTACAS,2,49,26,23,7
VERACRUZ DE IGNACIO DE LA LLAVE,30,CHONTLA,063,CHONTLA,6,867,421,446,57
VERACRUZ DE IGNACIO DE LA LLAVE,30,CHONTLA,063,COMALES,1,10,5,5,1
VERACRUZ DE IGNACIO DE LA LLAVE,30,CHONTLA,063,COMALES NARANJADO,1,22,6,16,2
VERACRUZ DE IGNACIO DE LA LLAVE,30,CHONTLA,063,CRUZ MANANTIAL,3,57,26,31,6
VERACRUZ DE IGNACIO DE LA LLAVE,30,CHONTLA,063,DOÑA ANA,2,15,9,6,2
VERACRUZ DE IGNACIO DE LA LLAVE,30,CHONTLA,063,EL CAJETE,2,6,2,4,1
VERACRUZ DE IGNACIO DE LA LLAVE,30,CHONTLA,063,EL COYOL,2,11,5,6,2
VERACRUZ DE IGNACIO DE LA LLAVE,30,CHONTLA,063,EL MAGUEY,3,28,14,14,5
VERACRUZ DE IGNACIO DE LA LLAVE,30,CHONTLA,063,LA CUCHILLA,1,8,6,2,1
VERACRUZ DE IGNACIO DE LA LLAVE,30,CHONTLA,063,LA FLORIDA,2,40,25,15,3
VERACRUZ DE IGNACIO DE LA LLAVE,30,CHONTLA,063,LA GARITA,3,120,54,66,10
VERACRUZ DE IGNACIO DE LA LLAVE,30,CHONTLA,063,LA REFORMA,2,20,10,10,2
VERACRUZ DE IGNACIO DE LA LLAVE,30,CHONTLA,063,LAS CANOAS,5,137,66,71,11
VERACRUZ DE IGNACIO DE LA LLAVE,30,CHONTLA,063,LAS CRUCES,3,84,48,36,11
VERACRUZ DE IGNACIO DE LA LLAVE,30,CHONTLA,063,LOS CALLEJONES,4,90,46,44,10
VERACRUZ DE IGNACIO DE LA LLAVE,30,CHONTLA,063,MAGOZAL,3,80,39,41,8
VERACRUZ DE IGNACIO DE LA LLAVE,30,CHONTLA,063,MALA GANA,1,17,7,10,2
VERACRUZ DE IGNACIO DE LA LLAVE,30,CHONTLA,063,MATA DE OTATE,4,127,68,59,11
VERACRUZ DE IGNACIO DE LA LLAVE,30,CHONTLA,063,PALO DE ROSAS,2,30,15,15,3
VERACRUZ DE IGNACIO DE LA LLAVE,30,CHONTLA,063,RANCHO QUEMADO,3,55,27,28,6
VERACRUZ DE IGNACIO DE LA LLAVE,30,CHONTLA,063,SAN FRANCISCO,4,288,131,157,30
VERACRUZ DE IGNACIO DE LA LLAVE,30,CHONTLA,063,SAN JUAN OTONTEPEC,4,204,99,105,19
VERACRUZ DE IGNACIO DE LA LLAVE,30,CHONTLA,063,SAN NICOLASILLO,2,36,20,16,4
VERACRUZ DE IGNACIO DE LA LLAVE,30,CHONTLA,063,SANTA VALERIA,2,21,9,12,2
VERACRUZ DE IGNACIO DE LA LLAVE,30,CHONTLA,063,TAMALCUATITLA,2,22,13,9,3
VERACRUZ DE IGNACIO DE LA LLAVE,30,CHONTLA,063,TANCOLOL,2,54,29,25,5
VERACRUZ DE IGNACIO DE LA LLAVE,30,CHONTLA,063,TEZITLAL,2,13,6,7,3
VERACRUZ DE IGNACIO DE LA LLAVE,30,CHONTLA,063,TLATEMALCO,1,6,3,3,1
VERACRUZ DE IGNACIO DE LA LLAVE,30,CHONTLA,063,XOCHITLÁN (PARAJES),4,101,40,61,9
VERACRUZ DE IGNACIO DE LA LLAVE,30,CHUMATLÁN,064,CHUMATLÁN,6,442,212,230,32
VERACRUZ DE IGNACIO DE LA LLAVE,30,CHUMATLÁN,064,EL ZAPOTE,2,28,11,17,2
VERACRUZ DE IGNACIO DE LA LLAVE,30,CHUMATLÁN,064,LA VEGA,2,92,41,51,7
VERACRUZ DE IGNACIO DE LA LLAVE,30,CHUMATLÁN,064,LÁZARO CÁRDENAS (SANTANA),4,445,231,214,28
VERACRUZ DE IGNACIO DE LA LLAVE,30,EMILIANO ZAPATA,065,ALBORADA,3,272,123,149,18
VERACRUZ DE IGNACIO DE LA LLAVE,30,EMILIANO ZAPATA,065,AQUILES CÓRDOBA MORÁN,2,22,15,7,3
VERACRUZ DE IGNACIO DE LA LLAVE,30,EMILIANO ZAPATA,065,BUENA VISTA,4,186,93,93,17
VERACRUZ DE IGNACIO DE LA LLAVE,30,EMILIANO ZAPATA,065,CERRO GORDO,4,379,192,187,24
VERACRUZ DE IGNACIO DE LA LLAVE,30,EMILIANO ZAPATA,065,CHAVARRILLO,4,390,195,195,28
VERACRUZ DE IGNACIO DE LA LLAVE,30,EMILIANO ZAPATA,065,CIUDAD PRIMAVERA,1,44,18,26,3
VERACRUZ DE IGNACIO DE LA LLAVE,30,EMILIANO ZAPATA,065,COLONIA LA PERSEVERANCIA,1,16,6,10,3
VERACRUZ DE IGNACIO DE LA LLAVE,30,EMILIANO ZAPATA,065,CORRAL FALSO,1,14,5,9,2
VERACRUZ DE IGNACIO DE LA LLAVE,30,EMILIANO ZAPATA,065,DOS RÍOS,6,893,434,459,73
VERACRUZ DE IGNACIO DE LA LLAVE,30,EMILIANO ZAPATA,065,EL AGUAJE,3,94,45,49,8
VERACRUZ DE IGNACIO DE LA LLAVE,30,EMILIANO ZAPATA,065,EL CHICO,5,527,226,301,38
VERACRUZ DE IGNACIO DE LA LLAVE,30,EMILIANO ZAPATA,065,EL GUAYABO,3,146,78,68,10
VERACRUZ DE IGNACIO DE LA LLAVE,30,EMILIANO ZAPATA,065,EL LENCERO,4,486,228,258,33
VERACRUZ DE IGNACIO DE LA LLAVE,30,EMILIANO ZAPATA,065,EL LIMÓN,1,3,1,2,1
VERACRUZ DE IGNACIO DE LA LLAVE,30,EMILIANO ZAPATA,065,EL PALMAR [ESTACIÓN EL PALMAR],3,86,40,46,8
VERACRUZ DE IGNACIO DE LA LLAVE,30,EMILIANO ZAPATA,065,EL ROBLE,3,94,42,52,7
VERACRUZ DE IGNACIO DE LA LLAVE,30,EMILIANO ZAPATA,065,EL TERRERO,5,242,120,122,22
VERACRUZ DE IGNACIO DE LA LLAVE,30,EMILIANO ZAPATA,065,ESTACIÓN CHAVARRILLO,2,86,36,50,8
VERACRUZ DE IGNACIO DE LA LLAVE,30,EMILIANO ZAPATA,065,JACARANDAS,9,1273,636,637,72
VERACRUZ DE IGNACIO DE LA LLAVE,30,EMILIANO ZAPATA,065,LA AURORA,1,4,3,1,1
VERACRUZ DE IGNACIO DE LA LLAVE,30,EMILIANO ZAPATA,065,LA BALSA,2,26,11,15,3
VERACRUZ DE IGNACIO DE LA LLAVE,30,EMILIANO ZAPATA,065,LA ESTANZUELA,7,1068,533,535,61
VERACRUZ DE IGNACIO DE LA LLAVE,30,EMILIANO ZAPATA,065,LA PRADERA,1,71,38,33,5
VERACRUZ DE IGNACIO DE LA LLAVE,30,EMILIANO ZAPATA,065,LA TINAJA,4,242,110,132,18
VERACRUZ DE IGNACIO DE LA LLAVE,30,EMILIANO ZAPATA,065,LAS TRANCAS,18,2879,1512,1367,381
VERACRUZ DE IGNACIO DE LA LLAVE,30,EMILIANO ZAPATA,065,LOMA DE ROGEL,2,18,8,10,3
VERACRUZ DE IGNACIO DE LA LLAVE,30,EMILIANO ZAPATA,065,LOMAS DE MIRADORES,1,25,12,13,3
VERACRUZ DE IGNACIO DE LA LLAVE,30,EMILIANO ZAPATA,065,MARCO ANTONIO MUÑOZ (NACAXTLE),3,94,44,50,8
VERACRUZ DE IGNACIO DE LA LLAVE,30,EMILIANO ZAPATA,065,MATA OBSCURA (LA VIRGEN),2,67,46,21,4
VERACRUZ DE IGNACIO DE LA LLAVE,30,EMILIANO ZAPATA,065,MIRADORES (MIRADORES DEL MAR),7,648,319,329,53
VERACRUZ DE IGNACIO DE LA LLAVE,30,EMILIANO ZAPATA,065,MONTE OBSCURO (COLONIA PÉNJAMO),2,58,22,36,5
VERACRUZ DE IGNACIO DE LA LLAVE,30,EMILIANO ZAPATA,065,OJO DE AGUA,3,359,177,182,23
VERACRUZ DE IGNACIO DE LA LLAVE,30,EMILIANO ZAPATA,065,PACHO NUEVO,5,675,338,337,50
VERACRUZ DE IGNACIO DE LA LLAVE,30,EMILIANO ZAPATA,065,PAJARITOS,2,65,32,33,6
VERACRUZ DE IGNACIO DE LA LLAVE,30,EMILIANO ZAPATA,065,PALMAREJO,2,58,25,33,4
VERACRUZ DE IGNACIO DE LA LLAVE,30,EMILIANO ZAPATA,065,PALO GACHO,4,298,149,149,27
VERACRUZ DE IGNACIO DE LA LLAVE,30,EMILIANO ZAPATA,065,PASO GRANDE [ESTACIÓN EL CHICO],2,28,17,11,3
VERACRUZ DE IGNACIO DE LA LLAVE,30,EMILIANO ZAPATA,065,PASO LADRILLO,2,43,18,25,5
VERACRUZ DE IGNACIO DE LA LLAVE,30,EMILIANO ZAPATA,065,PINOLTEPEC,4,222,116,106,16
VERACRUZ DE IGNACIO DE LA LLAVE,30,EMILIANO ZAPATA,065,PLAN DEL RÍO,3,208,111,97,13
VERACRUZ DE IGNACIO DE LA LLAVE,30,EMILIANO ZAPATA,065,RANCHO NUEVO,3,90,39,51,7
VERACRUZ DE IGNACIO DE LA LLAVE,30,EMILIANO ZAPATA,065,RANCHO VIEJO,4,402,203,199,27
VERACRUZ DE IGNACIO DE LA LLAVE,30,EMILIANO ZAPATA,065,RINCONADA,10,1824,939,885,118
VERACRUZ DE IGNACIO DE LA LLAVE,30,EMILIANO ZAPATA,065,ROMA,1,95,40,55,5
VERACRUZ DE IGNACIO DE LA LLAVE,30,EMILIANO ZAPATA,065,TRES PASOS,1,7,4,3,1
VERACRUZ DE IGNACIO DE LA LLAVE,30,EMILIANO ZAPATA,065,VILLA EMILIANO ZAPATA (EL CARRIZAL),8,1244,638,606,96
VERACRUZ DE IGNACIO DE LA LLAVE,30,EMILIANO ZAPATA,065,XOLTEPEC,2,41,23,18,3
VERACRUZ DE IGNACIO DE LA LLAVE,30,ESPINAL,066,ARENAL,4,345,174,171,24
VERACRUZ DE IGNACIO DE LA LLAVE,30,ESPINAL,066,BUENAVISTA,6,286,136,150,19
VERACRUZ DE IGNACIO DE LA LLAVE,30,ESPINAL,066,CHAPULTEPEC,3,174,91,83,12
VERACRUZ DE IGNACIO DE LA LLAVE,30,ESPINAL,066,CINCO DE OCTUBRE,2,147,72,75,8
VERACRUZ DE IGNACIO DE LA LLAVE,30,ESPINAL,066,COLONIA CUAUHTÉMOC,2,23,14,9,2
VERACRUZ DE IGNACIO DE LA LLAVE,30,ESPINAL,066,COLONIA GUADALUPE DE HIDALGO,2,26,9,17,2
VERACRUZ DE IGNACIO DE LA LLAVE,30,ESPINAL,066,COLONIA MEDIODÍA,2,31,13,18,3
VERACRUZ DE IGNACIO DE LA LLAVE,30,ESPINAL,066,COLONIA SANTA CRUZ,2,21,12,9,3
VERACRUZ DE IGNACIO DE LA LLAVE,30,ESPINAL,066,COMALTECO,5,340,162,178,26
VERACRUZ DE IGNACIO DE LA LLAVE,30,ESPINAL,066,EL CERRO,2,23,11,12,2
VERACRUZ DE IGNACIO DE LA LLAVE,30,ESPINAL,066,EL CIRUELO,6,331,163,168,21
VERACRUZ DE IGNACIO DE LA LLAVE,30,ESPINAL,066,EL ERMITAÑO,4,158,71,87,12
VERACRUZ DE IGNACIO DE LA LLAVE,30,ESPINAL,066,EL MIRADOR,4,110,57,53,9
VERACRUZ DE IGNACIO DE LA LLAVE,30,ESPINAL,066,EL PACÍFICO,4,233,109,124,14
VERACRUZ DE IGNACIO DE LA LLAVE,30,ESPINAL,066,EL ZAPOTAL,2,28,15,13,2
VERACRUZ DE IGNACIO DE LA LLAVE,30,ESPINAL,066,ENTABLADERO,8,1121,525,596,68
VERACRUZ DE IGNACIO DE LA LLAVE,30,ESPINAL,066,ESPINAL,14,1354,717,637,78
VERACRUZ DE IGNACIO DE LA LLAVE,30,ESPINAL,066,GARRANCHOS,1,24,12,12,2
VERACRUZ DE IGNACIO DE LA LLAVE,30,ESPINAL,066,LA GUADALUPE,2,44,22,22,3
VERACRUZ DE IGNACIO DE LA LLAVE,30,ESPINAL,066,LA LUNA,3,55,26,29,5
VERACRUZ DE IGNACIO DE LA LLAVE,30,ESPINAL,066,LA NORIA,2,105,48,57,9
VERACRUZ DE IGNACIO DE LA LLAVE,30,ESPINAL,066,LA NUEVA ESPERANZA,1,32,16,16,2
VERACRUZ DE IGNACIO DE LA LLAVE,30,ESPINAL,066,MELCHOR OCAMPO,4,276,130,146,15
VERACRUZ DE IGNACIO DE LA LLAVE,30,ESPINAL,066,MIGUEL ALEMÁN VALDÉS,5,237,105,132,16
VERACRUZ DE IGNACIO DE LA LLAVE,30,ESPINAL,066,NUEVO OJITE,2,25,13,12,2
VERACRUZ DE IGNACIO DE LA LLAVE,30,ESPINAL,066,OJO DE AGUA,2,62,29,33,6
VERACRUZ DE IGNACIO DE LA LLAVE,30,ESPINAL,066,ORIENTE MEDIO DÍA,3,159,67,92,11
VERACRUZ DE IGNACIO DE LA LLAVE,30,ESPINAL,066,ORIENTE MERIDIANO,2,100,64,36,9
VERACRUZ DE IGNACIO DE LA LLAVE,30,ESPINAL,066,POZA LARGA MIRADORES,3,114,46,68,10
VERACRUZ DE IGNACIO DE LA LLAVE,30,ESPINAL,066,POZA LARGA ZAPOTAL,5,284,140,144,18
VERACRUZ DE IGNACIO DE LA LLAVE,30,ESPINAL,066,SAN FRANCISCO,3,117,54,63,10
VERACRUZ DE IGNACIO DE LA LLAVE,30,ESPINAL,066,SAN LEONCIO JAMAYA,3,299,142,157,15
VERACRUZ DE IGNACIO DE LA LLAVE,30,ESPINAL,066,SAN PEDRO MIRADORES,1,9,3,6,1
VERACRUZ DE IGNACIO DE LA LLAVE,30,ESPINAL,066,SANTA ISABEL,7,466,232,234,26
VERACRUZ DE IGNACIO DE LA LLAVE,30,ESPINAL,066,ZACATE LIMÓN,2,107,53,54,9
VERACRUZ DE IGNACIO DE LA LLAVE,30,ESPINAL,066,ZAPOTE CHICO,2,38,17,21,4
VERACRUZ DE IGNACIO DE LA LLAVE,30,FILOMENO MATA,067,CERRO GRANDE,4,498,237,261,27
VERACRUZ DE IGNACIO DE LA LLAVE,30,FILOMENO MATA,067,COLONIA ELEODORO DÁVILA,3,540,260,280,25
VERACRUZ DE IGNACIO DE LA LLAVE,30,FILOMENO MATA,067,EL CRUCERO,3,237,127,110,13
VERACRUZ DE IGNACIO DE LA LLAVE,30,FILOMENO MATA,067,FILOMENO MATA,12,3644,1801,1843,189
VERACRUZ DE IGNACIO DE LA LLAVE,30,FILOMENO MATA,067,FRANCISCO VILLA,3,257,127,130,15
VERACRUZ DE IGNACIO DE LA LLAVE,30,FILOMENO MATA,067,MARÍA DE LA LETRA,2,64,36,28,3
VERACRUZ DE IGNACIO DE LA LLAVE,30,FORTÍN,068,COAPICHAPAN (BARRANCA DE SAN MIGUEL),4,77,34,43,6
VERACRUZ DE IGNACIO DE LA LLAVE,30,FORTÍN,068,CÓRDOBA (SANTA LETICIA),5,584,291,293,77
VERACRUZ DE IGNACIO DE LA LLAVE,30,FORTÍN,068,CRUCERO NACIONAL,3,225,103,122,20
VERACRUZ DE IGNACIO DE LA LLAVE,30,FORTÍN,068,FORTÍN DE LAS FLORES,68,8430,4237,4193,709
VERACRUZ DE IGNACIO DE LA LLAVE,30,FORTÍN,068,FRACCIONAMIENTO VILLAS DE LA LLAVE,2,330,155,175,14
VERACRUZ DE IGNACIO DE LA LLAVE,30,FORTÍN,068,KILÓMETRO QUINCE,2,9,5,4,2
VERACRUZ DE IGNACIO DE LA LLAVE,30,FORTÍN,068,MATA LARGA,1,15,5,10,1
VERACRUZ DE IGNACIO DE LA LLAVE,30,FORTÍN,068,MONTE BLANCO,8,1454,740,714,69
VERACRUZ DE IGNACIO DE LA LLAVE,30,FORTÍN,068,MONTE SALAS,3,524,247,277,25
VERACRUZ DE IGNACIO DE LA LLAVE,30,FORTÍN,068,PASO TIMÓN,1,34,14,20,3
VERACRUZ DE IGNACIO DE LA LLAVE,30,FORTÍN,068,PUEBLO DE LAS FLORES (TLACOTENGO),1,35,18,17,3
VERACRUZ DE IGNACIO DE LA LLAVE,30,FORTÍN,068,PUENTE BLANCO,2,50,17,33,4
VERACRUZ DE IGNACIO DE LA LLAVE,30,FORTÍN,068,SAN BASILIO,2,75,34,41,6
VERACRUZ DE IGNACIO DE LA LLAVE,30,FORTÍN,068,SAN MARTÍN,1,34,17,17,2
VERACRUZ DE IGNACIO DE LA LLAVE,30,FORTÍN,068,SANTA LUCÍA POTRERILLO,1,65,31,34,3
VERACRUZ DE IGNACIO DE LA LLAVE,30,FORTÍN,068,VILLA LIBERTAD,2,58,30,28,5
VERACRUZ DE IGNACIO DE LA LLAVE,30,FORTÍN,068,VILLA UNIÓN,3,213,105,108,11
VERACRUZ DE IGNACIO DE LA LLAVE,30,FORTÍN,068,ZAPOAPITA,2,12,5,7,2
VERACRUZ DE IGNACIO DE LA LLAVE,30,GUTIÉRREZ ZAMORA,069,ANCLÓN Y ARENAL,2,43,26,17,4
VERACRUZ DE IGNACIO DE LA LLAVE,30,GUTIÉRREZ ZAMORA,069,ARROYO GRANDE,3,39,11,28,7
VERACRUZ DE IGNACIO DE LA LLAVE,30,GUTIÉRREZ ZAMORA,069,CARRILLO PUERTO (SANTA ROSA),4,252,126,126,17
VERACRUZ DE IGNACIO DE LA LLAVE,30,GUTIÉRREZ ZAMORA,069,DESVIACIÓN PASO DE BARRILES,1,10,1,9,1
VERACRUZ DE IGNACIO DE LA LLAVE,30,GUTIÉRREZ ZAMORA,069,EJIDO SOTO Y GAMA,3,19,12,7,3
VERACRUZ DE IGNACIO DE LA LLAVE,30,GUTIÉRREZ ZAMORA,069,EL CEPILLO,3,52,27,25,7
VERACRUZ DE IGNACIO DE LA LLAVE,30,GUTIÉRREZ ZAMORA,069,EL COCO,2,23,12,11,3
VERACRUZ DE IGNACIO DE LA LLAVE,30,GUTIÉRREZ ZAMORA,069,EL MANGO,1,5,5,0,1
VERACRUZ DE IGNACIO DE LA LLAVE,30,GUTIÉRREZ ZAMORA,069,EL OJITE,2,32,17,15,4
VERACRUZ DE IGNACIO DE LA LLAVE,30,GUTIÉRREZ ZAMORA,069,ENSENADA DEL CEPILLO,1,2,0,2,1
VERACRUZ DE IGNACIO DE LA LLAVE,30,GUTIÉRREZ ZAMORA,069,GUTIÉRREZ ZAMORA,27,4504,2258,2246,482
VERACRUZ DE IGNACIO DE LA LLAVE,30,GUTIÉRREZ ZAMORA,069,HERMENEGILDO GALEANA,4,195,83,112,15
VERACRUZ DE IGNACIO DE LA LLAVE,30,GUTIÉRREZ ZAMORA,069,IGNACIO M. ALTAMIRANO (PLAN DE ALTAMIRANO),4,160,90,70,12
VERACRUZ DE IGNACIO DE LA LLAVE,30,GUTIÉRREZ ZAMORA,069,IGNACIO MUÑOZ (ZAPOTAL),3,51,19,32,6
VERACRUZ DE IGNACIO DE LA LLAVE,30,GUTIÉRREZ ZAMORA,069,LA LUZ DEL PORTUGUÉS,2,36,21,15,3
VERACRUZ DE IGNACIO DE LA LLAVE,30,GUTIÉRREZ ZAMORA,069,LOMAS CHICAS,2,15,8,7,2
VERACRUZ DE IGNACIO DE LA LLAVE,30,GUTIÉRREZ ZAMORA,069,LOMAS DE ARENA,5,271,144,127,18
VERACRUZ DE IGNACIO DE LA LLAVE,30,GUTIÉRREZ ZAMORA,069,MACARENA ARRAZOLA,1,6,3,3,1
VERACRUZ DE IGNACIO DE LA LLAVE,30,GUTIÉRREZ ZAMORA,069,NUEVO RENACIMIENTO 2000,4,188,92,96,16
VERACRUZ DE IGNACIO DE LA LLAVE,30,GUTIÉRREZ ZAMORA,069,PAGUAS DE ARROYO GRANDE,1,9,5,4,2
VERACRUZ DE IGNACIO DE LA LLAVE,30,GUTIÉRREZ ZAMORA,069,PAGUAS DE CORONADO,2,15,7,8,2
VERACRUZ DE IGNACIO DE LA LLAVE,30,GUTIÉRREZ ZAMORA,069,RAFAEL VALENZUELA,3,98,49,49,9
VERACRUZ DE IGNACIO DE LA LLAVE,30,GUTIÉRREZ ZAMORA,069,SAN MIGUEL,2,33,17,16,5
VERACRUZ DE IGNACIO DE LA LLAVE,30,HIDALGOTITLÁN,070,ADALBERTO TEJEDA,3,66,30,36,5
VERACRUZ DE IGNACIO DE LA LLAVE,30,HIDALGOTITLÁN,070,ADOLFO LÓPEZ MATEOS,4,107,51,56,7
VERACRUZ DE IGNACIO DE LA LLAVE,30,HIDALGOTITLÁN,070,ARROYO DE LA PALMA,4,171,86,85,9
VERACRUZ DE IGNACIO DE LA LLAVE,30,HIDALGOTITLÁN,070,BOCA DE ORO,2,42,18,24,3
VERACRUZ DE IGNACIO DE LA LLAVE,30,HIDALGOTITLÁN,070,BUENAVISTA,2,24,13,11,3
VERACRUZ DE IGNACIO DE LA LLAVE,30,HIDALGOTITLÁN,070,CAHUAPAN (ANEXO NIÑOS HÉROES),3,152,62,90,5
VERACRUZ DE IGNACIO DE LA LLAVE,30,HIDALGOTITLÁN,070,CERRO PELÓN (EL RETORNO),3,30,14,16,3
VERACRUZ DE IGNACIO DE LA LLAVE,30,HIDALGOTITLÁN,070,CHICHONAL,3,18,5,13,3
VERACRUZ DE IGNACIO DE LA LLAVE,30,HIDALGOTITLÁN,070,COAPILOLOYA,2,26,9,17,2
VERACRUZ DE IGNACIO DE LA LLAVE,30,HIDALGOTITLÁN,070,COLONIA BENITO JUÁREZ,2,33,15,18,3
VERACRUZ DE IGNACIO DE LA LLAVE,30,HIDALGOTITLÁN,070,COLONIA MIGUEL HIDALGO,1,20,7,13,1
VERACRUZ DE IGNACIO DE LA LLAVE,30,HIDALGOTITLÁN,070,COLONIA RODOLFO SÁNCHEZ TABOADA (PRIMERA SECCIÓN),2,51,28,23,4
VERACRUZ DE IGNACIO DE LA LLAVE,30,HIDALGOTITLÁN,070,DOS ARBOLITOS,2,13,5,8,2
VERACRUZ DE IGNACIO DE LA LLAVE,30,HIDALGOTITLÁN,070,EJIDO MIGUEL HIDALGO,3,74,45,29,5
VERACRUZ DE IGNACIO DE LA LLAVE,30,HIDALGOTITLÁN,070,EL ARROZAL,2,29,13,16,2
VERACRUZ DE IGNACIO DE LA LLAVE,30,HIDALGOTITLÁN,070,EL DEPÓSITO,2,19,10,9,3
VERACRUZ DE IGNACIO DE LA LLAVE,30,HIDALGOTITLÁN,070,EL MACAYAL,4,187,100,87,10
VERACRUZ DE IGNACIO DE LA LLAVE,30,HIDALGOTITLÁN,070,EL MANATÍ,1,7,5,2,1
VERACRUZ DE IGNACIO DE LA LLAVE,30,HIDALGOTITLÁN,070,EL MATADERO,3,21,10,11,2
VERACRUZ DE IGNACIO DE LA LLAVE,30,HIDALGOTITLÁN,070,EL PROGRESO,3,49,22,27,4
VERACRUZ DE IGNACIO DE LA LLAVE,30,HIDALGOTITLÁN,070,EL ROBALO,3,24,10,14,3
VERACRUZ DE IGNACIO DE LA LLAVE,30,HIDALGOTITLÁN,070,EL SALTO DEL MATADERO,2,36,21,15,2
VERACRUZ DE IGNACIO DE LA LLAVE,30,HIDALGOTITLÁN,070,EL ZAPOTAL,3,59,30,29,4
VERACRUZ DE IGNACIO DE LA LLAVE,30,HIDALGOTITLÁN,070,EMILIANO ZAPATA,2,31,19,12,3
VERACRUZ DE IGNACIO DE LA LLAVE,30,HIDALGOTITLÁN,070,FORTUÑO Y POTRERO LARGO,2,29,13,16,3
VERACRUZ DE IGNACIO DE LA LLAVE,30,HIDALGOTITLÁN,070,GALAPATA,2,6,4,2,1
VERACRUZ DE IGNACIO DE LA LLAVE,30,HIDALGOTITLÁN,070,GENERAL RODOLFO SÁNCHEZ TABOADA (LOS JUANES),1,22,11,11,3
VERACRUZ DE IGNACIO DE LA LLAVE,30,HIDALGOTITLÁN,070,HIDALGOTITLÁN,7,957,457,500,56
VERACRUZ DE IGNACIO DE LA LLAVE,30,HIDALGOTITLÁN,070,IGNACIO ALLENDE EL GRANDE,4,119,57,62,7
VERACRUZ DE IGNACIO DE LA LLAVE,30,HIDALGOTITLÁN,070,JAVIER ROJO GÓMEZ,4,139,62,77,8
VERACRUZ DE IGNACIO DE LA LLAVE,30,HIDALGOTITLÁN,070,LA ARENA,3,18,12,6,3
VERACRUZ DE IGNACIO DE LA LLAVE,30,HIDALGOTITLÁN,070,LA CEIBA,1,11,10,1,1
VERACRUZ DE IGNACIO DE LA LLAVE,30,HIDALGOTITLÁN,070,LA CONCEPCIÓN (LA UNIÓN),2,26,19,7,2
VERACRUZ DE IGNACIO DE LA LLAVE,30,HIDALGOTITLÁN,070,LA ESPERANZA,4,73,37,36,6
VERACRUZ DE IGNACIO DE LA LLAVE,30,HIDALGOTITLÁN,070,LA GUADALUPE,1,7,5,2,1
VERACRUZ DE IGNACIO DE LA LLAVE,30,HIDALGOTITLÁN,070,LA MAJAHUA,3,39,19,20,4
VERACRUZ DE IGNACIO DE LA LLAVE,30,HIDALGOTITLÁN,070,LA MERCED,2,30,15,15,3
VERACRUZ DE IGNACIO DE LA LLAVE,30,HIDALGOTITLÁN,070,LA NUEVA VICTORIA,2,21,9,12,3
VERACRUZ DE IGNACIO DE LA LLAVE,30,HIDALGOTITLÁN,070,LA TROPICAL,3,36,21,15,4
VERACRUZ DE IGNACIO DE LA LLAVE,30,HIDALGOTITLÁN,070,LAS PALOMAS,3,64,24,40,6
VERACRUZ DE IGNACIO DE LA LLAVE,30,HIDALGOTITLÁN,070,LICENCIADO GABRIEL RAMOS MILLÁN,4,141,64,77,8
VERACRUZ DE IGNACIO DE LA LLAVE,30,HIDALGOTITLÁN,070,LOS LAURELES,2,17,6,11,2
VERACRUZ DE IGNACIO DE LA LLAVE,30,HIDALGOTITLÁN,070,LOS LIRIOS,1,13,6,7,1
VERACRUZ DE IGNACIO DE LA LLAVE,30,HIDALGOTITLÁN,070,MONTERROSA,3,113,57,56,7
VERACRUZ DE IGNACIO DE LA LLAVE,30,HIDALGOTITLÁN,070,NUEVA CREACIÓN ABUNDANCIA,1,7,3,4,1
VERACRUZ DE IGNACIO DE LA LLAVE,30,HIDALGOTITLÁN,070,PLAYA GRANDE,1,7,3,4,1
VERACRUZ DE IGNACIO DE LA LLAVE,30,HIDALGOTITLÁN,070,PRIMERO DE MAYO,3,91,29,62,7
VERACRUZ DE IGNACIO DE LA LLAVE,30,HIDALGOTITLÁN,070,REUBICACIÓN PARAÍSO,1,4,3,1,1
VERACRUZ DE IGNACIO DE LA LLAVE,30,HIDALGOTITLÁN,070,RODOLFO SÁNCHEZ TABOADA (TERCERA SECCIÓN),1,11,7,4,1
VERACRUZ DE IGNACIO DE LA LLAVE,30,HIDALGOTITLÁN,070,SAN ANTONIO,2,9,6,3,1
VERACRUZ DE IGNACIO DE LA LLAVE,30,HIDALGOTITLÁN,070,SAN CARLOS,4,149,78,71,12
VERACRUZ DE IGNACIO DE LA LLAVE,30,HIDALGOTITLÁN,070,SAN JOSÉ,1,7,5,2,1
VERACRUZ DE IGNACIO DE LA LLAVE,30,HIDALGOTITLÁN,070,SAN MARCOS,1,9,3,6,1
VERACRUZ DE IGNACIO DE LA LLAVE,30,HIDALGOTITLÁN,070,VICENTE GUERRERO,6,343,171,172,19
VERACRUZ DE IGNACIO DE LA LLAVE,30,HUATUSCO,071,ADOLFO RUIZ CORTINES (LA PASTORÍA),3,156,70,86,11
VERACRUZ DE IGNACIO DE LA LLAVE,30,HUATUSCO,071,ALTA LUZ,3,139,74,65,9
VERACRUZ DE IGNACIO DE LA LLAVE,30,HUATUSCO,071,AMATIOPA (MESA LIMÓN),5,232,113,119,15
VERACRUZ DE IGNACIO DE LA LLAVE,30,HUATUSCO,071,BUENA VISTA,1,12,6,6,1
VERACRUZ DE IGNACIO DE LA LLAVE,30,HUATUSCO,071,CAPULAPA,5,305,157,148,20
VERACRUZ DE IGNACIO DE LA LLAVE,30,HUATUSCO,071,CARRIZAL,2,34,18,16,3
VERACRUZ DE IGNACIO DE LA LLAVE,30,HUATUSCO,071,CHALCHITEPEC,3,267,137,130,11
VERACRUZ DE IGNACIO DE LA LLAVE,30,HUATUSCO,071,CHAVAXTLA,5,277,142,135,14
VERACRUZ DE IGNACIO DE LA LLAVE,30,HUATUSCO,071,CINCO DE MAYO,1,8,5,3,1
VERACRUZ DE IGNACIO DE LA LLAVE,30,HUATUSCO,071,COLONIA FRANCISCO I. MADERO,1,21,8,13,3
VERACRUZ DE IGNACIO DE LA LLAVE,30,HUATUSCO,071,COTECONTLA,3,92,51,41,6
VERACRUZ DE IGNACIO DE LA LLAVE,30,HUATUSCO,071,COXCONTLA,1,13,6,7,1
VERACRUZ DE IGNACIO DE LA LLAVE,30,HUATUSCO,071,EL HORNO,2,6,2,4,1
VERACRUZ DE IGNACIO DE LA LLAVE,30,HUATUSCO,071,EL OCOTE,3,56,19,37,4
VERACRUZ DE IGNACIO DE LA LLAVE,30,HUATUSCO,071,EL ORIENTE,2,14,9,5,2
VERACRUZ DE IGNACIO DE LA LLAVE,30,HUATUSCO,071,ELOTEPEC,4,478,245,233,24
VERACRUZ DE IGNACIO DE LA LLAVE,30,HUATUSCO,071,GALERA QUEMADA,2,41,21,20,3
VERACRUZ DE IGNACIO DE LA LLAVE,30,HUATUSCO,071,HUATUSCO DE CHICUELLAR,53,12352,6296,6056,755
VERACRUZ DE IGNACIO DE LA LLAVE,30,HUATUSCO,071,IXPILA,4,339,155,184,20
VERACRUZ DE IGNACIO DE LA LLAVE,30,HUATUSCO,071,LA AVENTURA,1,18,13,5,1
VERACRUZ DE IGNACIO DE LA LLAVE,30,HUATUSCO,071,LA PATRONA,1,17,4,13,2
VERACRUZ DE IGNACIO DE LA LLAVE,30,HUATUSCO,071,LA PAZ,2,20,9,11,2
VERACRUZ DE IGNACIO DE LA LLAVE,30,HUATUSCO,071,LA RAYA,3,61,32,29,5
VERACRUZ DE IGNACIO DE LA LLAVE,30,HUATUSCO,071,LAS CAÑADAS,2,22,8,14,2
VERACRUZ DE IGNACIO DE LA LLAVE,30,HUATUSCO,071,MANZANA DOS (COLONIA CHICUELLAR),2,28,15,13,3
VERACRUZ DE IGNACIO DE LA LLAVE,30,HUATUSCO,071,MESA DEL RANCHO,3,126,62,64,12
VERACRUZ DE IGNACIO DE LA LLAVE,30,HUATUSCO,071,METLAPOXTECA (RINCÓN METLAPOXTECA),1,5,3,2,1
VERACRUZ DE IGNACIO DE LA LLAVE,30,HUATUSCO,071,MICHAPA,3,163,83,80,11
VERACRUZ DE IGNACIO DE LA LLAVE,30,HUATUSCO,071,NARANJOS,2,21,9,12,3
VERACRUZ DE IGNACIO DE LA LLAVE,30,HUATUSCO,071,NOVILLERO,1,8,3,5,1
VERACRUZ DE IGNACIO DE LA LLAVE,30,HUATUSCO,071,PEREGRINA,3,17,10,7,2
VERACRUZ DE IGNACIO DE LA LLAVE,30,HUATUSCO,071,PUENTECILLA,2,42,22,20,3
VERACRUZ DE IGNACIO DE LA LLAVE,30,HUATUSCO,071,RINCÓN DE CAPULAPA (PALO HUILOYA),3,19,9,10,3
VERACRUZ DE IGNACIO DE LA LLAVE,30,HUATUSCO,071,RINCÓN RAMÍREZ,2,29,16,13,3
VERACRUZ DE IGNACIO DE LA LLAVE,30,HUATUSCO,071,RINCÓN TLAZALO (SAN MIGUEL),3,44,22,22,6
VERACRUZ DE IGNACIO DE LA LLAVE,30,HUATUSCO,071,SABANAS,4,259,128,131,16
VERACRUZ DE IGNACIO DE LA LLAVE,30,HUATUSCO,071,SAN DIEGO TETITLÁN,3,94,50,44,6
VERACRUZ DE IGNACIO DE LA LLAVE,30,HUATUSCO,071,SAN ISIDRO,1,12,6,6,1
VERACRUZ DE IGNACIO DE LA LLAVE,30,HUATUSCO,071,SAN JOSÉ CHAPA,2,36,18,18,4
VERACRUZ DE IGNACIO DE LA LLAVE,30,HUATUSCO,071,SOCHIBEBECA,2,17,6,11,2
VERACRUZ DE IGNACIO DE LA LLAVE,30,HUATUSCO,071,TENEJAPA,3,178,88,90,12
VERACRUZ DE IGNACIO DE LA LLAVE,30,HUATUSCO,071,TEPAMPA,4,298,145,153,18
VERACRUZ DE IGNACIO DE LA LLAVE,30,HUATUSCO,071,TEPETLA,2,16,6,10,2
VERACRUZ DE IGNACIO DE LA LLAVE,30,HUATUSCO,071,TEPETZINGO,3,32,19,13,4
VERACRUZ DE IGNACIO DE LA LLAVE,30,HUATUSCO,071,TLAMATOCA,5,523,269,254,28
VERACRUZ DE IGNACIO DE LA LLAVE,30,HUATUSCO,071,TLAVICTEPAN,4,121,58,63,9
VERACRUZ DE IGNACIO DE LA LLAVE,30,HUATUSCO,071,TLAXOPA,1,7,3,4,1
VERACRUZ DE IGNACIO DE LA LLAVE,30,HUATUSCO,071,XOCOTLA,1,29,9,20,2
VERACRUZ DE IGNACIO DE LA LLAVE,30,HUAYACOCOTLA,072,ACANTILADO (SAN JOSECITO),2,28,17,11,3
VERACRUZ DE IGNACIO DE LA LLAVE,30,HUAYACOCOTLA,072,AGUA BENDITA,2,46,22,24,3
VERACRUZ DE IGNACIO DE LA LLAVE,30,HUAYACOCOTLA,072,ALTAMIRA,3,22,10,12,3
VERACRUZ DE IGNACIO DE LA LLAVE,30,HUAYACOCOTLA,072,BUENA VISTA,2,20,5,15,2
VERACRUZ DE IGNACIO DE LA LLAVE,30,HUAYACOCOTLA,072,CAMARONES,2,18,10,8,2
VERACRUZ DE IGNACIO DE LA LLAVE,30,HUAYACOCOTLA,072,CARBONERO JACALES,4,524,260,264,28
VERACRUZ DE IGNACIO DE LA LLAVE,30,HUAYACOCOTLA,072,CERRO DE LA LAGUNILLA,1,4,2,2,1
VERACRUZ DE IGNACIO DE LA LLAVE,30,HUAYACOCOTLA,072,CERRO DEL PLUMAJE,1,9,3,6,1
VERACRUZ DE IGNACIO DE LA LLAVE,30,HUAYACOCOTLA,072,CHICHAPALA,3,25,9,16,4
VERACRUZ DE IGNACIO DE LA LLAVE,30,HUAYACOCOTLA,072,CORRAL VIEJO,2,23,14,9,2
VERACRUZ DE IGNACIO DE LA LLAVE,30,HUAYACOCOTLA,072,CRUZ DE ATAQUE,2,33,16,17,3
VERACRUZ DE IGNACIO DE LA LLAVE,30,HUAYACOCOTLA,072,DEJIGÜÍ,1,9,4,5,1
VERACRUZ DE IGNACIO DE LA LLAVE,30,HUAYACOCOTLA,072,DONANGÚ BARRIO BAJO,3,28,17,11,3
VERACRUZ DE IGNACIO DE LA LLAVE,30,HUAYACOCOTLA,072,EL BATDA,2,18,10,8,3
VERACRUZ DE IGNACIO DE LA LLAVE,30,HUAYACOCOTLA,072,EL BOPO,1,10,4,6,1
VERACRUZ DE IGNACIO DE LA LLAVE,30,HUAYACOCOTLA,072,EL CUPIL,3,53,30,23,5
VERACRUZ DE IGNACIO DE LA LLAVE,30,HUAYACOCOTLA,072,EL DOTA,1,5,1,4,1
VERACRUZ DE IGNACIO DE LA LLAVE,30,HUAYACOCOTLA,072,EL NARANJO,1,10,6,4,1
VERACRUZ DE IGNACIO DE LA LLAVE,30,HUAYACOCOTLA,072,EL OCOTE,2,12,5,7,2
VERACRUZ DE IGNACIO DE LA LLAVE,30,HUAYACOCOTLA,072,EL ZAPOTE,1,11,7,4,1
VERACRUZ DE IGNACIO DE LA LLAVE,30,HUAYACOCOTLA,072,EL ZAYADO,1,12,6,6,1
VERACRUZ DE IGNACIO DE LA LLAVE,30,HUAYACOCOTLA,072,HELECHALES,2,21,12,9,2
VERACRUZ DE IGNACIO DE LA LLAVE,30,HUAYACOCOTLA,072,HUAYACOCOTLA,12,2405,1256,1149,132
VERACRUZ DE IGNACIO DE LA LLAVE,30,HUAYACOCOTLA,072,LA LOMA,1,13,7,6,1
VERACRUZ DE IGNACIO DE LA LLAVE,30,HUAYACOCOTLA,072,LA SELVA,2,72,43,29,5
VERACRUZ DE IGNACIO DE LA LLAVE,30,HUAYACOCOTLA,072,LAS BLANCAS (PALO GORDO),4,105,56,49,9
VERACRUZ DE IGNACIO DE LA LLAVE,30,HUAYACOCOTLA,072,LOMA DE YEGUAS,2,59,30,29,3
VERACRUZ DE IGNACIO DE LA LLAVE,30,HUAYACOCOTLA,072,LOS DURAZNOS,2,43,21,22,7
VERACRUZ DE IGNACIO DE LA LLAVE,30,HUAYACOCOTLA,072,LOS PARAJES,2,62,25,37,4
VERACRUZ DE IGNACIO DE LA LLAVE,30,HUAYACOCOTLA,072,MAGUEY VERDE (ATECONGO),1,6,3,3,1
VERACRUZ DE IGNACIO DE LA LLAVE,30,HUAYACOCOTLA,072,MIGUEL LERDO,2,29,14,15,3
VERACRUZ DE IGNACIO DE LA LLAVE,30,HUAYACOCOTLA,072,OJO DE AGUA,2,104,50,54,5
VERACRUZ DE IGNACIO DE LA LLAVE,30,HUAYACOCOTLA,072,PALO BENDITO,3,239,119,120,12
VERACRUZ DE IGNACIO DE LA LLAVE,30,HUAYACOCOTLA,072,PALO HUECO,2,18,10,8,2
VERACRUZ DE IGNACIO DE LA LLAVE,30,HUAYACOCOTLA,072,POTRERO DE MONROY,2,47,25,22,3
VERACRUZ DE IGNACIO DE LA LLAVE,30,HUAYACOCOTLA,072,POTRERO SECO,1,8,4,4,2
VERACRUZ DE IGNACIO DE LA LLAVE,30,HUAYACOCOTLA,072,RAFAEL VALENZUELA (SAN JOSECITO),2,37,20,17,3
VERACRUZ DE IGNACIO DE LA LLAVE,30,HUAYACOCOTLA,072,SAN ANTONIO IXTATETLA,1,11,7,4,1
VERACRUZ DE IGNACIO DE LA LLAVE,30,HUAYACOCOTLA,072,SAN JUAN LA LAGUNA,2,16,6,10,2
VERACRUZ DE IGNACIO DE LA LLAVE,30,HUAYACOCOTLA,072,SANTIAGO,2,35,15,20,3
VERACRUZ DE IGNACIO DE LA LLAVE,30,HUAYACOCOTLA,072,TEJOCOTES,2,35,17,18,3
VERACRUZ DE IGNACIO DE LA LLAVE,30,HUAYACOCOTLA,072,TENANGO DE SAN MIGUEL,3,78,44,34,8
VERACRUZ DE IGNACIO DE LA LLAVE,30,HUAYACOCOTLA,072,TENANTITLÁN,1,11,5,6,1
VERACRUZ DE IGNACIO DE LA LLAVE,30,HUAYACOCOTLA,072,TEXIMALPA,4,250,119,131,16
VERACRUZ DE IGNACIO DE LA LLAVE,30,HUAYACOCOTLA,072,TZIMENTEY (LAS PIEDRAS),3,62,30,32,10
VERACRUZ DE IGNACIO DE LA LLAVE,30,HUAYACOCOTLA,072,TZIMENTEY DE ABAJO,1,11,8,3,2
VERACRUZ DE IGNACIO DE LA LLAVE,30,HUAYACOCOTLA,072,VIBORILLAS,2,38,16,22,3
VERACRUZ DE IGNACIO DE LA LLAVE,30,HUAYACOCOTLA,072,ZILACATIPAN (TENAXCALZINGO),4,130,67,63,10
VERACRUZ DE IGNACIO DE LA LLAVE,30,HUAYACOCOTLA,072,ZONZONAPA,6,248,122,126,14
VERACRUZ DE IGNACIO DE LA LLAVE,30,HUEYAPAN DE OCAMPO,073,BARROSA,3,113,53,60,8
VERACRUZ DE IGNACIO DE LA LLAVE,30,HUEYAPAN DE OCAMPO,073,CERRO DE CASTRO,3,123,61,62,8
VERACRUZ DE IGNACIO DE LA LLAVE,30,HUEYAPAN DE OCAMPO,073,CHACALAPAN,4,122,68,54,9
VERACRUZ DE IGNACIO DE LA LLAVE,30,HUEYAPAN DE OCAMPO,073,CINCO DE MAYO,3,84,39,45,6
VERACRUZ DE IGNACIO DE LA LLAVE,30,HUEYAPAN DE OCAMPO,073,COLONIA HERMOSA,3,68,38,30,8
VERACRUZ DE IGNACIO DE LA LLAVE,30,HUEYAPAN DE OCAMPO,073,COYOL DE GONZÁLEZ,4,213,109,104,10
VERACRUZ DE IGNACIO DE LA LLAVE,30,HUEYAPAN DE OCAMPO,073,COYOLITO,2,37,17,20,2
VERACRUZ DE IGNACIO DE LA LLAVE,30,HUEYAPAN DE OCAMPO,073,CUATOTOLAPAN ESTACIÓN,4,315,169,146,21
VERACRUZ DE IGNACIO DE LA LLAVE,30,HUEYAPAN DE OCAMPO,073,CUATOTOLAPAN VIEJO,4,149,73,76,9
VERACRUZ DE IGNACIO DE LA LLAVE,30,HUEYAPAN DE OCAMPO,073,EL AGUACATE,6,447,207,240,24
VERACRUZ DE IGNACIO DE LA LLAVE,30,HUEYAPAN DE OCAMPO,073,EL CHAMIZAL,3,102,48,54,6
VERACRUZ DE IGNACIO DE LA LLAVE,30,HUEYAPAN DE OCAMPO,073,EL PALMAR,3,90,41,49,8
VERACRUZ DE IGNACIO DE LA LLAVE,30,HUEYAPAN DE OCAMPO,073,EL PORVENIR,1,13,5,8,1
VERACRUZ DE IGNACIO DE LA LLAVE,30,HUEYAPAN DE OCAMPO,073,EL SAUZAL,3,105,57,48,9
VERACRUZ DE IGNACIO DE LA LLAVE,30,HUEYAPAN DE OCAMPO,073,EMILIANO ZAPATA,2,38,18,20,2
VERACRUZ DE IGNACIO DE LA LLAVE,30,HUEYAPAN DE OCAMPO,073,FRANCISCO I. MADERO,3,79,37,42,6
VERACRUZ DE IGNACIO DE LA LLAVE,30,HUEYAPAN DE OCAMPO,073,HUEYAPAN DE OCAMPO,8,753,404,349,45
VERACRUZ DE IGNACIO DE LA LLAVE,30,HUEYAPAN DE OCAMPO,073,HUEYAPAN DE SOCONUSCO,3,122,57,65,9
VERACRUZ DE IGNACIO DE LA LLAVE,30,HUEYAPAN DE OCAMPO,073,JUAN DÍAZ COVARRUBIAS,17,1783,872,911,189
VERACRUZ DE IGNACIO DE LA LLAVE,30,HUEYAPAN DE OCAMPO,073,LA CONCEPCIÓN,3,51,25,26,7
VERACRUZ DE IGNACIO DE LA LLAVE,30,HUEYAPAN DE OCAMPO,073,LA GLORIA,3,151,73,78,10
VERACRUZ DE IGNACIO DE LA LLAVE,30,HUEYAPAN DE OCAMPO,073,LA GLORIA HUEITÉPETL,1,29,8,21,2
VERACRUZ DE IGNACIO DE LA LLAVE,30,HUEYAPAN DE OCAMPO,073,LA GUADALUPE,2,52,28,24,3
VERACRUZ DE IGNACIO DE LA LLAVE,30,HUEYAPAN DE OCAMPO,073,LA NUEVA ESPERANZA,2,29,12,17,3
VERACRUZ DE IGNACIO DE LA LLAVE,30,HUEYAPAN DE OCAMPO,073,LA PALMA,3,69,38,31,5
VERACRUZ DE IGNACIO DE LA LLAVE,30,HUEYAPAN DE OCAMPO,073,LA PERLA DE HUEYAPAN,2,37,23,14,3
VERACRUZ DE IGNACIO DE LA LLAVE,30,HUEYAPAN DE OCAMPO,073,LOMA DE LA PALMA,3,152,72,80,12
VERACRUZ DE IGNACIO DE LA LLAVE,30,HUEYAPAN DE OCAMPO,073,LOMA DE LOS INGLESES,2,82,37,45,4
VERACRUZ DE IGNACIO DE LA LLAVE,30,HUEYAPAN DE OCAMPO,073,LOMA DE ORO,3,101,43,58,7
VERACRUZ DE IGNACIO DE LA LLAVE,30,HUEYAPAN DE OCAMPO,073,LOMA DE SOGOTEGOYO,4,332,173,159,17
VERACRUZ DE IGNACIO DE LA LLAVE,30,HUEYAPAN DE OCAMPO,073,LOMA DEL TIGRE,3,74,43,31,5
VERACRUZ DE IGNACIO DE LA LLAVE,30,HUEYAPAN DE OCAMPO,073,LOS MANGOS,7,586,295,291,36
VERACRUZ DE IGNACIO DE LA LLAVE,30,HUEYAPAN DE OCAMPO,073,MEAPAN DE CALDELAS,2,44,23,21,3
VERACRUZ DE IGNACIO DE LA LLAVE,30,HUEYAPAN DE OCAMPO,073,NACAXTLE,4,338,145,193,17
VERACRUZ DE IGNACIO DE LA LLAVE,30,HUEYAPAN DE OCAMPO,073,NORMA,3,133,70,63,9
VERACRUZ DE IGNACIO DE LA LLAVE,30,HUEYAPAN DE OCAMPO,073,OZULUAMA,2,45,24,21,3
VERACRUZ DE IGNACIO DE LA LLAVE,30,HUEYAPAN DE OCAMPO,073,SABANETA,5,265,125,140,20
VERACRUZ DE IGNACIO DE LA LLAVE,30,HUEYAPAN DE OCAMPO,073,SAMARIA,4,103,54,49,7
VERACRUZ DE IGNACIO DE LA LLAVE,30,HUEYAPAN DE OCAMPO,073,SANTA CATALINA,1,12,6,6,1
VERACRUZ DE IGNACIO DE LA LLAVE,30,HUEYAPAN DE OCAMPO,073,SANTA ROSA CINTEPEC,3,92,40,52,6
VERACRUZ DE IGNACIO DE LA LLAVE,30,HUEYAPAN DE OCAMPO,073,SANTA ROSA LOMA LARGA,6,425,220,205,26
VERACRUZ DE IGNACIO DE LA LLAVE,30,HUEYAPAN DE OCAMPO,073,SONCOAVITAL,4,90,47,43,8
VERACRUZ DE IGNACIO DE LA LLAVE,30,HUEYAPAN DE OCAMPO,073,TIERRA NUEVA,4,385,175,210,20
VERACRUZ DE IGNACIO DE LA LLAVE,30,HUEYAPAN DE OCAMPO,073,VEINTE DE NOVIEMBRE,2,16,6,10,2
VERACRUZ DE IGNACIO DE LA LLAVE,30,HUEYAPAN DE OCAMPO,073,ZAPOAPAN DE AMAPAN,4,176,82,94,11
VERACRUZ DE IGNACIO DE LA LLAVE,30,HUILOAPAN DE CUAUHTÉMOC,074,HUILOAPAN DE CUAUHTÉMOC,9,659,311,348,43
VERACRUZ DE IGNACIO DE LA LLAVE,30,HUILOAPAN DE CUAUHTÉMOC,074,PAREDÓN VIEJO,1,58,19,39,3
VERACRUZ DE IGNACIO DE LA LLAVE,30,HUILOAPAN DE CUAUHTÉMOC,074,SAN CRISTÓBAL,3,105,48,57,8
VERACRUZ DE IGNACIO DE LA LLAVE,30,IGNACIO DE LA LLAVE,075,EL AGUACATE,3,91,44,47,6
VERACRUZ DE IGNACIO DE LA LLAVE,30,IGNACIO DE LA LLAVE,075,EL CAMARÓN,1,9,4,5,1
VERACRUZ DE IGNACIO DE LA LLAVE,30,IGNACIO DE LA LLAVE,075,EL MANGAL,2,23,12,11,2
VERACRUZ DE IGNACIO DE LA LLAVE,30,IGNACIO DE LA LLAVE,075,EL OBISPO,2,22,9,13,2
VERACRUZ DE IGNACIO DE LA LLAVE,30,IGNACIO DE LA LLAVE,075,EL SALITRAL,4,193,88,105,14
VERACRUZ DE IGNACIO DE LA LLAVE,30,IGNACIO DE LA LLAVE,075,EL SALTO,3,117,59,58,6
VERACRUZ DE IGNACIO DE LA LLAVE,30,IGNACIO DE LA LLAVE,075,EL ZAPOTAL NÚMERO UNO,4,214,98,116,16
VERACRUZ DE IGNACIO DE LA LLAVE,30,IGNACIO DE LA LLAVE,075,EL ZAPOTE,4,212,96,116,15
VERACRUZ DE IGNACIO DE LA LLAVE,30,IGNACIO DE LA LLAVE,075,IGNACIO DE LA LLAVE,8,1785,904,881,96
VERACRUZ DE IGNACIO DE LA LLAVE,30,IGNACIO DE LA LLAVE,075,LA CAMPANA,2,22,11,11,2
VERACRUZ DE IGNACIO DE LA LLAVE,30,IGNACIO DE LA LLAVE,075,LA ISLETA DE PANAMÁ (PUNTA ISLETA),2,17,9,8,1
VERACRUZ DE IGNACIO DE LA LLAVE,30,IGNACIO DE LA LLAVE,075,LOBATO Y TOTULCO (RANCHO NUEVO),2,25,14,11,2
VERACRUZ DE IGNACIO DE LA LLAVE,30,IGNACIO DE LA LLAVE,075,LOS CANDADILLOS,2,16,9,7,2
VERACRUZ DE IGNACIO DE LA LLAVE,30,IGNACIO DE LA LLAVE,075,MOYOTLA,2,64,25,39,5
VERACRUZ DE IGNACIO DE LA LLAVE,30,IGNACIO DE LA LLAVE,075,NUEVO PASO LIMÓN,1,24,9,15,1
VERACRUZ DE IGNACIO DE LA LLAVE,30,IGNACIO DE LA LLAVE,075,NUEVO SANTA ROSA,3,34,22,12,4
VERACRUZ DE IGNACIO DE LA LLAVE,30,IGNACIO DE LA LLAVE,075,PALMA CUATA,3,122,61,61,8
VERACRUZ DE IGNACIO DE LA LLAVE,30,IGNACIO DE LA LLAVE,075,PALMA DE COCO,4,96,45,51,8
VERACRUZ DE IGNACIO DE LA LLAVE,30,IGNACIO DE LA LLAVE,075,PASO DE LAS MULAS,2,19,5,14,2
VERACRUZ DE IGNACIO DE LA LLAVE,30,IGNACIO DE LA LLAVE,075,POTRERO NUEVO,2,30,15,15,3
VERACRUZ DE IGNACIO DE LA LLAVE,30,IGNACIO DE LA LLAVE,075,POZO DE ARENA,2,32,19,13,2
VERACRUZ DE IGNACIO DE LA LLAVE,30,IGNACIO DE LA LLAVE,075,RINCÓN DEL TIGRE,2,27,9,18,3
VERACRUZ DE IGNACIO DE LA LLAVE,30,IGNACIO DE LA LLAVE,075,SABANETA,3,83,37,46,6
VERACRUZ DE IGNACIO DE LA LLAVE,30,IGNACIO DE LA LLAVE,075,VAINILLAL (EL VAINILLAL),2,37,20,17,3
VERACRUZ DE IGNACIO DE LA LLAVE,30,IGNACIO DE LA LLAVE,075,ZACATE COLORADO PRIMERO (EL MORAL),4,198,103,95,16
VERACRUZ DE IGNACIO DE LA LLAVE,30,IGNACIO DE LA LLAVE,075,ZACATE COLORADO SEGUNDO (FRATERNIDAD),1,20,10,10,2
VERACRUZ DE IGNACIO DE LA LLAVE,30,IGNACIO DE LA LLAVE,075,ZANJA DEL BARRO,2,19,12,7,2
VERACRUZ DE IGNACIO DE LA LLAVE,30,ILAMATLÁN,076,ACHIYAHUAL,1,39,15,24,1
VERACRUZ DE IGNACIO DE LA LLAVE,30,ILAMATLÁN,076,AMATEPEC,4,156,70,86,13
VERACRUZ DE IGNACIO DE LA LLAVE,30,ILAMATLÁN,076,APACHITLA,3,170,99,71,9
VERACRUZ DE IGNACIO DE LA LLAVE,30,ILAMATLÁN,076,ATEMPA,3,126,63,63,9
VERACRUZ DE IGNACIO DE LA LLAVE,30,ILAMATLÁN,076,CHAHUATLÁN,4,156,74,82,10
VERACRUZ DE IGNACIO DE LA LLAVE,30,ILAMATLÁN,076,CHOCHOTLA,2,24,12,12,2
VERACRUZ DE IGNACIO DE LA LLAVE,30,ILAMATLÁN,076,COACOACO,4,212,110,102,14
VERACRUZ DE IGNACIO DE LA LLAVE,30,ILAMATLÁN,076,CONQUEXTLA,3,94,45,49,8
VERACRUZ DE IGNACIO DE LA LLAVE,30,ILAMATLÁN,076,EL EMBOCADERO,2,39,17,22,2
VERACRUZ DE IGNACIO DE LA LLAVE,30,ILAMATLÁN,076,HUITZTIPAN,3,108,56,52,8
VERACRUZ DE IGNACIO DE LA LLAVE,30,ILAMATLÁN,076,ILAMATLÁN,4,190,101,89,12
VERACRUZ DE IGNACIO DE LA LLAVE,30,ILAMATLÁN,076,PAHUAYO GRANDE,2,20,10,10,2
VERACRUZ DE IGNACIO DE LA LLAVE,30,ILAMATLÁN,076,PETLACUATLA,4,89,53,36,6
VERACRUZ DE IGNACIO DE LA LLAVE,30,ILAMATLÁN,076,SAN GREGORIO,4,263,130,133,17
VERACRUZ DE IGNACIO DE LA LLAVE,30,ILAMATLÁN,076,SAN MATEO,2,31,16,15,3
VERACRUZ DE IGNACIO DE LA LLAVE,30,ILAMATLÁN,076,SAN PABLO MITECATLÁN,3,285,156,129,13
VERACRUZ DE IGNACIO DE LA LLAVE,30,ILAMATLÁN,076,SANTA CRUZ,3,181,92,89,12
VERACRUZ DE IGNACIO DE LA LLAVE,30,ILAMATLÁN,076,SELEKXIUIKO,1,29,17,12,4
VERACRUZ DE IGNACIO DE LA LLAVE,30,ILAMATLÁN,076,TECAPA,5,363,191,172,20
VERACRUZ DE IGNACIO DE LA LLAVE,30,ILAMATLÁN,076,TENEXCO,2,24,16,8,3
VERACRUZ DE IGNACIO DE LA LLAVE,30,ILAMATLÁN,076,TLAMACUIMPA,4,72,35,37,7
VERACRUZ DE IGNACIO DE LA LLAVE,30,ILAMATLÁN,076,TLATLAZOQUICO,2,48,27,21,4
VERACRUZ DE IGNACIO DE LA LLAVE,30,ILAMATLÁN,076,TOLTEPEC,2,92,38,54,6
VERACRUZ DE IGNACIO DE LA LLAVE,30,ILAMATLÁN,076,XALTIPA,2,60,25,35,3
VERACRUZ DE IGNACIO DE LA LLAVE,30,ILAMATLÁN,076,XOXOCAPA,6,312,143,169,19
VERACRUZ DE IGNACIO DE LA LLAVE,30,ISLA,077,AGUAS PRIETAS (LOS CERROS),3,55,23,32,6
VERACRUZ DE IGNACIO DE LA LLAVE,30,ISLA,077,BALBOA,2,21,13,8,2
VERACRUZ DE IGNACIO DE LA LLAVE,30,ISLA,077,BENITO JUÁREZ,2,33,11,22,2
VERACRUZ DE IGNACIO DE LA LLAVE,30,ISLA,077,CHAPOPOAPAN,1,13,6,7,1
VERACRUZ DE IGNACIO DE LA LLAVE,30,ISLA,077,CHILTEPEC,1,12,6,6,1
VERACRUZ DE IGNACIO DE LA LLAVE,30,ISLA,077,COAPA,3,82,48,34,6
VERACRUZ DE IGNACIO DE LA LLAVE,30,ISLA,077,CUJULUAPAN (EL GUAYABO),4,82,38,44,7
VERACRUZ DE IGNACIO DE LA LLAVE,30,ISLA,077,EL CARRIZO,1,3,1,2,1
VERACRUZ DE IGNACIO DE LA LLAVE,30,ISLA,077,EL COCO,1,7,4,3,1
VERACRUZ DE IGNACIO DE LA LLAVE,30,ISLA,077,EL COCO (SAN JUAN DEL RÍO),1,19,10,9,1
VERACRUZ DE IGNACIO DE LA LLAVE,30,ISLA,077,EL CORTE,1,28,12,16,2
VERACRUZ DE IGNACIO DE LA LLAVE,30,ISLA,077,EL MAGUIAL (LA LAGUNA),3,25,8,17,3
VERACRUZ DE IGNACIO DE LA LLAVE,30,ISLA,077,EL MARCIAL (EL COYOLAR),4,142,74,68,9
VERACRUZ DE IGNACIO DE LA LLAVE,30,ISLA,077,EL MOSQUITO,1,11,6,5,1
VERACRUZ DE IGNACIO DE LA LLAVE,30,ISLA,077,EL ÑAPE,2,49,26,23,3
VERACRUZ DE IGNACIO DE LA LLAVE,30,ISLA,077,EL PAISAJE,2,25,12,13,3
VERACRUZ DE IGNACIO DE LA LLAVE,30,ISLA,077,EL POZÓN,2,21,11,10,2
VERACRUZ DE IGNACIO DE LA LLAVE,30,ISLA,077,EL TESORO,4,136,70,66,8
VERACRUZ DE IGNACIO DE LA LLAVE,30,ISLA,077,FRANCISCO VILLA,2,22,8,14,2
VERACRUZ DE IGNACIO DE LA LLAVE,30,ISLA,077,GARRO,4,221,99,122,12
VERACRUZ DE IGNACIO DE LA LLAVE,30,ISLA,077,GARZA BLANCA,2,11,6,5,2
VERACRUZ DE IGNACIO DE LA LLAVE,30,ISLA,077,IGNACIO RAMÍREZ,3,85,43,42,7
VERACRUZ DE IGNACIO DE LA LLAVE,30,ISLA,077,ISLA,42,6008,3051,2957,350
VERACRUZ DE IGNACIO DE LA LLAVE,30,ISLA,077,LA ESPERANZA,1,70,27,43,3
VERACRUZ DE IGNACIO DE LA LLAVE,30,ISLA,077,LA FLORIDA (NUEVO TENEJAPAN),2,9,3,6,1
VERACRUZ DE IGNACIO DE LA LLAVE,30,ISLA,077,LA LOMA,1,123,60,63,9
VERACRUZ DE IGNACIO DE LA LLAVE,30,ISLA,077,LA PEÑA,3,50,26,24,4
VERACRUZ DE IGNACIO DE LA LLAVE,30,ISLA,077,LAS GARZAS,1,17,11,6,1
VERACRUZ DE IGNACIO DE LA LLAVE,30,ISLA,077,LAS GOLONDRINAS,1,43,21,22,3
VERACRUZ DE IGNACIO DE LA LLAVE,30,ISLA,077,LAS MACAYAS,1,22,12,10,1
VERACRUZ DE IGNACIO DE LA LLAVE,30,ISLA,077,LAS PLAYAS,1,5,3,2,1
VERACRUZ DE IGNACIO DE LA LLAVE,30,ISLA,077,LEYES DE REFORMA,1,8,5,3,1
VERACRUZ DE IGNACIO DE LA LLAVE,30,ISLA,077,LICENCIADO ALFREDO V. BONFIL,2,7,5,2,1
VERACRUZ DE IGNACIO DE LA LLAVE,30,ISLA,077,LOMA ALTA,4,178,81,97,11
VERACRUZ DE IGNACIO DE LA LLAVE,30,ISLA,077,MACUILE,1,8,5,3,1
VERACRUZ DE IGNACIO DE LA LLAVE,30,ISLA,077,MATA LIMONES,2,8,4,4,1
VERACRUZ DE IGNACIO DE LA LLAVE,30,ISLA,077,MAZOCO,4,232,105,127,13
VERACRUZ DE IGNACIO DE LA LLAVE,30,ISLA,077,NUEVO CANTÓN,3,82,43,39,7
VERACRUZ DE IGNACIO DE LA LLAVE,30,ISLA,077,NUEVO POTRERO,3,169,78,91,10
VERACRUZ DE IGNACIO DE LA LLAVE,30,ISLA,077,NUEVO VILORIA,2,31,13,18,2
VERACRUZ DE IGNACIO DE LA LLAVE,30,ISLA,077,ORO VERDE (EL ARENAL),3,72,35,37,6
VERACRUZ DE IGNACIO DE LA LLAVE,30,ISLA,077,PALMARILLO,1,3,1,2,1
VERACRUZ DE IGNACIO DE LA LLAVE,30,ISLA,077,PALO BLANCO,1,8,3,5,1
VERACRUZ DE IGNACIO DE LA LLAVE,30,ISLA,077,POTRERILLOS,1,6,2,4,1
VERACRUZ DE IGNACIO DE LA LLAVE,30,ISLA,077,RODOLFO FIERRO,2,23,10,13,3
VERACRUZ DE IGNACIO DE LA LLAVE,30,ISLA,077,SALSIPUEDES,2,7,3,4,1
VERACRUZ DE IGNACIO DE LA LLAVE,30,ISLA,077,SAN ANASTACIO (TACHICÓN),2,40,20,20,3
VERACRUZ DE IGNACIO DE LA LLAVE,30,ISLA,077,SAN NICOLÁS ZACAPEXCO,2,13,6,7,2
VERACRUZ DE IGNACIO DE LA LLAVE,30,ISLA,077,SAN PEDRO MÁRTIR,2,5,2,3,1
VERACRUZ DE IGNACIO DE LA LLAVE,30,ISLA,077,SAN SIMÓN II,1,11,4,7,1
VERACRUZ DE IGNACIO DE LA LLAVE,30,ISLA,077,SOLERILLA,2,15,9,6,2
VERACRUZ DE IGNACIO DE LA LLAVE,30,ISLA,077,TOTOLOCHE,4,154,86,68,12
VERACRUZ DE IGNACIO DE LA LLAVE,30,ISLA,077,VILORIA VIEJO,3,88,48,40,7
VERACRUZ DE IGNACIO DE LA LLAVE,30,ISLA,077,VISTA HERMOSA,1,16,7,9,1
VERACRUZ DE IGNACIO DE LA LLAVE,30,IXCATEPEC,078,AGUA NACIDA,4,60,31,29,7
VERACRUZ DE IGNACIO DE LA LLAVE,30,IXCATEPEC,078,CHICUALA,3,50,30,20,6
VERACRUZ DE IGNACIO DE LA LLAVE,30,IXCATEPEC,078,CHILACACO,2,24,9,15,5
VERACRUZ DE IGNACIO DE LA LLAVE,30,IXCATEPEC,078,COYOL SECO,1,28,12,16,1
VERACRUZ DE IGNACIO DE LA LLAVE,30,IXCATEPEC,078,EJIDO IXCATEPEC,2,20,11,9,3
VERACRUZ DE IGNACIO DE LA LLAVE,30,IXCATEPEC,078,EL MEZQUITE,3,54,20,34,6
VERACRUZ DE IGNACIO DE LA LLAVE,30,IXCATEPEC,078,EL RINCÓN,4,131,66,65,10
VERACRUZ DE IGNACIO DE LA LLAVE,30,IXCATEPEC,078,EL VOLADOR,3,79,37,42,9
VERACRUZ DE IGNACIO DE LA LLAVE,30,IXCATEPEC,078,FLORIJOMEL (LA PEÑA),2,21,11,10,3
VERACRUZ DE IGNACIO DE LA LLAVE,30,IXCATEPEC,078,GAVILÁN,3,110,58,52,10
VERACRUZ DE IGNACIO DE LA LLAVE,30,IXCATEPEC,078,HUACHOLULA,2,15,6,9,3
VERACRUZ DE IGNACIO DE LA LLAVE,30,IXCATEPEC,078,IXCATEPEC,7,1126,570,556,73
VERACRUZ DE IGNACIO DE LA LLAVE,30,IXCATEPEC,078,LA CEIBA,1,4,3,1,1
VERACRUZ DE IGNACIO DE LA LLAVE,30,IXCATEPEC,078,LA GUÁSIMA,2,13,3,10,3
VERACRUZ DE IGNACIO DE LA LLAVE,30,IXCATEPEC,078,LA LIMA,1,22,12,10,2
VERACRUZ DE IGNACIO DE LA LLAVE,30,IXCATEPEC,078,LA PROMISIÓN,1,15,10,5,1
VERACRUZ DE IGNACIO DE LA LLAVE,30,IXCATEPEC,078,LÁZARO CÁRDENAS,2,26,11,15,4
VERACRUZ DE IGNACIO DE LA LLAVE,30,IXCATEPEC,078,PALMAS ALTAS,3,31,16,15,4
VERACRUZ DE IGNACIO DE LA LLAVE,30,IXCATEPEC,078,PLACETAS,2,17,8,9,3
VERACRUZ DE IGNACIO DE LA LLAVE,30,IXCATEPEC,078,POZA AZUL,4,201,97,104,15
VERACRUZ DE IGNACIO DE LA LLAVE,30,IXCATEPEC,078,SIETE PALMAS,4,86,33,53,13
VERACRUZ DE IGNACIO DE LA LLAVE,30,IXCATEPEC,078,TANCUBAN,2,23,9,14,4
VERACRUZ DE IGNACIO DE LA LLAVE,30,IXCATEPEC,078,TINAJA,1,13,7,6,1
VERACRUZ DE IGNACIO DE LA LLAVE,30,IXCATEPEC,078,TZICUATITLA,2,19,11,8,2
VERACRUZ DE IGNACIO DE LA LLAVE,30,IXCATEPEC,078,ZACAMANGO,1,10,3,7,1
VERACRUZ DE IGNACIO DE LA LLAVE,30,IXHUACÁN DE LOS REYES,079,AMATITLA,1,11,5,6,1
VERACRUZ DE IGNACIO DE LA LLAVE,30,IXHUACÁN DE LOS REYES,079,AMATLA,1,18,8,10,2
VERACRUZ DE IGNACIO DE LA LLAVE,30,IXHUACÁN DE LOS REYES,079,ATECAXIL,2,42,21,21,3
VERACRUZ DE IGNACIO DE LA LLAVE,30,IXHUACÁN DE LOS REYES,079,BARRANCA NUEVA,4,261,111,150,19
VERACRUZ DE IGNACIO DE LA LLAVE,30,IXHUACÁN DE LOS REYES,079,BUENAVISTA,2,41,26,15,3
VERACRUZ DE IGNACIO DE LA LLAVE,30,IXHUACÁN DE LOS REYES,079,CALTZONTEPEC,3,133,62,71,7
VERACRUZ DE IGNACIO DE LA LLAVE,30,IXHUACÁN DE LOS REYES,079,CERRO BOLUDO,3,75,38,37,6
VERACRUZ DE IGNACIO DE LA LLAVE,30,IXHUACÁN DE LOS REYES,079,COMALIXHUATLA,2,35,16,19,3
VERACRUZ DE IGNACIO DE LA LLAVE,30,IXHUACÁN DE LOS REYES,079,COYOPOLAN,2,51,30,21,4
VERACRUZ DE IGNACIO DE LA LLAVE,30,IXHUACÁN DE LOS REYES,079,DON VICENTE,2,62,36,26,4
VERACRUZ DE IGNACIO DE LA LLAVE,30,IXHUACÁN DE LOS REYES,079,EL CARRIZAL,2,53,29,24,3
VERACRUZ DE IGNACIO DE LA LLAVE,30,IXHUACÁN DE LOS REYES,079,EL FUTURO,3,12,5,7,3
VERACRUZ DE IGNACIO DE LA LLAVE,30,IXHUACÁN DE LOS REYES,079,IXHUACÁN DE LOS REYES,5,617,316,301,33
VERACRUZ DE IGNACIO DE LA LLAVE,30,IXHUACÁN DE LOS REYES,079,LA ALAMEDA,3,75,39,36,5
VERACRUZ DE IGNACIO DE LA LLAVE,30,IXHUACÁN DE LOS REYES,079,LA RAYA,2,27,13,14,3
VERACRUZ DE IGNACIO DE LA LLAVE,30,IXHUACÁN DE LOS REYES,079,LOS LAURELES,2,68,36,32,4
VERACRUZ DE IGNACIO DE LA LLAVE,30,IXHUACÁN DE LOS REYES,079,LOS RODRÍGUEZ,2,16,11,5,1
VERACRUZ DE IGNACIO DE LA LLAVE,30,IXHUACÁN DE LOS REYES,079,MONTE GRANDE,3,194,85,109,11
VERACRUZ DE IGNACIO DE LA LLAVE,30,IXHUACÁN DE LOS REYES,079,NUEVA VILLA,1,4,3,1,1
VERACRUZ DE IGNACIO DE LA LLAVE,30,IXHUACÁN DE LOS REYES,079,TECPITLA,4,103,56,47,9
VERACRUZ DE IGNACIO DE LA LLAVE,30,IXHUACÁN DE LOS REYES,079,TETLAXCA,2,33,18,15,3
VERACRUZ DE IGNACIO DE LA LLAVE,30,IXHUACÁN DE LOS REYES,079,TLALCHY,4,149,73,76,16
VERACRUZ DE IGNACIO DE LA LLAVE,30,IXHUACÁN DE LOS REYES,079,TLALTETELA,2,38,17,21,3
VERACRUZ DE IGNACIO DE LA LLAVE,30,IXHUACÁN DE LOS REYES,079,VILLA NUEVA,1,7,2,5,1
VERACRUZ DE IGNACIO DE LA LLAVE,30,IXHUACÁN DE LOS REYES,079,XIVIZIL,1,13,7,6,1
VERACRUZ DE IGNACIO DE LA LLAVE,30,IXHUACÁN DE LOS REYES,079,XIXILACATLA,2,23,12,11,2
VERACRUZ DE IGNACIO DE LA LLAVE,30,IXHUACÁN DE LOS REYES,079,XIXITLA,2,19,9,10,3
VERACRUZ DE IGNACIO DE LA LLAVE,30,IXHUATLÁN DEL CAFÉ,080,ÁLVARO OBREGÓN,3,194,102,92,11
VERACRUZ DE IGNACIO DE LA LLAVE,30,IXHUATLÁN DEL CAFÉ,080,EJIDO LOS NARANJOS,3,104,48,56,7
VERACRUZ DE IGNACIO DE LA LLAVE,30,IXHUATLÁN DEL CAFÉ,080,EL CRUCERO DE ZAPATA (EL CRUCERO),1,8,6,2,1
VERACRUZ DE IGNACIO DE LA LLAVE,30,IXHUATLÁN DEL CAFÉ,080,EL IZOTAL,1,18,7,11,2
VERACRUZ DE IGNACIO DE LA LLAVE,30,IXHUATLÁN DEL CAFÉ,080,GUZMANTLA,3,193,93,100,10
VERACRUZ DE IGNACIO DE LA LLAVE,30,IXHUATLÁN DEL CAFÉ,080,IXCAPANTLA,3,178,84,94,11
VERACRUZ DE IGNACIO DE LA LLAVE,30,IXHUATLÁN DEL CAFÉ,080,IXCATLA,4,267,138,129,14
VERACRUZ DE IGNACIO DE LA LLAVE,30,IXHUATLÁN DEL CAFÉ,080,IXHUATLÁN DEL CAFÉ,10,1574,774,800,76
VERACRUZ DE IGNACIO DE LA LLAVE,30,IXHUATLÁN DEL CAFÉ,080,IXVIONTLA,2,11,4,7,2
VERACRUZ DE IGNACIO DE LA LLAVE,30,IXHUATLÁN DEL CAFÉ,080,MATLAQUIÁHUITL,3,79,45,34,5
VERACRUZ DE IGNACIO DE LA LLAVE,30,IXHUATLÁN DEL CAFÉ,080,MOCTEZUMA (COLONIA MOCTEZUMA),2,25,13,12,2
VERACRUZ DE IGNACIO DE LA LLAVE,30,IXHUATLÁN DEL CAFÉ,080,NEVERÍA,2,15,8,7,2
VERACRUZ DE IGNACIO DE LA LLAVE,30,IXHUATLÁN DEL CAFÉ,080,OCOTITLÁN,4,770,387,383,34
VERACRUZ DE IGNACIO DE LA LLAVE,30,IXHUATLÁN DEL CAFÉ,080,OCOTITLANAPAN,1,75,40,35,4
VERACRUZ DE IGNACIO DE LA LLAVE,30,IXHUATLÁN DEL CAFÉ,080,OPATLA,2,59,21,38,3
VERACRUZ DE IGNACIO DE LA LLAVE,30,IXHUATLÁN DEL CAFÉ,080,OPATLA VIEJO (LA ESPERANZA),2,18,5,13,2
VERACRUZ DE IGNACIO DE LA LLAVE,30,IXHUATLÁN DEL CAFÉ,080,PLAN DE AYALA,3,109,60,49,6
VERACRUZ DE IGNACIO DE LA LLAVE,30,IXHUATLÁN DEL CAFÉ,080,PRESIDIO,4,553,290,263,27
VERACRUZ DE IGNACIO DE LA LLAVE,30,IXHUATLÁN DEL CAFÉ,080,SAN JOSÉ LA TROJE,2,107,64,43,6
VERACRUZ DE IGNACIO DE LA LLAVE,30,IXHUATLÁN DEL CAFÉ,080,TLAMATOCA POTRERILLO,11,611,308,303,35
VERACRUZ DE IGNACIO DE LA LLAVE,30,IXHUATLÁN DEL CAFÉ,080,ZACAMITLA,3,174,83,91,12
VERACRUZ DE IGNACIO DE LA LLAVE,30,IXHUATLANCILLO,081,CHICOLA DOS,2,51,21,30,4
VERACRUZ DE IGNACIO DE LA LLAVE,30,IXHUATLANCILLO,081,IXHUATLANCILLO,10,1525,813,712,76
VERACRUZ DE IGNACIO DE LA LLAVE,30,IXHUATLANCILLO,081,LOS CAPULINES,1,106,51,55,6
VERACRUZ DE IGNACIO DE LA LLAVE,30,IXHUATLANCILLO,081,RANCHO DE PALA,2,79,41,38,5
VERACRUZ DE IGNACIO DE LA LLAVE,30,IXHUATLANCILLO,081,RANCHO DEL CRISTO,1,205,101,104,8
VERACRUZ DE IGNACIO DE LA LLAVE,30,IXHUATLANCILLO,081,SAN ISIDRO,3,187,88,99,11
VERACRUZ DE IGNACIO DE LA LLAVE,30,IXHUATLANCILLO,081,UNIÓN Y PROGRESO,6,535,275,260,33
VERACRUZ DE IGNACIO DE LA LLAVE,30,IXHUATLÁN DEL SURESTE,082,BENITO CANALES,1,15,7,8,1
VERACRUZ DE IGNACIO DE LA LLAVE,30,IXHUATLÁN DEL SURESTE,082,CADETE JUAN DE LA BARRERA,2,11,7,4,1
VERACRUZ DE IGNACIO DE LA LLAVE,30,IXHUATLÁN DEL SURESTE,082,COLONIA J. M. ALDANA,2,10,4,6,1
VERACRUZ DE IGNACIO DE LA LLAVE,30,IXHUATLÁN DEL SURESTE,082,COYOLAR,4,142,74,68,8
VERACRUZ DE IGNACIO DE LA LLAVE,30,IXHUATLÁN DEL SURESTE,082,EL TÚNEL,3,163,81,82,12
VERACRUZ DE IGNACIO DE LA LLAVE,30,IXHUATLÁN DEL SURESTE,082,EL ZAPOTAL,1,10,5,5,1
VERACRUZ DE IGNACIO DE LA LLAVE,30,IXHUATLÁN DEL SURESTE,082,ESFUERZO DEL TRABAJO (NANCHINTA),1,9,5,4,1
VERACRUZ DE IGNACIO DE LA LLAVE,30,IXHUATLÁN DEL SURESTE,082,FELIPE BERRIOZÁBAL,1,20,7,13,1
VERACRUZ DE IGNACIO DE LA LLAVE,30,IXHUATLÁN DEL SURESTE,082,GUAYABAL,1,11,6,5,1
VERACRUZ DE IGNACIO DE LA LLAVE,30,IXHUATLÁN DEL SURESTE,082,IXHUATLÁN DEL SURESTE,14,2299,1137,1162,125
VERACRUZ DE IGNACIO DE LA LLAVE,30,IXHUATLÁN DEL SURESTE,082,LA CEIBA,1,9,3,6,1
VERACRUZ DE IGNACIO DE LA LLAVE,30,IXHUATLÁN DEL SURESTE,082,LAS ÁGUILAS,2,65,32,33,4
VERACRUZ DE IGNACIO DE LA LLAVE,30,IXHUATLÁN DEL SURESTE,082,LAS PALOMAS,2,54,25,29,3
VERACRUZ DE IGNACIO DE LA LLAVE,30,IXHUATLÁN DEL SURESTE,082,PARAÍSO,2,29,16,13,2
VERACRUZ DE IGNACIO DE LA LLAVE,30,IXHUATLÁN DEL SURESTE,082,SANTA CLARA,3,115,48,67,10
VERACRUZ DE IGNACIO DE LA LLAVE,30,IXHUATLÁN DEL SURESTE,082,VILLA DEL ESPÍRITU SANTO,2,46,25,21,4
VERACRUZ DE IGNACIO DE LA LLAVE,30,IXHUATLÁN DE MADERO,083,ACATÍPA,1,11,5,6,1
VERACRUZ DE IGNACIO DE LA LLAVE,30,IXHUATLÁN DE MADERO,083,ACHICHIPIC,1,6,1,5,1
VERACRUZ DE IGNACIO DE LA LLAVE,30,IXHUATLÁN DE MADERO,083,AHUACAPA I,1,7,3,4,1
VERACRUZ DE IGNACIO DE LA LLAVE,30,IXHUATLÁN DE MADERO,083,AHUACAPA SEGUNDO,4,227,132,95,13
VERACRUZ DE IGNACIO DE LA LLAVE,30,IXHUATLÁN DE MADERO,083,APACHAHUATL,3,36,19,17,4
VERACRUZ DE IGNACIO DE LA LLAVE,30,IXHUATLÁN DE MADERO,083,AYOLIA,3,124,53,71,11
VERACRUZ DE IGNACIO DE LA LLAVE,30,IXHUATLÁN DE MADERO,083,AYOTLA,2,33,17,16,2
VERACRUZ DE IGNACIO DE LA LLAVE,30,IXHUATLÁN DE MADERO,083,BARRIO ABAJO COLATLÁN,1,154,78,76,11
VERACRUZ DE IGNACIO DE LA LLAVE,30,IXHUATLÁN DE MADERO,083,BENITO JUÁREZ,1,10,2,8,2
VERACRUZ DE IGNACIO DE LA LLAVE,30,IXHUATLÁN DE MADERO,083,BUENA VISTA,1,4,2,2,1
VERACRUZ DE IGNACIO DE LA LLAVE,30,IXHUATLÁN DE MADERO,083,CACAHUATENGO,4,500,250,250,25
VERACRUZ DE IGNACIO DE LA LLAVE,30,IXHUATLÁN DE MADERO,083,CANTOLLANO,2,35,17,18,2
VERACRUZ DE IGNACIO DE LA LLAVE,30,IXHUATLÁN DE MADERO,083,CERRO DEL PROGRESO,3,89,46,43,8
VERACRUZ DE IGNACIO DE LA LLAVE,30,IXHUATLÁN DE MADERO,083,CHAHUANTLA,1,4,1,3,1
VERACRUZ DE IGNACIO DE LA LLAVE,30,IXHUATLÁN DE MADERO,083,CHAPOPOTE,3,72,35,37,7
VERACRUZ DE IGNACIO DE LA LLAVE,30,IXHUATLÁN DE MADERO,083,CHIJOLITO MILCAHUATL,1,3,2,1,1
VERACRUZ DE IGNACIO DE LA LLAVE,30,IXHUATLÁN DE MADERO,083,COLATLÁN,6,891,480,411,53
VERACRUZ DE IGNACIO DE LA LLAVE,30,IXHUATLÁN DE MADERO,083,CRUZ BLANCA,2,40,14,26,3
VERACRUZ DE IGNACIO DE LA LLAVE,30,IXHUATLÁN DE MADERO,083,CUAHUELOCO,2,37,18,19,4
VERACRUZ DE IGNACIO DE LA LLAVE,30,IXHUATLÁN DE MADERO,083,EL AGUACATE BARRIO ABAJO,3,224,96,128,14
VERACRUZ DE IGNACIO DE LA LLAVE,30,IXHUATLÁN DE MADERO,083,EL AGUACATE BARRIO ARRIBA,3,106,54,52,11
VERACRUZ DE IGNACIO DE LA LLAVE,30,IXHUATLÁN DE MADERO,083,EL BECERRO,2,35,16,19,3
VERACRUZ DE IGNACIO DE LA LLAVE,30,IXHUATLÁN DE MADERO,083,EL LIMÓN,5,230,120,110,18
VERACRUZ DE IGNACIO DE LA LLAVE,30,IXHUATLÁN DE MADERO,083,EL LINDERO,1,8,6,2,1
VERACRUZ DE IGNACIO DE LA LLAVE,30,IXHUATLÁN DE MADERO,083,EL MIRADOR,6,208,106,102,17
VERACRUZ DE IGNACIO DE LA LLAVE,30,IXHUATLÁN DE MADERO,083,EL TABLÓN,2,30,18,12,3
VERACRUZ DE IGNACIO DE LA LLAVE,30,IXHUATLÁN DE MADERO,083,EL TEPETATE,2,57,29,28,4
VERACRUZ DE IGNACIO DE LA LLAVE,30,IXHUATLÁN DE MADERO,083,EL TERRERO,2,119,60,59,12
VERACRUZ DE IGNACIO DE LA LLAVE,30,IXHUATLÁN DE MADERO,083,EL TIZAL,4,86,38,48,9
VERACRUZ DE IGNACIO DE LA LLAVE,30,IXHUATLÁN DE MADERO,083,EL ZAPOTAL (LA LAJA),2,41,23,18,3
VERACRUZ DE IGNACIO DE LA LLAVE,30,IXHUATLÁN DE MADERO,083,EMILIANO ZAPATA,2,34,13,21,3
VERACRUZ DE IGNACIO DE LA LLAVE,30,IXHUATLÁN DE MADERO,083,GENERAL FELIPE ÁNGELES,4,183,94,89,11
VERACRUZ DE IGNACIO DE LA LLAVE,30,IXHUATLÁN DE MADERO,083,GUAGUACO,2,58,29,29,3
VERACRUZ DE IGNACIO DE LA LLAVE,30,IXHUATLÁN DE MADERO,083,HEBERTO CASTILLO MARTÍNEZ,2,32,15,17,3
VERACRUZ DE IGNACIO DE LA LLAVE,30,IXHUATLÁN DE MADERO,083,HUEXOTITLA,4,222,101,121,15
VERACRUZ DE IGNACIO DE LA LLAVE,30,IXHUATLÁN DE MADERO,083,HUITZITZILCO,2,24,12,12,3
VERACRUZ DE IGNACIO DE LA LLAVE,30,IXHUATLÁN DE MADERO,083,IXHUATLÁN DE MADERO,8,979,539,440,49
VERACRUZ DE IGNACIO DE LA LLAVE,30,IXHUATLÁN DE MADERO,083,JONOTAL AZTECA,5,169,79,90,12
VERACRUZ DE IGNACIO DE LA LLAVE,30,IXHUATLÁN DE MADERO,083,JONOTAL PROGRESO,1,9,5,4,1
VERACRUZ DE IGNACIO DE LA LLAVE,30,IXHUATLÁN DE MADERO,083,JOYA CHICA,3,106,38,68,9
VERACRUZ DE IGNACIO DE LA LLAVE,30,IXHUATLÁN DE MADERO,083,JOYA GRANDE,1,8,4,4,1
VERACRUZ DE IGNACIO DE LA LLAVE,30,IXHUATLÁN DE MADERO,083,JUNTAS GRANDES,3,54,28,26,5
VERACRUZ DE IGNACIO DE LA LLAVE,30,IXHUATLÁN DE MADERO,083,LA CHACA,2,15,8,7,2
VERACRUZ DE IGNACIO DE LA LLAVE,30,IXHUATLÁN DE MADERO,083,LA COLMENA,1,6,6,0,1
VERACRUZ DE IGNACIO DE LA LLAVE,30,IXHUATLÁN DE MADERO,083,LA GUADA,2,14,7,7,2
VERACRUZ DE IGNACIO DE LA LLAVE,30,IXHUATLÁN DE MADERO,083,LA MATA (CAMPO LA MATA),2,28,16,12,3
VERACRUZ DE IGNACIO DE LA LLAVE,30,IXHUATLÁN DE MADERO,083,LA PALMA CAPADERO,3,71,38,33,6
VERACRUZ DE IGNACIO DE LA LLAVE,30,IXHUATLÁN DE MADERO,083,LA PITA,2,46,28,18,4
VERACRUZ DE IGNACIO DE LA LLAVE,30,IXHUATLÁN DE MADERO,083,LA REFORMA,2,52,28,24,4
VERACRUZ DE IGNACIO DE LA LLAVE,30,IXHUATLÁN DE MADERO,083,LAS FLORES,2,43,22,21,3
VERACRUZ DE IGNACIO DE LA LLAVE,30,IXHUATLÁN DE MADERO,083,LAS MARAVILLAS,1,14,9,5,1
VERACRUZ DE IGNACIO DE LA LLAVE,30,IXHUATLÁN DE MADERO,083,LAS MESILLAS,1,5,2,3,1
VERACRUZ DE IGNACIO DE LA LLAVE,30,IXHUATLÁN DE MADERO,083,LECHECUATITLA,1,13,8,5,1
VERACRUZ DE IGNACIO DE LA LLAVE,30,IXHUATLÁN DE MADERO,083,LINDERO LIMÓN,2,24,14,10,2
VERACRUZ DE IGNACIO DE LA LLAVE,30,IXHUATLÁN DE MADERO,083,LLANO ENMEDIO,2,310,142,168,18
VERACRUZ DE IGNACIO DE LA LLAVE,30,IXHUATLÁN DE MADERO,083,LOMA BONITA (MESA CACAHUTENCO),1,7,4,3,1
VERACRUZ DE IGNACIO DE LA LLAVE,30,IXHUATLÁN DE MADERO,083,LOMAS DEL DORADO,3,99,54,45,7
VERACRUZ DE IGNACIO DE LA LLAVE,30,IXHUATLÁN DE MADERO,083,MARCIALTA,2,43,16,27,4
VERACRUZ DE IGNACIO DE LA LLAVE,30,IXHUATLÁN DE MADERO,083,MILCAHUAL,2,20,9,11,3
VERACRUZ DE IGNACIO DE LA LLAVE,30,IXHUATLÁN DE MADERO,083,MOLANGO,3,69,28,41,7
VERACRUZ DE IGNACIO DE LA LLAVE,30,IXHUATLÁN DE MADERO,083,NARANJO DULCE,2,23,13,10,2
VERACRUZ DE IGNACIO DE LA LLAVE,30,IXHUATLÁN DE MADERO,083,OJITAL CUAYO,4,144,83,61,12
VERACRUZ DE IGNACIO DE LA LLAVE,30,IXHUATLÁN DE MADERO,083,OJTLATZINTLA,1,4,2,2,1
VERACRUZ DE IGNACIO DE LA LLAVE,30,IXHUATLÁN DE MADERO,083,OXITEMPA,2,29,16,13,2
VERACRUZ DE IGNACIO DE LA LLAVE,30,IXHUATLÁN DE MADERO,083,PAHUA CHICA,1,7,3,4,1
VERACRUZ DE IGNACIO DE LA LLAVE,30,IXHUATLÁN DE MADERO,083,PAHUA GRANDE,4,126,68,58,9
VERACRUZ DE IGNACIO DE LA LLAVE,30,IXHUATLÁN DE MADERO,083,PASO DE AMATITLÁN,2,20,12,8,3
VERACRUZ DE IGNACIO DE LA LLAVE,30,IXHUATLÁN DE MADERO,083,PASO DE AYOLIA,1,9,5,4,1
VERACRUZ DE IGNACIO DE LA LLAVE,30,IXHUATLÁN DE MADERO,083,PIEDRA GRANDE (EL GUAYABO),2,114,58,56,9
VERACRUZ DE IGNACIO DE LA LLAVE,30,IXHUATLÁN DE MADERO,083,PIEDRA GRANDE CHIJOLITO,3,93,54,39,7
VERACRUZ DE IGNACIO DE LA LLAVE,30,IXHUATLÁN DE MADERO,083,PIEDRA GRANDE LA SIERRA,3,68,35,33,6
VERACRUZ DE IGNACIO DE LA LLAVE,30,IXHUATLÁN DE MADERO,083,PINO SUÁREZ,1,7,4,3,1
VERACRUZ DE IGNACIO DE LA LLAVE,30,IXHUATLÁN DE MADERO,083,PISAFLORES,9,689,348,341,49
VERACRUZ DE IGNACIO DE LA LLAVE,30,IXHUATLÁN DE MADERO,083,PITZOCALI,2,29,15,14,2
VERACRUZ DE IGNACIO DE LA LLAVE,30,IXHUATLÁN DE MADERO,083,PLAN DEL ENCINAL (EL ENCINAL),3,73,34,39,5
VERACRUZ DE IGNACIO DE LA LLAVE,30,IXHUATLÁN DE MADERO,083,POZA GRANDE,1,4,2,2,1
VERACRUZ DE IGNACIO DE LA LLAVE,30,IXHUATLÁN DE MADERO,083,PROGRESO,2,33,19,14,3
VERACRUZ DE IGNACIO DE LA LLAVE,30,IXHUATLÁN DE MADERO,083,PUYECACO,3,85,45,40,4
VERACRUZ DE IGNACIO DE LA LLAVE,30,IXHUATLÁN DE MADERO,083,RANCHO NUEVO,2,38,23,15,3
VERACRUZ DE IGNACIO DE LA LLAVE,30,IXHUATLÁN DE MADERO,083,REYIXTLA,3,106,62,44,10
VERACRUZ DE IGNACIO DE LA LLAVE,30,IXHUATLÁN DE MADERO,083,SAN BERNARDO,1,7,3,4,1
VERACRUZ DE IGNACIO DE LA LLAVE,30,IXHUATLÁN DE MADERO,083,SAN FRANCISCO,6,818,422,396,47
VERACRUZ DE IGNACIO DE LA LLAVE,30,IXHUATLÁN DE MADERO,083,SAN JOSÉ EL SALTO,2,66,37,29,4
VERACRUZ DE IGNACIO DE LA LLAVE,30,IXHUATLÁN DE MADERO,083,SAN MARTÍN,4,162,71,91,12
VERACRUZ DE IGNACIO DE LA LLAVE,30,IXHUATLÁN DE MADERO,083,SAN PEDRO TZILTZACUAPAN,4,136,66,70,11
VERACRUZ DE IGNACIO DE LA LLAVE,30,IXHUATLÁN DE MADERO,083,SANTA FE,2,18,12,6,2
VERACRUZ DE IGNACIO DE LA LLAVE,30,IXHUATLÁN DE MADERO,083,SANTA MARÍA APIPILHUASCO,3,71,33,38,9
VERACRUZ DE IGNACIO DE LA LLAVE,30,IXHUATLÁN DE MADERO,083,SIETE PALMAS BARRIO ABAJO,3,52,24,28,4
VERACRUZ DE IGNACIO DE LA LLAVE,30,IXHUATLÁN DE MADERO,083,SIETE PALMAS BARRIO ARRIBA,2,78,40,38,6
VERACRUZ DE IGNACIO DE LA LLAVE,30,IXHUATLÁN DE MADERO,083,TECALCO,3,37,20,17,5
VERACRUZ DE IGNACIO DE LA LLAVE,30,IXHUATLÁN DE MADERO,083,TECOMATE DE BELTRÁN,2,48,23,25,3
VERACRUZ DE IGNACIO DE LA LLAVE,30,IXHUATLÁN DE MADERO,083,TENEXTONGO (SAN ANTONIO),3,37,17,20,4
VERACRUZ DE IGNACIO DE LA LLAVE,30,IXHUATLÁN DE MADERO,083,TEOPANCAHUATL,4,95,56,39,7
VERACRUZ DE IGNACIO DE LA LLAVE,30,IXHUATLÁN DE MADERO,083,TEPETLACO,1,9,3,6,1
VERACRUZ DE IGNACIO DE LA LLAVE,30,IXHUATLÁN DE MADERO,083,TEPOZUAPAN,2,15,4,11,3
VERACRUZ DE IGNACIO DE LA LLAVE,30,IXHUATLÁN DE MADERO,083,TLACHIQUILE,2,41,23,18,3
VERACRUZ DE IGNACIO DE LA LLAVE,30,IXHUATLÁN DE MADERO,083,TZAPALOTE,3,75,35,40,6
VERACRUZ DE IGNACIO DE LA LLAVE,30,IXHUATLÁN DE MADERO,083,TZAPOHÍCA,1,4,2,2,1
VERACRUZ DE IGNACIO DE LA LLAVE,30,IXHUATLÁN DE MADERO,083,TZOCOHUITE,4,302,128,174,19
VERACRUZ DE IGNACIO DE LA LLAVE,30,IXHUATLÁN DE MADERO,083,VILLA HERMOSA,1,5,2,3,1
VERACRUZ DE IGNACIO DE LA LLAVE,30,IXHUATLÁN DE MADERO,083,VISTA ALEGRE,2,44,22,22,4
VERACRUZ DE IGNACIO DE LA LLAVE,30,IXHUATLÁN DE MADERO,083,XOCHIMILCO,4,274,134,140,18
VERACRUZ DE IGNACIO DE LA LLAVE,30,IXHUATLÁN DE MADERO,083,XOMULCO,2,25,15,10,2
VERACRUZ DE IGNACIO DE LA LLAVE,30,IXHUATLÁN DE MADERO,083,ZAPOTE BRAVO,5,355,163,192,25
VERACRUZ DE IGNACIO DE LA LLAVE,30,IXHUATLÁN DE MADERO,083,ZIMATLA,3,80,39,41,6
VERACRUZ DE IGNACIO DE LA LLAVE,30,IXHUATLÁN DE MADERO,083,ZOLONTLA,1,1,0,1,1
VERACRUZ DE IGNACIO DE LA LLAVE,30,IXMATLAHUACAN,084,CAÑO GRANDE,2,18,10,8,2
VERACRUZ DE IGNACIO DE LA LLAVE,30,IXMATLAHUACAN,084,CHALPA,2,20,6,14,2
VERACRUZ DE IGNACIO DE LA LLAVE,30,IXMATLAHUACAN,084,CHARCO DE LA PEÑA,2,12,4,8,2
VERACRUZ DE IGNACIO DE LA LLAVE,30,IXMATLAHUACAN,084,CHICALPEXTLE,2,39,19,20,4
VERACRUZ DE IGNACIO DE LA LLAVE,30,IXMATLAHUACAN,084,EL CACIQUE,3,37,20,17,4
VERACRUZ DE IGNACIO DE LA LLAVE,30,IXMATLAHUACAN,084,EL CHINO,2,58,31,27,4
VERACRUZ DE IGNACIO DE LA LLAVE,30,IXMATLAHUACAN,084,IXMATLAHUACAN,4,307,179,128,25
VERACRUZ DE IGNACIO DE LA LLAVE,30,IXMATLAHUACAN,084,LAS CUATAS,1,10,8,2,1
VERACRUZ DE IGNACIO DE LA LLAVE,30,IXMATLAHUACAN,084,MOZAPA,4,221,127,94,16
VERACRUZ DE IGNACIO DE LA LLAVE,30,IXMATLAHUACAN,084,NUEVO CENTRO DE POBLACIÓN LA MAJAPA,1,4,4,0,1
VERACRUZ DE IGNACIO DE LA LLAVE,30,IXMATLAHUACAN,084,PACHUCA,2,38,22,16,4
VERACRUZ DE IGNACIO DE LA LLAVE,30,IXMATLAHUACAN,084,PEJE PUERCO,1,9,4,5,1
VERACRUZ DE IGNACIO DE LA LLAVE,30,IXTACZOQUITLÁN,085,BARRIO SAN ISIDRO,2,8,3,5,2
VERACRUZ DE IGNACIO DE LA LLAVE,30,IXTACZOQUITLÁN,085,BUENAVISTA,3,433,210,223,25
VERACRUZ DE IGNACIO DE LA LLAVE,30,IXTACZOQUITLÁN,085,CAMPO CHICO,4,688,345,343,35
VERACRUZ DE IGNACIO DE LA LLAVE,30,IXTACZOQUITLÁN,085,CAMPO GRANDE,3,543,270,273,25
VERACRUZ DE IGNACIO DE LA LLAVE,30,IXTACZOQUITLÁN,085,CAPOLUCA,5,558,274,284,30
VERACRUZ DE IGNACIO DE LA LLAVE,30,IXTACZOQUITLÁN,085,CAPOLUQUILLA,1,94,48,46,3
VERACRUZ DE IGNACIO DE LA LLAVE,30,IXTACZOQUITLÁN,085,CHILTEPEC,2,62,29,33,4
VERACRUZ DE IGNACIO DE LA LLAVE,30,IXTACZOQUITLÁN,085,CUAUTLAPAN,9,1418,704,714,97
VERACRUZ DE IGNACIO DE LA LLAVE,30,IXTACZOQUITLÁN,085,CUESTA DEL MEXICANO,3,184,84,100,12
VERACRUZ DE IGNACIO DE LA LLAVE,30,IXTACZOQUITLÁN,085,CUMBRE DE METLAC,3,72,36,36,6
VERACRUZ DE IGNACIO DE LA LLAVE,30,IXTACZOQUITLÁN,085,CUMBRES DE TUXPANGO,2,76,37,39,7
VERACRUZ DE IGNACIO DE LA LLAVE,30,IXTACZOQUITLÁN,085,EJIDO CUAUTLAPAN,1,20,8,12,2
VERACRUZ DE IGNACIO DE LA LLAVE,30,IXTACZOQUITLÁN,085,EX-HACIENDA TUXPANGO,2,79,37,42,5
VERACRUZ DE IGNACIO DE LA LLAVE,30,IXTACZOQUITLÁN,085,FRESNAL,3,132,66,66,9
VERACRUZ DE IGNACIO DE LA LLAVE,30,IXTACZOQUITLÁN,085,INTERMEDIO ZAPOAPAN,1,30,13,17,2
VERACRUZ DE IGNACIO DE LA LLAVE,30,IXTACZOQUITLÁN,085,IXTACZOQUITLÁN,24,5982,2726,3256,397
VERACRUZ DE IGNACIO DE LA LLAVE,30,IXTACZOQUITLÁN,085,LAGUNILLA,2,72,39,33,6
VERACRUZ DE IGNACIO DE LA LLAVE,30,IXTACZOQUITLÁN,085,LEZAMA,2,14,4,10,2
VERACRUZ DE IGNACIO DE LA LLAVE,30,IXTACZOQUITLÁN,085,MOYOAPAN,4,475,235,240,26
VERACRUZ DE IGNACIO DE LA LLAVE,30,IXTACZOQUITLÁN,085,NEXCA,2,79,37,42,4
VERACRUZ DE IGNACIO DE LA LLAVE,30,IXTACZOQUITLÁN,085,PAREDONES,2,35,20,15,3
VERACRUZ DE IGNACIO DE LA LLAVE,30,IXTACZOQUITLÁN,085,POTRERILLO,9,1439,739,700,74
VERACRUZ DE IGNACIO DE LA LLAVE,30,IXTACZOQUITLÁN,085,RANCHO VIEJO,2,109,54,55,5
VERACRUZ DE IGNACIO DE LA LLAVE,30,IXTACZOQUITLÁN,085,RINCÓN DE MARAVILLAS,3,164,78,86,11
VERACRUZ DE IGNACIO DE LA LLAVE,30,IXTACZOQUITLÁN,085,RINCÓN DE TECOLAYO,2,53,23,30,2
VERACRUZ DE IGNACIO DE LA LLAVE,30,IXTACZOQUITLÁN,085,RINCÓN TUXPANGUILLO,1,113,57,56,6
VERACRUZ DE IGNACIO DE LA LLAVE,30,IXTACZOQUITLÁN,085,SANTA ROSA,1,6,4,2,1
VERACRUZ DE IGNACIO DE LA LLAVE,30,IXTACZOQUITLÁN,085,SUMIDERO,6,818,389,429,49
VERACRUZ DE IGNACIO DE LA LLAVE,30,IXTACZOQUITLÁN,085,TEOPANAPA,1,13,7,6,1
VERACRUZ DE IGNACIO DE LA LLAVE,30,IXTACZOQUITLÁN,085,TUXPANGUILLO,6,883,434,449,45
VERACRUZ DE IGNACIO DE LA LLAVE,30,IXTACZOQUITLÁN,085,VISTA HERMOSA,1,9,4,5,1
VERACRUZ DE IGNACIO DE LA LLAVE,30,IXTACZOQUITLÁN,085,ZACATLA,2,12,9,3,2
VERACRUZ DE IGNACIO DE LA LLAVE,30,IXTACZOQUITLÁN,085,ZAPOAPAN,4,540,288,252,30
VERACRUZ DE IGNACIO DE LA LLAVE,30,IXTACZOQUITLÁN,085,ZOQUITLÁN VIEJO,2,48,21,27,3
VERACRUZ DE IGNACIO DE LA LLAVE,30,JALACINGO,086,AHUACATÁN,4,608,318,290,30
VERACRUZ DE IGNACIO DE LA LLAVE,30,JALACINGO,086,CALPULALPAN,3,215,102,113,12
VERACRUZ DE IGNACIO DE LA LLAVE,30,JALACINGO,086,CHICONTA,3,87,41,46,6
VERACRUZ DE IGNACIO DE LA LLAVE,30,JALACINGO,086,COLONIA LAS DELICIAS (EJIDO CUAUHTAMINGO),3,24,12,12,3
VERACRUZ DE IGNACIO DE LA LLAVE,30,JALACINGO,086,CRUZ ALTA,2,4,3,1,1
VERACRUZ DE IGNACIO DE LA LLAVE,30,JALACINGO,086,CUARTEL CUATRO,3,232,119,113,11
VERACRUZ DE IGNACIO DE LA LLAVE,30,JALACINGO,086,CUAUHTAMINGO,5,241,113,128,17
VERACRUZ DE IGNACIO DE LA LLAVE,30,JALACINGO,086,EL ARCO,3,76,31,45,7
VERACRUZ DE IGNACIO DE LA LLAVE,30,JALACINGO,086,EL BRAVO CHICO,2,14,7,7,3
VERACRUZ DE IGNACIO DE LA LLAVE,30,JALACINGO,086,EL PROGRESO,3,93,39,54,7
VERACRUZ DE IGNACIO DE LA LLAVE,30,JALACINGO,086,EL RINCÓN,1,22,6,16,2
VERACRUZ DE IGNACIO DE LA LLAVE,30,JALACINGO,086,EL TEPEYAC,3,17,7,10,3
VERACRUZ DE IGNACIO DE LA LLAVE,30,JALACINGO,086,EPAPA,3,108,45,63,7
VERACRUZ DE IGNACIO DE LA LLAVE,30,JALACINGO,086,FRANCISCO BARRIENTOS Y BARRIENTOS (SANTA ANITA),3,452,229,223,22
VERACRUZ DE IGNACIO DE LA LLAVE,30,JALACINGO,086,GUADALUPE VICTORIA,2,303,153,150,14
VERACRUZ DE IGNACIO DE LA LLAVE,30,JALACINGO,086,HUAXTLA,1,10,7,3,1
VERACRUZ DE IGNACIO DE LA LLAVE,30,JALACINGO,086,IGNACIO ALLENDE,2,30,8,22,3
VERACRUZ DE IGNACIO DE LA LLAVE,30,JALACINGO,086,JALACINGO,15,3558,1826,1732,151
VERACRUZ DE IGNACIO DE LA LLAVE,30,JALACINGO,086,JOSÉ MARÍA MORELOS Y PAVÓN,3,224,107,117,11
VERACRUZ DE IGNACIO DE LA LLAVE,30,JALACINGO,086,LOMA DE HIDALGO,1,83,44,39,5
VERACRUZ DE IGNACIO DE LA LLAVE,30,JALACINGO,086,LOMA LARGA,2,22,13,9,3
VERACRUZ DE IGNACIO DE LA LLAVE,30,JALACINGO,086,MELCHOR OCAMPO,6,359,173,186,18
VERACRUZ DE IGNACIO DE LA LLAVE,30,JALACINGO,086,MIGUEL HIDALGO,6,401,216,185,27
VERACRUZ DE IGNACIO DE LA LLAVE,30,JALACINGO,086,MIXQUIAPAN,6,737,357,380,33
VERACRUZ DE IGNACIO DE LA LLAVE,30,JALACINGO,086,NICOLÁS BRAVO,6,140,66,74,9
VERACRUZ DE IGNACIO DE LA LLAVE,30,JALACINGO,086,OCOTEPEC,5,442,225,217,29
VERACRUZ DE IGNACIO DE LA LLAVE,30,JALACINGO,086,ORILLA DEL MONTE,4,552,299,253,26
VERACRUZ DE IGNACIO DE LA LLAVE,30,JALACINGO,086,PLAN DE HIDALGO,3,85,40,45,6
VERACRUZ DE IGNACIO DE LA LLAVE,30,JALACINGO,086,PLAN DE SAN LUIS,2,117,59,58,5
VERACRUZ DE IGNACIO DE LA LLAVE,30,JALACINGO,086,SANTA ANA,3,170,91,79,10
VERACRUZ DE IGNACIO DE LA LLAVE,30,JALACINGO,086,VICENTE GUERRERO,2,63,25,38,4
VERACRUZ DE IGNACIO DE LA LLAVE,30,JALACINGO,086,VISTA HERMOSA,5,592,308,284,29
VERACRUZ DE IGNACIO DE LA LLAVE,30,JALACINGO,086,VISTA HERMOSA PARTE ALTA (CUARTEL SIETE),1,10,8,2,1
VERACRUZ DE IGNACIO DE LA LLAVE,30,XALAPA,087,CASTILLO CHICO,2,103,51,52,6
VERACRUZ DE IGNACIO DE LA LLAVE,30,XALAPA,087,CHILTOYAC,4,586,274,312,35
VERACRUZ DE IGNACIO DE LA LLAVE,30,XALAPA,087,COLONIA SEIS DE ENERO,2,91,35,56,9
VERACRUZ DE IGNACIO DE LA LLAVE,30,XALAPA,087,EJIDO BENITO JUÁREZ,2,9,3,6,2
VERACRUZ DE IGNACIO DE LA LLAVE,30,XALAPA,087,EL CASTILLO,10,1573,816,757,102
VERACRUZ DE IGNACIO DE LA LLAVE,30,XALAPA,087,FRACCIONAMIENTO LAS FUENTES,3,98,48,50,8
VERACRUZ DE IGNACIO DE LA LLAVE,30,XALAPA,087,LAS CRUCES,3,96,60,36,8
VERACRUZ DE IGNACIO DE LA LLAVE,30,XALAPA,087,LOMA BONITA,1,33,13,20,2
VERACRUZ DE IGNACIO DE LA LLAVE,30,XALAPA,087,LOMAS VERDES,1,39,20,19,5
VERACRUZ DE IGNACIO DE LA LLAVE,30,XALAPA,087,SAN ANTONIO PASO DEL TORO,3,171,93,78,14
VERACRUZ DE IGNACIO DE LA LLAVE,30,XALAPA,087,TRONCONAL,3,317,161,156,22
VERACRUZ DE IGNACIO DE LA LLAVE,30,XALAPA,087,XALAPA-ENRÍQUEZ,807,209050,111409,97641,18596
VERACRUZ DE IGNACIO DE LA LLAVE,30,XALAPA,087,XOLOXTLA,1,28,15,13,2
VERACRUZ DE IGNACIO DE LA LLAVE,30,JALCOMULCO,088,JALCOMULCO,4,516,267,249,32
VERACRUZ DE IGNACIO DE LA LLAVE,30,JALCOMULCO,088,SANTA MARÍA TATETLA,4,293,155,138,18
VERACRUZ DE IGNACIO DE LA LLAVE,30,JALCOMULCO,088,TACOTALPAN,2,25,13,12,2
VERACRUZ DE IGNACIO DE LA LLAVE,30,JÁLTIPAN,089,AHUACATEPEC,2,27,16,11,3
VERACRUZ DE IGNACIO DE LA LLAVE,30,JÁLTIPAN,089,AHUATEPEC,5,114,61,53,10
VERACRUZ DE IGNACIO DE LA LLAVE,30,JÁLTIPAN,089,ANÁHUAC,1,3,2,1,1
VERACRUZ DE IGNACIO DE LA LLAVE,30,JÁLTIPAN,089,BOQUIAPAN,2,15,9,6,2
VERACRUZ DE IGNACIO DE LA LLAVE,30,JÁLTIPAN,089,BUENAVISTA DE LA ASUNCIÓN,2,28,17,11,3
VERACRUZ DE IGNACIO DE LA LLAVE,30,JÁLTIPAN,089,CASAS VIEJAS,1,13,8,5,1
VERACRUZ DE IGNACIO DE LA LLAVE,30,JÁLTIPAN,089,EMILIANO ZAPATA,3,29,11,18,3
VERACRUZ DE IGNACIO DE LA LLAVE,30,JÁLTIPAN,089,IXPUCHAPAN,3,56,21,35,4
VERACRUZ DE IGNACIO DE LA LLAVE,30,JÁLTIPAN,089,JÁLTIPAN DE MORELOS,46,6021,3042,2979,459
VERACRUZ DE IGNACIO DE LA LLAVE,30,JÁLTIPAN,089,JUAN DE LA BARRERA,1,6,3,3,1
VERACRUZ DE IGNACIO DE LA LLAVE,30,JÁLTIPAN,089,KILÓMETRO CINCUENTA,2,8,5,3,2
VERACRUZ DE IGNACIO DE LA LLAVE,30,JÁLTIPAN,089,LA CIÉNEGA,2,33,15,18,3
VERACRUZ DE IGNACIO DE LA LLAVE,30,JÁLTIPAN,089,LA LAJILLA,2,28,13,15,3
VERACRUZ DE IGNACIO DE LA LLAVE,30,JÁLTIPAN,089,LAS GALERAS,3,54,23,31,5
VERACRUZ DE IGNACIO DE LA LLAVE,30,JÁLTIPAN,089,LAS LOMAS DE TACAMICHAPAN,4,176,85,91,16
VERACRUZ DE IGNACIO DE LA LLAVE,30,JÁLTIPAN,089,MALOTA,2,26,12,14,2
VERACRUZ DE IGNACIO DE LA LLAVE,30,JÁLTIPAN,089,MIXTÁN,2,18,8,10,2
VERACRUZ DE IGNACIO DE LA LLAVE,30,JÁLTIPAN,089,POBLADO COCUITAL,1,40,18,22,2
VERACRUZ DE IGNACIO DE LA LLAVE,30,JÁLTIPAN,089,RANCHOAPAN,4,131,72,59,10
VERACRUZ DE IGNACIO DE LA LLAVE,30,JÁLTIPAN,089,SAN ANTONIO,1,10,3,7,1
VERACRUZ DE IGNACIO DE LA LLAVE,30,JÁLTIPAN,089,SAN LORENZO,2,36,19,17,3
VERACRUZ DE IGNACIO DE LA LLAVE,30,JÁLTIPAN,089,SAN SOLES,2,9,5,4,2
VERACRUZ DE IGNACIO DE LA LLAVE,30,JÁLTIPAN,089,YANCUIGAPAN,2,40,18,22,3
VERACRUZ DE IGNACIO DE LA LLAVE,30,JAMAPA,090,EL APACHITAL,2,29,11,18,3
VERACRUZ DE IGNACIO DE LA LLAVE,30,JAMAPA,090,EL JILGUERO,2,22,12,10,2
VERACRUZ DE IGNACIO DE LA LLAVE,30,JAMAPA,090,EL MANILA,2,8,5,3,1
VERACRUZ DE IGNACIO DE LA LLAVE,30,JAMAPA,090,EL PIÑONAL,2,35,19,16,3
VERACRUZ DE IGNACIO DE LA LLAVE,30,JAMAPA,090,EL RINCÓN,2,43,14,29,4
VERACRUZ DE IGNACIO DE LA LLAVE,30,JAMAPA,090,EL YAGUAL,2,27,17,10,3
VERACRUZ DE IGNACIO DE LA LLAVE,30,JAMAPA,090,EL ZACATAL,4,159,85,74,13
VERACRUZ DE IGNACIO DE LA LLAVE,30,JAMAPA,090,JAMAPA,10,1325,689,636,80
VERACRUZ DE IGNACIO DE LA LLAVE,30,JAMAPA,090,LA BRECHA,1,11,4,7,1
VERACRUZ DE IGNACIO DE LA LLAVE,30,JAMAPA,090,LA JAVILLA,3,89,38,51,10
VERACRUZ DE IGNACIO DE LA LLAVE,30,JAMAPA,090,LA LAJILLA,2,24,10,14,2
VERACRUZ DE IGNACIO DE LA LLAVE,30,JAMAPA,090,LA MATAMBA (HIGUERA DE LAS RAÍCES),4,245,104,141,15
VERACRUZ DE IGNACIO DE LA LLAVE,30,JAMAPA,090,LA ZAPILLA,1,9,4,5,1
VERACRUZ DE IGNACIO DE LA LLAVE,30,JAMAPA,090,LAS IGUANAS,1,17,10,7,1
VERACRUZ DE IGNACIO DE LA LLAVE,30,JAMAPA,090,LAS PUERTAS,3,123,71,52,10
VERACRUZ DE IGNACIO DE LA LLAVE,30,JAMAPA,090,PASO DE LA CRUZ,2,33,13,20,3
VERACRUZ DE IGNACIO DE LA LLAVE,30,JESÚS CARRANZA,091,ADALBERTO TEJEDA,2,13,6,7,2
VERACRUZ DE IGNACIO DE LA LLAVE,30,JESÚS CARRANZA,091,ADOLFO LÓPEZ MATEOS (ZACATAL),1,9,5,4,1
VERACRUZ DE IGNACIO DE LA LLAVE,30,JESÚS CARRANZA,091,ADRIÁN CASTREJÓN VIEJO,3,37,20,17,3
VERACRUZ DE IGNACIO DE LA LLAVE,30,JESÚS CARRANZA,091,ARROYO AZUL,1,4,0,4,1
VERACRUZ DE IGNACIO DE LA LLAVE,30,JESÚS CARRANZA,091,ARROYO EL SAUCE,3,49,21,28,3
VERACRUZ DE IGNACIO DE LA LLAVE,30,JESÚS CARRANZA,091,BOCA ARENALES,2,20,9,11,2
VERACRUZ DE IGNACIO DE LA LLAVE,30,JESÚS CARRANZA,091,BUENAVISTA,3,113,53,60,8
VERACRUZ DE IGNACIO DE LA LLAVE,30,JESÚS CARRANZA,091,CAROLINO ANAYA,2,17,6,11,2
VERACRUZ DE IGNACIO DE LA LLAVE,30,JESÚS CARRANZA,091,CASCAJAL UNO,4,48,26,22,5
VERACRUZ DE IGNACIO DE LA LLAVE,30,JESÚS CARRANZA,091,CHALCHIJAPAN (ANEXO EL PARAÍSO),3,120,54,66,7
VERACRUZ DE IGNACIO DE LA LLAVE,30,JESÚS CARRANZA,091,CHICAJÁN,2,15,5,10,3
VERACRUZ DE IGNACIO DE LA LLAVE,30,JESÚS CARRANZA,091,CINCO DE MAYO,2,13,8,5,1
VERACRUZ DE IGNACIO DE LA LLAVE,30,JESÚS CARRANZA,091,COAPILOLOYITA,3,90,29,61,6
VERACRUZ DE IGNACIO DE LA LLAVE,30,JESÚS CARRANZA,091,COLONIA NUEVO MORELOS,7,927,472,455,83
VERACRUZ DE IGNACIO DE LA LLAVE,30,JESÚS CARRANZA,091,CUACLÁN,1,6,4,2,1
VERACRUZ DE IGNACIO DE LA LLAVE,30,JESÚS CARRANZA,091,CUAUHTÉMOC DOS,4,77,36,41,6
VERACRUZ DE IGNACIO DE LA LLAVE,30,JESÚS CARRANZA,091,DIECISÉIS DE SEPTIEMBRE,4,64,35,29,6
VERACRUZ DE IGNACIO DE LA LLAVE,30,JESÚS CARRANZA,091,DOMINGO ARENAS,2,7,5,2,1
VERACRUZ DE IGNACIO DE LA LLAVE,30,JESÚS CARRANZA,091,EL NARANJO,2,19,8,11,2
VERACRUZ DE IGNACIO DE LA LLAVE,30,JESÚS CARRANZA,091,EL NOPAL,1,10,6,4,1
VERACRUZ DE IGNACIO DE LA LLAVE,30,JESÚS CARRANZA,091,EL PORVENIR,1,8,2,6,1
VERACRUZ DE IGNACIO DE LA LLAVE,30,JESÚS CARRANZA,091,EL SÚCHIL,2,118,50,68,7
VERACRUZ DE IGNACIO DE LA LLAVE,30,JESÚS CARRANZA,091,EL TEPACHE,4,158,80,78,10
VERACRUZ DE IGNACIO DE LA LLAVE,30,JESÚS CARRANZA,091,EL TESORO,2,25,6,19,2
VERACRUZ DE IGNACIO DE LA LLAVE,30,JESÚS CARRANZA,091,ENRIQUE RODRÍGUEZ CANO,2,18,12,6,2
VERACRUZ DE IGNACIO DE LA LLAVE,30,JESÚS CARRANZA,091,EUGENIO MÉNDEZ DOCURRO,2,50,23,27,4
VERACRUZ DE IGNACIO DE LA LLAVE,30,JESÚS CARRANZA,091,FERNANDO LÓPEZ ARIAS,2,27,12,15,2
VERACRUZ DE IGNACIO DE LA LLAVE,30,JESÚS CARRANZA,091,FRANCISCO VILLA NUEVO,1,11,7,4,1
VERACRUZ DE IGNACIO DE LA LLAVE,30,JESÚS CARRANZA,091,FRANCISCO VILLA VIEJO,2,18,9,9,2
VERACRUZ DE IGNACIO DE LA LLAVE,30,JESÚS CARRANZA,091,GENERAL VICENTE GUERRERO,1,7,2,5,1
VERACRUZ DE IGNACIO DE LA LLAVE,30,JESÚS CARRANZA,091,GRACIANO SÁNCHEZ,1,5,2,3,1
VERACRUZ DE IGNACIO DE LA LLAVE,30,JESÚS CARRANZA,091,GUADALUPE PIEDRA BOLA CASTILLITO,2,10,6,4,1
VERACRUZ DE IGNACIO DE LA LLAVE,30,JESÚS CARRANZA,091,HERIBERTO JARA CORONA,1,12,5,7,1
VERACRUZ DE IGNACIO DE LA LLAVE,30,JESÚS CARRANZA,091,ITURBIDE I,1,3,2,1,1
VERACRUZ DE IGNACIO DE LA LLAVE,30,JESÚS CARRANZA,091,JESÚS CARRANZA,9,2132,1087,1045,110
VERACRUZ DE IGNACIO DE LA LLAVE,30,JESÚS CARRANZA,091,JOSÉ VASCONCELOS,2,24,12,12,2
VERACRUZ DE IGNACIO DE LA LLAVE,30,JESÚS CARRANZA,091,JOSEFA ORTIZ DE DOMÍNGUEZ (TRONCONADA),3,79,44,35,6
VERACRUZ DE IGNACIO DE LA LLAVE,30,JESÚS CARRANZA,091,JUAN DE LA LUZ ENRÍQUEZ,1,12,4,8,2
VERACRUZ DE IGNACIO DE LA LLAVE,30,JESÚS CARRANZA,091,JUAN ESCUTIA,2,44,18,26,3
VERACRUZ DE IGNACIO DE LA LLAVE,30,JESÚS CARRANZA,091,LA BOCA DEL CHALCHIJAPAN,1,14,9,5,1
VERACRUZ DE IGNACIO DE LA LLAVE,30,JESÚS CARRANZA,091,LA CANDELARIA,1,7,2,5,1
VERACRUZ DE IGNACIO DE LA LLAVE,30,JESÚS CARRANZA,091,LA ESPERANZA,1,23,12,11,2
VERACRUZ DE IGNACIO DE LA LLAVE,30,JESÚS CARRANZA,091,LA GUADALUPE,2,23,14,9,2
VERACRUZ DE IGNACIO DE LA LLAVE,30,JESÚS CARRANZA,091,LA JAROCHITA,1,5,1,4,1
VERACRUZ DE IGNACIO DE LA LLAVE,30,JESÚS CARRANZA,091,LA PROVIDENCIA,2,20,5,15,2
VERACRUZ DE IGNACIO DE LA LLAVE,30,JESÚS CARRANZA,091,LAS LIMAS,3,87,40,47,7
VERACRUZ DE IGNACIO DE LA LLAVE,30,JESÚS CARRANZA,091,LAS PERLAS,3,105,56,49,5
VERACRUZ DE IGNACIO DE LA LLAVE,30,JESÚS CARRANZA,091,LÁZARO CÁRDENAS,1,4,0,4,1
VERACRUZ DE IGNACIO DE LA LLAVE,30,JESÚS CARRANZA,091,MADAMITA,1,5,2,3,1
VERACRUZ DE IGNACIO DE LA LLAVE,30,JESÚS CARRANZA,091,MODELO DOS RÍOS (LAS FLORES),3,106,56,50,9
VERACRUZ DE IGNACIO DE LA LLAVE,30,JESÚS CARRANZA,091,NIÑOS HÉROES DE CHAPULTEPEC (ZETINA),4,137,65,72,6
VERACRUZ DE IGNACIO DE LA LLAVE,30,JESÚS CARRANZA,091,NIPOJPOLÍHUITL,2,27,14,13,2
VERACRUZ DE IGNACIO DE LA LLAVE,30,JESÚS CARRANZA,091,NUEVA ESPERANZA,3,67,36,31,6
VERACRUZ DE IGNACIO DE LA LLAVE,30,JESÚS CARRANZA,091,NUEVA TAPATÍA,2,30,12,18,2
VERACRUZ DE IGNACIO DE LA LLAVE,30,JESÚS CARRANZA,091,NUEVO PARAÍSO,1,22,12,10,4
VERACRUZ DE IGNACIO DE LA LLAVE,30,JESÚS CARRANZA,091,NUEVO PROGRESO (LAS HUERTAS MEDINA),2,40,18,22,3
VERACRUZ DE IGNACIO DE LA LLAVE,30,JESÚS CARRANZA,091,NUEVO ZACATEPEC,2,21,11,10,2
VERACRUZ DE IGNACIO DE LA LLAVE,30,JESÚS CARRANZA,091,NUEVO ZACUALPAN,3,53,21,32,4
VERACRUZ DE IGNACIO DE LA LLAVE,30,JESÚS CARRANZA,091,OJO DE AGUA,2,16,9,7,2
VERACRUZ DE IGNACIO DE LA LLAVE,30,JESÚS CARRANZA,091,PALO DULCE,3,117,58,59,8
VERACRUZ DE IGNACIO DE LA LLAVE,30,JESÚS CARRANZA,091,PLAN DE PERICOS,3,26,14,12,3
VERACRUZ DE IGNACIO DE LA LLAVE,30,JESÚS CARRANZA,091,REVOLUCIÓN,1,12,6,6,1
VERACRUZ DE IGNACIO DE LA LLAVE,30,JESÚS CARRANZA,091,RICARDO FLORES MAGÓN,4,118,57,61,7
VERACRUZ DE IGNACIO DE LA LLAVE,30,JESÚS CARRANZA,091,SAN CRISTÓBAL,1,20,14,6,2
VERACRUZ DE IGNACIO DE LA LLAVE,30,JESÚS CARRANZA,091,SAN LUIS,2,28,13,15,3
VERACRUZ DE IGNACIO DE LA LLAVE,30,JESÚS CARRANZA,091,SAN MARCOS,1,5,2,3,1
VERACRUZ DE IGNACIO DE LA LLAVE,30,JESÚS CARRANZA,091,SAN MARTÍN,2,48,28,20,4
VERACRUZ DE IGNACIO DE LA LLAVE,30,JESÚS CARRANZA,091,SAN MIGUEL DEL RÍO,3,34,20,14,3
VERACRUZ DE IGNACIO DE LA LLAVE,30,JESÚS CARRANZA,091,SANTA LUCRECIA,3,387,207,180,23
VERACRUZ DE IGNACIO DE LA LLAVE,30,JESÚS CARRANZA,091,SUCHILAPAN DEL RÍO,7,758,387,371,41
VERACRUZ DE IGNACIO DE LA LLAVE,30,JESÚS CARRANZA,091,SUCHILAPILLA,3,42,17,25,5
VERACRUZ DE IGNACIO DE LA LLAVE,30,JESÚS CARRANZA,091,TECOLOTEPEC,4,74,42,32,8
VERACRUZ DE IGNACIO DE LA LLAVE,30,JESÚS CARRANZA,091,TEPACHILLO,1,19,9,10,1
VERACRUZ DE IGNACIO DE LA LLAVE,30,JESÚS CARRANZA,091,VEINTICUATRO DE FEBRERO,4,202,92,110,11
VERACRUZ DE IGNACIO DE LA LLAVE,30,JESÚS CARRANZA,091,VISTA HERMOSA (COLORADO),1,20,10,10,1
VERACRUZ DE IGNACIO DE LA LLAVE,30,XICO,092,ARROYO SECO,2,6,2,4,1
VERACRUZ DE IGNACIO DE LA LLAVE,30,XICO,092,BUENA VISTA,1,13,5,8,1
VERACRUZ DE IGNACIO DE LA LLAVE,30,XICO,092,COATITILÁN,2,54,26,28,4
VERACRUZ DE IGNACIO DE LA LLAVE,30,XICO,092,COAUHTEMECATLA,2,34,19,15,3
VERACRUZ DE IGNACIO DE LA LLAVE,30,XICO,092,COLONIA EL HAYA (CHAPULAPAN),2,361,167,194,21
VERACRUZ DE IGNACIO DE LA LLAVE,30,XICO,092,COLONIA RODRÍGUEZ CLARA,3,59,25,34,8
VERACRUZ DE IGNACIO DE LA LLAVE,30,XICO,092,COLONIA ÚRSULO GALVÁN,5,397,192,205,30
VERACRUZ DE IGNACIO DE LA LLAVE,30,XICO,092,COXMATLA,2,37,18,19,3
VERACRUZ DE IGNACIO DE LA LLAVE,30,XICO,092,CRUZ BLANCA,3,34,20,14,4
VERACRUZ DE IGNACIO DE LA LLAVE,30,XICO,092,EL FILO,2,18,7,11,1
VERACRUZ DE IGNACIO DE LA LLAVE,30,XICO,092,FINCA SAN BARTOLO,2,383,182,201,18
VERACRUZ DE IGNACIO DE LA LLAVE,30,XICO,092,INGENIO DEL ROSARIO,1,8,8,0,1
VERACRUZ DE IGNACIO DE LA LLAVE,30,XICO,092,IXÓCHITL,2,24,13,11,2
VERACRUZ DE IGNACIO DE LA LLAVE,30,XICO,092,LA LAGUNA,3,96,49,47,8
VERACRUZ DE IGNACIO DE LA LLAVE,30,XICO,092,LAS CARABINAS,2,9,6,3,1
VERACRUZ DE IGNACIO DE LA LLAVE,30,XICO,092,LAS CRUCES,2,4,3,1,1
VERACRUZ DE IGNACIO DE LA LLAVE,30,XICO,092,LOS POCITOS,3,131,56,75,8
VERACRUZ DE IGNACIO DE LA LLAVE,30,XICO,092,MATLALAPA,4,193,95,98,13
VERACRUZ DE IGNACIO DE LA LLAVE,30,XICO,092,MICOXTLA,3,112,58,54,9
VERACRUZ DE IGNACIO DE LA LLAVE,30,XICO,092,OXTLAPA,4,82,41,41,10
VERACRUZ DE IGNACIO DE LA LLAVE,30,XICO,092,PASO PANAL,3,42,20,22,5
VERACRUZ DE IGNACIO DE LA LLAVE,30,XICO,092,RUSIA,2,14,8,6,2
VERACRUZ DE IGNACIO DE LA LLAVE,30,XICO,092,SAN JOSÉ PASO NUEVO,2,20,10,10,2
VERACRUZ DE IGNACIO DE LA LLAVE,30,XICO,092,SAN MARCOS DE LEÓN (SAN MARCOS),10,1101,575,526,88
VERACRUZ DE IGNACIO DE LA LLAVE,30,XICO,092,SANTA ELENA,1,5,4,1,1
VERACRUZ DE IGNACIO DE LA LLAVE,30,XICO,092,TEMBLADERAS,3,146,72,74,7
VERACRUZ DE IGNACIO DE LA LLAVE,30,XICO,092,TICUATIPAN,3,98,49,49,7
VERACRUZ DE IGNACIO DE LA LLAVE,30,XICO,092,TLACUILOLAN,3,95,45,50,8
VERACRUZ DE IGNACIO DE LA LLAVE,30,XICO,092,TONALACO,4,339,170,169,20
VERACRUZ DE IGNACIO DE LA LLAVE,30,XICO,092,XICO,25,3558,1770,1788,242
VERACRUZ DE IGNACIO DE LA LLAVE,30,XICO,092,XICO VIEJO,3,155,78,77,10
VERACRUZ DE IGNACIO DE LA LLAVE,30,JILOTEPEC,093,CERRO DE LA GALLINA,2,12,3,9,2
VERACRUZ DE IGNACIO DE LA LLAVE,30,JILOTEPEC,093,COLONIA SAN MARTÍN,2,56,25,31,5
VERACRUZ DE IGNACIO DE LA LLAVE,30,JILOTEPEC,093,EL ESQUILÓN,1,12,7,5,1
VERACRUZ DE IGNACIO DE LA LLAVE,30,JILOTEPEC,093,EL PUEBLITO (GARBANZAL),3,137,62,75,13
VERACRUZ DE IGNACIO DE LA LLAVE,30,JILOTEPEC,093,JILOTEPEC,6,1115,576,539,70
VERACRUZ DE IGNACIO DE LA LLAVE,30,JILOTEPEC,093,LA CONCEPCIÓN,7,555,275,280,43
VERACRUZ DE IGNACIO DE LA LLAVE,30,JILOTEPEC,093,LAS LOMAS,2,93,49,44,7
VERACRUZ DE IGNACIO DE LA LLAVE,30,JILOTEPEC,093,LINDEROS,3,148,74,74,11
VERACRUZ DE IGNACIO DE LA LLAVE,30,JILOTEPEC,093,LOS EQUIMITES,2,32,24,8,4
VERACRUZ DE IGNACIO DE LA LLAVE,30,JILOTEPEC,093,PASO DE SAN JUAN,3,198,95,103,13
VERACRUZ DE IGNACIO DE LA LLAVE,30,JILOTEPEC,093,PIEDRA DE AGUA,3,122,57,65,12
VERACRUZ DE IGNACIO DE LA LLAVE,30,JILOTEPEC,093,VISTA HERMOSA PRIMERA MANZANA,5,332,172,160,31
VERACRUZ DE IGNACIO DE LA LLAVE,30,JILOTEPEC,093,VISTA HERMOSA SEGUNDA MANZANA,1,39,26,13,3
VERACRUZ DE IGNACIO DE LA LLAVE,30,JUAN RODRÍGUEZ CLARA,094,ANGOSTURA,4,201,98,103,11
VERACRUZ DE IGNACIO DE LA LLAVE,30,JUAN RODRÍGUEZ CLARA,094,ANTONIO M. QUIRASCO,2,15,9,6,2
VERACRUZ DE IGNACIO DE LA LLAVE,30,JUAN RODRÍGUEZ CLARA,094,CASAS VIEJAS,4,281,151,130,14
VERACRUZ DE IGNACIO DE LA LLAVE,30,JUAN RODRÍGUEZ CLARA,094,CERRO DEL INDIO (MATA VERDE),2,28,15,13,3
VERACRUZ DE IGNACIO DE LA LLAVE,30,JUAN RODRÍGUEZ CLARA,094,CINCO DE MAYO,2,26,14,12,2
VERACRUZ DE IGNACIO DE LA LLAVE,30,JUAN RODRÍGUEZ CLARA,094,COLONIA DOMÍNGUEZ,3,66,37,29,5
VERACRUZ DE IGNACIO DE LA LLAVE,30,JUAN RODRÍGUEZ CLARA,094,COLONIA VEINTE DE NOVIEMBRE (PANCHO VILLA),3,75,40,35,5
VERACRUZ DE IGNACIO DE LA LLAVE,30,JUAN RODRÍGUEZ CLARA,094,EL BLANCO,4,212,113,99,13
VERACRUZ DE IGNACIO DE LA LLAVE,30,JUAN RODRÍGUEZ CLARA,094,EL CAFETAL,2,36,17,19,3
VERACRUZ DE IGNACIO DE LA LLAVE,30,JUAN RODRÍGUEZ CLARA,094,EL CEDRO (RANCHO ALEGRE),2,23,15,8,2
VERACRUZ DE IGNACIO DE LA LLAVE,30,JUAN RODRÍGUEZ CLARA,094,EL JATILLO (EL HATILLO),1,12,4,8,1
VERACRUZ DE IGNACIO DE LA LLAVE,30,JUAN RODRÍGUEZ CLARA,094,EL MARQUESILLO,3,100,51,49,7
VERACRUZ DE IGNACIO DE LA LLAVE,30,JUAN RODRÍGUEZ CLARA,094,EL MIRADOR (EL CERRITO),1,7,2,5,1
VERACRUZ DE IGNACIO DE LA LLAVE,30,JUAN RODRÍGUEZ CLARA,094,EMILIANO ZAPATA,3,39,17,22,4
VERACRUZ DE IGNACIO DE LA LLAVE,30,JUAN RODRÍGUEZ CLARA,094,GLORIA DE CUAPA (CARTAGENA),2,11,5,6,2
VERACRUZ DE IGNACIO DE LA LLAVE,30,JUAN RODRÍGUEZ CLARA,094,GUADALUPE CASTRO MORENO,3,20,9,11,3
VERACRUZ DE IGNACIO DE LA LLAVE,30,JUAN RODRÍGUEZ CLARA,094,HUAYACANES,4,360,200,160,16
VERACRUZ DE IGNACIO DE LA LLAVE,30,JUAN RODRÍGUEZ CLARA,094,INDEPENDENCIA,2,32,18,14,2
VERACRUZ DE IGNACIO DE LA LLAVE,30,JUAN RODRÍGUEZ CLARA,094,JIMBA,3,73,36,37,7
VERACRUZ DE IGNACIO DE LA LLAVE,30,JUAN RODRÍGUEZ CLARA,094,JUAN RODRÍGUEZ CLARA,27,4657,2361,2296,272
VERACRUZ DE IGNACIO DE LA LLAVE,30,JUAN RODRÍGUEZ CLARA,094,LA CAÑADA,3,122,56,66,10
VERACRUZ DE IGNACIO DE LA LLAVE,30,JUAN RODRÍGUEZ CLARA,094,LA FLOREADORA (LA BODEGA),2,6,4,2,1
VERACRUZ DE IGNACIO DE LA LLAVE,30,JUAN RODRÍGUEZ CLARA,094,LA ISLETA,3,108,56,52,7
VERACRUZ DE IGNACIO DE LA LLAVE,30,JUAN RODRÍGUEZ CLARA,094,LA UNIÓN,4,134,55,79,11
VERACRUZ DE IGNACIO DE LA LLAVE,30,JUAN RODRÍGUEZ CLARA,094,LAS CANOAS,2,9,5,4,2
VERACRUZ DE IGNACIO DE LA LLAVE,30,JUAN RODRÍGUEZ CLARA,094,LOMA DE HUJUAPAN,3,60,27,33,4
VERACRUZ DE IGNACIO DE LA LLAVE,30,JUAN RODRÍGUEZ CLARA,094,LOMA DE LOS CHANGOS,2,13,6,7,2
VERACRUZ DE IGNACIO DE LA LLAVE,30,JUAN RODRÍGUEZ CLARA,094,LOS DOMÍNGUEZ,1,18,7,11,1
VERACRUZ DE IGNACIO DE LA LLAVE,30,JUAN RODRÍGUEZ CLARA,094,LOS TIGRES (SAN MARCOS),5,938,495,443,43
VERACRUZ DE IGNACIO DE LA LLAVE,30,JUAN RODRÍGUEZ CLARA,094,MATILLA DE CONEJO,1,16,8,8,1
VERACRUZ DE IGNACIO DE LA LLAVE,30,JUAN RODRÍGUEZ CLARA,094,MIGUEL HIDALGO,3,95,55,40,6
VERACRUZ DE IGNACIO DE LA LLAVE,30,JUAN RODRÍGUEZ CLARA,094,MONTE ROSA,3,81,31,50,4
VERACRUZ DE IGNACIO DE LA LLAVE,30,JUAN RODRÍGUEZ CLARA,094,NOPALAPAN,5,328,148,180,20
VERACRUZ DE IGNACIO DE LA LLAVE,30,JUAN RODRÍGUEZ CLARA,094,NUEVA ESPERANZA,3,72,31,41,6
VERACRUZ DE IGNACIO DE LA LLAVE,30,JUAN RODRÍGUEZ CLARA,094,NUEVO PASO NOVILLO (LIBERTAD Y PROGRESO),2,32,18,14,3
VERACRUZ DE IGNACIO DE LA LLAVE,30,JUAN RODRÍGUEZ CLARA,094,OJO DE AGUA,2,96,38,58,5
VERACRUZ DE IGNACIO DE LA LLAVE,30,JUAN RODRÍGUEZ CLARA,094,PALO MIGUEL,4,141,69,72,9
VERACRUZ DE IGNACIO DE LA LLAVE,30,JUAN RODRÍGUEZ CLARA,094,PASO DEL GANADO,3,100,56,44,6
VERACRUZ DE IGNACIO DE LA LLAVE,30,JUAN RODRÍGUEZ CLARA,094,PASO DEL GANADO (LA LOMA),2,27,16,11,2
VERACRUZ DE IGNACIO DE LA LLAVE,30,JUAN RODRÍGUEZ CLARA,094,SAN BENITO,2,54,34,20,3
VERACRUZ DE IGNACIO DE LA LLAVE,30,JUAN RODRÍGUEZ CLARA,094,SAN JOSÉ TULAPAN (SAN ISIDRO),2,27,10,17,2
VERACRUZ DE IGNACIO DE LA LLAVE,30,JUAN RODRÍGUEZ CLARA,094,SAN PEDRO DEL LLANO,3,30,19,11,5
VERACRUZ DE IGNACIO DE LA LLAVE,30,JUAN RODRÍGUEZ CLARA,094,SAN SEBASTIÁN,3,91,48,43,6
VERACRUZ DE IGNACIO DE LA LLAVE,30,JUAN RODRÍGUEZ CLARA,094,SANTA ROSA,2,47,15,32,3
VERACRUZ DE IGNACIO DE LA LLAVE,30,JUAN RODRÍGUEZ CLARA,094,VICENTE GUERRERO,1,9,6,3,1
VERACRUZ DE IGNACIO DE LA LLAVE,30,JUCHIQUE DE FERRER,095,ARROYO DE CHILARES,1,22,12,10,2
VERACRUZ DE IGNACIO DE LA LLAVE,30,JUCHIQUE DE FERRER,095,BUENA VISTA,1,6,4,2,1
VERACRUZ DE IGNACIO DE LA LLAVE,30,JUCHIQUE DE FERRER,095,BUENA VISTA (CERRO AMARILLO),2,13,3,10,2
VERACRUZ DE IGNACIO DE LA LLAVE,30,JUCHIQUE DE FERRER,095,CARRIZAL,3,60,27,33,7
VERACRUZ DE IGNACIO DE LA LLAVE,30,JUCHIQUE DE FERRER,095,CERRO DE TEPOZCALILLO,1,16,10,6,2
VERACRUZ DE IGNACIO DE LA LLAVE,30,JUCHIQUE DE FERRER,095,CERRO ESCUINGO,1,16,8,8,1
VERACRUZ DE IGNACIO DE LA LLAVE,30,JUCHIQUE DE FERRER,095,COLONIA FRANCISCO I. MADERO (LAS MESILLAS),2,25,13,12,2
VERACRUZ DE IGNACIO DE LA LLAVE,30,JUCHIQUE DE FERRER,095,COLONIA LIBRES NORTE,1,8,1,7,1
VERACRUZ DE IGNACIO DE LA LLAVE,30,JUCHIQUE DE FERRER,095,COLONIA LIBRES SUR (PALO BLANCO),1,97,54,43,17
VERACRUZ DE IGNACIO DE LA LLAVE,30,JUCHIQUE DE FERRER,095,CORRALITOS,1,10,4,6,1
VERACRUZ DE IGNACIO DE LA LLAVE,30,JUCHIQUE DE FERRER,095,DOS ARROYOS,4,186,109,77,13
VERACRUZ DE IGNACIO DE LA LLAVE,30,JUCHIQUE DE FERRER,095,EL ARENAL,2,37,21,16,3
VERACRUZ DE IGNACIO DE LA LLAVE,30,JUCHIQUE DE FERRER,095,EL CALABOZO,3,42,24,18,7
VERACRUZ DE IGNACIO DE LA LLAVE,30,JUCHIQUE DE FERRER,095,EL CARMEN,1,5,2,3,1
VERACRUZ DE IGNACIO DE LA LLAVE,30,JUCHIQUE DE FERRER,095,EL CHAPARRAL,4,196,101,95,14
VERACRUZ DE IGNACIO DE LA LLAVE,30,JUCHIQUE DE FERRER,095,EL MANGO,1,5,4,1,1
VERACRUZ DE IGNACIO DE LA LLAVE,30,JUCHIQUE DE FERRER,095,EL PENSAMIENTO,1,7,1,6,1
VERACRUZ DE IGNACIO DE LA LLAVE,30,JUCHIQUE DE FERRER,095,EL PORVENIR,1,10,4,6,1
VERACRUZ DE IGNACIO DE LA LLAVE,30,JUCHIQUE DE FERRER,095,EL RECREO,1,7,5,2,1
VERACRUZ DE IGNACIO DE LA LLAVE,30,JUCHIQUE DE FERRER,095,EL TACAHUITE,2,14,7,7,2
VERACRUZ DE IGNACIO DE LA LLAVE,30,JUCHIQUE DE FERRER,095,EL ZAPOTAL,1,2,1,1,1
VERACRUZ DE IGNACIO DE LA LLAVE,30,JUCHIQUE DE FERRER,095,JUCHIQUE DE FERRER,9,863,413,450,61
VERACRUZ DE IGNACIO DE LA LLAVE,30,JUCHIQUE DE FERRER,095,LA CODICIA,1,13,3,10,1
VERACRUZ DE IGNACIO DE LA LLAVE,30,JUCHIQUE DE FERRER,095,LA ESPERANZA,3,57,24,33,6
VERACRUZ DE IGNACIO DE LA LLAVE,30,JUCHIQUE DE FERRER,095,LA FILA,1,7,5,2,1
VERACRUZ DE IGNACIO DE LA LLAVE,30,JUCHIQUE DE FERRER,095,LA FRONTERA,2,12,6,6,2
VERACRUZ DE IGNACIO DE LA LLAVE,30,JUCHIQUE DE FERRER,095,LA GLORIA,1,10,6,4,1
VERACRUZ DE IGNACIO DE LA LLAVE,30,JUCHIQUE DE FERRER,095,LA PAGÜITA,2,8,6,2,1
VERACRUZ DE IGNACIO DE LA LLAVE,30,JUCHIQUE DE FERRER,095,LA SORPRESA,1,6,5,1,1
VERACRUZ DE IGNACIO DE LA LLAVE,30,JUCHIQUE DE FERRER,095,LAGUNA DE FARFÁN,4,173,86,87,14
VERACRUZ DE IGNACIO DE LA LLAVE,30,JUCHIQUE DE FERRER,095,LOMA ALTA,1,8,1,7,1
VERACRUZ DE IGNACIO DE LA LLAVE,30,JUCHIQUE DE FERRER,095,LOMA DE SAN NICOLÁS,2,27,11,16,2
VERACRUZ DE IGNACIO DE LA LLAVE,30,JUCHIQUE DE FERRER,095,MUNDO NUEVO,1,12,5,7,2
VERACRUZ DE IGNACIO DE LA LLAVE,30,JUCHIQUE DE FERRER,095,PLAN DE LA FLOR,4,120,60,60,10
VERACRUZ DE IGNACIO DE LA LLAVE,30,JUCHIQUE DE FERRER,095,PLAN DE LAS HAYAS,5,457,236,221,32
VERACRUZ DE IGNACIO DE LA LLAVE,30,JUCHIQUE DE FERRER,095,PORFIRIO DÍAZ (EL NARANJAL),5,81,39,42,9
VERACRUZ DE IGNACIO DE LA LLAVE,30,JUCHIQUE DE FERRER,095,RANCHO ALEGRE,1,8,5,3,1
VERACRUZ DE IGNACIO DE LA LLAVE,30,JUCHIQUE DE FERRER,095,RANCHO NAOLINCO (QUINTA HERMOSA),1,3,3,0,1
VERACRUZ DE IGNACIO DE LA LLAVE,30,JUCHIQUE DE FERRER,095,SAN ALFONSO,2,40,17,23,4
VERACRUZ DE IGNACIO DE LA LLAVE,30,JUCHIQUE DE FERRER,095,SANTA LUCÍA,1,13,9,4,2
VERACRUZ DE IGNACIO DE LA LLAVE,30,JUCHIQUE DE FERRER,095,SANTA ROSA NORTE,1,11,5,6,1
VERACRUZ DE IGNACIO DE LA LLAVE,30,JUCHIQUE DE FERRER,095,SANTA ROSA SUR,3,67,31,36,7
VERACRUZ DE IGNACIO DE LA LLAVE,30,JUCHIQUE DE FERRER,095,SANTIAGO XIHUITLÁN,5,183,83,100,14
VERACRUZ DE IGNACIO DE LA LLAVE,30,LANDERO Y COSS,096,BUENA VISTA,2,53,31,22,3
VERACRUZ DE IGNACIO DE LA LLAVE,30,LANDERO Y COSS,096,LANDERO Y COSS,4,223,112,111,14
VERACRUZ DE IGNACIO DE LA LLAVE,30,LERDO DE TEJADA,097,BAJADA DE LOS APOMPOS,1,4,3,1,1
VERACRUZ DE IGNACIO DE LA LLAVE,30,LERDO DE TEJADA,097,LA VÍA VIEJA,1,3,2,1,1
VERACRUZ DE IGNACIO DE LA LLAVE,30,LERDO DE TEJADA,097,LERDO DE TEJADA,35,3856,1930,1926,327
VERACRUZ DE IGNACIO DE LA LLAVE,30,LERDO DE TEJADA,097,SANTA TERESA,2,38,19,19,4
VERACRUZ DE IGNACIO DE LA LLAVE,30,MAGDALENA,098,CAPULTITLA,2,113,50,63,6
VERACRUZ DE IGNACIO DE LA LLAVE,30,MAGDALENA,098,CHICOMOCELOC,2,41,21,20,4
VERACRUZ DE IGNACIO DE LA LLAVE,30,MAGDALENA,098,HELICOTLA,2,240,128,112,13
VERACRUZ DE IGNACIO DE LA LLAVE,30,MAGDALENA,098,MAGDALENA,4,502,270,232,21
VERACRUZ DE IGNACIO DE LA LLAVE,30,MAGDALENA,098,TEPETZINGO,1,6,3,3,1
VERACRUZ DE IGNACIO DE LA LLAVE,30,MALTRATA,099,ADOLFO LÓPEZ MATEOS (LA LOMITA),2,21,8,13,2
VERACRUZ DE IGNACIO DE LA LLAVE,30,MALTRATA,099,AGUA CERCADA,1,15,8,7,1
VERACRUZ DE IGNACIO DE LA LLAVE,30,MALTRATA,099,CARLOS SALINAS DE GORTARI (LA ESTANCIA),2,51,24,27,4
VERACRUZ DE IGNACIO DE LA LLAVE,30,MALTRATA,099,CUMBRES DE MALTRATA,2,16,5,11,2
VERACRUZ DE IGNACIO DE LA LLAVE,30,MALTRATA,099,EL MIRADOR AGUA ROSA,3,138,65,73,8
VERACRUZ DE IGNACIO DE LA LLAVE,30,MALTRATA,099,GALINDO,2,8,2,6,1
VERACRUZ DE IGNACIO DE LA LLAVE,30,MALTRATA,099,GUADALUPE MAGUEYES,5,176,87,89,10
VERACRUZ DE IGNACIO DE LA LLAVE,30,MALTRATA,099,HERIBERTO JARA CORONA,2,42,17,25,2
VERACRUZ DE IGNACIO DE LA LLAVE,30,MALTRATA,099,LA BOTA,3,452,209,243,20
VERACRUZ DE IGNACIO DE LA LLAVE,30,MALTRATA,099,LA COBRANZA,2,5,3,2,1
VERACRUZ DE IGNACIO DE LA LLAVE,30,MALTRATA,099,LA ESTANCIA,3,57,32,25,5
VERACRUZ DE IGNACIO DE LA LLAVE,30,MALTRATA,099,MALTRATA,9,2623,1296,1327,123
VERACRUZ DE IGNACIO DE LA LLAVE,30,MALTRATA,099,RODOLFO LOZADA VALLEJO (PLAN DE SAN JOSÉ),2,47,24,23,3
VERACRUZ DE IGNACIO DE LA LLAVE,30,MALTRATA,099,RUEDA DE OCOTE,3,16,6,10,2
VERACRUZ DE IGNACIO DE LA LLAVE,30,MALTRATA,099,SAN JOSÉ SÚCHIL,4,475,238,237,22
VERACRUZ DE IGNACIO DE LA LLAVE,30,MALTRATA,099,ZACATIPAN,2,6,3,3,1
VERACRUZ DE IGNACIO DE LA LLAVE,30,MALTRATA,099,ZACATONAL,3,22,11,11,3
VERACRUZ DE IGNACIO DE LA LLAVE,30,MANLIO FABIO ALTAMIRANO,100,ALTA LUZ,3,53,28,25,4
VERACRUZ DE IGNACIO DE LA LLAVE,30,MANLIO FABIO ALTAMIRANO,100,BELISARIO DOMÍNGUEZ (LA BURRERA),3,97,43,54,8
VERACRUZ DE IGNACIO DE LA LLAVE,30,MANLIO FABIO ALTAMIRANO,100,BENITO JUÁREZ,2,24,10,14,3
VERACRUZ DE IGNACIO DE LA LLAVE,30,MANLIO FABIO ALTAMIRANO,100,EL BUZÓN,3,106,54,52,9
VERACRUZ DE IGNACIO DE LA LLAVE,30,MANLIO FABIO ALTAMIRANO,100,EL CEDRALITO,2,23,12,11,2
VERACRUZ DE IGNACIO DE LA LLAVE,30,MANLIO FABIO ALTAMIRANO,100,EL SAUCE,3,104,51,53,8
VERACRUZ DE IGNACIO DE LA LLAVE,30,MANLIO FABIO ALTAMIRANO,100,FRANCISCO J. MORENO,3,32,12,20,3
VERACRUZ DE IGNACIO DE LA LLAVE,30,MANLIO FABIO ALTAMIRANO,100,GUSTAVO SUÁREZ (SANTA ANA),1,9,2,7,1
VERACRUZ DE IGNACIO DE LA LLAVE,30,MANLIO FABIO ALTAMIRANO,100,LA CANTERA,3,37,23,14,4
VERACRUZ DE IGNACIO DE LA LLAVE,30,MANLIO FABIO ALTAMIRANO,100,LA ESPERANZA,1,17,6,11,1
VERACRUZ DE IGNACIO DE LA LLAVE,30,MANLIO FABIO ALTAMIRANO,100,LA FIRMEZA,3,55,26,29,6
VERACRUZ DE IGNACIO DE LA LLAVE,30,MANLIO FABIO ALTAMIRANO,100,LA FLORIDA,2,15,6,9,2
VERACRUZ DE IGNACIO DE LA LLAVE,30,MANLIO FABIO ALTAMIRANO,100,LA LIMA,1,11,5,6,1
VERACRUZ DE IGNACIO DE LA LLAVE,30,MANLIO FABIO ALTAMIRANO,100,LA POLVAREDA,1,7,4,3,1
VERACRUZ DE IGNACIO DE LA LLAVE,30,MANLIO FABIO ALTAMIRANO,100,LA VENTA,1,22,9,13,2
VERACRUZ DE IGNACIO DE LA LLAVE,30,MANLIO FABIO ALTAMIRANO,100,LOMA DE LOS CARMONA,4,288,137,151,17
VERACRUZ DE IGNACIO DE LA LLAVE,30,MANLIO FABIO ALTAMIRANO,100,LOMA DE PIEDRA,2,28,18,10,2
VERACRUZ DE IGNACIO DE LA LLAVE,30,MANLIO FABIO ALTAMIRANO,100,LOMA DE SANTA MARÍA,2,31,19,12,3
VERACRUZ DE IGNACIO DE LA LLAVE,30,MANLIO FABIO ALTAMIRANO,100,MANLIO FABIO ALTAMIRANO,8,1101,539,562,102
VERACRUZ DE IGNACIO DE LA LLAVE,30,MANLIO FABIO ALTAMIRANO,100,MATA LOMA,3,305,158,147,19
VERACRUZ DE IGNACIO DE LA LLAVE,30,MANLIO FABIO ALTAMIRANO,100,PASO HIGUERA (MIRADOR Y ANEXOS),2,29,12,17,3
VERACRUZ DE IGNACIO DE LA LLAVE,30,MANLIO FABIO ALTAMIRANO,100,PASO MORAL,1,14,7,7,1
VERACRUZ DE IGNACIO DE LA LLAVE,30,MANLIO FABIO ALTAMIRANO,100,PASO REAL,3,80,47,33,7
VERACRUZ DE IGNACIO DE LA LLAVE,30,MANLIO FABIO ALTAMIRANO,100,PASO SECO,2,31,12,19,3
VERACRUZ DE IGNACIO DE LA LLAVE,30,MANLIO FABIO ALTAMIRANO,100,PASO SOLÍS,2,89,44,45,4
VERACRUZ DE IGNACIO DE LA LLAVE,30,MANLIO FABIO ALTAMIRANO,100,PIEDRA PARADA,1,12,7,5,1
VERACRUZ DE IGNACIO DE LA LLAVE,30,MANLIO FABIO ALTAMIRANO,100,PLATAFORMA,1,19,6,13,2
VERACRUZ DE IGNACIO DE LA LLAVE,30,MANLIO FABIO ALTAMIRANO,100,PORTEZUELO,2,35,18,17,3
VERACRUZ DE IGNACIO DE LA LLAVE,30,MANLIO FABIO ALTAMIRANO,100,RANCHO NUEVO,3,93,38,55,7
VERACRUZ DE IGNACIO DE LA LLAVE,30,MANLIO FABIO ALTAMIRANO,100,SAN CENOBIO,3,81,44,37,7
VERACRUZ DE IGNACIO DE LA LLAVE,30,MANLIO FABIO ALTAMIRANO,100,SAN DIEGO,1,12,6,6,1
VERACRUZ DE IGNACIO DE LA LLAVE,30,MANLIO FABIO ALTAMIRANO,100,SAN JUAN DE ESTANCIA,1,12,5,7,1
VERACRUZ DE IGNACIO DE LA LLAVE,30,MANLIO FABIO ALTAMIRANO,100,SAN MARTÍN DEL YAGUAL,1,11,1,10,1
VERACRUZ DE IGNACIO DE LA LLAVE,30,MANLIO FABIO ALTAMIRANO,100,TENENEXPAN,4,372,190,182,23
VERACRUZ DE IGNACIO DE LA LLAVE,30,MANLIO FABIO ALTAMIRANO,100,ÚRSULO GALVÁN,1,12,3,9,1
VERACRUZ DE IGNACIO DE LA LLAVE,30,MANLIO FABIO ALTAMIRANO,100,VILLA DEL RÍO,1,20,10,10,2
VERACRUZ DE IGNACIO DE LA LLAVE,30,MARIANO ESCOBEDO,101,AGUA ESCONDIDA,2,16,8,8,2
VERACRUZ DE IGNACIO DE LA LLAVE,30,MARIANO ESCOBEDO,101,BUENOS AIRES,1,12,7,5,1
VERACRUZ DE IGNACIO DE LA LLAVE,30,MARIANO ESCOBEDO,101,CARBONERA,3,21,7,14,3
VERACRUZ DE IGNACIO DE LA LLAVE,30,MARIANO ESCOBEDO,101,CHICOLA,4,458,212,246,28
VERACRUZ DE IGNACIO DE LA LLAVE,30,MARIANO ESCOBEDO,101,COLONIA EJIDAL,3,318,159,159,19
VERACRUZ DE IGNACIO DE LA LLAVE,30,MARIANO ESCOBEDO,101,COLONIA LA LIBERTAD,1,13,5,8,1
VERACRUZ DE IGNACIO DE LA LLAVE,30,MARIANO ESCOBEDO,101,EL ASOLEADERO,2,43,19,24,3
VERACRUZ DE IGNACIO DE LA LLAVE,30,MARIANO ESCOBEDO,101,EL MANZANO (CHILAPEÑO),2,65,32,33,3
VERACRUZ DE IGNACIO DE LA LLAVE,30,MARIANO ESCOBEDO,101,EL MIRADOR,3,107,56,51,10
VERACRUZ DE IGNACIO DE LA LLAVE,30,MARIANO ESCOBEDO,101,EL PROGRESO,1,12,6,6,1
VERACRUZ DE IGNACIO DE LA LLAVE,30,MARIANO ESCOBEDO,101,EL RECREO,1,17,8,9,2
VERACRUZ DE IGNACIO DE LA LLAVE,30,MARIANO ESCOBEDO,101,EL TELAR,2,15,8,7,2
VERACRUZ DE IGNACIO DE LA LLAVE,30,MARIANO ESCOBEDO,101,EL TUZAL,2,37,18,19,3
VERACRUZ DE IGNACIO DE LA LLAVE,30,MARIANO ESCOBEDO,101,FRIJOLILLO,4,289,148,141,16
VERACRUZ DE IGNACIO DE LA LLAVE,30,MARIANO ESCOBEDO,101,LA CIENEGUILLA,3,71,29,42,4
VERACRUZ DE IGNACIO DE LA LLAVE,30,MARIANO ESCOBEDO,101,LA LOMA,2,112,49,63,6
VERACRUZ DE IGNACIO DE LA LLAVE,30,MARIANO ESCOBEDO,101,LAS CAMELIAS,2,41,17,24,3
VERACRUZ DE IGNACIO DE LA LLAVE,30,MARIANO ESCOBEDO,101,LOMA GRANDE,4,677,358,319,29
VERACRUZ DE IGNACIO DE LA LLAVE,30,MARIANO ESCOBEDO,101,LOS NARANJOS,2,105,58,47,6
VERACRUZ DE IGNACIO DE LA LLAVE,30,MARIANO ESCOBEDO,101,MARIANO ESCOBEDO,12,1554,739,815,101
VERACRUZ DE IGNACIO DE LA LLAVE,30,MARIANO ESCOBEDO,101,MONTE GRANDE,2,81,42,39,5
VERACRUZ DE IGNACIO DE LA LLAVE,30,MARIANO ESCOBEDO,101,OCOXOTLA,3,186,98,88,11
VERACRUZ DE IGNACIO DE LA LLAVE,30,MARIANO ESCOBEDO,101,OCOXOTLILLA,2,16,5,11,2
VERACRUZ DE IGNACIO DE LA LLAVE,30,MARIANO ESCOBEDO,101,PALMIRA,6,539,258,281,42
VERACRUZ DE IGNACIO DE LA LLAVE,30,MARIANO ESCOBEDO,101,PASO GANADO,1,17,10,7,1
VERACRUZ DE IGNACIO DE LA LLAVE,30,MARIANO ESCOBEDO,101,RINCÓN DE CHICOLA,1,41,22,19,3
VERACRUZ DE IGNACIO DE LA LLAVE,30,MARIANO ESCOBEDO,101,SAN ANTONIO (RANCHO NUEVO),3,50,17,33,4
VERACRUZ DE IGNACIO DE LA LLAVE,30,MARIANO ESCOBEDO,101,SAN BALTAZAR,4,172,83,89,10
VERACRUZ DE IGNACIO DE LA LLAVE,30,MARIANO ESCOBEDO,101,SAN ISIDRO EL BERRO,3,378,193,185,17
VERACRUZ DE IGNACIO DE LA LLAVE,30,MARIANO ESCOBEDO,101,SAN JOSÉ PILANCÓN,2,67,28,39,3
VERACRUZ DE IGNACIO DE LA LLAVE,30,MARIANO ESCOBEDO,101,TEMAXCALTITLA,3,82,34,48,5
VERACRUZ DE IGNACIO DE LA LLAVE,30,MARIANO ESCOBEDO,101,TEPOXTLÁN (ALPESUR) [GRANJA],1,37,17,20,3
VERACRUZ DE IGNACIO DE LA LLAVE,30,MARIANO ESCOBEDO,101,TEXMALACA,3,173,87,86,11
VERACRUZ DE IGNACIO DE LA LLAVE,30,MARIANO ESCOBEDO,101,TEXMOLA,3,429,218,211,21
VERACRUZ DE IGNACIO DE LA LLAVE,30,MARIANO ESCOBEDO,101,VILLAHERMOSA,2,49,33,16,3
VERACRUZ DE IGNACIO DE LA LLAVE,30,MARIANO ESCOBEDO,101,VISTA HERMOSA,2,75,43,32,3
VERACRUZ DE IGNACIO DE LA LLAVE,30,MARIANO ESCOBEDO,101,VUELTA GRANDE,1,12,7,5,1
VERACRUZ DE IGNACIO DE LA LLAVE,30,MARIANO ESCOBEDO,101,XIQUILA,3,135,56,79,8
VERACRUZ DE IGNACIO DE LA LLAVE,30,MARTÍNEZ DE LA TORRE,102,ARROYO BLANCO,3,159,72,87,10
VERACRUZ DE IGNACIO DE LA LLAVE,30,MARTÍNEZ DE LA TORRE,102,ARROYO DE FIERRO,3,83,42,41,6
VERACRUZ DE IGNACIO DE LA LLAVE,30,MARTÍNEZ DE LA TORRE,102,ARROYO DEL POTRERO,3,273,141,132,15
VERACRUZ DE IGNACIO DE LA LLAVE,30,MARTÍNEZ DE LA TORRE,102,ARROYO NEGRO,3,73,32,41,7
VERACRUZ DE IGNACIO DE LA LLAVE,30,MARTÍNEZ DE LA TORRE,102,BALSAS DE AGUA (POZOS DE ORO),2,63,34,29,4
VERACRUZ DE IGNACIO DE LA LLAVE,30,MARTÍNEZ DE LA TORRE,102,CARTAGO,2,934,428,506,34
VERACRUZ DE IGNACIO DE LA LLAVE,30,MARTÍNEZ DE LA TORRE,102,EL DIAMANTE,2,72,35,37,6
VERACRUZ DE IGNACIO DE LA LLAVE,30,MARTÍNEZ DE LA TORRE,102,EL MIRADOR,1,17,7,10,2
VERACRUZ DE IGNACIO DE LA LLAVE,30,MARTÍNEZ DE LA TORRE,102,EL PROGRESO,3,183,95,88,12
VERACRUZ DE IGNACIO DE LA LLAVE,30,MARTÍNEZ DE LA TORRE,102,EL REFUGIO,2,51,18,33,4
VERACRUZ DE IGNACIO DE LA LLAVE,30,MARTÍNEZ DE LA TORRE,102,FELIPE CARRILLO PUERTO,7,749,353,396,52
VERACRUZ DE IGNACIO DE LA LLAVE,30,MARTÍNEZ DE LA TORRE,102,FLAMENCOS,2,63,31,32,5
VERACRUZ DE IGNACIO DE LA LLAVE,30,MARTÍNEZ DE LA TORRE,102,GRACIANO SÁNCHEZ,2,40,18,22,3
VERACRUZ DE IGNACIO DE LA LLAVE,30,MARTÍNEZ DE LA TORRE,102,HUIPILTEPEC,4,363,184,179,24
VERACRUZ DE IGNACIO DE LA LLAVE,30,MARTÍNEZ DE LA TORRE,102,INDEPENDENCIA,17,3284,1658,1626,165
VERACRUZ DE IGNACIO DE LA LLAVE,30,MARTÍNEZ DE LA TORRE,102,JOSÉ MARÍA MORELOS Y PAVÓN,3,70,31,39,5
VERACRUZ DE IGNACIO DE LA LLAVE,30,MARTÍNEZ DE LA TORRE,102,LA COLMENA,3,92,38,54,8
VERACRUZ DE IGNACIO DE LA LLAVE,30,MARTÍNEZ DE LA TORRE,102,LA PALMA,4,362,193,169,19
VERACRUZ DE IGNACIO DE LA LLAVE,30,MARTÍNEZ DE LA TORRE,102,LA PIEDRILLA,4,307,128,179,20
VERACRUZ DE IGNACIO DE LA LLAVE,30,MARTÍNEZ DE LA TORRE,102,LA POZA,2,22,11,11,3
VERACRUZ DE IGNACIO DE LA LLAVE,30,MARTÍNEZ DE LA TORRE,102,LA UNIÓN PASO LARGO,2,173,92,81,9
VERACRUZ DE IGNACIO DE LA LLAVE,30,MARTÍNEZ DE LA TORRE,102,LAS CAÑADAS MARTÍNEZ,3,47,23,24,6
VERACRUZ DE IGNACIO DE LA LLAVE,30,MARTÍNEZ DE LA TORRE,102,LOMA DE LAS FLORES,3,63,37,26,6
VERACRUZ DE IGNACIO DE LA LLAVE,30,MARTÍNEZ DE LA TORRE,102,MANANTIALES,2,87,39,48,5
VERACRUZ DE IGNACIO DE LA LLAVE,30,MARTÍNEZ DE LA TORRE,102,MARÍA DE LA TORRE,3,442,212,230,19
VERACRUZ DE IGNACIO DE LA LLAVE,30,MARTÍNEZ DE LA TORRE,102,MARTÍNEZ DE LA TORRE,107,15183,7754,7429,1158
VERACRUZ DE IGNACIO DE LA LLAVE,30,MARTÍNEZ DE LA TORRE,102,NUEVA ITALIA,2,33,8,25,2
VERACRUZ DE IGNACIO DE LA LLAVE,30,MARTÍNEZ DE LA TORRE,102,NUEVA SURIANA,4,65,28,37,5
VERACRUZ DE IGNACIO DE LA LLAVE,30,MARTÍNEZ DE LA TORRE,102,PLAN DE LIMÓN,3,102,54,48,10
VERACRUZ DE IGNACIO DE LA LLAVE,30,MARTÍNEZ DE LA TORRE,102,PUEBLO VIEJO DOS,2,79,47,32,4
VERACRUZ DE IGNACIO DE LA LLAVE,30,MARTÍNEZ DE LA TORRE,102,PUEBLO VIEJO UNO,3,115,51,64,9
VERACRUZ DE IGNACIO DE LA LLAVE,30,MARTÍNEZ DE LA TORRE,102,SALVADOR DÍAZ MIRÓN,3,209,99,110,12
VERACRUZ DE IGNACIO DE LA LLAVE,30,MARTÍNEZ DE LA TORRE,102,TEPETATE,1,25,14,11,2
VERACRUZ DE IGNACIO DE LA LLAVE,30,MARTÍNEZ DE LA TORRE,102,TIERRA BLANCA,1,6,5,1,1
VERACRUZ DE IGNACIO DE LA LLAVE,30,MARTÍNEZ DE LA TORRE,102,VEGA REDONDA,2,184,87,97,12
VERACRUZ DE IGNACIO DE LA LLAVE,30,MARTÍNEZ DE LA TORRE,102,ZAPOTE BUENO,3,51,25,26,6
VERACRUZ DE IGNACIO DE LA LLAVE,30,MECATLÁN,103,AGUA AZUL,3,26,5,21,3
VERACRUZ DE IGNACIO DE LA LLAVE,30,MECATLÁN,103,CUHUIXANATH,4,131,69,62,9
VERACRUZ DE IGNACIO DE LA LLAVE,30,MECATLÁN,103,LA CEIBA,2,36,16,20,3
VERACRUZ DE IGNACIO DE LA LLAVE,30,MECATLÁN,103,LA CRUZ,3,155,80,75,11
VERACRUZ DE IGNACIO DE LA LLAVE,30,MECATLÁN,103,LA ESCALERA,3,120,55,65,7
VERACRUZ DE IGNACIO DE LA LLAVE,30,MECATLÁN,103,LAS FLORES,3,133,66,67,8
VERACRUZ DE IGNACIO DE LA LLAVE,30,MECATLÁN,103,MANANTIALES,2,106,55,51,6
VERACRUZ DE IGNACIO DE LA LLAVE,30,MECATLÁN,103,MECATLÁN,6,1500,747,753,76
VERACRUZ DE IGNACIO DE LA LLAVE,30,MECATLÁN,103,NARANJALES,3,86,42,44,5
VERACRUZ DE IGNACIO DE LA LLAVE,30,MECATLÁN,103,PUXTLA,3,77,35,42,4
VERACRUZ DE IGNACIO DE LA LLAVE,30,MECATLÁN,103,RANCHO ALEGRE,5,275,126,149,17
VERACRUZ DE IGNACIO DE LA LLAVE,30,MECATLÁN,103,RICARDO FLORES MAGÓN,4,443,202,241,24
VERACRUZ DE IGNACIO DE LA LLAVE,30,MECAYAPAN,104,ARROYO TEXIZAPAN,2,29,13,16,2
VERACRUZ DE IGNACIO DE LA LLAVE,30,MECAYAPAN,104,CERRO DE LA PALMA,3,166,74,92,9
VERACRUZ DE IGNACIO DE LA LLAVE,30,MECAYAPAN,104,EL NARANJO,2,87,47,40,5
VERACRUZ DE IGNACIO DE LA LLAVE,30,MECAYAPAN,104,EL PARAÍSO (SAN FRANCISCO),3,26,10,16,3
VERACRUZ DE IGNACIO DE LA LLAVE,30,MECAYAPAN,104,EL RUBÍ,1,11,7,4,1
VERACRUZ DE IGNACIO DE LA LLAVE,30,MECAYAPAN,104,ENCINO AMARILLO,3,127,54,73,10
VERACRUZ DE IGNACIO DE LA LLAVE,30,MECAYAPAN,104,HUAZUNTLÁN,8,729,412,317,50
VERACRUZ DE IGNACIO DE LA LLAVE,30,MECAYAPAN,104,IXHUAPAN,7,422,214,208,30
VERACRUZ DE IGNACIO DE LA LLAVE,30,MECAYAPAN,104,LA NUEVA ESPERANZA,2,14,8,6,2
VERACRUZ DE IGNACIO DE LA LLAVE,30,MECAYAPAN,104,LA PERLA DEL GOLFO,4,94,37,57,7
VERACRUZ DE IGNACIO DE LA LLAVE,30,MECAYAPAN,104,LOS ARRECIFES,3,150,80,70,9
VERACRUZ DE IGNACIO DE LA LLAVE,30,MECAYAPAN,104,MECAYAPAN,10,1331,648,683,72
VERACRUZ DE IGNACIO DE LA LLAVE,30,MECAYAPAN,104,PLAN AGRARIO,2,121,61,60,8
VERACRUZ DE IGNACIO DE LA LLAVE,30,MECAYAPAN,104,SAN ANDRÉS CHAMILPA,3,135,68,67,9
VERACRUZ DE IGNACIO DE LA LLAVE,30,MECAYAPAN,104,TONALAPA,3,201,88,113,18
VERACRUZ DE IGNACIO DE LA LLAVE,30,MECAYAPAN,104,VICENTE GUERRERO,3,28,13,15,2
VERACRUZ DE IGNACIO DE LA LLAVE,30,MEDELLÍN DE BRAVO,105,ARROYO DE CAÑA,1,16,8,8,2
VERACRUZ DE IGNACIO DE LA LLAVE,30,MEDELLÍN DE BRAVO,105,CEDRAL,3,79,41,38,8
VERACRUZ DE IGNACIO DE LA LLAVE,30,MEDELLÍN DE BRAVO,105,DOS BOCAS [TERMOELÉCTRICA],2,18,11,7,2
VERACRUZ DE IGNACIO DE LA LLAVE,30,MEDELLÍN DE BRAVO,105,EL COPITAL,2,57,32,25,3
VERACRUZ DE IGNACIO DE LA LLAVE,30,MEDELLÍN DE BRAVO,105,EL DOCE (RANCHO NUEVO),2,26,13,13,3
VERACRUZ DE IGNACIO DE LA LLAVE,30,MEDELLÍN DE BRAVO,105,EL GUASIMAL,1,27,12,15,2
VERACRUZ DE IGNACIO DE LA LLAVE,30,MEDELLÍN DE BRAVO,105,EL INFIERNILLO,2,21,12,9,2
VERACRUZ DE IGNACIO DE LA LLAVE,30,MEDELLÍN DE BRAVO,105,EL MANGAL,2,115,54,61,10
VERACRUZ DE IGNACIO DE LA LLAVE,30,MEDELLÍN DE BRAVO,105,EL TEJAR,15,2940,1426,1514,153
VERACRUZ DE IGNACIO DE LA LLAVE,30,MEDELLÍN DE BRAVO,105,FRACCIONAMIENTO ARBOLEDAS DE SAN MIGUEL,3,332,177,155,21
VERACRUZ DE IGNACIO DE LA LLAVE,30,MEDELLÍN DE BRAVO,105,FRACCIONAMIENTO ARBOLEDAS SAN RAMÓN,3,728,346,382,31
VERACRUZ DE IGNACIO DE LA LLAVE,30,MEDELLÍN DE BRAVO,105,FRACCIONAMIENTO PUENTE MORENO,10,2925,1477,1448,147
VERACRUZ DE IGNACIO DE LA LLAVE,30,MEDELLÍN DE BRAVO,105,HERÓN PROAL [COLONIA CAMPESTRE],1,31,20,11,3
VERACRUZ DE IGNACIO DE LA LLAVE,30,MEDELLÍN DE BRAVO,105,IXCOALCO,3,52,29,23,6
VERACRUZ DE IGNACIO DE LA LLAVE,30,MEDELLÍN DE BRAVO,105,JUAN DE ALFARO,1,14,6,8,1
VERACRUZ DE IGNACIO DE LA LLAVE,30,MEDELLÍN DE BRAVO,105,LA BÁSCULA (LA UNIÓN),1,29,13,16,2
VERACRUZ DE IGNACIO DE LA LLAVE,30,MEDELLÍN DE BRAVO,105,LA BOCANA (DOS BOCAS),6,844,427,417,64
VERACRUZ DE IGNACIO DE LA LLAVE,30,MEDELLÍN DE BRAVO,105,LA CANDELARIA,2,65,23,42,4
VERACRUZ DE IGNACIO DE LA LLAVE,30,MEDELLÍN DE BRAVO,105,LA ESPERANZA,1,15,8,7,2
VERACRUZ DE IGNACIO DE LA LLAVE,30,MEDELLÍN DE BRAVO,105,LA GLORIA,2,47,26,21,3
VERACRUZ DE IGNACIO DE LA LLAVE,30,MEDELLÍN DE BRAVO,105,LA LAGUNA Y MONTE DEL CASTILLO,3,307,147,160,15
VERACRUZ DE IGNACIO DE LA LLAVE,30,MEDELLÍN DE BRAVO,105,LAS BALSAS,1,11,7,4,1
VERACRUZ DE IGNACIO DE LA LLAVE,30,MEDELLÍN DE BRAVO,105,LOMAS DEL PORVENIR,2,29,16,13,2
VERACRUZ DE IGNACIO DE LA LLAVE,30,MEDELLÍN DE BRAVO,105,LOS ROBLES,6,642,341,301,41
VERACRUZ DE IGNACIO DE LA LLAVE,30,MEDELLÍN DE BRAVO,105,MATA ORTIZ,2,26,13,13,2
VERACRUZ DE IGNACIO DE LA LLAVE,30,MEDELLÍN DE BRAVO,105,MEDELLÍN,16,1538,743,795,101
VERACRUZ DE IGNACIO DE LA LLAVE,30,MEDELLÍN DE BRAVO,105,MORALILLO,2,32,19,13,2
VERACRUZ DE IGNACIO DE LA LLAVE,30,MEDELLÍN DE BRAVO,105,MOZAMBIQUE,3,85,46,39,8
VERACRUZ DE IGNACIO DE LA LLAVE,30,MEDELLÍN DE BRAVO,105,PALMIRA,2,34,17,17,3
VERACRUZ DE IGNACIO DE LA LLAVE,30,MEDELLÍN DE BRAVO,105,PASO CHOCOLATE,1,23,11,12,1
VERACRUZ DE IGNACIO DE LA LLAVE,30,MEDELLÍN DE BRAVO,105,PASO COLORADO,2,79,41,38,5
VERACRUZ DE IGNACIO DE LA LLAVE,30,MEDELLÍN DE BRAVO,105,PASO DE LOS ARRIEROS,2,34,16,18,3
VERACRUZ DE IGNACIO DE LA LLAVE,30,MEDELLÍN DE BRAVO,105,PASO DEL TORO,10,1358,688,670,80
VERACRUZ DE IGNACIO DE LA LLAVE,30,MEDELLÍN DE BRAVO,105,PLAYA DE VACAS,2,261,119,142,12
VERACRUZ DE IGNACIO DE LA LLAVE,30,MEDELLÍN DE BRAVO,105,PLAZA DE TOROS,1,17,6,11,1
VERACRUZ DE IGNACIO DE LA LLAVE,30,MEDELLÍN DE BRAVO,105,PRIMERO DE LA PALMA,2,89,28,61,5
VERACRUZ DE IGNACIO DE LA LLAVE,30,MEDELLÍN DE BRAVO,105,RANCHO DEL PADRE,3,79,33,46,5
VERACRUZ DE IGNACIO DE LA LLAVE,30,MEDELLÍN DE BRAVO,105,RINCÓN DE PÉREZ,2,66,38,28,4
VERACRUZ DE IGNACIO DE LA LLAVE,30,MEDELLÍN DE BRAVO,105,SAN FRANCISCO,1,12,7,5,1
VERACRUZ DE IGNACIO DE LA LLAVE,30,MEDELLÍN DE BRAVO,105,SAN MIGUEL,2,58,24,34,3
VERACRUZ DE IGNACIO DE LA LLAVE,30,MEDELLÍN DE BRAVO,105,SANTA TERESA [AGRÍCOLA TROPICAL DEL GOLFO],1,58,29,29,5
VERACRUZ DE IGNACIO DE LA LLAVE,30,MIAHUATLÁN,106,BARTOLO GARCÍA,1,17,9,8,1
VERACRUZ DE IGNACIO DE LA LLAVE,30,MIAHUATLÁN,106,BELLA UNIÓN,1,16,8,8,1
VERACRUZ DE IGNACIO DE LA LLAVE,30,MIAHUATLÁN,106,CAROLINO ANAYA,1,17,9,8,1
VERACRUZ DE IGNACIO DE LA LLAVE,30,MIAHUATLÁN,106,CUMBRE DE JONOTAL,2,52,21,31,4
VERACRUZ DE IGNACIO DE LA LLAVE,30,MIAHUATLÁN,106,DOS JACALES,2,67,36,31,5
VERACRUZ DE IGNACIO DE LA LLAVE,30,MIAHUATLÁN,106,EL MIRADOR,2,35,15,20,4
VERACRUZ DE IGNACIO DE LA LLAVE,30,MIAHUATLÁN,106,MIAHUATLÁN,5,876,427,449,44
VERACRUZ DE IGNACIO DE LA LLAVE,30,MIAHUATLÁN,106,RANCHO ALEGRE (LOS MÉNDEZ),1,5,3,2,1
VERACRUZ DE IGNACIO DE LA LLAVE,30,LAS MINAS,107,CARBONERAS,1,1,0,1,1
VERACRUZ DE IGNACIO DE LA LLAVE,30,LAS MINAS,107,EL PIMIENTO,3,39,21,18,4
VERACRUZ DE IGNACIO DE LA LLAVE,30,LAS MINAS,107,HUAPALA,4,60,29,31,6
VERACRUZ DE IGNACIO DE LA LLAVE,30,LAS MINAS,107,LANDACO,3,93,50,43,6
VERACRUZ DE IGNACIO DE LA LLAVE,30,LAS MINAS,107,LAS MINAS,4,118,53,65,9
VERACRUZ DE IGNACIO DE LA LLAVE,30,LAS MINAS,107,LAS MINAS [PLANTA HIDROELÉCTRICA],1,11,7,4,1
VERACRUZ DE IGNACIO DE LA LLAVE,30,LAS MINAS,107,MOLINILLO,3,79,44,35,6
VERACRUZ DE IGNACIO DE LA LLAVE,30,LAS MINAS,107,PUEBLO NUEVO,1,7,4,3,1
VERACRUZ DE IGNACIO DE LA LLAVE,30,LAS MINAS,107,QUIAHUIXCUAUTLA,5,56,27,29,6
VERACRUZ DE IGNACIO DE LA LLAVE,30,LAS MINAS,107,RINCONADA,3,110,60,50,6
VERACRUZ DE IGNACIO DE LA LLAVE,30,LAS MINAS,107,ROMERILLOS,2,21,8,13,2
VERACRUZ DE IGNACIO DE LA LLAVE,30,LAS MINAS,107,ZOMELAHUACAN,4,98,47,51,9
VERACRUZ DE IGNACIO DE LA LLAVE,30,MINATITLÁN,108,ADALBERTO TEJEDA,6,336,139,197,17
VERACRUZ DE IGNACIO DE LA LLAVE,30,MINATITLÁN,108,ADALBERTO TEJEDA (SECCIÓN CINCO),2,41,20,21,2
VERACRUZ DE IGNACIO DE LA LLAVE,30,MINATITLÁN,108,ADALBERTO TEJEDA (SECCIÓN CUATRO),2,31,14,17,2
VERACRUZ DE IGNACIO DE LA LLAVE,30,MINATITLÁN,108,ADALBERTO TEJEDA (SECCIÓN TRES),2,37,21,16,2
VERACRUZ DE IGNACIO DE LA LLAVE,30,MINATITLÁN,108,ADALBERTO TEJEDA [SECCIÓN DOS],2,13,7,6,2
VERACRUZ DE IGNACIO DE LA LLAVE,30,MINATITLÁN,108,ADOLFO LÓPEZ MATEOS,3,48,24,24,3
VERACRUZ DE IGNACIO DE LA LLAVE,30,MINATITLÁN,108,AGUA FRÍA,2,23,7,16,2
VERACRUZ DE IGNACIO DE LA LLAVE,30,MINATITLÁN,108,ALTO DE UXPANAPA,1,10,3,7,1
VERACRUZ DE IGNACIO DE LA LLAVE,30,MINATITLÁN,108,AMPLIACIÓN EL DEPÓSITO,2,24,13,11,2
VERACRUZ DE IGNACIO DE LA LLAVE,30,MINATITLÁN,108,ANTIGUA UXPANA,1,8,3,5,1
VERACRUZ DE IGNACIO DE LA LLAVE,30,MINATITLÁN,108,ANTONIO PLAZA,1,10,2,8,1
VERACRUZ DE IGNACIO DE LA LLAVE,30,MINATITLÁN,108,AQUILES SERDÁN (FILOSOLA),2,57,27,30,4
VERACRUZ DE IGNACIO DE LA LLAVE,30,MINATITLÁN,108,ARROYO CINTA,2,14,5,9,3
VERACRUZ DE IGNACIO DE LA LLAVE,30,MINATITLÁN,108,BENITO JUÁREZ,3,44,20,24,5
VERACRUZ DE IGNACIO DE LA LLAVE,30,MINATITLÁN,108,BENITO JUÁREZ (COCUITE),2,30,14,16,2
VERACRUZ DE IGNACIO DE LA LLAVE,30,MINATITLÁN,108,BOCA DE ORO,2,19,7,12,2
VERACRUZ DE IGNACIO DE LA LLAVE,30,MINATITLÁN,108,BOCA DE UXPANAPA,2,36,22,14,4
VERACRUZ DE IGNACIO DE LA LLAVE,30,MINATITLÁN,108,BUENA VISTA,2,16,4,12,2
VERACRUZ DE IGNACIO DE LA LLAVE,30,MINATITLÁN,108,BUENAVISTA DE JUÁREZ,3,91,39,52,7
VERACRUZ DE IGNACIO DE LA LLAVE,30,MINATITLÁN,108,CADETE AGUSTÍN MELGAR,1,25,11,14,1
VERACRUZ DE IGNACIO DE LA LLAVE,30,MINATITLÁN,108,CAFETAL,2,18,12,6,3
VERACRUZ DE IGNACIO DE LA LLAVE,30,MINATITLÁN,108,CAHUAPAN,3,48,24,24,5
VERACRUZ DE IGNACIO DE LA LLAVE,30,MINATITLÁN,108,CÁNDIDO AGUILAR,2,54,28,26,4
VERACRUZ DE IGNACIO DE LA LLAVE,30,MINATITLÁN,108,CAPOACAN,4,272,128,144,25
VERACRUZ DE IGNACIO DE LA LLAVE,30,MINATITLÁN,108,CAROLINO ANAYA RAMÍREZ,3,142,72,70,6
VERACRUZ DE IGNACIO DE LA LLAVE,30,MINATITLÁN,108,CARRIZAL CINCO DE FEBRERO,4,212,102,110,10
VERACRUZ DE IGNACIO DE LA LLAVE,30,MINATITLÁN,108,CEIBA BONITA,4,90,47,43,8
VERACRUZ DE IGNACIO DE LA LLAVE,30,MINATITLÁN,108,CHANCARRAL,2,7,1,6,1
VERACRUZ DE IGNACIO DE LA LLAVE,30,MINATITLÁN,108,CHICHIGAPA,5,174,86,88,12
VERACRUZ DE IGNACIO DE LA LLAVE,30,MINATITLÁN,108,CHICHONAL NOPALAPA,3,61,33,28,5
VERACRUZ DE IGNACIO DE LA LLAVE,30,MINATITLÁN,108,COACHAPA,1,5,3,2,1
VERACRUZ DE IGNACIO DE LA LLAVE,30,MINATITLÁN,108,CRUCERO ARROYO DE CHICHIGAPAN,2,20,8,12,2
VERACRUZ DE IGNACIO DE LA LLAVE,30,MINATITLÁN,108,EJIDO BUENAVISTA NOPALAPA,1,62,35,27,4
VERACRUZ DE IGNACIO DE LA LLAVE,30,MINATITLÁN,108,EJIDO RODRÍGUEZ,3,30,17,13,2
VERACRUZ DE IGNACIO DE LA LLAVE,30,MINATITLÁN,108,EL CEDRAL,2,55,29,26,4
VERACRUZ DE IGNACIO DE LA LLAVE,30,MINATITLÁN,108,EL CHAMIZAL,1,19,9,10,1
VERACRUZ DE IGNACIO DE LA LLAVE,30,MINATITLÁN,108,EL CHIFLIDO,3,76,39,37,5
VERACRUZ DE IGNACIO DE LA LLAVE,30,MINATITLÁN,108,EL DEPÓSITO,3,89,49,40,7
VERACRUZ DE IGNACIO DE LA LLAVE,30,MINATITLÁN,108,EL DIAMANTE,3,85,43,42,6
VERACRUZ DE IGNACIO DE LA LLAVE,30,MINATITLÁN,108,EL ENCANTO,2,20,9,11,2
VERACRUZ DE IGNACIO DE LA LLAVE,30,MINATITLÁN,108,EL JAGÜEY,9,637,303,334,40
VERACRUZ DE IGNACIO DE LA LLAVE,30,MINATITLÁN,108,EL JIMBAL,3,134,78,56,8
VERACRUZ DE IGNACIO DE LA LLAVE,30,MINATITLÁN,108,EL METATE,2,11,6,5,2
VERACRUZ DE IGNACIO DE LA LLAVE,30,MINATITLÁN,108,EL MONAL,3,29,12,17,3
VERACRUZ DE IGNACIO DE LA LLAVE,30,MINATITLÁN,108,EL PROGRESO,2,36,17,19,3
VERACRUZ DE IGNACIO DE LA LLAVE,30,MINATITLÁN,108,EL REMOLINO,4,234,111,123,20
VERACRUZ DE IGNACIO DE LA LLAVE,30,MINATITLÁN,108,EL ROBLE,3,34,19,15,3
VERACRUZ DE IGNACIO DE LA LLAVE,30,MINATITLÁN,108,EL RUBÍ,1,25,9,16,2
VERACRUZ DE IGNACIO DE LA LLAVE,30,MINATITLÁN,108,EL RUBIO (LOMA GRANDE),2,20,12,8,2
VERACRUZ DE IGNACIO DE LA LLAVE,30,MINATITLÁN,108,EL TABASQUEÑO,2,27,15,12,3
VERACRUZ DE IGNACIO DE LA LLAVE,30,MINATITLÁN,108,EL TORTUGUERO,1,34,17,17,1
VERACRUZ DE IGNACIO DE LA LLAVE,30,MINATITLÁN,108,EL VALEDOR,2,40,22,18,3
VERACRUZ DE IGNACIO DE LA LLAVE,30,MINATITLÁN,108,EL VALLE,1,71,41,30,4
VERACRUZ DE IGNACIO DE LA LLAVE,30,MINATITLÁN,108,EL ZAPOTAL,1,4,2,2,1
VERACRUZ DE IGNACIO DE LA LLAVE,30,MINATITLÁN,108,EMILIANO ZAPATA,5,211,108,103,12
VERACRUZ DE IGNACIO DE LA LLAVE,30,MINATITLÁN,108,EMILIANO ZAPATA DOS,1,17,9,8,1
VERACRUZ DE IGNACIO DE LA LLAVE,30,MINATITLÁN,108,EMILIO CARRANZA (SALINAS),5,97,50,47,10
VERACRUZ DE IGNACIO DE LA LLAVE,30,MINATITLÁN,108,ENRIQUE RODRÍGUEZ CANO,1,9,3,6,1
VERACRUZ DE IGNACIO DE LA LLAVE,30,MINATITLÁN,108,ESTERO DE ZICATLÁN,2,69,38,31,2
VERACRUZ DE IGNACIO DE LA LLAVE,30,MINATITLÁN,108,FERNANDO LÓPEZ ARIAS,4,213,106,107,13
VERACRUZ DE IGNACIO DE LA LLAVE,30,MINATITLÁN,108,FILISOLA,3,48,17,31,4
VERACRUZ DE IGNACIO DE LA LLAVE,30,MINATITLÁN,108,FRANCISCO DE GARAY (AMPLIACIÓN COLORADO),5,131,62,69,13
VERACRUZ DE IGNACIO DE LA LLAVE,30,MINATITLÁN,108,FRANCISCO I. MADERO,6,202,107,95,15
VERACRUZ DE IGNACIO DE LA LLAVE,30,MINATITLÁN,108,FRANCISCO VILLA,5,27,14,13,5
VERACRUZ DE IGNACIO DE LA LLAVE,30,MINATITLÁN,108,FRANCITA,3,101,52,49,7
VERACRUZ DE IGNACIO DE LA LLAVE,30,MINATITLÁN,108,GUSTAVO DÍAZ ORDAZ,6,390,196,194,21
VERACRUZ DE IGNACIO DE LA LLAVE,30,MINATITLÁN,108,GUSTAVO DÍAZ ORDAZ (SAN FELIPE),1,5,3,2,1
VERACRUZ DE IGNACIO DE LA LLAVE,30,MINATITLÁN,108,IXHUATEPEC (PASO DEL CHIPILE),4,125,65,60,8
VERACRUZ DE IGNACIO DE LA LLAVE,30,MINATITLÁN,108,JOSÉ CARDEL,1,8,4,4,1
VERACRUZ DE IGNACIO DE LA LLAVE,30,MINATITLÁN,108,JOSÉ GUADALUPE RODRÍGUEZ (LA JOTA),2,34,14,20,2
VERACRUZ DE IGNACIO DE LA LLAVE,30,MINATITLÁN,108,JOSÉ MARÍA MORELOS,3,53,24,29,4
VERACRUZ DE IGNACIO DE LA LLAVE,30,MINATITLÁN,108,JOSEFA ORTIZ DE DOMÍNGUEZ,2,26,15,11,2
VERACRUZ DE IGNACIO DE LA LLAVE,30,MINATITLÁN,108,LA ABUNDANCIA,4,103,48,55,7
VERACRUZ DE IGNACIO DE LA LLAVE,30,MINATITLÁN,108,LA ARENA,2,27,17,10,2
VERACRUZ DE IGNACIO DE LA LLAVE,30,MINATITLÁN,108,LA BREÑA,3,268,127,141,13
VERACRUZ DE IGNACIO DE LA LLAVE,30,MINATITLÁN,108,LA CONCEPCIÓN,2,106,57,49,6
VERACRUZ DE IGNACIO DE LA LLAVE,30,MINATITLÁN,108,LA ESMERALDA,3,63,31,32,4
VERACRUZ DE IGNACIO DE LA LLAVE,30,MINATITLÁN,108,LA ESPERANZA,2,12,5,7,1
VERACRUZ DE IGNACIO DE LA LLAVE,30,MINATITLÁN,108,LA FORTUNA,4,50,24,26,4
VERACRUZ DE IGNACIO DE LA LLAVE,30,MINATITLÁN,108,LA MAGDALENA,1,15,9,6,1
VERACRUZ DE IGNACIO DE LA LLAVE,30,MINATITLÁN,108,LA MICHOACANA,4,132,79,53,7
VERACRUZ DE IGNACIO DE LA LLAVE,30,MINATITLÁN,108,LA NUEVA CONCEPCIÓN,4,103,54,49,7
VERACRUZ DE IGNACIO DE LA LLAVE,30,MINATITLÁN,108,LA NUEVA REFORMA,3,65,35,30,4
VERACRUZ DE IGNACIO DE LA LLAVE,30,MINATITLÁN,108,LA NUEVA ROSITA,3,24,7,17,2
VERACRUZ DE IGNACIO DE LA LLAVE,30,MINATITLÁN,108,LA PALMA (EJIDO BUENAVISTA NOPALAPA),1,5,1,4,1
VERACRUZ DE IGNACIO DE LA LLAVE,30,MINATITLÁN,108,LA PAZ,1,12,3,9,1
VERACRUZ DE IGNACIO DE LA LLAVE,30,MINATITLÁN,108,LA PIMIENTA,3,33,20,13,4
VERACRUZ DE IGNACIO DE LA LLAVE,30,MINATITLÁN,108,LA PROVIDENCIA,4,136,62,74,8
VERACRUZ DE IGNACIO DE LA LLAVE,30,MINATITLÁN,108,LA REFORMA,6,262,125,137,12
VERACRUZ DE IGNACIO DE LA LLAVE,30,MINATITLÁN,108,LA SOLEDAD,2,33,10,23,3
VERACRUZ DE IGNACIO DE LA LLAVE,30,MINATITLÁN,108,LA VICTORIA,3,102,52,50,8
VERACRUZ DE IGNACIO DE LA LLAVE,30,MINATITLÁN,108,LAS ÁNIMAS,4,242,113,129,15
VERACRUZ DE IGNACIO DE LA LLAVE,30,MINATITLÁN,108,LAS CARMELITAS,3,68,38,30,5
VERACRUZ DE IGNACIO DE LA LLAVE,30,MINATITLÁN,108,LAS LIMAS,2,37,16,21,3
VERACRUZ DE IGNACIO DE LA LLAVE,30,MINATITLÁN,108,LAS LOMAS,3,160,77,83,13
VERACRUZ DE IGNACIO DE LA LLAVE,30,MINATITLÁN,108,LAS PALMAS,3,56,28,28,4
VERACRUZ DE IGNACIO DE LA LLAVE,30,MINATITLÁN,108,LÁZARO CÁRDENAS,1,9,4,5,1
VERACRUZ DE IGNACIO DE LA LLAVE,30,MINATITLÁN,108,LIMONTA,3,98,48,50,11
VERACRUZ DE IGNACIO DE LA LLAVE,30,MINATITLÁN,108,LOS CABRITOS,1,16,8,8,1
VERACRUZ DE IGNACIO DE LA LLAVE,30,MINATITLÁN,108,LOS MANANTIALES,1,15,7,8,1
VERACRUZ DE IGNACIO DE LA LLAVE,30,MINATITLÁN,108,MAPACHAPA,6,846,441,405,57
VERACRUZ DE IGNACIO DE LA LLAVE,30,MINATITLÁN,108,MIGUEL ALEMÁN,2,15,5,10,2
VERACRUZ DE IGNACIO DE LA LLAVE,30,MINATITLÁN,108,MIGUEL HIDALGO,1,7,4,3,1
VERACRUZ DE IGNACIO DE LA LLAVE,30,MINATITLÁN,108,MINATITLÁN,183,29727,15043,14684,2329
VERACRUZ DE IGNACIO DE LA LLAVE,30,MINATITLÁN,108,MOCTEZUMA,1,13,6,7,2
VERACRUZ DE IGNACIO DE LA LLAVE,30,MINATITLÁN,108,MONTE OBSCURO,2,44,21,23,3
VERACRUZ DE IGNACIO DE LA LLAVE,30,MINATITLÁN,108,NIÑO ARTILLERO,3,164,85,79,7
VERACRUZ DE IGNACIO DE LA LLAVE,30,MINATITLÁN,108,NOPALAPA,1,12,4,8,1
VERACRUZ DE IGNACIO DE LA LLAVE,30,MINATITLÁN,108,NORBERTO AGUIRRE PALANCARES,5,90,38,52,6
VERACRUZ DE IGNACIO DE LA LLAVE,30,MINATITLÁN,108,NUEVO ATOYAC,4,266,146,120,59
VERACRUZ DE IGNACIO DE LA LLAVE,30,MINATITLÁN,108,NUEVO CAZONES DE HERRERA,3,62,31,31,5
VERACRUZ DE IGNACIO DE LA LLAVE,30,MINATITLÁN,108,NUEVO ZARAGOZA,2,6,3,3,1
VERACRUZ DE IGNACIO DE LA LLAVE,30,MINATITLÁN,108,NUEVO ZARAGOZA TERCERA FRACCIÓN,1,4,2,2,1
VERACRUZ DE IGNACIO DE LA LLAVE,30,MINATITLÁN,108,OJOCHAPA,2,30,15,15,4
VERACRUZ DE IGNACIO DE LA LLAVE,30,MINATITLÁN,108,OTAPA,3,145,71,74,8
VERACRUZ DE IGNACIO DE LA LLAVE,30,MINATITLÁN,108,PALO BONITO,1,8,3,5,1
VERACRUZ DE IGNACIO DE LA LLAVE,30,MINATITLÁN,108,PLAN DE LA CEIBA,1,15,6,9,2
VERACRUZ DE IGNACIO DE LA LLAVE,30,MINATITLÁN,108,PLAN DE LIMONES,4,190,92,98,8
VERACRUZ DE IGNACIO DE LA LLAVE,30,MINATITLÁN,108,POBLADO CINCO DE MAYO DOS,2,44,26,18,3
VERACRUZ DE IGNACIO DE LA LLAVE,30,MINATITLÁN,108,POTRERO GRANDE,1,27,13,14,1
VERACRUZ DE IGNACIO DE LA LLAVE,30,MINATITLÁN,108,POZA AZUL II (LA ANGOSTURA),3,11,6,5,2
VERACRUZ DE IGNACIO DE LA LLAVE,30,MINATITLÁN,108,PROGRESO DEL MIRADOR,2,31,14,17,3
VERACRUZ DE IGNACIO DE LA LLAVE,30,MINATITLÁN,108,PUEBLO VIEJO (KILÓMETRO 4),3,172,79,93,7
VERACRUZ DE IGNACIO DE LA LLAVE,30,MINATITLÁN,108,RANCHO NUEVO CARRIZAL,2,93,43,50,8
VERACRUZ DE IGNACIO DE LA LLAVE,30,MINATITLÁN,108,RANCHO NUEVO DE MORELOS,2,12,9,3,2
VERACRUZ DE IGNACIO DE LA LLAVE,30,MINATITLÁN,108,ROMITA,1,10,6,4,1
VERACRUZ DE IGNACIO DE LA LLAVE,30,MINATITLÁN,108,SAN ANDRÉS LOMA ENCERRADA,1,7,2,5,1
VERACRUZ DE IGNACIO DE LA LLAVE,30,MINATITLÁN,108,SAN CÁNDIDO,1,1,1,0,1
VERACRUZ DE IGNACIO DE LA LLAVE,30,MINATITLÁN,108,SAN CRISTÓBAL,4,172,78,94,13
VERACRUZ DE IGNACIO DE LA LLAVE,30,MINATITLÁN,108,SAN FRANCISCO LAS ÁNIMAS,2,45,21,24,3
VERACRUZ DE IGNACIO DE LA LLAVE,30,MINATITLÁN,108,SAN JERÓNIMO,3,24,15,9,2
VERACRUZ DE IGNACIO DE LA LLAVE,30,MINATITLÁN,108,SAN JOSÉ POCHITOQUE,2,17,12,5,2
VERACRUZ DE IGNACIO DE LA LLAVE,30,MINATITLÁN,108,SAN PEDRO MEZCALAPA,2,39,21,18,3
VERACRUZ DE IGNACIO DE LA LLAVE,30,MINATITLÁN,108,SAN PLÁCIDO,1,12,6,6,1
VERACRUZ DE IGNACIO DE LA LLAVE,30,MINATITLÁN,108,SAN VICENTE,2,10,5,5,1
VERACRUZ DE IGNACIO DE LA LLAVE,30,MINATITLÁN,108,SANTA ALEJANDRINA,1,14,6,8,1
VERACRUZ DE IGNACIO DE LA LLAVE,30,MINATITLÁN,108,SANTA ISABEL,2,17,5,12,2
VERACRUZ DE IGNACIO DE LA LLAVE,30,MINATITLÁN,108,SEHUALACA,2,18,5,13,2
VERACRUZ DE IGNACIO DE LA LLAVE,30,MINATITLÁN,108,TECUANAPILLA,2,19,7,12,2
VERACRUZ DE IGNACIO DE LA LLAVE,30,MINATITLÁN,108,TENOCHTITLÁN,3,75,39,36,4
VERACRUZ DE IGNACIO DE LA LLAVE,30,MINATITLÁN,108,TORTUGUERO CHICO,1,4,1,3,1
VERACRUZ DE IGNACIO DE LA LLAVE,30,MINATITLÁN,108,VILLA DE LAS FLORES,2,14,6,8,2
VERACRUZ DE IGNACIO DE LA LLAVE,30,MINATITLÁN,108,YUCATECAL,1,12,6,6,1
VERACRUZ DE IGNACIO DE LA LLAVE,30,MINATITLÁN,108,ZAMORANA,1,13,4,9,1
VERACRUZ DE IGNACIO DE LA LLAVE,30,MISANTLA,109,ARROYO FRÍO,3,88,34,54,8
VERACRUZ DE IGNACIO DE LA LLAVE,30,MISANTLA,109,ARROYO HONDO,7,790,404,386,71
VERACRUZ DE IGNACIO DE LA LLAVE,30,MISANTLA,109,ARROYO NEGRO,1,12,7,5,1
VERACRUZ DE IGNACIO DE LA LLAVE,30,MISANTLA,109,BUENOS AIRES,2,135,63,72,10
VERACRUZ DE IGNACIO DE LA LLAVE,30,MISANTLA,109,BUENOS AIRES (PUEBLO VIEJO),1,32,20,12,2
VERACRUZ DE IGNACIO DE LA LLAVE,30,MISANTLA,109,CERRO QUEBRADO II (PIEDRAS PODRIDAS),2,13,6,7,2
VERACRUZ DE IGNACIO DE LA LLAVE,30,MISANTLA,109,CERRO QUEBRADO UNO (SAN FELIPE),2,34,18,16,2
VERACRUZ DE IGNACIO DE LA LLAVE,30,MISANTLA,109,CHAPACHAPA,3,50,20,30,5
VERACRUZ DE IGNACIO DE LA LLAVE,30,MISANTLA,109,COAPECHE,3,86,36,50,11
VERACRUZ DE IGNACIO DE LA LLAVE,30,MISANTLA,109,COLONIA EL PORVENIR,2,12,6,6,2
VERACRUZ DE IGNACIO DE LA LLAVE,30,MISANTLA,109,COLORADO CHICO,2,49,23,26,4
VERACRUZ DE IGNACIO DE LA LLAVE,30,MISANTLA,109,CUATRO CAMINOS,1,6,5,1,1
VERACRUZ DE IGNACIO DE LA LLAVE,30,MISANTLA,109,EJIDO VISTA HERMOSA (PLATANILLO),1,9,4,5,1
VERACRUZ DE IGNACIO DE LA LLAVE,30,MISANTLA,109,EL CARMEN,2,23,12,11,3
VERACRUZ DE IGNACIO DE LA LLAVE,30,MISANTLA,109,EL COLORADITO,3,26,15,11,3
VERACRUZ DE IGNACIO DE LA LLAVE,30,MISANTLA,109,EL LIRIAL,2,17,8,9,2
VERACRUZ DE IGNACIO DE LA LLAVE,30,MISANTLA,109,EL POZÓN,3,84,47,37,8
VERACRUZ DE IGNACIO DE LA LLAVE,30,MISANTLA,109,FRANCISCO I. MADERO,2,17,6,11,3
VERACRUZ DE IGNACIO DE LA LLAVE,30,MISANTLA,109,FRANCISCO SARABIA (PASO VIEJO),4,225,103,122,19
VERACRUZ DE IGNACIO DE LA LLAVE,30,MISANTLA,109,GUADALUPE VICTORIA,3,29,10,19,5
VERACRUZ DE IGNACIO DE LA LLAVE,30,MISANTLA,109,GUADALUPE VICTORIA (LA VAQUERÍA),1,11,8,3,1
VERACRUZ DE IGNACIO DE LA LLAVE,30,MISANTLA,109,GUILLERMO BADILLO (EL GUAYABAL),1,7,4,3,1
VERACRUZ DE IGNACIO DE LA LLAVE,30,MISANTLA,109,IGNACIO ZARAGOZA (EL CHORRO),4,114,59,55,14
VERACRUZ DE IGNACIO DE LA LLAVE,30,MISANTLA,109,INDEPENDENCIA (CERRO VERDE),2,19,13,6,2
VERACRUZ DE IGNACIO DE LA LLAVE,30,MISANTLA,109,JUAN JACOBO TORRES (LA MONERA),4,44,19,25,7
VERACRUZ DE IGNACIO DE LA LLAVE,30,MISANTLA,109,LA CAPILLA,1,4,1,3,1
VERACRUZ DE IGNACIO DE LA LLAVE,30,MISANTLA,109,LA DEFENSA,5,296,138,158,22
VERACRUZ DE IGNACIO DE LA LLAVE,30,MISANTLA,109,LA HABANA,1,12,4,8,1
VERACRUZ DE IGNACIO DE LA LLAVE,30,MISANTLA,109,LA LIBERTAD,4,172,74,98,14
VERACRUZ DE IGNACIO DE LA LLAVE,30,MISANTLA,109,LA LIMA,3,37,20,17,6
VERACRUZ DE IGNACIO DE LA LLAVE,30,MISANTLA,109,LA PALMA,1,8,5,3,1
VERACRUZ DE IGNACIO DE LA LLAVE,30,MISANTLA,109,LA PALMA (CASA BLANCA),3,38,17,21,5
VERACRUZ DE IGNACIO DE LA LLAVE,30,MISANTLA,109,LA PIEDAD,1,12,6,6,1
VERACRUZ DE IGNACIO DE LA LLAVE,30,MISANTLA,109,LA PRIMAVERA,3,150,66,84,10
VERACRUZ DE IGNACIO DE LA LLAVE,30,MISANTLA,109,LA REFORMA,4,155,90,65,10
VERACRUZ DE IGNACIO DE LA LLAVE,30,MISANTLA,109,LA REFORMA (KILÓMETRO 9),3,105,57,48,10
VERACRUZ DE IGNACIO DE LA LLAVE,30,MISANTLA,109,LA SOLEDAD,2,11,6,5,2
VERACRUZ DE IGNACIO DE LA LLAVE,30,MISANTLA,109,LAS LAJAS,2,30,13,17,2
VERACRUZ DE IGNACIO DE LA LLAVE,30,MISANTLA,109,LAS LOMAS,2,62,24,38,6
VERACRUZ DE IGNACIO DE LA LLAVE,30,MISANTLA,109,LIQUIDÁMBAR,2,21,13,8,3
VERACRUZ DE IGNACIO DE LA LLAVE,30,MISANTLA,109,LOMA BONITA,2,14,5,9,2
VERACRUZ DE IGNACIO DE LA LLAVE,30,MISANTLA,109,LOMA DEL COJOLITE,3,129,59,70,10
VERACRUZ DE IGNACIO DE LA LLAVE,30,MISANTLA,109,LOMA DEL MIRASOL,4,64,33,31,7
VERACRUZ DE IGNACIO DE LA LLAVE,30,MISANTLA,109,LOS ÍDOLOS,3,49,25,24,7
VERACRUZ DE IGNACIO DE LA LLAVE,30,MISANTLA,109,LOS TRAPICHES,6,144,67,77,15
VERACRUZ DE IGNACIO DE LA LLAVE,30,MISANTLA,109,MAFAFAS (EJIDO PIPIANALES),2,30,13,17,4
VERACRUZ DE IGNACIO DE LA LLAVE,30,MISANTLA,109,MANUEL ÁVILA CAMACHO,1,5,3,2,1
VERACRUZ DE IGNACIO DE LA LLAVE,30,MISANTLA,109,MANUEL GUTIÉRREZ NÁJERA,4,121,68,53,11
VERACRUZ DE IGNACIO DE LA LLAVE,30,MISANTLA,109,MÁXIMO GARCÍA (LA GUADALUPE),3,107,56,51,9
VERACRUZ DE IGNACIO DE LA LLAVE,30,MISANTLA,109,MISANTLA,41,8309,3983,4326,507
VERACRUZ DE IGNACIO DE LA LLAVE,30,MISANTLA,109,MORELOS,3,42,25,17,5
VERACRUZ DE IGNACIO DE LA LLAVE,30,MISANTLA,109,MOXILLÓN,4,86,46,40,10
VERACRUZ DE IGNACIO DE LA LLAVE,30,MISANTLA,109,PALCHÁN,1,8,6,2,1
VERACRUZ DE IGNACIO DE LA LLAVE,30,MISANTLA,109,PALMA SOLA DE RAMÍREZ,2,15,10,5,2
VERACRUZ DE IGNACIO DE LA LLAVE,30,MISANTLA,109,PALMIRA DE HIDALGO,2,23,13,10,2
VERACRUZ DE IGNACIO DE LA LLAVE,30,MISANTLA,109,PALPOALA IXCÁN,4,265,147,118,19
VERACRUZ DE IGNACIO DE LA LLAVE,30,MISANTLA,109,PASO BLANCO,4,209,106,103,16
VERACRUZ DE IGNACIO DE LA LLAVE,30,MISANTLA,109,PIPIANALES (EJIDO PIPIANALES),4,63,39,24,8
VERACRUZ DE IGNACIO DE LA LLAVE,30,MISANTLA,109,PLAN DE GUERRERO,2,55,23,32,5
VERACRUZ DE IGNACIO DE LA LLAVE,30,MISANTLA,109,PLAN DE LA VEGA,6,266,128,138,21
VERACRUZ DE IGNACIO DE LA LLAVE,30,MISANTLA,109,POBLADO IGNACIO ALLENDE,3,22,9,13,4
VERACRUZ DE IGNACIO DE LA LLAVE,30,MISANTLA,109,POXTITLÁN,3,132,60,72,9
VERACRUZ DE IGNACIO DE LA LLAVE,30,MISANTLA,109,POZA DEL TIGRE,3,66,33,33,7
VERACRUZ DE IGNACIO DE LA LLAVE,30,MISANTLA,109,PUEBLO VIEJO,4,214,103,111,16
VERACRUZ DE IGNACIO DE LA LLAVE,30,MISANTLA,109,PUERTO PALCHÁN,3,306,133,173,17
VERACRUZ DE IGNACIO DE LA LLAVE,30,MISANTLA,109,RANCHERÍA ESPALDILLA,3,35,16,19,3
VERACRUZ DE IGNACIO DE LA LLAVE,30,MISANTLA,109,RANCHERÍA VISTA HERMOSA,2,15,7,8,3
VERACRUZ DE IGNACIO DE LA LLAVE,30,MISANTLA,109,RANCHO VIEJO,1,7,4,3,1
VERACRUZ DE IGNACIO DE LA LLAVE,30,MISANTLA,109,SALVADOR DÍAZ MIRÓN,4,216,109,107,15
VERACRUZ DE IGNACIO DE LA LLAVE,30,MISANTLA,109,SAN FRANCISCO,1,8,5,3,1
VERACRUZ DE IGNACIO DE LA LLAVE,30,MISANTLA,109,SANTA CECILIA,2,36,20,16,3
VERACRUZ DE IGNACIO DE LA LLAVE,30,MISANTLA,109,SANTA CLARA,3,81,38,43,9
VERACRUZ DE IGNACIO DE LA LLAVE,30,MISANTLA,109,SANTA CRUZ BUENA VISTA,3,68,41,27,7
VERACRUZ DE IGNACIO DE LA LLAVE,30,MISANTLA,109,SANTA CRUZ HIDALGO,4,122,61,61,10
VERACRUZ DE IGNACIO DE LA LLAVE,30,MISANTLA,109,SANTA MARGARITA,2,49,36,13,4
VERACRUZ DE IGNACIO DE LA LLAVE,30,MISANTLA,109,TAPAPULUM,2,20,11,9,2
VERACRUZ DE IGNACIO DE LA LLAVE,30,MISANTLA,109,TRONCONES,2,45,22,23,3
VERACRUZ DE IGNACIO DE LA LLAVE,30,MISANTLA,109,UNIÓN VENUSTIANO CARRANZA (LOS NARANJOS),1,10,7,3,1
VERACRUZ DE IGNACIO DE LA LLAVE,30,MISANTLA,109,VENUSTIANO CARRANZA,5,276,125,151,20
VERACRUZ DE IGNACIO DE LA LLAVE,30,MISANTLA,109,VICENTE GUERRERO,4,222,101,121,20
VERACRUZ DE IGNACIO DE LA LLAVE,30,MISANTLA,109,VILLA NUEVA,3,54,26,28,7
VERACRUZ DE IGNACIO DE LA LLAVE,30,MIXTLA DE ALTAMIRANO,110,AHUACATLA,2,47,26,21,5
VERACRUZ DE IGNACIO DE LA LLAVE,30,MIXTLA DE ALTAMIRANO,110,ATZALA,1,33,19,14,2
VERACRUZ DE IGNACIO DE LA LLAVE,30,MIXTLA DE ALTAMIRANO,110,AXOXOHUILCO,3,174,93,81,10
VERACRUZ DE IGNACIO DE LA LLAVE,30,MIXTLA DE ALTAMIRANO,110,AYAHUALULCO,3,111,53,58,7
VERACRUZ DE IGNACIO DE LA LLAVE,30,MIXTLA DE ALTAMIRANO,110,BARRIO CUARTO,3,142,75,67,7
VERACRUZ DE IGNACIO DE LA LLAVE,30,MIXTLA DE ALTAMIRANO,110,BARRIO SAN ANTONIO,1,19,6,13,1
VERACRUZ DE IGNACIO DE LA LLAVE,30,MIXTLA DE ALTAMIRANO,110,BARRIO SEGUNDO,2,214,91,123,10
VERACRUZ DE IGNACIO DE LA LLAVE,30,MIXTLA DE ALTAMIRANO,110,BARRIO TERCERO,1,19,11,8,1
VERACRUZ DE IGNACIO DE LA LLAVE,30,MIXTLA DE ALTAMIRANO,110,CAPULTITLA,2,40,18,22,3
VERACRUZ DE IGNACIO DE LA LLAVE,30,MIXTLA DE ALTAMIRANO,110,COLONIA MIGUEL ALEMÁN,2,11,5,6,2
VERACRUZ DE IGNACIO DE LA LLAVE,30,MIXTLA DE ALTAMIRANO,110,COXIMALCO,3,94,48,46,7
VERACRUZ DE IGNACIO DE LA LLAVE,30,MIXTLA DE ALTAMIRANO,110,CUATLEIXCO,1,11,8,3,1
VERACRUZ DE IGNACIO DE LA LLAVE,30,MIXTLA DE ALTAMIRANO,110,CUAUTLAJAPA,2,66,27,39,4
VERACRUZ DE IGNACIO DE LA LLAVE,30,MIXTLA DE ALTAMIRANO,110,EL TERRERO,3,14,6,8,3
VERACRUZ DE IGNACIO DE LA LLAVE,30,MIXTLA DE ALTAMIRANO,110,MANGOTITLA,1,11,6,5,1
VERACRUZ DE IGNACIO DE LA LLAVE,30,MIXTLA DE ALTAMIRANO,110,MATLATECOYA,1,18,10,8,2
VERACRUZ DE IGNACIO DE LA LLAVE,30,MIXTLA DE ALTAMIRANO,110,MEXCALA,3,41,21,20,4
VERACRUZ DE IGNACIO DE LA LLAVE,30,MIXTLA DE ALTAMIRANO,110,MIXTLA DE ALTAMIRANO,5,589,326,263,26
VERACRUZ DE IGNACIO DE LA LLAVE,30,MIXTLA DE ALTAMIRANO,110,MIXTLANTLAKPAK,2,76,33,43,5
VERACRUZ DE IGNACIO DE LA LLAVE,30,MIXTLA DE ALTAMIRANO,110,OCOTEMPA (BARRIO PRIMERO),2,124,55,69,10
VERACRUZ DE IGNACIO DE LA LLAVE,30,MIXTLA DE ALTAMIRANO,110,TEAPA OCOTEMPA,2,32,15,17,2
VERACRUZ DE IGNACIO DE LA LLAVE,30,MIXTLA DE ALTAMIRANO,110,TECOLOTLA,3,64,33,31,4
VERACRUZ DE IGNACIO DE LA LLAVE,30,MIXTLA DE ALTAMIRANO,110,TENEXCALCO,3,127,59,68,8
VERACRUZ DE IGNACIO DE LA LLAVE,30,MIXTLA DE ALTAMIRANO,110,TEPECUITLAPA,3,79,32,47,5
VERACRUZ DE IGNACIO DE LA LLAVE,30,MIXTLA DE ALTAMIRANO,110,TETZILQUILA,2,38,20,18,2
VERACRUZ DE IGNACIO DE LA LLAVE,30,MIXTLA DE ALTAMIRANO,110,TLACHICUAPA,2,26,19,7,2
VERACRUZ DE IGNACIO DE LA LLAVE,30,MIXTLA DE ALTAMIRANO,110,TLAXCALA,2,20,13,7,2
VERACRUZ DE IGNACIO DE LA LLAVE,30,MIXTLA DE ALTAMIRANO,110,TLAXCANTLA (OCOMANALCO),3,169,84,85,11
VERACRUZ DE IGNACIO DE LA LLAVE,30,MIXTLA DE ALTAMIRANO,110,TLAZALOLAPA,2,28,12,16,3
VERACRUZ DE IGNACIO DE LA LLAVE,30,MIXTLA DE ALTAMIRANO,110,XALA,2,53,25,28,3
VERACRUZ DE IGNACIO DE LA LLAVE,30,MIXTLA DE ALTAMIRANO,110,XOCHITLA,5,245,129,116,16
VERACRUZ DE IGNACIO DE LA LLAVE,30,MIXTLA DE ALTAMIRANO,110,XOMETLA,3,31,16,15,3
VERACRUZ DE IGNACIO DE LA LLAVE,30,MIXTLA DE ALTAMIRANO,110,ZACALOMA,2,45,25,20,3
VERACRUZ DE IGNACIO DE LA LLAVE,30,MIXTLA DE ALTAMIRANO,110,ZACATILICA,4,140,69,71,10
VERACRUZ DE IGNACIO DE LA LLAVE,30,MOLOACÁN,111,ACALAPA UNO,1,18,7,11,1
VERACRUZ DE IGNACIO DE LA LLAVE,30,MOLOACÁN,111,COLONIA LA FLORIDA,1,6,5,1,1
VERACRUZ DE IGNACIO DE LA LLAVE,30,MOLOACÁN,111,CUICHAPA,10,1561,795,766,106
VERACRUZ DE IGNACIO DE LA LLAVE,30,MOLOACÁN,111,EJIDO ARROYO BLANCO (EL ÁGATA),2,65,35,30,5
VERACRUZ DE IGNACIO DE LA LLAVE,30,MOLOACÁN,111,EJIDO POPOTLA,3,59,22,37,6
VERACRUZ DE IGNACIO DE LA LLAVE,30,MOLOACÁN,111,FRANCISCO VILLA,2,20,7,13,2
VERACRUZ DE IGNACIO DE LA LLAVE,30,MOLOACÁN,111,KILÓMETRO TREINTA Y NUEVE (EJIDO CUICHAPA),1,13,7,6,1
VERACRUZ DE IGNACIO DE LA LLAVE,30,MOLOACÁN,111,LA GUADALUPE,1,6,4,2,1
VERACRUZ DE IGNACIO DE LA LLAVE,30,MOLOACÁN,111,MOLOACÁN,4,389,184,205,20
VERACRUZ DE IGNACIO DE LA LLAVE,30,MOLOACÁN,111,NUEVA PALMA SOLA,1,5,2,3,1
VERACRUZ DE IGNACIO DE LA LLAVE,30,MOLOACÁN,111,NUEVO TEAPA,5,439,213,226,25
VERACRUZ DE IGNACIO DE LA LLAVE,30,MOLOACÁN,111,NUEVO TEAPA (SANTA CECILIA),1,14,9,5,1
VERACRUZ DE IGNACIO DE LA LLAVE,30,MOLOACÁN,111,SAN JUAN DE LOS REYES (LOS CAIMANES),2,32,14,18,3
VERACRUZ DE IGNACIO DE LA LLAVE,30,MOLOACÁN,111,SAN LORENZO MEZCALAPA,2,46,22,24,3
VERACRUZ DE IGNACIO DE LA LLAVE,30,MOLOACÁN,111,SAN MARTÍN,3,46,20,26,4
VERACRUZ DE IGNACIO DE LA LLAVE,30,MOLOACÁN,111,TACOMANGO,3,22,14,8,3
VERACRUZ DE IGNACIO DE LA LLAVE,30,MOLOACÁN,111,TLACUILOLAPAN,4,430,205,225,22
VERACRUZ DE IGNACIO DE LA LLAVE,30,MOLOACÁN,111,TRANCAS VIEJAS,3,93,50,43,6
VERACRUZ DE IGNACIO DE LA LLAVE,30,NAOLINCO,112,ALMOLONGA,4,340,152,188,30
VERACRUZ DE IGNACIO DE LA LLAVE,30,NAOLINCO,112,BUENAVISTA,2,46,23,23,4
VERACRUZ DE IGNACIO DE LA LLAVE,30,NAOLINCO,112,CERRO DEL LEÓN,2,10,7,3,1
VERACRUZ DE IGNACIO DE LA LLAVE,30,NAOLINCO,112,CERRO GORDO,3,28,16,12,3
VERACRUZ DE IGNACIO DE LA LLAVE,30,NAOLINCO,112,EL CAFETAL,2,21,13,8,2
VERACRUZ DE IGNACIO DE LA LLAVE,30,NAOLINCO,112,EL CHIRIMOYO,1,7,3,4,1
VERACRUZ DE IGNACIO DE LA LLAVE,30,NAOLINCO,112,EL COPETE,2,9,6,3,1
VERACRUZ DE IGNACIO DE LA LLAVE,30,NAOLINCO,112,EL ESPINAL,6,478,222,256,29
VERACRUZ DE IGNACIO DE LA LLAVE,30,NAOLINCO,112,FRACCIONAMIENTO DE LOS 4 SOLES,3,228,112,116,14
VERACRUZ DE IGNACIO DE LA LLAVE,30,NAOLINCO,112,LA MESA DEL ESPINAL,2,52,28,24,4
VERACRUZ DE IGNACIO DE LA LLAVE,30,NAOLINCO,112,LA PALMA,2,19,11,8,2
VERACRUZ DE IGNACIO DE LA LLAVE,30,NAOLINCO,112,LA YERBABUENA,2,41,24,17,3
VERACRUZ DE IGNACIO DE LA LLAVE,30,NAOLINCO,112,LAS HALDAS,4,168,85,83,13
VERACRUZ DE IGNACIO DE LA LLAVE,30,NAOLINCO,112,LOS CEDROS,2,26,10,16,2
VERACRUZ DE IGNACIO DE LA LLAVE,30,NAOLINCO,112,NAOLINCO DE VICTORIA,12,2774,1418,1356,158
VERACRUZ DE IGNACIO DE LA LLAVE,30,NAOLINCO,112,NARANJILLO,2,20,15,5,3
VERACRUZ DE IGNACIO DE LA LLAVE,30,NAOLINCO,112,SAN MARCOS ATESQUILAPAN,4,401,188,213,22
VERACRUZ DE IGNACIO DE LA LLAVE,30,NAOLINCO,112,SAN MIGUEL AGUAZUELOS,2,46,21,25,3
VERACRUZ DE IGNACIO DE LA LLAVE,30,NAOLINCO,112,SAN PABLO COAPAN,4,385,189,196,25
VERACRUZ DE IGNACIO DE LA LLAVE,30,NAOLINCO,112,TENAMPA,2,56,32,24,7
VERACRUZ DE IGNACIO DE LA LLAVE,30,NARANJAL,113,AXALPA,2,15,6,9,2
VERACRUZ DE IGNACIO DE LA LLAVE,30,NARANJAL,113,LINDERO XOCHITLA,2,59,26,33,3
VERACRUZ DE IGNACIO DE LA LLAVE,30,NARANJAL,113,NARANJAL,6,583,303,280,32
VERACRUZ DE IGNACIO DE LA LLAVE,30,NARANJAL,113,NEXCA NARANJAL,3,49,22,27,4
VERACRUZ DE IGNACIO DE LA LLAVE,30,NARANJAL,113,TEQUECHOLAPA,3,77,37,40,5
VERACRUZ DE IGNACIO DE LA LLAVE,30,NARANJAL,113,XOCHITLA,3,109,53,56,8
VERACRUZ DE IGNACIO DE LA LLAVE,30,NARANJAL,113,ZOQUIAPA,4,97,50,47,10
VERACRUZ DE IGNACIO DE LA LLAVE,30,NAUTLA,114,ADALBERTO TEJEDA,3,39,20,19,6
VERACRUZ DE IGNACIO DE LA LLAVE,30,NAUTLA,114,BARRA DE PALMAS,3,85,49,36,7
VERACRUZ DE IGNACIO DE LA LLAVE,30,NAUTLA,114,CAMINO REAL,2,6,4,2,1
VERACRUZ DE IGNACIO DE LA LLAVE,30,NAUTLA,114,CUATRO CAMINOS,2,113,55,58,8
VERACRUZ DE IGNACIO DE LA LLAVE,30,NAUTLA,114,EL ALTILLO,2,28,13,15,2
VERACRUZ DE IGNACIO DE LA LLAVE,30,NAUTLA,114,EL CIERVO (SAN JOSÉ BUENAVISTA),4,193,98,95,13
VERACRUZ DE IGNACIO DE LA LLAVE,30,NAUTLA,114,EL HUANAL,1,3,2,1,1
VERACRUZ DE IGNACIO DE LA LLAVE,30,NAUTLA,114,EL PORVENIR,1,17,6,11,1
VERACRUZ DE IGNACIO DE LA LLAVE,30,NAUTLA,114,EL RAUDAL (RAUDAL DE LAS FLORES),2,28,18,10,4
VERACRUZ DE IGNACIO DE LA LLAVE,30,NAUTLA,114,EL TORDO,2,6,3,3,1
VERACRUZ DE IGNACIO DE LA LLAVE,30,NAUTLA,114,EMILIANO ZAPATA,1,6,2,4,1
VERACRUZ DE IGNACIO DE LA LLAVE,30,NAUTLA,114,ISLA DE CHAPACHAPA,4,226,107,119,17
VERACRUZ DE IGNACIO DE LA LLAVE,30,NAUTLA,114,JICALTEPEC,4,134,57,77,12
VERACRUZ DE IGNACIO DE LA LLAVE,30,NAUTLA,114,LA MARTINICA,3,83,32,51,7
VERACRUZ DE IGNACIO DE LA LLAVE,30,NAUTLA,114,LA PEÑA,1,15,9,6,1
VERACRUZ DE IGNACIO DE LA LLAVE,30,NAUTLA,114,LA UNIÓN (EL POBLADO),3,84,38,46,7
VERACRUZ DE IGNACIO DE LA LLAVE,30,NAUTLA,114,NAUTLA,6,531,256,275,36
VERACRUZ DE IGNACIO DE LA LLAVE,30,NAUTLA,114,RANCHO NUEVO,1,5,3,2,1
VERACRUZ DE IGNACIO DE LA LLAVE,30,NAUTLA,114,SEBASTIÁN CAMACHO,1,11,5,6,1
VERACRUZ DE IGNACIO DE LA LLAVE,30,NOGALES,115,AGRÍCOLA LÁZARO CÁRDENAS,2,293,160,133,13
VERACRUZ DE IGNACIO DE LA LLAVE,30,NOGALES,115,CAMPESINA EL MIRADOR,2,76,40,36,4
VERACRUZ DE IGNACIO DE LA LLAVE,30,NOGALES,115,CECILIO TERÁN (BALASTRERA),3,314,161,153,16
VERACRUZ DE IGNACIO DE LA LLAVE,30,NOGALES,115,CHICAHUAXTLA,2,25,17,8,2
VERACRUZ DE IGNACIO DE LA LLAVE,30,NOGALES,115,EL CAMPANARIO,5,229,111,118,13
VERACRUZ DE IGNACIO DE LA LLAVE,30,NOGALES,115,EL NICHO,3,54,30,24,4
VERACRUZ DE IGNACIO DE LA LLAVE,30,NOGALES,115,EMILIANO ZAPATA,1,63,33,30,4
VERACRUZ DE IGNACIO DE LA LLAVE,30,NOGALES,115,ESCALERILLA,2,38,13,25,3
VERACRUZ DE IGNACIO DE LA LLAVE,30,NOGALES,115,FERNANDO LÓPEZ ARIAS,2,97,46,51,5
VERACRUZ DE IGNACIO DE LA LLAVE,30,NOGALES,115,LA CARBONERA,2,188,102,86,11
VERACRUZ DE IGNACIO DE LA LLAVE,30,NOGALES,115,LA ROSA,5,192,105,87,10
VERACRUZ DE IGNACIO DE LA LLAVE,30,NOGALES,115,NOGALES,32,5061,2533,2528,327
VERACRUZ DE IGNACIO DE LA LLAVE,30,NOGALES,115,PALO VERDE,2,60,32,28,3
VERACRUZ DE IGNACIO DE LA LLAVE,30,NOGALES,115,PASEO NUEVO,1,32,15,17,2
VERACRUZ DE IGNACIO DE LA LLAVE,30,NOGALES,115,RANCHO VIEJO,2,31,15,16,5
VERACRUZ DE IGNACIO DE LA LLAVE,30,NOGALES,115,REFORMA,3,82,40,42,7
VERACRUZ DE IGNACIO DE LA LLAVE,30,NOGALES,115,SANTA CRUZ MUYUAPAN,2,48,24,24,3
VERACRUZ DE IGNACIO DE LA LLAVE,30,NOGALES,115,SIERRA DE AGUA,2,31,15,16,2
VERACRUZ DE IGNACIO DE LA LLAVE,30,NOGALES,115,TAZA DE AGUA OJO ZARCO,7,488,255,233,38
VERACRUZ DE IGNACIO DE LA LLAVE,30,OLUTA,116,CORREA,3,75,36,39,5
VERACRUZ DE IGNACIO DE LA LLAVE,30,OLUTA,116,OLUTA,17,2430,1200,1230,156
VERACRUZ DE IGNACIO DE LA LLAVE,30,OLUTA,116,TENEJAPA,3,153,78,75,10
VERACRUZ DE IGNACIO DE LA LLAVE,30,OMEALCA,117,AMPLIACIÓN BALSA LARGA (PASO HUICHAPA),2,49,26,23,4
VERACRUZ DE IGNACIO DE LA LLAVE,30,OMEALCA,117,AMPLIACIÓN POZORRÓN,2,18,5,13,2
VERACRUZ DE IGNACIO DE LA LLAVE,30,OMEALCA,117,AMPLIACIÓN SAN PABLO OJO DE AGUA,2,47,19,28,3
VERACRUZ DE IGNACIO DE LA LLAVE,30,OMEALCA,117,ATOLKA,3,34,23,11,3
VERACRUZ DE IGNACIO DE LA LLAVE,30,OMEALCA,117,BAJO GRANDE,3,162,86,76,11
VERACRUZ DE IGNACIO DE LA LLAVE,30,OMEALCA,117,BALSA LARGA,2,18,8,10,2
VERACRUZ DE IGNACIO DE LA LLAVE,30,OMEALCA,117,COATICA,2,52,31,21,2
VERACRUZ DE IGNACIO DE LA LLAVE,30,OMEALCA,117,CRUZ TETELA,4,238,125,113,15
VERACRUZ DE IGNACIO DE LA LLAVE,30,OMEALCA,117,DOS CAMINOS,2,48,35,13,3
VERACRUZ DE IGNACIO DE LA LLAVE,30,OMEALCA,117,EL CALLEJÓN,1,10,4,6,1
VERACRUZ DE IGNACIO DE LA LLAVE,30,OMEALCA,117,EL JOBO,2,60,25,35,4
VERACRUZ DE IGNACIO DE LA LLAVE,30,OMEALCA,117,EL MIRADOR,2,28,16,12,3
VERACRUZ DE IGNACIO DE LA LLAVE,30,OMEALCA,117,EL POZORRÓN,2,14,7,7,2
VERACRUZ DE IGNACIO DE LA LLAVE,30,OMEALCA,117,EMILIANO ZAPATA,3,74,37,37,6
VERACRUZ DE IGNACIO DE LA LLAVE,30,OMEALCA,117,KILÓMETRO G. VEINTINUEVE,2,16,7,9,2
VERACRUZ DE IGNACIO DE LA LLAVE,30,OMEALCA,117,LA BALSA,2,43,18,25,3
VERACRUZ DE IGNACIO DE LA LLAVE,30,OMEALCA,117,LAS PALMAS,4,227,106,121,18
VERACRUZ DE IGNACIO DE LA LLAVE,30,OMEALCA,117,LÁZARO CÁRDENAS,3,28,11,17,3
VERACRUZ DE IGNACIO DE LA LLAVE,30,OMEALCA,117,LOMA MULATO,2,56,28,28,4
VERACRUZ DE IGNACIO DE LA LLAVE,30,OMEALCA,117,MATA DE CAÑA,2,30,14,16,3
VERACRUZ DE IGNACIO DE LA LLAVE,30,OMEALCA,117,MATA TENATITO (CASCO HACIENDA),4,506,252,254,28
VERACRUZ DE IGNACIO DE LA LLAVE,30,OMEALCA,117,MIAHUATLÁN,2,67,36,31,7
VERACRUZ DE IGNACIO DE LA LLAVE,30,OMEALCA,117,MIGUEL HIDALGO Y COSTILLA,2,39,18,21,3
VERACRUZ DE IGNACIO DE LA LLAVE,30,OMEALCA,117,OMEALCA,8,1608,819,789,95
VERACRUZ DE IGNACIO DE LA LLAVE,30,OMEALCA,117,PALMA SOLA,2,40,21,19,3
VERACRUZ DE IGNACIO DE LA LLAVE,30,OMEALCA,117,PASO AMAPA,3,130,57,73,8
VERACRUZ DE IGNACIO DE LA LLAVE,30,OMEALCA,117,PASO CARRILLO,2,30,13,17,3
VERACRUZ DE IGNACIO DE LA LLAVE,30,OMEALCA,117,PASO DEL ROSARIO,2,53,27,26,4
VERACRUZ DE IGNACIO DE LA LLAVE,30,OMEALCA,117,PASO REAL,3,63,32,31,6
VERACRUZ DE IGNACIO DE LA LLAVE,30,OMEALCA,117,RINCÓN DE BUENA VISTA,4,262,125,137,15
VERACRUZ DE IGNACIO DE LA LLAVE,30,OMEALCA,117,RINCÓN VIEJO,1,16,12,4,1
VERACRUZ DE IGNACIO DE LA LLAVE,30,OMEALCA,117,RÍO MORENO,3,148,73,75,12
VERACRUZ DE IGNACIO DE LA LLAVE,30,OMEALCA,117,SAN PABLO OJO DE AGUA,2,36,13,23,3
VERACRUZ DE IGNACIO DE LA LLAVE,30,OMEALCA,117,TENEJÁPAM DE MATA,4,479,241,238,37
VERACRUZ DE IGNACIO DE LA LLAVE,30,OMEALCA,117,VICTORIA,2,5,2,3,1
VERACRUZ DE IGNACIO DE LA LLAVE,30,OMEALCA,117,VISTA HERMOSA (LA TURBINA),1,9,4,5,1
VERACRUZ DE IGNACIO DE LA LLAVE,30,OMEALCA,117,XÚCHILES,3,158,74,84,11
VERACRUZ DE IGNACIO DE LA LLAVE,30,ORIZABA,118,ORIZABA,264,47017,23800,23217,3698
VERACRUZ DE IGNACIO DE LA LLAVE,30,OTATITLÁN,119,EL ZAPOTE,1,6,3,3,1
VERACRUZ DE IGNACIO DE LA LLAVE,30,OTATITLÁN,119,OTATITLÁN,8,1154,557,597,75
VERACRUZ DE IGNACIO DE LA LLAVE,30,OTEAPAN,120,EL PORVENIR,1,6,3,3,2
VERACRUZ DE IGNACIO DE LA LLAVE,30,OTEAPAN,120,OTEAPAN,22,2529,1299,1230,142
VERACRUZ DE IGNACIO DE LA LLAVE,30,OZULUAMA DE MASCAREÑAS,121,AGUA NACIDA,2,31,13,18,3
VERACRUZ DE IGNACIO DE LA LLAVE,30,OZULUAMA DE MASCAREÑAS,121,ALTO DEL MORALITO,3,170,86,84,9
VERACRUZ DE IGNACIO DE LA LLAVE,30,OZULUAMA DE MASCAREÑAS,121,ALTO DEL POZO VIEJO,2,28,19,9,4
VERACRUZ DE IGNACIO DE LA LLAVE,30,OZULUAMA DE MASCAREÑAS,121,ALTO DEL TIGRE,2,42,19,23,4
VERACRUZ DE IGNACIO DE LA LLAVE,30,OZULUAMA DE MASCAREÑAS,121,ARROYO SAN ANTONIO,2,31,15,16,3
VERACRUZ DE IGNACIO DE LA LLAVE,30,OZULUAMA DE MASCAREÑAS,121,BELISARIO DOMÍNGUEZ (SAN GREGORIO),4,212,86,126,19
VERACRUZ DE IGNACIO DE LA LLAVE,30,OZULUAMA DE MASCAREÑAS,121,BUENOS AIRES,1,10,4,6,1
VERACRUZ DE IGNACIO DE LA LLAVE,30,OZULUAMA DE MASCAREÑAS,121,BUENOS AIRES (EL MANTE),1,5,2,3,1
VERACRUZ DE IGNACIO DE LA LLAVE,30,OZULUAMA DE MASCAREÑAS,121,CAHUAYOTES,3,25,12,13,3
VERACRUZ DE IGNACIO DE LA LLAVE,30,OZULUAMA DE MASCAREÑAS,121,CAMPANARIO,2,33,19,14,3
VERACRUZ DE IGNACIO DE LA LLAVE,30,OZULUAMA DE MASCAREÑAS,121,CHACA GORDA,1,8,6,2,1
VERACRUZ DE IGNACIO DE LA LLAVE,30,OZULUAMA DE MASCAREÑAS,121,COLONIA MORENO (ISLA JUAN A. RAMÍREZ),3,39,17,22,5
VERACRUZ DE IGNACIO DE LA LLAVE,30,OZULUAMA DE MASCAREÑAS,121,COYOLES,1,5,3,2,1
VERACRUZ DE IGNACIO DE LA LLAVE,30,OZULUAMA DE MASCAREÑAS,121,CUATRO PALMAS,3,62,27,35,6
VERACRUZ DE IGNACIO DE LA LLAVE,30,OZULUAMA DE MASCAREÑAS,121,CUCHARAS,4,372,179,193,21
VERACRUZ DE IGNACIO DE LA LLAVE,30,OZULUAMA DE MASCAREÑAS,121,DOS ESTERILLOS,1,8,4,4,2
VERACRUZ DE IGNACIO DE LA LLAVE,30,OZULUAMA DE MASCAREÑAS,121,EL BEJUCO,1,17,7,10,1
VERACRUZ DE IGNACIO DE LA LLAVE,30,OZULUAMA DE MASCAREÑAS,121,EL CAPITÁN,2,23,10,13,3
VERACRUZ DE IGNACIO DE LA LLAVE,30,OZULUAMA DE MASCAREÑAS,121,EL EBANITO,1,6,2,4,1
VERACRUZ DE IGNACIO DE LA LLAVE,30,OZULUAMA DE MASCAREÑAS,121,EL ESTRIBILLO,1,22,6,16,1
VERACRUZ DE IGNACIO DE LA LLAVE,30,OZULUAMA DE MASCAREÑAS,121,EL LIMÓN,1,13,7,6,1
VERACRUZ DE IGNACIO DE LA LLAVE,30,OZULUAMA DE MASCAREÑAS,121,EL MAGUEY (ISLA JUAN A. RAMÍREZ),1,13,9,4,1
VERACRUZ DE IGNACIO DE LA LLAVE,30,OZULUAMA DE MASCAREÑAS,121,EL MERCADO,3,64,22,42,6
VERACRUZ DE IGNACIO DE LA LLAVE,30,OZULUAMA DE MASCAREÑAS,121,EL MIRADOR,2,32,16,16,3
VERACRUZ DE IGNACIO DE LA LLAVE,30,OZULUAMA DE MASCAREÑAS,121,EL PARAÍSO,3,15,8,7,2
VERACRUZ DE IGNACIO DE LA LLAVE,30,OZULUAMA DE MASCAREÑAS,121,ESTACIÓN CHAPANCAL,1,4,4,0,1
VERACRUZ DE IGNACIO DE LA LLAVE,30,OZULUAMA DE MASCAREÑAS,121,ESTACIÓN CORONEL MASCAREÑAS,2,59,27,32,5
VERACRUZ DE IGNACIO DE LA LLAVE,30,OZULUAMA DE MASCAREÑAS,121,ESTACIÓN TANCEME,1,12,6,6,1
VERACRUZ DE IGNACIO DE LA LLAVE,30,OZULUAMA DE MASCAREÑAS,121,HORCONCITOS,3,65,29,36,8
VERACRUZ DE IGNACIO DE LA LLAVE,30,OZULUAMA DE MASCAREÑAS,121,HUIL BLANCO,2,23,8,15,2
VERACRUZ DE IGNACIO DE LA LLAVE,30,OZULUAMA DE MASCAREÑAS,121,LA BARTOLINA,2,28,15,13,3
VERACRUZ DE IGNACIO DE LA LLAVE,30,OZULUAMA DE MASCAREÑAS,121,LA ESPERANZA,1,8,5,3,1
VERACRUZ DE IGNACIO DE LA LLAVE,30,OZULUAMA DE MASCAREÑAS,121,LA FRONTERA,2,19,10,9,2
VERACRUZ DE IGNACIO DE LA LLAVE,30,OZULUAMA DE MASCAREÑAS,121,LA LAJA,3,155,73,82,18
VERACRUZ DE IGNACIO DE LA LLAVE,30,OZULUAMA DE MASCAREÑAS,121,LA LOMA,1,8,3,5,1
VERACRUZ DE IGNACIO DE LA LLAVE,30,OZULUAMA DE MASCAREÑAS,121,LA LOMITA,2,14,6,8,2
VERACRUZ DE IGNACIO DE LA LLAVE,30,OZULUAMA DE MASCAREÑAS,121,LA MINA,4,114,49,65,11
VERACRUZ DE IGNACIO DE LA LLAVE,30,OZULUAMA DE MASCAREÑAS,121,LA PUENTE,3,44,18,26,4
VERACRUZ DE IGNACIO DE LA LLAVE,30,OZULUAMA DE MASCAREÑAS,121,LAS BREAS,3,74,28,46,6
VERACRUZ DE IGNACIO DE LA LLAVE,30,OZULUAMA DE MASCAREÑAS,121,LAS MARAVILLAS,1,14,8,6,1
VERACRUZ DE IGNACIO DE LA LLAVE,30,OZULUAMA DE MASCAREÑAS,121,LOS PIÑONES,1,18,9,9,1
VERACRUZ DE IGNACIO DE LA LLAVE,30,OZULUAMA DE MASCAREÑAS,121,LOS ZAVALES,1,12,4,8,2
VERACRUZ DE IGNACIO DE LA LLAVE,30,OZULUAMA DE MASCAREÑAS,121,OZULUAMA DE MASCAREÑAS,10,1307,637,670,112
VERACRUZ DE IGNACIO DE LA LLAVE,30,OZULUAMA DE MASCAREÑAS,121,PALMAR ALTO,3,21,9,12,2
VERACRUZ DE IGNACIO DE LA LLAVE,30,OZULUAMA DE MASCAREÑAS,121,PASO REAL,4,205,99,106,10
VERACRUZ DE IGNACIO DE LA LLAVE,30,OZULUAMA DE MASCAREÑAS,121,POBLADO TIERRA Y LIBERTAD (PASO PIEDRA),4,182,74,108,12
VERACRUZ DE IGNACIO DE LA LLAVE,30,OZULUAMA DE MASCAREÑAS,121,POTRERILLOS,3,84,47,37,7
VERACRUZ DE IGNACIO DE LA LLAVE,30,OZULUAMA DE MASCAREÑAS,121,POZA DEL TULE,1,6,3,3,1
VERACRUZ DE IGNACIO DE LA LLAVE,30,OZULUAMA DE MASCAREÑAS,121,PUNTA DE LOMA ALTA,1,15,10,5,2
VERACRUZ DE IGNACIO DE LA LLAVE,30,OZULUAMA DE MASCAREÑAS,121,RANCHERÍA CEBADILLA,1,5,2,3,1
VERACRUZ DE IGNACIO DE LA LLAVE,30,OZULUAMA DE MASCAREÑAS,121,SAN JAVIER,1,6,2,4,1
VERACRUZ DE IGNACIO DE LA LLAVE,30,OZULUAMA DE MASCAREÑAS,121,SAN LUCIANO,3,35,17,18,4
VERACRUZ DE IGNACIO DE LA LLAVE,30,OZULUAMA DE MASCAREÑAS,121,SANTA MARIQUITA,2,26,14,12,2
VERACRUZ DE IGNACIO DE LA LLAVE,30,OZULUAMA DE MASCAREÑAS,121,SANTA ROSA (LOS CHOTES),1,9,4,5,1
VERACRUZ DE IGNACIO DE LA LLAVE,30,OZULUAMA DE MASCAREÑAS,121,TAMONTAO (PASO REAL),2,26,14,12,3
VERACRUZ DE IGNACIO DE LA LLAVE,30,OZULUAMA DE MASCAREÑAS,121,VÍCTOR SANTIAGO,1,56,30,26,5
VERACRUZ DE IGNACIO DE LA LLAVE,30,OZULUAMA DE MASCAREÑAS,121,VIJARRAS,1,4,3,1,1
VERACRUZ DE IGNACIO DE LA LLAVE,30,PAJAPAN,122,BATAJAPÁN,2,89,39,50,5
VERACRUZ DE IGNACIO DE LA LLAVE,30,PAJAPAN,122,BENITO JUÁREZ,2,37,26,11,3
VERACRUZ DE IGNACIO DE LA LLAVE,30,PAJAPAN,122,COSCAPAN,3,70,29,41,5
VERACRUZ DE IGNACIO DE LA LLAVE,30,PAJAPAN,122,EL MANGAL,3,94,47,47,5
VERACRUZ DE IGNACIO DE LA LLAVE,30,PAJAPAN,122,EL PESCADOR (EL MORAL),2,30,14,16,2
VERACRUZ DE IGNACIO DE LA LLAVE,30,PAJAPAN,122,JICACAL,3,187,86,101,12
VERACRUZ DE IGNACIO DE LA LLAVE,30,PAJAPAN,122,JOSÉ MARÍA MORELOS,1,3,1,2,1
VERACRUZ DE IGNACIO DE LA LLAVE,30,PAJAPAN,122,MINZAPAN,5,344,183,161,21
VERACRUZ DE IGNACIO DE LA LLAVE,30,PAJAPAN,122,NUEVO MANGAL,2,8,4,4,1
VERACRUZ DE IGNACIO DE LA LLAVE,30,PAJAPAN,122,PAJAPAN,12,2269,1088,1181,127
VERACRUZ DE IGNACIO DE LA LLAVE,30,PAJAPAN,122,PALMA REAL,2,9,3,6,2
VERACRUZ DE IGNACIO DE LA LLAVE,30,PAJAPAN,122,SAN JUAN VOLADOR,6,444,207,237,26
VERACRUZ DE IGNACIO DE LA LLAVE,30,PAJAPAN,122,SAN MIGUEL TEMOLOAPAN (NUEVO SAN MIGUEL),2,36,23,13,3
VERACRUZ DE IGNACIO DE LA LLAVE,30,PAJAPAN,122,TECOLAPA,2,54,28,26,3
VERACRUZ DE IGNACIO DE LA LLAVE,30,PAJAPAN,122,TORONJAL,2,317,156,161,16
VERACRUZ DE IGNACIO DE LA LLAVE,30,PAJAPAN,122,ÚRSULO GALVÁN,3,58,27,31,6
VERACRUZ DE IGNACIO DE LA LLAVE,30,PÁNUCO,123,ADOLFO LÓPEZ MATEOS,1,7,3,4,1
VERACRUZ DE IGNACIO DE LA LLAVE,30,PÁNUCO,123,AGUACATE,1,19,8,11,2
VERACRUZ DE IGNACIO DE LA LLAVE,30,PÁNUCO,123,ALTO DE VEGA CERCADA,1,24,16,8,2
VERACRUZ DE IGNACIO DE LA LLAVE,30,PÁNUCO,123,ALTO DEL CHIJOL (LOS MANGUITOS),3,70,32,38,5
VERACRUZ DE IGNACIO DE LA LLAVE,30,PÁNUCO,123,AMPLIACIÓN CARRIZAL,2,9,5,4,2
VERACRUZ DE IGNACIO DE LA LLAVE,30,PÁNUCO,123,ANTONIO J. BERMÚDEZ,3,196,94,102,9
VERACRUZ DE IGNACIO DE LA LLAVE,30,PÁNUCO,123,AQUILES SERDÁN,4,366,170,196,18
VERACRUZ DE IGNACIO DE LA LLAVE,30,PÁNUCO,123,BARROTERA DEL TAMESÍ,1,3,2,1,1
VERACRUZ DE IGNACIO DE LA LLAVE,30,PÁNUCO,123,BENITO JUÁREZ,3,32,20,12,3
VERACRUZ DE IGNACIO DE LA LLAVE,30,PÁNUCO,123,BERNABÉ SÁNCHEZ FUENTES,2,40,20,20,3
VERACRUZ DE IGNACIO DE LA LLAVE,30,PÁNUCO,123,BUENAVISTA (MAHUAVES),3,174,86,88,10
VERACRUZ DE IGNACIO DE LA LLAVE,30,PÁNUCO,123,CALENTADORES,4,192,96,96,15
VERACRUZ DE IGNACIO DE LA LLAVE,30,PÁNUCO,123,CERRO DE LA TORTUGA (ISLA LA TORTUGA),1,3,0,3,1
VERACRUZ DE IGNACIO DE LA LLAVE,30,PÁNUCO,123,CHIJOL DIECISIETE,4,53,31,22,6
VERACRUZ DE IGNACIO DE LA LLAVE,30,PÁNUCO,123,CHIJOLES,1,4,2,2,1
VERACRUZ DE IGNACIO DE LA LLAVE,30,PÁNUCO,123,CHINTÓN DE LAS FLORES,3,22,9,13,3
VERACRUZ DE IGNACIO DE LA LLAVE,30,PÁNUCO,123,CHUNCA,2,7,3,4,2
VERACRUZ DE IGNACIO DE LA LLAVE,30,PÁNUCO,123,CINCO DE SEPTIEMBRE,3,14,7,7,3
VERACRUZ DE IGNACIO DE LA LLAVE,30,PÁNUCO,123,COLONIA CHIJOLITO,1,5,2,3,1
VERACRUZ DE IGNACIO DE LA LLAVE,30,PÁNUCO,123,COLONIA MEDIO CAMINO,2,12,4,8,2
VERACRUZ DE IGNACIO DE LA LLAVE,30,PÁNUCO,123,COLONIA PILOTO,4,186,83,103,13
VERACRUZ DE IGNACIO DE LA LLAVE,30,PÁNUCO,123,CONFEDERACIÓN NACIONAL CAMPESINA (CANOAS),3,397,200,197,56
VERACRUZ DE IGNACIO DE LA LLAVE,30,PÁNUCO,123,EJIDO ESCUDO NACIONAL,1,8,3,5,1
VERACRUZ DE IGNACIO DE LA LLAVE,30,PÁNUCO,123,EJIDO TANCOCO,2,18,13,5,2
VERACRUZ DE IGNACIO DE LA LLAVE,30,PÁNUCO,123,EJIDO VICENTE GUERRERO (SEIS INTERNACIONAL),1,5,2,3,1
VERACRUZ DE IGNACIO DE LA LLAVE,30,PÁNUCO,123,EL CARACOL,1,12,3,9,1
VERACRUZ DE IGNACIO DE LA LLAVE,30,PÁNUCO,123,EL CARRIZAL,1,15,8,7,2
VERACRUZ DE IGNACIO DE LA LLAVE,30,PÁNUCO,123,EL CEPILLO,2,25,14,11,3
VERACRUZ DE IGNACIO DE LA LLAVE,30,PÁNUCO,123,EL JOBO (ALTO DEL JOBO),3,93,39,54,7
VERACRUZ DE IGNACIO DE LA LLAVE,30,PÁNUCO,123,EL MOLINO,6,316,157,159,21
VERACRUZ DE IGNACIO DE LA LLAVE,30,PÁNUCO,123,EL TERRERO,2,14,5,9,2
VERACRUZ DE IGNACIO DE LA LLAVE,30,PÁNUCO,123,ESCUDO NACIONAL,1,25,10,15,2
VERACRUZ DE IGNACIO DE LA LLAVE,30,PÁNUCO,123,ESTACIÓN MÉNDEZ,3,57,32,25,5
VERACRUZ DE IGNACIO DE LA LLAVE,30,PÁNUCO,123,EX-HACIENDA CHINTÓN (LA QUINA),3,171,88,83,12
VERACRUZ DE IGNACIO DE LA LLAVE,30,PÁNUCO,123,GUAYALEJO,6,491,251,240,43
VERACRUZ DE IGNACIO DE LA LLAVE,30,PÁNUCO,123,INDEPENDENCIA (LA PERIODISTA),2,34,15,19,3
VERACRUZ DE IGNACIO DE LA LLAVE,30,PÁNUCO,123,ISLETA GRANDE,2,25,11,14,4
VERACRUZ DE IGNACIO DE LA LLAVE,30,PÁNUCO,123,JABONCILLO,3,82,42,40,6
VERACRUZ DE IGNACIO DE LA LLAVE,30,PÁNUCO,123,JOPOY,3,65,32,33,6
VERACRUZ DE IGNACIO DE LA LLAVE,30,PÁNUCO,123,LA ANGOSTURA,3,55,17,38,4
VERACRUZ DE IGNACIO DE LA LLAVE,30,PÁNUCO,123,LA CORTADURA,2,31,13,18,3
VERACRUZ DE IGNACIO DE LA LLAVE,30,PÁNUCO,123,LA COSTA,4,186,78,108,14
VERACRUZ DE IGNACIO DE LA LLAVE,30,PÁNUCO,123,LA ESPERANZA,1,8,4,4,1
VERACRUZ DE IGNACIO DE LA LLAVE,30,PÁNUCO,123,LA HERRADURA,2,19,10,9,2
VERACRUZ DE IGNACIO DE LA LLAVE,30,PÁNUCO,123,LA PALMA,2,25,16,9,3
VERACRUZ DE IGNACIO DE LA LLAVE,30,PÁNUCO,123,LA PITAHAYA,2,75,32,43,8
VERACRUZ DE IGNACIO DE LA LLAVE,30,PÁNUCO,123,LA POTOSINA,1,14,7,7,1
VERACRUZ DE IGNACIO DE LA LLAVE,30,PÁNUCO,123,LA TRINIDAD,3,97,45,52,7
VERACRUZ DE IGNACIO DE LA LLAVE,30,PÁNUCO,123,LAS ÁNIMAS,2,33,20,13,3
VERACRUZ DE IGNACIO DE LA LLAVE,30,PÁNUCO,123,LAS CHACAS NUEVAS,2,28,19,9,3
VERACRUZ DE IGNACIO DE LA LLAVE,30,PÁNUCO,123,LAS FLORES,4,66,38,28,7
VERACRUZ DE IGNACIO DE LA LLAVE,30,PÁNUCO,123,LÁZARO CÁRDENAS,3,91,44,47,7
VERACRUZ DE IGNACIO DE LA LLAVE,30,PÁNUCO,123,MANLIO FABIO ALTAMIRANO,3,53,22,31,4
VERACRUZ DE IGNACIO DE LA LLAVE,30,PÁNUCO,123,MATA DE LA MONTEADA,2,26,15,11,3
VERACRUZ DE IGNACIO DE LA LLAVE,30,PÁNUCO,123,MAYORAZGO ALTO,1,6,4,2,1
VERACRUZ DE IGNACIO DE LA LLAVE,30,PÁNUCO,123,MAYORAZGO BAJO,2,57,27,30,4
VERACRUZ DE IGNACIO DE LA LLAVE,30,PÁNUCO,123,MIGUEL HIDALGO,1,16,9,7,1
VERACRUZ DE IGNACIO DE LA LLAVE,30,PÁNUCO,123,MIRADORES,4,72,39,33,6
VERACRUZ DE IGNACIO DE LA LLAVE,30,PÁNUCO,123,MIRAVEGAS,3,97,47,50,8
VERACRUZ DE IGNACIO DE LA LLAVE,30,PÁNUCO,123,MONTERREY,2,17,13,4,2
VERACRUZ DE IGNACIO DE LA LLAVE,30,PÁNUCO,123,MORALILLO,13,1218,560,658,60
VERACRUZ DE IGNACIO DE LA LLAVE,30,PÁNUCO,123,NUEVO CHICAYÁN,4,130,62,68,11
VERACRUZ DE IGNACIO DE LA LLAVE,30,PÁNUCO,123,NUEVO MICHOACÁN (LA MICHOACANA),4,186,94,92,18
VERACRUZ DE IGNACIO DE LA LLAVE,30,PÁNUCO,123,OCHOA,3,50,27,23,6
VERACRUZ DE IGNACIO DE LA LLAVE,30,PÁNUCO,123,OVIEDO,7,366,178,188,23
VERACRUZ DE IGNACIO DE LA LLAVE,30,PÁNUCO,123,PACIENCIA,3,50,23,27,5
VERACRUZ DE IGNACIO DE LA LLAVE,30,PÁNUCO,123,PALMAS REALES,3,59,27,32,5
VERACRUZ DE IGNACIO DE LA LLAVE,30,PÁNUCO,123,PÁNUCO,72,11263,5655,5608,884
VERACRUZ DE IGNACIO DE LA LLAVE,30,PÁNUCO,123,PÁNUCO (LA PITAHAYA) [NUEVO CENTRO DE POBLACIÓN],2,59,28,31,5
VERACRUZ DE IGNACIO DE LA LLAVE,30,PÁNUCO,123,PASO DE PIEDRAS,1,7,6,1,1
VERACRUZ DE IGNACIO DE LA LLAVE,30,PÁNUCO,123,PASO POTRERO,2,32,13,19,3
VERACRUZ DE IGNACIO DE LA LLAVE,30,PÁNUCO,123,PASO REAL (BUENAVISTA),2,58,31,27,5
VERACRUZ DE IGNACIO DE LA LLAVE,30,PÁNUCO,123,PAYTÉ,1,7,2,5,1
VERACRUZ DE IGNACIO DE LA LLAVE,30,PÁNUCO,123,PEMUXTITLA II,1,14,7,7,1
VERACRUZ DE IGNACIO DE LA LLAVE,30,PÁNUCO,123,POTRERO DE LA ISLETA,2,50,18,32,5
VERACRUZ DE IGNACIO DE LA LLAVE,30,PÁNUCO,123,PUNTA ARENA,4,49,26,23,6
VERACRUZ DE IGNACIO DE LA LLAVE,30,PÁNUCO,123,RAFAEL JACOBO GARCÍA,2,22,10,12,3
VERACRUZ DE IGNACIO DE LA LLAVE,30,PÁNUCO,123,REVENTADERO,4,118,45,73,9
VERACRUZ DE IGNACIO DE LA LLAVE,30,PÁNUCO,123,SALSIPUEDES,2,8,3,5,2
VERACRUZ DE IGNACIO DE LA LLAVE,30,PÁNUCO,123,SAN CRISTÓBAL,2,26,12,14,3
VERACRUZ DE IGNACIO DE LA LLAVE,30,PÁNUCO,123,SAN PEDRO,1,180,94,86,9
VERACRUZ DE IGNACIO DE LA LLAVE,30,PÁNUCO,123,TAMANTE,2,33,16,17,3
VERACRUZ DE IGNACIO DE LA LLAVE,30,PÁNUCO,123,TAMBOYOCHE Y TOPILA,1,10,4,6,1
VERACRUZ DE IGNACIO DE LA LLAVE,30,PÁNUCO,123,TAMOS,9,772,387,385,49
VERACRUZ DE IGNACIO DE LA LLAVE,30,PÁNUCO,123,TAMPALACHE E ISLETA GRANDE (LAS ÁNIMAS),1,66,33,33,5
VERACRUZ DE IGNACIO DE LA LLAVE,30,PÁNUCO,123,TAMPUCHE,2,42,25,17,5
VERACRUZ DE IGNACIO DE LA LLAVE,30,PÁNUCO,123,TANCHICUÍN BOCA DEL ESTERO,3,42,18,24,4
VERACRUZ DE IGNACIO DE LA LLAVE,30,PÁNUCO,123,TANCHICUÍN PIEDRAS,2,11,8,3,2
VERACRUZ DE IGNACIO DE LA LLAVE,30,PÁNUCO,123,TLAXCALITA,2,31,19,12,3
VERACRUZ DE IGNACIO DE LA LLAVE,30,PÁNUCO,123,ÚRSULO GALVÁN,3,31,13,18,4
VERACRUZ DE IGNACIO DE LA LLAVE,30,PÁNUCO,123,VEGA CERCADA,2,41,19,22,4
VERACRUZ DE IGNACIO DE LA LLAVE,30,PÁNUCO,123,VEGA DE OTATES,5,248,113,135,17
VERACRUZ DE IGNACIO DE LA LLAVE,30,PÁNUCO,123,VICHINCHIJOL NUEVO,1,41,17,24,3
VERACRUZ DE IGNACIO DE LA LLAVE,30,PÁNUCO,123,VILLA CACALILAO DOS,5,337,168,169,29
VERACRUZ DE IGNACIO DE LA LLAVE,30,PÁNUCO,123,VUELTA DE LAS ADJUNTAS,1,11,6,5,1
VERACRUZ DE IGNACIO DE LA LLAVE,30,PAPANTLA,124,ADOLFO RUIZ CORTINES,6,419,216,203,34
VERACRUZ DE IGNACIO DE LA LLAVE,30,PAPANTLA,124,AGUA DULCE,8,1167,603,564,68
VERACRUZ DE IGNACIO DE LA LLAVE,30,PAPANTLA,124,ÁLAMO,2,18,5,13,2
VERACRUZ DE IGNACIO DE LA LLAVE,30,PAPANTLA,124,ARROYO COLORADO,3,91,48,43,6
VERACRUZ DE IGNACIO DE LA LLAVE,30,PAPANTLA,124,ARROYO DE CAÑAS,2,19,10,9,2
VERACRUZ DE IGNACIO DE LA LLAVE,30,PAPANTLA,124,ARROYO DE LA LAJA,2,31,13,18,3
VERACRUZ DE IGNACIO DE LA LLAVE,30,PAPANTLA,124,ARROYO DEL ARCO,3,154,61,93,11
VERACRUZ DE IGNACIO DE LA LLAVE,30,PAPANTLA,124,ARROYO GRANDE NÚMERO DOS,3,100,49,51,9
VERACRUZ DE IGNACIO DE LA LLAVE,30,PAPANTLA,124,ARROYO GRANDE NÚMERO UNO,2,48,26,22,3
VERACRUZ DE IGNACIO DE LA LLAVE,30,PAPANTLA,124,ARROYO VERDE,3,40,18,22,4
VERACRUZ DE IGNACIO DE LA LLAVE,30,PAPANTLA,124,ARROYO VERDE NÚMERO UNO,2,63,30,33,5
VERACRUZ DE IGNACIO DE LA LLAVE,30,PAPANTLA,124,AUGUSTO GÓMEZ VILLANUEVA,3,112,53,59,8
VERACRUZ DE IGNACIO DE LA LLAVE,30,PAPANTLA,124,BELISARIO DOMÍNGUEZ,4,218,105,113,14
VERACRUZ DE IGNACIO DE LA LLAVE,30,PAPANTLA,124,BENITO JUÁREZ,2,48,21,27,4
VERACRUZ DE IGNACIO DE LA LLAVE,30,PAPANTLA,124,CARISTAY,4,368,188,180,23
VERACRUZ DE IGNACIO DE LA LLAVE,30,PAPANTLA,124,CARRIZAL,6,491,253,238,32
VERACRUZ DE IGNACIO DE LA LLAVE,30,PAPANTLA,124,CASA BLANCA,2,11,6,5,2
VERACRUZ DE IGNACIO DE LA LLAVE,30,PAPANTLA,124,CAZUELAS,2,39,19,20,4
VERACRUZ DE IGNACIO DE LA LLAVE,30,PAPANTLA,124,CERRO BLANCO,3,54,18,36,5
VERACRUZ DE IGNACIO DE LA LLAVE,30,PAPANTLA,124,CERRO DE LAS FLORES,2,30,18,12,3
VERACRUZ DE IGNACIO DE LA LLAVE,30,PAPANTLA,124,CERRO DEL CARBÓN,4,155,82,73,13
VERACRUZ DE IGNACIO DE LA LLAVE,30,PAPANTLA,124,CERRO DEL MESÓN,2,27,16,11,2
VERACRUZ DE IGNACIO DE LA LLAVE,30,PAPANTLA,124,CERRO GRANDE (ADOLFO RUIZ CORTINES),1,13,4,9,1
VERACRUZ DE IGNACIO DE LA LLAVE,30,PAPANTLA,124,CERRO GRANDE DOS,4,196,92,104,17
VERACRUZ DE IGNACIO DE LA LLAVE,30,PAPANTLA,124,CHIJOL,3,66,31,35,4
VERACRUZ DE IGNACIO DE LA LLAVE,30,PAPANTLA,124,CONGREGACIÓN TARACUÁN,5,156,75,81,13
VERACRUZ DE IGNACIO DE LA LLAVE,30,PAPANTLA,124,CRUZ VERDE,2,25,11,14,4
VERACRUZ DE IGNACIO DE LA LLAVE,30,PAPANTLA,124,CUYUXQUIHUI,3,79,36,43,6
VERACRUZ DE IGNACIO DE LA LLAVE,30,PAPANTLA,124,DONATO MÁRQUEZ AZUARA,3,189,82,107,13
VERACRUZ DE IGNACIO DE LA LLAVE,30,PAPANTLA,124,EL AGUACATE,1,9,5,4,1
VERACRUZ DE IGNACIO DE LA LLAVE,30,PAPANTLA,124,EL CABELLAL,3,169,86,83,12
VERACRUZ DE IGNACIO DE LA LLAVE,30,PAPANTLA,124,EL CALVARIO,1,4,2,2,1
VERACRUZ DE IGNACIO DE LA LLAVE,30,PAPANTLA,124,EL CEDRAL,3,118,50,68,10
VERACRUZ DE IGNACIO DE LA LLAVE,30,PAPANTLA,124,EL CEDRO,4,248,125,123,21
VERACRUZ DE IGNACIO DE LA LLAVE,30,PAPANTLA,124,EL CHOTE,8,371,169,202,30
VERACRUZ DE IGNACIO DE LA LLAVE,30,PAPANTLA,124,EL COPAL,2,28,12,16,3
VERACRUZ DE IGNACIO DE LA LLAVE,30,PAPANTLA,124,EL EDÉN,2,51,27,24,4
VERACRUZ DE IGNACIO DE LA LLAVE,30,PAPANTLA,124,EL ESCOLÍN,4,147,69,78,12
VERACRUZ DE IGNACIO DE LA LLAVE,30,PAPANTLA,124,EL ESFUERZO,2,46,21,25,4
VERACRUZ DE IGNACIO DE LA LLAVE,30,PAPANTLA,124,EL PAHUAL,2,56,26,30,5
VERACRUZ DE IGNACIO DE LA LLAVE,30,PAPANTLA,124,EL PALMAR,5,164,89,75,13
VERACRUZ DE IGNACIO DE LA LLAVE,30,PAPANTLA,124,EL PALMAR (KILÓMETRO 40),4,390,188,202,27
VERACRUZ DE IGNACIO DE LA LLAVE,30,PAPANTLA,124,EL PALMITO (KILÓMETRO 44),2,37,16,21,4
VERACRUZ DE IGNACIO DE LA LLAVE,30,PAPANTLA,124,EL PITAL,4,350,169,181,26
VERACRUZ DE IGNACIO DE LA LLAVE,30,PAPANTLA,124,EL PORVENIR NÚMERO DOS,4,174,88,86,13
VERACRUZ DE IGNACIO DE LA LLAVE,30,PAPANTLA,124,EL REMOLINO,5,342,172,170,21
VERACRUZ DE IGNACIO DE LA LLAVE,30,PAPANTLA,124,EL TAJÍN,5,620,299,321,37
VERACRUZ DE IGNACIO DE LA LLAVE,30,PAPANTLA,124,EL TRIUNFO,2,26,14,12,3
VERACRUZ DE IGNACIO DE LA LLAVE,30,PAPANTLA,124,EL VOLADOR,6,422,221,201,29
VERACRUZ DE IGNACIO DE LA LLAVE,30,PAPANTLA,124,EMILIANO ZAPATA,4,342,171,171,22
VERACRUZ DE IGNACIO DE LA LLAVE,30,PAPANTLA,124,FRANCISCO I. MADERO,4,380,195,185,22
VERACRUZ DE IGNACIO DE LA LLAVE,30,PAPANTLA,124,FRANCISCO SARABIA,4,247,139,108,16
VERACRUZ DE IGNACIO DE LA LLAVE,30,PAPANTLA,124,FRANCISCO VILLA,3,176,79,97,12
VERACRUZ DE IGNACIO DE LA LLAVE,30,PAPANTLA,124,GENERAL LÁZARO CÁRDENAS,3,44,23,21,6
VERACRUZ DE IGNACIO DE LA LLAVE,30,PAPANTLA,124,GILDARDO MUÑOZ,3,123,67,56,9
VERACRUZ DE IGNACIO DE LA LLAVE,30,PAPANTLA,124,GUADALUPE VICTORIA,3,139,76,63,11
VERACRUZ DE IGNACIO DE LA LLAVE,30,PAPANTLA,124,HELADIO GARCÍA VÁZQUEZ,2,33,14,19,3
VERACRUZ DE IGNACIO DE LA LLAVE,30,PAPANTLA,124,IGNACIO ALLENDE,4,213,117,96,13
VERACRUZ DE IGNACIO DE LA LLAVE,30,PAPANTLA,124,INSURGENTES SOCIALISTAS,3,232,125,107,12
VERACRUZ DE IGNACIO DE LA LLAVE,30,PAPANTLA,124,ISLA DE JUAN ROSAS,2,59,24,35,5
VERACRUZ DE IGNACIO DE LA LLAVE,30,PAPANTLA,124,JOLOAPAN,4,212,104,108,17
VERACRUZ DE IGNACIO DE LA LLAVE,30,PAPANTLA,124,JORGE SERDÁN,3,59,27,32,4
VERACRUZ DE IGNACIO DE LA LLAVE,30,PAPANTLA,124,JOSÉ MARÍA MORELOS,4,227,113,114,17
VERACRUZ DE IGNACIO DE LA LLAVE,30,PAPANTLA,124,LA CADENA,2,13,7,6,2
VERACRUZ DE IGNACIO DE LA LLAVE,30,PAPANTLA,124,LA CEIBA,1,25,14,11,2
VERACRUZ DE IGNACIO DE LA LLAVE,30,PAPANTLA,124,LA COLMENA (LA LOMA),3,70,29,41,8
VERACRUZ DE IGNACIO DE LA LLAVE,30,PAPANTLA,124,LA CONCHA,3,113,45,68,12
VERACRUZ DE IGNACIO DE LA LLAVE,30,PAPANTLA,124,LA GRANDEZA,4,248,114,134,17
VERACRUZ DE IGNACIO DE LA LLAVE,30,PAPANTLA,124,LA GUÁSIMA,5,510,231,279,25
VERACRUZ DE IGNACIO DE LA LLAVE,30,PAPANTLA,124,LA ISLA,4,110,47,63,11
VERACRUZ DE IGNACIO DE LA LLAVE,30,PAPANTLA,124,LA LAGUNA,3,152,81,71,15
VERACRUZ DE IGNACIO DE LA LLAVE,30,PAPANTLA,124,LA MARTINICA,2,41,25,16,3
VERACRUZ DE IGNACIO DE LA LLAVE,30,PAPANTLA,124,LA REFORMA PASO DEL CORREO,3,136,69,67,11
VERACRUZ DE IGNACIO DE LA LLAVE,30,PAPANTLA,124,LA SABANA,3,70,33,37,7
VERACRUZ DE IGNACIO DE LA LLAVE,30,PAPANTLA,124,LA VICTORIA (KILÓMETRO 47),4,525,253,272,33
VERACRUZ DE IGNACIO DE LA LLAVE,30,PAPANTLA,124,LAS CASITAS,2,36,16,20,3
VERACRUZ DE IGNACIO DE LA LLAVE,30,PAPANTLA,124,LAS MESILLAS,3,19,8,11,2
VERACRUZ DE IGNACIO DE LA LLAVE,30,PAPANTLA,124,LICENCIADO GUSTAVO DÍAZ ORDAZ,3,61,33,28,5
VERACRUZ DE IGNACIO DE LA LLAVE,30,PAPANTLA,124,LINDERO VOLADOR,2,41,16,25,3
VERACRUZ DE IGNACIO DE LA LLAVE,30,PAPANTLA,124,LLANOS DE SAN LORENZO,3,107,39,68,9
VERACRUZ DE IGNACIO DE LA LLAVE,30,PAPANTLA,124,LOMAS VERDES,1,31,13,18,2
VERACRUZ DE IGNACIO DE LA LLAVE,30,PAPANTLA,124,LOS JIMÉNEZ,1,6,4,2,1
VERACRUZ DE IGNACIO DE LA LLAVE,30,PAPANTLA,124,LUIS DONALDO COLOSIO,3,26,13,13,3
VERACRUZ DE IGNACIO DE LA LLAVE,30,PAPANTLA,124,LUIS ECHEVERRÍA,2,62,28,34,4
VERACRUZ DE IGNACIO DE LA LLAVE,30,PAPANTLA,124,LUIS SALAS GARCÍA,3,133,57,76,10
VERACRUZ DE IGNACIO DE LA LLAVE,30,PAPANTLA,124,MANANTIAL,3,61,34,27,5
VERACRUZ DE IGNACIO DE LA LLAVE,30,PAPANTLA,124,MESA CHICA LA GLORIA,3,110,48,62,9
VERACRUZ DE IGNACIO DE LA LLAVE,30,PAPANTLA,124,MESA CHICA NUEVA (EL CORCHO),2,81,35,46,5
VERACRUZ DE IGNACIO DE LA LLAVE,30,PAPANTLA,124,MIGUEL ALEMÁN VELASCO,2,30,11,19,3
VERACRUZ DE IGNACIO DE LA LLAVE,30,PAPANTLA,124,MIGUEL HIDALGO,2,44,26,18,4
VERACRUZ DE IGNACIO DE LA LLAVE,30,PAPANTLA,124,MIZANTÉCATL,2,108,52,56,9
VERACRUZ DE IGNACIO DE LA LLAVE,30,PAPANTLA,124,MORGADAL PARTE ALTA 2,7,527,258,269,36
VERACRUZ DE IGNACIO DE LA LLAVE,30,PAPANTLA,124,MOZUTLA,4,220,112,108,14
VERACRUZ DE IGNACIO DE LA LLAVE,30,PAPANTLA,124,OCOTILLAR,2,31,13,18,3
VERACRUZ DE IGNACIO DE LA LLAVE,30,PAPANTLA,124,OJITAL NUEVO,2,47,21,26,4
VERACRUZ DE IGNACIO DE LA LLAVE,30,PAPANTLA,124,OJITAL VIEJO,3,131,61,70,9
VERACRUZ DE IGNACIO DE LA LLAVE,30,PAPANTLA,124,PABANCO,3,99,47,52,7
VERACRUZ DE IGNACIO DE LA LLAVE,30,PAPANTLA,124,PAJASCO LIMONAR,3,96,42,54,9
VERACRUZ DE IGNACIO DE LA LLAVE,30,PAPANTLA,124,PAPANTLA DE OLARTE,97,11543,5852,5691,792
VERACRUZ DE IGNACIO DE LA LLAVE,30,PAPANTLA,124,PASO DE LAS LIMAS,2,39,22,17,3
VERACRUZ DE IGNACIO DE LA LLAVE,30,PAPANTLA,124,PASO DE VALENCIA,4,240,113,127,18
VERACRUZ DE IGNACIO DE LA LLAVE,30,PAPANTLA,124,PASO DEL CORREO,4,370,197,173,21
VERACRUZ DE IGNACIO DE LA LLAVE,30,PAPANTLA,124,PÍPILA,3,25,18,7,4
VERACRUZ DE IGNACIO DE LA LLAVE,30,PAPANTLA,124,PLAN DE HIDALGO,3,223,124,99,12
VERACRUZ DE IGNACIO DE LA LLAVE,30,PAPANTLA,124,PLAN DE LIMÓN,3,92,43,49,8
VERACRUZ DE IGNACIO DE LA LLAVE,30,PAPANTLA,124,PLAN DE LOS MANGOS,3,168,78,90,10
VERACRUZ DE IGNACIO DE LA LLAVE,30,PAPANTLA,124,PLAN DEL PALMAR,4,268,128,140,14
VERACRUZ DE IGNACIO DE LA LLAVE,30,PAPANTLA,124,POLUTLA,4,359,155,204,23
VERACRUZ DE IGNACIO DE LA LLAVE,30,PAPANTLA,124,PORVENIR NÚMERO UNO,2,76,47,29,7
VERACRUZ DE IGNACIO DE LA LLAVE,30,PAPANTLA,124,POZA LARGA,4,81,42,39,9
VERACRUZ DE IGNACIO DE LA LLAVE,30,PAPANTLA,124,POZA VERDE,4,141,70,71,12
VERACRUZ DE IGNACIO DE LA LLAVE,30,PAPANTLA,124,PRIMERO DE MAYO,3,90,37,53,8
VERACRUZ DE IGNACIO DE LA LLAVE,30,PAPANTLA,124,PUEBLILLO,7,580,285,295,34
VERACRUZ DE IGNACIO DE LA LLAVE,30,PAPANTLA,124,PUENTE DE PIEDRA,4,266,125,141,25
VERACRUZ DE IGNACIO DE LA LLAVE,30,PAPANTLA,124,PUXTLA,4,132,61,71,11
VERACRUZ DE IGNACIO DE LA LLAVE,30,PAPANTLA,124,RAFAEL ROSAS,3,109,56,53,8
VERACRUZ DE IGNACIO DE LA LLAVE,30,PAPANTLA,124,RANCHO NUEVO SAN JOSÉ,2,37,25,12,3
VERACRUZ DE IGNACIO DE LA LLAVE,30,PAPANTLA,124,RANCHO PLAYA,3,90,48,42,10
VERACRUZ DE IGNACIO DE LA LLAVE,30,PAPANTLA,124,REFORMA ESCOLÍN,4,262,131,131,17
VERACRUZ DE IGNACIO DE LA LLAVE,30,PAPANTLA,124,RESIDENCIAL TAJÍN,1,28,15,13,4
VERACRUZ DE IGNACIO DE LA LLAVE,30,PAPANTLA,124,RÍO CLARO,2,55,27,28,4
VERACRUZ DE IGNACIO DE LA LLAVE,30,PAPANTLA,124,RIVA PALACIO,2,40,18,22,4
VERACRUZ DE IGNACIO DE LA LLAVE,30,PAPANTLA,124,RODOLFO CURTI,2,54,25,29,4
VERACRUZ DE IGNACIO DE LA LLAVE,30,PAPANTLA,124,SABANA DE LA ESTANCIA,2,15,5,10,2
VERACRUZ DE IGNACIO DE LA LLAVE,30,PAPANTLA,124,SAN ANDRÉS,1,15,6,9,1
VERACRUZ DE IGNACIO DE LA LLAVE,30,PAPANTLA,124,SAN ANTONIO CARRIZAL,2,42,23,19,4
VERACRUZ DE IGNACIO DE LA LLAVE,30,PAPANTLA,124,SAN ANTONIO OJITAL,1,6,2,4,1
VERACRUZ DE IGNACIO DE LA LLAVE,30,PAPANTLA,124,SAN GOTARDO,3,82,41,41,7
VERACRUZ DE IGNACIO DE LA LLAVE,30,PAPANTLA,124,SAN JOSÉ DE LAS LAJAS,2,43,22,21,3
VERACRUZ DE IGNACIO DE LA LLAVE,30,PAPANTLA,124,SAN JUAN,3,29,13,16,3
VERACRUZ DE IGNACIO DE LA LLAVE,30,PAPANTLA,124,SAN LORENZO,5,197,91,106,11
VERACRUZ DE IGNACIO DE LA LLAVE,30,PAPANTLA,124,SAN MANUEL,1,20,7,13,2
VERACRUZ DE IGNACIO DE LA LLAVE,30,PAPANTLA,124,SAN PABLO,4,163,83,80,15
VERACRUZ DE IGNACIO DE LA LLAVE,30,PAPANTLA,124,SANTA ÁGUEDA,3,157,71,86,11
VERACRUZ DE IGNACIO DE LA LLAVE,30,PAPANTLA,124,SANTA ROSA DE LIMA,2,46,22,24,4
VERACRUZ DE IGNACIO DE LA LLAVE,30,PAPANTLA,124,SERAFÍN OLARTE,5,343,158,185,22
VERACRUZ DE IGNACIO DE LA LLAVE,30,PAPANTLA,124,SOLTEROS DE JUAN ROSAS,2,24,14,10,2
VERACRUZ DE IGNACIO DE LA LLAVE,30,PAPANTLA,124,SOMBRERETE,5,206,96,110,17
VERACRUZ DE IGNACIO DE LA LLAVE,30,PAPANTLA,124,TALAXCA,3,56,28,28,5
VERACRUZ DE IGNACIO DE LA LLAVE,30,PAPANTLA,124,TENIENTE CORONEL SIMÓN TIBURCIO,2,15,9,6,2
VERACRUZ DE IGNACIO DE LA LLAVE,30,PAPANTLA,124,TENIXTEPEC,4,146,83,63,14
VERACRUZ DE IGNACIO DE LA LLAVE,30,PAPANTLA,124,TLAHUANAPA,4,149,70,79,13
VERACRUZ DE IGNACIO DE LA LLAVE,30,PAPANTLA,124,TOTOMOXTLE,5,263,135,128,18
VERACRUZ DE IGNACIO DE LA LLAVE,30,PAPANTLA,124,TRES CRUCES,2,38,20,18,4
VERACRUZ DE IGNACIO DE LA LLAVE,30,PAPANTLA,124,TRES FLORES,3,195,84,111,9
VERACRUZ DE IGNACIO DE LA LLAVE,30,PAPANTLA,124,TRES NACIONES,2,19,10,9,3
VERACRUZ DE IGNACIO DE LA LLAVE,30,PAPANTLA,124,UNIÓN Y PROGRESO,5,165,73,92,12
VERACRUZ DE IGNACIO DE LA LLAVE,30,PAPANTLA,124,ÚRSULO GALVÁN,2,66,36,30,6
VERACRUZ DE IGNACIO DE LA LLAVE,30,PAPANTLA,124,VALSEQUILLO,4,162,76,86,12
VERACRUZ DE IGNACIO DE LA LLAVE,30,PAPANTLA,124,VEINTE DE NOVIEMBRE,2,59,29,30,4
VERACRUZ DE IGNACIO DE LA LLAVE,30,PAPANTLA,124,VENUSTIANO CARRANZA,2,24,12,12,2
VERACRUZ DE IGNACIO DE LA LLAVE,30,PAPANTLA,124,VICENTE GUERRERO,1,3,1,2,1
VERACRUZ DE IGNACIO DE LA LLAVE,30,PAPANTLA,124,VICENTE HERRERA,4,388,203,185,25
VERACRUZ DE IGNACIO DE LA LLAVE,30,PAPANTLA,124,VISTA HERMOSA DE ANAYA,2,76,37,39,7
VERACRUZ DE IGNACIO DE LA LLAVE,30,PAPANTLA,124,VISTA HERMOSA DE JUÁREZ,2,53,19,34,4
VERACRUZ DE IGNACIO DE LA LLAVE,30,PAPANTLA,124,VISTA HERMOSA DE MADERO,4,244,117,127,16
VERACRUZ DE IGNACIO DE LA LLAVE,30,PAPANTLA,124,ZAPOTAL SANTA CRUZ,2,47,21,26,3
VERACRUZ DE IGNACIO DE LA LLAVE,30,PASO DEL MACHO,125,ACTOPAN,2,30,18,12,3
VERACRUZ DE IGNACIO DE LA LLAVE,30,PASO DEL MACHO,125,BENITO JUÁREZ,3,132,76,56,8
VERACRUZ DE IGNACIO DE LA LLAVE,30,PASO DEL MACHO,125,BUENOS AIRES,3,94,44,50,7
VERACRUZ DE IGNACIO DE LA LLAVE,30,PASO DEL MACHO,125,CAÑAMAZAL,1,5,4,1,1
VERACRUZ DE IGNACIO DE LA LLAVE,30,PASO DEL MACHO,125,CARRIZAL,2,49,20,29,4
VERACRUZ DE IGNACIO DE LA LLAVE,30,PASO DEL MACHO,125,CERRO AZUL,4,178,86,92,13
VERACRUZ DE IGNACIO DE LA LLAVE,30,PASO DEL MACHO,125,COLONIA CABRERA,2,56,30,26,3
VERACRUZ DE IGNACIO DE LA LLAVE,30,PASO DEL MACHO,125,COLONIA LOS ALMENDROS,1,14,8,6,1
VERACRUZ DE IGNACIO DE LA LLAVE,30,PASO DEL MACHO,125,COMALCOÁHUITL,2,19,9,10,2
VERACRUZ DE IGNACIO DE LA LLAVE,30,PASO DEL MACHO,125,EL ACACIO,3,63,36,27,5
VERACRUZ DE IGNACIO DE LA LLAVE,30,PASO DEL MACHO,125,EL ANGOSTILLO,2,10,3,7,1
VERACRUZ DE IGNACIO DE LA LLAVE,30,PASO DEL MACHO,125,EL BRINCO,3,69,30,39,5
VERACRUZ DE IGNACIO DE LA LLAVE,30,PASO DEL MACHO,125,EL CEDRO,1,5,5,0,1
VERACRUZ DE IGNACIO DE LA LLAVE,30,PASO DEL MACHO,125,EL RANCHITO,2,21,9,12,2
VERACRUZ DE IGNACIO DE LA LLAVE,30,PASO DEL MACHO,125,EL ZAPOTAL,4,121,57,64,8
VERACRUZ DE IGNACIO DE LA LLAVE,30,PASO DEL MACHO,125,EMILIANO ZAPATA,1,149,73,76,8
VERACRUZ DE IGNACIO DE LA LLAVE,30,PASO DEL MACHO,125,FRANCISCO VILLA,3,38,19,19,4
VERACRUZ DE IGNACIO DE LA LLAVE,30,PASO DEL MACHO,125,LA DEFENSA,3,65,28,37,4
VERACRUZ DE IGNACIO DE LA LLAVE,30,PASO DEL MACHO,125,LA GLORIA,1,4,3,1,1
VERACRUZ DE IGNACIO DE LA LLAVE,30,PASO DEL MACHO,125,LA MARIPOSA,2,91,43,48,6
VERACRUZ DE IGNACIO DE LA LLAVE,30,PASO DEL MACHO,125,LA REFORMA,1,11,4,7,2
VERACRUZ DE IGNACIO DE LA LLAVE,30,PASO DEL MACHO,125,LA UNIÓN DE LOS REYES,1,11,6,5,1
VERACRUZ DE IGNACIO DE LA LLAVE,30,PASO DEL MACHO,125,LAS MARIPOSAS,1,11,5,6,1
VERACRUZ DE IGNACIO DE LA LLAVE,30,PASO DEL MACHO,125,LOMA DE ENMEDIO,2,10,5,5,2
VERACRUZ DE IGNACIO DE LA LLAVE,30,PASO DEL MACHO,125,LOMA DEL CHIVO,1,9,6,3,1
VERACRUZ DE IGNACIO DE LA LLAVE,30,PASO DEL MACHO,125,LOMA DEL CRISTO,2,13,8,5,2
VERACRUZ DE IGNACIO DE LA LLAVE,30,PASO DEL MACHO,125,LOMA DEL NANCHE,2,27,8,19,3
VERACRUZ DE IGNACIO DE LA LLAVE,30,PASO DEL MACHO,125,LOS GARCÍA,2,6,4,2,2
VERACRUZ DE IGNACIO DE LA LLAVE,30,PASO DEL MACHO,125,MATA CALABAZA,2,6,1,5,1
VERACRUZ DE IGNACIO DE LA LLAVE,30,PASO DEL MACHO,125,MATA DE VARAS,3,108,62,46,6
VERACRUZ DE IGNACIO DE LA LLAVE,30,PASO DEL MACHO,125,MATA NARANJO,3,102,47,55,6
VERACRUZ DE IGNACIO DE LA LLAVE,30,PASO DEL MACHO,125,MORÓN DOS,2,5,2,3,1
VERACRUZ DE IGNACIO DE LA LLAVE,30,PASO DEL MACHO,125,PASO AZÚCAR,2,10,1,9,2
VERACRUZ DE IGNACIO DE LA LLAVE,30,PASO DEL MACHO,125,PASO DEL BURRO,2,7,3,4,2
VERACRUZ DE IGNACIO DE LA LLAVE,30,PASO DEL MACHO,125,PASO DEL MACHO,19,3575,1890,1685,211
VERACRUZ DE IGNACIO DE LA LLAVE,30,PASO DEL MACHO,125,PASO FRIJOL,3,31,12,19,3
VERACRUZ DE IGNACIO DE LA LLAVE,30,PASO DEL MACHO,125,PASO GAVILÁN,1,24,10,14,2
VERACRUZ DE IGNACIO DE LA LLAVE,30,PASO DEL MACHO,125,PASO GRANDE,3,95,47,48,7
VERACRUZ DE IGNACIO DE LA LLAVE,30,PASO DEL MACHO,125,PASO GRANDE UNO (MATA ZOPILOTE),2,6,4,2,2
VERACRUZ DE IGNACIO DE LA LLAVE,30,PASO DEL MACHO,125,PASO ILAMA,2,27,11,16,2
VERACRUZ DE IGNACIO DE LA LLAVE,30,PASO DEL MACHO,125,PASO MULATO,3,198,103,95,10
VERACRUZ DE IGNACIO DE LA LLAVE,30,PASO DEL MACHO,125,PASO VAQUERO,2,20,16,4,2
VERACRUZ DE IGNACIO DE LA LLAVE,30,PASO DEL MACHO,125,PIEDRA FINA,1,4,4,0,1
VERACRUZ DE IGNACIO DE LA LLAVE,30,PASO DEL MACHO,125,POCITOS Y CAÑAMAZO,2,53,24,29,4
VERACRUZ DE IGNACIO DE LA LLAVE,30,PASO DEL MACHO,125,POTRERILLO,4,55,28,27,5
VERACRUZ DE IGNACIO DE LA LLAVE,30,PASO DEL MACHO,125,POTRERO GRANDE (REMUDADERO RANCHO NUEVO),3,60,27,33,4
VERACRUZ DE IGNACIO DE LA LLAVE,30,PASO DEL MACHO,125,RANCHO CHICO,2,6,3,3,1
VERACRUZ DE IGNACIO DE LA LLAVE,30,PASO DEL MACHO,125,RANCHO NUEVO,1,32,15,17,2
VERACRUZ DE IGNACIO DE LA LLAVE,30,PASO DEL MACHO,125,RINCÓN DE LOS TOROS,3,99,54,45,7
VERACRUZ DE IGNACIO DE LA LLAVE,30,PASO DEL MACHO,125,SALVADOR ESQUER APODACA [UNIDAD HABITACIONAL],2,47,26,21,3
VERACRUZ DE IGNACIO DE LA LLAVE,30,PASO DEL MACHO,125,SAN JOSÉ BALSA CAMARÓN (LA COLMENA),4,208,105,103,14
VERACRUZ DE IGNACIO DE LA LLAVE,30,PASO DEL MACHO,125,SANTA ROSA,3,19,13,6,2
VERACRUZ DE IGNACIO DE LA LLAVE,30,PASO DE OVEJAS,126,ACAZÓNICA,4,213,114,99,15
VERACRUZ DE IGNACIO DE LA LLAVE,30,PASO DE OVEJAS,126,ANGOSTILLO,4,106,47,59,8
VERACRUZ DE IGNACIO DE LA LLAVE,30,PASO DE OVEJAS,126,BANDERA DE JUÁREZ,3,114,53,61,8
VERACRUZ DE IGNACIO DE LA LLAVE,30,PASO DE OVEJAS,126,BUENA VISTA,2,18,7,11,2
VERACRUZ DE IGNACIO DE LA LLAVE,30,PASO DE OVEJAS,126,CANTARRANAS,3,75,36,39,8
VERACRUZ DE IGNACIO DE LA LLAVE,30,PASO DE OVEJAS,126,CARRETAS,2,17,14,3,3
VERACRUZ DE IGNACIO DE LA LLAVE,30,PASO DE OVEJAS,126,CERRO GUZMÁN,3,198,92,106,13
VERACRUZ DE IGNACIO DE LA LLAVE,30,PASO DE OVEJAS,126,EL COCUYO,1,53,30,23,3
VERACRUZ DE IGNACIO DE LA LLAVE,30,PASO DE OVEJAS,126,EL FAISÁN,2,98,35,63,9
VERACRUZ DE IGNACIO DE LA LLAVE,30,PASO DE OVEJAS,126,EL HATITO,2,115,62,53,8
VERACRUZ DE IGNACIO DE LA LLAVE,30,PASO DE OVEJAS,126,EL LIMÓN,2,16,8,8,3
VERACRUZ DE IGNACIO DE LA LLAVE,30,PASO DE OVEJAS,126,EL MANGO,2,29,10,19,5
VERACRUZ DE IGNACIO DE LA LLAVE,30,PASO DE OVEJAS,126,EL POCHOTE,2,79,40,39,4
VERACRUZ DE IGNACIO DE LA LLAVE,30,PASO DE OVEJAS,126,EL TEJÓN,2,25,10,15,3
VERACRUZ DE IGNACIO DE LA LLAVE,30,PASO DE OVEJAS,126,GUAYABAL,3,46,25,21,6
VERACRUZ DE IGNACIO DE LA LLAVE,30,PASO DE OVEJAS,126,LA CEIBA,2,80,38,42,8
VERACRUZ DE IGNACIO DE LA LLAVE,30,PASO DE OVEJAS,126,LA VÍBORA,2,21,14,7,3
VERACRUZ DE IGNACIO DE LA LLAVE,30,PASO DE OVEJAS,126,LAS TRANCAS,1,18,5,13,2
VERACRUZ DE IGNACIO DE LA LLAVE,30,PASO DE OVEJAS,126,LOMA DEL NANCHE,2,99,42,57,5
VERACRUZ DE IGNACIO DE LA LLAVE,30,PASO DE OVEJAS,126,LOMA FINA (LOMA PELONA),2,30,11,19,4
VERACRUZ DE IGNACIO DE LA LLAVE,30,PASO DE OVEJAS,126,MATA GRANDE,2,21,11,10,2
VERACRUZ DE IGNACIO DE LA LLAVE,30,PASO DE OVEJAS,126,PALMARITOS,3,183,79,104,11
VERACRUZ DE IGNACIO DE LA LLAVE,30,PASO DE OVEJAS,126,PASO DE OVEJAS,12,1805,908,897,119
VERACRUZ DE IGNACIO DE LA LLAVE,30,PASO DE OVEJAS,126,PASO PANAL,3,43,20,23,5
VERACRUZ DE IGNACIO DE LA LLAVE,30,PASO DE OVEJAS,126,PLAN DEL MANANTIAL,2,146,70,76,10
VERACRUZ DE IGNACIO DE LA LLAVE,30,PASO DE OVEJAS,126,POZO DE MATA RAMÍREZ,4,138,67,71,12
VERACRUZ DE IGNACIO DE LA LLAVE,30,PASO DE OVEJAS,126,PUENTE JULA,5,656,297,359,41
VERACRUZ DE IGNACIO DE LA LLAVE,30,PASO DE OVEJAS,126,RANCHO NUEVO,3,67,32,35,4
VERACRUZ DE IGNACIO DE LA LLAVE,30,PASO DE OVEJAS,126,TAMARINDO (TAMARINDILLO),2,12,3,9,2
VERACRUZ DE IGNACIO DE LA LLAVE,30,PASO DE OVEJAS,126,TIERRA COLORADA,4,593,299,294,38
VERACRUZ DE IGNACIO DE LA LLAVE,30,PASO DE OVEJAS,126,TOLOME,6,451,216,235,32
VERACRUZ DE IGNACIO DE LA LLAVE,30,PASO DE OVEJAS,126,XOCOTITLA,2,13,8,5,2
VERACRUZ DE IGNACIO DE LA LLAVE,30,PASO DE OVEJAS,126,YUCATÁN,1,39,17,22,3
VERACRUZ DE IGNACIO DE LA LLAVE,30,PASO DE OVEJAS,126,ZAPOTITO,1,17,9,8,1
VERACRUZ DE IGNACIO DE LA LLAVE,30,LA PERLA,127,AGUA ESCONDIDA,5,219,107,112,12
VERACRUZ DE IGNACIO DE LA LLAVE,30,LA PERLA,127,BARRIO DE SAN MIGUEL,3,219,115,104,12
VERACRUZ DE IGNACIO DE LA LLAVE,30,LA PERLA,127,BARRIO LOS ABELES,2,32,14,18,2
VERACRUZ DE IGNACIO DE LA LLAVE,30,LA PERLA,127,CHILAPA,4,512,249,263,26
VERACRUZ DE IGNACIO DE LA LLAVE,30,LA PERLA,127,CHILAPILLA,2,148,76,72,6
VERACRUZ DE IGNACIO DE LA LLAVE,30,LA PERLA,127,CRUZ DE CHOCAMÁN,2,208,103,105,11
VERACRUZ DE IGNACIO DE LA LLAVE,30,LA PERLA,127,CRUZ GRANDE,2,27,13,14,3
VERACRUZ DE IGNACIO DE LA LLAVE,30,LA PERLA,127,CUESTA CHICA,1,88,47,41,5
VERACRUZ DE IGNACIO DE LA LLAVE,30,LA PERLA,127,CUMBRE DEL ESPAÑOL,3,229,110,119,12
VERACRUZ DE IGNACIO DE LA LLAVE,30,LA PERLA,127,EL CEBADAL,1,27,11,16,1
VERACRUZ DE IGNACIO DE LA LLAVE,30,LA PERLA,127,EL COMAL,2,59,31,28,4
VERACRUZ DE IGNACIO DE LA LLAVE,30,LA PERLA,127,EL LINDERO,3,175,70,105,11
VERACRUZ DE IGNACIO DE LA LLAVE,30,LA PERLA,127,EL MINERO,2,16,9,7,2
VERACRUZ DE IGNACIO DE LA LLAVE,30,LA PERLA,127,EL PASO,1,38,19,19,2
VERACRUZ DE IGNACIO DE LA LLAVE,30,LA PERLA,127,EL ZAPOTE,3,273,133,140,14
VERACRUZ DE IGNACIO DE LA LLAVE,30,LA PERLA,127,GALICIA,2,26,12,14,2
VERACRUZ DE IGNACIO DE LA LLAVE,30,LA PERLA,127,LA CIÉNEGA,3,305,148,157,18
VERACRUZ DE IGNACIO DE LA LLAVE,30,LA PERLA,127,LA COYOTERA,3,48,30,18,3
VERACRUZ DE IGNACIO DE LA LLAVE,30,LA PERLA,127,LA CUCHILLA,2,48,28,20,3
VERACRUZ DE IGNACIO DE LA LLAVE,30,LA PERLA,127,LA LAGUNILLA,3,260,132,128,14
VERACRUZ DE IGNACIO DE LA LLAVE,30,LA PERLA,127,LA MATA,3,32,14,18,3
VERACRUZ DE IGNACIO DE LA LLAVE,30,LA PERLA,127,LA PERLA,5,1206,629,577,56
VERACRUZ DE IGNACIO DE LA LLAVE,30,LA PERLA,127,LAS TRINCHERAS,2,16,11,5,2
VERACRUZ DE IGNACIO DE LA LLAVE,30,LA PERLA,127,LOS FRESNOS,4,236,115,121,14
VERACRUZ DE IGNACIO DE LA LLAVE,30,LA PERLA,127,MACUILÁCATL CHICO,2,61,27,34,5
VERACRUZ DE IGNACIO DE LA LLAVE,30,LA PERLA,127,MACUILÁCATL GRANDE,3,282,161,121,15
VERACRUZ DE IGNACIO DE LA LLAVE,30,LA PERLA,127,MAGUEYES,1,3,2,1,1
VERACRUZ DE IGNACIO DE LA LLAVE,30,LA PERLA,127,METLAC HERNÁNDEZ (METLAC PRIMERO),3,273,137,136,14
VERACRUZ DE IGNACIO DE LA LLAVE,30,LA PERLA,127,METLAC SOLANO (METLAC SEGUNDO),3,175,88,87,10
VERACRUZ DE IGNACIO DE LA LLAVE,30,LA PERLA,127,PAPALOTLA,2,131,62,69,6
VERACRUZ DE IGNACIO DE LA LLAVE,30,LA PERLA,127,POTRERO NUEVO,4,63,37,26,4
VERACRUZ DE IGNACIO DE LA LLAVE,30,LA PERLA,127,RANCHO NUEVO,2,104,55,49,4
VERACRUZ DE IGNACIO DE LA LLAVE,30,LA PERLA,127,RANCHO VIEJO,2,9,5,4,2
VERACRUZ DE IGNACIO DE LA LLAVE,30,LA PERLA,127,SAN LORENZO,2,161,74,87,8
VERACRUZ DE IGNACIO DE LA LLAVE,30,LA PERLA,127,SAN MARTÍN,2,48,29,19,3
VERACRUZ DE IGNACIO DE LA LLAVE,30,LA PERLA,127,SAN MIGUEL CHINELA,3,18,11,7,3
VERACRUZ DE IGNACIO DE LA LLAVE,30,LA PERLA,127,SAN MIGUEL PILANCÓN,3,114,62,52,7
VERACRUZ DE IGNACIO DE LA LLAVE,30,LA PERLA,127,TUZANTLA,3,232,116,116,14
VERACRUZ DE IGNACIO DE LA LLAVE,30,LA PERLA,127,VILLA HERMOSA,2,132,60,72,9
VERACRUZ DE IGNACIO DE LA LLAVE,30,LA PERLA,127,XOMETLA,6,470,233,237,27
VERACRUZ DE IGNACIO DE LA LLAVE,30,PEROTE,128,COLONIA EL PROGRESO,2,21,9,12,2
VERACRUZ DE IGNACIO DE LA LLAVE,30,PEROTE,128,DOS AGUAS,1,28,18,10,2
VERACRUZ DE IGNACIO DE LA LLAVE,30,PEROTE,128,EJIDO VEINTE DE NOVIEMBRE,2,78,47,31,5
VERACRUZ DE IGNACIO DE LA LLAVE,30,PEROTE,128,EL CONEJO,3,266,125,141,12
VERACRUZ DE IGNACIO DE LA LLAVE,30,PEROTE,128,EL ESCOBILLO,4,263,130,133,16
VERACRUZ DE IGNACIO DE LA LLAVE,30,PEROTE,128,EL FRIJOL COLORADO,3,149,73,76,9
VERACRUZ DE IGNACIO DE LA LLAVE,30,PEROTE,128,FRANCISCO I. MADERO,4,626,300,326,29
VERACRUZ DE IGNACIO DE LA LLAVE,30,PEROTE,128,GUADALUPE VICTORIA,3,212,106,106,13
VERACRUZ DE IGNACIO DE LA LLAVE,30,PEROTE,128,LA GLORIA,4,561,274,287,28
VERACRUZ DE IGNACIO DE LA LLAVE,30,PEROTE,128,LIBERTAD,2,85,44,41,7
VERACRUZ DE IGNACIO DE LA LLAVE,30,PEROTE,128,LOS MOLINOS (SAN JOSÉ),5,735,341,394,35
VERACRUZ DE IGNACIO DE LA LLAVE,30,PEROTE,128,LOS PESCADOS,5,487,247,240,20
VERACRUZ DE IGNACIO DE LA LLAVE,30,PEROTE,128,PEROTE,75,14806,7314,7492,926
VERACRUZ DE IGNACIO DE LA LLAVE,30,PEROTE,128,RANCHO NUEVO,2,75,36,39,5
VERACRUZ DE IGNACIO DE LA LLAVE,30,PEROTE,128,SAN ANTONIO TENEXTEPEC,5,1191,586,605,49
VERACRUZ DE IGNACIO DE LA LLAVE,30,PEROTE,128,SIERRA DE AGUA,3,373,181,192,22
VERACRUZ DE IGNACIO DE LA LLAVE,30,PEROTE,128,VEINTE DE NOVIEMBRE (COLONIA AGRÍCOLA),4,180,104,76,12
VERACRUZ DE IGNACIO DE LA LLAVE,30,PEROTE,128,VIDAL DÍAZ MUÑOZ,1,8,2,6,1
VERACRUZ DE IGNACIO DE LA LLAVE,30,PEROTE,128,XALTEPEC (SAN ISIDRO XALTEPEC),3,214,99,115,13
VERACRUZ DE IGNACIO DE LA LLAVE,30,PEROTE,128,ZALAYETA (ALCHICHICA Y EL BORDO),3,140,78,62,9
VERACRUZ DE IGNACIO DE LA LLAVE,30,PLATÓN SÁNCHEZ,129,AHITIC,3,61,25,36,11
VERACRUZ DE IGNACIO DE LA LLAVE,30,PLATÓN SÁNCHEZ,129,AMOXOYAHUTL,3,42,18,24,5
VERACRUZ DE IGNACIO DE LA LLAVE,30,PLATÓN SÁNCHEZ,129,ANACLETO RAMOS,2,12,5,7,2
VERACRUZ DE IGNACIO DE LA LLAVE,30,PLATÓN SÁNCHEZ,129,APACHITEMPA,3,45,28,17,8
VERACRUZ DE IGNACIO DE LA LLAVE,30,PLATÓN SÁNCHEZ,129,ATEMPA,1,8,5,3,1
VERACRUZ DE IGNACIO DE LA LLAVE,30,PLATÓN SÁNCHEZ,129,ATEXCAL,2,36,18,18,4
VERACRUZ DE IGNACIO DE LA LLAVE,30,PLATÓN SÁNCHEZ,129,CACALACA,2,23,12,11,2
VERACRUZ DE IGNACIO DE LA LLAVE,30,PLATÓN SÁNCHEZ,129,CERRO VIEJO,1,15,7,8,1
VERACRUZ DE IGNACIO DE LA LLAVE,30,PLATÓN SÁNCHEZ,129,CHIATITLA,1,7,6,1,1
VERACRUZ DE IGNACIO DE LA LLAVE,30,PLATÓN SÁNCHEZ,129,CORRALILLO,3,72,43,29,6
VERACRUZ DE IGNACIO DE LA LLAVE,30,PLATÓN SÁNCHEZ,129,EL DUQUE,1,276,146,130,12
VERACRUZ DE IGNACIO DE LA LLAVE,30,PLATÓN SÁNCHEZ,129,EL LINDERO,2,33,15,18,4
VERACRUZ DE IGNACIO DE LA LLAVE,30,PLATÓN SÁNCHEZ,129,EL NARANJO,1,11,6,5,1
VERACRUZ DE IGNACIO DE LA LLAVE,30,PLATÓN SÁNCHEZ,129,EL SAUCITO,2,14,6,8,2
VERACRUZ DE IGNACIO DE LA LLAVE,30,PLATÓN SÁNCHEZ,129,EL SAUZAL,2,36,20,16,2
VERACRUZ DE IGNACIO DE LA LLAVE,30,PLATÓN SÁNCHEZ,129,LA CRINOLINA,2,16,5,11,2
VERACRUZ DE IGNACIO DE LA LLAVE,30,PLATÓN SÁNCHEZ,129,LA MARTINICA,1,6,4,2,1
VERACRUZ DE IGNACIO DE LA LLAVE,30,PLATÓN SÁNCHEZ,129,LAS COSQUILLAS,1,5,2,3,1
VERACRUZ DE IGNACIO DE LA LLAVE,30,PLATÓN SÁNCHEZ,129,LEOPOLDO SÁNCHEZ MERAZ,1,19,12,7,2
VERACRUZ DE IGNACIO DE LA LLAVE,30,PLATÓN SÁNCHEZ,129,LOS COSTEÑOS,1,6,3,3,1
VERACRUZ DE IGNACIO DE LA LLAVE,30,PLATÓN SÁNCHEZ,129,LOS PERICOS,1,9,2,7,1
VERACRUZ DE IGNACIO DE LA LLAVE,30,PLATÓN SÁNCHEZ,129,LOS POZOS,3,41,15,26,7
VERACRUZ DE IGNACIO DE LA LLAVE,30,PLATÓN SÁNCHEZ,129,MONTE GRANDE,3,41,22,19,5
VERACRUZ DE IGNACIO DE LA LLAVE,30,PLATÓN SÁNCHEZ,129,OCTAYO VIEJO,1,7,4,3,1
VERACRUZ DE IGNACIO DE LA LLAVE,30,PLATÓN SÁNCHEZ,129,PLATÓN SÁNCHEZ,22,2426,1237,1189,176
VERACRUZ DE IGNACIO DE LA LLAVE,30,PLATÓN SÁNCHEZ,129,SAN FRANCISCO,2,25,17,8,4
VERACRUZ DE IGNACIO DE LA LLAVE,30,PLATÓN SÁNCHEZ,129,TASAJERAS,3,73,27,46,11
VERACRUZ DE IGNACIO DE LA LLAVE,30,PLATÓN SÁNCHEZ,129,TECOMATE,1,50,23,27,7
VERACRUZ DE IGNACIO DE LA LLAVE,30,PLATÓN SÁNCHEZ,129,TEPETATIPÁN,3,55,25,30,5
VERACRUZ DE IGNACIO DE LA LLAVE,30,PLATÓN SÁNCHEZ,129,TERRERO,1,7,3,4,1
VERACRUZ DE IGNACIO DE LA LLAVE,30,PLATÓN SÁNCHEZ,129,TLALPANI,3,62,38,24,9
VERACRUZ DE IGNACIO DE LA LLAVE,30,PLATÓN SÁNCHEZ,129,ZACATIANGUIS,4,95,39,56,10
VERACRUZ DE IGNACIO DE LA LLAVE,30,PLATÓN SÁNCHEZ,129,ZAPOTALITO,1,11,5,6,2
VERACRUZ DE IGNACIO DE LA LLAVE,30,PLAYA VICENTE,130,ABASOLO DEL VALLE,9,951,489,462,50
VERACRUZ DE IGNACIO DE LA LLAVE,30,PLAYA VICENTE,130,AGUA FRÍA NAZARENO,2,11,4,7,2
VERACRUZ DE IGNACIO DE LA LLAVE,30,PLAYA VICENTE,130,ÁLVARO OBREGÓN,2,5,2,3,1
VERACRUZ DE IGNACIO DE LA LLAVE,30,PLAYA VICENTE,130,AMPLIACIÓN CHILAPA,2,17,11,6,1
VERACRUZ DE IGNACIO DE LA LLAVE,30,PLAYA VICENTE,130,ANDRÉS GÓMEZ ALEMÁN,3,32,11,21,3
VERACRUZ DE IGNACIO DE LA LLAVE,30,PLAYA VICENTE,130,ARENAL SANTA ANA,6,322,142,180,21
VERACRUZ DE IGNACIO DE LA LLAVE,30,PLAYA VICENTE,130,ARROYO BERMEJO,3,91,49,42,8
VERACRUZ DE IGNACIO DE LA LLAVE,30,PLAYA VICENTE,130,ARROYO COLORADO,2,15,5,10,2
VERACRUZ DE IGNACIO DE LA LLAVE,30,PLAYA VICENTE,130,ARROYO DEHESA,3,72,30,42,6
VERACRUZ DE IGNACIO DE LA LLAVE,30,PLAYA VICENTE,130,ARROYO GUADALUPE LA PALMA,2,25,15,10,3
VERACRUZ DE IGNACIO DE LA LLAVE,30,PLAYA VICENTE,130,ARROYO LEÓN,2,18,8,10,2
VERACRUZ DE IGNACIO DE LA LLAVE,30,PLAYA VICENTE,130,ARROYO SAN PEDRO,3,70,35,35,5
VERACRUZ DE IGNACIO DE LA LLAVE,30,PLAYA VICENTE,130,ARROYO SECO,4,127,64,63,9
VERACRUZ DE IGNACIO DE LA LLAVE,30,PLAYA VICENTE,130,ARROYO ZACATE,3,136,60,76,8
VERACRUZ DE IGNACIO DE LA LLAVE,30,PLAYA VICENTE,130,CARMEN ARROYO DEL GAVILÁN,1,12,8,4,1
VERACRUZ DE IGNACIO DE LA LLAVE,30,PLAYA VICENTE,130,CHILAPA DEL CARMEN,3,95,44,51,10
VERACRUZ DE IGNACIO DE LA LLAVE,30,PLAYA VICENTE,130,COAHUILA,1,16,11,5,1
VERACRUZ DE IGNACIO DE LA LLAVE,30,PLAYA VICENTE,130,COLONIA BENITO JUÁREZ,1,15,4,11,1
VERACRUZ DE IGNACIO DE LA LLAVE,30,PLAYA VICENTE,130,COLONIA DEL CARMEN,2,101,53,48,6
VERACRUZ DE IGNACIO DE LA LLAVE,30,PLAYA VICENTE,130,CUAUHTÉMOC,2,19,11,8,2
VERACRUZ DE IGNACIO DE LA LLAVE,30,PLAYA VICENTE,130,EDÉN DE LAS FLORES,3,73,36,37,7
VERACRUZ DE IGNACIO DE LA LLAVE,30,PLAYA VICENTE,130,EL MIRADOR,2,34,15,19,3
VERACRUZ DE IGNACIO DE LA LLAVE,30,PLAYA VICENTE,130,EL NARANJO,1,8,3,5,1
VERACRUZ DE IGNACIO DE LA LLAVE,30,PLAYA VICENTE,130,EL NIGROMANTE,8,489,250,239,29
VERACRUZ DE IGNACIO DE LA LLAVE,30,PLAYA VICENTE,130,EL RAMIE,2,24,15,9,2
VERACRUZ DE IGNACIO DE LA LLAVE,30,PLAYA VICENTE,130,EL SERRANO,3,82,36,46,6
VERACRUZ DE IGNACIO DE LA LLAVE,30,PLAYA VICENTE,130,EL TORITO,2,8,1,7,2
VERACRUZ DE IGNACIO DE LA LLAVE,30,PLAYA VICENTE,130,EL VERGEL,1,16,8,8,1
VERACRUZ DE IGNACIO DE LA LLAVE,30,PLAYA VICENTE,130,EL ZAPOTAL,2,51,26,25,4
VERACRUZ DE IGNACIO DE LA LLAVE,30,PLAYA VICENTE,130,GENERAL GUADALUPE VICTORIA,3,48,20,28,4
VERACRUZ DE IGNACIO DE LA LLAVE,30,PLAYA VICENTE,130,GENERAL HERMENEGILDO GALEANA,3,63,35,28,6
VERACRUZ DE IGNACIO DE LA LLAVE,30,PLAYA VICENTE,130,JUAN ENRÍQUEZ,4,91,43,48,8
VERACRUZ DE IGNACIO DE LA LLAVE,30,PLAYA VICENTE,130,LA CANDELARIA,2,33,12,21,3
VERACRUZ DE IGNACIO DE LA LLAVE,30,PLAYA VICENTE,130,LA FLORENCIA,1,11,5,6,1
VERACRUZ DE IGNACIO DE LA LLAVE,30,PLAYA VICENTE,130,LA NUEVA ERA,4,245,117,128,15
VERACRUZ DE IGNACIO DE LA LLAVE,30,PLAYA VICENTE,130,LA PETRONILA,1,12,6,6,1
VERACRUZ DE IGNACIO DE LA LLAVE,30,PLAYA VICENTE,130,LA SABANA CARAME,1,9,3,6,1
VERACRUZ DE IGNACIO DE LA LLAVE,30,PLAYA VICENTE,130,LA UNIÓN JUAN ENRÍQUEZ,2,51,24,27,3
VERACRUZ DE IGNACIO DE LA LLAVE,30,PLAYA VICENTE,130,LA VICTORIA,3,133,72,61,9
VERACRUZ DE IGNACIO DE LA LLAVE,30,PLAYA VICENTE,130,LEALTAD DE MUÑOZ,4,214,98,116,12
VERACRUZ DE IGNACIO DE LA LLAVE,30,PLAYA VICENTE,130,MATA DE CAÑA,2,25,10,15,2
VERACRUZ DE IGNACIO DE LA LLAVE,30,PLAYA VICENTE,130,MIGUEL LÓPEZ,2,36,15,21,3
VERACRUZ DE IGNACIO DE LA LLAVE,30,PLAYA VICENTE,130,NUEVO ARROYO DEL TIGRE,2,52,25,27,2
VERACRUZ DE IGNACIO DE LA LLAVE,30,PLAYA VICENTE,130,NUEVO ARROYO GRANDE,2,20,10,10,2
VERACRUZ DE IGNACIO DE LA LLAVE,30,PLAYA VICENTE,130,NUEVO COSOLAPA SARMIENTO,2,53,25,28,4
VERACRUZ DE IGNACIO DE LA LLAVE,30,PLAYA VICENTE,130,NUEVO IXCATLÁN,10,936,471,465,54
VERACRUZ DE IGNACIO DE LA LLAVE,30,PLAYA VICENTE,130,NUEVO OJITLÁN,2,32,20,12,2
VERACRUZ DE IGNACIO DE LA LLAVE,30,PLAYA VICENTE,130,NUEVO PESCADITO DE ARRIBA,2,49,23,26,3
VERACRUZ DE IGNACIO DE LA LLAVE,30,PLAYA VICENTE,130,NUEVO RAYA CARACOL (ZANJA SECA),3,100,46,54,7
VERACRUZ DE IGNACIO DE LA LLAVE,30,PLAYA VICENTE,130,NUEVO SAN MARTÍN,5,353,155,198,21
VERACRUZ DE IGNACIO DE LA LLAVE,30,PLAYA VICENTE,130,PIEDRA DE CAL,2,31,18,13,3
VERACRUZ DE IGNACIO DE LA LLAVE,30,PLAYA VICENTE,130,PLAYA VICENTE,16,2908,1479,1429,158
VERACRUZ DE IGNACIO DE LA LLAVE,30,PLAYA VICENTE,130,RANCHO GRANDE,2,37,21,16,3
VERACRUZ DE IGNACIO DE LA LLAVE,30,PLAYA VICENTE,130,RUIZ CORTINES REVOLUCIÓN,1,17,9,8,1
VERACRUZ DE IGNACIO DE LA LLAVE,30,PLAYA VICENTE,130,SAN FRANCISCO,2,48,27,21,4
VERACRUZ DE IGNACIO DE LA LLAVE,30,PLAYA VICENTE,130,SAN GABRIEL,3,70,40,30,6
VERACRUZ DE IGNACIO DE LA LLAVE,30,PLAYA VICENTE,130,SAN ISIDRO,1,13,12,1,1
VERACRUZ DE IGNACIO DE LA LLAVE,30,PLAYA VICENTE,130,SAN JOSÉ CHILAPA,2,24,9,15,2
VERACRUZ DE IGNACIO DE LA LLAVE,30,PLAYA VICENTE,130,SAN RAMÓN SEGUNDO,3,37,15,22,4
VERACRUZ DE IGNACIO DE LA LLAVE,30,PLAYA VICENTE,130,SANTA ELENA,2,44,20,24,3
VERACRUZ DE IGNACIO DE LA LLAVE,30,PLAYA VICENTE,130,SANTA ROSA,2,37,21,16,3
VERACRUZ DE IGNACIO DE LA LLAVE,30,PLAYA VICENTE,130,TIERRA NUEVA,3,43,22,21,4
VERACRUZ DE IGNACIO DE LA LLAVE,30,PLAYA VICENTE,130,TOMATE RÍO MANSO,3,105,52,53,8
VERACRUZ DE IGNACIO DE LA LLAVE,30,PLAYA VICENTE,130,TOMATILLO,3,80,46,34,9
VERACRUZ DE IGNACIO DE LA LLAVE,30,PLAYA VICENTE,130,ÚRSULO GALVÁN (LA PRIMAVERA),2,37,22,15,3
VERACRUZ DE IGNACIO DE LA LLAVE,30,PLAYA VICENTE,130,VEGA DEL JOVAL,1,12,4,8,2
VERACRUZ DE IGNACIO DE LA LLAVE,30,PLAYA VICENTE,130,VICENTE GUERRERO,1,10,3,7,1
VERACRUZ DE IGNACIO DE LA LLAVE,30,PLAYA VICENTE,130,ZANJA DE CAÑA,1,11,5,6,1
VERACRUZ DE IGNACIO DE LA LLAVE,30,POZA RICA DE HIDALGO,131,ARROYO DEL MAÍZ UNO,1,72,39,33,4
VERACRUZ DE IGNACIO DE LA LLAVE,30,POZA RICA DE HIDALGO,131,CERRO DEL MESÓN,1,29,16,13,2
VERACRUZ DE IGNACIO DE LA LLAVE,30,POZA RICA DE HIDALGO,131,ESCOLÍN DE OLARTE,5,758,379,379,41
VERACRUZ DE IGNACIO DE LA LLAVE,30,POZA RICA DE HIDALGO,131,POZA RICA DE HIDALGO,304,51131,26062,25069,4095
VERACRUZ DE IGNACIO DE LA LLAVE,30,LAS VIGAS DE RAMÍREZ,132,AGUASUELAS,2,42,17,25,3
VERACRUZ DE IGNACIO DE LA LLAVE,30,LAS VIGAS DE RAMÍREZ,132,BARRIO DE SAN MIGUEL,3,233,113,120,15
VERACRUZ DE IGNACIO DE LA LLAVE,30,LAS VIGAS DE RAMÍREZ,132,CALAVERNAS,3,95,49,46,7
VERACRUZ DE IGNACIO DE LA LLAVE,30,LAS VIGAS DE RAMÍREZ,132,CASA BLANCA,2,82,40,42,5
VERACRUZ DE IGNACIO DE LA LLAVE,30,LAS VIGAS DE RAMÍREZ,132,CRUZ DE RAMA,2,9,3,6,2
VERACRUZ DE IGNACIO DE LA LLAVE,30,LAS VIGAS DE RAMÍREZ,132,EL ARENAL,2,21,6,15,2
VERACRUZ DE IGNACIO DE LA LLAVE,30,LAS VIGAS DE RAMÍREZ,132,EL JONOTAL,2,19,8,11,3
VERACRUZ DE IGNACIO DE LA LLAVE,30,LAS VIGAS DE RAMÍREZ,132,EL LLANILLO REDONDO,4,303,157,146,16
VERACRUZ DE IGNACIO DE LA LLAVE,30,LAS VIGAS DE RAMÍREZ,132,EL PAISANO,4,308,167,141,18
VERACRUZ DE IGNACIO DE LA LLAVE,30,LAS VIGAS DE RAMÍREZ,132,ENCINO GACHO,2,27,17,10,2
VERACRUZ DE IGNACIO DE LA LLAVE,30,LAS VIGAS DE RAMÍREZ,132,LAS TROJES,2,13,8,5,2
VERACRUZ DE IGNACIO DE LA LLAVE,30,LAS VIGAS DE RAMÍREZ,132,LAS VIGAS DE RAMÍREZ,20,3394,1725,1669,189
VERACRUZ DE IGNACIO DE LA LLAVE,30,LAS VIGAS DE RAMÍREZ,132,LOMA DE TABLAS,1,11,3,8,1
VERACRUZ DE IGNACIO DE LA LLAVE,30,LAS VIGAS DE RAMÍREZ,132,MANZANILLO,3,193,70,123,13
VERACRUZ DE IGNACIO DE LA LLAVE,30,LAS VIGAS DE RAMÍREZ,132,RANCHILLOS,2,40,18,22,3
VERACRUZ DE IGNACIO DE LA LLAVE,30,LAS VIGAS DE RAMÍREZ,132,SAN PABLO,1,5,1,4,1
VERACRUZ DE IGNACIO DE LA LLAVE,30,LAS VIGAS DE RAMÍREZ,132,TEJERÍAS,2,58,37,21,3
VERACRUZ DE IGNACIO DE LA LLAVE,30,LAS VIGAS DE RAMÍREZ,132,TEJOCOTAL,2,38,19,19,3
VERACRUZ DE IGNACIO DE LA LLAVE,30,LAS VIGAS DE RAMÍREZ,132,TEPETATES,2,129,66,63,7
VERACRUZ DE IGNACIO DE LA LLAVE,30,LAS VIGAS DE RAMÍREZ,132,TOXTLACUAYA,3,109,57,52,11
VERACRUZ DE IGNACIO DE LA LLAVE,30,LAS VIGAS DE RAMÍREZ,132,TRES CRUCES,1,2,0,2,0
VERACRUZ DE IGNACIO DE LA LLAVE,30,LAS VIGAS DE RAMÍREZ,132,ÚRSULO GALVÁN,2,33,17,16,2
VERACRUZ DE IGNACIO DE LA LLAVE,30,PUEBLO VIEJO,133,ANÁHUAC,19,2055,1053,1002,131
VERACRUZ DE IGNACIO DE LA LLAVE,30,PUEBLO VIEJO,133,BELLA VISTA,2,31,13,18,3
VERACRUZ DE IGNACIO DE LA LLAVE,30,PUEBLO VIEJO,133,BENITO JUÁREZ,3,424,209,215,16
VERACRUZ DE IGNACIO DE LA LLAVE,30,PUEBLO VIEJO,133,CD. CUAUHTÉMOC,22,3905,1989,1916,221
VERACRUZ DE IGNACIO DE LA LLAVE,30,PUEBLO VIEJO,133,COLONIA PETROLERA LINDAVISTA,4,386,184,202,25
VERACRUZ DE IGNACIO DE LA LLAVE,30,PUEBLO VIEJO,133,EJIDO EL BARCO,2,33,11,22,4
VERACRUZ DE IGNACIO DE LA LLAVE,30,PUEBLO VIEJO,133,EL CRUCERO (ESTACIÓN PEDERNALES),2,95,50,45,5
VERACRUZ DE IGNACIO DE LA LLAVE,30,PUEBLO VIEJO,133,EL SENDERO,2,34,15,19,3
VERACRUZ DE IGNACIO DE LA LLAVE,30,PUEBLO VIEJO,133,EMILIANO ZAPATA,3,143,57,86,9
VERACRUZ DE IGNACIO DE LA LLAVE,30,PUEBLO VIEJO,133,GONZÁLEZ ORTEGA,2,58,32,26,4
VERACRUZ DE IGNACIO DE LA LLAVE,30,PUEBLO VIEJO,133,HIDALGO,8,1345,664,681,75
VERACRUZ DE IGNACIO DE LA LLAVE,30,PUEBLO VIEJO,133,KILÓMETRO QUINCE,1,12,4,8,1
VERACRUZ DE IGNACIO DE LA LLAVE,30,PUEBLO VIEJO,133,LA GUADALUPE,1,14,4,10,1
VERACRUZ DE IGNACIO DE LA LLAVE,30,PUEBLO VIEJO,133,LA LADRILLERA,1,18,9,9,1
VERACRUZ DE IGNACIO DE LA LLAVE,30,PUEBLO VIEJO,133,MEZQUITE GORDO,2,18,8,10,2
VERACRUZ DE IGNACIO DE LA LLAVE,30,PUEBLO VIEJO,133,OJITAL,1,8,4,4,1
VERACRUZ DE IGNACIO DE LA LLAVE,30,PUEBLO VIEJO,133,PACIENCIA Y AGUACATE (SANTA FE),2,52,23,29,5
VERACRUZ DE IGNACIO DE LA LLAVE,30,PUEBLO VIEJO,133,PRIMERO DE MAYO (LOS MANGOS),3,244,114,130,20
VERACRUZ DE IGNACIO DE LA LLAVE,30,PUENTE NACIONAL,134,ARROYO SECO,1,5,4,1,1
VERACRUZ DE IGNACIO DE LA LLAVE,30,PUENTE NACIONAL,134,CABEZAS,3,278,135,143,20
VERACRUZ DE IGNACIO DE LA LLAVE,30,PUENTE NACIONAL,134,CAMARONCILLO,2,32,16,16,2
VERACRUZ DE IGNACIO DE LA LLAVE,30,PUENTE NACIONAL,134,CASA BLANCA,2,291,148,143,16
VERACRUZ DE IGNACIO DE LA LLAVE,30,PUENTE NACIONAL,134,CHICHICAXTLE,5,416,201,215,30
VERACRUZ DE IGNACIO DE LA LLAVE,30,PUENTE NACIONAL,134,COLONIA BARRIOS,1,9,1,8,1
VERACRUZ DE IGNACIO DE LA LLAVE,30,PUENTE NACIONAL,134,EL CEDRO,1,6,4,2,1
VERACRUZ DE IGNACIO DE LA LLAVE,30,PUENTE NACIONAL,134,EL COYOLAR,3,87,43,44,6
VERACRUZ DE IGNACIO DE LA LLAVE,30,PUENTE NACIONAL,134,EL CRUCERO,3,108,54,54,7
VERACRUZ DE IGNACIO DE LA LLAVE,30,PUENTE NACIONAL,134,EL CUAJILOTE,2,40,17,23,3
VERACRUZ DE IGNACIO DE LA LLAVE,30,PUENTE NACIONAL,134,EL PALMAR,3,115,61,54,11
VERACRUZ DE IGNACIO DE LA LLAVE,30,PUENTE NACIONAL,134,HATO DE LA HIGUERA,4,204,105,99,14
VERACRUZ DE IGNACIO DE LA LLAVE,30,PUENTE NACIONAL,134,INFONAVIT EL PANDO I,3,41,24,17,5
VERACRUZ DE IGNACIO DE LA LLAVE,30,PUENTE NACIONAL,134,JUAN DE LA LUZ ENRÍQUEZ,3,37,16,21,4
VERACRUZ DE IGNACIO DE LA LLAVE,30,PUENTE NACIONAL,134,LA PALMILLA,2,21,11,10,2
VERACRUZ DE IGNACIO DE LA LLAVE,30,PUENTE NACIONAL,134,LA TERNERA,3,56,29,27,5
VERACRUZ DE IGNACIO DE LA LLAVE,30,PUENTE NACIONAL,134,MATA DE JOBO,3,63,35,28,5
VERACRUZ DE IGNACIO DE LA LLAVE,30,PUENTE NACIONAL,134,MATA DE ZARZA,2,55,28,27,3
VERACRUZ DE IGNACIO DE LA LLAVE,30,PUENTE NACIONAL,134,MIGUEL HIDALGO,1,7,4,3,1
VERACRUZ DE IGNACIO DE LA LLAVE,30,PUENTE NACIONAL,134,PACHUQUILLA,3,110,56,54,10
VERACRUZ DE IGNACIO DE LA LLAVE,30,PUENTE NACIONAL,134,PASO DE LA VENTA,2,24,11,13,3
VERACRUZ DE IGNACIO DE LA LLAVE,30,PUENTE NACIONAL,134,PASO DE VARAS,2,37,12,25,4
VERACRUZ DE IGNACIO DE LA LLAVE,30,PUENTE NACIONAL,134,PASO MARIANO,2,29,11,18,3
VERACRUZ DE IGNACIO DE LA LLAVE,30,PUENTE NACIONAL,134,POTRERILLOS,2,24,11,13,3
VERACRUZ DE IGNACIO DE LA LLAVE,30,PUENTE NACIONAL,134,PUENTE NACIONAL,3,129,60,69,9
VERACRUZ DE IGNACIO DE LA LLAVE,30,PUENTE NACIONAL,134,REMUDADERO,1,5,5,0,1
VERACRUZ DE IGNACIO DE LA LLAVE,30,PUENTE NACIONAL,134,RINCÓN PANAL,2,26,13,13,2
VERACRUZ DE IGNACIO DE LA LLAVE,30,PUENTE NACIONAL,134,SAN JOSÉ CHIPILA,4,165,78,87,13
VERACRUZ DE IGNACIO DE LA LLAVE,30,PUENTE NACIONAL,134,TAMARINDO,3,171,87,84,12
VERACRUZ DE IGNACIO DE LA LLAVE,30,PUENTE NACIONAL,134,TEOPANAPAN,3,66,35,31,4
VERACRUZ DE IGNACIO DE LA LLAVE,30,RAFAEL DELGADO,135,HUELLETECOXCO,3,382,195,187,20
VERACRUZ DE IGNACIO DE LA LLAVE,30,RAFAEL DELGADO,135,JALAPILLA,10,2029,1002,1027,110
VERACRUZ DE IGNACIO DE LA LLAVE,30,RAFAEL DELGADO,135,LA CUMBRE DE TONALIXCO,1,7,2,5,1
VERACRUZ DE IGNACIO DE LA LLAVE,30,RAFAEL DELGADO,135,LAS SIRENAS,1,79,42,37,3
VERACRUZ DE IGNACIO DE LA LLAVE,30,RAFAEL DELGADO,135,OMIQUILA,1,28,16,12,2
VERACRUZ DE IGNACIO DE LA LLAVE,30,RAFAEL DELGADO,135,RAFAEL DELGADO,8,1157,569,588,53
VERACRUZ DE IGNACIO DE LA LLAVE,30,RAFAEL DELGADO,135,TZONCOLCO,3,234,115,119,14
VERACRUZ DE IGNACIO DE LA LLAVE,30,RAFAEL DELGADO,135,XALTITITLA,3,453,226,227,29
VERACRUZ DE IGNACIO DE LA LLAVE,30,RAFAEL LUCIO,136,COLONIA TRES DE MAYO,2,52,24,28,5
VERACRUZ DE IGNACIO DE LA LLAVE,30,RAFAEL LUCIO,136,EL ROSARIO,1,36,15,21,3
VERACRUZ DE IGNACIO DE LA LLAVE,30,RAFAEL LUCIO,136,PILETAS,5,368,191,177,27
VERACRUZ DE IGNACIO DE LA LLAVE,30,RAFAEL LUCIO,136,RAFAEL LUCIO,8,2146,1224,922,104
VERACRUZ DE IGNACIO DE LA LLAVE,30,RAFAEL LUCIO,136,TEAPAN,2,56,29,27,7
VERACRUZ DE IGNACIO DE LA LLAVE,30,LOS REYES,137,AHUATEPEC,2,57,27,30,5
VERACRUZ DE IGNACIO DE LA LLAVE,30,LOS REYES,137,ATLANCA,3,257,118,139,13
VERACRUZ DE IGNACIO DE LA LLAVE,30,LOS REYES,137,CIHUATEO,3,126,64,62,9
VERACRUZ DE IGNACIO DE LA LLAVE,30,LOS REYES,137,CRUZ VERDE,2,33,15,18,2
VERACRUZ DE IGNACIO DE LA LLAVE,30,LOS REYES,137,CUACABALLO,4,134,68,66,8
VERACRUZ DE IGNACIO DE LA LLAVE,30,LOS REYES,137,CUBANICUILCO,4,52,20,32,5
VERACRUZ DE IGNACIO DE LA LLAVE,30,LOS REYES,137,ICZOTITLA,3,59,28,31,4
VERACRUZ DE IGNACIO DE LA LLAVE,30,LOS REYES,137,LOS REYES,7,505,248,257,28
VERACRUZ DE IGNACIO DE LA LLAVE,30,LOS REYES,137,OCOTEPEC,2,50,25,25,3
VERACRUZ DE IGNACIO DE LA LLAVE,30,LOS REYES,137,TLAMANCA,1,23,12,11,2
VERACRUZ DE IGNACIO DE LA LLAVE,30,LOS REYES,137,TLAXAMANILCO,2,12,6,6,2
VERACRUZ DE IGNACIO DE LA LLAVE,30,LOS REYES,137,TOTOLATEMPA,2,23,10,13,2
VERACRUZ DE IGNACIO DE LA LLAVE,30,LOS REYES,137,TOTOLINGA,3,65,38,27,4
VERACRUZ DE IGNACIO DE LA LLAVE,30,LOS REYES,137,ZACATLA,2,8,6,2,2
VERACRUZ DE IGNACIO DE LA LLAVE,30,LOS REYES,137,ZOQUIAPAN,2,75,35,40,4
VERACRUZ DE IGNACIO DE LA LLAVE,30,RÍO BLANCO,138,RÍO BLANCO,60,9384,5023,4361,720
VERACRUZ DE IGNACIO DE LA LLAVE,30,SALTABARRANCA,139,BOCA DE LA SIERRA,1,19,10,9,2
VERACRUZ DE IGNACIO DE LA LLAVE,30,SALTABARRANCA,139,CARLOS HUERTA NÁJERA (LA CRUZ),2,63,28,35,3
VERACRUZ DE IGNACIO DE LA LLAVE,30,SALTABARRANCA,139,EL MACUILE,2,5,5,0,2
VERACRUZ DE IGNACIO DE LA LLAVE,30,SALTABARRANCA,139,EL NOPO,3,16,8,8,2
VERACRUZ DE IGNACIO DE LA LLAVE,30,SALTABARRANCA,139,EL RINCÓN CALETÓN,2,32,18,14,3
VERACRUZ DE IGNACIO DE LA LLAVE,30,SALTABARRANCA,139,SALTABARRANCA,7,610,303,307,41
VERACRUZ DE IGNACIO DE LA LLAVE,30,SALTABARRANCA,139,ZAMORA CALETÓN,3,135,71,64,10
VERACRUZ DE IGNACIO DE LA LLAVE,30,SAN ANDRÉS TENEJAPAN,140,ENCINO GRANDE,3,113,50,63,7
VERACRUZ DE IGNACIO DE LA LLAVE,30,SAN ANDRÉS TENEJAPAN,140,IXCOCA,2,10,6,4,2
VERACRUZ DE IGNACIO DE LA LLAVE,30,SAN ANDRÉS TENEJAPAN,140,PETLACALA,3,43,24,19,5
VERACRUZ DE IGNACIO DE LA LLAVE,30,SAN ANDRÉS TENEJAPAN,140,QUIÑIATLA,2,79,43,36,4
VERACRUZ DE IGNACIO DE LA LLAVE,30,SAN ANDRÉS TENEJAPAN,140,SAN ANDRÉS TENEJAPAN,3,205,101,104,10
VERACRUZ DE IGNACIO DE LA LLAVE,30,SAN ANDRÉS TENEJAPAN,140,TEOPANCAHUALCO,2,45,22,23,3
VERACRUZ DE IGNACIO DE LA LLAVE,30,SAN ANDRÉS TENEJAPAN,140,TIERRA COLORADA,1,20,6,14,2
VERACRUZ DE IGNACIO DE LA LLAVE,30,SAN ANDRÉS TUXTLA,141,ABREVADERO,4,347,163,184,17
VERACRUZ DE IGNACIO DE LA LLAVE,30,SAN ANDRÉS TUXTLA,141,ADOLFO RUIZ CORTINES,1,7,4,3,1
VERACRUZ DE IGNACIO DE LA LLAVE,30,SAN ANDRÉS TUXTLA,141,ADOLFO RUIZ CORTINES (LA FLOREÑA),2,48,19,29,3
VERACRUZ DE IGNACIO DE LA LLAVE,30,SAN ANDRÉS TUXTLA,141,AHUACAPAN,3,84,43,41,9
VERACRUZ DE IGNACIO DE LA LLAVE,30,SAN ANDRÉS TUXTLA,141,APIXITA,2,90,48,42,6
VERACRUZ DE IGNACIO DE LA LLAVE,30,SAN ANDRÉS TUXTLA,141,ARROYO DE LIMÓN,2,46,15,31,3
VERACRUZ DE IGNACIO DE LA LLAVE,30,SAN ANDRÉS TUXTLA,141,ARROYO DE LIZA,2,45,20,25,3
VERACRUZ DE IGNACIO DE LA LLAVE,30,SAN ANDRÉS TUXTLA,141,AXOCHIO,4,256,126,130,15
VERACRUZ DE IGNACIO DE LA LLAVE,30,SAN ANDRÉS TUXTLA,141,BALZAPOTE,4,80,36,44,8
VERACRUZ DE IGNACIO DE LA LLAVE,30,SAN ANDRÉS TUXTLA,141,BELLA VISTA,2,19,11,8,2
VERACRUZ DE IGNACIO DE LA LLAVE,30,SAN ANDRÉS TUXTLA,141,BENITO JUÁREZ,3,267,136,131,15
VERACRUZ DE IGNACIO DE LA LLAVE,30,SAN ANDRÉS TUXTLA,141,BEZUAPAN,2,61,32,29,5
VERACRUZ DE IGNACIO DE LA LLAVE,30,SAN ANDRÉS TUXTLA,141,BUENOS AIRES TEXALPAN,4,536,255,281,23
VERACRUZ DE IGNACIO DE LA LLAVE,30,SAN ANDRÉS TUXTLA,141,BUENOS AIRES XOTEAPAN,2,126,63,63,10
VERACRUZ DE IGNACIO DE LA LLAVE,30,SAN ANDRÉS TUXTLA,141,CALERÍA,5,739,383,356,40
VERACRUZ DE IGNACIO DE LA LLAVE,30,SAN ANDRÉS TUXTLA,141,CARAVACA,2,165,89,76,8
VERACRUZ DE IGNACIO DE LA LLAVE,30,SAN ANDRÉS TUXTLA,141,CEBADILLA CHICA,2,53,26,27,5
VERACRUZ DE IGNACIO DE LA LLAVE,30,SAN ANDRÉS TUXTLA,141,CEBADILLA GRANDE,3,136,67,69,9
VERACRUZ DE IGNACIO DE LA LLAVE,30,SAN ANDRÉS TUXTLA,141,CERRO AMARILLO DE ABAJO,2,138,75,63,5
VERACRUZ DE IGNACIO DE LA LLAVE,30,SAN ANDRÉS TUXTLA,141,CERRO AMARILLO DE ARRIBA,2,63,26,37,4
VERACRUZ DE IGNACIO DE LA LLAVE,30,SAN ANDRÉS TUXTLA,141,CERRO LAS IGUANAS,2,152,79,73,8
VERACRUZ DE IGNACIO DE LA LLAVE,30,SAN ANDRÉS TUXTLA,141,CHUNIAPAN DE ABAJO,3,169,84,85,12
VERACRUZ DE IGNACIO DE LA LLAVE,30,SAN ANDRÉS TUXTLA,141,CHUNIAPAN DE ARRIBA,5,565,283,282,29
VERACRUZ DE IGNACIO DE LA LLAVE,30,SAN ANDRÉS TUXTLA,141,COBALTEPEC,3,48,22,26,4
VERACRUZ DE IGNACIO DE LA LLAVE,30,SAN ANDRÉS TUXTLA,141,COMOAPAN,6,1022,484,538,51
VERACRUZ DE IGNACIO DE LA LLAVE,30,SAN ANDRÉS TUXTLA,141,COSTA DE ORO (ARROYO DE ORO),4,181,92,89,13
VERACRUZ DE IGNACIO DE LA LLAVE,30,SAN ANDRÉS TUXTLA,141,COYOLTEPEC,3,60,31,29,4
VERACRUZ DE IGNACIO DE LA LLAVE,30,SAN ANDRÉS TUXTLA,141,CUAUHTÉMOC,3,30,15,15,3
VERACRUZ DE IGNACIO DE LA LLAVE,30,SAN ANDRÉS TUXTLA,141,CUESTA AMARILLA,4,264,122,142,14
VERACRUZ DE IGNACIO DE LA LLAVE,30,SAN ANDRÉS TUXTLA,141,CUESTA DE LAJA,4,311,155,156,16
VERACRUZ DE IGNACIO DE LA LLAVE,30,SAN ANDRÉS TUXTLA,141,DANIEL LAGUNES,2,28,16,12,3
VERACRUZ DE IGNACIO DE LA LLAVE,30,SAN ANDRÉS TUXTLA,141,DOS AGUAJES,3,64,32,32,4
VERACRUZ DE IGNACIO DE LA LLAVE,30,SAN ANDRÉS TUXTLA,141,DOS DE ABRIL (MONTEPÍO CHIQUITO),4,132,73,59,9
VERACRUZ DE IGNACIO DE LA LLAVE,30,SAN ANDRÉS TUXTLA,141,EL BEBEDERO,2,48,23,25,3
VERACRUZ DE IGNACIO DE LA LLAVE,30,SAN ANDRÉS TUXTLA,141,EL COCAL,1,30,18,12,3
VERACRUZ DE IGNACIO DE LA LLAVE,30,SAN ANDRÉS TUXTLA,141,EL DIAMANTE,2,13,3,10,2
VERACRUZ DE IGNACIO DE LA LLAVE,30,SAN ANDRÉS TUXTLA,141,EL HUIDERO,4,266,123,143,14
VERACRUZ DE IGNACIO DE LA LLAVE,30,SAN ANDRÉS TUXTLA,141,EL LAUREL,4,334,167,167,16
VERACRUZ DE IGNACIO DE LA LLAVE,30,SAN ANDRÉS TUXTLA,141,EL NACAXTLE,2,14,7,7,2
VERACRUZ DE IGNACIO DE LA LLAVE,30,SAN ANDRÉS TUXTLA,141,EL NOPAL,2,68,32,36,6
VERACRUZ DE IGNACIO DE LA LLAVE,30,SAN ANDRÉS TUXTLA,141,EL PARAÍSO,1,17,7,10,2
VERACRUZ DE IGNACIO DE LA LLAVE,30,SAN ANDRÉS TUXTLA,141,EL POLVORÍN,1,18,9,9,2
VERACRUZ DE IGNACIO DE LA LLAVE,30,SAN ANDRÉS TUXTLA,141,EL POPOTAL,3,179,98,81,11
VERACRUZ DE IGNACIO DE LA LLAVE,30,SAN ANDRÉS TUXTLA,141,EL REMOLINO,3,87,42,45,5
VERACRUZ DE IGNACIO DE LA LLAVE,30,SAN ANDRÉS TUXTLA,141,ENRIQUE LÓPEZ HUITRÓN,2,38,19,19,3
VERACRUZ DE IGNACIO DE LA LLAVE,30,SAN ANDRÉS TUXTLA,141,FRANCISCO I. MADERO,3,89,47,42,7
VERACRUZ DE IGNACIO DE LA LLAVE,30,SAN ANDRÉS TUXTLA,141,FRANCISCO J. MORENO,2,24,9,15,3
VERACRUZ DE IGNACIO DE LA LLAVE,30,SAN ANDRÉS TUXTLA,141,JOSÉ MARÍA MORELOS Y PAVÓN,3,186,85,101,11
VERACRUZ DE IGNACIO DE LA LLAVE,30,SAN ANDRÉS TUXTLA,141,JUAN JACOBO TORRES [BODEGA DE TOTONTEPEC],4,268,122,146,18
VERACRUZ DE IGNACIO DE LA LLAVE,30,SAN ANDRÉS TUXTLA,141,LA AURORA,3,27,12,15,3
VERACRUZ DE IGNACIO DE LA LLAVE,30,SAN ANDRÉS TUXTLA,141,LA BOCA,2,50,26,24,4
VERACRUZ DE IGNACIO DE LA LLAVE,30,SAN ANDRÉS TUXTLA,141,LA CANELA,2,47,31,16,3
VERACRUZ DE IGNACIO DE LA LLAVE,30,SAN ANDRÉS TUXTLA,141,LA ESPERANZA,1,47,19,28,3
VERACRUZ DE IGNACIO DE LA LLAVE,30,SAN ANDRÉS TUXTLA,141,LA NUEVA VICTORIA,5,449,225,224,27
VERACRUZ DE IGNACIO DE LA LLAVE,30,SAN ANDRÉS TUXTLA,141,LA REDONDA,4,217,103,114,14
VERACRUZ DE IGNACIO DE LA LLAVE,30,SAN ANDRÉS TUXTLA,141,LAGUNA ESCONDIDA,1,5,4,1,1
VERACRUZ DE IGNACIO DE LA LLAVE,30,SAN ANDRÉS TUXTLA,141,LAGUNETA,3,217,98,119,14
VERACRUZ DE IGNACIO DE LA LLAVE,30,SAN ANDRÉS TUXTLA,141,LAS GALERAS,4,131,66,65,10
VERACRUZ DE IGNACIO DE LA LLAVE,30,SAN ANDRÉS TUXTLA,141,LAUCHAPAN,3,102,45,57,7
VERACRUZ DE IGNACIO DE LA LLAVE,30,SAN ANDRÉS TUXTLA,141,LÁZARO CÁRDENAS,3,34,20,14,4
VERACRUZ DE IGNACIO DE LA LLAVE,30,SAN ANDRÉS TUXTLA,141,LEY SEIS DE ENERO DE 1915,1,7,3,4,1
VERACRUZ DE IGNACIO DE LA LLAVE,30,SAN ANDRÉS TUXTLA,141,LOS MANANTIALES,2,36,15,21,3
VERACRUZ DE IGNACIO DE LA LLAVE,30,SAN ANDRÉS TUXTLA,141,LOS MÉRIDA,3,152,80,72,9
VERACRUZ DE IGNACIO DE LA LLAVE,30,SAN ANDRÉS TUXTLA,141,LOS NARANJOS,3,196,101,95,11
VERACRUZ DE IGNACIO DE LA LLAVE,30,SAN ANDRÉS TUXTLA,141,LOS ÓRGANOS,2,34,16,18,3
VERACRUZ DE IGNACIO DE LA LLAVE,30,SAN ANDRÉS TUXTLA,141,LOS PINOS,3,235,105,130,14
VERACRUZ DE IGNACIO DE LA LLAVE,30,SAN ANDRÉS TUXTLA,141,MATACAPAN,5,2768,1284,1484,106
VERACRUZ DE IGNACIO DE LA LLAVE,30,SAN ANDRÉS TUXTLA,141,MAZUMIAPAN,4,380,174,206,18
VERACRUZ DE IGNACIO DE LA LLAVE,30,SAN ANDRÉS TUXTLA,141,MIGUEL HIDALGO Y COSTILLA,5,19,9,10,5
VERACRUZ DE IGNACIO DE LA LLAVE,30,SAN ANDRÉS TUXTLA,141,MILTEPEC,2,13,9,4,2
VERACRUZ DE IGNACIO DE LA LLAVE,30,SAN ANDRÉS TUXTLA,141,MONTEPÍO,2,32,22,10,2
VERACRUZ DE IGNACIO DE LA LLAVE,30,SAN ANDRÉS TUXTLA,141,NACIMIENTOS DE XOGAPAN (FRANCISCO I. MADERO),4,197,96,101,13
VERACRUZ DE IGNACIO DE LA LLAVE,30,SAN ANDRÉS TUXTLA,141,NOMPITA,2,8,2,6,2
VERACRUZ DE IGNACIO DE LA LLAVE,30,SAN ANDRÉS TUXTLA,141,NUEVO PROGRESO,2,42,22,20,4
VERACRUZ DE IGNACIO DE LA LLAVE,30,SAN ANDRÉS TUXTLA,141,OCELOTA,4,390,178,212,20
VERACRUZ DE IGNACIO DE LA LLAVE,30,SAN ANDRÉS TUXTLA,141,OHUILAPAN,4,245,132,113,18
VERACRUZ DE IGNACIO DE LA LLAVE,30,SAN ANDRÉS TUXTLA,141,PASO DE LA VÍA,2,51,24,27,4
VERACRUZ DE IGNACIO DE LA LLAVE,30,SAN ANDRÉS TUXTLA,141,PIZAPAN,2,25,13,12,3
VERACRUZ DE IGNACIO DE LA LLAVE,30,SAN ANDRÉS TUXTLA,141,PLAYA HERMOSA,2,71,38,33,4
VERACRUZ DE IGNACIO DE LA LLAVE,30,SAN ANDRÉS TUXTLA,141,PUERTA NUEVA XOTEAPAN (PUERTA NUEVA),5,421,223,198,26
VERACRUZ DE IGNACIO DE LA LLAVE,30,SAN ANDRÉS TUXTLA,141,RANCHO NUEVO (LA CEIBA DE ABAJO),3,44,19,25,4
VERACRUZ DE IGNACIO DE LA LLAVE,30,SAN ANDRÉS TUXTLA,141,RANCHOAPAN DOS,1,470,218,252,26
VERACRUZ DE IGNACIO DE LA LLAVE,30,SAN ANDRÉS TUXTLA,141,REVOLUCIÓN,2,34,14,20,2
VERACRUZ DE IGNACIO DE LA LLAVE,30,SAN ANDRÉS TUXTLA,141,RICARDO FLORES MAGÓN,2,36,18,18,5
VERACRUZ DE IGNACIO DE LA LLAVE,30,SAN ANDRÉS TUXTLA,141,RÍO DE TUXTLA,3,112,45,67,7
VERACRUZ DE IGNACIO DE LA LLAVE,30,SAN ANDRÉS TUXTLA,141,ROBERTO ENRÍQUEZ RUIZ,1,16,8,8,1
VERACRUZ DE IGNACIO DE LA LLAVE,30,SAN ANDRÉS TUXTLA,141,SALINAS ROCA PARTIDA,4,191,101,90,13
VERACRUZ DE IGNACIO DE LA LLAVE,30,SAN ANDRÉS TUXTLA,141,SALTO DE EYIPANTLA,6,784,335,449,39
VERACRUZ DE IGNACIO DE LA LLAVE,30,SAN ANDRÉS TUXTLA,141,SALVADOR DÍAZ MIRÓN (EL SALTO HUATUSCO),2,27,15,12,2
VERACRUZ DE IGNACIO DE LA LLAVE,30,SAN ANDRÉS TUXTLA,141,SAN ANDRÉS TUXTLA,94,14495,7340,7155,1131
VERACRUZ DE IGNACIO DE LA LLAVE,30,SAN ANDRÉS TUXTLA,141,SAN ISIDRO XOTEAPAN (SAN ISIDRO TEXCALTITÁN),2,217,123,94,13
VERACRUZ DE IGNACIO DE LA LLAVE,30,SAN ANDRÉS TUXTLA,141,SAN JUAN DE LA GLORIA,2,52,25,27,3
VERACRUZ DE IGNACIO DE LA LLAVE,30,SAN ANDRÉS TUXTLA,141,SAN LEOPOLDO,3,96,50,46,6
VERACRUZ DE IGNACIO DE LA LLAVE,30,SAN ANDRÉS TUXTLA,141,SAN MARCOS,1,10,9,1,1
VERACRUZ DE IGNACIO DE LA LLAVE,30,SAN ANDRÉS TUXTLA,141,SANTA ROSA ABATA,3,254,121,133,16
VERACRUZ DE IGNACIO DE LA LLAVE,30,SAN ANDRÉS TUXTLA,141,SIHUAPAN,5,848,396,452,50
VERACRUZ DE IGNACIO DE LA LLAVE,30,SAN ANDRÉS TUXTLA,141,SOYATA,4,276,131,145,18
VERACRUZ DE IGNACIO DE LA LLAVE,30,SAN ANDRÉS TUXTLA,141,TEPÁNCAN,4,823,378,445,34
VERACRUZ DE IGNACIO DE LA LLAVE,30,SAN ANDRÉS TUXTLA,141,TEXALPAN DE ABAJO,5,439,210,229,27
VERACRUZ DE IGNACIO DE LA LLAVE,30,SAN ANDRÉS TUXTLA,141,TEXALPAN DE ARRIBA,6,591,285,306,31
VERACRUZ DE IGNACIO DE LA LLAVE,30,SAN ANDRÉS TUXTLA,141,TEXCALTITÁN XOTEAPAN (TEXCALTITÁN),4,429,196,233,26
VERACRUZ DE IGNACIO DE LA LLAVE,30,SAN ANDRÉS TUXTLA,141,TILAPAN,4,555,275,280,29
VERACRUZ DE IGNACIO DE LA LLAVE,30,SAN ANDRÉS TUXTLA,141,TONALAPAN,3,219,96,123,16
VERACRUZ DE IGNACIO DE LA LLAVE,30,SAN ANDRÉS TUXTLA,141,TORO PRIETO,1,30,18,12,2
VERACRUZ DE IGNACIO DE LA LLAVE,30,SAN ANDRÉS TUXTLA,141,TRES ZAPOTES,2,30,13,17,2
VERACRUZ DE IGNACIO DE LA LLAVE,30,SAN ANDRÉS TUXTLA,141,TULAPAN,5,382,178,204,23
VERACRUZ DE IGNACIO DE LA LLAVE,30,SAN ANDRÉS TUXTLA,141,VISTA HERMOSA,1,17,11,6,1
VERACRUZ DE IGNACIO DE LA LLAVE,30,SAN ANDRÉS TUXTLA,141,VISTA HERMOSA II,3,36,22,14,4
VERACRUZ DE IGNACIO DE LA LLAVE,30,SAN ANDRÉS TUXTLA,141,XOTEAPAN,4,716,333,383,38
VERACRUZ DE IGNACIO DE LA LLAVE,30,SAN JUAN EVANGELISTA,142,ACHOTAL,4,191,109,82,13
VERACRUZ DE IGNACIO DE LA LLAVE,30,SAN JUAN EVANGELISTA,142,AGUACATILLO,2,34,21,13,3
VERACRUZ DE IGNACIO DE LA LLAVE,30,SAN JUAN EVANGELISTA,142,APOMPAL DEL DESLINDE,2,15,5,10,2
VERACRUZ DE IGNACIO DE LA LLAVE,30,SAN JUAN EVANGELISTA,142,BAJO LAS PALMAS,2,25,12,13,3
VERACRUZ DE IGNACIO DE LA LLAVE,30,SAN JUAN EVANGELISTA,142,BELLACO,3,159,74,85,11
VERACRUZ DE IGNACIO DE LA LLAVE,30,SAN JUAN EVANGELISTA,142,BENITO JUÁREZ,2,21,6,15,2
VERACRUZ DE IGNACIO DE LA LLAVE,30,SAN JUAN EVANGELISTA,142,CAMPO NUEVO,4,219,95,124,18
VERACRUZ DE IGNACIO DE LA LLAVE,30,SAN JUAN EVANGELISTA,142,CAOBAL,4,126,64,62,9
VERACRUZ DE IGNACIO DE LA LLAVE,30,SAN JUAN EVANGELISTA,142,CARTAGENA DE MICHAPAN,2,27,14,13,3
VERACRUZ DE IGNACIO DE LA LLAVE,30,SAN JUAN EVANGELISTA,142,CASCAJAL GRANDE,3,53,26,27,6
VERACRUZ DE IGNACIO DE LA LLAVE,30,SAN JUAN EVANGELISTA,142,CASCAJALITO,3,34,15,19,4
VERACRUZ DE IGNACIO DE LA LLAVE,30,SAN JUAN EVANGELISTA,142,CHAPOPOAPAN,2,110,43,67,7
VERACRUZ DE IGNACIO DE LA LLAVE,30,SAN JUAN EVANGELISTA,142,COLONIA LÁZARO CÁRDENAS (EL SALADERO),1,8,4,4,1
VERACRUZ DE IGNACIO DE LA LLAVE,30,SAN JUAN EVANGELISTA,142,COLONIA REFORMA AGRARIA,3,80,36,44,6
VERACRUZ DE IGNACIO DE LA LLAVE,30,SAN JUAN EVANGELISTA,142,COLONIA VILLA ALTA,4,166,79,87,9
VERACRUZ DE IGNACIO DE LA LLAVE,30,SAN JUAN EVANGELISTA,142,COLONIA VILLAHERMOSA,3,67,34,33,5
VERACRUZ DE IGNACIO DE LA LLAVE,30,SAN JUAN EVANGELISTA,142,CUAUHTÉMOC,2,21,6,15,2
VERACRUZ DE IGNACIO DE LA LLAVE,30,SAN JUAN EVANGELISTA,142,EJIDO EL IXTAL,2,30,15,15,2
VERACRUZ DE IGNACIO DE LA LLAVE,30,SAN JUAN EVANGELISTA,142,EJIDO FRANCISCO J. MORENO,2,27,13,14,2
VERACRUZ DE IGNACIO DE LA LLAVE,30,SAN JUAN EVANGELISTA,142,EJIDO FRANCISCO VILLA,2,27,11,16,2
VERACRUZ DE IGNACIO DE LA LLAVE,30,SAN JUAN EVANGELISTA,142,EJIDO GUADALUPE VICTORIA,3,88,49,39,6
VERACRUZ DE IGNACIO DE LA LLAVE,30,SAN JUAN EVANGELISTA,142,EJIDO LA GLORIA,2,38,18,20,3
VERACRUZ DE IGNACIO DE LA LLAVE,30,SAN JUAN EVANGELISTA,142,EJIDO LA SOLEDAD (MALOTA),2,9,4,5,2
VERACRUZ DE IGNACIO DE LA LLAVE,30,SAN JUAN EVANGELISTA,142,EJIDO LA UNIÓN Y CAMPO NUEVO,2,35,19,16,3
VERACRUZ DE IGNACIO DE LA LLAVE,30,SAN JUAN EVANGELISTA,142,EJIDO LÁZARO CÁRDENAS (LA GLORIA),2,73,39,34,6
VERACRUZ DE IGNACIO DE LA LLAVE,30,SAN JUAN EVANGELISTA,142,EJIDO MONTE VERDE,3,110,58,52,5
VERACRUZ DE IGNACIO DE LA LLAVE,30,SAN JUAN EVANGELISTA,142,EJIDO NICOLÁS BRAVO,2,26,14,12,2
VERACRUZ DE IGNACIO DE LA LLAVE,30,SAN JUAN EVANGELISTA,142,EJIDO NUEVO LÁZARO CÁRDENAS,3,50,25,25,4
VERACRUZ DE IGNACIO DE LA LLAVE,30,SAN JUAN EVANGELISTA,142,EJIDO NUEVO SALTILLO,2,18,9,9,2
VERACRUZ DE IGNACIO DE LA LLAVE,30,SAN JUAN EVANGELISTA,142,EJIDO VILLA GUERRERO MELCHOR OCAMPO,4,224,112,112,12
VERACRUZ DE IGNACIO DE LA LLAVE,30,SAN JUAN EVANGELISTA,142,EL MANANTIAL,3,90,45,45,6
VERACRUZ DE IGNACIO DE LA LLAVE,30,SAN JUAN EVANGELISTA,142,EMILIANO ZAPATA (LA LLORONA),2,39,18,21,2
VERACRUZ DE IGNACIO DE LA LLAVE,30,SAN JUAN EVANGELISTA,142,ESTACIÓN JUANITA,7,797,401,396,47
VERACRUZ DE IGNACIO DE LA LLAVE,30,SAN JUAN EVANGELISTA,142,FRANCISCO I. MADERO (PLAN DE LA GLORIA),1,13,5,8,1
VERACRUZ DE IGNACIO DE LA LLAVE,30,SAN JUAN EVANGELISTA,142,JALAPILLA,1,4,3,1,1
VERACRUZ DE IGNACIO DE LA LLAVE,30,SAN JUAN EVANGELISTA,142,JIMBA DE MICHAPAN,3,44,16,28,4
VERACRUZ DE IGNACIO DE LA LLAVE,30,SAN JUAN EVANGELISTA,142,LA CAUDALOSA,4,213,95,118,15
VERACRUZ DE IGNACIO DE LA LLAVE,30,SAN JUAN EVANGELISTA,142,LA CERQUILLA,5,557,274,283,28
VERACRUZ DE IGNACIO DE LA LLAVE,30,SAN JUAN EVANGELISTA,142,LA FORTUNA,1,15,9,6,1
VERACRUZ DE IGNACIO DE LA LLAVE,30,SAN JUAN EVANGELISTA,142,LA LIMA,3,103,51,52,9
VERACRUZ DE IGNACIO DE LA LLAVE,30,SAN JUAN EVANGELISTA,142,LAS FLORES,4,53,26,27,5
VERACRUZ DE IGNACIO DE LA LLAVE,30,SAN JUAN EVANGELISTA,142,LAS YAGUAS,2,31,19,12,3
VERACRUZ DE IGNACIO DE LA LLAVE,30,SAN JUAN EVANGELISTA,142,LOMA BONITA,2,24,14,10,4
VERACRUZ DE IGNACIO DE LA LLAVE,30,SAN JUAN EVANGELISTA,142,LOS ÁNGELES,2,39,19,20,3
VERACRUZ DE IGNACIO DE LA LLAVE,30,SAN JUAN EVANGELISTA,142,MATA DE CAÑA,4,24,15,9,3
VERACRUZ DE IGNACIO DE LA LLAVE,30,SAN JUAN EVANGELISTA,142,MICHAPAN DE OSORIO,3,104,59,45,7
VERACRUZ DE IGNACIO DE LA LLAVE,30,SAN JUAN EVANGELISTA,142,MIGUEL ALEMÁN,3,57,24,33,4
VERACRUZ DE IGNACIO DE LA LLAVE,30,SAN JUAN EVANGELISTA,142,POBLADO LOS ARCO IRIS,3,60,26,34,4
VERACRUZ DE IGNACIO DE LA LLAVE,30,SAN JUAN EVANGELISTA,142,QUETZALAPA (EL REFUGIO),2,33,11,22,3
VERACRUZ DE IGNACIO DE LA LLAVE,30,SAN JUAN EVANGELISTA,142,RANCHO NUEVO,3,193,84,109,11
VERACRUZ DE IGNACIO DE LA LLAVE,30,SAN JUAN EVANGELISTA,142,RAYA DE LAS CAROLINAS,1,9,4,5,1
VERACRUZ DE IGNACIO DE LA LLAVE,30,SAN JUAN EVANGELISTA,142,SAN FELIPE DE JESÚS,1,15,4,11,1
VERACRUZ DE IGNACIO DE LA LLAVE,30,SAN JUAN EVANGELISTA,142,SAN JUAN EVANGELISTA,10,894,452,442,66
VERACRUZ DE IGNACIO DE LA LLAVE,30,SAN JUAN EVANGELISTA,142,SAN JUANITO,1,14,6,8,1
VERACRUZ DE IGNACIO DE LA LLAVE,30,SAN JUAN EVANGELISTA,142,SAN LORENZO,2,5,4,1,1
VERACRUZ DE IGNACIO DE LA LLAVE,30,SAN JUAN EVANGELISTA,142,SAN PEDRO TULAPAN,3,34,15,19,3
VERACRUZ DE IGNACIO DE LA LLAVE,30,SAN JUAN EVANGELISTA,142,TIZAMAR,3,62,30,32,6
VERACRUZ DE IGNACIO DE LA LLAVE,30,SAN JUAN EVANGELISTA,142,VISTA HERMOSA,3,162,81,81,12
VERACRUZ DE IGNACIO DE LA LLAVE,30,SAN JUAN EVANGELISTA,142,ZACATAL,2,29,13,16,3
VERACRUZ DE IGNACIO DE LA LLAVE,30,SANTIAGO TUXTLA,143,ABELINO LAGUNES,1,37,14,23,2
VERACRUZ DE IGNACIO DE LA LLAVE,30,SANTIAGO TUXTLA,143,ALTA LUZ,2,15,8,7,2
VERACRUZ DE IGNACIO DE LA LLAVE,30,SANTIAGO TUXTLA,143,AMPLIACIÓN COBATA (VIGÍA LADERA),2,6,4,2,1
VERACRUZ DE IGNACIO DE LA LLAVE,30,SANTIAGO TUXTLA,143,ARROYO LARGO,3,89,44,45,7
VERACRUZ DE IGNACIO DE LA LLAVE,30,SANTIAGO TUXTLA,143,ARROYO SAN ISIDRO,3,186,103,83,11
VERACRUZ DE IGNACIO DE LA LLAVE,30,SANTIAGO TUXTLA,143,AYOTZINTLA,2,50,23,27,4
VERACRUZ DE IGNACIO DE LA LLAVE,30,SANTIAGO TUXTLA,143,BOCA DEL MONTE,3,107,58,49,7
VERACRUZ DE IGNACIO DE LA LLAVE,30,SANTIAGO TUXTLA,143,CAMACHO,2,53,29,24,3
VERACRUZ DE IGNACIO DE LA LLAVE,30,SANTIAGO TUXTLA,143,CERRO AZUL,1,4,2,2,1
VERACRUZ DE IGNACIO DE LA LLAVE,30,SANTIAGO TUXTLA,143,CERRO BLANCO,3,61,27,34,5
VERACRUZ DE IGNACIO DE LA LLAVE,30,SANTIAGO TUXTLA,143,CERRO DEL CUBILETE,2,15,5,10,1
VERACRUZ DE IGNACIO DE LA LLAVE,30,SANTIAGO TUXTLA,143,CERRO DEL VIGÍA DE ABAJO (VIGÍA COOPERATIVA),3,60,37,23,6
VERACRUZ DE IGNACIO DE LA LLAVE,30,SANTIAGO TUXTLA,143,CHILCHUTIUCA,1,50,22,28,3
VERACRUZ DE IGNACIO DE LA LLAVE,30,SANTIAGO TUXTLA,143,CHININIAPAN DE ARRIBA,1,9,5,4,1
VERACRUZ DE IGNACIO DE LA LLAVE,30,SANTIAGO TUXTLA,143,CINCO DE MAYO,2,52,26,26,3
VERACRUZ DE IGNACIO DE LA LLAVE,30,SANTIAGO TUXTLA,143,CRUZ DE VIDAÑA,3,66,33,33,8
VERACRUZ DE IGNACIO DE LA LLAVE,30,SANTIAGO TUXTLA,143,CUYUAPAN,1,4,2,2,1
VERACRUZ DE IGNACIO DE LA LLAVE,30,SANTIAGO TUXTLA,143,EL AGUAJE,1,22,14,8,1
VERACRUZ DE IGNACIO DE LA LLAVE,30,SANTIAGO TUXTLA,143,EL COYOL,3,79,41,38,5
VERACRUZ DE IGNACIO DE LA LLAVE,30,SANTIAGO TUXTLA,143,EL ESPINAL,3,40,19,21,4
VERACRUZ DE IGNACIO DE LA LLAVE,30,SANTIAGO TUXTLA,143,EL JIOTE,2,3,1,2,1
VERACRUZ DE IGNACIO DE LA LLAVE,30,SANTIAGO TUXTLA,143,EL MIRADOR,2,19,6,13,2
VERACRUZ DE IGNACIO DE LA LLAVE,30,SANTIAGO TUXTLA,143,EL MIRADOR (SAN MARQUITOS),3,286,145,141,14
VERACRUZ DE IGNACIO DE LA LLAVE,30,SANTIAGO TUXTLA,143,EL MORAL,3,27,9,18,4
VERACRUZ DE IGNACIO DE LA LLAVE,30,SANTIAGO TUXTLA,143,EL MORILLO,4,88,49,39,8
VERACRUZ DE IGNACIO DE LA LLAVE,30,SANTIAGO TUXTLA,143,EL MOSTAL,2,18,10,8,2
VERACRUZ DE IGNACIO DE LA LLAVE,30,SANTIAGO TUXTLA,143,EL NANCHITAL,2,5,2,3,1
VERACRUZ DE IGNACIO DE LA LLAVE,30,SANTIAGO TUXTLA,143,EL PALMAR,2,11,3,8,1
VERACRUZ DE IGNACIO DE LA LLAVE,30,SANTIAGO TUXTLA,143,EL PLATANAR,3,95,41,54,7
VERACRUZ DE IGNACIO DE LA LLAVE,30,SANTIAGO TUXTLA,143,EL POTRERO,2,40,22,18,3
VERACRUZ DE IGNACIO DE LA LLAVE,30,SANTIAGO TUXTLA,143,EL PREDIO DE LOS IXHUÁPAM,2,15,6,9,2
VERACRUZ DE IGNACIO DE LA LLAVE,30,SANTIAGO TUXTLA,143,EL PRETIL,2,4,2,2,1
VERACRUZ DE IGNACIO DE LA LLAVE,30,SANTIAGO TUXTLA,143,EL TULAR,2,20,13,7,2
VERACRUZ DE IGNACIO DE LA LLAVE,30,SANTIAGO TUXTLA,143,EL YUALE CHICO,3,45,32,13,4
VERACRUZ DE IGNACIO DE LA LLAVE,30,SANTIAGO TUXTLA,143,EL YUALE GRANDE,1,5,2,3,1
VERACRUZ DE IGNACIO DE LA LLAVE,30,SANTIAGO TUXTLA,143,EL ZAPOTAL,3,92,51,41,7
VERACRUZ DE IGNACIO DE LA LLAVE,30,SANTIAGO TUXTLA,143,EMILIANO ZAPATA,1,4,3,1,1
VERACRUZ DE IGNACIO DE LA LLAVE,30,SANTIAGO TUXTLA,143,FRANCISCO I. MADERO,5,402,186,216,23
VERACRUZ DE IGNACIO DE LA LLAVE,30,SANTIAGO TUXTLA,143,GUINDA,1,30,12,18,3
VERACRUZ DE IGNACIO DE LA LLAVE,30,SANTIAGO TUXTLA,143,ISLETILLA,2,26,15,11,3
VERACRUZ DE IGNACIO DE LA LLAVE,30,SANTIAGO TUXTLA,143,LA CEIBILLA,1,12,7,5,1
VERACRUZ DE IGNACIO DE LA LLAVE,30,SANTIAGO TUXTLA,143,LA FLORIDA,1,6,3,3,1
VERACRUZ DE IGNACIO DE LA LLAVE,30,SANTIAGO TUXTLA,143,LA MECHUDA,1,26,13,13,2
VERACRUZ DE IGNACIO DE LA LLAVE,30,SANTIAGO TUXTLA,143,LA PITAHAYA,3,91,44,47,7
VERACRUZ DE IGNACIO DE LA LLAVE,30,SANTIAGO TUXTLA,143,LAS POCHOTAS,4,175,76,99,9
VERACRUZ DE IGNACIO DE LA LLAVE,30,SANTIAGO TUXTLA,143,LICENCIADO ÁNGEL CARVAJAL (PROVIDENCIA II),2,22,10,12,2
VERACRUZ DE IGNACIO DE LA LLAVE,30,SANTIAGO TUXTLA,143,LOMAS DE ALONSO LÁZARO (EL BURRO),2,20,12,8,2
VERACRUZ DE IGNACIO DE LA LLAVE,30,SANTIAGO TUXTLA,143,MATA DE CAÑA,1,4,3,1,1
VERACRUZ DE IGNACIO DE LA LLAVE,30,SANTIAGO TUXTLA,143,MAXYAPÁN,3,133,68,65,10
VERACRUZ DE IGNACIO DE LA LLAVE,30,SANTIAGO TUXTLA,143,MAZATÁN,2,7,1,6,2
VERACRUZ DE IGNACIO DE LA LLAVE,30,SANTIAGO TUXTLA,143,MEDELLÍN,3,118,62,56,7
VERACRUZ DE IGNACIO DE LA LLAVE,30,SANTIAGO TUXTLA,143,MIGUEL HIDALGO Y COSTILLA,2,31,17,14,3
VERACRUZ DE IGNACIO DE LA LLAVE,30,SANTIAGO TUXTLA,143,NUEVO TOTLALLI,2,33,22,11,2
VERACRUZ DE IGNACIO DE LA LLAVE,30,SANTIAGO TUXTLA,143,OJO DE AGUA,3,71,35,36,5
VERACRUZ DE IGNACIO DE LA LLAVE,30,SANTIAGO TUXTLA,143,OMEAPAN,1,8,6,2,1
VERACRUZ DE IGNACIO DE LA LLAVE,30,SANTIAGO TUXTLA,143,PASO DEL AMATE,2,21,8,13,3
VERACRUZ DE IGNACIO DE LA LLAVE,30,SANTIAGO TUXTLA,143,PIXIXIAPAN,2,37,15,22,3
VERACRUZ DE IGNACIO DE LA LLAVE,30,SANTIAGO TUXTLA,143,POPOCTÉPETL,3,107,52,55,7
VERACRUZ DE IGNACIO DE LA LLAVE,30,SANTIAGO TUXTLA,143,PUEBLO NUEVO DEL MOSTAL,2,49,18,31,3
VERACRUZ DE IGNACIO DE LA LLAVE,30,SANTIAGO TUXTLA,143,RANCHO NUEVO,1,24,12,12,1
VERACRUZ DE IGNACIO DE LA LLAVE,30,SANTIAGO TUXTLA,143,RINCÓN DE SOSA,1,9,4,5,1
VERACRUZ DE IGNACIO DE LA LLAVE,30,SANTIAGO TUXTLA,143,RINCÓN DE ZAPATERO,4,245,113,132,16
VERACRUZ DE IGNACIO DE LA LLAVE,30,SANTIAGO TUXTLA,143,RÍO GRANDE,2,39,24,15,4
VERACRUZ DE IGNACIO DE LA LLAVE,30,SANTIAGO TUXTLA,143,SABANETA,1,7,3,4,1
VERACRUZ DE IGNACIO DE LA LLAVE,30,SANTIAGO TUXTLA,143,SALTO DE AGUA DE LOS ISLABA,2,50,25,25,3
VERACRUZ DE IGNACIO DE LA LLAVE,30,SANTIAGO TUXTLA,143,SALTO DE AGUA DE PÍO (DOS CAMINOS),3,49,24,25,6
VERACRUZ DE IGNACIO DE LA LLAVE,30,SANTIAGO TUXTLA,143,SAN ANTONIO DE LA HUERTA,4,274,141,133,17
VERACRUZ DE IGNACIO DE LA LLAVE,30,SANTIAGO TUXTLA,143,SAN DIEGO,2,14,9,5,2
VERACRUZ DE IGNACIO DE LA LLAVE,30,SANTIAGO TUXTLA,143,SAN MARCOS,2,39,20,19,3
VERACRUZ DE IGNACIO DE LA LLAVE,30,SANTIAGO TUXTLA,143,SAN SIMÓN,2,6,3,3,1
VERACRUZ DE IGNACIO DE LA LLAVE,30,SANTIAGO TUXTLA,143,SANTIAGO TUXTLA,28,3572,1794,1778,299
VERACRUZ DE IGNACIO DE LA LLAVE,30,SANTIAGO TUXTLA,143,SEHUALACA,4,360,188,172,23
VERACRUZ DE IGNACIO DE LA LLAVE,30,SANTIAGO TUXTLA,143,SESECAPAN,3,91,45,46,8
VERACRUZ DE IGNACIO DE LA LLAVE,30,SANTIAGO TUXTLA,143,SINAPÁN,3,233,105,128,15
VERACRUZ DE IGNACIO DE LA LLAVE,30,SANTIAGO TUXTLA,143,TAPALAPAN,4,402,191,211,29
VERACRUZ DE IGNACIO DE LA LLAVE,30,SANTIAGO TUXTLA,143,TETAX SESECAPAN,2,118,50,68,7
VERACRUZ DE IGNACIO DE LA LLAVE,30,SANTIAGO TUXTLA,143,TEXCOCHAPAN DE ABAJO,3,132,64,68,8
VERACRUZ DE IGNACIO DE LA LLAVE,30,SANTIAGO TUXTLA,143,TIBERNAL,4,167,84,83,12
VERACRUZ DE IGNACIO DE LA LLAVE,30,SANTIAGO TUXTLA,143,TLAPACOYAN,4,498,253,245,24
VERACRUZ DE IGNACIO DE LA LLAVE,30,SANTIAGO TUXTLA,143,TRES ZAPOTES,4,714,347,367,39
VERACRUZ DE IGNACIO DE LA LLAVE,30,SANTIAGO TUXTLA,143,TRES ZAPOTES DOS A (PALO HERRADO),1,9,2,7,1
VERACRUZ DE IGNACIO DE LA LLAVE,30,SANTIAGO TUXTLA,143,TRES ZAPOTES UNO,2,25,14,11,3
VERACRUZ DE IGNACIO DE LA LLAVE,30,SANTIAGO TUXTLA,143,VIGÍA CORONA,1,4,2,2,1
VERACRUZ DE IGNACIO DE LA LLAVE,30,SANTIAGO TUXTLA,143,VISTA HERMOSA,2,145,68,77,11
VERACRUZ DE IGNACIO DE LA LLAVE,30,SANTIAGO TUXTLA,143,XIGÜIPILINCAN,3,107,55,52,7
VERACRUZ DE IGNACIO DE LA LLAVE,30,SANTIAGO TUXTLA,143,ZACATAL (SAN JOSÉ BUENA VISTA),1,7,3,4,1
VERACRUZ DE IGNACIO DE LA LLAVE,30,SAYULA DE ALEMÁN,144,ADOLFO LÓPEZ MATEOS,3,72,35,37,4
VERACRUZ DE IGNACIO DE LA LLAVE,30,SAYULA DE ALEMÁN,144,AGUILERA,6,558,278,280,33
VERACRUZ DE IGNACIO DE LA LLAVE,30,SAYULA DE ALEMÁN,144,ALFREDO V. BONFIL,2,10,6,4,2
VERACRUZ DE IGNACIO DE LA LLAVE,30,SAYULA DE ALEMÁN,144,ALMAGRES,5,417,185,232,26
VERACRUZ DE IGNACIO DE LA LLAVE,30,SAYULA DE ALEMÁN,144,ARMANDO HERRERA,3,36,18,18,4
VERACRUZ DE IGNACIO DE LA LLAVE,30,SAYULA DE ALEMÁN,144,CRUZ DEL MILAGRO,5,371,184,187,23
VERACRUZ DE IGNACIO DE LA LLAVE,30,SAYULA DE ALEMÁN,144,EL ALICANTE,1,19,10,9,2
VERACRUZ DE IGNACIO DE LA LLAVE,30,SAYULA DE ALEMÁN,144,EL JUILE,3,158,83,75,11
VERACRUZ DE IGNACIO DE LA LLAVE,30,SAYULA DE ALEMÁN,144,EL ORIENTE,1,22,14,8,2
VERACRUZ DE IGNACIO DE LA LLAVE,30,SAYULA DE ALEMÁN,144,EL PROGRESO MIXE,5,192,87,105,12
VERACRUZ DE IGNACIO DE LA LLAVE,30,SAYULA DE ALEMÁN,144,EL REFUGIO,2,31,19,12,2
VERACRUZ DE IGNACIO DE LA LLAVE,30,SAYULA DE ALEMÁN,144,EL SUSPIRO,2,16,8,8,2
VERACRUZ DE IGNACIO DE LA LLAVE,30,SAYULA DE ALEMÁN,144,EMILIANO ZAPATA (SAYULITA),2,29,17,12,2
VERACRUZ DE IGNACIO DE LA LLAVE,30,SAYULA DE ALEMÁN,144,GELACIA CEBALLOS GÓMEZ (EL AZUFRE),1,7,2,5,1
VERACRUZ DE IGNACIO DE LA LLAVE,30,SAYULA DE ALEMÁN,144,GENERAL MIGUEL ALEMÁN,1,6,4,2,1
VERACRUZ DE IGNACIO DE LA LLAVE,30,SAYULA DE ALEMÁN,144,LA ESPERANZA,1,9,3,6,1
VERACRUZ DE IGNACIO DE LA LLAVE,30,SAYULA DE ALEMÁN,144,LA FLORIDA,2,23,8,15,2
VERACRUZ DE IGNACIO DE LA LLAVE,30,SAYULA DE ALEMÁN,144,LA PROVIDENCIA,2,20,11,9,2
VERACRUZ DE IGNACIO DE LA LLAVE,30,SAYULA DE ALEMÁN,144,LA PROVIDENCIA (CANGREJERA),1,15,7,8,1
VERACRUZ DE IGNACIO DE LA LLAVE,30,SAYULA DE ALEMÁN,144,LA VICTORIA UNO,6,181,87,94,12
VERACRUZ DE IGNACIO DE LA LLAVE,30,SAYULA DE ALEMÁN,144,LÁZARO CÁRDENAS (ADOLFO RUIZ CORTINES),2,31,13,18,2
VERACRUZ DE IGNACIO DE LA LLAVE,30,SAYULA DE ALEMÁN,144,LOS REYES,1,13,8,5,1
VERACRUZ DE IGNACIO DE LA LLAVE,30,SAYULA DE ALEMÁN,144,MACAYA,2,41,23,18,3
VERACRUZ DE IGNACIO DE LA LLAVE,30,SAYULA DE ALEMÁN,144,MEDIAS AGUAS,5,262,125,137,15
VERACRUZ DE IGNACIO DE LA LLAVE,30,SAYULA DE ALEMÁN,144,PALMA MORENA,2,23,13,10,2
VERACRUZ DE IGNACIO DE LA LLAVE,30,SAYULA DE ALEMÁN,144,PARAÍSO NARANJO,4,132,53,79,8
VERACRUZ DE IGNACIO DE LA LLAVE,30,SAYULA DE ALEMÁN,144,ROMERO RUBIO,3,69,41,28,5
VERACRUZ DE IGNACIO DE LA LLAVE,30,SAYULA DE ALEMÁN,144,RUBÉN M. JARAMILLO,1,13,1,12,1
VERACRUZ DE IGNACIO DE LA LLAVE,30,SAYULA DE ALEMÁN,144,SAN ANTONIO,1,7,1,6,1
VERACRUZ DE IGNACIO DE LA LLAVE,30,SAYULA DE ALEMÁN,144,SAN FRANCISCO EL MORAL,2,22,15,7,2
VERACRUZ DE IGNACIO DE LA LLAVE,30,SAYULA DE ALEMÁN,144,SAN ISIDRO,3,36,23,13,3
VERACRUZ DE IGNACIO DE LA LLAVE,30,SAYULA DE ALEMÁN,144,SAN JOSÉ DEL PALMAR,2,12,6,6,2
VERACRUZ DE IGNACIO DE LA LLAVE,30,SAYULA DE ALEMÁN,144,SAN LUIS,2,32,11,21,2
VERACRUZ DE IGNACIO DE LA LLAVE,30,SAYULA DE ALEMÁN,144,SANTA ROSA DE AMAPAN,1,10,4,6,1
VERACRUZ DE IGNACIO DE LA LLAVE,30,SAYULA DE ALEMÁN,144,SANTA TERESITA,2,26,12,14,3
VERACRUZ DE IGNACIO DE LA LLAVE,30,SAYULA DE ALEMÁN,144,SAYULA DE ALEMÁN,23,3692,1827,1865,219
VERACRUZ DE IGNACIO DE LA LLAVE,30,SAYULA DE ALEMÁN,144,VALLE HERMOSO,2,7,5,2,1
VERACRUZ DE IGNACIO DE LA LLAVE,30,SAYULA DE ALEMÁN,144,VEINTE DE NOVIEMBRE,2,68,29,39,4
VERACRUZ DE IGNACIO DE LA LLAVE,30,SAYULA DE ALEMÁN,144,VEINTISIETE DE SEPTIEMBRE,2,28,20,8,2
VERACRUZ DE IGNACIO DE LA LLAVE,30,SOCONUSCO,145,BENITO JUÁREZ,1,9,4,5,1
VERACRUZ DE IGNACIO DE LA LLAVE,30,SOCONUSCO,145,CHALCOMULCO,3,108,47,61,10
VERACRUZ DE IGNACIO DE LA LLAVE,30,SOCONUSCO,145,CHOGOTA,4,101,47,54,9
VERACRUZ DE IGNACIO DE LA LLAVE,30,SOCONUSCO,145,COLONIA LEALTAD,4,506,230,276,19
VERACRUZ DE IGNACIO DE LA LLAVE,30,SOCONUSCO,145,EJIDO LA VIRGEN,4,132,66,66,12
VERACRUZ DE IGNACIO DE LA LLAVE,30,SOCONUSCO,145,EL CASTAÑO,1,23,13,10,2
VERACRUZ DE IGNACIO DE LA LLAVE,30,SOCONUSCO,145,FRACCIONAMIENTO SANTA CRUZ,3,310,159,151,18
VERACRUZ DE IGNACIO DE LA LLAVE,30,SOCONUSCO,145,LA COLMENA,3,65,35,30,7
VERACRUZ DE IGNACIO DE LA LLAVE,30,SOCONUSCO,145,LA PROVIDENCIA,1,17,8,9,2
VERACRUZ DE IGNACIO DE LA LLAVE,30,SOCONUSCO,145,PALMARILLO,2,28,17,11,2
VERACRUZ DE IGNACIO DE LA LLAVE,30,SOCONUSCO,145,SOCONUSCO,8,1322,634,688,72
VERACRUZ DE IGNACIO DE LA LLAVE,30,SOCHIAPA,146,GUADALUPE VICTORIA,4,166,78,88,11
VERACRUZ DE IGNACIO DE LA LLAVE,30,SOCHIAPA,146,LA CAROLINA,1,8,5,3,1
VERACRUZ DE IGNACIO DE LA LLAVE,30,SOCHIAPA,146,LA RAYA (RANCHO VIEJO),1,14,10,4,1
VERACRUZ DE IGNACIO DE LA LLAVE,30,SOCHIAPA,146,LIMÓN,2,113,60,53,6
VERACRUZ DE IGNACIO DE LA LLAVE,30,SOCHIAPA,146,RANCHO NUEVO,1,18,8,10,2
VERACRUZ DE IGNACIO DE LA LLAVE,30,SOCHIAPA,146,SANTA MARÍA,1,25,11,14,3
VERACRUZ DE IGNACIO DE LA LLAVE,30,SOCHIAPA,146,SOCHIAPA,4,340,160,180,21
VERACRUZ DE IGNACIO DE LA LLAVE,30,SOCHIAPA,146,TOMATLANCILLO,3,112,47,65,7
VERACRUZ DE IGNACIO DE LA LLAVE,30,SOLEDAD ATZOMPA,147,ACUAPA,2,74,32,42,4
VERACRUZ DE IGNACIO DE LA LLAVE,30,SOLEDAD ATZOMPA,147,ACULTZINAPA,4,297,148,149,15
VERACRUZ DE IGNACIO DE LA LLAVE,30,SOLEDAD ATZOMPA,147,AHUACUITLAPA,2,33,21,12,3
VERACRUZ DE IGNACIO DE LA LLAVE,30,SOLEDAD ATZOMPA,147,AHUATEMPA,2,47,21,26,3
VERACRUZ DE IGNACIO DE LA LLAVE,30,SOLEDAD ATZOMPA,147,ATEMPA,2,61,26,35,3
VERACRUZ DE IGNACIO DE LA LLAVE,30,SOLEDAD ATZOMPA,147,ATEXCALCO,2,76,41,35,3
VERACRUZ DE IGNACIO DE LA LLAVE,30,SOLEDAD ATZOMPA,147,ATZOMPA,8,1079,506,573,55
VERACRUZ DE IGNACIO DE LA LLAVE,30,SOLEDAD ATZOMPA,147,BARRIO NUEVO,2,38,19,19,3
VERACRUZ DE IGNACIO DE LA LLAVE,30,SOLEDAD ATZOMPA,147,BENITO JUÁREZ,2,40,23,17,3
VERACRUZ DE IGNACIO DE LA LLAVE,30,SOLEDAD ATZOMPA,147,BUENA VISTA,3,319,170,149,17
VERACRUZ DE IGNACIO DE LA LLAVE,30,SOLEDAD ATZOMPA,147,EL PARAÍSO,1,4,3,1,1
VERACRUZ DE IGNACIO DE LA LLAVE,30,SOLEDAD ATZOMPA,147,EL PORVENIR,2,32,22,10,3
VERACRUZ DE IGNACIO DE LA LLAVE,30,SOLEDAD ATZOMPA,147,EMILIANO ZAPATA,1,21,11,10,1
VERACRUZ DE IGNACIO DE LA LLAVE,30,SOLEDAD ATZOMPA,147,EXOQUILA,1,6,2,4,1
VERACRUZ DE IGNACIO DE LA LLAVE,30,SOLEDAD ATZOMPA,147,HUITZILA,5,772,381,391,54
VERACRUZ DE IGNACIO DE LA LLAVE,30,SOLEDAD ATZOMPA,147,HUIXTITLA,2,152,60,92,7
VERACRUZ DE IGNACIO DE LA LLAVE,30,SOLEDAD ATZOMPA,147,LAS PORFIADAS,2,56,36,20,3
VERACRUZ DE IGNACIO DE LA LLAVE,30,SOLEDAD ATZOMPA,147,LINDA VISTA,2,57,30,27,5
VERACRUZ DE IGNACIO DE LA LLAVE,30,SOLEDAD ATZOMPA,147,LOS CAPULINES,2,76,35,41,4
VERACRUZ DE IGNACIO DE LA LLAVE,30,SOLEDAD ATZOMPA,147,MEXCALA,3,332,181,151,14
VERACRUZ DE IGNACIO DE LA LLAVE,30,SOLEDAD ATZOMPA,147,MONTERREY,2,152,76,76,8
VERACRUZ DE IGNACIO DE LA LLAVE,30,SOLEDAD ATZOMPA,147,SAN JUAN DE LOS LAGOS,2,112,55,57,7
VERACRUZ DE IGNACIO DE LA LLAVE,30,SOLEDAD ATZOMPA,147,SOLEDAD ATZOMPA,3,196,103,93,9
VERACRUZ DE IGNACIO DE LA LLAVE,30,SOLEDAD ATZOMPA,147,TEOTLALCO,2,51,31,20,4
VERACRUZ DE IGNACIO DE LA LLAVE,30,SOLEDAD ATZOMPA,147,TEPAXAPA,4,251,128,123,14
VERACRUZ DE IGNACIO DE LA LLAVE,30,SOLEDAD ATZOMPA,147,TEPEXPAN,2,85,39,46,4
VERACRUZ DE IGNACIO DE LA LLAVE,30,SOLEDAD ATZOMPA,147,TETLA (IXTACAHUATITLA),2,13,7,6,2
VERACRUZ DE IGNACIO DE LA LLAVE,30,SOLEDAD ATZOMPA,147,TETLATZINGA,2,142,80,62,8
VERACRUZ DE IGNACIO DE LA LLAVE,30,SOLEDAD ATZOMPA,147,TLALPAN,2,147,71,76,8
VERACRUZ DE IGNACIO DE LA LLAVE,30,SOLEDAD ATZOMPA,147,TLALTZALA,4,347,190,157,15
VERACRUZ DE IGNACIO DE LA LLAVE,30,SOLEDAD ATZOMPA,147,TLATILPA,4,282,144,138,15
VERACRUZ DE IGNACIO DE LA LLAVE,30,SOLEDAD ATZOMPA,147,VILLA NUEVA,2,31,17,14,3
VERACRUZ DE IGNACIO DE LA LLAVE,30,SOLEDAD ATZOMPA,147,XIQUILA,3,221,106,115,11
VERACRUZ DE IGNACIO DE LA LLAVE,30,SOLEDAD ATZOMPA,147,XONOTLA,3,294,161,133,15
VERACRUZ DE IGNACIO DE LA LLAVE,30,SOLEDAD ATZOMPA,147,ZACATEPEC,2,11,4,7,2
VERACRUZ DE IGNACIO DE LA LLAVE,30,SOLEDAD DE DOBLADO,148,ADALBERTO TEJEDA (LA IGUANA),2,4,2,2,1
VERACRUZ DE IGNACIO DE LA LLAVE,30,SOLEDAD DE DOBLADO,148,BARRANCA DE PALMA,1,13,6,7,1
VERACRUZ DE IGNACIO DE LA LLAVE,30,SOLEDAD DE DOBLADO,148,BUENAVISTA,1,7,4,3,1
VERACRUZ DE IGNACIO DE LA LLAVE,30,SOLEDAD DE DOBLADO,148,COLONIA JOSÉ CARDEL,2,27,14,13,4
VERACRUZ DE IGNACIO DE LA LLAVE,30,SOLEDAD DE DOBLADO,148,EL CEDRO,2,23,10,13,3
VERACRUZ DE IGNACIO DE LA LLAVE,30,SOLEDAD DE DOBLADO,148,EL IZOTE,2,21,11,10,3
VERACRUZ DE IGNACIO DE LA LLAVE,30,SOLEDAD DE DOBLADO,148,EL ORGANAL,1,10,4,6,1
VERACRUZ DE IGNACIO DE LA LLAVE,30,SOLEDAD DE DOBLADO,148,EL PROGRESO (MATA NOVILLO),1,12,7,5,1
VERACRUZ DE IGNACIO DE LA LLAVE,30,SOLEDAD DE DOBLADO,148,EL ROSARIO,4,71,34,37,7
VERACRUZ DE IGNACIO DE LA LLAVE,30,SOLEDAD DE DOBLADO,148,EMILIO CARRANZA,1,8,4,4,1
VERACRUZ DE IGNACIO DE LA LLAVE,30,SOLEDAD DE DOBLADO,148,ESPINAL DE SANTA BÁRBARA,2,45,23,22,3
VERACRUZ DE IGNACIO DE LA LLAVE,30,SOLEDAD DE DOBLADO,148,HUIHUIXTLA,1,16,11,5,1
VERACRUZ DE IGNACIO DE LA LLAVE,30,SOLEDAD DE DOBLADO,148,LA CRUZ (LÁZARO CÁRDENAS),1,10,7,3,1
VERACRUZ DE IGNACIO DE LA LLAVE,30,SOLEDAD DE DOBLADO,148,LA GUADALUPE (MATA DE LOROS),3,12,4,8,2
VERACRUZ DE IGNACIO DE LA LLAVE,30,SOLEDAD DE DOBLADO,148,LA ORIENTAL,2,31,12,19,4
VERACRUZ DE IGNACIO DE LA LLAVE,30,SOLEDAD DE DOBLADO,148,LA UNIÓN UNO,3,96,48,48,7
VERACRUZ DE IGNACIO DE LA LLAVE,30,SOLEDAD DE DOBLADO,148,LAGUNA BLANCA,2,46,24,22,3
VERACRUZ DE IGNACIO DE LA LLAVE,30,SOLEDAD DE DOBLADO,148,LAS REMOJADAS,3,152,79,73,11
VERACRUZ DE IGNACIO DE LA LLAVE,30,SOLEDAD DE DOBLADO,148,LOMA DE SANTA BÁRBARA (EL ORGANAL),2,30,12,18,3
VERACRUZ DE IGNACIO DE LA LLAVE,30,SOLEDAD DE DOBLADO,148,LOMA DEL FARO (EL TOCHE),1,24,11,13,1
VERACRUZ DE IGNACIO DE LA LLAVE,30,SOLEDAD DE DOBLADO,148,LOS GUAJITOS,2,56,25,31,5
VERACRUZ DE IGNACIO DE LA LLAVE,30,SOLEDAD DE DOBLADO,148,LOS PORTALES,2,16,5,11,2
VERACRUZ DE IGNACIO DE LA LLAVE,30,SOLEDAD DE DOBLADO,148,LOS TETELES,2,24,9,15,2
VERACRUZ DE IGNACIO DE LA LLAVE,30,SOLEDAD DE DOBLADO,148,MATA BRUJA,2,9,5,4,1
VERACRUZ DE IGNACIO DE LA LLAVE,30,SOLEDAD DE DOBLADO,148,MATA CAZUELA,4,186,92,94,14
VERACRUZ DE IGNACIO DE LA LLAVE,30,SOLEDAD DE DOBLADO,148,MATA CONEJO,1,13,8,5,1
VERACRUZ DE IGNACIO DE LA LLAVE,30,SOLEDAD DE DOBLADO,148,MATA NOVILLO,1,44,24,20,3
VERACRUZ DE IGNACIO DE LA LLAVE,30,SOLEDAD DE DOBLADO,148,MATA REDONDA,3,38,23,15,4
VERACRUZ DE IGNACIO DE LA LLAVE,30,SOLEDAD DE DOBLADO,148,MIRADOR DE SANTA ROSA,3,98,53,45,6
VERACRUZ DE IGNACIO DE LA LLAVE,30,SOLEDAD DE DOBLADO,148,MIRALEJOS,2,28,12,16,3
VERACRUZ DE IGNACIO DE LA LLAVE,30,SOLEDAD DE DOBLADO,148,OAXAQUILLA,2,12,8,4,2
VERACRUZ DE IGNACIO DE LA LLAVE,30,SOLEDAD DE DOBLADO,148,PASO CABESTRO,1,23,17,6,1
VERACRUZ DE IGNACIO DE LA LLAVE,30,SOLEDAD DE DOBLADO,148,PASO DON ROQUE,1,10,7,3,1
VERACRUZ DE IGNACIO DE LA LLAVE,30,SOLEDAD DE DOBLADO,148,PASO LAGARTO,4,92,46,46,8
VERACRUZ DE IGNACIO DE LA LLAVE,30,SOLEDAD DE DOBLADO,148,PASO LAS PINTAS,1,23,11,12,2
VERACRUZ DE IGNACIO DE LA LLAVE,30,SOLEDAD DE DOBLADO,148,PASO NARANJO ORIENTE,1,9,3,6,1
VERACRUZ DE IGNACIO DE LA LLAVE,30,SOLEDAD DE DOBLADO,148,PASO NARANJO PONIENTE,2,14,3,11,2
VERACRUZ DE IGNACIO DE LA LLAVE,30,SOLEDAD DE DOBLADO,148,PASO SANTIAGO,3,54,24,30,5
VERACRUZ DE IGNACIO DE LA LLAVE,30,SOLEDAD DE DOBLADO,148,PASO SOLANO (EJIDO MIRADOR Y ANEXOS),4,160,75,85,10
VERACRUZ DE IGNACIO DE LA LLAVE,30,SOLEDAD DE DOBLADO,148,PUERTA DE MATA ANONA,2,33,13,20,3
VERACRUZ DE IGNACIO DE LA LLAVE,30,SOLEDAD DE DOBLADO,148,RINCÓN DE LOS TOROS,1,22,10,12,1
VERACRUZ DE IGNACIO DE LA LLAVE,30,SOLEDAD DE DOBLADO,148,SANTA CRUZ,3,77,39,38,4
VERACRUZ DE IGNACIO DE LA LLAVE,30,SOLEDAD DE DOBLADO,148,SANTA RITA,2,3,3,0,1
VERACRUZ DE IGNACIO DE LA LLAVE,30,SOLEDAD DE DOBLADO,148,SANTA ROSA,1,10,4,6,1
VERACRUZ DE IGNACIO DE LA LLAVE,30,SOLEDAD DE DOBLADO,148,SOLEDAD DE DOBLADO,22,3527,1778,1749,200
VERACRUZ DE IGNACIO DE LA LLAVE,30,SOLEDAD DE DOBLADO,148,TAMARINDO DE SAN MIGUEL,2,36,17,19,3
VERACRUZ DE IGNACIO DE LA LLAVE,30,SOLEDAD DE DOBLADO,148,TAMARINDO UNO (TAMARINDO DE CONRADO),1,16,11,5,1
VERACRUZ DE IGNACIO DE LA LLAVE,30,SOLEDAD DE DOBLADO,148,TEPETATES,3,91,48,43,6
VERACRUZ DE IGNACIO DE LA LLAVE,30,SOLEDAD DE DOBLADO,148,TIZALTEPEC,2,48,20,28,5
VERACRUZ DE IGNACIO DE LA LLAVE,30,SOLEDAD DE DOBLADO,148,VISTA HERMOSA,1,15,11,4,2
VERACRUZ DE IGNACIO DE LA LLAVE,30,SOLEDAD DE DOBLADO,148,VISTA HERMOSA SUR,2,17,11,6,2
VERACRUZ DE IGNACIO DE LA LLAVE,30,SOTEAPAN,149,AMAMALOYA,3,102,41,61,8
VERACRUZ DE IGNACIO DE LA LLAVE,30,SOTEAPAN,149,BASTONAL,2,17,10,7,2
VERACRUZ DE IGNACIO DE LA LLAVE,30,SOTEAPAN,149,BUENA VISTA,6,1285,626,659,61
VERACRUZ DE IGNACIO DE LA LLAVE,30,SOTEAPAN,149,CERRO COLORADO,3,50,20,30,4
VERACRUZ DE IGNACIO DE LA LLAVE,30,SOTEAPAN,149,COLONIA BENITO JUÁREZ,6,865,435,430,45
VERACRUZ DE IGNACIO DE LA LLAVE,30,SOTEAPAN,149,COLONIA LA MAGDALENA,4,247,114,133,13
VERACRUZ DE IGNACIO DE LA LLAVE,30,SOTEAPAN,149,CUILONIA,2,39,21,18,2
VERACRUZ DE IGNACIO DE LA LLAVE,30,SOTEAPAN,149,CUILONIA NUEVA,3,141,81,60,11
VERACRUZ DE IGNACIO DE LA LLAVE,30,SOTEAPAN,149,EL TULÍN,4,356,161,195,21
VERACRUZ DE IGNACIO DE LA LLAVE,30,SOTEAPAN,149,HILARIO C. SALAS,4,275,148,127,13
VERACRUZ DE IGNACIO DE LA LLAVE,30,SOTEAPAN,149,KILÓMETRO DIEZ,3,46,20,26,4
VERACRUZ DE IGNACIO DE LA LLAVE,30,SOTEAPAN,149,LA ESTRIBERA,3,157,76,81,11
VERACRUZ DE IGNACIO DE LA LLAVE,30,SOTEAPAN,149,LA FLORIDA,2,70,31,39,5
VERACRUZ DE IGNACIO DE LA LLAVE,30,SOTEAPAN,149,LAS PALOMAS (BAJO PALOMA),4,238,127,111,14
VERACRUZ DE IGNACIO DE LA LLAVE,30,SOTEAPAN,149,LOS ARIAS,1,8,3,5,1
VERACRUZ DE IGNACIO DE LA LLAVE,30,SOTEAPAN,149,MAZUMIAPAN CHICO,2,45,18,27,2
VERACRUZ DE IGNACIO DE LA LLAVE,30,SOTEAPAN,149,MIRADOR SALTILLO,5,248,118,130,20
VERACRUZ DE IGNACIO DE LA LLAVE,30,SOTEAPAN,149,MORELOS,6,971,472,499,49
VERACRUZ DE IGNACIO DE LA LLAVE,30,SOTEAPAN,149,NUEVO MÉXICO,1,5,2,3,1
VERACRUZ DE IGNACIO DE LA LLAVE,30,SOTEAPAN,149,OCOTAL CHICO,4,330,163,167,18
VERACRUZ DE IGNACIO DE LA LLAVE,30,SOTEAPAN,149,OCOTAL GRANDE,3,190,96,94,10
VERACRUZ DE IGNACIO DE LA LLAVE,30,SOTEAPAN,149,OCOZOTEPEC,5,739,350,389,39
VERACRUZ DE IGNACIO DE LA LLAVE,30,SOTEAPAN,149,POP-SOJNAS,1,11,8,3,1
VERACRUZ DE IGNACIO DE LA LLAVE,30,SOTEAPAN,149,REFORMA AGRARIA,2,35,16,19,2
VERACRUZ DE IGNACIO DE LA LLAVE,30,SOTEAPAN,149,SAN ANTONIO,3,166,78,88,11
VERACRUZ DE IGNACIO DE LA LLAVE,30,SOTEAPAN,149,SAN FERNANDO,3,224,112,112,15
VERACRUZ DE IGNACIO DE LA LLAVE,30,SOTEAPAN,149,SAN MARTÍN,2,41,22,19,3
VERACRUZ DE IGNACIO DE LA LLAVE,30,SOTEAPAN,149,SAN PEDRITO,2,39,17,22,3
VERACRUZ DE IGNACIO DE LA LLAVE,30,SOTEAPAN,149,SANTA MARTHA,3,91,49,42,6
VERACRUZ DE IGNACIO DE LA LLAVE,30,SOTEAPAN,149,SOTEAPAN,7,1687,809,878,76
VERACRUZ DE IGNACIO DE LA LLAVE,30,SOTEAPAN,149,TIERRA Y LIBERTAD,4,182,89,93,12
VERACRUZ DE IGNACIO DE LA LLAVE,30,TAMALÍN,150,AMPLIACIÓN EJIDO RINCÓN,2,46,20,26,3
VERACRUZ DE IGNACIO DE LA LLAVE,30,TAMALÍN,150,AMPLIACIÓN PALMARILLO,2,10,6,4,1
VERACRUZ DE IGNACIO DE LA LLAVE,30,TAMALÍN,150,CALMECATE,3,47,25,22,5
VERACRUZ DE IGNACIO DE LA LLAVE,30,TAMALÍN,150,CARMONA Y VALLE,2,58,24,34,7
VERACRUZ DE IGNACIO DE LA LLAVE,30,TAMALÍN,150,EJIDO CEDRAL,1,6,3,3,1
VERACRUZ DE IGNACIO DE LA LLAVE,30,TAMALÍN,150,EL CEDRAL (POBLADO EL CEDRAL),4,46,20,26,5
VERACRUZ DE IGNACIO DE LA LLAVE,30,TAMALÍN,150,EL MAGUEY,2,22,15,7,3
VERACRUZ DE IGNACIO DE LA LLAVE,30,TAMALÍN,150,EL RINCÓN,4,71,37,34,6
VERACRUZ DE IGNACIO DE LA LLAVE,30,TAMALÍN,150,ESCOBAL (EJIDO ESCOBAL),2,24,12,12,4
VERACRUZ DE IGNACIO DE LA LLAVE,30,TAMALÍN,150,HACIENDA VIEJA,1,10,6,4,1
VERACRUZ DE IGNACIO DE LA LLAVE,30,TAMALÍN,150,LA CEBADILLA,1,7,3,4,1
VERACRUZ DE IGNACIO DE LA LLAVE,30,TAMALÍN,150,LA MERCED,1,9,3,6,1
VERACRUZ DE IGNACIO DE LA LLAVE,30,TAMALÍN,150,LA RIVERITA,1,11,2,9,1
VERACRUZ DE IGNACIO DE LA LLAVE,30,TAMALÍN,150,LAS PIEDRAS,1,18,8,10,2
VERACRUZ DE IGNACIO DE LA LLAVE,30,TAMALÍN,150,LOS POTREROS,4,88,49,39,8
VERACRUZ DE IGNACIO DE LA LLAVE,30,TAMALÍN,150,MAMEY LA MAR,4,161,80,81,12
VERACRUZ DE IGNACIO DE LA LLAVE,30,TAMALÍN,150,PALMARILLO,3,78,35,43,9
VERACRUZ DE IGNACIO DE LA LLAVE,30,TAMALÍN,150,RANCHO NUEVO,1,10,3,7,2
VERACRUZ DE IGNACIO DE LA LLAVE,30,TAMALÍN,150,SALADERO,5,163,75,88,22
VERACRUZ DE IGNACIO DE LA LLAVE,30,TAMALÍN,150,SAN JERÓNIMO (LA GUÁSIMA),2,30,12,18,2
VERACRUZ DE IGNACIO DE LA LLAVE,30,TAMALÍN,150,TAMALÍN,8,1112,569,543,68
VERACRUZ DE IGNACIO DE LA LLAVE,30,TAMIAHUA,151,ACALA,4,80,44,36,10
VERACRUZ DE IGNACIO DE LA LLAVE,30,TAMIAHUA,151,BALCÁZAR,3,62,31,31,7
VERACRUZ DE IGNACIO DE LA LLAVE,30,TAMIAHUA,151,BARRA DE CORAZONES,2,17,9,8,3
VERACRUZ DE IGNACIO DE LA LLAVE,30,TAMIAHUA,151,BENITO JUÁREZ SEGUNDO,3,30,18,12,4
VERACRUZ DE IGNACIO DE LA LLAVE,30,TAMIAHUA,151,BUENAVISTA,3,36,11,25,4
VERACRUZ DE IGNACIO DE LA LLAVE,30,TAMIAHUA,151,COYOLAR,2,16,5,11,2
VERACRUZ DE IGNACIO DE LA LLAVE,30,TAMIAHUA,151,CUECILLOS,1,15,7,8,2
VERACRUZ DE IGNACIO DE LA LLAVE,30,TAMIAHUA,151,EL ANONO,4,171,76,95,15
VERACRUZ DE IGNACIO DE LA LLAVE,30,TAMIAHUA,151,EL BRUJO,1,7,2,5,1
VERACRUZ DE IGNACIO DE LA LLAVE,30,TAMIAHUA,151,EL CAFETAL,3,78,40,38,8
VERACRUZ DE IGNACIO DE LA LLAVE,30,TAMIAHUA,151,EL CHIJOLAR,2,19,9,10,2
VERACRUZ DE IGNACIO DE LA LLAVE,30,TAMIAHUA,151,EL COYOL,3,23,7,16,3
VERACRUZ DE IGNACIO DE LA LLAVE,30,TAMIAHUA,151,EL MESÓN,4,74,33,41,9
VERACRUZ DE IGNACIO DE LA LLAVE,30,TAMIAHUA,151,EL NARANJAL,2,27,12,15,2
VERACRUZ DE IGNACIO DE LA LLAVE,30,TAMIAHUA,151,EL OJITAL,2,21,12,9,2
VERACRUZ DE IGNACIO DE LA LLAVE,30,TAMIAHUA,151,EL PIÑAL,1,6,3,3,1
VERACRUZ DE IGNACIO DE LA LLAVE,30,TAMIAHUA,151,ESTERO DE MILPAS,3,299,147,152,40
VERACRUZ DE IGNACIO DE LA LLAVE,30,TAMIAHUA,151,EX-HACIENDA DOCTOR LAVISTA,5,85,39,46,13
VERACRUZ DE IGNACIO DE LA LLAVE,30,TAMIAHUA,151,HORMIGUERO,1,12,5,7,1
VERACRUZ DE IGNACIO DE LA LLAVE,30,TAMIAHUA,151,ISLA DEL ÍDOLO (ISLA EL ÍDOLO),3,34,20,14,5
VERACRUZ DE IGNACIO DE LA LLAVE,30,TAMIAHUA,151,LA ENCARNACIÓN,2,29,8,21,4
VERACRUZ DE IGNACIO DE LA LLAVE,30,TAMIAHUA,151,LA GUÁSIMA,1,8,4,4,2
VERACRUZ DE IGNACIO DE LA LLAVE,30,TAMIAHUA,151,LA LABOR,1,8,3,5,1
VERACRUZ DE IGNACIO DE LA LLAVE,30,TAMIAHUA,151,LA PUNTILLA,2,16,8,8,2
VERACRUZ DE IGNACIO DE LA LLAVE,30,TAMIAHUA,151,LA REFORMA,4,94,52,42,9
VERACRUZ DE IGNACIO DE LA LLAVE,30,TAMIAHUA,151,LAJA BLANCA,1,9,5,4,1
VERACRUZ DE IGNACIO DE LA LLAVE,30,TAMIAHUA,151,LAS FLORES,2,14,7,7,2
VERACRUZ DE IGNACIO DE LA LLAVE,30,TAMIAHUA,151,LAS MESILLAS,1,11,3,8,1
VERACRUZ DE IGNACIO DE LA LLAVE,30,TAMIAHUA,151,MAJAHUAL,1,14,7,7,2
VERACRUZ DE IGNACIO DE LA LLAVE,30,TAMIAHUA,151,MORALILLO,1,4,4,0,1
VERACRUZ DE IGNACIO DE LA LLAVE,30,TAMIAHUA,151,PALMA SOLA,2,18,7,11,3
VERACRUZ DE IGNACIO DE LA LLAVE,30,TAMIAHUA,151,PALO BLANCO,4,177,84,93,17
VERACRUZ DE IGNACIO DE LA LLAVE,30,TAMIAHUA,151,PAPATLAR,4,129,64,65,12
VERACRUZ DE IGNACIO DE LA LLAVE,30,TAMIAHUA,151,PASO DE LEÓN,1,16,4,12,2
VERACRUZ DE IGNACIO DE LA LLAVE,30,TAMIAHUA,151,PASO DE SAN LORENZO,2,45,18,27,5
VERACRUZ DE IGNACIO DE LA LLAVE,30,TAMIAHUA,151,PASO DEL NORTE,2,18,6,12,4
VERACRUZ DE IGNACIO DE LA LLAVE,30,TAMIAHUA,151,PASO GRANDE,1,9,4,5,1
VERACRUZ DE IGNACIO DE LA LLAVE,30,TAMIAHUA,151,POZA HONDA,1,2,1,1,1
VERACRUZ DE IGNACIO DE LA LLAVE,30,TAMIAHUA,151,RAYA OBSCURA,2,35,14,21,5
VERACRUZ DE IGNACIO DE LA LLAVE,30,TAMIAHUA,151,SAN MARCOS,4,88,37,51,12
VERACRUZ DE IGNACIO DE LA LLAVE,30,TAMIAHUA,151,SAN SEBASTIÁN TIERRA BLANCA,1,7,4,3,1
VERACRUZ DE IGNACIO DE LA LLAVE,30,TAMIAHUA,151,TAMIAHUA,10,1058,488,570,82
VERACRUZ DE IGNACIO DE LA LLAVE,30,TAMIAHUA,151,TAMPACHE,4,239,123,116,22
VERACRUZ DE IGNACIO DE LA LLAVE,30,TAMIAHUA,151,TANCOCHÍN,2,30,11,19,4
VERACRUZ DE IGNACIO DE LA LLAVE,30,TAMIAHUA,151,TANHUIJO,1,7,3,4,1
VERACRUZ DE IGNACIO DE LA LLAVE,30,TAMIAHUA,151,TANTÁLAMOS,3,75,32,43,12
VERACRUZ DE IGNACIO DE LA LLAVE,30,TAMIAHUA,151,TARABITAS,1,14,4,10,2
VERACRUZ DE IGNACIO DE LA LLAVE,30,TAMIAHUA,151,TENECHACO,2,19,9,10,2
VERACRUZ DE IGNACIO DE LA LLAVE,30,TAMIAHUA,151,TIERRA Y LIBERTAD,1,10,7,3,1
VERACRUZ DE IGNACIO DE LA LLAVE,30,TAMIAHUA,151,TOTOLAPA,2,7,2,5,3
VERACRUZ DE IGNACIO DE LA LLAVE,30,TAMIAHUA,151,VENUSTIANO CARRANZA,4,144,67,77,20
VERACRUZ DE IGNACIO DE LA LLAVE,30,TAMIAHUA,151,XONACATES,1,8,5,3,1
VERACRUZ DE IGNACIO DE LA LLAVE,30,TAMPICO ALTO,152,ALTO DE LA ZAPUPERA,1,16,6,10,3
VERACRUZ DE IGNACIO DE LA LLAVE,30,TAMPICO ALTO,152,CHIJOL,1,7,4,3,1
VERACRUZ DE IGNACIO DE LA LLAVE,30,TAMPICO ALTO,152,EJIDO EMILIANO ZAPATA,2,18,9,9,2
VERACRUZ DE IGNACIO DE LA LLAVE,30,TAMPICO ALTO,152,EJIDO PUNTA DE MANGLES Y PALO ALTO,1,6,5,1,1
VERACRUZ DE IGNACIO DE LA LLAVE,30,TAMPICO ALTO,152,EL JOBO CONGREGACIÓN ESCRIBANO,2,8,3,5,2
VERACRUZ DE IGNACIO DE LA LLAVE,30,TAMPICO ALTO,152,EL SAUCE,2,16,11,5,3
VERACRUZ DE IGNACIO DE LA LLAVE,30,TAMPICO ALTO,152,EL TULAR,3,23,11,12,3
VERACRUZ DE IGNACIO DE LA LLAVE,30,TAMPICO ALTO,152,ESTACIÓN AGRARIOS,2,18,11,7,2
VERACRUZ DE IGNACIO DE LA LLAVE,30,TAMPICO ALTO,152,ESTACIÓN CARBONO,3,67,30,37,4
VERACRUZ DE IGNACIO DE LA LLAVE,30,TAMPICO ALTO,152,ESTACIÓN LAGARTERO,1,15,10,5,1
VERACRUZ DE IGNACIO DE LA LLAVE,30,TAMPICO ALTO,152,ESTACIÓN PALACHO,1,14,7,7,1
VERACRUZ DE IGNACIO DE LA LLAVE,30,TAMPICO ALTO,152,ESTACIÓN TOPILA,1,6,2,4,1
VERACRUZ DE IGNACIO DE LA LLAVE,30,TAMPICO ALTO,152,GARRAPATAS KILÓMETRO OCHENTA Y DOS,1,7,4,3,1
VERACRUZ DE IGNACIO DE LA LLAVE,30,TAMPICO ALTO,152,KILÓMETRO CIEN,2,55,26,29,5
VERACRUZ DE IGNACIO DE LA LLAVE,30,TAMPICO ALTO,152,KILÓMETRO OCHENTA,2,62,25,37,5
VERACRUZ DE IGNACIO DE LA LLAVE,30,TAMPICO ALTO,152,KILÓMETRO SETENTA Y CINCO,3,174,81,93,13
VERACRUZ DE IGNACIO DE LA LLAVE,30,TAMPICO ALTO,152,LA MAJAHUA,4,85,42,43,8
VERACRUZ DE IGNACIO DE LA LLAVE,30,TAMPICO ALTO,152,LA MATA,1,16,10,6,1
VERACRUZ DE IGNACIO DE LA LLAVE,30,TAMPICO ALTO,152,LA RESTINGA,2,16,7,9,2
VERACRUZ DE IGNACIO DE LA LLAVE,30,TAMPICO ALTO,152,LA RIBERA,3,133,58,75,14
VERACRUZ DE IGNACIO DE LA LLAVE,30,TAMPICO ALTO,152,LAS CHACAS,2,56,27,29,5
VERACRUZ DE IGNACIO DE LA LLAVE,30,TAMPICO ALTO,152,LLANO DE BUSTOS,2,43,12,31,6
VERACRUZ DE IGNACIO DE LA LLAVE,30,TAMPICO ALTO,152,LLANO GRANDE,2,29,12,17,4
VERACRUZ DE IGNACIO DE LA LLAVE,30,TAMPICO ALTO,152,LOS JOBOS,3,28,12,16,4
VERACRUZ DE IGNACIO DE LA LLAVE,30,TAMPICO ALTO,152,MADERAS,1,11,3,8,1
VERACRUZ DE IGNACIO DE LA LLAVE,30,TAMPICO ALTO,152,MATA DE CHÁVEZ,2,35,19,16,3
VERACRUZ DE IGNACIO DE LA LLAVE,30,TAMPICO ALTO,152,PERERA,1,5,3,2,1
VERACRUZ DE IGNACIO DE LA LLAVE,30,TAMPICO ALTO,152,PUNTA DE BUSTOS,4,149,72,77,12
VERACRUZ DE IGNACIO DE LA LLAVE,30,TAMPICO ALTO,152,RANCHERÍA QUEBRACHE,2,20,7,13,2
VERACRUZ DE IGNACIO DE LA LLAVE,30,TAMPICO ALTO,152,SAN ISIDRO,2,33,20,13,3
VERACRUZ DE IGNACIO DE LA LLAVE,30,TAMPICO ALTO,152,TAMPICO ALTO,9,751,385,366,72
VERACRUZ DE IGNACIO DE LA LLAVE,30,TAMPICO ALTO,152,TRES MORILLOS,2,17,9,8,2
VERACRUZ DE IGNACIO DE LA LLAVE,30,TAMPICO ALTO,152,ZAPOTAL,1,4,2,2,1
VERACRUZ DE IGNACIO DE LA LLAVE,30,TANCOCO,153,AGUA SALADA,3,27,14,13,4
VERACRUZ DE IGNACIO DE LA LLAVE,30,TANCOCO,153,DOCTOR LICEAGA,2,26,9,17,3
VERACRUZ DE IGNACIO DE LA LLAVE,30,TANCOCO,153,EL BAJÍO,2,28,16,12,2
VERACRUZ DE IGNACIO DE LA LLAVE,30,TANCOCO,153,IGNACIO ZARAGOZA,2,52,27,25,5
VERACRUZ DE IGNACIO DE LA LLAVE,30,TANCOCO,153,KILÓMETRO CUARENTA Y TRES,3,60,31,29,5
VERACRUZ DE IGNACIO DE LA LLAVE,30,TANCOCO,153,LA MORA,2,13,5,8,2
VERACRUZ DE IGNACIO DE LA LLAVE,30,TANCOCO,153,LÁZARO CÁRDENAS,1,5,2,3,1
VERACRUZ DE IGNACIO DE LA LLAVE,30,TANCOCO,153,LLANO DE ENMEDIO,3,24,14,10,3
VERACRUZ DE IGNACIO DE LA LLAVE,30,TANCOCO,153,SANTOS DEGOLLADO (SAN FRANCISCO),2,12,7,5,1
VERACRUZ DE IGNACIO DE LA LLAVE,30,TANCOCO,153,TANCOCO,6,253,111,142,25
VERACRUZ DE IGNACIO DE LA LLAVE,30,TANCOCO,153,TOTECO,3,56,35,21,5
VERACRUZ DE IGNACIO DE LA LLAVE,30,TANCOCO,153,ZACAMIXTLE,4,286,132,154,20
VERACRUZ DE IGNACIO DE LA LLAVE,30,TANTIMA,154,BENITO JUÁREZ,2,21,9,12,3
VERACRUZ DE IGNACIO DE LA LLAVE,30,TANTIMA,154,BUENA VISTA,1,6,3,3,2
VERACRUZ DE IGNACIO DE LA LLAVE,30,TANTIMA,154,CARMONA Y VALLE (LAS GALLINAS),1,14,5,9,1
VERACRUZ DE IGNACIO DE LA LLAVE,30,TANTIMA,154,COYOL REAL,2,19,6,13,2
VERACRUZ DE IGNACIO DE LA LLAVE,30,TANTIMA,154,EJIDO MONTE GRANDE,2,36,17,19,3
VERACRUZ DE IGNACIO DE LA LLAVE,30,TANTIMA,154,EL ANONO CUCHARAS,3,41,25,16,6
VERACRUZ DE IGNACIO DE LA LLAVE,30,TANTIMA,154,EL CHOTE,1,21,8,13,1
VERACRUZ DE IGNACIO DE LA LLAVE,30,TANTIMA,154,EL CINCUENTA,1,6,5,1,2
VERACRUZ DE IGNACIO DE LA LLAVE,30,TANTIMA,154,EL COLORADO,1,7,4,3,1
VERACRUZ DE IGNACIO DE LA LLAVE,30,TANTIMA,154,EL MIRADOR,2,37,13,24,4
VERACRUZ DE IGNACIO DE LA LLAVE,30,TANTIMA,154,EL NARANJAL,1,6,3,3,1
VERACRUZ DE IGNACIO DE LA LLAVE,30,TANTIMA,154,EL RÍO,2,13,5,8,2
VERACRUZ DE IGNACIO DE LA LLAVE,30,TANTIMA,154,EL XÚCHITL VIEJO,2,62,29,33,4
VERACRUZ DE IGNACIO DE LA LLAVE,30,TANTIMA,154,EL ZAPOTAL,3,147,65,82,11
VERACRUZ DE IGNACIO DE LA LLAVE,30,TANTIMA,154,GUTIÉRREZ ZAMORA,4,179,85,94,18
VERACRUZ DE IGNACIO DE LA LLAVE,30,TANTIMA,154,JOSÉ MARÍA MORELOS,2,23,10,13,3
VERACRUZ DE IGNACIO DE LA LLAVE,30,TANTIMA,154,LA CEIBA OCAMPO,3,61,31,30,7
VERACRUZ DE IGNACIO DE LA LLAVE,30,TANTIMA,154,LA LAJITA,4,152,68,84,11
VERACRUZ DE IGNACIO DE LA LLAVE,30,TANTIMA,154,LA PITAHAYA,3,25,14,11,3
VERACRUZ DE IGNACIO DE LA LLAVE,30,TANTIMA,154,LA PUENTE,3,56,30,26,5
VERACRUZ DE IGNACIO DE LA LLAVE,30,TANTIMA,154,LA REFORMA (LA NUEVA REFORMA),3,59,27,32,5
VERACRUZ DE IGNACIO DE LA LLAVE,30,TANTIMA,154,LAS FLORES,2,74,44,30,6
VERACRUZ DE IGNACIO DE LA LLAVE,30,TANTIMA,154,LOS HIGUEROS,3,50,28,22,5
VERACRUZ DE IGNACIO DE LA LLAVE,30,TANTIMA,154,NUEVO OCAMPO (CONGREGACIÓN DE OCAMPO),1,9,7,2,1
VERACRUZ DE IGNACIO DE LA LLAVE,30,TANTIMA,154,NUEVO XÚCHITL,3,48,18,30,5
VERACRUZ DE IGNACIO DE LA LLAVE,30,TANTIMA,154,RANCHO ABAJO,4,74,34,40,7
VERACRUZ DE IGNACIO DE LA LLAVE,30,TANTIMA,154,RANCHO ALEGRE,1,6,2,4,1
VERACRUZ DE IGNACIO DE LA LLAVE,30,TANTIMA,154,SAN ANDRÉS,2,25,14,11,3
VERACRUZ DE IGNACIO DE LA LLAVE,30,TANTIMA,154,SAN LORENZO,2,28,10,18,3
VERACRUZ DE IGNACIO DE LA LLAVE,30,TANTIMA,154,SAN SEBASTIÁN,2,44,26,18,4
VERACRUZ DE IGNACIO DE LA LLAVE,30,TANTIMA,154,SANTIAGO CHICONCILLO,2,14,7,7,3
VERACRUZ DE IGNACIO DE LA LLAVE,30,TANTIMA,154,TANTIMA,5,245,119,126,25
VERACRUZ DE IGNACIO DE LA LLAVE,30,TANTIMA,154,TERRERO CUCHARAS,2,12,8,4,2
VERACRUZ DE IGNACIO DE LA LLAVE,30,TANTIMA,154,VICENTE GUERRERO (PALO BLANCO),1,8,1,7,1
VERACRUZ DE IGNACIO DE LA LLAVE,30,TANTOYUCA,155,ACECECA,8,403,231,172,58
VERACRUZ DE IGNACIO DE LA LLAVE,30,TANTOYUCA,155,AJOLOCO,1,8,3,5,2
VERACRUZ DE IGNACIO DE LA LLAVE,30,TANTOYUCA,155,ALTO MINCUINI,3,42,16,26,4
VERACRUZ DE IGNACIO DE LA LLAVE,30,TANTOYUCA,155,BUENA VISTA,5,93,50,43,10
VERACRUZ DE IGNACIO DE LA LLAVE,30,TANTOYUCA,155,CALLEJÓN,1,13,9,4,3
VERACRUZ DE IGNACIO DE LA LLAVE,30,TANTOYUCA,155,CALLEJÓN SANTA CLARA,2,77,37,40,10
VERACRUZ DE IGNACIO DE LA LLAVE,30,TANTOYUCA,155,CARDONAL,3,150,73,77,14
VERACRUZ DE IGNACIO DE LA LLAVE,30,TANTOYUCA,155,CASAS VIEJAS,3,50,32,18,6
VERACRUZ DE IGNACIO DE LA LLAVE,30,TANTOYUCA,155,CASITAS CHILA PÉREZ,4,166,87,79,16
VERACRUZ DE IGNACIO DE LA LLAVE,30,TANTOYUCA,155,CERRO ACECECA,1,13,6,7,2
VERACRUZ DE IGNACIO DE LA LLAVE,30,TANTOYUCA,155,CERRO CHILA PÉREZ,2,60,26,34,5
VERACRUZ DE IGNACIO DE LA LLAVE,30,TANTOYUCA,155,CERRO JOCUTLA,1,1,0,1,1
VERACRUZ DE IGNACIO DE LA LLAVE,30,TANTOYUCA,155,CERRO MIRADOR,2,60,28,32,6
VERACRUZ DE IGNACIO DE LA LLAVE,30,TANTOYUCA,155,CERRO SAN GABRIEL,2,25,14,11,2
VERACRUZ DE IGNACIO DE LA LLAVE,30,TANTOYUCA,155,CERRO SAN ROMÁN,1,6,5,1,1
VERACRUZ DE IGNACIO DE LA LLAVE,30,TANTOYUCA,155,CHOTE ARRIBA,3,278,139,139,20
VERACRUZ DE IGNACIO DE LA LLAVE,30,TANTOYUCA,155,CIRUELAR AQUICHE,4,288,121,167,21
VERACRUZ DE IGNACIO DE LA LLAVE,30,TANTOYUCA,155,CIRUELAR CHOTE,1,32,19,13,3
VERACRUZ DE IGNACIO DE LA LLAVE,30,TANTOYUCA,155,CORNIZUELOS,1,5,2,3,1
VERACRUZ DE IGNACIO DE LA LLAVE,30,TANTOYUCA,155,CORRAL VIEJO LAJA PRIMERA,4,142,74,68,14
VERACRUZ DE IGNACIO DE LA LLAVE,30,TANTOYUCA,155,CORRALILLO,3,107,50,57,11
VERACRUZ DE IGNACIO DE LA LLAVE,30,TANTOYUCA,155,COYOLES,1,8,4,4,1
VERACRUZ DE IGNACIO DE LA LLAVE,30,TANTOYUCA,155,CUCHILLA CHICA,2,78,38,40,11
VERACRUZ DE IGNACIO DE LA LLAVE,30,TANTOYUCA,155,CUCHILLA GRANDE,2,79,38,41,6
VERACRUZ DE IGNACIO DE LA LLAVE,30,TANTOYUCA,155,DOS CAMINOS,1,86,47,39,3
VERACRUZ DE IGNACIO DE LA LLAVE,30,TANTOYUCA,155,EJIDO CUAUHTÉMOC (CHILA CURTAZA),4,53,26,27,8
VERACRUZ DE IGNACIO DE LA LLAVE,30,TANTOYUCA,155,EJIDO EMILIANO ZAPATA,1,11,5,6,1
VERACRUZ DE IGNACIO DE LA LLAVE,30,TANTOYUCA,155,EJIDO INDEPENDENCIA NACIONAL,2,22,8,14,4
VERACRUZ DE IGNACIO DE LA LLAVE,30,TANTOYUCA,155,EJIDO SIETE PALMAS,1,23,9,14,1
VERACRUZ DE IGNACIO DE LA LLAVE,30,TANTOYUCA,155,EJIDO TECOMATE CHAPOPO,1,13,10,3,2
VERACRUZ DE IGNACIO DE LA LLAVE,30,TANTOYUCA,155,EL AGUACATE,2,274,146,128,12
VERACRUZ DE IGNACIO DE LA LLAVE,30,TANTOYUCA,155,EL AQUICHAL (LAJA SEGUNDA),2,16,8,8,3
VERACRUZ DE IGNACIO DE LA LLAVE,30,TANTOYUCA,155,EL CERRO,3,62,31,31,6
VERACRUZ DE IGNACIO DE LA LLAVE,30,TANTOYUCA,155,EL CHIQUERO,2,30,15,15,2
VERACRUZ DE IGNACIO DE LA LLAVE,30,TANTOYUCA,155,EL CHOTE,2,120,60,60,8
VERACRUZ DE IGNACIO DE LA LLAVE,30,TANTOYUCA,155,EL CIRUELAR,3,82,36,46,8
VERACRUZ DE IGNACIO DE LA LLAVE,30,TANTOYUCA,155,EL COYOL,2,29,18,11,2
VERACRUZ DE IGNACIO DE LA LLAVE,30,TANTOYUCA,155,EL GALLO,2,72,32,40,7
VERACRUZ DE IGNACIO DE LA LLAVE,30,TANTOYUCA,155,EL JOBO AQUICHE,2,59,24,35,4
VERACRUZ DE IGNACIO DE LA LLAVE,30,TANTOYUCA,155,EL LIMÓN,3,206,103,103,18
VERACRUZ DE IGNACIO DE LA LLAVE,30,TANTOYUCA,155,EL LINDERO,5,352,188,164,17
VERACRUZ DE IGNACIO DE LA LLAVE,30,TANTOYUCA,155,EL MAGUEY SABANA GRANDE,2,25,12,13,4
VERACRUZ DE IGNACIO DE LA LLAVE,30,TANTOYUCA,155,EL MAMEY,2,36,17,19,5
VERACRUZ DE IGNACIO DE LA LLAVE,30,TANTOYUCA,155,EL MAMEY SAN GABRIEL,1,11,6,5,1
VERACRUZ DE IGNACIO DE LA LLAVE,30,TANTOYUCA,155,EL MEZQUITE,6,440,234,206,38
VERACRUZ DE IGNACIO DE LA LLAVE,30,TANTOYUCA,155,EL MIRADOR,3,146,71,75,13
VERACRUZ DE IGNACIO DE LA LLAVE,30,TANTOYUCA,155,EL NARANJAL,3,117,47,70,16
VERACRUZ DE IGNACIO DE LA LLAVE,30,TANTOYUCA,155,EL NOPAL,3,20,7,13,3
VERACRUZ DE IGNACIO DE LA LLAVE,30,TANTOYUCA,155,EL PADRE,2,13,5,8,3
VERACRUZ DE IGNACIO DE LA LLAVE,30,TANTOYUCA,155,EL PALMAR,2,25,15,10,3
VERACRUZ DE IGNACIO DE LA LLAVE,30,TANTOYUCA,155,EL PORVENIR,1,88,37,51,8
VERACRUZ DE IGNACIO DE LA LLAVE,30,TANTOYUCA,155,EL PORVENIR CHOPOPO,3,200,114,86,11
VERACRUZ DE IGNACIO DE LA LLAVE,30,TANTOYUCA,155,EL REMANSO,5,209,110,99,18
VERACRUZ DE IGNACIO DE LA LLAVE,30,TANTOYUCA,155,EL RINCÓN,1,11,5,6,2
VERACRUZ DE IGNACIO DE LA LLAVE,30,TANTOYUCA,155,EL SABINO,3,94,44,50,7
VERACRUZ DE IGNACIO DE LA LLAVE,30,TANTOYUCA,155,EL TERRERO,2,7,4,3,1
VERACRUZ DE IGNACIO DE LA LLAVE,30,TANTOYUCA,155,EL TOYOL,3,156,78,78,12
VERACRUZ DE IGNACIO DE LA LLAVE,30,TANTOYUCA,155,GUAYABAL AQUICHE,2,50,28,22,7
VERACRUZ DE IGNACIO DE LA LLAVE,30,TANTOYUCA,155,GUAYABAL GRANDE,1,21,12,9,3
VERACRUZ DE IGNACIO DE LA LLAVE,30,TANTOYUCA,155,GUAYABO CHICO,4,208,109,99,17
VERACRUZ DE IGNACIO DE LA LLAVE,30,TANTOYUCA,155,GUAYABO GRANDE,1,56,28,28,8
VERACRUZ DE IGNACIO DE LA LLAVE,30,TANTOYUCA,155,GUAYALAR,2,69,38,31,4
VERACRUZ DE IGNACIO DE LA LLAVE,30,TANTOYUCA,155,HUICHINAL CHILA PÉREZ,4,277,123,154,18
VERACRUZ DE IGNACIO DE LA LLAVE,30,TANTOYUCA,155,HUIZACHE,2,90,49,41,7
VERACRUZ DE IGNACIO DE LA LLAVE,30,TANTOYUCA,155,HUIZACHE LAJA,2,15,6,9,3
VERACRUZ DE IGNACIO DE LA LLAVE,30,TANTOYUCA,155,IXCANELCO,4,289,152,137,23
VERACRUZ DE IGNACIO DE LA LLAVE,30,TANTOYUCA,155,IXTLAR,4,192,96,96,13
VERACRUZ DE IGNACIO DE LA LLAVE,30,TANTOYUCA,155,IXTLE BLANCO,2,59,22,37,5
VERACRUZ DE IGNACIO DE LA LLAVE,30,TANTOYUCA,155,IZOTAL CARDONAL,2,69,44,25,6
VERACRUZ DE IGNACIO DE LA LLAVE,30,TANTOYUCA,155,JACUBAL,2,83,39,44,7
VERACRUZ DE IGNACIO DE LA LLAVE,30,TANTOYUCA,155,LA CALZADA,2,46,19,27,2
VERACRUZ DE IGNACIO DE LA LLAVE,30,TANTOYUCA,155,LA CAMPANA,2,24,15,9,2
VERACRUZ DE IGNACIO DE LA LLAVE,30,TANTOYUCA,155,LA CHACA,1,8,3,5,1
VERACRUZ DE IGNACIO DE LA LLAVE,30,TANTOYUCA,155,LA ESPERANZA,3,38,22,16,3
VERACRUZ DE IGNACIO DE LA LLAVE,30,TANTOYUCA,155,LA ESTANZUELA,4,427,220,207,24
VERACRUZ DE IGNACIO DE LA LLAVE,30,TANTOYUCA,155,LA FLORIDA,1,13,9,4,1
VERACRUZ DE IGNACIO DE LA LLAVE,30,TANTOYUCA,155,LA FORTUNA DOS M,1,229,140,89,24
VERACRUZ DE IGNACIO DE LA LLAVE,30,TANTOYUCA,155,LA GARRAPATA SAN LORENZO,3,137,71,66,9
VERACRUZ DE IGNACIO DE LA LLAVE,30,TANTOYUCA,155,LA HIGUERA,1,7,4,3,1
VERACRUZ DE IGNACIO DE LA LLAVE,30,TANTOYUCA,155,LA LIMA,2,23,13,10,3
VERACRUZ DE IGNACIO DE LA LLAVE,30,TANTOYUCA,155,LA MATA,3,17,11,6,3
VERACRUZ DE IGNACIO DE LA LLAVE,30,TANTOYUCA,155,LA MORA,2,27,14,13,4
VERACRUZ DE IGNACIO DE LA LLAVE,30,TANTOYUCA,155,LA MORITA,1,12,3,9,1
VERACRUZ DE IGNACIO DE LA LLAVE,30,TANTOYUCA,155,LA PEÑA,3,117,63,54,11
VERACRUZ DE IGNACIO DE LA LLAVE,30,TANTOYUCA,155,LA PITAHAYA,3,175,96,79,17
VERACRUZ DE IGNACIO DE LA LLAVE,30,TANTOYUCA,155,LA RIVERA,1,7,6,1,1
VERACRUZ DE IGNACIO DE LA LLAVE,30,TANTOYUCA,155,LA TINAJA SAN GABRIEL,3,64,28,36,5
VERACRUZ DE IGNACIO DE LA LLAVE,30,TANTOYUCA,155,LAGARTOS,1,6,2,4,1
VERACRUZ DE IGNACIO DE LA LLAVE,30,TANTOYUCA,155,LAJITAS,2,72,45,27,5
VERACRUZ DE IGNACIO DE LA LLAVE,30,TANTOYUCA,155,LAS AGUJAS,2,73,37,36,5
VERACRUZ DE IGNACIO DE LA LLAVE,30,TANTOYUCA,155,LAS LAJITAS,5,177,83,94,18
VERACRUZ DE IGNACIO DE LA LLAVE,30,TANTOYUCA,155,LAS MESAS SAN GABRIEL (LAS MESAS),5,218,106,112,18
VERACRUZ DE IGNACIO DE LA LLAVE,30,TANTOYUCA,155,LAS VÍBORAS,2,56,28,28,7
VERACRUZ DE IGNACIO DE LA LLAVE,30,TANTOYUCA,155,LINDERO AGUACATE,1,6,3,3,1
VERACRUZ DE IGNACIO DE LA LLAVE,30,TANTOYUCA,155,LOMA ALTA,3,79,42,37,7
VERACRUZ DE IGNACIO DE LA LLAVE,30,TANTOYUCA,155,LOMA ATRAVESADA,2,17,5,12,3
VERACRUZ DE IGNACIO DE LA LLAVE,30,TANTOYUCA,155,LOMA DE LA CRUZ,2,34,17,17,5
VERACRUZ DE IGNACIO DE LA LLAVE,30,TANTOYUCA,155,LOMA LARGA,2,68,29,39,5
VERACRUZ DE IGNACIO DE LA LLAVE,30,TANTOYUCA,155,LOS AJOS,1,32,13,19,3
VERACRUZ DE IGNACIO DE LA LLAVE,30,TANTOYUCA,155,LOS AJOS ARRIBA,2,164,86,78,21
VERACRUZ DE IGNACIO DE LA LLAVE,30,TANTOYUCA,155,LOS MANANTIALES,2,35,17,18,3
VERACRUZ DE IGNACIO DE LA LLAVE,30,TANTOYUCA,155,MAGUEY PRIMERO,1,13,9,4,1
VERACRUZ DE IGNACIO DE LA LLAVE,30,TANTOYUCA,155,MAGUEY SEGUNDO,2,99,53,46,7
VERACRUZ DE IGNACIO DE LA LLAVE,30,TANTOYUCA,155,MANCORNADEROS PRIMERO,2,101,50,51,6
VERACRUZ DE IGNACIO DE LA LLAVE,30,TANTOYUCA,155,MANO DE LEÓN,2,9,4,5,2
VERACRUZ DE IGNACIO DE LA LLAVE,30,TANTOYUCA,155,MAPÁN MATA DEL TIGRE,2,38,14,24,6
VERACRUZ DE IGNACIO DE LA LLAVE,30,TANTOYUCA,155,MATA DEL TIGRE,4,84,45,39,10
VERACRUZ DE IGNACIO DE LA LLAVE,30,TANTOYUCA,155,MECAPALA,3,64,31,33,7
VERACRUZ DE IGNACIO DE LA LLAVE,30,TANTOYUCA,155,MONTE GRANDE,3,121,54,67,10
VERACRUZ DE IGNACIO DE LA LLAVE,30,TANTOYUCA,155,MORALILLO,5,199,100,99,18
VERACRUZ DE IGNACIO DE LA LLAVE,30,TANTOYUCA,155,NUEVO LAREDO,2,27,12,15,4
VERACRUZ DE IGNACIO DE LA LLAVE,30,TANTOYUCA,155,PALMA ALTA,4,155,79,76,13
VERACRUZ DE IGNACIO DE LA LLAVE,30,TANTOYUCA,155,PALMA REDONDA,1,5,4,1,1
VERACRUZ DE IGNACIO DE LA LLAVE,30,TANTOYUCA,155,PALMA SOLITA,2,35,18,17,5
VERACRUZ DE IGNACIO DE LA LLAVE,30,TANTOYUCA,155,PALMAR AQUICHE PRIMERO,2,78,34,44,6
VERACRUZ DE IGNACIO DE LA LLAVE,30,TANTOYUCA,155,PALMITAL SAN LORENZO,2,98,61,37,9
VERACRUZ DE IGNACIO DE LA LLAVE,30,TANTOYUCA,155,PALMITO,4,192,83,109,11
VERACRUZ DE IGNACIO DE LA LLAVE,30,TANTOYUCA,155,PALO DE ROSA,2,62,38,24,5
VERACRUZ DE IGNACIO DE LA LLAVE,30,TANTOYUCA,155,PALO SOLO,4,231,122,109,12
VERACRUZ DE IGNACIO DE LA LLAVE,30,TANTOYUCA,155,PAREDONES,2,25,15,10,4
VERACRUZ DE IGNACIO DE LA LLAVE,30,TANTOYUCA,155,PASO DEL LIMÓN,1,6,4,2,1
VERACRUZ DE IGNACIO DE LA LLAVE,30,TANTOYUCA,155,PASTORÍA,2,35,20,15,3
VERACRUZ DE IGNACIO DE LA LLAVE,30,TANTOYUCA,155,PECERO,1,19,13,6,1
VERACRUZ DE IGNACIO DE LA LLAVE,30,TANTOYUCA,155,PENSADOR MEXICANO,2,141,61,80,9
VERACRUZ DE IGNACIO DE LA LLAVE,30,TANTOYUCA,155,PLACETAS,3,96,45,51,13
VERACRUZ DE IGNACIO DE LA LLAVE,30,TANTOYUCA,155,POTRERO PRIMERO,2,39,23,16,2
VERACRUZ DE IGNACIO DE LA LLAVE,30,TANTOYUCA,155,POTRERO SAN GABRIEL,1,8,4,4,1
VERACRUZ DE IGNACIO DE LA LLAVE,30,TANTOYUCA,155,POTRERO SEGUNDO,2,57,30,27,4
VERACRUZ DE IGNACIO DE LA LLAVE,30,TANTOYUCA,155,RANCHO NUEVO,2,34,16,18,5
VERACRUZ DE IGNACIO DE LA LLAVE,30,TANTOYUCA,155,RANCHO NUEVO CHIJOLAR,1,4,1,3,1
VERACRUZ DE IGNACIO DE LA LLAVE,30,TANTOYUCA,155,RANCHO NUEVO SAN JOSÉ,1,24,13,11,2
VERACRUZ DE IGNACIO DE LA LLAVE,30,TANTOYUCA,155,RANCHO VIEJO,3,65,35,30,10
VERACRUZ DE IGNACIO DE LA LLAVE,30,TANTOYUCA,155,SAN ANTONIO,1,5,1,4,1
VERACRUZ DE IGNACIO DE LA LLAVE,30,TANTOYUCA,155,SAN ANTONIO PECERO,3,30,15,15,5
VERACRUZ DE IGNACIO DE LA LLAVE,30,TANTOYUCA,155,SAN DIEGO,2,51,26,25,7
VERACRUZ DE IGNACIO DE LA LLAVE,30,TANTOYUCA,155,SAN JERÓNIMO,2,22,9,13,2
VERACRUZ DE IGNACIO DE LA LLAVE,30,TANTOYUCA,155,SAN JUAN CHIJOLAR,5,393,187,206,36
VERACRUZ DE IGNACIO DE LA LLAVE,30,TANTOYUCA,155,SAN SEBASTIÁN,4,506,237,269,46
VERACRUZ DE IGNACIO DE LA LLAVE,30,TANTOYUCA,155,SANTA CLARA,2,85,42,43,5
VERACRUZ DE IGNACIO DE LA LLAVE,30,TANTOYUCA,155,SANTA MÓNICA,2,13,5,8,2
VERACRUZ DE IGNACIO DE LA LLAVE,30,TANTOYUCA,155,SANTA RITA,1,2,1,1,1
VERACRUZ DE IGNACIO DE LA LLAVE,30,TANTOYUCA,155,SANTA ROSA,1,10,4,6,1
VERACRUZ DE IGNACIO DE LA LLAVE,30,TANTOYUCA,155,TAMETATE,4,269,135,134,18
VERACRUZ DE IGNACIO DE LA LLAVE,30,TANTOYUCA,155,TAMPATEL,1,15,9,6,2
VERACRUZ DE IGNACIO DE LA LLAVE,30,TANTOYUCA,155,TANTOYUCA,60,11417,5797,5620,768
VERACRUZ DE IGNACIO DE LA LLAVE,30,TANTOYUCA,155,TANZAQUIL,2,31,12,19,3
VERACRUZ DE IGNACIO DE LA LLAVE,30,TANTOYUCA,155,TAZAJERA,1,9,6,3,1
VERACRUZ DE IGNACIO DE LA LLAVE,30,TANTOYUCA,155,TECOMATE,5,208,100,108,22
VERACRUZ DE IGNACIO DE LA LLAVE,30,TANTOYUCA,155,TEPATLÁN,4,202,110,92,19
VERACRUZ DE IGNACIO DE LA LLAVE,30,TANTOYUCA,155,TEPATLÁN CHICO,2,34,16,18,3
VERACRUZ DE IGNACIO DE LA LLAVE,30,TANTOYUCA,155,TERRERO,3,275,117,158,24
VERACRUZ DE IGNACIO DE LA LLAVE,30,TANTOYUCA,155,TERRERO TAMETATE,2,31,12,19,4
VERACRUZ DE IGNACIO DE LA LLAVE,30,TANTOYUCA,155,TETILLAS,3,124,60,64,10
VERACRUZ DE IGNACIO DE LA LLAVE,30,TANTOYUCA,155,TIANGUIS,2,15,8,7,2
VERACRUZ DE IGNACIO DE LA LLAVE,30,TANTOYUCA,155,TIERRA BLANCA,2,33,13,20,3
VERACRUZ DE IGNACIO DE LA LLAVE,30,TANTOYUCA,155,XILOXÚCHITL,4,273,136,137,24
VERACRUZ DE IGNACIO DE LA LLAVE,30,TANTOYUCA,155,ZANJA MARÍA,1,21,9,12,2
VERACRUZ DE IGNACIO DE LA LLAVE,30,TANTOYUCA,155,ZAPOTAL,3,85,35,50,11
VERACRUZ DE IGNACIO DE LA LLAVE,30,TANTOYUCA,155,ZAPOTAL SAN LORENZO,4,239,124,115,21
VERACRUZ DE IGNACIO DE LA LLAVE,30,TANTOYUCA,155,ZAPUPE,2,14,7,7,2
VERACRUZ DE IGNACIO DE LA LLAVE,30,TATATILA,156,EL BOQUERÓN,1,10,5,5,1
VERACRUZ DE IGNACIO DE LA LLAVE,30,TATATILA,156,ESCALONA,3,36,18,18,4
VERACRUZ DE IGNACIO DE LA LLAVE,30,TATATILA,156,LA CONCORDIA,1,31,14,17,2
VERACRUZ DE IGNACIO DE LA LLAVE,30,TATATILA,156,LA MANCUERNA,3,137,69,68,10
VERACRUZ DE IGNACIO DE LA LLAVE,30,TATATILA,156,LA MONERA,1,4,1,3,1
VERACRUZ DE IGNACIO DE LA LLAVE,30,TATATILA,156,LA VAQUERÍA,3,92,47,45,5
VERACRUZ DE IGNACIO DE LA LLAVE,30,TATATILA,156,LOMA ALTA,1,8,5,3,1
VERACRUZ DE IGNACIO DE LA LLAVE,30,TATATILA,156,MONTE REAL,2,18,5,13,3
VERACRUZ DE IGNACIO DE LA LLAVE,30,TATATILA,156,PIEDRA PARADA,3,219,117,102,12
VERACRUZ DE IGNACIO DE LA LLAVE,30,TATATILA,156,PILHUATEPEC,4,161,78,83,10
VERACRUZ DE IGNACIO DE LA LLAVE,30,TATATILA,156,SAN ANTONIO DE CÓRDOBA,2,47,24,23,3
VERACRUZ DE IGNACIO DE LA LLAVE,30,TATATILA,156,SAN JUAN TEZONTÉMOC,3,56,31,25,4
VERACRUZ DE IGNACIO DE LA LLAVE,30,TATATILA,156,SANTIAGO MEXTLA,3,26,14,12,4
VERACRUZ DE IGNACIO DE LA LLAVE,30,TATATILA,156,TATATILA,5,423,223,200,26
VERACRUZ DE IGNACIO DE LA LLAVE,30,TATATILA,156,TENEXPANOYA,4,105,60,45,9
VERACRUZ DE IGNACIO DE LA LLAVE,30,CASTILLO DE TEAYO,157,AMÉRICAS CHICAS,1,24,13,11,2
VERACRUZ DE IGNACIO DE LA LLAVE,30,CASTILLO DE TEAYO,157,CASTILLO DE TEAYO,11,1123,579,544,67
VERACRUZ DE IGNACIO DE LA LLAVE,30,CASTILLO DE TEAYO,157,EL BEJUCAL,3,130,73,57,11
VERACRUZ DE IGNACIO DE LA LLAVE,30,CASTILLO DE TEAYO,157,EL MANTE,3,108,59,49,8
VERACRUZ DE IGNACIO DE LA LLAVE,30,CASTILLO DE TEAYO,157,EL NARANJAL,2,51,30,21,4
VERACRUZ DE IGNACIO DE LA LLAVE,30,CASTILLO DE TEAYO,157,EL NUEVO NARANJAL (LAS CARMELITAS),2,44,27,17,3
VERACRUZ DE IGNACIO DE LA LLAVE,30,CASTILLO DE TEAYO,157,EL OJITAL,3,75,32,43,7
VERACRUZ DE IGNACIO DE LA LLAVE,30,CASTILLO DE TEAYO,157,EL PITAL,2,30,18,12,3
VERACRUZ DE IGNACIO DE LA LLAVE,30,CASTILLO DE TEAYO,157,EL XÚCHITL,4,338,158,180,19
VERACRUZ DE IGNACIO DE LA LLAVE,30,CASTILLO DE TEAYO,157,FRANCISCO LUJÁN ADAME (DOS PASOS),1,8,6,2,1
VERACRUZ DE IGNACIO DE LA LLAVE,30,CASTILLO DE TEAYO,157,FRANCISCO LUJÁN ADAME (EL TOTOMOXCLE),3,41,21,20,5
VERACRUZ DE IGNACIO DE LA LLAVE,30,CASTILLO DE TEAYO,157,IGNACIO ZARAGOZA,3,47,21,26,8
VERACRUZ DE IGNACIO DE LA LLAVE,30,CASTILLO DE TEAYO,157,LA CEIBA,2,83,45,38,5
VERACRUZ DE IGNACIO DE LA LLAVE,30,CASTILLO DE TEAYO,157,LA DEFENSA,4,257,132,125,15
VERACRUZ DE IGNACIO DE LA LLAVE,30,CASTILLO DE TEAYO,157,LA ESPERANZA VIEJA,3,72,42,30,6
VERACRUZ DE IGNACIO DE LA LLAVE,30,CASTILLO DE TEAYO,157,LA GUADALUPE,4,213,97,116,16
VERACRUZ DE IGNACIO DE LA LLAVE,30,CASTILLO DE TEAYO,157,LA LIMA NUEVA,3,88,44,44,8
VERACRUZ DE IGNACIO DE LA LLAVE,30,CASTILLO DE TEAYO,157,LA PUERTA,1,6,4,2,1
VERACRUZ DE IGNACIO DE LA LLAVE,30,CASTILLO DE TEAYO,157,LAS AMÉRICAS GRANDES,2,49,24,25,4
VERACRUZ DE IGNACIO DE LA LLAVE,30,CASTILLO DE TEAYO,157,LAS CAMELIAS,1,20,14,6,2
VERACRUZ DE IGNACIO DE LA LLAVE,30,CASTILLO DE TEAYO,157,LIMA VIEJA,3,107,53,54,8
VERACRUZ DE IGNACIO DE LA LLAVE,30,CASTILLO DE TEAYO,157,MEQUETLA,4,475,239,236,32
VERACRUZ DE IGNACIO DE LA LLAVE,30,CASTILLO DE TEAYO,157,NUEVA REFORMA,3,23,13,10,3
VERACRUZ DE IGNACIO DE LA LLAVE,30,CASTILLO DE TEAYO,157,NUEVO JALISCO,2,37,19,18,4
VERACRUZ DE IGNACIO DE LA LLAVE,30,CASTILLO DE TEAYO,157,PALMA NUEVA,2,34,14,20,3
VERACRUZ DE IGNACIO DE LA LLAVE,30,CASTILLO DE TEAYO,157,PALMA REAL,2,33,20,13,3
VERACRUZ DE IGNACIO DE LA LLAVE,30,CASTILLO DE TEAYO,157,PASO DE LAS FLORES,2,16,8,8,2
VERACRUZ DE IGNACIO DE LA LLAVE,30,CASTILLO DE TEAYO,157,PASO DEL ARROYO (NUEVO PASO),1,6,3,3,1
VERACRUZ DE IGNACIO DE LA LLAVE,30,CASTILLO DE TEAYO,157,PUEBLO VIEJO (EL NARANJAL),2,40,24,16,4
VERACRUZ DE IGNACIO DE LA LLAVE,30,CASTILLO DE TEAYO,157,SANTA CRUZ,4,183,91,92,13
VERACRUZ DE IGNACIO DE LA LLAVE,30,CASTILLO DE TEAYO,157,TEAYO,4,324,167,157,20
VERACRUZ DE IGNACIO DE LA LLAVE,30,CASTILLO DE TEAYO,157,ZONA URBANA EJIDO EL MANTE,3,28,14,14,4
VERACRUZ DE IGNACIO DE LA LLAVE,30,TECOLUTLA,158,BOCA DE LIMA,5,250,125,125,19
VERACRUZ DE IGNACIO DE LA LLAVE,30,TECOLUTLA,158,CAÑADA RICA,4,301,149,152,19
VERACRUZ DE IGNACIO DE LA LLAVE,30,TECOLUTLA,158,CASITAS,5,390,190,200,31
VERACRUZ DE IGNACIO DE LA LLAVE,30,TECOLUTLA,158,CERRO DE HUEYTEPEC,3,54,29,25,4
VERACRUZ DE IGNACIO DE LA LLAVE,30,TECOLUTLA,158,CHICHICATZAPAN MÉNDEZ,3,48,19,29,6
VERACRUZ DE IGNACIO DE LA LLAVE,30,TECOLUTLA,158,CINCO DE MAYO,4,120,55,65,9
VERACRUZ DE IGNACIO DE LA LLAVE,30,TECOLUTLA,158,COLONIA GENERAL MAXIMINO ÁVILA CAMACHO,2,46,24,22,4
VERACRUZ DE IGNACIO DE LA LLAVE,30,TECOLUTLA,158,CRUZ DE LOS ESTEROS,4,181,89,92,15
VERACRUZ DE IGNACIO DE LA LLAVE,30,TECOLUTLA,158,DOS DE OCTUBRE,2,20,6,14,2
VERACRUZ DE IGNACIO DE LA LLAVE,30,TECOLUTLA,158,EJIDO LA PERLA,1,10,4,6,1
VERACRUZ DE IGNACIO DE LA LLAVE,30,TECOLUTLA,158,EL EMBARCADERO,3,9,5,4,3
VERACRUZ DE IGNACIO DE LA LLAVE,30,TECOLUTLA,158,EL FUERTE DE ANAYA,4,175,82,93,14
VERACRUZ DE IGNACIO DE LA LLAVE,30,TECOLUTLA,158,EL PARAÍSO,1,4,3,1,1
VERACRUZ DE IGNACIO DE LA LLAVE,30,TECOLUTLA,158,HUEYTEPEC,7,470,230,240,35
VERACRUZ DE IGNACIO DE LA LLAVE,30,TECOLUTLA,158,IGNACIO ZARAGOZA,2,18,7,11,2
VERACRUZ DE IGNACIO DE LA LLAVE,30,TECOLUTLA,158,JOSÉ MARÍA PINO SUÁREZ,1,26,9,17,2
VERACRUZ DE IGNACIO DE LA LLAVE,30,TECOLUTLA,158,LA CURVA,1,9,2,7,1
VERACRUZ DE IGNACIO DE LA LLAVE,30,TECOLUTLA,158,LA FLORIDA,1,5,2,3,1
VERACRUZ DE IGNACIO DE LA LLAVE,30,TECOLUTLA,158,LA GLORIA,2,33,18,15,3
VERACRUZ DE IGNACIO DE LA LLAVE,30,TECOLUTLA,158,LA GUADALUPE,4,309,156,153,20
VERACRUZ DE IGNACIO DE LA LLAVE,30,TECOLUTLA,158,LA LIBERTAD,3,69,35,34,5
VERACRUZ DE IGNACIO DE LA LLAVE,30,TECOLUTLA,158,LA NUEVA GUADALUPE,3,11,6,5,2
VERACRUZ DE IGNACIO DE LA LLAVE,30,TECOLUTLA,158,LA VICTORIA,3,58,34,24,5
VERACRUZ DE IGNACIO DE LA LLAVE,30,TECOLUTLA,158,LA VIGUETA,2,48,22,26,5
VERACRUZ DE IGNACIO DE LA LLAVE,30,TECOLUTLA,158,LÁZARO CÁRDENAS (RIACHUELOS),3,32,16,16,5
VERACRUZ DE IGNACIO DE LA LLAVE,30,TECOLUTLA,158,MESA DEL TIGRE,1,4,1,3,1
VERACRUZ DE IGNACIO DE LA LLAVE,30,TECOLUTLA,158,MONTE GORDO,4,181,97,84,14
VERACRUZ DE IGNACIO DE LA LLAVE,30,TECOLUTLA,158,PASO DEL PROGRESO,4,195,90,105,14
VERACRUZ DE IGNACIO DE LA LLAVE,30,TECOLUTLA,158,PASO DEL RÍO,2,5,3,2,1
VERACRUZ DE IGNACIO DE LA LLAVE,30,TECOLUTLA,158,PASO REAL,3,122,58,64,9
VERACRUZ DE IGNACIO DE LA LLAVE,30,TECOLUTLA,158,PINO SUÁREZ,3,63,39,24,8
VERACRUZ DE IGNACIO DE LA LLAVE,30,TECOLUTLA,158,PLAN DE VILLA CUAUHTÉMOC (EL NEGRO),2,49,28,21,4
VERACRUZ DE IGNACIO DE LA LLAVE,30,TECOLUTLA,158,PLAN DEL CARRIZO,1,4,2,2,1
VERACRUZ DE IGNACIO DE LA LLAVE,30,TECOLUTLA,158,RICARDO FLORES MAGÓN,3,206,108,98,17
VERACRUZ DE IGNACIO DE LA LLAVE,30,TECOLUTLA,158,RÍO BLANCO,2,43,25,18,4
VERACRUZ DE IGNACIO DE LA LLAVE,30,TECOLUTLA,158,SAN FRANCISCO,1,49,26,23,3
VERACRUZ DE IGNACIO DE LA LLAVE,30,TECOLUTLA,158,TECOLUTLA,6,714,367,347,46
VERACRUZ DE IGNACIO DE LA LLAVE,30,TECOLUTLA,158,VISTA HERMOSA (EL AGUACATE),2,28,10,18,3
VERACRUZ DE IGNACIO DE LA LLAVE,30,TECOLUTLA,158,VISTA HERMOSA CALICHAL,2,35,16,19,4
VERACRUZ DE IGNACIO DE LA LLAVE,30,TEHUIPANGO,159,ACHICHIPICO,3,256,135,121,12
VERACRUZ DE IGNACIO DE LA LLAVE,30,TEHUIPANGO,159,AGUACATLA,2,20,12,8,2
VERACRUZ DE IGNACIO DE LA LLAVE,30,TEHUIPANGO,159,AMOLTEPEC,2,34,19,15,3
VERACRUZ DE IGNACIO DE LA LLAVE,30,TEHUIPANGO,159,APIPITZACTITLA,3,282,129,153,12
VERACRUZ DE IGNACIO DE LA LLAVE,30,TEHUIPANGO,159,BARRIO GUERRERO,2,49,25,24,4
VERACRUZ DE IGNACIO DE LA LLAVE,30,TEHUIPANGO,159,CHIAPA,1,57,35,22,3
VERACRUZ DE IGNACIO DE LA LLAVE,30,TEHUIPANGO,159,CIMARRONTLA,2,46,24,22,4
VERACRUZ DE IGNACIO DE LA LLAVE,30,TEHUIPANGO,159,CUAUYOLOTITLA,2,162,80,82,9
VERACRUZ DE IGNACIO DE LA LLAVE,30,TEHUIPANGO,159,DOS CAMINOS,3,50,34,16,5
VERACRUZ DE IGNACIO DE LA LLAVE,30,TEHUIPANGO,159,DURAZNOTLA,2,50,23,27,4
VERACRUZ DE IGNACIO DE LA LLAVE,30,TEHUIPANGO,159,LA JOYA,2,80,43,37,4
VERACRUZ DE IGNACIO DE LA LLAVE,30,TEHUIPANGO,159,LOMA BONITA,2,256,128,128,5
VERACRUZ DE IGNACIO DE LA LLAVE,30,TEHUIPANGO,159,LOMA CHICA,2,57,32,25,4
VERACRUZ DE IGNACIO DE LA LLAVE,30,TEHUIPANGO,159,LOMA DE LOS PINOS,2,76,42,34,3
VERACRUZ DE IGNACIO DE LA LLAVE,30,TEHUIPANGO,159,LOMATIPA,2,47,25,22,4
VERACRUZ DE IGNACIO DE LA LLAVE,30,TEHUIPANGO,159,MORELOS,1,3,2,1,1
VERACRUZ DE IGNACIO DE LA LLAVE,30,TEHUIPANGO,159,MOXALA,2,31,18,13,3
VERACRUZ DE IGNACIO DE LA LLAVE,30,TEHUIPANGO,159,OCOTELICA,2,26,12,14,2
VERACRUZ DE IGNACIO DE LA LLAVE,30,TEHUIPANGO,159,OCOTITLÁN,2,53,23,30,3
VERACRUZ DE IGNACIO DE LA LLAVE,30,TEHUIPANGO,159,OJO DE AGUA,2,145,71,74,8
VERACRUZ DE IGNACIO DE LA LLAVE,30,TEHUIPANGO,159,OPOTZINGA,4,313,144,169,15
VERACRUZ DE IGNACIO DE LA LLAVE,30,TEHUIPANGO,159,SANTA CRUZ ATITLA,2,55,30,25,3
VERACRUZ DE IGNACIO DE LA LLAVE,30,TEHUIPANGO,159,TEHUIPANGO,5,1772,980,792,66
VERACRUZ DE IGNACIO DE LA LLAVE,30,TEHUIPANGO,159,TEPECUITLAPA,3,286,144,142,13
VERACRUZ DE IGNACIO DE LA LLAVE,30,TEHUIPANGO,159,TEPEICA,3,297,140,157,11
VERACRUZ DE IGNACIO DE LA LLAVE,30,TEHUIPANGO,159,TEPEPA,2,139,73,66,7
VERACRUZ DE IGNACIO DE LA LLAVE,30,TEHUIPANGO,159,TEPETLAMPA,1,42,18,24,2
VERACRUZ DE IGNACIO DE LA LLAVE,30,TEHUIPANGO,159,TEPETZALA,2,21,8,13,2
VERACRUZ DE IGNACIO DE LA LLAVE,30,TEHUIPANGO,159,TERRERO,2,84,47,37,3
VERACRUZ DE IGNACIO DE LA LLAVE,30,TEHUIPANGO,159,TICOMA,3,188,72,116,8
VERACRUZ DE IGNACIO DE LA LLAVE,30,TEHUIPANGO,159,TILICA,2,74,42,32,3
VERACRUZ DE IGNACIO DE LA LLAVE,30,TEHUIPANGO,159,TLACHICOLATEMPA,3,38,19,19,4
VERACRUZ DE IGNACIO DE LA LLAVE,30,TEHUIPANGO,159,TLAJCOLTEPEC,2,129,69,60,6
VERACRUZ DE IGNACIO DE LA LLAVE,30,TEHUIPANGO,159,TLALCHICHICASPA,2,89,42,47,5
VERACRUZ DE IGNACIO DE LA LLAVE,30,TEHUIPANGO,159,TLALCHICHILCO,2,92,39,53,5
VERACRUZ DE IGNACIO DE LA LLAVE,30,TEHUIPANGO,159,TLALCOSPA,2,120,64,56,5
VERACRUZ DE IGNACIO DE LA LLAVE,30,TEHUIPANGO,159,TLALIXTLAHUAC,1,36,12,24,2
VERACRUZ DE IGNACIO DE LA LLAVE,30,TEHUIPANGO,159,TLAQUEXPA,2,57,25,32,3
VERACRUZ DE IGNACIO DE LA LLAVE,30,TEHUIPANGO,159,TOLAPA,2,34,15,19,3
VERACRUZ DE IGNACIO DE LA LLAVE,30,TEHUIPANGO,159,TONALAPA,2,58,29,29,2
VERACRUZ DE IGNACIO DE LA LLAVE,30,TEHUIPANGO,159,TOTUTLA,2,96,51,45,6
VERACRUZ DE IGNACIO DE LA LLAVE,30,TEHUIPANGO,159,TUXPANGO,2,36,20,16,3
VERACRUZ DE IGNACIO DE LA LLAVE,30,TEHUIPANGO,159,TZACUALA PRIMERO,4,599,296,303,25
VERACRUZ DE IGNACIO DE LA LLAVE,30,TEHUIPANGO,159,TZACUALA SEGUNDO,2,93,45,48,5
VERACRUZ DE IGNACIO DE LA LLAVE,30,TEHUIPANGO,159,TZOMPOALECCA SEGUNDO,3,171,86,85,10
VERACRUZ DE IGNACIO DE LA LLAVE,30,TEHUIPANGO,159,TZOMPOALECCA UNO,3,195,96,99,8
VERACRUZ DE IGNACIO DE LA LLAVE,30,TEHUIPANGO,159,XALTEPEC,2,136,71,65,7
VERACRUZ DE IGNACIO DE LA LLAVE,30,TEHUIPANGO,159,XIUJTEMPA,2,138,67,71,8
VERACRUZ DE IGNACIO DE LA LLAVE,30,TEHUIPANGO,159,XONACAYOJCA,2,155,68,87,7
VERACRUZ DE IGNACIO DE LA LLAVE,30,TEHUIPANGO,159,XOPILAPA,5,1041,523,518,41
VERACRUZ DE IGNACIO DE LA LLAVE,30,TEHUIPANGO,159,ZACATECOXCO,2,115,51,64,3
VERACRUZ DE IGNACIO DE LA LLAVE,30,TEHUIPANGO,159,ZACATLAIXCO,2,216,106,110,9
VERACRUZ DE IGNACIO DE LA LLAVE,30,ÁLAMO TEMAPACHE,160,ADOLFO LÓPEZ MATEOS,2,37,21,16,4
VERACRUZ DE IGNACIO DE LA LLAVE,30,ÁLAMO TEMAPACHE,160,AGUA NACIDA,3,169,85,84,11
VERACRUZ DE IGNACIO DE LA LLAVE,30,ÁLAMO TEMAPACHE,160,AGUA ZARCA,2,41,19,22,3
VERACRUZ DE IGNACIO DE LA LLAVE,30,ÁLAMO TEMAPACHE,160,AGUACATE DE VINAZCO,2,50,24,26,4
VERACRUZ DE IGNACIO DE LA LLAVE,30,ÁLAMO TEMAPACHE,160,ALAJUELA,2,17,7,10,2
VERACRUZ DE IGNACIO DE LA LLAVE,30,ÁLAMO TEMAPACHE,160,ÁLAMO,51,6948,3513,3435,422
VERACRUZ DE IGNACIO DE LA LLAVE,30,ÁLAMO TEMAPACHE,160,ALFREDO V. BONFIL,2,15,8,7,2
VERACRUZ DE IGNACIO DE LA LLAVE,30,ÁLAMO TEMAPACHE,160,AQUILES SERDÁN (EL NUEVE),2,73,37,36,6
VERACRUZ DE IGNACIO DE LA LLAVE,30,ÁLAMO TEMAPACHE,160,ARROYO HONDO,1,21,11,10,1
VERACRUZ DE IGNACIO DE LA LLAVE,30,ÁLAMO TEMAPACHE,160,ARROYO HONDO (KILÓMETRO 26),1,4,1,3,1
VERACRUZ DE IGNACIO DE LA LLAVE,30,ÁLAMO TEMAPACHE,160,ARROYO SECO,3,43,25,18,6
VERACRUZ DE IGNACIO DE LA LLAVE,30,ÁLAMO TEMAPACHE,160,ARTÍCULO VEINTISIETE CONSTITUCIONAL,1,8,4,4,1
VERACRUZ DE IGNACIO DE LA LLAVE,30,ÁLAMO TEMAPACHE,160,AUGUSTO GÓMEZ VILLANUEVA,2,24,13,11,3
VERACRUZ DE IGNACIO DE LA LLAVE,30,ÁLAMO TEMAPACHE,160,BELÉN,2,21,9,12,4
VERACRUZ DE IGNACIO DE LA LLAVE,30,ÁLAMO TEMAPACHE,160,BIENES NACIONALES,2,33,18,15,2
VERACRUZ DE IGNACIO DE LA LLAVE,30,ÁLAMO TEMAPACHE,160,BRASILAR,3,70,26,44,8
VERACRUZ DE IGNACIO DE LA LLAVE,30,ÁLAMO TEMAPACHE,160,BUENA VISTA MOLINO,2,26,10,16,2
VERACRUZ DE IGNACIO DE LA LLAVE,30,ÁLAMO TEMAPACHE,160,BUENA VISTA NÚMERO DOS,2,24,7,17,2
VERACRUZ DE IGNACIO DE LA LLAVE,30,ÁLAMO TEMAPACHE,160,BUENAVISTA LA PEÑA,1,5,1,4,1
VERACRUZ DE IGNACIO DE LA LLAVE,30,ÁLAMO TEMAPACHE,160,BUENOS AIRES (SAN ISIDRO),4,325,170,155,21
VERACRUZ DE IGNACIO DE LA LLAVE,30,ÁLAMO TEMAPACHE,160,CAROLINO ANAYA,1,11,6,5,1
VERACRUZ DE IGNACIO DE LA LLAVE,30,ÁLAMO TEMAPACHE,160,CERRITO DE CHIJOLAR,1,29,18,11,2
VERACRUZ DE IGNACIO DE LA LLAVE,30,ÁLAMO TEMAPACHE,160,CERRITOS FRIJOLILLO,2,32,14,18,3
VERACRUZ DE IGNACIO DE LA LLAVE,30,ÁLAMO TEMAPACHE,160,CERRO DE HORCONES,1,4,1,3,2
VERACRUZ DE IGNACIO DE LA LLAVE,30,ÁLAMO TEMAPACHE,160,CERRO DEL PLUMAJE,3,91,46,45,6
VERACRUZ DE IGNACIO DE LA LLAVE,30,ÁLAMO TEMAPACHE,160,CERRO DULCE,2,78,37,41,6
VERACRUZ DE IGNACIO DE LA LLAVE,30,ÁLAMO TEMAPACHE,160,CHAPOPOTE NÚÑEZ,7,942,464,478,92
VERACRUZ DE IGNACIO DE LA LLAVE,30,ÁLAMO TEMAPACHE,160,CINCO DE FEBRERO,2,9,6,3,2
VERACRUZ DE IGNACIO DE LA LLAVE,30,ÁLAMO TEMAPACHE,160,CITLALTÉPETL,3,94,41,53,10
VERACRUZ DE IGNACIO DE LA LLAVE,30,ÁLAMO TEMAPACHE,160,DOCTOR FERRER,2,18,9,9,2
VERACRUZ DE IGNACIO DE LA LLAVE,30,ÁLAMO TEMAPACHE,160,DOCTOR MONTES DE OCA (SAN ISIDRO),4,424,189,235,38
VERACRUZ DE IGNACIO DE LA LLAVE,30,ÁLAMO TEMAPACHE,160,EJIDO ÁLAMO TORTUGA (SANTA ELENA),3,99,66,33,10
VERACRUZ DE IGNACIO DE LA LLAVE,30,ÁLAMO TEMAPACHE,160,EL ALAZÁN,1,8,3,5,1
VERACRUZ DE IGNACIO DE LA LLAVE,30,ÁLAMO TEMAPACHE,160,EL ARBOLITO,2,40,16,24,3
VERACRUZ DE IGNACIO DE LA LLAVE,30,ÁLAMO TEMAPACHE,160,EL CATORCE (HIDALGO AMAJAC),2,15,7,8,3
VERACRUZ DE IGNACIO DE LA LLAVE,30,ÁLAMO TEMAPACHE,160,EL COYOTE,2,17,9,8,2
VERACRUZ DE IGNACIO DE LA LLAVE,30,ÁLAMO TEMAPACHE,160,EL FORTÍN,3,45,27,18,5
VERACRUZ DE IGNACIO DE LA LLAVE,30,ÁLAMO TEMAPACHE,160,EL GUAYABO,2,45,22,23,4
VERACRUZ DE IGNACIO DE LA LLAVE,30,ÁLAMO TEMAPACHE,160,EL IXTLE,3,33,21,12,4
VERACRUZ DE IGNACIO DE LA LLAVE,30,ÁLAMO TEMAPACHE,160,EL MANANTIAL,2,62,31,31,6
VERACRUZ DE IGNACIO DE LA LLAVE,30,ÁLAMO TEMAPACHE,160,EL MANTE,2,15,6,9,3
VERACRUZ DE IGNACIO DE LA LLAVE,30,ÁLAMO TEMAPACHE,160,EL SALTO VIEJO,1,12,5,7,1
VERACRUZ DE IGNACIO DE LA LLAVE,30,ÁLAMO TEMAPACHE,160,EL XÚCHITL,2,17,11,6,2
VERACRUZ DE IGNACIO DE LA LLAVE,30,ÁLAMO TEMAPACHE,160,EMILIANO ZAPATA,3,272,127,145,21
VERACRUZ DE IGNACIO DE LA LLAVE,30,ÁLAMO TEMAPACHE,160,ESCOBAL,1,11,4,7,1
VERACRUZ DE IGNACIO DE LA LLAVE,30,ÁLAMO TEMAPACHE,160,ESTACIÓN CHAPAPOTE (PUERTA SIETE),3,168,76,92,11
VERACRUZ DE IGNACIO DE LA LLAVE,30,ÁLAMO TEMAPACHE,160,ESTACIÓN LLANO GRANDE,1,9,5,4,1
VERACRUZ DE IGNACIO DE LA LLAVE,30,ÁLAMO TEMAPACHE,160,ESTERO DEL ÍDOLO,3,553,271,282,39
VERACRUZ DE IGNACIO DE LA LLAVE,30,ÁLAMO TEMAPACHE,160,EX-HACIENDA EL ALAZÁN,2,150,79,71,11
VERACRUZ DE IGNACIO DE LA LLAVE,30,ÁLAMO TEMAPACHE,160,GENERAL A. TEJEDA Y SU A. GRACIANO SÁNCHEZ,3,133,65,68,10
VERACRUZ DE IGNACIO DE LA LLAVE,30,ÁLAMO TEMAPACHE,160,GENERAL ÁLVARO OBREGÓN (EL RETIRO),3,30,15,15,4
VERACRUZ DE IGNACIO DE LA LLAVE,30,ÁLAMO TEMAPACHE,160,GENERAL LÁZARO CÁRDENAS,2,42,18,24,3
VERACRUZ DE IGNACIO DE LA LLAVE,30,ÁLAMO TEMAPACHE,160,GENERAL MANUEL ÁVILA CAMACHO (LA GLORIA),2,11,6,5,2
VERACRUZ DE IGNACIO DE LA LLAVE,30,ÁLAMO TEMAPACHE,160,GUILLERMO VÉLEZ,1,9,4,5,1
VERACRUZ DE IGNACIO DE LA LLAVE,30,ÁLAMO TEMAPACHE,160,HERMENEGILDO GALEANA,2,30,16,14,3
VERACRUZ DE IGNACIO DE LA LLAVE,30,ÁLAMO TEMAPACHE,160,HÉROES DEL CUARENTA Y SIETE (OTATAL),4,206,96,110,16
VERACRUZ DE IGNACIO DE LA LLAVE,30,ÁLAMO TEMAPACHE,160,HIDALGO AMAJAC,4,253,132,121,19
VERACRUZ DE IGNACIO DE LA LLAVE,30,ÁLAMO TEMAPACHE,160,HORCONES,2,57,26,31,6
VERACRUZ DE IGNACIO DE LA LLAVE,30,ÁLAMO TEMAPACHE,160,IGNACIO ZARAGOZA,2,43,19,24,3
VERACRUZ DE IGNACIO DE LA LLAVE,30,ÁLAMO TEMAPACHE,160,INDEPENDENCIA,2,23,13,10,2
VERACRUZ DE IGNACIO DE LA LLAVE,30,ÁLAMO TEMAPACHE,160,JARDÍN VIEJO,6,228,120,108,19
VERACRUZ DE IGNACIO DE LA LLAVE,30,ÁLAMO TEMAPACHE,160,JAVIER ROJO GÓMEZ,2,11,6,5,2
VERACRUZ DE IGNACIO DE LA LLAVE,30,ÁLAMO TEMAPACHE,160,JOSÉ MARÍA PINO SUÁREZ,1,12,4,8,1
VERACRUZ DE IGNACIO DE LA LLAVE,30,ÁLAMO TEMAPACHE,160,JOSEFA ORTIZ DE DOMÍNGUEZ (TABASQUITO),2,22,8,14,3
VERACRUZ DE IGNACIO DE LA LLAVE,30,ÁLAMO TEMAPACHE,160,KILÓMETRO TREINTA Y TRES (PASO REAL),3,109,54,55,12
VERACRUZ DE IGNACIO DE LA LLAVE,30,ÁLAMO TEMAPACHE,160,LA BARRANCA,2,49,26,23,4
VERACRUZ DE IGNACIO DE LA LLAVE,30,ÁLAMO TEMAPACHE,160,LA BARRANCA (LA VICTORIA),2,21,6,15,2
VERACRUZ DE IGNACIO DE LA LLAVE,30,ÁLAMO TEMAPACHE,160,LA CAMELIA (PALO BLANCO),5,603,302,301,42
VERACRUZ DE IGNACIO DE LA LLAVE,30,ÁLAMO TEMAPACHE,160,LA CEIBA,1,3,3,0,1
VERACRUZ DE IGNACIO DE LA LLAVE,30,ÁLAMO TEMAPACHE,160,LA CONCEPCIÓN,4,466,259,207,25
VERACRUZ DE IGNACIO DE LA LLAVE,30,ÁLAMO TEMAPACHE,160,LA CONSTITUCIÓN (COYOLAR),3,304,164,140,5
VERACRUZ DE IGNACIO DE LA LLAVE,30,ÁLAMO TEMAPACHE,160,LA DEFENSA,4,173,76,97,11
VERACRUZ DE IGNACIO DE LA LLAVE,30,ÁLAMO TEMAPACHE,160,LA ENSENADA (SAN JUAN),3,36,23,13,3
VERACRUZ DE IGNACIO DE LA LLAVE,30,ÁLAMO TEMAPACHE,160,LA ESPERANZA NUEVA,3,85,31,54,5
VERACRUZ DE IGNACIO DE LA LLAVE,30,ÁLAMO TEMAPACHE,160,LA FORTUNA,2,6,4,2,1
VERACRUZ DE IGNACIO DE LA LLAVE,30,ÁLAMO TEMAPACHE,160,LA GRANADILLA,4,184,85,99,15
VERACRUZ DE IGNACIO DE LA LLAVE,30,ÁLAMO TEMAPACHE,160,LA MATA,2,28,14,14,2
VERACRUZ DE IGNACIO DE LA LLAVE,30,ÁLAMO TEMAPACHE,160,LA NORIA,3,131,66,65,10
VERACRUZ DE IGNACIO DE LA LLAVE,30,ÁLAMO TEMAPACHE,160,LA PALMA,2,29,11,18,2
VERACRUZ DE IGNACIO DE LA LLAVE,30,ÁLAMO TEMAPACHE,160,LA PEDRERA (CUICUINACO),4,177,93,84,12
VERACRUZ DE IGNACIO DE LA LLAVE,30,ÁLAMO TEMAPACHE,160,LA PIEDRA ENCONTRADA (FLORIDA),4,163,78,85,13
VERACRUZ DE IGNACIO DE LA LLAVE,30,ÁLAMO TEMAPACHE,160,LA PROVIDENCIA,2,44,23,21,4
VERACRUZ DE IGNACIO DE LA LLAVE,30,ÁLAMO TEMAPACHE,160,LA REFORMA,4,120,56,64,12
VERACRUZ DE IGNACIO DE LA LLAVE,30,ÁLAMO TEMAPACHE,160,LA TORTUGA,1,20,13,7,2
VERACRUZ DE IGNACIO DE LA LLAVE,30,ÁLAMO TEMAPACHE,160,LA UNIÓN,2,102,50,52,8
VERACRUZ DE IGNACIO DE LA LLAVE,30,ÁLAMO TEMAPACHE,160,LA VICTORIA,1,8,4,4,1
VERACRUZ DE IGNACIO DE LA LLAVE,30,ÁLAMO TEMAPACHE,160,LAGUNA LOMAS DE VINAZCO,2,27,18,9,2
VERACRUZ DE IGNACIO DE LA LLAVE,30,ÁLAMO TEMAPACHE,160,LAS CAÑAS DE ABAJO,4,183,92,91,14
VERACRUZ DE IGNACIO DE LA LLAVE,30,ÁLAMO TEMAPACHE,160,LAS FLORES CINCO POBLADOS,4,175,89,86,14
VERACRUZ DE IGNACIO DE LA LLAVE,30,ÁLAMO TEMAPACHE,160,LOMA BONITA,2,108,54,54,7
VERACRUZ DE IGNACIO DE LA LLAVE,30,ÁLAMO TEMAPACHE,160,LOMA LARGA (RANCHO NUEVO),1,7,3,4,1
VERACRUZ DE IGNACIO DE LA LLAVE,30,ÁLAMO TEMAPACHE,160,LOMAS DE VINAZCO,4,301,149,152,17
VERACRUZ DE IGNACIO DE LA LLAVE,30,ÁLAMO TEMAPACHE,160,LOS INSURGENTES,3,71,37,34,5
VERACRUZ DE IGNACIO DE LA LLAVE,30,ÁLAMO TEMAPACHE,160,LUCIO BLANCO,2,43,21,22,4
VERACRUZ DE IGNACIO DE LA LLAVE,30,ÁLAMO TEMAPACHE,160,MANUEL ALMANZA (RANCHO NUEVO),2,70,32,38,4
VERACRUZ DE IGNACIO DE LA LLAVE,30,ÁLAMO TEMAPACHE,160,MESÓN MOLINO,4,125,59,66,10
VERACRUZ DE IGNACIO DE LA LLAVE,30,ÁLAMO TEMAPACHE,160,MILCAHUALES,2,36,18,18,3
VERACRUZ DE IGNACIO DE LA LLAVE,30,ÁLAMO TEMAPACHE,160,MONTE CHIQUITO,2,73,40,33,5
VERACRUZ DE IGNACIO DE LA LLAVE,30,ÁLAMO TEMAPACHE,160,MONTE VERDE,2,13,9,4,3
VERACRUZ DE IGNACIO DE LA LLAVE,30,ÁLAMO TEMAPACHE,160,NUEVO JARDÍN,2,237,108,129,12
VERACRUZ DE IGNACIO DE LA LLAVE,30,ÁLAMO TEMAPACHE,160,NUEVO MÉXICO,2,4,1,3,2
VERACRUZ DE IGNACIO DE LA LLAVE,30,ÁLAMO TEMAPACHE,160,NUEVO PASO REAL,3,53,22,31,5
VERACRUZ DE IGNACIO DE LA LLAVE,30,ÁLAMO TEMAPACHE,160,OJITAL CIRUELO,5,236,117,119,17
VERACRUZ DE IGNACIO DE LA LLAVE,30,ÁLAMO TEMAPACHE,160,OJITAL LA GUADALUPE,2,31,16,15,3
VERACRUZ DE IGNACIO DE LA LLAVE,30,ÁLAMO TEMAPACHE,160,OJITAL SANTA MARÍA,5,169,73,96,10
VERACRUZ DE IGNACIO DE LA LLAVE,30,ÁLAMO TEMAPACHE,160,OTATAL,3,63,30,33,7
VERACRUZ DE IGNACIO DE LA LLAVE,30,ÁLAMO TEMAPACHE,160,PALO BLANCO,4,251,114,137,17
VERACRUZ DE IGNACIO DE LA LLAVE,30,ÁLAMO TEMAPACHE,160,PASO DE ÁLAMO (LA PITA),2,14,9,5,2
VERACRUZ DE IGNACIO DE LA LLAVE,30,ÁLAMO TEMAPACHE,160,PASO DEL PERRO (LA PIMIENTA),4,213,120,93,13
VERACRUZ DE IGNACIO DE LA LLAVE,30,ÁLAMO TEMAPACHE,160,POTRERO DEL LLANO,9,964,472,492,69
VERACRUZ DE IGNACIO DE LA LLAVE,30,ÁLAMO TEMAPACHE,160,PUEBLO NUEVO,1,21,12,9,2
VERACRUZ DE IGNACIO DE LA LLAVE,30,ÁLAMO TEMAPACHE,160,PUERTA SIETE,1,24,12,12,2
VERACRUZ DE IGNACIO DE LA LLAVE,30,ÁLAMO TEMAPACHE,160,RANCHO NUEVO,3,89,45,44,6
VERACRUZ DE IGNACIO DE LA LLAVE,30,ÁLAMO TEMAPACHE,160,RAUDAL NUEVO,3,122,55,67,10
VERACRUZ DE IGNACIO DE LA LLAVE,30,ÁLAMO TEMAPACHE,160,RAYA OBSCURA,2,58,28,30,5
VERACRUZ DE IGNACIO DE LA LLAVE,30,ÁLAMO TEMAPACHE,160,REFORMA AGRARIA INTEGRAL,2,35,19,16,3
VERACRUZ DE IGNACIO DE LA LLAVE,30,ÁLAMO TEMAPACHE,160,RODRÍGUEZ CLARA,3,97,51,46,7
VERACRUZ DE IGNACIO DE LA LLAVE,30,ÁLAMO TEMAPACHE,160,SAN FERNANDO,3,119,50,69,11
VERACRUZ DE IGNACIO DE LA LLAVE,30,ÁLAMO TEMAPACHE,160,SAN MIGUEL,2,62,31,31,6
VERACRUZ DE IGNACIO DE LA LLAVE,30,ÁLAMO TEMAPACHE,160,SANTA EMILIA,3,45,19,26,4
VERACRUZ DE IGNACIO DE LA LLAVE,30,ÁLAMO TEMAPACHE,160,SANTA MARTHA,3,23,14,9,3
VERACRUZ DE IGNACIO DE LA LLAVE,30,ÁLAMO TEMAPACHE,160,SANTA ROSALÍA (CAMALOTE),2,30,15,15,3
VERACRUZ DE IGNACIO DE LA LLAVE,30,ÁLAMO TEMAPACHE,160,SIERRA DE SAN MIGUEL,2,20,11,9,3
VERACRUZ DE IGNACIO DE LA LLAVE,30,ÁLAMO TEMAPACHE,160,SIERRA DOCTOR MONTES DE OCA (LA SIERRITA),3,82,44,38,7
VERACRUZ DE IGNACIO DE LA LLAVE,30,ÁLAMO TEMAPACHE,160,SOLÍS DE ALLENDE,3,29,17,12,4
VERACRUZ DE IGNACIO DE LA LLAVE,30,ÁLAMO TEMAPACHE,160,SOMBRERETE GRANDE,3,137,68,69,8
VERACRUZ DE IGNACIO DE LA LLAVE,30,ÁLAMO TEMAPACHE,160,TABLONES,2,27,12,15,3
VERACRUZ DE IGNACIO DE LA LLAVE,30,ÁLAMO TEMAPACHE,160,TAMATOCO,4,149,61,88,11
VERACRUZ DE IGNACIO DE LA LLAVE,30,ÁLAMO TEMAPACHE,160,TEMAPACHE,5,379,177,202,37
VERACRUZ DE IGNACIO DE LA LLAVE,30,ÁLAMO TEMAPACHE,160,TEPETZINTLILLA,3,79,39,40,10
VERACRUZ DE IGNACIO DE LA LLAVE,30,ÁLAMO TEMAPACHE,160,TIERRA AMARILLA,3,60,21,39,7
VERACRUZ DE IGNACIO DE LA LLAVE,30,ÁLAMO TEMAPACHE,160,TIERRA BLANCA BOOXTER,5,335,169,166,27
VERACRUZ DE IGNACIO DE LA LLAVE,30,ÁLAMO TEMAPACHE,160,TINCONTLÁN,4,291,131,160,21
VERACRUZ DE IGNACIO DE LA LLAVE,30,ÁLAMO TEMAPACHE,160,TOHACO (PIEDRAS NEGRAS),2,36,12,24,2
VERACRUZ DE IGNACIO DE LA LLAVE,30,ÁLAMO TEMAPACHE,160,TUMBADERO,1,11,5,6,1
VERACRUZ DE IGNACIO DE LA LLAVE,30,ÁLAMO TEMAPACHE,160,TUMBADERO DEL ÁGUILA,5,131,62,69,12
VERACRUZ DE IGNACIO DE LA LLAVE,30,ÁLAMO TEMAPACHE,160,ÚRSULO GALVÁN II,3,78,44,34,7
VERACRUZ DE IGNACIO DE LA LLAVE,30,ÁLAMO TEMAPACHE,160,ÚRSULO GALVÁN UNO (EL LIMONAR),2,125,59,66,8
VERACRUZ DE IGNACIO DE LA LLAVE,30,ÁLAMO TEMAPACHE,160,VARA ALTA,3,78,40,38,10
VERACRUZ DE IGNACIO DE LA LLAVE,30,ÁLAMO TEMAPACHE,160,VEGAS DE LA SOLEDAD Y SOLEDAD DOS,4,364,192,172,23
VERACRUZ DE IGNACIO DE LA LLAVE,30,ÁLAMO TEMAPACHE,160,VENUSTIANO CARRANZA,3,127,63,64,9
VERACRUZ DE IGNACIO DE LA LLAVE,30,ÁLAMO TEMAPACHE,160,VICENTE GUERRERO,4,152,68,84,9
VERACRUZ DE IGNACIO DE LA LLAVE,30,ÁLAMO TEMAPACHE,160,VILLA HERMOSA,4,137,78,59,15
VERACRUZ DE IGNACIO DE LA LLAVE,30,ÁLAMO TEMAPACHE,160,XOYOTITLA,4,1888,813,1075,97
VERACRUZ DE IGNACIO DE LA LLAVE,30,ÁLAMO TEMAPACHE,160,ZACATAL,3,70,28,42,7
VERACRUZ DE IGNACIO DE LA LLAVE,30,ÁLAMO TEMAPACHE,160,ZANJA DEL BOTE,2,77,42,35,8
VERACRUZ DE IGNACIO DE LA LLAVE,30,ÁLAMO TEMAPACHE,160,ZAPOTAL SOLÍS (SAN JOSÉ SOLÍS),3,43,25,18,6
VERACRUZ DE IGNACIO DE LA LLAVE,30,ÁLAMO TEMAPACHE,160,ZAPOTITLÁN NÚMERO DOS,2,54,23,31,5
VERACRUZ DE IGNACIO DE LA LLAVE,30,TEMPOAL,161,ABEL ESCOBAR VICENCIO,2,8,6,2,1
VERACRUZ DE IGNACIO DE LA LLAVE,30,TEMPOAL,161,ALTO DE VEGA RICA,3,34,22,12,4
VERACRUZ DE IGNACIO DE LA LLAVE,30,TEMPOAL,161,ALTO DEL OJITE,3,53,20,33,6
VERACRUZ DE IGNACIO DE LA LLAVE,30,TEMPOAL,161,ARROYO CANCHEY,4,94,36,58,9
VERACRUZ DE IGNACIO DE LA LLAVE,30,TEMPOAL,161,ARROYO HONDO,1,7,1,6,1
VERACRUZ DE IGNACIO DE LA LLAVE,30,TEMPOAL,161,BUENAVISTA UNO,1,13,3,10,2
VERACRUZ DE IGNACIO DE LA LLAVE,30,TEMPOAL,161,CAMPO VIEJO,2,22,14,8,3
VERACRUZ DE IGNACIO DE LA LLAVE,30,TEMPOAL,161,CHICAYÁN,3,20,11,9,3
VERACRUZ DE IGNACIO DE LA LLAVE,30,TEMPOAL,161,CORNIZUELO,3,92,40,52,10
VERACRUZ DE IGNACIO DE LA LLAVE,30,TEMPOAL,161,COROZAL,5,318,148,170,24
VERACRUZ DE IGNACIO DE LA LLAVE,30,TEMPOAL,161,CRUZ DE PALMA (EL CARMEN),4,136,76,60,14
VERACRUZ DE IGNACIO DE LA LLAVE,30,TEMPOAL,161,DOS RAYAS,2,15,8,7,2
VERACRUZ DE IGNACIO DE LA LLAVE,30,TEMPOAL,161,EL AGUACATE,2,28,11,17,3
VERACRUZ DE IGNACIO DE LA LLAVE,30,TEMPOAL,161,EL AGUACATE TERRERO,5,197,94,103,14
VERACRUZ DE IGNACIO DE LA LLAVE,30,TEMPOAL,161,EL ARMADILLO,5,53,23,30,8
VERACRUZ DE IGNACIO DE LA LLAVE,30,TEMPOAL,161,EL BARBECHO,2,33,17,16,3
VERACRUZ DE IGNACIO DE LA LLAVE,30,TEMPOAL,161,EL BASUCHE,1,3,3,0,1
VERACRUZ DE IGNACIO DE LA LLAVE,30,TEMPOAL,161,EL CANTARITO,4,167,84,83,21
VERACRUZ DE IGNACIO DE LA LLAVE,30,TEMPOAL,161,EL CARDÓN LIMÓN,2,26,16,10,3
VERACRUZ DE IGNACIO DE LA LLAVE,30,TEMPOAL,161,EL CARRIZAL,2,23,9,14,2
VERACRUZ DE IGNACIO DE LA LLAVE,30,TEMPOAL,161,EL CHIJOL,3,34,20,14,6
VERACRUZ DE IGNACIO DE LA LLAVE,30,TEMPOAL,161,EL COYOLITO,2,34,16,18,3
VERACRUZ DE IGNACIO DE LA LLAVE,30,TEMPOAL,161,EL HULE (EL BARRANCO),3,181,89,92,12
VERACRUZ DE IGNACIO DE LA LLAVE,30,TEMPOAL,161,EL HULE NUEVO,1,15,8,7,1
VERACRUZ DE IGNACIO DE LA LLAVE,30,TEMPOAL,161,EL MIRADOR,2,23,13,10,3
VERACRUZ DE IGNACIO DE LA LLAVE,30,TEMPOAL,161,EL MORALILLO (MORILLO),3,33,20,13,4
VERACRUZ DE IGNACIO DE LA LLAVE,30,TEMPOAL,161,EL PESCADO,1,14,8,6,3
VERACRUZ DE IGNACIO DE LA LLAVE,30,TEMPOAL,161,EL PESCADO (NAPOLEÓN SÁNCHEZ SÁNCHEZ),2,34,22,12,4
VERACRUZ DE IGNACIO DE LA LLAVE,30,TEMPOAL,161,EL RANCHITO,1,39,24,15,2
VERACRUZ DE IGNACIO DE LA LLAVE,30,TEMPOAL,161,EL SAUCE,2,47,19,28,6
VERACRUZ DE IGNACIO DE LA LLAVE,30,TEMPOAL,161,EL TULE,1,3,0,3,1
VERACRUZ DE IGNACIO DE LA LLAVE,30,TEMPOAL,161,EL ZAPOTAL,1,8,3,5,1
VERACRUZ DE IGNACIO DE LA LLAVE,30,TEMPOAL,161,GUAYALITOS,1,5,1,4,1
VERACRUZ DE IGNACIO DE LA LLAVE,30,TEMPOAL,161,LA AURORA,2,14,8,6,3
VERACRUZ DE IGNACIO DE LA LLAVE,30,TEMPOAL,161,LA BARRANCA,1,3,0,3,1
VERACRUZ DE IGNACIO DE LA LLAVE,30,TEMPOAL,161,LA CAMPANA,2,11,7,4,1
VERACRUZ DE IGNACIO DE LA LLAVE,30,TEMPOAL,161,LA CENTRAL,4,110,60,50,14
VERACRUZ DE IGNACIO DE LA LLAVE,30,TEMPOAL,161,LA CIÉNEGA,1,9,4,5,1
VERACRUZ DE IGNACIO DE LA LLAVE,30,TEMPOAL,161,LA CUEVA DEL TIGRE,3,91,51,40,11
VERACRUZ DE IGNACIO DE LA LLAVE,30,TEMPOAL,161,LA NORIA,1,9,5,4,1
VERACRUZ DE IGNACIO DE LA LLAVE,30,TEMPOAL,161,LA PALMA (EJIDO LA PALMA),2,25,9,16,4
VERACRUZ DE IGNACIO DE LA LLAVE,30,TEMPOAL,161,LA PUENTE,2,22,8,14,4
VERACRUZ DE IGNACIO DE LA LLAVE,30,TEMPOAL,161,LA REFORMA,2,26,14,12,3
VERACRUZ DE IGNACIO DE LA LLAVE,30,TEMPOAL,161,LA SOMBRA,3,25,10,15,4
VERACRUZ DE IGNACIO DE LA LLAVE,30,TEMPOAL,161,LA VICTORIA,2,10,7,3,2
VERACRUZ DE IGNACIO DE LA LLAVE,30,TEMPOAL,161,LLANO GRANDE,3,245,121,124,14
VERACRUZ DE IGNACIO DE LA LLAVE,30,TEMPOAL,161,LOMA DEL GALLO,2,55,26,29,5
VERACRUZ DE IGNACIO DE LA LLAVE,30,TEMPOAL,161,LOS ALACRANES,2,10,4,6,2
VERACRUZ DE IGNACIO DE LA LLAVE,30,TEMPOAL,161,LOS CÚES,1,12,8,4,1
VERACRUZ DE IGNACIO DE LA LLAVE,30,TEMPOAL,161,MANANTIALES,3,59,29,30,5
VERACRUZ DE IGNACIO DE LA LLAVE,30,TEMPOAL,161,MESILLAS,3,114,58,56,10
VERACRUZ DE IGNACIO DE LA LLAVE,30,TEMPOAL,161,PALMA SOLA,1,7,2,5,1
VERACRUZ DE IGNACIO DE LA LLAVE,30,TEMPOAL,161,PALO SOLO,1,8,3,5,1
VERACRUZ DE IGNACIO DE LA LLAVE,30,TEMPOAL,161,POCHUCO,4,36,9,27,6
VERACRUZ DE IGNACIO DE LA LLAVE,30,TEMPOAL,161,POTRERO DE BRASIL,3,34,19,15,4
VERACRUZ DE IGNACIO DE LA LLAVE,30,TEMPOAL,161,POTRERO HORCÓN,4,114,67,47,13
VERACRUZ DE IGNACIO DE LA LLAVE,30,TEMPOAL,161,RANCHO NUEVO,5,203,92,111,19
VERACRUZ DE IGNACIO DE LA LLAVE,30,TEMPOAL,161,RANCHO NUEVO LIMÓN,1,7,2,5,1
VERACRUZ DE IGNACIO DE LA LLAVE,30,TEMPOAL,161,RANGEL,5,104,47,57,9
VERACRUZ DE IGNACIO DE LA LLAVE,30,TEMPOAL,161,SAN ISIDRO,3,131,67,64,11
VERACRUZ DE IGNACIO DE LA LLAVE,30,TEMPOAL,161,SAN RAFAEL,1,3,3,0,2
VERACRUZ DE IGNACIO DE LA LLAVE,30,TEMPOAL,161,SANTA FE,3,43,21,22,8
VERACRUZ DE IGNACIO DE LA LLAVE,30,TEMPOAL,161,SANTIAGO SÁNCHEZ (SANCUDO),2,36,18,18,3
VERACRUZ DE IGNACIO DE LA LLAVE,30,TEMPOAL,161,SARDO,3,68,32,36,5
VERACRUZ DE IGNACIO DE LA LLAVE,30,TEMPOAL,161,TANCHECHE,2,26,9,17,3
VERACRUZ DE IGNACIO DE LA LLAVE,30,TEMPOAL,161,TANCOY,2,12,9,3,2
VERACRUZ DE IGNACIO DE LA LLAVE,30,TEMPOAL,161,TEMPOAL DE SÁNCHEZ,25,3006,1487,1519,245
VERACRUZ DE IGNACIO DE LA LLAVE,30,TEMPOAL,161,TERESA MORALES DE DELGADO,1,7,5,2,1
VERACRUZ DE IGNACIO DE LA LLAVE,30,TEMPOAL,161,TIERRA COLORADA,1,5,3,2,2
VERACRUZ DE IGNACIO DE LA LLAVE,30,TEMPOAL,161,TRES PALMAS,4,108,57,51,6
VERACRUZ DE IGNACIO DE LA LLAVE,30,TEMPOAL,161,VALANTÍN,2,36,19,17,4
VERACRUZ DE IGNACIO DE LA LLAVE,30,TEMPOAL,161,VEGA RICA,2,44,19,25,4
VERACRUZ DE IGNACIO DE LA LLAVE,30,TEMPOAL,161,ZAPOTALITO,4,49,26,23,6
VERACRUZ DE IGNACIO DE LA LLAVE,30,TENAMPA,162,COLONIA SAN JOSÉ,2,59,26,33,3
VERACRUZ DE IGNACIO DE LA LLAVE,30,TENAMPA,162,EL COYOLITO,5,252,133,119,17
VERACRUZ DE IGNACIO DE LA LLAVE,30,TENAMPA,162,EL RECREO,2,32,21,11,3
VERACRUZ DE IGNACIO DE LA LLAVE,30,TENAMPA,162,EL SÚCHIL,4,203,105,98,14
VERACRUZ DE IGNACIO DE LA LLAVE,30,TENAMPA,162,LA REFORMA,1,10,4,6,1
VERACRUZ DE IGNACIO DE LA LLAVE,30,TENAMPA,162,SANTA RITA,3,59,26,33,4
VERACRUZ DE IGNACIO DE LA LLAVE,30,TENAMPA,162,TENAMPA,4,378,185,193,22
VERACRUZ DE IGNACIO DE LA LLAVE,30,TENAMPA,162,XOPILAPA,3,51,26,25,4
VERACRUZ DE IGNACIO DE LA LLAVE,30,TENOCHTITLÁN,163,AGUSTÍN MELGAR,1,9,5,4,1
VERACRUZ DE IGNACIO DE LA LLAVE,30,TENOCHTITLÁN,163,ARROYO DE LA YEGUA,1,5,2,3,2
VERACRUZ DE IGNACIO DE LA LLAVE,30,TENOCHTITLÁN,163,CUAUHTÉMOC,2,61,34,27,3
VERACRUZ DE IGNACIO DE LA LLAVE,30,TENOCHTITLÁN,163,EL COLORADO,4,274,145,129,24
VERACRUZ DE IGNACIO DE LA LLAVE,30,TENOCHTITLÁN,163,EL MIRADOR,2,71,27,44,6
VERACRUZ DE IGNACIO DE LA LLAVE,30,TENOCHTITLÁN,163,EL PORVENIR,3,48,32,16,4
VERACRUZ DE IGNACIO DE LA LLAVE,30,TENOCHTITLÁN,163,EL ZAPOTE,3,25,12,13,3
VERACRUZ DE IGNACIO DE LA LLAVE,30,TENOCHTITLÁN,163,HIDALGOTITLÁN,1,7,2,5,1
VERACRUZ DE IGNACIO DE LA LLAVE,30,TENOCHTITLÁN,163,LA CAÑADA,3,27,14,13,4
VERACRUZ DE IGNACIO DE LA LLAVE,30,TENOCHTITLÁN,163,LA DEFENSA,2,26,10,16,2
VERACRUZ DE IGNACIO DE LA LLAVE,30,TENOCHTITLÁN,163,LA UNIÓN,2,11,5,6,1
VERACRUZ DE IGNACIO DE LA LLAVE,30,TENOCHTITLÁN,163,TENOCHTITLÁN,6,517,240,277,32
VERACRUZ DE IGNACIO DE LA LLAVE,30,TENOCHTITLÁN,163,TETLEPANQUETZALT,2,13,5,8,2
VERACRUZ DE IGNACIO DE LA LLAVE,30,TENOCHTITLÁN,163,TONALMIL,2,15,7,8,2
VERACRUZ DE IGNACIO DE LA LLAVE,30,TENOCHTITLÁN,163,TROJILLAS,1,14,9,5,1
VERACRUZ DE IGNACIO DE LA LLAVE,30,TEOCELO,164,BAXTLA,3,144,72,72,11
VERACRUZ DE IGNACIO DE LA LLAVE,30,TEOCELO,164,EL ZAPOTE (LAS CANOAS JUAN S. CONDE),2,15,6,9,2
VERACRUZ DE IGNACIO DE LA LLAVE,30,TEOCELO,164,INDEPENDENCIA,2,45,15,30,4
VERACRUZ DE IGNACIO DE LA LLAVE,30,TEOCELO,164,LLANO GRANDE,4,262,120,142,21
VERACRUZ DE IGNACIO DE LA LLAVE,30,TEOCELO,164,MONTE BLANCO,5,329,174,155,19
VERACRUZ DE IGNACIO DE LA LLAVE,30,TEOCELO,164,TEJERÍA,2,64,36,28,5
VERACRUZ DE IGNACIO DE LA LLAVE,30,TEOCELO,164,TEOCELO,14,1886,947,939,146
VERACRUZ DE IGNACIO DE LA LLAVE,30,TEOCELO,164,TEXÍN,6,238,123,115,19
VERACRUZ DE IGNACIO DE LA LLAVE,30,TEPATLAXCO,165,ALTA LUZ DEL CASTILLO,2,45,23,22,3
VERACRUZ DE IGNACIO DE LA LLAVE,30,TEPATLAXCO,165,BUENA VISTA,5,207,118,89,12
VERACRUZ DE IGNACIO DE LA LLAVE,30,TEPATLAXCO,165,CAÑADA AZUL,2,21,10,11,2
VERACRUZ DE IGNACIO DE LA LLAVE,30,TEPATLAXCO,165,EJIDO SONORA,1,9,2,7,1
VERACRUZ DE IGNACIO DE LA LLAVE,30,TEPATLAXCO,165,EL PEDREGAL,2,53,26,27,3
VERACRUZ DE IGNACIO DE LA LLAVE,30,TEPATLAXCO,165,EL TRIUNFO,3,157,68,89,11
VERACRUZ DE IGNACIO DE LA LLAVE,30,TEPATLAXCO,165,LA PALMA,3,249,119,130,14
VERACRUZ DE IGNACIO DE LA LLAVE,30,TEPATLAXCO,165,LAS ÁGUILAS,2,13,7,6,1
VERACRUZ DE IGNACIO DE LA LLAVE,30,TEPATLAXCO,165,PALO GACHO,2,52,27,25,4
VERACRUZ DE IGNACIO DE LA LLAVE,30,TEPATLAXCO,165,SAN JOSÉ TENEJAPA,7,589,294,295,22
VERACRUZ DE IGNACIO DE LA LLAVE,30,TEPATLAXCO,165,TEPATLAXCO,4,475,243,232,21
VERACRUZ DE IGNACIO DE LA LLAVE,30,TEPATLAXCO,165,TERCERA MANZANA,3,51,26,25,4
VERACRUZ DE IGNACIO DE LA LLAVE,30,TEPETLÁN,166,ALTO TÍO DIEGO,3,250,129,121,15
VERACRUZ DE IGNACIO DE LA LLAVE,30,TEPETLÁN,166,BARRO BLANCO,3,55,29,26,5
VERACRUZ DE IGNACIO DE LA LLAVE,30,TEPETLÁN,166,BARRO BLANCO DOS,1,6,1,5,1
VERACRUZ DE IGNACIO DE LA LLAVE,30,TEPETLÁN,166,CITALAPA,2,57,26,31,4
VERACRUZ DE IGNACIO DE LA LLAVE,30,TEPETLÁN,166,COLONIA CUAUHTÉMOC,2,25,9,16,2
VERACRUZ DE IGNACIO DE LA LLAVE,30,TEPETLÁN,166,COLONIA EJIDAL,1,28,16,12,2
VERACRUZ DE IGNACIO DE LA LLAVE,30,TEPETLÁN,166,COLONIA ENRÍQUEZ,3,103,45,58,8
VERACRUZ DE IGNACIO DE LA LLAVE,30,TEPETLÁN,166,EL PATIO,1,4,2,2,1
VERACRUZ DE IGNACIO DE LA LLAVE,30,TEPETLÁN,166,LA CAÑADA (LA BARBECHERA),2,21,12,9,2
VERACRUZ DE IGNACIO DE LA LLAVE,30,TEPETLÁN,166,LA NUEVA REFORMA (LA PARADA),1,11,6,5,1
VERACRUZ DE IGNACIO DE LA LLAVE,30,TEPETLÁN,166,LAS PALOMAS,2,17,4,13,2
VERACRUZ DE IGNACIO DE LA LLAVE,30,TEPETLÁN,166,MAFAFAS,4,279,124,155,17
VERACRUZ DE IGNACIO DE LA LLAVE,30,TEPETLÁN,166,RINCÓN GRANDE,1,16,8,8,2
VERACRUZ DE IGNACIO DE LA LLAVE,30,TEPETLÁN,166,SAN LORENZO,2,35,15,20,3
VERACRUZ DE IGNACIO DE LA LLAVE,30,TEPETLÁN,166,TEPETLÁN,5,490,251,239,27
VERACRUZ DE IGNACIO DE LA LLAVE,30,TEPETLÁN,166,TOTOYAC,3,42,21,21,5
VERACRUZ DE IGNACIO DE LA LLAVE,30,TEPETLÁN,166,VICENTE GUERRERO (TEPETATES),3,188,95,93,12
VERACRUZ DE IGNACIO DE LA LLAVE,30,TEPETZINTLA,167,APACHICRUZ,2,32,10,22,4
VERACRUZ DE IGNACIO DE LA LLAVE,30,TEPETZINTLA,167,AUGUSTO GÓMEZ VILLANUEVA,3,77,39,38,6
VERACRUZ DE IGNACIO DE LA LLAVE,30,TEPETZINTLA,167,COPALTITLA,3,132,69,63,11
VERACRUZ DE IGNACIO DE LA LLAVE,30,TEPETZINTLA,167,CUAMANCO,4,152,81,71,11
VERACRUZ DE IGNACIO DE LA LLAVE,30,TEPETZINTLA,167,EL HUMO,5,373,172,201,29
VERACRUZ DE IGNACIO DE LA LLAVE,30,TEPETZINTLA,167,JILITLA,2,24,16,8,2
VERACRUZ DE IGNACIO DE LA LLAVE,30,TEPETZINTLA,167,LA GUÁSIMA,3,132,63,69,8
VERACRUZ DE IGNACIO DE LA LLAVE,30,TEPETZINTLA,167,LA LAJA,1,3,2,1,1
VERACRUZ DE IGNACIO DE LA LLAVE,30,TEPETZINTLA,167,LA LIMA (CUAMANCO),1,12,5,7,1
VERACRUZ DE IGNACIO DE LA LLAVE,30,TEPETZINTLA,167,LA LOMA,3,80,31,49,5
VERACRUZ DE IGNACIO DE LA LLAVE,30,TEPETZINTLA,167,MOYUTLA (KILÓMETRO 48),4,146,83,63,10
VERACRUZ DE IGNACIO DE LA LLAVE,30,TEPETZINTLA,167,SAN JOSÉ,2,26,16,10,2
VERACRUZ DE IGNACIO DE LA LLAVE,30,TEPETZINTLA,167,TECOMATE,3,153,84,69,10
VERACRUZ DE IGNACIO DE LA LLAVE,30,TEPETZINTLA,167,TENEXCO,1,8,2,6,1
VERACRUZ DE IGNACIO DE LA LLAVE,30,TEPETZINTLA,167,TEPETZINTLA,9,1042,520,522,68
VERACRUZ DE IGNACIO DE LA LLAVE,30,TEPETZINTLA,167,TIERRA BLANCA,5,372,201,171,23
VERACRUZ DE IGNACIO DE LA LLAVE,30,TEQUILA,168,AHUATEPEC,3,141,66,75,8
VERACRUZ DE IGNACIO DE LA LLAVE,30,TEQUILA,168,ATEMPA,3,94,42,52,7
VERACRUZ DE IGNACIO DE LA LLAVE,30,TEQUILA,168,ATLAJCO,2,63,37,26,4
VERACRUZ DE IGNACIO DE LA LLAVE,30,TEQUILA,168,AYAHUALULCO,3,34,17,17,4
VERACRUZ DE IGNACIO DE LA LLAVE,30,TEQUILA,168,CHAPULTEPEC EL GRANDE,2,36,20,16,3
VERACRUZ DE IGNACIO DE LA LLAVE,30,TEQUILA,168,COLONIA LOS ÁLAMOS,2,79,44,35,4
VERACRUZ DE IGNACIO DE LA LLAVE,30,TEQUILA,168,COLONIA NUEVO PROGRESO,2,48,30,18,3
VERACRUZ DE IGNACIO DE LA LLAVE,30,TEQUILA,168,CORTEZCA,2,39,21,18,3
VERACRUZ DE IGNACIO DE LA LLAVE,30,TEQUILA,168,COTLAJAPA,1,228,106,122,11
VERACRUZ DE IGNACIO DE LA LLAVE,30,TEQUILA,168,COXITITLA,3,78,36,42,5
VERACRUZ DE IGNACIO DE LA LLAVE,30,TEQUILA,168,EL CAMPANARIO,2,95,49,46,7
VERACRUZ DE IGNACIO DE LA LLAVE,30,TEQUILA,168,EX-HACIENDA TLAZOLOLAPAN,6,176,92,84,10
VERACRUZ DE IGNACIO DE LA LLAVE,30,TEQUILA,168,LA CUMBRE (BUENA VISTA),2,52,20,32,4
VERACRUZ DE IGNACIO DE LA LLAVE,30,TEQUILA,168,MIRADOR,2,23,11,12,2
VERACRUZ DE IGNACIO DE LA LLAVE,30,TEQUILA,168,MITEPEC,3,57,27,30,3
VERACRUZ DE IGNACIO DE LA LLAVE,30,TEQUILA,168,MOXALA,3,216,87,129,11
VERACRUZ DE IGNACIO DE LA LLAVE,30,TEQUILA,168,OCOTEMPA,6,119,67,52,8
VERACRUZ DE IGNACIO DE LA LLAVE,30,TEQUILA,168,OCOTLA,2,48,30,18,3
VERACRUZ DE IGNACIO DE LA LLAVE,30,TEQUILA,168,OCOTZOCOTLA,2,41,17,24,3
VERACRUZ DE IGNACIO DE LA LLAVE,30,TEQUILA,168,OXTOTITLA,3,125,58,67,7
VERACRUZ DE IGNACIO DE LA LLAVE,30,TEQUILA,168,POPOCATÉPETL,1,10,4,6,1
VERACRUZ DE IGNACIO DE LA LLAVE,30,TEQUILA,168,POXCAUTLA,5,226,124,102,14
VERACRUZ DE IGNACIO DE LA LLAVE,30,TEQUILA,168,SANTA CRUZ,2,105,61,44,8
VERACRUZ DE IGNACIO DE LA LLAVE,30,TEQUILA,168,TEOTZACUALCO,3,113,62,51,6
VERACRUZ DE IGNACIO DE LA LLAVE,30,TEQUILA,168,TEPAPALOTLA,2,14,5,9,2
VERACRUZ DE IGNACIO DE LA LLAVE,30,TEQUILA,168,TEPECUITLAPA,2,59,24,35,4
VERACRUZ DE IGNACIO DE LA LLAVE,30,TEQUILA,168,TEQUILA,13,1859,981,878,128
VERACRUZ DE IGNACIO DE LA LLAVE,30,TEQUILA,168,TLECUAXCO,3,99,40,59,8
VERACRUZ DE IGNACIO DE LA LLAVE,30,TEQUILA,168,TOLAPA,2,71,37,34,4
VERACRUZ DE IGNACIO DE LA LLAVE,30,TEQUILA,168,XALXOCOTLA,1,24,8,16,2
VERACRUZ DE IGNACIO DE LA LLAVE,30,TEQUILA,168,XONOCOJTLA,1,11,4,7,1
VERACRUZ DE IGNACIO DE LA LLAVE,30,TEQUILA,168,ZACATLAMANCA II,2,16,5,11,3
VERACRUZ DE IGNACIO DE LA LLAVE,30,TEQUILA,168,ZINCALCO,1,27,11,16,1
VERACRUZ DE IGNACIO DE LA LLAVE,30,JOSÉ AZUETA,169,AGUA FRÍA,3,35,14,21,4
VERACRUZ DE IGNACIO DE LA LLAVE,30,JOSÉ AZUETA,169,AMPLIACIÓN EJIDO SAN ANTONIO,3,16,7,9,3
VERACRUZ DE IGNACIO DE LA LLAVE,30,JOSÉ AZUETA,169,ARROYO DE LA CRUZ,1,47,23,24,2
VERACRUZ DE IGNACIO DE LA LLAVE,30,JOSÉ AZUETA,169,BUENA VISTA,1,9,3,6,1
VERACRUZ DE IGNACIO DE LA LLAVE,30,JOSÉ AZUETA,169,BUENOS AIRES,1,92,45,47,6
VERACRUZ DE IGNACIO DE LA LLAVE,30,JOSÉ AZUETA,169,CUJULIAPAN,4,195,102,93,13
VERACRUZ DE IGNACIO DE LA LLAVE,30,JOSÉ AZUETA,169,CURAZAO,3,139,67,72,11
VERACRUZ DE IGNACIO DE LA LLAVE,30,JOSÉ AZUETA,169,EL CAFÉ Y ANEXAS,2,16,9,7,3
VERACRUZ DE IGNACIO DE LA LLAVE,30,JOSÉ AZUETA,169,EL CARRIZAL (MAJAHUAL),2,28,15,13,2
VERACRUZ DE IGNACIO DE LA LLAVE,30,JOSÉ AZUETA,169,EL MAGUEY,2,64,37,27,3
VERACRUZ DE IGNACIO DE LA LLAVE,30,JOSÉ AZUETA,169,ESTACIÓN DOBLADERO,4,241,109,132,14
VERACRUZ DE IGNACIO DE LA LLAVE,30,JOSÉ AZUETA,169,JUAN GARCÍA,4,119,58,61,7
VERACRUZ DE IGNACIO DE LA LLAVE,30,JOSÉ AZUETA,169,JUAN MULATO,1,7,2,5,1
VERACRUZ DE IGNACIO DE LA LLAVE,30,JOSÉ AZUETA,169,LA CUATEZONA,1,20,11,9,2
VERACRUZ DE IGNACIO DE LA LLAVE,30,JOSÉ AZUETA,169,LA FLORIDA SUR,2,32,19,13,5
VERACRUZ DE IGNACIO DE LA LLAVE,30,JOSÉ AZUETA,169,LA GLORIA,2,40,13,27,3
VERACRUZ DE IGNACIO DE LA LLAVE,30,JOSÉ AZUETA,169,LA GUADALUPE,3,87,44,43,5
VERACRUZ DE IGNACIO DE LA LLAVE,30,JOSÉ AZUETA,169,LA NUEVA ESPERANZA,2,26,12,14,3
VERACRUZ DE IGNACIO DE LA LLAVE,30,JOSÉ AZUETA,169,LA REFORMA,1,2,1,1,1
VERACRUZ DE IGNACIO DE LA LLAVE,30,JOSÉ AZUETA,169,LAS CADENAS,3,59,33,26,5
VERACRUZ DE IGNACIO DE LA LLAVE,30,JOSÉ AZUETA,169,LAS CRUCES (LA GALLINA),1,9,6,3,2
VERACRUZ DE IGNACIO DE LA LLAVE,30,JOSÉ AZUETA,169,LINDA VISTA,6,392,193,199,23
VERACRUZ DE IGNACIO DE LA LLAVE,30,JOSÉ AZUETA,169,LLANETE,1,5,4,1,1
VERACRUZ DE IGNACIO DE LA LLAVE,30,JOSÉ AZUETA,169,MANZANILLO,2,48,21,27,3
VERACRUZ DE IGNACIO DE LA LLAVE,30,JOSÉ AZUETA,169,NUEVO SAN JOSÉ (CERRO DE ORO),2,54,31,23,4
VERACRUZ DE IGNACIO DE LA LLAVE,30,JOSÉ AZUETA,169,PASO DE LA VIRGEN,1,10,2,8,1
VERACRUZ DE IGNACIO DE LA LLAVE,30,JOSÉ AZUETA,169,PUEBLO NUEVO,3,82,37,45,6
VERACRUZ DE IGNACIO DE LA LLAVE,30,JOSÉ AZUETA,169,RAMIE NUEVO,3,57,27,30,5
VERACRUZ DE IGNACIO DE LA LLAVE,30,JOSÉ AZUETA,169,RANCHO NUEVO,3,14,10,4,3
VERACRUZ DE IGNACIO DE LA LLAVE,30,JOSÉ AZUETA,169,SAN ANTONIO DE BRAVO,2,19,8,11,3
VERACRUZ DE IGNACIO DE LA LLAVE,30,JOSÉ AZUETA,169,SAN JERÓNIMO,4,96,47,49,8
VERACRUZ DE IGNACIO DE LA LLAVE,30,JOSÉ AZUETA,169,SAN LUIS,4,106,41,65,8
VERACRUZ DE IGNACIO DE LA LLAVE,30,JOSÉ AZUETA,169,TENEJAPAN (TENEJAPAN DE MATA),4,117,54,63,8
VERACRUZ DE IGNACIO DE LA LLAVE,30,JOSÉ AZUETA,169,TESECHOACÁN,3,163,92,71,13
VERACRUZ DE IGNACIO DE LA LLAVE,30,JOSÉ AZUETA,169,TIERRA Y LIBERTAD,1,7,5,2,1
VERACRUZ DE IGNACIO DE LA LLAVE,30,JOSÉ AZUETA,169,TINAJA DE MATA,1,4,2,2,1
VERACRUZ DE IGNACIO DE LA LLAVE,30,JOSÉ AZUETA,169,TRES LAGUNAS,1,8,4,4,1
VERACRUZ DE IGNACIO DE LA LLAVE,30,JOSÉ AZUETA,169,VICENTE GUERRERO (EL AGUACATE),4,218,107,111,13
VERACRUZ DE IGNACIO DE LA LLAVE,30,JOSÉ AZUETA,169,VILLA AZUETA,19,1836,931,905,125
VERACRUZ DE IGNACIO DE LA LLAVE,30,TEXCATEPEC,170,AGUA LINDA,2,33,18,15,3
VERACRUZ DE IGNACIO DE LA LLAVE,30,TEXCATEPEC,170,AMAXAC,3,72,40,32,5
VERACRUZ DE IGNACIO DE LA LLAVE,30,TEXCATEPEC,170,AYOTUXTLA,4,514,251,263,22
VERACRUZ DE IGNACIO DE LA LLAVE,30,TEXCATEPEC,170,BENITO JUÁREZ (EL ARMADILLO),2,34,14,20,3
VERACRUZ DE IGNACIO DE LA LLAVE,30,TEXCATEPEC,170,CASA REDONDA,2,68,35,33,4
VERACRUZ DE IGNACIO DE LA LLAVE,30,TEXCATEPEC,170,CERRO CHIQUITO,1,8,6,2,1
VERACRUZ DE IGNACIO DE LA LLAVE,30,TEXCATEPEC,170,CERRO GORDO,3,50,18,32,4
VERACRUZ DE IGNACIO DE LA LLAVE,30,TEXCATEPEC,170,CHILA DE ENRÍQUEZ,2,77,39,38,3
VERACRUZ DE IGNACIO DE LA LLAVE,30,TEXCATEPEC,170,EL LINDERO,1,28,10,18,2
VERACRUZ DE IGNACIO DE LA LLAVE,30,TEXCATEPEC,170,EL LINDERO DE CERRO GORDO,1,17,9,8,1
VERACRUZ DE IGNACIO DE LA LLAVE,30,TEXCATEPEC,170,EL PAPATLAR,3,108,59,49,7
VERACRUZ DE IGNACIO DE LA LLAVE,30,TEXCATEPEC,170,EL PERICÓN,3,168,92,76,11
VERACRUZ DE IGNACIO DE LA LLAVE,30,TEXCATEPEC,170,EL PUERTO,1,6,4,2,2
VERACRUZ DE IGNACIO DE LA LLAVE,30,TEXCATEPEC,170,EL SÓTANO,3,78,41,37,7
VERACRUZ DE IGNACIO DE LA LLAVE,30,TEXCATEPEC,170,EL TOMATE,2,22,12,10,2
VERACRUZ DE IGNACIO DE LA LLAVE,30,TEXCATEPEC,170,LA FLORIDA,3,162,82,80,8
VERACRUZ DE IGNACIO DE LA LLAVE,30,TEXCATEPEC,170,LA MIRRA,4,146,75,71,5
VERACRUZ DE IGNACIO DE LA LLAVE,30,TEXCATEPEC,170,LAS CANOAS,2,143,67,76,7
VERACRUZ DE IGNACIO DE LA LLAVE,30,TEXCATEPEC,170,PIE DE LA CUESTA,3,173,91,82,12
VERACRUZ DE IGNACIO DE LA LLAVE,30,TEXCATEPEC,170,TEXCATEPEC,4,401,200,201,18
VERACRUZ DE IGNACIO DE LA LLAVE,30,TEXCATEPEC,170,TZICATLÁN,4,352,172,180,18
VERACRUZ DE IGNACIO DE LA LLAVE,30,TEXHUACÁN,171,APOXTECA,2,27,15,12,2
VERACRUZ DE IGNACIO DE LA LLAVE,30,TEXHUACÁN,171,ATICPAC,1,6,4,2,1
VERACRUZ DE IGNACIO DE LA LLAVE,30,TEXHUACÁN,171,ATIOPA,2,7,3,4,1
VERACRUZ DE IGNACIO DE LA LLAVE,30,TEXHUACÁN,171,ATZINGO,2,63,36,27,5
VERACRUZ DE IGNACIO DE LA LLAVE,30,TEXHUACÁN,171,EL MIRADOR,1,44,23,21,2
VERACRUZ DE IGNACIO DE LA LLAVE,30,TEXHUACÁN,171,EL PEDREGAL,2,58,24,34,3
VERACRUZ DE IGNACIO DE LA LLAVE,30,TEXHUACÁN,171,EQUIMITITLA,2,14,6,8,1
VERACRUZ DE IGNACIO DE LA LLAVE,30,TEXHUACÁN,171,PALULCA,2,37,23,14,3
VERACRUZ DE IGNACIO DE LA LLAVE,30,TEXHUACÁN,171,TEXALA,1,54,20,34,3
VERACRUZ DE IGNACIO DE LA LLAVE,30,TEXHUACÁN,171,TEXHUACÁN,8,956,479,477,43
VERACRUZ DE IGNACIO DE LA LLAVE,30,TEXHUACÁN,171,TEXUTZINGO (LOS PINOS),1,29,13,16,2
VERACRUZ DE IGNACIO DE LA LLAVE,30,TEXHUACÁN,171,TLALCA,2,84,41,43,4
VERACRUZ DE IGNACIO DE LA LLAVE,30,TEXHUACÁN,171,XOCHITITLA,2,52,27,25,3
VERACRUZ DE IGNACIO DE LA LLAVE,30,TEXISTEPEC,172,APÓSTOL FRANCISCO I. MADERO,2,23,11,12,2
VERACRUZ DE IGNACIO DE LA LLAVE,30,TEXISTEPEC,172,BOCA DEL RÍO,3,101,51,50,7
VERACRUZ DE IGNACIO DE LA LLAVE,30,TEXISTEPEC,172,BUENAVISTA (EL CORPAL),2,34,16,18,2
VERACRUZ DE IGNACIO DE LA LLAVE,30,TEXISTEPEC,172,COLOMBIA,1,3,1,2,1
VERACRUZ DE IGNACIO DE LA LLAVE,30,TEXISTEPEC,172,EMILIANO ZAPATA,3,73,37,36,6
VERACRUZ DE IGNACIO DE LA LLAVE,30,TEXISTEPEC,172,ENCINAL DE OJAPA,2,48,18,30,4
VERACRUZ DE IGNACIO DE LA LLAVE,30,TEXISTEPEC,172,FRANCISCO I. MADERO,3,97,44,53,8
VERACRUZ DE IGNACIO DE LA LLAVE,30,TEXISTEPEC,172,GUADALUPE VICTORIA,2,28,13,15,3
VERACRUZ DE IGNACIO DE LA LLAVE,30,TEXISTEPEC,172,HIPÓLITO LANDEROS (ZACATAL),3,155,80,75,11
VERACRUZ DE IGNACIO DE LA LLAVE,30,TEXISTEPEC,172,IXTEPEC,1,5,1,4,1
VERACRUZ DE IGNACIO DE LA LLAVE,30,TEXISTEPEC,172,JOSÉ MARÍA MORELOS Y PAVÓN,3,70,34,36,5
VERACRUZ DE IGNACIO DE LA LLAVE,30,TEXISTEPEC,172,JOSÉ MARÍA PINO SUÁREZ,3,41,18,23,4
VERACRUZ DE IGNACIO DE LA LLAVE,30,TEXISTEPEC,172,LA LAGUNA,3,40,21,19,4
VERACRUZ DE IGNACIO DE LA LLAVE,30,TEXISTEPEC,172,LAS CAMELIAS (SAN FRANCISCO),3,57,25,32,5
VERACRUZ DE IGNACIO DE LA LLAVE,30,TEXISTEPEC,172,LÁZARO CÁRDENAS,2,29,14,15,2
VERACRUZ DE IGNACIO DE LA LLAVE,30,TEXISTEPEC,172,LOMA BONITA,3,74,32,42,5
VERACRUZ DE IGNACIO DE LA LLAVE,30,TEXISTEPEC,172,LOMA CENTRAL,2,37,20,17,3
VERACRUZ DE IGNACIO DE LA LLAVE,30,TEXISTEPEC,172,OJO DE AGUA,3,47,24,23,5
VERACRUZ DE IGNACIO DE LA LLAVE,30,TEXISTEPEC,172,PASO DE LOS INDIOS,2,18,7,11,2
VERACRUZ DE IGNACIO DE LA LLAVE,30,TEXISTEPEC,172,SAN LORENZO POTRERO NUEVO,2,37,19,18,3
VERACRUZ DE IGNACIO DE LA LLAVE,30,TEXISTEPEC,172,SAN LORENZO TENOCHTITLÁN,5,304,139,165,16
VERACRUZ DE IGNACIO DE LA LLAVE,30,TEXISTEPEC,172,TEXISTEPEC,12,1501,752,749,97
VERACRUZ DE IGNACIO DE LA LLAVE,30,TEXISTEPEC,172,VENUSTIANO CARRANZA (PEÑA BLANCA),5,316,167,149,14
VERACRUZ DE IGNACIO DE LA LLAVE,30,TEXISTEPEC,172,VILLA ALTA,4,305,143,162,13
VERACRUZ DE IGNACIO DE LA LLAVE,30,TEXISTEPEC,172,XOCHILTEPEC,1,15,9,6,2
VERACRUZ DE IGNACIO DE LA LLAVE,30,TEXISTEPEC,172,XOCHITLÁN (PALMILLAS),4,59,30,29,7
VERACRUZ DE IGNACIO DE LA LLAVE,30,TEXISTEPEC,172,XOCHITLÁN MONTE NEGRO,1,10,6,4,1
VERACRUZ DE IGNACIO DE LA LLAVE,30,TEXISTEPEC,172,YATEPEC,3,22,13,9,3
VERACRUZ DE IGNACIO DE LA LLAVE,30,TEXISTEPEC,172,ZACATAL,3,33,17,16,3
VERACRUZ DE IGNACIO DE LA LLAVE,30,TEZONAPA,173,ADOLFO LÓPEZ MATEOS,2,48,21,27,3
VERACRUZ DE IGNACIO DE LA LLAVE,30,TEZONAPA,173,ADOLFO RUIZ CORTINES,1,3,0,3,1
VERACRUZ DE IGNACIO DE LA LLAVE,30,TEZONAPA,173,AGUA ESCONDIDA,2,74,37,37,3
VERACRUZ DE IGNACIO DE LA LLAVE,30,TEZONAPA,173,ALMILINGA (SANTO DOMINGO MANZANARES),4,232,116,116,14
VERACRUZ DE IGNACIO DE LA LLAVE,30,TEZONAPA,173,ATLIPOZONIA,2,21,13,8,2
VERACRUZ DE IGNACIO DE LA LLAVE,30,TEZONAPA,173,ATLIZACUAPAN,3,131,54,77,8
VERACRUZ DE IGNACIO DE LA LLAVE,30,TEZONAPA,173,BARRIO NUEVO,3,35,20,15,3
VERACRUZ DE IGNACIO DE LA LLAVE,30,TEZONAPA,173,CARRIZAL,2,26,8,18,2
VERACRUZ DE IGNACIO DE LA LLAVE,30,TEZONAPA,173,CAXAPA,6,464,220,244,25
VERACRUZ DE IGNACIO DE LA LLAVE,30,TEZONAPA,173,CEDRO QUEMADO,2,24,14,10,2
VERACRUZ DE IGNACIO DE LA LLAVE,30,TEZONAPA,173,CERRO AZUL,2,17,4,13,2
VERACRUZ DE IGNACIO DE LA LLAVE,30,TEZONAPA,173,CESEKAPA,2,14,5,9,2
VERACRUZ DE IGNACIO DE LA LLAVE,30,TEZONAPA,173,COLONIA AGRÍCOLA INDEPENDENCIA,2,46,25,21,3
VERACRUZ DE IGNACIO DE LA LLAVE,30,TEZONAPA,173,COLONIA AGRÍCOLA MARCO ANTONIO MUÑOZ,3,62,35,27,7
VERACRUZ DE IGNACIO DE LA LLAVE,30,TEZONAPA,173,COLONIA AGRÍCOLA RINCÓN DE LAS FLORES,4,150,72,78,10
VERACRUZ DE IGNACIO DE LA LLAVE,30,TEZONAPA,173,COLONIA CAFETERA VERACRUZANA (LA JOYA),3,20,10,10,3
VERACRUZ DE IGNACIO DE LA LLAVE,30,TEZONAPA,173,COLONIA EL PROGRESO,2,40,18,22,3
VERACRUZ DE IGNACIO DE LA LLAVE,30,TEZONAPA,173,COLONIA IGNACIO ALLENDE,2,21,9,12,2
VERACRUZ DE IGNACIO DE LA LLAVE,30,TEZONAPA,173,COLONIA IGNACIO ESCOBAR CONTRERAS,2,32,16,16,2
VERACRUZ DE IGNACIO DE LA LLAVE,30,TEZONAPA,173,COLONIA MORELOS (CONGREGACIÓN VÁZQUEZ VELA),1,4,3,1,1
VERACRUZ DE IGNACIO DE LA LLAVE,30,TEZONAPA,173,COLONIA SAN BERNARDO SEGUNDA FRACCIÓN,2,20,12,8,2
VERACRUZ DE IGNACIO DE LA LLAVE,30,TEZONAPA,173,COLONIA SANTA MARÍA,2,29,13,16,2
VERACRUZ DE IGNACIO DE LA LLAVE,30,TEZONAPA,173,EJECATÉPETL,2,20,7,13,2
VERACRUZ DE IGNACIO DE LA LLAVE,30,TEZONAPA,173,EL AGUAJE,2,35,14,21,3
VERACRUZ DE IGNACIO DE LA LLAVE,30,TEZONAPA,173,EL CEDRO,2,42,20,22,3
VERACRUZ DE IGNACIO DE LA LLAVE,30,TEZONAPA,173,EL CRUCERO (COLONIA LAS JOSEFINAS),3,121,58,63,9
VERACRUZ DE IGNACIO DE LA LLAVE,30,TEZONAPA,173,EL FILETE (EL CALVARIO),3,51,22,29,4
VERACRUZ DE IGNACIO DE LA LLAVE,30,TEZONAPA,173,EL MIRADOR,2,43,19,24,2
VERACRUZ DE IGNACIO DE LA LLAVE,30,TEZONAPA,173,EL OTATE (CRUZTITLA OJO DE AGUA),3,55,22,33,4
VERACRUZ DE IGNACIO DE LA LLAVE,30,TEZONAPA,173,EL PALMAR [CAMPO AGRÍCOLA EXPERIMENTAL],3,71,36,35,5
VERACRUZ DE IGNACIO DE LA LLAVE,30,TEZONAPA,173,EL PALMAR GRANDE,4,227,112,115,15
VERACRUZ DE IGNACIO DE LA LLAVE,30,TEZONAPA,173,EL SUSPIRO,2,68,27,41,4
VERACRUZ DE IGNACIO DE LA LLAVE,30,TEZONAPA,173,EL TRIUNFO,3,57,30,27,5
VERACRUZ DE IGNACIO DE LA LLAVE,30,TEZONAPA,173,FRANCISCO VILLA PRIMERA FRACCIÓN (SAN BERNARDO),1,17,12,5,1
VERACRUZ DE IGNACIO DE LA LLAVE,30,TEZONAPA,173,FRANCISCO VILLA SEGUNDA FRACCIÓN,2,17,8,9,2
VERACRUZ DE IGNACIO DE LA LLAVE,30,TEZONAPA,173,IXTACAPA EL CHICO,5,266,125,141,29
VERACRUZ DE IGNACIO DE LA LLAVE,30,TEZONAPA,173,IXTACAPA EL GRANDE,3,152,74,78,9
VERACRUZ DE IGNACIO DE LA LLAVE,30,TEZONAPA,173,JOYA HONDA,1,10,5,5,1
VERACRUZ DE IGNACIO DE LA LLAVE,30,TEZONAPA,173,LA JOYA (CONGREGACIÓN PARAÍSO REFORMA),2,43,20,23,3
VERACRUZ DE IGNACIO DE LA LLAVE,30,TEZONAPA,173,LA POCHOTA,1,14,6,8,2
VERACRUZ DE IGNACIO DE LA LLAVE,30,TEZONAPA,173,LA SOLEDAD,2,60,31,29,4
VERACRUZ DE IGNACIO DE LA LLAVE,30,TEZONAPA,173,LA TOMA,2,21,11,10,2
VERACRUZ DE IGNACIO DE LA LLAVE,30,TEZONAPA,173,LA UNIÓN,1,21,11,10,2
VERACRUZ DE IGNACIO DE LA LLAVE,30,TEZONAPA,173,LAGUNA CHICA (PUEBLO NUEVO),5,584,317,267,29
VERACRUZ DE IGNACIO DE LA LLAVE,30,TEZONAPA,173,LAS FLORES,3,83,47,36,5
VERACRUZ DE IGNACIO DE LA LLAVE,30,TEZONAPA,173,LAS LIMAS,3,123,68,55,9
VERACRUZ DE IGNACIO DE LA LLAVE,30,TEZONAPA,173,LAS MARAVILLAS,3,63,38,25,6
VERACRUZ DE IGNACIO DE LA LLAVE,30,TEZONAPA,173,LIBERTAD CERRO DE AGUA,3,42,19,23,4
VERACRUZ DE IGNACIO DE LA LLAVE,30,TEZONAPA,173,LIMONESTITLA,4,239,137,102,13
VERACRUZ DE IGNACIO DE LA LLAVE,30,TEZONAPA,173,LOMA BUENAVISTA,2,19,9,10,3
VERACRUZ DE IGNACIO DE LA LLAVE,30,TEZONAPA,173,LOMAS VERDES,2,26,12,14,2
VERACRUZ DE IGNACIO DE LA LLAVE,30,TEZONAPA,173,LOS GARCÍA,1,4,1,3,1
VERACRUZ DE IGNACIO DE LA LLAVE,30,TEZONAPA,173,MANANTIALES DE LOS ALTOS,1,20,5,15,1
VERACRUZ DE IGNACIO DE LA LLAVE,30,TEZONAPA,173,MARÍA LOMA SAN MIGUEL,1,20,7,13,1
VERACRUZ DE IGNACIO DE LA LLAVE,30,TEZONAPA,173,MIRAMAR,1,10,4,6,1
VERACRUZ DE IGNACIO DE LA LLAVE,30,TEZONAPA,173,MONTE ALTO (EMILIANO ZAPATA),6,252,127,125,18
VERACRUZ DE IGNACIO DE LA LLAVE,30,TEZONAPA,173,MOTZORONGO,6,1292,699,593,90
VERACRUZ DE IGNACIO DE LA LLAVE,30,TEZONAPA,173,NICOXCOTLA,1,17,9,8,1
VERACRUZ DE IGNACIO DE LA LLAVE,30,TEZONAPA,173,OJO DE AGUA CHICO,2,21,8,13,2
VERACRUZ DE IGNACIO DE LA LLAVE,30,TEZONAPA,173,OJO DE AGUA GRANDE,2,24,17,7,2
VERACRUZ DE IGNACIO DE LA LLAVE,30,TEZONAPA,173,PALMARITO,1,20,10,10,1
VERACRUZ DE IGNACIO DE LA LLAVE,30,TEZONAPA,173,PARAÍSO LA REFORMA,4,303,140,163,17
VERACRUZ DE IGNACIO DE LA LLAVE,30,TEZONAPA,173,POCITOS,3,105,45,60,8
VERACRUZ DE IGNACIO DE LA LLAVE,30,TEZONAPA,173,POTRERILLO,4,49,26,23,5
VERACRUZ DE IGNACIO DE LA LLAVE,30,TEZONAPA,173,PRESIDIO (PLAN DE LIBRES),5,337,178,159,26
VERACRUZ DE IGNACIO DE LA LLAVE,30,TEZONAPA,173,PUENTE CHILAPA,2,100,52,48,5
VERACRUZ DE IGNACIO DE LA LLAVE,30,TEZONAPA,173,RANCHO NUEVO,3,200,92,108,17
VERACRUZ DE IGNACIO DE LA LLAVE,30,TEZONAPA,173,RAYA CARACOL,2,55,30,25,3
VERACRUZ DE IGNACIO DE LA LLAVE,30,TEZONAPA,173,SAN AGUSTÍN DEL PALMAR,4,172,88,84,12
VERACRUZ DE IGNACIO DE LA LLAVE,30,TEZONAPA,173,SAN ANTONIO,1,9,4,5,1
VERACRUZ DE IGNACIO DE LA LLAVE,30,TEZONAPA,173,SAN BERNARDO,1,7,3,4,1
VERACRUZ DE IGNACIO DE LA LLAVE,30,TEZONAPA,173,SAN GABRIEL,2,41,18,23,3
VERACRUZ DE IGNACIO DE LA LLAVE,30,TEZONAPA,173,SAN ISIDRO,2,10,6,4,2
VERACRUZ DE IGNACIO DE LA LLAVE,30,TEZONAPA,173,SAN ISIDRO (SAN ISIDRO VILLA NUEVA),2,23,14,9,3
VERACRUZ DE IGNACIO DE LA LLAVE,30,TEZONAPA,173,SAN JERÓNIMO MANZANARES,2,51,25,26,5
VERACRUZ DE IGNACIO DE LA LLAVE,30,TEZONAPA,173,SAN JOSÉ ATITLA,2,20,13,7,2
VERACRUZ DE IGNACIO DE LA LLAVE,30,TEZONAPA,173,SAN JOSÉ LAS LAJAS (VILLA NUEVA),3,122,66,56,7
VERACRUZ DE IGNACIO DE LA LLAVE,30,TEZONAPA,173,SAN JUAN (VILLA NUEVA),3,49,23,26,4
VERACRUZ DE IGNACIO DE LA LLAVE,30,TEZONAPA,173,SAN MIGUEL TENEJAPA,3,102,49,53,7
VERACRUZ DE IGNACIO DE LA LLAVE,30,TEZONAPA,173,SANTA CRUZ OLINTZI,2,27,10,17,2
VERACRUZ DE IGNACIO DE LA LLAVE,30,TEZONAPA,173,SOYATLA (TENEXAPA),2,68,38,30,4
VERACRUZ DE IGNACIO DE LA LLAVE,30,TEZONAPA,173,TEPECOXTLA,3,203,98,105,9
VERACRUZ DE IGNACIO DE LA LLAVE,30,TEZONAPA,173,TEPETLAMPA,2,129,74,55,7
VERACRUZ DE IGNACIO DE LA LLAVE,30,TEZONAPA,173,TEPETZINGO,1,14,8,6,2
VERACRUZ DE IGNACIO DE LA LLAVE,30,TEZONAPA,173,TEZONAPA,8,1257,628,629,96
VERACRUZ DE IGNACIO DE LA LLAVE,30,TEZONAPA,173,TILICA,2,45,17,28,3
VERACRUZ DE IGNACIO DE LA LLAVE,30,TEZONAPA,173,TRES CRUCES,2,8,2,6,1
VERACRUZ DE IGNACIO DE LA LLAVE,30,TEZONAPA,173,UNIÓN AGRÍCOLA,1,30,11,19,1
VERACRUZ DE IGNACIO DE LA LLAVE,30,TEZONAPA,173,UNIÓN Y PROGRESO (VILLA NUEVA),3,67,37,30,5
VERACRUZ DE IGNACIO DE LA LLAVE,30,TEZONAPA,173,ÚRSULO GALVÁN,2,25,16,9,2
VERACRUZ DE IGNACIO DE LA LLAVE,30,TEZONAPA,173,VÁZQUEZ VELA,5,97,40,57,8
VERACRUZ DE IGNACIO DE LA LLAVE,30,TEZONAPA,173,VILLA HERMOSA (VILLA NUEVA),2,57,27,30,4
VERACRUZ DE IGNACIO DE LA LLAVE,30,TEZONAPA,173,VILLA NUEVA (PRIMERA MANZANA),6,360,168,192,32
VERACRUZ DE IGNACIO DE LA LLAVE,30,TEZONAPA,173,VILLA NUEVA PANTEÓN,1,16,8,8,1
VERACRUZ DE IGNACIO DE LA LLAVE,30,TEZONAPA,173,VISTA HERMOSA,4,123,60,63,8
VERACRUZ DE IGNACIO DE LA LLAVE,30,TEZONAPA,173,XINICUILA (PASO VIEJO),1,14,6,8,1
VERACRUZ DE IGNACIO DE LA LLAVE,30,TEZONAPA,173,XOCOAPA,2,46,26,20,4
VERACRUZ DE IGNACIO DE LA LLAVE,30,TEZONAPA,173,XOMETLA,2,27,16,11,2
VERACRUZ DE IGNACIO DE LA LLAVE,30,TEZONAPA,173,XONOTLA,3,127,68,59,8
VERACRUZ DE IGNACIO DE LA LLAVE,30,TEZONAPA,173,YOHUALTEPEC,1,4,2,2,1
VERACRUZ DE IGNACIO DE LA LLAVE,30,TEZONAPA,173,YOLOLTEPEC,2,20,9,11,2
VERACRUZ DE IGNACIO DE LA LLAVE,30,TIERRA BLANCA,174,BARAHÚNDA,4,255,120,135,13
VERACRUZ DE IGNACIO DE LA LLAVE,30,TIERRA BLANCA,174,BENITO JUÁREZ,3,114,62,52,6
VERACRUZ DE IGNACIO DE LA LLAVE,30,TIERRA BLANCA,174,BUENA VISTA,2,26,13,13,2
VERACRUZ DE IGNACIO DE LA LLAVE,30,TIERRA BLANCA,174,BUENOS AIRES,1,42,21,21,1
VERACRUZ DE IGNACIO DE LA LLAVE,30,TIERRA BLANCA,174,CAZADERO,2,26,14,12,2
VERACRUZ DE IGNACIO DE LA LLAVE,30,TIERRA BLANCA,174,CERRITOS,1,6,6,0,1
VERACRUZ DE IGNACIO DE LA LLAVE,30,TIERRA BLANCA,174,CERRO AZUL,1,7,3,4,1
VERACRUZ DE IGNACIO DE LA LLAVE,30,TIERRA BLANCA,174,COLONIA PRIMERO DE MAYO,1,30,17,13,3
VERACRUZ DE IGNACIO DE LA LLAVE,30,TIERRA BLANCA,174,EL ABISAL,1,10,3,7,1
VERACRUZ DE IGNACIO DE LA LLAVE,30,TIERRA BLANCA,174,EL AMATE,3,223,116,107,13
VERACRUZ DE IGNACIO DE LA LLAVE,30,TIERRA BLANCA,174,EL BARRIO,1,18,6,12,1
VERACRUZ DE IGNACIO DE LA LLAVE,30,TIERRA BLANCA,174,EL CHISMOSO,1,18,5,13,1
VERACRUZ DE IGNACIO DE LA LLAVE,30,TIERRA BLANCA,174,EL CIMARRÓN,1,7,5,2,1
VERACRUZ DE IGNACIO DE LA LLAVE,30,TIERRA BLANCA,174,EL CONTENTO,3,75,42,33,5
VERACRUZ DE IGNACIO DE LA LLAVE,30,TIERRA BLANCA,174,EL DORADO,2,12,5,7,2
VERACRUZ DE IGNACIO DE LA LLAVE,30,TIERRA BLANCA,174,EL FRAILE,2,36,14,22,3
VERACRUZ DE IGNACIO DE LA LLAVE,30,TIERRA BLANCA,174,EL JÍCARO,4,224,120,104,15
VERACRUZ DE IGNACIO DE LA LLAVE,30,TIERRA BLANCA,174,EL JOBO,2,54,31,23,4
VERACRUZ DE IGNACIO DE LA LLAVE,30,TIERRA BLANCA,174,EL MANANTIAL,2,34,15,19,3
VERACRUZ DE IGNACIO DE LA LLAVE,30,TIERRA BLANCA,174,EL MANGO,1,12,5,7,1
VERACRUZ DE IGNACIO DE LA LLAVE,30,TIERRA BLANCA,174,EL MIRADOR,2,12,6,6,2
VERACRUZ DE IGNACIO DE LA LLAVE,30,TIERRA BLANCA,174,EL MORAL,4,218,108,110,12
VERACRUZ DE IGNACIO DE LA LLAVE,30,TIERRA BLANCA,174,EL NANCHE,2,138,64,74,7
VERACRUZ DE IGNACIO DE LA LLAVE,30,TIERRA BLANCA,174,EL PALENQUE,2,35,15,20,4
VERACRUZ DE IGNACIO DE LA LLAVE,30,TIERRA BLANCA,174,EL PORVENIR,3,115,58,57,7
VERACRUZ DE IGNACIO DE LA LLAVE,30,TIERRA BLANCA,174,EL PROGRESO,1,3,3,0,1
VERACRUZ DE IGNACIO DE LA LLAVE,30,TIERRA BLANCA,174,EL RESPLANDOR,1,5,3,2,1
VERACRUZ DE IGNACIO DE LA LLAVE,30,TIERRA BLANCA,174,EL ROBLE,2,36,19,17,3
VERACRUZ DE IGNACIO DE LA LLAVE,30,TIERRA BLANCA,174,EL TAMARINDO,2,45,18,27,3
VERACRUZ DE IGNACIO DE LA LLAVE,30,TIERRA BLANCA,174,EL VENUSTO,1,8,2,6,1
VERACRUZ DE IGNACIO DE LA LLAVE,30,TIERRA BLANCA,174,ENRIQUE RODRÍGUEZ CANO,1,4,2,2,1
VERACRUZ DE IGNACIO DE LA LLAVE,30,TIERRA BLANCA,174,GALVÁN CARACAS,2,26,13,13,3
VERACRUZ DE IGNACIO DE LA LLAVE,30,TIERRA BLANCA,174,GENERAL EMILIO MÁRQUEZ GALINDO,2,53,22,31,3
VERACRUZ DE IGNACIO DE LA LLAVE,30,TIERRA BLANCA,174,HUIXCOLOTLA,4,489,237,252,22
VERACRUZ DE IGNACIO DE LA LLAVE,30,TIERRA BLANCA,174,IDEAL DE ABAJO,3,175,77,98,12
VERACRUZ DE IGNACIO DE LA LLAVE,30,TIERRA BLANCA,174,JOACHÍN,5,840,445,395,47
VERACRUZ DE IGNACIO DE LA LLAVE,30,TIERRA BLANCA,174,JOSÉ FUENTES PANTOJA,1,13,7,6,1
VERACRUZ DE IGNACIO DE LA LLAVE,30,TIERRA BLANCA,174,JOSÉ MARÍA MORELOS,2,27,12,15,3
VERACRUZ DE IGNACIO DE LA LLAVE,30,TIERRA BLANCA,174,JOYA DE LA PITA,4,144,71,73,12
VERACRUZ DE IGNACIO DE LA LLAVE,30,TIERRA BLANCA,174,JUAN PACHECO ALEMÁN,2,15,10,5,2
VERACRUZ DE IGNACIO DE LA LLAVE,30,TIERRA BLANCA,174,JUNTA DE MORENO,1,14,6,8,2
VERACRUZ DE IGNACIO DE LA LLAVE,30,TIERRA BLANCA,174,LA AMAPOLA,3,107,56,51,6
VERACRUZ DE IGNACIO DE LA LLAVE,30,TIERRA BLANCA,174,LA ATALAYA,4,254,126,128,19
VERACRUZ DE IGNACIO DE LA LLAVE,30,TIERRA BLANCA,174,LA CAMPANA (LA ICA),4,260,138,122,16
VERACRUZ DE IGNACIO DE LA LLAVE,30,TIERRA BLANCA,174,LA CANDELARIA,2,23,8,15,3
VERACRUZ DE IGNACIO DE LA LLAVE,30,TIERRA BLANCA,174,LA LAGUNA,1,30,13,17,1
VERACRUZ DE IGNACIO DE LA LLAVE,30,TIERRA BLANCA,174,LA LOMA,2,4,2,2,1
VERACRUZ DE IGNACIO DE LA LLAVE,30,TIERRA BLANCA,174,LA PROVIDENCIA,2,27,13,14,2
VERACRUZ DE IGNACIO DE LA LLAVE,30,TIERRA BLANCA,174,LA VICTORIA (SAN JOAQUÍN),2,64,27,37,5
VERACRUZ DE IGNACIO DE LA LLAVE,30,TIERRA BLANCA,174,LAS CONCHAS,2,27,14,13,3
VERACRUZ DE IGNACIO DE LA LLAVE,30,TIERRA BLANCA,174,LAS FLORES,2,38,18,20,3
VERACRUZ DE IGNACIO DE LA LLAVE,30,TIERRA BLANCA,174,LAS PRIETAS,3,79,42,37,9
VERACRUZ DE IGNACIO DE LA LLAVE,30,TIERRA BLANCA,174,LÁZARO CÁRDENAS,4,167,81,86,10
VERACRUZ DE IGNACIO DE LA LLAVE,30,TIERRA BLANCA,174,LOMA ALTA,2,28,12,16,4
VERACRUZ DE IGNACIO DE LA LLAVE,30,TIERRA BLANCA,174,LOMA DE LA VILLA,2,41,22,19,3
VERACRUZ DE IGNACIO DE LA LLAVE,30,TIERRA BLANCA,174,LOMA DE LOS PICHONES,1,8,7,1,1
VERACRUZ DE IGNACIO DE LA LLAVE,30,TIERRA BLANCA,174,LOMA DEL CABALLO,2,12,4,8,2
VERACRUZ DE IGNACIO DE LA LLAVE,30,TIERRA BLANCA,174,LOMA DEL IZOTE (MATA PLANTA),2,56,30,26,6
VERACRUZ DE IGNACIO DE LA LLAVE,30,TIERRA BLANCA,174,LOMA DEL MANANTIAL,3,84,39,45,6
VERACRUZ DE IGNACIO DE LA LLAVE,30,TIERRA BLANCA,174,LOS CERRITOS,1,28,22,6,2
VERACRUZ DE IGNACIO DE LA LLAVE,30,TIERRA BLANCA,174,LOS CERROS,2,15,12,3,2
VERACRUZ DE IGNACIO DE LA LLAVE,30,TIERRA BLANCA,174,LOS LEONES,3,91,40,51,7
VERACRUZ DE IGNACIO DE LA LLAVE,30,TIERRA BLANCA,174,LOS MANGOS,4,168,79,89,11
VERACRUZ DE IGNACIO DE LA LLAVE,30,TIERRA BLANCA,174,MATA ALTA (SERENILLA DE ARRIBA),2,59,35,24,6
VERACRUZ DE IGNACIO DE LA LLAVE,30,TIERRA BLANCA,174,MATA ANONILLA,2,51,21,30,3
VERACRUZ DE IGNACIO DE LA LLAVE,30,TIERRA BLANCA,174,MATA COYOL,2,33,11,22,4
VERACRUZ DE IGNACIO DE LA LLAVE,30,TIERRA BLANCA,174,MATA DE CAÑA,1,14,10,4,1
VERACRUZ DE IGNACIO DE LA LLAVE,30,TIERRA BLANCA,174,MATA MAGUEY,2,41,18,23,3
VERACRUZ DE IGNACIO DE LA LLAVE,30,TIERRA BLANCA,174,MATA NARANJO,2,18,8,10,2
VERACRUZ DE IGNACIO DE LA LLAVE,30,TIERRA BLANCA,174,MATA TRAPICHE,1,19,4,15,1
VERACRUZ DE IGNACIO DE LA LLAVE,30,TIERRA BLANCA,174,MATAGALLINAS,2,26,16,10,2
VERACRUZ DE IGNACIO DE LA LLAVE,30,TIERRA BLANCA,174,MIGUEL ALEMÁN VELASCO,1,4,0,4,1
VERACRUZ DE IGNACIO DE LA LLAVE,30,TIERRA BLANCA,174,MORENO SUR,1,6,3,3,1
VERACRUZ DE IGNACIO DE LA LLAVE,30,TIERRA BLANCA,174,NOPILOA,1,5,0,5,1
VERACRUZ DE IGNACIO DE LA LLAVE,30,TIERRA BLANCA,174,NUEVA REFORMA,2,66,40,26,6
VERACRUZ DE IGNACIO DE LA LLAVE,30,TIERRA BLANCA,174,NUEVO ARROYO TAMBOR,2,54,27,27,3
VERACRUZ DE IGNACIO DE LA LLAVE,30,TIERRA BLANCA,174,NUEVO LAGUNA ESCONDIDA,2,21,8,13,2
VERACRUZ DE IGNACIO DE LA LLAVE,30,TIERRA BLANCA,174,NUEVO MASAMILA (LOS CAÑOS),1,26,11,15,2
VERACRUZ DE IGNACIO DE LA LLAVE,30,TIERRA BLANCA,174,NUEVO PORVENIR DE HIDALGO (DICHA TUERTA),2,34,19,15,3
VERACRUZ DE IGNACIO DE LA LLAVE,30,TIERRA BLANCA,174,OTAPA,2,24,11,13,2
VERACRUZ DE IGNACIO DE LA LLAVE,30,TIERRA BLANCA,174,PALMA SOLA,2,41,18,23,6
VERACRUZ DE IGNACIO DE LA LLAVE,30,TIERRA BLANCA,174,PALMERINDA,2,24,8,16,3
VERACRUZ DE IGNACIO DE LA LLAVE,30,TIERRA BLANCA,174,PASO BOBO,2,33,23,10,3
VERACRUZ DE IGNACIO DE LA LLAVE,30,TIERRA BLANCA,174,PASO COYOTE,4,176,91,85,10
VERACRUZ DE IGNACIO DE LA LLAVE,30,TIERRA BLANCA,174,PASO DE LA PALMA,1,9,5,4,1
VERACRUZ DE IGNACIO DE LA LLAVE,30,TIERRA BLANCA,174,PASO DEL GANADO,2,36,15,21,3
VERACRUZ DE IGNACIO DE LA LLAVE,30,TIERRA BLANCA,174,PASO JULIÁN,3,45,14,31,5
VERACRUZ DE IGNACIO DE LA LLAVE,30,TIERRA BLANCA,174,PASO MAGUEYITO,2,44,23,21,3
VERACRUZ DE IGNACIO DE LA LLAVE,30,TIERRA BLANCA,174,PASO NUEVO,3,127,57,70,8
VERACRUZ DE IGNACIO DE LA LLAVE,30,TIERRA BLANCA,174,PITALILLO (PINOLILLO),2,32,14,18,3
VERACRUZ DE IGNACIO DE LA LLAVE,30,TIERRA BLANCA,174,PLAN DE VILLA,4,137,64,73,9
VERACRUZ DE IGNACIO DE LA LLAVE,30,TIERRA BLANCA,174,POBLADO CINCO (NUEVO VILLA OJITLÁN),4,197,94,103,13
VERACRUZ DE IGNACIO DE LA LLAVE,30,TIERRA BLANCA,174,QUECHULEÑO,4,214,95,119,12
VERACRUZ DE IGNACIO DE LA LLAVE,30,TIERRA BLANCA,174,RINCÓN DE IGUANAS (EL IGUANERO),1,4,2,2,1
VERACRUZ DE IGNACIO DE LA LLAVE,30,TIERRA BLANCA,174,RINCÓN ZACAISTE,1,6,4,2,1
VERACRUZ DE IGNACIO DE LA LLAVE,30,TIERRA BLANCA,174,ROBERTO BARRIOS,2,33,16,17,3
VERACRUZ DE IGNACIO DE LA LLAVE,30,TIERRA BLANCA,174,RODRÍGUEZ TEJEDA,3,278,127,151,18
VERACRUZ DE IGNACIO DE LA LLAVE,30,TIERRA BLANCA,174,SALVADOR GONZALO GARCÍA,3,386,196,190,21
VERACRUZ DE IGNACIO DE LA LLAVE,30,TIERRA BLANCA,174,SAN FRANCISCO (PIEDRA GORDA),3,40,16,24,4
VERACRUZ DE IGNACIO DE LA LLAVE,30,TIERRA BLANCA,174,SAN FRANCISCO EL VIEJO,3,27,11,16,3
VERACRUZ DE IGNACIO DE LA LLAVE,30,TIERRA BLANCA,174,SAN JOAQUÍN,2,201,99,102,12
VERACRUZ DE IGNACIO DE LA LLAVE,30,TIERRA BLANCA,174,SAN JOSÉ DEL CACAO,1,9,4,5,1
VERACRUZ DE IGNACIO DE LA LLAVE,30,TIERRA BLANCA,174,SAN MIGUEL,2,3,1,2,1
VERACRUZ DE IGNACIO DE LA LLAVE,30,TIERRA BLANCA,174,SAN NICOLÁS,2,56,25,31,3
VERACRUZ DE IGNACIO DE LA LLAVE,30,TIERRA BLANCA,174,SAN NICOLÁS (LA BURRERA),1,55,33,22,3
VERACRUZ DE IGNACIO DE LA LLAVE,30,TIERRA BLANCA,174,SAN SALVADOR,1,16,8,8,1
VERACRUZ DE IGNACIO DE LA LLAVE,30,TIERRA BLANCA,174,SANTA LUCÍA,4,154,81,73,11
VERACRUZ DE IGNACIO DE LA LLAVE,30,TIERRA BLANCA,174,SERENILLA DE ABAJO,4,164,79,85,11
VERACRUZ DE IGNACIO DE LA LLAVE,30,TIERRA BLANCA,174,TIERRA ADENTRO,2,15,10,5,2
VERACRUZ DE IGNACIO DE LA LLAVE,30,TIERRA BLANCA,174,TIERRA BLANCA,81,14002,6869,7133,916
VERACRUZ DE IGNACIO DE LA LLAVE,30,TIERRA BLANCA,174,TRECE DE SEPTIEMBRE,1,8,4,4,1
VERACRUZ DE IGNACIO DE LA LLAVE,30,TIERRA BLANCA,174,ÚRSULO GALVÁN (LAS CHARCAS),2,40,17,23,3
VERACRUZ DE IGNACIO DE LA LLAVE,30,TIERRA BLANCA,174,VICENTE GUERRERO,2,33,15,18,3
VERACRUZ DE IGNACIO DE LA LLAVE,30,TIERRA BLANCA,174,ZAPOTILLO,4,18,5,13,3
VERACRUZ DE IGNACIO DE LA LLAVE,30,TIHUATLÁN,175,ACONTITLA,5,446,211,235,30
VERACRUZ DE IGNACIO DE LA LLAVE,30,TIHUATLÁN,175,ACUATEMPA,1,9,4,5,2
VERACRUZ DE IGNACIO DE LA LLAVE,30,TIHUATLÁN,175,AGUA FRÍA,2,58,25,33,5
VERACRUZ DE IGNACIO DE LA LLAVE,30,TIHUATLÁN,175,ANTONIO M. QUIRASCO,4,194,107,87,14
VERACRUZ DE IGNACIO DE LA LLAVE,30,TIHUATLÁN,175,BENITO JUÁREZ (CUAUHTÉMOC),4,119,56,63,12
VERACRUZ DE IGNACIO DE LA LLAVE,30,TIHUATLÁN,175,BUENA VISTA,4,131,65,66,12
VERACRUZ DE IGNACIO DE LA LLAVE,30,TIHUATLÁN,175,CASA AMARILLA,2,15,10,5,2
VERACRUZ DE IGNACIO DE LA LLAVE,30,TIHUATLÁN,175,CENTRO DE REHABILITACIÓN,1,32,15,17,3
VERACRUZ DE IGNACIO DE LA LLAVE,30,TIHUATLÁN,175,CERRO DE BUENAVISTA,1,47,22,25,2
VERACRUZ DE IGNACIO DE LA LLAVE,30,TIHUATLÁN,175,CHICHICOAXTLA,3,35,13,22,6
VERACRUZ DE IGNACIO DE LA LLAVE,30,TIHUATLÁN,175,CHICHIMANTLA SEGUNDO,4,251,126,125,21
VERACRUZ DE IGNACIO DE LA LLAVE,30,TIHUATLÁN,175,CHONTLA,1,4,3,1,1
VERACRUZ DE IGNACIO DE LA LLAVE,30,TIHUATLÁN,175,CINCO DE MAYO,2,47,23,24,3
VERACRUZ DE IGNACIO DE LA LLAVE,30,TIHUATLÁN,175,CONSTITUCIÓN,3,47,29,18,6
VERACRUZ DE IGNACIO DE LA LLAVE,30,TIHUATLÁN,175,EL ÁGUILA,4,235,119,116,21
VERACRUZ DE IGNACIO DE LA LLAVE,30,TIHUATLÁN,175,EL CEDRAL,1,207,99,108,11
VERACRUZ DE IGNACIO DE LA LLAVE,30,TIHUATLÁN,175,EL COPAL,4,225,102,123,19
VERACRUZ DE IGNACIO DE LA LLAVE,30,TIHUATLÁN,175,EL HORCÓN,3,134,54,80,14
VERACRUZ DE IGNACIO DE LA LLAVE,30,TIHUATLÁN,175,EL ORIENTE,2,75,27,48,11
VERACRUZ DE IGNACIO DE LA LLAVE,30,TIHUATLÁN,175,EL PALMAR,2,72,38,34,6
VERACRUZ DE IGNACIO DE LA LLAVE,30,TIHUATLÁN,175,EL TERRERO,3,112,57,55,10
VERACRUZ DE IGNACIO DE LA LLAVE,30,TIHUATLÁN,175,EL VELADERO,1,13,10,3,1
VERACRUZ DE IGNACIO DE LA LLAVE,30,TIHUATLÁN,175,EMILIANO ZAPATA (LA BOMBA),5,503,249,254,28
VERACRUZ DE IGNACIO DE LA LLAVE,30,TIHUATLÁN,175,EMILIANO ZAPATA (LOS MICOS),2,22,11,11,3
VERACRUZ DE IGNACIO DE LA LLAVE,30,TIHUATLÁN,175,ENRIQUE RODRÍGUEZ CANO (ZAPOTALILLO),4,250,116,134,17
VERACRUZ DE IGNACIO DE LA LLAVE,30,TIHUATLÁN,175,FERNANDO GUTIÉRREZ BARRIOS,2,17,8,9,2
VERACRUZ DE IGNACIO DE LA LLAVE,30,TIHUATLÁN,175,FRACCIONAMIENTO SANTA INÉS,1,5,3,2,1
VERACRUZ DE IGNACIO DE LA LLAVE,30,TIHUATLÁN,175,FRANCISCO I. MADERO,1,26,15,11,2
VERACRUZ DE IGNACIO DE LA LLAVE,30,TIHUATLÁN,175,FRANCISCO VILLA,4,158,95,63,12
VERACRUZ DE IGNACIO DE LA LLAVE,30,TIHUATLÁN,175,GENERAL LÁZARO CÁRDENAS DEL RÍO,6,635,312,323,34
VERACRUZ DE IGNACIO DE LA LLAVE,30,TIHUATLÁN,175,HUIZOTATE,3,128,65,63,11
VERACRUZ DE IGNACIO DE LA LLAVE,30,TIHUATLÁN,175,INDEPENDENCIA NACIONAL,2,57,29,28,4
VERACRUZ DE IGNACIO DE LA LLAVE,30,TIHUATLÁN,175,JILIAPA I,2,47,19,28,5
VERACRUZ DE IGNACIO DE LA LLAVE,30,TIHUATLÁN,175,JILIAPA SEGUNDO,4,166,70,96,16
VERACRUZ DE IGNACIO DE LA LLAVE,30,TIHUATLÁN,175,JOSÉ MARÍA CARDEL,2,45,23,22,3
VERACRUZ DE IGNACIO DE LA LLAVE,30,TIHUATLÁN,175,KILÓMETRO NUEVE (EJIDO LÁZARO CÁRDENAS),2,69,30,39,6
VERACRUZ DE IGNACIO DE LA LLAVE,30,TIHUATLÁN,175,LA ANTIGUA (POZA LARGA),2,38,21,17,3
VERACRUZ DE IGNACIO DE LA LLAVE,30,TIHUATLÁN,175,LA CONCEPCIÓN,3,296,131,165,27
VERACRUZ DE IGNACIO DE LA LLAVE,30,TIHUATLÁN,175,LA ESFERA,2,13,8,5,2
VERACRUZ DE IGNACIO DE LA LLAVE,30,TIHUATLÁN,175,LA ISLA (KILÓMETRO 10),2,131,60,71,9
VERACRUZ DE IGNACIO DE LA LLAVE,30,TIHUATLÁN,175,LA LOMA,3,51,25,26,6
VERACRUZ DE IGNACIO DE LA LLAVE,30,TIHUATLÁN,175,LA PASADITA,2,25,13,12,3
VERACRUZ DE IGNACIO DE LA LLAVE,30,TIHUATLÁN,175,LA PEDRERA,2,14,10,4,2
VERACRUZ DE IGNACIO DE LA LLAVE,30,TIHUATLÁN,175,LA REFORMA,2,27,11,16,2
VERACRUZ DE IGNACIO DE LA LLAVE,30,TIHUATLÁN,175,LA UNIÓN,4,156,77,79,13
VERACRUZ DE IGNACIO DE LA LLAVE,30,TIHUATLÁN,175,LA VEGA,1,8,5,3,1
VERACRUZ DE IGNACIO DE LA LLAVE,30,TIHUATLÁN,175,LAS PALMAS,2,46,18,28,5
VERACRUZ DE IGNACIO DE LA LLAVE,30,TIHUATLÁN,175,LAS PIEDRAS,2,29,13,16,3
VERACRUZ DE IGNACIO DE LA LLAVE,30,TIHUATLÁN,175,LAS PUENTES,2,43,27,16,4
VERACRUZ DE IGNACIO DE LA LLAVE,30,TIHUATLÁN,175,LINDERO,2,22,10,12,2
VERACRUZ DE IGNACIO DE LA LLAVE,30,TIHUATLÁN,175,LOMAS DEL PARAÍSO,2,27,14,13,2
VERACRUZ DE IGNACIO DE LA LLAVE,30,TIHUATLÁN,175,MAMEY,4,118,49,69,10
VERACRUZ DE IGNACIO DE LA LLAVE,30,TIHUATLÁN,175,MESA CERRADA,2,40,14,26,3
VERACRUZ DE IGNACIO DE LA LLAVE,30,TIHUATLÁN,175,MIGUEL HIDALGO (KILÓMETRO 17),2,128,64,64,10
VERACRUZ DE IGNACIO DE LA LLAVE,30,TIHUATLÁN,175,NUEVO PROGRESO (KILÓMETRO 12),5,694,348,346,41
VERACRUZ DE IGNACIO DE LA LLAVE,30,TIHUATLÁN,175,OJO DE AGUA,1,8,5,3,1
VERACRUZ DE IGNACIO DE LA LLAVE,30,TIHUATLÁN,175,PALO DE ROSA,4,94,49,45,10
VERACRUZ DE IGNACIO DE LA LLAVE,30,TIHUATLÁN,175,PAPATLARILLO,2,40,23,17,3
VERACRUZ DE IGNACIO DE LA LLAVE,30,TIHUATLÁN,175,PASO DEL PITAL,4,243,117,126,18
VERACRUZ DE IGNACIO DE LA LLAVE,30,TIHUATLÁN,175,PASO LA UNO,4,89,41,48,12
VERACRUZ DE IGNACIO DE LA LLAVE,30,TIHUATLÁN,175,PIEDRA CLAVADA,2,29,19,10,2
VERACRUZ DE IGNACIO DE LA LLAVE,30,TIHUATLÁN,175,PLAN DE AYALA,8,873,451,422,64
VERACRUZ DE IGNACIO DE LA LLAVE,30,TIHUATLÁN,175,POZA AZUL DE LOS REYES,4,298,140,158,16
VERACRUZ DE IGNACIO DE LA LLAVE,30,TIHUATLÁN,175,PROGRESO DE MARAVILLAS,2,52,29,23,3
VERACRUZ DE IGNACIO DE LA LLAVE,30,TIHUATLÁN,175,PUEBLO VIEJO,2,25,10,15,3
VERACRUZ DE IGNACIO DE LA LLAVE,30,TIHUATLÁN,175,RAMÓN CARACAS LARA,2,60,30,30,6
VERACRUZ DE IGNACIO DE LA LLAVE,30,TIHUATLÁN,175,RANCHO ALEGRE,1,18,9,9,1
VERACRUZ DE IGNACIO DE LA LLAVE,30,TIHUATLÁN,175,RANCHO NUEVO,3,173,81,92,13
VERACRUZ DE IGNACIO DE LA LLAVE,30,TIHUATLÁN,175,RICARDO FLORES MAGÓN,4,449,228,221,24
VERACRUZ DE IGNACIO DE LA LLAVE,30,TIHUATLÁN,175,SAN ÁNGEL,2,11,3,8,2
VERACRUZ DE IGNACIO DE LA LLAVE,30,TIHUATLÁN,175,SAN ISIDRO,1,26,15,11,3
VERACRUZ DE IGNACIO DE LA LLAVE,30,TIHUATLÁN,175,SAN MIGUEL MECATEPEC (MANANTIAL),5,1122,589,533,63
VERACRUZ DE IGNACIO DE LA LLAVE,30,TIHUATLÁN,175,SAN NICOLÁS,3,58,30,28,7
VERACRUZ DE IGNACIO DE LA LLAVE,30,TIHUATLÁN,175,SAN PEDRO MIAHUAPAN,4,209,102,107,14
VERACRUZ DE IGNACIO DE LA LLAVE,30,TIHUATLÁN,175,SANTA FE (KILÓMETRO 8),1,8,6,2,2
VERACRUZ DE IGNACIO DE LA LLAVE,30,TIHUATLÁN,175,SEBASTIÁN LERDO DE TEJADA,3,90,43,47,8
VERACRUZ DE IGNACIO DE LA LLAVE,30,TIHUATLÁN,175,SECTOR CINCO,3,453,215,238,25
VERACRUZ DE IGNACIO DE LA LLAVE,30,TIHUATLÁN,175,SECTOR LA CEIBA (EJIDO POZA DE CUERO),1,7,4,3,1
VERACRUZ DE IGNACIO DE LA LLAVE,30,TIHUATLÁN,175,TECOMATE,3,109,56,53,11
VERACRUZ DE IGNACIO DE LA LLAVE,30,TIHUATLÁN,175,TECOXTEMPA,3,54,28,26,6
VERACRUZ DE IGNACIO DE LA LLAVE,30,TIHUATLÁN,175,TECOXTEMPA SEGUNDO,1,54,27,27,3
VERACRUZ DE IGNACIO DE LA LLAVE,30,TIHUATLÁN,175,TIHUATLÁN,21,3637,1868,1769,208
VERACRUZ DE IGNACIO DE LA LLAVE,30,TIHUATLÁN,175,TOTOLAPA,8,985,484,501,65
VERACRUZ DE IGNACIO DE LA LLAVE,30,TIHUATLÁN,175,TUMBADERO,2,36,20,16,3
VERACRUZ DE IGNACIO DE LA LLAVE,30,TIHUATLÁN,175,ÚRSULO GALVÁN,5,446,221,225,26
VERACRUZ DE IGNACIO DE LA LLAVE,30,TIHUATLÁN,175,VEGAS DE ACUATEMPA,1,49,18,31,3
VERACRUZ DE IGNACIO DE LA LLAVE,30,TIHUATLÁN,175,VENUSTIANO CARRANZA (EL MOZUELO),3,23,11,12,3
VERACRUZ DE IGNACIO DE LA LLAVE,30,TIHUATLÁN,175,XOCOTLA,2,59,32,27,6
VERACRUZ DE IGNACIO DE LA LLAVE,30,TIHUATLÁN,175,ZACATE COLORADO,5,952,461,491,52
VERACRUZ DE IGNACIO DE LA LLAVE,30,TIHUATLÁN,175,ZAPOTAL SANTA CRUZ,4,293,129,164,18
VERACRUZ DE IGNACIO DE LA LLAVE,30,TIHUATLÁN,175,ZIPATLÁN,2,39,16,23,3
VERACRUZ DE IGNACIO DE LA LLAVE,30,TLACOJALPAN,176,AMBROSIO ALCALDE,2,17,8,9,2
VERACRUZ DE IGNACIO DE LA LLAVE,30,TLACOJALPAN,176,TLACOJALPAN,6,762,378,384,45
VERACRUZ DE IGNACIO DE LA LLAVE,30,TLACOLULAN,177,ARELLANO,2,79,35,44,5
VERACRUZ DE IGNACIO DE LA LLAVE,30,TLACOLULAN,177,ATALPA CHICO,3,254,126,128,13
VERACRUZ DE IGNACIO DE LA LLAVE,30,TLACOLULAN,177,BAÑILLOS,1,8,4,4,1
VERACRUZ DE IGNACIO DE LA LLAVE,30,TLACOLULAN,177,BLANCA ESPUMA,3,63,31,32,6
VERACRUZ DE IGNACIO DE LA LLAVE,30,TLACOLULAN,177,CEBOLLANA,4,184,95,89,11
VERACRUZ DE IGNACIO DE LA LLAVE,30,TLACOLULAN,177,CINCO DE MAYO,3,116,51,65,7
VERACRUZ DE IGNACIO DE LA LLAVE,30,TLACOLULAN,177,CUMBRES DE CEBOLLANA,2,49,18,31,4
VERACRUZ DE IGNACIO DE LA LLAVE,30,TLACOLULAN,177,DURAZNAL,2,70,40,30,4
VERACRUZ DE IGNACIO DE LA LLAVE,30,TLACOLULAN,177,EJIDO SAN JOSÉ,3,41,16,25,5
VERACRUZ DE IGNACIO DE LA LLAVE,30,TLACOLULAN,177,EL BORDO,5,184,101,83,12
VERACRUZ DE IGNACIO DE LA LLAVE,30,TLACOLULAN,177,EL COJOLITE,1,4,3,1,1
VERACRUZ DE IGNACIO DE LA LLAVE,30,TLACOLULAN,177,EL FRESNO,4,479,249,230,31
VERACRUZ DE IGNACIO DE LA LLAVE,30,TLACOLULAN,177,EL PORTÓN,1,5,3,2,1
VERACRUZ DE IGNACIO DE LA LLAVE,30,TLACOLULAN,177,ETLANTEPEC,4,126,63,63,9
VERACRUZ DE IGNACIO DE LA LLAVE,30,TLACOLULAN,177,HUICHILA,3,246,121,125,14
VERACRUZ DE IGNACIO DE LA LLAVE,30,TLACOLULAN,177,LOMA BONITA,2,10,2,8,2
VERACRUZ DE IGNACIO DE LA LLAVE,30,TLACOLULAN,177,MAZCAYA,2,38,23,15,3
VERACRUZ DE IGNACIO DE LA LLAVE,30,TLACOLULAN,177,MISANTLA EL VIEJO,2,6,2,4,1
VERACRUZ DE IGNACIO DE LA LLAVE,30,TLACOLULAN,177,OMEAPA,3,61,31,30,5
VERACRUZ DE IGNACIO DE LA LLAVE,30,TLACOLULAN,177,POTRERO DE GARCÍA,1,13,2,11,2
VERACRUZ DE IGNACIO DE LA LLAVE,30,TLACOLULAN,177,SAN ANDRÉS,2,30,21,9,3
VERACRUZ DE IGNACIO DE LA LLAVE,30,TLACOLULAN,177,SAN JOSÉ,2,45,25,20,3
VERACRUZ DE IGNACIO DE LA LLAVE,30,TLACOLULAN,177,TEAPAN,1,4,3,1,1
VERACRUZ DE IGNACIO DE LA LLAVE,30,TLACOLULAN,177,TENGONAPA,2,97,47,50,7
VERACRUZ DE IGNACIO DE LA LLAVE,30,TLACOLULAN,177,TLACOLULAN,4,632,310,322,34
VERACRUZ DE IGNACIO DE LA LLAVE,30,TLACOLULAN,177,TLACOLULAN EL VIEJO,2,32,17,15,3
VERACRUZ DE IGNACIO DE LA LLAVE,30,TLACOLULAN,177,TREINTA DE ABRIL,2,51,26,25,4
VERACRUZ DE IGNACIO DE LA LLAVE,30,TLACOLULAN,177,XOXOTLA,2,27,15,12,2
VERACRUZ DE IGNACIO DE LA LLAVE,30,TLACOTALPAN,178,BOCA DE SAN MIGUEL,3,81,44,37,4
VERACRUZ DE IGNACIO DE LA LLAVE,30,TLACOTALPAN,178,BOCA DEL BARCO (BOCA DE SAN JUAN),1,10,4,6,1
VERACRUZ DE IGNACIO DE LA LLAVE,30,TLACOTALPAN,178,BODEGUILLAS,2,8,5,3,1
VERACRUZ DE IGNACIO DE LA LLAVE,30,TLACOTALPAN,178,BUGAMBILIA,1,32,14,18,2
VERACRUZ DE IGNACIO DE LA LLAVE,30,TLACOTALPAN,178,CASAS VIEJAS,3,40,25,15,4
VERACRUZ DE IGNACIO DE LA LLAVE,30,TLACOTALPAN,178,CHAPULTEPEC (CHAPULTES),2,6,4,2,2
VERACRUZ DE IGNACIO DE LA LLAVE,30,TLACOTALPAN,178,EL CIRUELO,1,4,2,2,1
VERACRUZ DE IGNACIO DE LA LLAVE,30,TLACOTALPAN,178,EL HORNERO (FRANCISCO J. MORENO),1,9,5,4,1
VERACRUZ DE IGNACIO DE LA LLAVE,30,TLACOTALPAN,178,EL LIMÓN (SAN JOSÉ DE CHÁZARO),1,5,1,4,1
VERACRUZ DE IGNACIO DE LA LLAVE,30,TLACOTALPAN,178,EL MARQUÉS,2,14,6,8,1
VERACRUZ DE IGNACIO DE LA LLAVE,30,TLACOTALPAN,178,EL NACASTE,1,4,2,2,1
VERACRUZ DE IGNACIO DE LA LLAVE,30,TLACOTALPAN,178,EL SÚCHIL DOS,2,30,19,11,2
VERACRUZ DE IGNACIO DE LA LLAVE,30,TLACOTALPAN,178,EL SÚCHIL UNO,1,4,3,1,1
VERACRUZ DE IGNACIO DE LA LLAVE,30,TLACOTALPAN,178,HACIENDA VIEJA,1,18,6,12,1
VERACRUZ DE IGNACIO DE LA LLAVE,30,TLACOTALPAN,178,LA CARBONERA,1,11,6,5,1
VERACRUZ DE IGNACIO DE LA LLAVE,30,TLACOTALPAN,178,LA CORRIENTE,1,6,4,2,1
VERACRUZ DE IGNACIO DE LA LLAVE,30,TLACOTALPAN,178,LAS AMAPOLAS,2,26,11,15,2
VERACRUZ DE IGNACIO DE LA LLAVE,30,TLACOTALPAN,178,LINDA VISTA,3,44,21,23,5
VERACRUZ DE IGNACIO DE LA LLAVE,30,TLACOTALPAN,178,MANO PERDIDA (LA NUEVA REFORMA),3,42,25,17,5
VERACRUZ DE IGNACIO DE LA LLAVE,30,TLACOTALPAN,178,PÉREZ Y JIMÉNEZ,3,57,28,29,6
VERACRUZ DE IGNACIO DE LA LLAVE,30,TLACOTALPAN,178,REMOLINO DE AGUILERA,2,13,5,8,2
VERACRUZ DE IGNACIO DE LA LLAVE,30,TLACOTALPAN,178,REMOLINO DE PAVÁN,2,20,10,10,2
VERACRUZ DE IGNACIO DE LA LLAVE,30,TLACOTALPAN,178,SAN JOSÉ DE CHÁZARO,2,4,1,3,1
VERACRUZ DE IGNACIO DE LA LLAVE,30,TLACOTALPAN,178,SANTA JULIA,1,9,5,4,1
VERACRUZ DE IGNACIO DE LA LLAVE,30,TLACOTALPAN,178,SANTA ROSALÍA,1,11,5,6,1
VERACRUZ DE IGNACIO DE LA LLAVE,30,TLACOTALPAN,178,TIERRA NUEVA (EJIDO EL ZAPOTAL),1,6,2,4,1
VERACRUZ DE IGNACIO DE LA LLAVE,30,TLACOTALPAN,178,TLACOTALPAN,20,2293,1317,976,288
VERACRUZ DE IGNACIO DE LA LLAVE,30,TLACOTEPEC DE MEJÍA,179,ACTOPAN,3,58,21,37,4
VERACRUZ DE IGNACIO DE LA LLAVE,30,TLACOTEPEC DE MEJÍA,179,AMATITLA,2,96,50,46,6
VERACRUZ DE IGNACIO DE LA LLAVE,30,TLACOTEPEC DE MEJÍA,179,CHIXTLA,2,79,39,40,5
VERACRUZ DE IGNACIO DE LA LLAVE,30,TLACOTEPEC DE MEJÍA,179,TLACOTEPEC DE MEJÍA,8,654,329,325,64
VERACRUZ DE IGNACIO DE LA LLAVE,30,TLACHICHILCO,180,APETLACO,2,22,12,10,3
VERACRUZ DE IGNACIO DE LA LLAVE,30,TLACHICHILCO,180,ARROYO GRANDE (EL ARROYO),1,6,2,4,1
VERACRUZ DE IGNACIO DE LA LLAVE,30,TLACHICHILCO,180,CHINTIPAN,4,260,135,125,14
VERACRUZ DE IGNACIO DE LA LLAVE,30,TLACHICHILCO,180,EL COYOL,2,28,17,11,3
VERACRUZ DE IGNACIO DE LA LLAVE,30,TLACHICHILCO,180,EL LLANO,3,51,31,20,4
VERACRUZ DE IGNACIO DE LA LLAVE,30,TLACHICHILCO,180,EL MIRADOR,2,46,25,21,3
VERACRUZ DE IGNACIO DE LA LLAVE,30,TLACHICHILCO,180,EL MIRADOR DE LA LLAVE,2,23,7,16,3
VERACRUZ DE IGNACIO DE LA LLAVE,30,TLACHICHILCO,180,EL MIRRAL,3,16,13,3,2
VERACRUZ DE IGNACIO DE LA LLAVE,30,TLACHICHILCO,180,EL NARANJAL,3,112,61,51,13
VERACRUZ DE IGNACIO DE LA LLAVE,30,TLACHICHILCO,180,EL SÚCHIL,2,18,10,8,2
VERACRUZ DE IGNACIO DE LA LLAVE,30,TLACHICHILCO,180,GÓMEZ FARÍAS,2,30,13,17,2
VERACRUZ DE IGNACIO DE LA LLAVE,30,TLACHICHILCO,180,LA GUITARRA,1,12,6,6,1
VERACRUZ DE IGNACIO DE LA LLAVE,30,TLACHICHILCO,180,LA JABONERA,1,6,2,4,1
VERACRUZ DE IGNACIO DE LA LLAVE,30,TLACHICHILCO,180,LA LLAVE,4,127,61,66,8
VERACRUZ DE IGNACIO DE LA LLAVE,30,TLACHICHILCO,180,LA MINA,2,26,11,15,3
VERACRUZ DE IGNACIO DE LA LLAVE,30,TLACHICHILCO,180,LA PAHUA,1,10,5,5,1
VERACRUZ DE IGNACIO DE LA LLAVE,30,TLACHICHILCO,180,LA SOLEDAD,2,26,11,15,3
VERACRUZ DE IGNACIO DE LA LLAVE,30,TLACHICHILCO,180,LANDERO Y COSS,2,73,42,31,3
VERACRUZ DE IGNACIO DE LA LLAVE,30,TLACHICHILCO,180,LOS APÓSTOLES,1,8,4,4,1
VERACRUZ DE IGNACIO DE LA LLAVE,30,TLACHICHILCO,180,MONTERREY,2,83,33,50,4
VERACRUZ DE IGNACIO DE LA LLAVE,30,TLACHICHILCO,180,NUEVO CHINTIPAN,2,52,26,26,4
VERACRUZ DE IGNACIO DE LA LLAVE,30,TLACHICHILCO,180,OTATITLÁN,4,407,216,191,23
VERACRUZ DE IGNACIO DE LA LLAVE,30,TLACHICHILCO,180,SAN JOSÉ NARANJAL,2,44,22,22,4
VERACRUZ DE IGNACIO DE LA LLAVE,30,TLACHICHILCO,180,TEXCÁ CHIQUITO,1,13,6,7,1
VERACRUZ DE IGNACIO DE LA LLAVE,30,TLACHICHILCO,180,TIERRA COLORADA,2,78,36,42,6
VERACRUZ DE IGNACIO DE LA LLAVE,30,TLACHICHILCO,180,TLACHICHILCO,5,594,277,317,31
VERACRUZ DE IGNACIO DE LA LLAVE,30,TLACHICHILCO,180,TUZANCALLI,1,10,2,8,1
VERACRUZ DE IGNACIO DE LA LLAVE,30,TLACHICHILCO,180,VÍCTOR ROSALES,3,31,14,17,4
VERACRUZ DE IGNACIO DE LA LLAVE,30,TLACHICHILCO,180,XALAME,2,50,24,26,3
VERACRUZ DE IGNACIO DE LA LLAVE,30,TLACHICHILCO,180,XICOTÉNCATL (PALOS ALTOS),3,117,50,67,6
VERACRUZ DE IGNACIO DE LA LLAVE,30,TLALIXCOYAN,181,AMPLIACIÓN ISLA DE PAJARITOS,2,11,5,6,1
VERACRUZ DE IGNACIO DE LA LLAVE,30,TLALIXCOYAN,181,BOTE EN BOTE,2,32,20,12,2
VERACRUZ DE IGNACIO DE LA LLAVE,30,TLALIXCOYAN,181,CALDERAS,2,43,28,15,4
VERACRUZ DE IGNACIO DE LA LLAVE,30,TLALIXCOYAN,181,CASA BLANCA,2,21,9,12,2
VERACRUZ DE IGNACIO DE LA LLAVE,30,TLALIXCOYAN,181,CERRO BARTOLO,2,13,5,8,2
VERACRUZ DE IGNACIO DE LA LLAVE,30,TLALIXCOYAN,181,CERRO DE LAS CONCHAS,2,7,2,5,1
VERACRUZ DE IGNACIO DE LA LLAVE,30,TLALIXCOYAN,181,CUYUCUENDA,3,203,101,102,11
VERACRUZ DE IGNACIO DE LA LLAVE,30,TLALIXCOYAN,181,EL AVIÓN,2,5,3,2,1
VERACRUZ DE IGNACIO DE LA LLAVE,30,TLALIXCOYAN,181,EL CALLEJÓN,2,21,8,13,2
VERACRUZ DE IGNACIO DE LA LLAVE,30,TLALIXCOYAN,181,EL CEDRAL,1,3,0,3,1
VERACRUZ DE IGNACIO DE LA LLAVE,30,TLALIXCOYAN,181,EL COCUITE,3,218,102,116,15
VERACRUZ DE IGNACIO DE LA LLAVE,30,TLALIXCOYAN,181,EL GUAYABO,1,6,2,4,1
VERACRUZ DE IGNACIO DE LA LLAVE,30,TLALIXCOYAN,181,EL MORALILLO,2,30,13,17,3
VERACRUZ DE IGNACIO DE LA LLAVE,30,TLALIXCOYAN,181,EL OJOCHAL,3,58,23,35,4
VERACRUZ DE IGNACIO DE LA LLAVE,30,TLALIXCOYAN,181,EL RECREO,2,30,14,16,3
VERACRUZ DE IGNACIO DE LA LLAVE,30,TLALIXCOYAN,181,EL REMOLINO,3,57,25,32,6
VERACRUZ DE IGNACIO DE LA LLAVE,30,TLALIXCOYAN,181,EL SAUCE (CERRO GRANDE),4,152,75,77,14
VERACRUZ DE IGNACIO DE LA LLAVE,30,TLALIXCOYAN,181,EL SÚCHIL,4,111,54,57,9
VERACRUZ DE IGNACIO DE LA LLAVE,30,TLALIXCOYAN,181,EL ZAPOTE,3,74,39,35,6
VERACRUZ DE IGNACIO DE LA LLAVE,30,TLALIXCOYAN,181,GARRAPATA,2,4,1,3,1
VERACRUZ DE IGNACIO DE LA LLAVE,30,TLALIXCOYAN,181,ISLA DE PAJARITOS,3,81,34,47,5
VERACRUZ DE IGNACIO DE LA LLAVE,30,TLALIXCOYAN,181,LA CAMACHA,1,4,2,2,1
VERACRUZ DE IGNACIO DE LA LLAVE,30,TLALIXCOYAN,181,LA CAMELIA,3,13,7,6,3
VERACRUZ DE IGNACIO DE LA LLAVE,30,TLALIXCOYAN,181,LA ICA,2,65,27,38,4
VERACRUZ DE IGNACIO DE LA LLAVE,30,TLALIXCOYAN,181,LA LAJA,3,90,44,46,5
VERACRUZ DE IGNACIO DE LA LLAVE,30,TLALIXCOYAN,181,LA PEINETA,1,6,4,2,1
VERACRUZ DE IGNACIO DE LA LLAVE,30,TLALIXCOYAN,181,LA POCHOTA,2,21,11,10,2
VERACRUZ DE IGNACIO DE LA LLAVE,30,TLALIXCOYAN,181,LA ROSALÍA,2,24,18,6,3
VERACRUZ DE IGNACIO DE LA LLAVE,30,TLALIXCOYAN,181,LA TEPEHUA,2,21,10,11,2
VERACRUZ DE IGNACIO DE LA LLAVE,30,TLALIXCOYAN,181,LA TRANCA,3,139,59,80,10
VERACRUZ DE IGNACIO DE LA LLAVE,30,TLALIXCOYAN,181,LA TUNA MORELOS,3,36,24,12,5
VERACRUZ DE IGNACIO DE LA LLAVE,30,TLALIXCOYAN,181,LA VÍBORA (LA REFORMA),3,82,36,46,6
VERACRUZ DE IGNACIO DE LA LLAVE,30,TLALIXCOYAN,181,LAGUNA DE ROJAS (PUEBLO NUEVO),1,5,2,3,1
VERACRUZ DE IGNACIO DE LA LLAVE,30,TLALIXCOYAN,181,LAGUNA DEL CEDRAL,2,32,20,12,2
VERACRUZ DE IGNACIO DE LA LLAVE,30,TLALIXCOYAN,181,LAS MESILLAS,2,5,3,2,1
VERACRUZ DE IGNACIO DE LA LLAVE,30,TLALIXCOYAN,181,LOMA DEL CARMEN,2,71,28,43,3
VERACRUZ DE IGNACIO DE LA LLAVE,30,TLALIXCOYAN,181,LOS AMATONES,2,26,13,13,3
VERACRUZ DE IGNACIO DE LA LLAVE,30,TLALIXCOYAN,181,LOS NEGRITOS,1,13,7,6,1
VERACRUZ DE IGNACIO DE LA LLAVE,30,TLALIXCOYAN,181,MADEREROS,3,81,44,37,6
VERACRUZ DE IGNACIO DE LA LLAVE,30,TLALIXCOYAN,181,MATA CABESTRO,2,60,33,27,5
VERACRUZ DE IGNACIO DE LA LLAVE,30,TLALIXCOYAN,181,MATA DE LÁZARO,3,89,44,45,7
VERACRUZ DE IGNACIO DE LA LLAVE,30,TLALIXCOYAN,181,MATA DE LOS DOS TOROS,2,31,11,20,3
VERACRUZ DE IGNACIO DE LA LLAVE,30,TLALIXCOYAN,181,MATA GUITARRA,2,33,15,18,2
VERACRUZ DE IGNACIO DE LA LLAVE,30,TLALIXCOYAN,181,MATA VERDE,2,30,15,15,2
VERACRUZ DE IGNACIO DE LA LLAVE,30,TLALIXCOYAN,181,NUEVO ARROYO CARACOL,2,16,6,10,2
VERACRUZ DE IGNACIO DE LA LLAVE,30,TLALIXCOYAN,181,OTAPAN,2,36,23,13,3
VERACRUZ DE IGNACIO DE LA LLAVE,30,TLALIXCOYAN,181,PALMA SOLA,3,60,21,39,7
VERACRUZ DE IGNACIO DE LA LLAVE,30,TLALIXCOYAN,181,PALO GACHO,3,45,21,24,3
VERACRUZ DE IGNACIO DE LA LLAVE,30,TLALIXCOYAN,181,PASO CARRETAS,3,85,44,41,7
VERACRUZ DE IGNACIO DE LA LLAVE,30,TLALIXCOYAN,181,PASO DE LA BOCA,4,392,204,188,23
VERACRUZ DE IGNACIO DE LA LLAVE,30,TLALIXCOYAN,181,PASO DEL BOTE,2,24,8,16,2
VERACRUZ DE IGNACIO DE LA LLAVE,30,TLALIXCOYAN,181,PASO METATE,2,6,4,2,1
VERACRUZ DE IGNACIO DE LA LLAVE,30,TLALIXCOYAN,181,PIEDRAS NEGRAS,20,2264,1149,1115,142
VERACRUZ DE IGNACIO DE LA LLAVE,30,TLALIXCOYAN,181,PLAN SEXENAL (EL LIMONCITO),2,18,6,12,2
VERACRUZ DE IGNACIO DE LA LLAVE,30,TLALIXCOYAN,181,POZUELO,2,7,4,3,2
VERACRUZ DE IGNACIO DE LA LLAVE,30,TLALIXCOYAN,181,RANCHO NUEVO,2,16,10,6,2
VERACRUZ DE IGNACIO DE LA LLAVE,30,TLALIXCOYAN,181,RECREO SEGUNDO,2,25,9,16,2
VERACRUZ DE IGNACIO DE LA LLAVE,30,TLALIXCOYAN,181,ROJAS,1,8,1,7,1
VERACRUZ DE IGNACIO DE LA LLAVE,30,TLALIXCOYAN,181,SAN ANTONIO,4,86,36,50,8
VERACRUZ DE IGNACIO DE LA LLAVE,30,TLALIXCOYAN,181,SAN JOAQUÍN LIMÓN,3,41,23,18,3
VERACRUZ DE IGNACIO DE LA LLAVE,30,TLALIXCOYAN,181,SANTA ANA (MATA DE CAÑA),2,22,11,11,2
VERACRUZ DE IGNACIO DE LA LLAVE,30,TLALIXCOYAN,181,TENACALCO,2,51,28,23,3
VERACRUZ DE IGNACIO DE LA LLAVE,30,TLALIXCOYAN,181,TLALIXCOYAN,8,1169,602,567,72
VERACRUZ DE IGNACIO DE LA LLAVE,30,TLALIXCOYAN,181,TUZALES,3,148,89,59,10
VERACRUZ DE IGNACIO DE LA LLAVE,30,TLALNELHUAYOCAN,182,CAÑADA LARGA,1,30,14,16,3
VERACRUZ DE IGNACIO DE LA LLAVE,30,TLALNELHUAYOCAN,182,CHILACAYOTES,2,29,17,12,3
VERACRUZ DE IGNACIO DE LA LLAVE,30,TLALNELHUAYOCAN,182,COLONIA EJIDAL (EJIDO SAN ANDRÉS),1,134,68,66,9
VERACRUZ DE IGNACIO DE LA LLAVE,30,TLALNELHUAYOCAN,182,COLONIA ZAMORA,3,251,133,118,19
VERACRUZ DE IGNACIO DE LA LLAVE,30,TLALNELHUAYOCAN,182,CUAUZACATLA,1,44,20,24,7
VERACRUZ DE IGNACIO DE LA LLAVE,30,TLALNELHUAYOCAN,182,GUADALUPE VICTORIA,5,966,469,497,66
VERACRUZ DE IGNACIO DE LA LLAVE,30,TLALNELHUAYOCAN,182,NARANJILLOS,1,23,11,12,3
VERACRUZ DE IGNACIO DE LA LLAVE,30,TLALNELHUAYOCAN,182,OTILPAN,4,497,243,254,29
VERACRUZ DE IGNACIO DE LA LLAVE,30,TLALNELHUAYOCAN,182,PLAN DE MESA CHICA,1,4,0,4,1
VERACRUZ DE IGNACIO DE LA LLAVE,30,TLALNELHUAYOCAN,182,POTRERO DEL BORDO (SANTA MARÍA),1,27,17,10,2
VERACRUZ DE IGNACIO DE LA LLAVE,30,TLALNELHUAYOCAN,182,RANCHO VIEJO,3,310,158,152,19
VERACRUZ DE IGNACIO DE LA LLAVE,30,TLALNELHUAYOCAN,182,SAN ANTONIO HIDALGO,4,419,194,225,29
VERACRUZ DE IGNACIO DE LA LLAVE,30,TLALNELHUAYOCAN,182,TLALNELHUAYOCAN,3,297,133,164,22
VERACRUZ DE IGNACIO DE LA LLAVE,30,TLALNELHUAYOCAN,182,XOCOTLA,2,67,37,30,7
VERACRUZ DE IGNACIO DE LA LLAVE,30,TLAPACOYAN,183,ARROYO DE PIEDRA,3,98,48,50,5
VERACRUZ DE IGNACIO DE LA LLAVE,30,TLAPACOYAN,183,ARROYO PIEDRA,1,9,4,5,1
VERACRUZ DE IGNACIO DE LA LLAVE,30,TLAPACOYAN,183,BUENA VISTA,2,44,21,23,3
VERACRUZ DE IGNACIO DE LA LLAVE,30,TLAPACOYAN,183,CONGREGACIÓN HIDALGO,5,171,80,91,11
VERACRUZ DE IGNACIO DE LA LLAVE,30,TLAPACOYAN,183,COSMIQUILOYAN,2,33,17,16,3
VERACRUZ DE IGNACIO DE LA LLAVE,30,TLAPACOYAN,183,EL CORTIJO,2,10,3,7,1
VERACRUZ DE IGNACIO DE LA LLAVE,30,TLAPACOYAN,183,EL JOBO,4,523,278,245,27
VERACRUZ DE IGNACIO DE LA LLAVE,30,TLAPACOYAN,183,EL MEZCLERO,1,40,17,23,2
VERACRUZ DE IGNACIO DE LA LLAVE,30,TLAPACOYAN,183,EYTEPÉQUEZ,4,387,199,188,19
VERACRUZ DE IGNACIO DE LA LLAVE,30,TLAPACOYAN,183,FRANCISCO I. MADERO,1,12,7,5,1
VERACRUZ DE IGNACIO DE LA LLAVE,30,TLAPACOYAN,183,IXTACUACO,2,56,25,31,5
VERACRUZ DE IGNACIO DE LA LLAVE,30,TLAPACOYAN,183,JAVIER ROJO GÓMEZ,4,453,223,230,28
VERACRUZ DE IGNACIO DE LA LLAVE,30,TLAPACOYAN,183,LA PALMILLA,5,1120,596,524,50
VERACRUZ DE IGNACIO DE LA LLAVE,30,TLAPACOYAN,183,LA REFORMA,3,100,39,61,8
VERACRUZ DE IGNACIO DE LA LLAVE,30,TLAPACOYAN,183,LUIS ECHEVERRÍA,3,122,72,50,8
VERACRUZ DE IGNACIO DE LA LLAVE,30,TLAPACOYAN,183,OTRA BANDA,4,308,154,154,15
VERACRUZ DE IGNACIO DE LA LLAVE,30,TLAPACOYAN,183,PIEDRA PINTA,3,208,100,108,13
VERACRUZ DE IGNACIO DE LA LLAVE,30,TLAPACOYAN,183,PLAN DE HIDALGO,1,4,0,4,1
VERACRUZ DE IGNACIO DE LA LLAVE,30,TLAPACOYAN,183,PLATANOZAPAN,3,83,39,44,6
VERACRUZ DE IGNACIO DE LA LLAVE,30,TLAPACOYAN,183,POCHOTITÁN,2,29,14,15,3
VERACRUZ DE IGNACIO DE LA LLAVE,30,TLAPACOYAN,183,SAN ISIDRO,3,246,129,117,20
VERACRUZ DE IGNACIO DE LA LLAVE,30,TLAPACOYAN,183,SAN PEDRO TLAPACOYAN,3,149,73,76,11
VERACRUZ DE IGNACIO DE LA LLAVE,30,TLAPACOYAN,183,TLAPACOYAN,45,8103,4071,4032,454
VERACRUZ DE IGNACIO DE LA LLAVE,30,TLAPACOYAN,183,TOMATA,1,6,5,1,1
VERACRUZ DE IGNACIO DE LA LLAVE,30,TLAPACOYAN,183,VEGA CHICA,1,8,2,6,2
VERACRUZ DE IGNACIO DE LA LLAVE,30,TLAQUILPA,184,ACATITLA (TEXMOLA),2,34,11,23,3
VERACRUZ DE IGNACIO DE LA LLAVE,30,TLAQUILPA,184,APOXQUILA (LOS PINOS),2,28,15,13,2
VERACRUZ DE IGNACIO DE LA LLAVE,30,TLAQUILPA,184,ARBISTAGCA (ARBISTAGA),2,68,36,32,4
VERACRUZ DE IGNACIO DE LA LLAVE,30,TLAQUILPA,184,ATÉXCATL,2,27,14,13,3
VERACRUZ DE IGNACIO DE LA LLAVE,30,TLAQUILPA,184,BARRIO DE SAN PEDRO TEPEPA,2,74,34,40,6
VERACRUZ DE IGNACIO DE LA LLAVE,30,TLAQUILPA,184,CRUCERO DE OJTLAMAXALCO,1,11,4,7,1
VERACRUZ DE IGNACIO DE LA LLAVE,30,TLAQUILPA,184,EL CARRIL (MONERA),2,22,12,10,3
VERACRUZ DE IGNACIO DE LA LLAVE,30,TLAQUILPA,184,EYITEPEC,2,36,18,18,3
VERACRUZ DE IGNACIO DE LA LLAVE,30,TLAQUILPA,184,ICHCUALCO (LAS CANOAS),2,21,13,8,2
VERACRUZ DE IGNACIO DE LA LLAVE,30,TLAQUILPA,184,LA QUEBRADORA,2,15,8,7,2
VERACRUZ DE IGNACIO DE LA LLAVE,30,TLAQUILPA,184,LOMA DE XOCUAPA,2,47,26,21,3
VERACRUZ DE IGNACIO DE LA LLAVE,30,TLAQUILPA,184,LOMATIPA,2,34,14,20,2
VERACRUZ DE IGNACIO DE LA LLAVE,30,TLAQUILPA,184,OCOTITLA,2,25,13,12,2
VERACRUZ DE IGNACIO DE LA LLAVE,30,TLAQUILPA,184,PITZCUAUTLA,4,259,143,116,16
VERACRUZ DE IGNACIO DE LA LLAVE,30,TLAQUILPA,184,QUETZALTÓTOTL,2,47,24,23,4
VERACRUZ DE IGNACIO DE LA LLAVE,30,TLAQUILPA,184,TENEXCALCO,2,48,30,18,3
VERACRUZ DE IGNACIO DE LA LLAVE,30,TLAQUILPA,184,TEPEPA,2,40,22,18,2
VERACRUZ DE IGNACIO DE LA LLAVE,30,TLAQUILPA,184,TLALTENANGO,2,181,92,89,9
VERACRUZ DE IGNACIO DE LA LLAVE,30,TLAQUILPA,184,TLAQUETZALTITLA,2,99,49,50,8
VERACRUZ DE IGNACIO DE LA LLAVE,30,TLAQUILPA,184,TLAQUILPA,6,763,392,371,33
VERACRUZ DE IGNACIO DE LA LLAVE,30,TLAQUILPA,184,TLETLISTAKA,2,22,9,13,3
VERACRUZ DE IGNACIO DE LA LLAVE,30,TLAQUILPA,184,VISTA HERMOSA,2,69,34,35,3
VERACRUZ DE IGNACIO DE LA LLAVE,30,TLILAPAN,185,TLILAPAN,5,882,408,474,45
VERACRUZ DE IGNACIO DE LA LLAVE,30,TLILAPAN,185,TONALIXCO,3,296,154,142,17
VERACRUZ DE IGNACIO DE LA LLAVE,30,TLILAPAN,185,XOCHITITLA,1,19,3,16,1
VERACRUZ DE IGNACIO DE LA LLAVE,30,TOMATLÁN,186,CRUZ VERDE,2,42,18,24,2
VERACRUZ DE IGNACIO DE LA LLAVE,30,TOMATLÁN,186,SAN MARTÍN,2,15,8,7,2
VERACRUZ DE IGNACIO DE LA LLAVE,30,TOMATLÁN,186,TECAMA,4,400,203,197,19
VERACRUZ DE IGNACIO DE LA LLAVE,30,TOMATLÁN,186,TECAMILLA,2,108,49,59,7
VERACRUZ DE IGNACIO DE LA LLAVE,30,TOMATLÁN,186,TECOLOTLA,1,5,4,1,1
VERACRUZ DE IGNACIO DE LA LLAVE,30,TOMATLÁN,186,TOMATLÁN,5,800,363,437,48
VERACRUZ DE IGNACIO DE LA LLAVE,30,TONAYÁN,187,ASTILLERO,1,6,4,2,1
VERACRUZ DE IGNACIO DE LA LLAVE,30,TONAYÁN,187,BARRIO DE SANTA CRUZ,2,44,20,24,3
VERACRUZ DE IGNACIO DE LA LLAVE,30,TONAYÁN,187,BARRIO DE SANTIAGO,1,26,10,16,2
VERACRUZ DE IGNACIO DE LA LLAVE,30,TONAYÁN,187,CRUZ BLANCA,2,14,9,5,2
VERACRUZ DE IGNACIO DE LA LLAVE,30,TONAYÁN,187,CRUZ VERDE,1,26,7,19,1
VERACRUZ DE IGNACIO DE LA LLAVE,30,TONAYÁN,187,DOS POCITOS,2,44,26,18,3
VERACRUZ DE IGNACIO DE LA LLAVE,30,TONAYÁN,187,IXTAPAN,3,38,22,16,3
VERACRUZ DE IGNACIO DE LA LLAVE,30,TONAYÁN,187,MONTE REAL,4,228,121,107,15
VERACRUZ DE IGNACIO DE LA LLAVE,30,TONAYÁN,187,PIEDRAS GRANDES,3,154,82,72,11
VERACRUZ DE IGNACIO DE LA LLAVE,30,TONAYÁN,187,PUENTEZUELOS,3,204,111,93,11
VERACRUZ DE IGNACIO DE LA LLAVE,30,TONAYÁN,187,TEJOCOTAL,1,31,15,16,2
VERACRUZ DE IGNACIO DE LA LLAVE,30,TONAYÁN,187,TONAYÁN,4,466,251,215,27
VERACRUZ DE IGNACIO DE LA LLAVE,30,TONAYÁN,187,ZACATAL,3,179,85,94,10
VERACRUZ DE IGNACIO DE LA LLAVE,30,TOTUTLA,188,CALCAHUALCO,4,141,70,71,10
VERACRUZ DE IGNACIO DE LA LLAVE,30,TOTUTLA,188,CHACHAXTLA,2,28,16,12,3
VERACRUZ DE IGNACIO DE LA LLAVE,30,TOTUTLA,188,COLONIA PROGRESO,2,61,26,35,3
VERACRUZ DE IGNACIO DE LA LLAVE,30,TOTUTLA,188,COSOLAPA,2,56,26,30,3
VERACRUZ DE IGNACIO DE LA LLAVE,30,TOTUTLA,188,EL CAPRICHO,1,11,5,6,2
VERACRUZ DE IGNACIO DE LA LLAVE,30,TOTUTLA,188,EL ENCINAL,2,42,21,21,3
VERACRUZ DE IGNACIO DE LA LLAVE,30,TOTUTLA,188,EL MIRADOR,2,23,14,9,2
VERACRUZ DE IGNACIO DE LA LLAVE,30,TOTUTLA,188,EL RETIRO,3,72,38,34,6
VERACRUZ DE IGNACIO DE LA LLAVE,30,TOTUTLA,188,EL SANTUARIO (BARRIO NUEVO),2,50,22,28,4
VERACRUZ DE IGNACIO DE LA LLAVE,30,TOTUTLA,188,MATA DE INDIO,3,236,125,111,15
VERACRUZ DE IGNACIO DE LA LLAVE,30,TOTUTLA,188,MATA OBSCURA,4,446,235,211,22
VERACRUZ DE IGNACIO DE LA LLAVE,30,TOTUTLA,188,NARANJOS,3,48,23,25,3
VERACRUZ DE IGNACIO DE LA LLAVE,30,TOTUTLA,188,NAVATEPEC,2,20,13,7,3
VERACRUZ DE IGNACIO DE LA LLAVE,30,TOTUTLA,188,OTEAPA (CALZADA AL RÍO),1,6,2,4,1
VERACRUZ DE IGNACIO DE LA LLAVE,30,TOTUTLA,188,PALMARITOS,2,28,14,14,2
VERACRUZ DE IGNACIO DE LA LLAVE,30,TOTUTLA,188,PALMAS,2,35,15,20,2
VERACRUZ DE IGNACIO DE LA LLAVE,30,TOTUTLA,188,RINCÓN DE CALCAHUALCO,1,24,11,13,1
VERACRUZ DE IGNACIO DE LA LLAVE,30,TOTUTLA,188,TECOMATLA,2,66,39,27,5
VERACRUZ DE IGNACIO DE LA LLAVE,30,TOTUTLA,188,TEPETLAPA,1,21,10,11,2
VERACRUZ DE IGNACIO DE LA LLAVE,30,TOTUTLA,188,TLACUATZINTLA,1,17,9,8,1
VERACRUZ DE IGNACIO DE LA LLAVE,30,TOTUTLA,188,TLAPALA,4,347,171,176,19
VERACRUZ DE IGNACIO DE LA LLAVE,30,TOTUTLA,188,TOTOLAPA (CRUZ VERDE),2,57,30,27,4
VERACRUZ DE IGNACIO DE LA LLAVE,30,TOTUTLA,188,TOTUTLA,7,1093,565,528,52
VERACRUZ DE IGNACIO DE LA LLAVE,30,TOTUTLA,188,ZAPOTITLA,3,156,79,77,11
VERACRUZ DE IGNACIO DE LA LLAVE,30,TUXPAN,189,AIRE LIBRE (KILÓMETRO 15),4,291,145,146,15
VERACRUZ DE IGNACIO DE LA LLAVE,30,TUXPAN,189,ALTAMIRA,2,18,11,7,3
VERACRUZ DE IGNACIO DE LA LLAVE,30,TUXPAN,189,ALTO DE SAN LORENZO,1,11,4,7,1
VERACRUZ DE IGNACIO DE LA LLAVE,30,TUXPAN,189,ALTO LUCERO,9,861,440,421,55
VERACRUZ DE IGNACIO DE LA LLAVE,30,TUXPAN,189,BALTAZAR,1,21,11,10,1
VERACRUZ DE IGNACIO DE LA LLAVE,30,TUXPAN,189,BANCO DEL CALICHAR,2,18,9,9,2
VERACRUZ DE IGNACIO DE LA LLAVE,30,TUXPAN,189,BANDERAS,4,387,184,203,17
VERACRUZ DE IGNACIO DE LA LLAVE,30,TUXPAN,189,BARRA DE GALINDO,3,24,10,14,3
VERACRUZ DE IGNACIO DE LA LLAVE,30,TUXPAN,189,BARRA NORTE,3,132,54,78,9
VERACRUZ DE IGNACIO DE LA LLAVE,30,TUXPAN,189,BOCA DEL MONTE,2,25,12,13,3
VERACRUZ DE IGNACIO DE LA LLAVE,30,TUXPAN,189,BUENA VISTA,1,7,4,3,1
VERACRUZ DE IGNACIO DE LA LLAVE,30,TUXPAN,189,BUENOS AIRES,4,286,145,141,16
VERACRUZ DE IGNACIO DE LA LLAVE,30,TUXPAN,189,CAÑADA RICA,4,248,124,124,17
VERACRUZ DE IGNACIO DE LA LLAVE,30,TUXPAN,189,CEIBA RICA,3,62,30,32,8
VERACRUZ DE IGNACIO DE LA LLAVE,30,TUXPAN,189,CHACOACO,2,54,31,23,6
VERACRUZ DE IGNACIO DE LA LLAVE,30,TUXPAN,189,CHALAHUITE,3,67,34,33,6
VERACRUZ DE IGNACIO DE LA LLAVE,30,TUXPAN,189,CHICONCOA,2,34,13,21,3
VERACRUZ DE IGNACIO DE LA LLAVE,30,TUXPAN,189,CHOMOTLA,1,7,2,5,1
VERACRUZ DE IGNACIO DE LA LLAVE,30,TUXPAN,189,COBOS,2,89,43,46,8
VERACRUZ DE IGNACIO DE LA LLAVE,30,TUXPAN,189,COLONIA CHIJOLAR,3,66,32,34,5
VERACRUZ DE IGNACIO DE LA LLAVE,30,TUXPAN,189,COLONIA MÉXICO LINDO,1,16,7,9,1
VERACRUZ DE IGNACIO DE LA LLAVE,30,TUXPAN,189,COLONIA REVOLUCIONARIA VERACRUZANA (FIDEL HERRERA BELTRÁN),2,12,7,5,2
VERACRUZ DE IGNACIO DE LA LLAVE,30,TUXPAN,189,COMEJÉN,1,12,4,8,2
VERACRUZ DE IGNACIO DE LA LLAVE,30,TUXPAN,189,CRUZ NARANJOS,2,73,37,36,6
VERACRUZ DE IGNACIO DE LA LLAVE,30,TUXPAN,189,EJIDO LA CALZADA,5,951,439,512,117
VERACRUZ DE IGNACIO DE LA LLAVE,30,TUXPAN,189,EL COYOL,2,20,7,13,2
VERACRUZ DE IGNACIO DE LA LLAVE,30,TUXPAN,189,EL EDÉN,3,46,19,27,4
VERACRUZ DE IGNACIO DE LA LLAVE,30,TUXPAN,189,EL ESFUERZO,1,12,6,6,1
VERACRUZ DE IGNACIO DE LA LLAVE,30,TUXPAN,189,EL JOBO,3,66,39,27,6
VERACRUZ DE IGNACIO DE LA LLAVE,30,TUXPAN,189,EL LINDERO,3,66,32,34,7
VERACRUZ DE IGNACIO DE LA LLAVE,30,TUXPAN,189,EL MURO,2,35,21,14,4
VERACRUZ DE IGNACIO DE LA LLAVE,30,TUXPAN,189,EL PARAÍSO,1,7,3,4,1
VERACRUZ DE IGNACIO DE LA LLAVE,30,TUXPAN,189,EL PROGRESO (CABELLAL),1,3,2,1,1
VERACRUZ DE IGNACIO DE LA LLAVE,30,TUXPAN,189,EL SALTO,1,6,3,3,1
VERACRUZ DE IGNACIO DE LA LLAVE,30,TUXPAN,189,EL SALTO DE LA REFORMA,3,51,27,24,6
VERACRUZ DE IGNACIO DE LA LLAVE,30,TUXPAN,189,EMILIANO ZAPATA,1,133,71,62,10
VERACRUZ DE IGNACIO DE LA LLAVE,30,TUXPAN,189,FRANCISCO I. MADERO,2,46,22,24,3
VERACRUZ DE IGNACIO DE LA LLAVE,30,TUXPAN,189,FRIJOLILLO,4,102,51,51,7
VERACRUZ DE IGNACIO DE LA LLAVE,30,TUXPAN,189,HÉROE DE NACOZARI (ARROYO DE SAN LORENZO),3,18,11,7,3
VERACRUZ DE IGNACIO DE LA LLAVE,30,TUXPAN,189,HÉROES DE CHAPULTEPEC (EL TAMARINDO),2,37,17,20,3
VERACRUZ DE IGNACIO DE LA LLAVE,30,TUXPAN,189,HIGO DE LA ESPERANZA,2,34,18,16,3
VERACRUZ DE IGNACIO DE LA LLAVE,30,TUXPAN,189,HIGUERAL,3,63,32,31,7
VERACRUZ DE IGNACIO DE LA LLAVE,30,TUXPAN,189,JUANA MOZA,6,194,87,107,19
VERACRUZ DE IGNACIO DE LA LLAVE,30,TUXPAN,189,LA ARGENTINA,1,48,25,23,4
VERACRUZ DE IGNACIO DE LA LLAVE,30,TUXPAN,189,LA CAMELIA,2,32,13,19,3
VERACRUZ DE IGNACIO DE LA LLAVE,30,TUXPAN,189,LA JOYA,2,29,14,15,3
VERACRUZ DE IGNACIO DE LA LLAVE,30,TUXPAN,189,LA LAJA DE COLOMAN,4,114,61,53,9
VERACRUZ DE IGNACIO DE LA LLAVE,30,TUXPAN,189,LA LAJA DE ZAPOTE BUENO,2,38,18,20,3
VERACRUZ DE IGNACIO DE LA LLAVE,30,TUXPAN,189,LA UNIÓN,2,54,29,25,4
VERACRUZ DE IGNACIO DE LA LLAVE,30,TUXPAN,189,LA VICTORIA (LA PEÑITA),3,181,95,86,12
VERACRUZ DE IGNACIO DE LA LLAVE,30,TUXPAN,189,LAJA DEL TUBO,4,120,57,63,10
VERACRUZ DE IGNACIO DE LA LLAVE,30,TUXPAN,189,LAS PASAS,4,111,63,48,10
VERACRUZ DE IGNACIO DE LA LLAVE,30,TUXPAN,189,LINDA VISTA,3,38,14,24,4
VERACRUZ DE IGNACIO DE LA LLAVE,30,TUXPAN,189,LOMA ALTA,2,26,8,18,3
VERACRUZ DE IGNACIO DE LA LLAVE,30,TUXPAN,189,LOS MANGOS,1,36,14,22,3
VERACRUZ DE IGNACIO DE LA LLAVE,30,TUXPAN,189,MACUILTÉPETL,2,36,19,17,3
VERACRUZ DE IGNACIO DE LA LLAVE,30,TUXPAN,189,MIRAMAR (LA ANTIGUA),2,34,17,17,3
VERACRUZ DE IGNACIO DE LA LLAVE,30,TUXPAN,189,MONTE GRANDE,2,56,34,22,4
VERACRUZ DE IGNACIO DE LA LLAVE,30,TUXPAN,189,MONTE MORELOS,1,15,8,7,2
VERACRUZ DE IGNACIO DE LA LLAVE,30,TUXPAN,189,MONTES DE ARMENIA,3,81,29,52,8
VERACRUZ DE IGNACIO DE LA LLAVE,30,TUXPAN,189,NALÚA,3,54,31,23,4
VERACRUZ DE IGNACIO DE LA LLAVE,30,TUXPAN,189,NUEVA ESPERANZA,2,78,36,42,5
VERACRUZ DE IGNACIO DE LA LLAVE,30,TUXPAN,189,OJITE RANCHO NUEVO,4,220,115,105,13
VERACRUZ DE IGNACIO DE LA LLAVE,30,TUXPAN,189,OTATAL,2,46,16,30,3
VERACRUZ DE IGNACIO DE LA LLAVE,30,TUXPAN,189,PAÍSES BAJOS (KILÓMETRO 8),4,149,77,72,14
VERACRUZ DE IGNACIO DE LA LLAVE,30,TUXPAN,189,PALMA DE MORELOS,1,4,1,3,1
VERACRUZ DE IGNACIO DE LA LLAVE,30,TUXPAN,189,PEÑA ALTA,2,39,21,18,3
VERACRUZ DE IGNACIO DE LA LLAVE,30,TUXPAN,189,PEÑA DE AFUERA,4,129,71,58,9
VERACRUZ DE IGNACIO DE LA LLAVE,30,TUXPAN,189,PLAYA EMILIANO ZAPATA,2,22,10,12,2
VERACRUZ DE IGNACIO DE LA LLAVE,30,TUXPAN,189,PRAXEDIS GUERRERO (KILÓMETRO 18),3,258,138,120,23
VERACRUZ DE IGNACIO DE LA LLAVE,30,TUXPAN,189,PUENTE DON DIEGO,2,118,58,60,7
VERACRUZ DE IGNACIO DE LA LLAVE,30,TUXPAN,189,SABANILLAS,1,20,6,14,1
VERACRUZ DE IGNACIO DE LA LLAVE,30,TUXPAN,189,SAN ANTONIO,2,19,7,12,2
VERACRUZ DE IGNACIO DE LA LLAVE,30,TUXPAN,189,SAN FERNANDO,2,276,148,128,17
VERACRUZ DE IGNACIO DE LA LLAVE,30,TUXPAN,189,SAN JOSÉ EL GRANDE,4,139,67,72,8
VERACRUZ DE IGNACIO DE LA LLAVE,30,TUXPAN,189,SANTIAGO DE LA PEÑA,12,1670,826,844,106
VERACRUZ DE IGNACIO DE LA LLAVE,30,TUXPAN,189,TAMPIQUILLO,2,69,30,39,4
VERACRUZ DE IGNACIO DE LA LLAVE,30,TUXPAN,189,TEBANCO,2,31,17,14,3
VERACRUZ DE IGNACIO DE LA LLAVE,30,TUXPAN,189,TIERRA BLANCA,4,307,150,157,17
VERACRUZ DE IGNACIO DE LA LLAVE,30,TUXPAN,189,TRONCONAL DE HERRERA BELTRÁN,2,7,5,2,3
VERACRUZ DE IGNACIO DE LA LLAVE,30,TUXPAN,189,TÚXPAM DE RODRÍGUEZ CANO,182,24150,12417,11733,1929
VERACRUZ DE IGNACIO DE LA LLAVE,30,TUXPAN,189,VILLA MAR CHILE FRÍO,3,44,16,28,4
VERACRUZ DE IGNACIO DE LA LLAVE,30,TUXPAN,189,ZAPOTAL ZARAGOZA,2,24,10,14,3
VERACRUZ DE IGNACIO DE LA LLAVE,30,TUXPAN,189,ZAPOTALILLO,1,4,4,0,1
VERACRUZ DE IGNACIO DE LA LLAVE,30,TUXPAN,189,ZAPOTE DOMINGO,4,205,95,110,9
VERACRUZ DE IGNACIO DE LA LLAVE,30,TUXTILLA,190,TUXTILLA,5,426,219,207,24
VERACRUZ DE IGNACIO DE LA LLAVE,30,URSULO GALVÁN,191,BARRA DE CHACHALACAS,3,196,85,111,17
VERACRUZ DE IGNACIO DE LA LLAVE,30,URSULO GALVÁN,191,EL ARENAL,2,104,46,58,7
VERACRUZ DE IGNACIO DE LA LLAVE,30,URSULO GALVÁN,191,EL CHALAHUITE,2,38,17,21,4
VERACRUZ DE IGNACIO DE LA LLAVE,30,URSULO GALVÁN,191,EL LIMONCITO,2,33,15,18,4
VERACRUZ DE IGNACIO DE LA LLAVE,30,URSULO GALVÁN,191,EL PARAÍSO (LA CHARCA),3,101,45,56,11
VERACRUZ DE IGNACIO DE LA LLAVE,30,URSULO GALVÁN,191,EL PORVENIR,1,8,6,2,1
VERACRUZ DE IGNACIO DE LA LLAVE,30,URSULO GALVÁN,191,EL ZAPOTITO,3,83,42,41,9
VERACRUZ DE IGNACIO DE LA LLAVE,30,URSULO GALVÁN,191,FRANCISCO I. MADERO,1,25,9,16,2
VERACRUZ DE IGNACIO DE LA LLAVE,30,URSULO GALVÁN,191,JAREROS,4,180,104,76,13
VERACRUZ DE IGNACIO DE LA LLAVE,30,URSULO GALVÁN,191,JOSÉ GUADALUPE RODRÍGUEZ (DESPOBLADO),2,107,48,59,5
VERACRUZ DE IGNACIO DE LA LLAVE,30,URSULO GALVÁN,191,LA GLORIA,5,357,166,191,39
VERACRUZ DE IGNACIO DE LA LLAVE,30,URSULO GALVÁN,191,LOMA DE SAN RAFAEL,2,39,18,21,3
VERACRUZ DE IGNACIO DE LA LLAVE,30,URSULO GALVÁN,191,MATA VERDE,1,6,3,3,1
VERACRUZ DE IGNACIO DE LA LLAVE,30,URSULO GALVÁN,191,PASO DE DOÑA JUANA,3,61,31,30,7
VERACRUZ DE IGNACIO DE LA LLAVE,30,URSULO GALVÁN,191,PLAYA DE CHACHALACAS,3,109,60,49,10
VERACRUZ DE IGNACIO DE LA LLAVE,30,URSULO GALVÁN,191,REAL DEL ORO,3,225,113,112,17
VERACRUZ DE IGNACIO DE LA LLAVE,30,URSULO GALVÁN,191,URSULO GALVÁN,14,3931,1835,2096,218
VERACRUZ DE IGNACIO DE LA LLAVE,30,URSULO GALVÁN,191,ZEMPOALA,18,1769,832,937,128
VERACRUZ DE IGNACIO DE LA LLAVE,30,VEGA DE ALATORRE,192,APARICIO,1,9,2,7,1
VERACRUZ DE IGNACIO DE LA LLAVE,30,VEGA DE ALATORRE,192,ARROYO GRANDE SEGUNDO,2,34,13,21,3
VERACRUZ DE IGNACIO DE LA LLAVE,30,VEGA DE ALATORRE,192,EL BEJUCO (ALTO CONCORDIA),2,17,7,10,3
VERACRUZ DE IGNACIO DE LA LLAVE,30,VEGA DE ALATORRE,192,EL CENTENARIO (EL TECOLOTE),2,11,5,6,2
VERACRUZ DE IGNACIO DE LA LLAVE,30,VEGA DE ALATORRE,192,EL DIAMANTE,2,70,34,36,4
VERACRUZ DE IGNACIO DE LA LLAVE,30,VEGA DE ALATORRE,192,EL FORTÍN,1,11,5,6,1
VERACRUZ DE IGNACIO DE LA LLAVE,30,VEGA DE ALATORRE,192,EL LAUREL,3,36,13,23,5
VERACRUZ DE IGNACIO DE LA LLAVE,30,VEGA DE ALATORRE,192,EL TACAHUITE,1,38,20,18,3
VERACRUZ DE IGNACIO DE LA LLAVE,30,VEGA DE ALATORRE,192,EL ZAPOTE,1,15,8,7,2
VERACRUZ DE IGNACIO DE LA LLAVE,30,VEGA DE ALATORRE,192,EMILIO CARRANZA,12,1319,647,672,108
VERACRUZ DE IGNACIO DE LA LLAVE,30,VEGA DE ALATORRE,192,JUAN MARTÍN,3,60,29,31,7
VERACRUZ DE IGNACIO DE LA LLAVE,30,VEGA DE ALATORRE,192,LA MARTINICA (ARROYO GRANDE PRIMERO),2,60,38,22,5
VERACRUZ DE IGNACIO DE LA LLAVE,30,VEGA DE ALATORRE,192,LA REFORMA,1,13,6,7,1
VERACRUZ DE IGNACIO DE LA LLAVE,30,VEGA DE ALATORRE,192,LAS HIGUERAS,3,209,92,117,12
VERACRUZ DE IGNACIO DE LA LLAVE,30,VEGA DE ALATORRE,192,LECHUGUILLAS,2,25,12,13,4
VERACRUZ DE IGNACIO DE LA LLAVE,30,VEGA DE ALATORRE,192,LOMA BONITA,1,12,7,5,1
VERACRUZ DE IGNACIO DE LA LLAVE,30,VEGA DE ALATORRE,192,LOMA BONITA (ÚRSULO GALVÁN),3,82,38,44,9
VERACRUZ DE IGNACIO DE LA LLAVE,30,VEGA DE ALATORRE,192,PALO VERDE,1,7,2,5,1
VERACRUZ DE IGNACIO DE LA LLAVE,30,VEGA DE ALATORRE,192,PASO DEL TORO,1,5,3,2,1
VERACRUZ DE IGNACIO DE LA LLAVE,30,VEGA DE ALATORRE,192,PASO VIEJO,2,19,10,9,2
VERACRUZ DE IGNACIO DE LA LLAVE,30,VEGA DE ALATORRE,192,RANCHO NUEVO,2,30,17,13,3
VERACRUZ DE IGNACIO DE LA LLAVE,30,VEGA DE ALATORRE,192,TACAHUITE VIEJO,2,376,183,193,17
VERACRUZ DE IGNACIO DE LA LLAVE,30,VEGA DE ALATORRE,192,VEGA DE ALATORRE,11,1470,747,723,104
VERACRUZ DE IGNACIO DE LA LLAVE,30,VERACRUZ,193,BAJOS DEL JOBO (PUENTE MORENO),3,298,154,144,16
VERACRUZ DE IGNACIO DE LA LLAVE,30,VERACRUZ,193,CABO VERDE,3,137,64,73,12
VERACRUZ DE IGNACIO DE LA LLAVE,30,VERACRUZ,193,COLINAS DE SANTA FE,3,520,260,260,20
VERACRUZ DE IGNACIO DE LA LLAVE,30,VERACRUZ,193,COLONIA BAHIA LIBRE,1,8,4,4,1
VERACRUZ DE IGNACIO DE LA LLAVE,30,VERACRUZ,193,COLONIA CHALCHIHUECAN,1,78,36,42,4
VERACRUZ DE IGNACIO DE LA LLAVE,30,VERACRUZ,193,COLONIA EL RENACIMIENTO,1,34,13,21,2
VERACRUZ DE IGNACIO DE LA LLAVE,30,VERACRUZ,193,DELFINO VICTORIA (SANTA FE),7,1035,509,526,81
VERACRUZ DE IGNACIO DE LA LLAVE,30,VERACRUZ,193,DOS LOMAS,4,768,383,385,28
VERACRUZ DE IGNACIO DE LA LLAVE,30,VERACRUZ,193,EL MANGUITO,1,8,3,5,1
VERACRUZ DE IGNACIO DE LA LLAVE,30,VERACRUZ,193,EL PANDO,3,120,55,65,7
VERACRUZ DE IGNACIO DE LA LLAVE,30,VERACRUZ,193,FRACCIONAMIENTO COSTA DORADA,1,151,58,93,6
VERACRUZ DE IGNACIO DE LA LLAVE,30,VERACRUZ,193,FRACCIONAMIENTO EL CAMPANARIO,1,245,126,119,9
VERACRUZ DE IGNACIO DE LA LLAVE,30,VERACRUZ,193,FRACCIONAMIENTO PASEO DE LAS PALMAS (CASAS RUBA),2,390,192,198,16
VERACRUZ DE IGNACIO DE LA LLAVE,30,VERACRUZ,193,HACIENDA LA CAPILLA DE LA PARROQUIA,3,379,182,197,16
VERACRUZ DE IGNACIO DE LA LLAVE,30,VERACRUZ,193,LAS AMAPOLAS,3,153,75,78,16
VERACRUZ DE IGNACIO DE LA LLAVE,30,VERACRUZ,193,LAS BAJADAS,11,1624,824,800,90
VERACRUZ DE IGNACIO DE LA LLAVE,30,VERACRUZ,193,LOMAS DE RÍO MEDIO CUATRO,2,211,94,117,6
VERACRUZ DE IGNACIO DE LA LLAVE,30,VERACRUZ,193,LOS CAÑOS DE SANTA RITA,1,9,5,4,1
VERACRUZ DE IGNACIO DE LA LLAVE,30,VERACRUZ,193,MATA COCUITE,4,898,438,460,31
VERACRUZ DE IGNACIO DE LA LLAVE,30,VERACRUZ,193,MATA DE PITA,9,1578,813,765,78
VERACRUZ DE IGNACIO DE LA LLAVE,30,VERACRUZ,193,PASO SAN JUAN,2,60,31,29,4
VERACRUZ DE IGNACIO DE LA LLAVE,30,VERACRUZ,193,SAN JULIÁN,3,174,77,97,12
VERACRUZ DE IGNACIO DE LA LLAVE,30,VERACRUZ,193,SANTA ELENA,1,21,10,11,1
VERACRUZ DE IGNACIO DE LA LLAVE,30,VERACRUZ,193,SANTA RITA,3,217,101,116,14
VERACRUZ DE IGNACIO DE LA LLAVE,30,VERACRUZ,193,SENTIMIENTOS DE LA NACIÓN,3,367,186,181,18
VERACRUZ DE IGNACIO DE LA LLAVE,30,VERACRUZ,193,UNIDAD ANTORCHISTA,1,337,175,162,10
VERACRUZ DE IGNACIO DE LA LLAVE,30,VERACRUZ,193,VALENTE DÍAZ,18,5046,2479,2567,203
VERACRUZ DE IGNACIO DE LA LLAVE,30,VERACRUZ,193,VARGAS,4,462,213,249,24
VERACRUZ DE IGNACIO DE LA LLAVE,30,VERACRUZ,193,VERACRUZ,732,123809,63191,60618,9932
VERACRUZ DE IGNACIO DE LA LLAVE,30,VERACRUZ,193,VILLARÍN,1,33,17,16,2
VERACRUZ DE IGNACIO DE LA LLAVE,30,VILLA ALDAMA,194,CERRO DE LEÓN,2,125,62,63,9
VERACRUZ DE IGNACIO DE LA LLAVE,30,VILLA ALDAMA,194,COLONIA BENITO JUÁREZ,3,242,122,120,14
VERACRUZ DE IGNACIO DE LA LLAVE,30,VILLA ALDAMA,194,COLONIA LIBERTAD,4,812,410,402,39
VERACRUZ DE IGNACIO DE LA LLAVE,30,VILLA ALDAMA,194,CRUZ BLANCA,5,535,272,263,30
VERACRUZ DE IGNACIO DE LA LLAVE,30,VILLA ALDAMA,194,LA SOLEDAD,1,3,2,1,1
VERACRUZ DE IGNACIO DE LA LLAVE,30,VILLA ALDAMA,194,SAN ANDRÉS BUENAVISTA,2,114,59,55,6
VERACRUZ DE IGNACIO DE LA LLAVE,30,VILLA ALDAMA,194,VILLA ALDAMA,6,1207,633,574,55
VERACRUZ DE IGNACIO DE LA LLAVE,30,XOXOCOTLA,195,CUXTEPEC,2,54,24,30,3
VERACRUZ DE IGNACIO DE LA LLAVE,30,XOXOCOTLA,195,LLANO GRANDE,3,39,15,24,3
VERACRUZ DE IGNACIO DE LA LLAVE,30,XOXOCOTLA,195,MAZITUAYA,3,94,45,49,4
VERACRUZ DE IGNACIO DE LA LLAVE,30,XOXOCOTLA,195,TECALATZOMPA,2,20,11,9,3
VERACRUZ DE IGNACIO DE LA LLAVE,30,XOXOCOTLA,195,TECUAQUE,3,25,9,16,3
VERACRUZ DE IGNACIO DE LA LLAVE,30,XOXOCOTLA,195,TENEXAPA,2,62,36,26,4
VERACRUZ DE IGNACIO DE LA LLAVE,30,XOXOCOTLA,195,TEPEYOLULCO,2,41,25,16,2
VERACRUZ DE IGNACIO DE LA LLAVE,30,XOXOCOTLA,195,TLAJCOTEPEC (AGUA LIMPIA),2,46,21,25,3
VERACRUZ DE IGNACIO DE LA LLAVE,30,XOXOCOTLA,195,TLILCALCO,3,266,141,125,13
VERACRUZ DE IGNACIO DE LA LLAVE,30,XOXOCOTLA,195,TULA,2,54,28,26,4
VERACRUZ DE IGNACIO DE LA LLAVE,30,XOXOCOTLA,195,XOXOCOTLA,4,729,353,376,34
VERACRUZ DE IGNACIO DE LA LLAVE,30,XOXOCOTLA,195,ZOLIHUA,1,10,5,5,1
VERACRUZ DE IGNACIO DE LA LLAVE,30,YANGA,196,ADOLFO LÓPEZ MATEOS (SAN JOSÉ DE ENMEDIO),3,143,71,72,10
VERACRUZ DE IGNACIO DE LA LLAVE,30,YANGA,196,EL MIRADOR,2,26,10,16,2
VERACRUZ DE IGNACIO DE LA LLAVE,30,YANGA,196,EL POCHOTE,2,31,18,13,3
VERACRUZ DE IGNACIO DE LA LLAVE,30,YANGA,196,EX-HACIENDA LA CONCEPCIÓN,3,173,76,97,12
VERACRUZ DE IGNACIO DE LA LLAVE,30,YANGA,196,GENERAL ALATRISTE (SAN JOAQUÍN),3,203,92,111,23
VERACRUZ DE IGNACIO DE LA LLAVE,30,YANGA,196,GENERAL FRANCISCO PAZ (EL POBLADO),2,59,24,35,5
VERACRUZ DE IGNACIO DE LA LLAVE,30,YANGA,196,GENERAL JUAN JOSÉ BAZ (SAN JOSÉ DEL CORRAL),3,231,113,118,15
VERACRUZ DE IGNACIO DE LA LLAVE,30,YANGA,196,LA LOMA DE GUADALUPE,2,65,26,39,6
VERACRUZ DE IGNACIO DE LA LLAVE,30,YANGA,196,LA TOTONQUERA,2,13,4,9,2
VERACRUZ DE IGNACIO DE LA LLAVE,30,YANGA,196,LOS MANGOS,1,28,16,12,2
VERACRUZ DE IGNACIO DE LA LLAVE,30,YANGA,196,PALMILLAS,5,446,232,214,27
VERACRUZ DE IGNACIO DE LA LLAVE,30,YANGA,196,SAN FRANCISCO DE LAS MESILLAS,2,82,46,36,4
VERACRUZ DE IGNACIO DE LA LLAVE,30,YANGA,196,SAN MIGUEL EL GRANDE (DOCTOR VÉRTIZ),3,38,22,16,4
VERACRUZ DE IGNACIO DE LA LLAVE,30,YANGA,196,SAN RAFAEL (LA TRANCA DEL PERRO),2,26,11,15,2
VERACRUZ DE IGNACIO DE LA LLAVE,30,YANGA,196,YANGA,8,1861,987,874,86
VERACRUZ DE IGNACIO DE LA LLAVE,30,YECUATLA,197,ARROYO DE LAS CAÑAS,2,25,14,11,2
VERACRUZ DE IGNACIO DE LA LLAVE,30,YECUATLA,197,BENITO JUÁREZ,1,6,4,2,1
VERACRUZ DE IGNACIO DE LA LLAVE,30,YECUATLA,197,COLONIA LA CEIBA (EL INGENIO),1,8,3,5,1
VERACRUZ DE IGNACIO DE LA LLAVE,30,YECUATLA,197,CRISTÓBAL HIDALGO,3,153,57,96,9
VERACRUZ DE IGNACIO DE LA LLAVE,30,YECUATLA,197,CRUZ BLANCA,1,19,10,9,2
VERACRUZ DE IGNACIO DE LA LLAVE,30,YECUATLA,197,CUAUTITLÁN DEL PARRAL,3,111,47,64,7
VERACRUZ DE IGNACIO DE LA LLAVE,30,YECUATLA,197,DOS CAMINOS,2,8,5,3,1
VERACRUZ DE IGNACIO DE LA LLAVE,30,YECUATLA,197,EL MIRADOR,2,20,12,8,3
VERACRUZ DE IGNACIO DE LA LLAVE,30,YECUATLA,197,EL OJITE,1,8,5,3,1
VERACRUZ DE IGNACIO DE LA LLAVE,30,YECUATLA,197,INDEPENDENCIA (LA INDIA),3,80,38,42,7
VERACRUZ DE IGNACIO DE LA LLAVE,30,YECUATLA,197,LA AURORA,2,29,10,19,2
VERACRUZ DE IGNACIO DE LA LLAVE,30,YECUATLA,197,LA DEFENSA,2,66,32,34,4
VERACRUZ DE IGNACIO DE LA LLAVE,30,YECUATLA,197,LA ESPERANZA,3,48,22,26,5
VERACRUZ DE IGNACIO DE LA LLAVE,30,YECUATLA,197,LA UNIÓN,3,73,32,41,7
VERACRUZ DE IGNACIO DE LA LLAVE,30,YECUATLA,197,LA VICTORIA,2,35,17,18,4
VERACRUZ DE IGNACIO DE LA LLAVE,30,YECUATLA,197,LAS LAJAS,2,15,9,6,2
VERACRUZ DE IGNACIO DE LA LLAVE,30,YECUATLA,197,LEONA VICARIO,4,183,84,99,15
VERACRUZ DE IGNACIO DE LA LLAVE,30,YECUATLA,197,LOMA DE SAN AGUSTÍN,3,25,12,13,3
VERACRUZ DE IGNACIO DE LA LLAVE,30,YECUATLA,197,LOMA DE SANTA RITA,1,11,4,7,1
VERACRUZ DE IGNACIO DE LA LLAVE,30,YECUATLA,197,LOS CAPULINES,3,18,12,6,2
VERACRUZ DE IGNACIO DE LA LLAVE,30,YECUATLA,197,MIRAMAR,1,15,7,8,1
VERACRUZ DE IGNACIO DE LA LLAVE,30,YECUATLA,197,NUEVA REFORMA,1,10,4,6,2
VERACRUZ DE IGNACIO DE LA LLAVE,30,YECUATLA,197,PAZ DE ENRÍQUEZ,2,30,15,15,3
VERACRUZ DE IGNACIO DE LA LLAVE,30,YECUATLA,197,PLAN DE ALMANZA,2,41,22,19,4
VERACRUZ DE IGNACIO DE LA LLAVE,30,YECUATLA,197,PLAN DE NARANJOS,2,9,5,4,2
VERACRUZ DE IGNACIO DE LA LLAVE,30,YECUATLA,197,PROGRESO DE JUÁREZ,3,51,30,21,5
VERACRUZ DE IGNACIO DE LA LLAVE,30,YECUATLA,197,ROCA DE ORO,2,63,35,28,4
VERACRUZ DE IGNACIO DE LA LLAVE,30,YECUATLA,197,SANTA JULIA,1,9,4,5,1
VERACRUZ DE IGNACIO DE LA LLAVE,30,YECUATLA,197,YECUATLA,9,895,446,449,58
VERACRUZ DE IGNACIO DE LA LLAVE,30,ZACUALPAN,198,AGUA DE LA GALLINA,2,12,4,8,1
VERACRUZ DE IGNACIO DE LA LLAVE,30,ZACUALPAN,198,AMPLIACIÓN DE CANALEJAS DE OTATES,2,10,8,2,2
VERACRUZ DE IGNACIO DE LA LLAVE,30,ZACUALPAN,198,ATIXTACA,4,127,59,68,8
VERACRUZ DE IGNACIO DE LA LLAVE,30,ZACUALPAN,198,CANALEJAS DE OTATES,3,112,48,64,9
VERACRUZ DE IGNACIO DE LA LLAVE,30,ZACUALPAN,198,CARRIZAL CHICO,2,47,21,26,4
VERACRUZ DE IGNACIO DE LA LLAVE,30,ZACUALPAN,198,CARRIZAL CHIFLÓN,1,18,7,11,1
VERACRUZ DE IGNACIO DE LA LLAVE,30,ZACUALPAN,198,CARRIZAL GRANDE,1,9,2,7,1
VERACRUZ DE IGNACIO DE LA LLAVE,30,ZACUALPAN,198,CERRO CHATO,3,58,26,32,4
VERACRUZ DE IGNACIO DE LA LLAVE,30,ZACUALPAN,198,EJIDO TLACHICHILQUILLO (LAS JARILLAS),1,28,17,11,3
VERACRUZ DE IGNACIO DE LA LLAVE,30,ZACUALPAN,198,EL CAPULÍN,5,46,24,22,6
VERACRUZ DE IGNACIO DE LA LLAVE,30,ZACUALPAN,198,EL COJOLITE,2,31,13,18,3
VERACRUZ DE IGNACIO DE LA LLAVE,30,ZACUALPAN,198,EL DEMANTZA,2,30,11,19,3
VERACRUZ DE IGNACIO DE LA LLAVE,30,ZACUALPAN,198,EL MADROÑO,2,25,12,13,3
VERACRUZ DE IGNACIO DE LA LLAVE,30,ZACUALPAN,198,EL TUNDO,1,4,2,2,1
VERACRUZ DE IGNACIO DE LA LLAVE,30,ZACUALPAN,198,GENERAL PRIM (SAN FRANCISCO),4,153,92,61,12
VERACRUZ DE IGNACIO DE LA LLAVE,30,ZACUALPAN,198,LA PEZMA,3,38,15,23,3
VERACRUZ DE IGNACIO DE LA LLAVE,30,ZACUALPAN,198,MONTE BUENO,2,9,3,6,2
VERACRUZ DE IGNACIO DE LA LLAVE,30,ZACUALPAN,198,PUEBLO NUEVO,3,52,26,26,4
VERACRUZ DE IGNACIO DE LA LLAVE,30,ZACUALPAN,198,PUEBLO VIEJO,1,19,11,8,2
VERACRUZ DE IGNACIO DE LA LLAVE,30,ZACUALPAN,198,PUERTO CHICO,2,19,10,9,2
VERACRUZ DE IGNACIO DE LA LLAVE,30,ZACUALPAN,198,TLACHICHILQUILLO,3,42,17,25,5
VERACRUZ DE IGNACIO DE LA LLAVE,30,ZACUALPAN,198,TZOCOHUITE,2,11,7,4,2
VERACRUZ DE IGNACIO DE LA LLAVE,30,ZACUALPAN,198,ZACUALPAN,4,410,210,200,21
VERACRUZ DE IGNACIO DE LA LLAVE,30,ZACUALPAN,198,ZACUALPILLA,2,17,8,9,2
VERACRUZ DE IGNACIO DE LA LLAVE,30,ZARAGOZA,199,CAMPO NUEVO,2,121,66,55,10
VERACRUZ DE IGNACIO DE LA LLAVE,30,ZARAGOZA,199,CASCAJAL,1,10,6,4,2
VERACRUZ DE IGNACIO DE LA LLAVE,30,ZARAGOZA,199,COLONIA MARCO ANTONIO MUÑOZ,1,28,15,13,3
VERACRUZ DE IGNACIO DE LA LLAVE,30,ZARAGOZA,199,MANGOS SALINAS,1,4,2,2,1
VERACRUZ DE IGNACIO DE LA LLAVE,30,ZARAGOZA,199,MANGOTAL,2,79,38,41,4
VERACRUZ DE IGNACIO DE LA LLAVE,30,ZARAGOZA,199,ZARAGOZA,10,2807,1385,1422,155
VERACRUZ DE IGNACIO DE LA LLAVE,30,ZENTLA,200,AGUA ESCONDIDA (EL OLVIDO),2,48,25,23,3
VERACRUZ DE IGNACIO DE LA LLAVE,30,ZENTLA,200,COLONIA MANUEL GONZÁLEZ,4,397,212,185,21
VERACRUZ DE IGNACIO DE LA LLAVE,30,ZENTLA,200,CORAZÓN DE JESÚS (PIÑA),5,119,55,64,8
VERACRUZ DE IGNACIO DE LA LLAVE,30,ZENTLA,200,COYOTEPEC,3,27,14,13,4
VERACRUZ DE IGNACIO DE LA LLAVE,30,ZENTLA,200,DOS DE ABRIL,2,25,12,13,3
VERACRUZ DE IGNACIO DE LA LLAVE,30,ZENTLA,200,DOS LUCEROS,1,13,6,7,1
VERACRUZ DE IGNACIO DE LA LLAVE,30,ZENTLA,200,EJIDO LA PIÑA (MAROMILLA),3,228,108,120,14
VERACRUZ DE IGNACIO DE LA LLAVE,30,ZENTLA,200,EL CONSUELO,1,11,6,5,1
VERACRUZ DE IGNACIO DE LA LLAVE,30,ZENTLA,200,EL HUAJE,2,39,23,16,4
VERACRUZ DE IGNACIO DE LA LLAVE,30,ZENTLA,200,EL LEÓN,2,16,8,8,2
VERACRUZ DE IGNACIO DE LA LLAVE,30,ZENTLA,200,EL OLVIDO,1,16,7,9,1
VERACRUZ DE IGNACIO DE LA LLAVE,30,ZENTLA,200,EL POCHOTE,2,42,20,22,3
VERACRUZ DE IGNACIO DE LA LLAVE,30,ZENTLA,200,LA FLOR,2,37,16,21,3
VERACRUZ DE IGNACIO DE LA LLAVE,30,ZENTLA,200,LA REPRESA,2,40,20,20,3
VERACRUZ DE IGNACIO DE LA LLAVE,30,ZENTLA,200,MAFARA,1,11,7,4,1
VERACRUZ DE IGNACIO DE LA LLAVE,30,ZENTLA,200,MAROMILLA,2,15,7,8,2
VERACRUZ DE IGNACIO DE LA LLAVE,30,ZENTLA,200,MATA COYOTE,3,38,19,19,3
VERACRUZ DE IGNACIO DE LA LLAVE,30,ZENTLA,200,MATA PASTOR,1,3,3,0,1
VERACRUZ DE IGNACIO DE LA LLAVE,30,ZENTLA,200,MATLALUCA,5,218,111,107,15
VERACRUZ DE IGNACIO DE LA LLAVE,30,ZENTLA,200,PUEBLITO DE MATLALUCA,1,133,70,63,6
VERACRUZ DE IGNACIO DE LA LLAVE,30,ZENTLA,200,PUENTECILLA,3,97,50,47,7
VERACRUZ DE IGNACIO DE LA LLAVE,30,ZENTLA,200,RINCÓN CORIA (RINCÓN TLACUACHE),1,5,1,4,1
VERACRUZ DE IGNACIO DE LA LLAVE,30,ZENTLA,200,RINCÓN MARIANO,3,66,31,35,4
VERACRUZ DE IGNACIO DE LA LLAVE,30,ZENTLA,200,RINCÓN PATIÑO,2,9,7,2,1
VERACRUZ DE IGNACIO DE LA LLAVE,30,ZENTLA,200,RINCÓN TÍO TAMAL,2,6,5,1,1
VERACRUZ DE IGNACIO DE LA LLAVE,30,ZENTLA,200,SAN MIGUEL,2,11,6,5,1
VERACRUZ DE IGNACIO DE LA LLAVE,30,ZENTLA,200,SAN RAFAEL PIÑA,3,81,50,31,6
VERACRUZ DE IGNACIO DE LA LLAVE,30,ZENTLA,200,SAN VICENTE,1,16,10,6,1
VERACRUZ DE IGNACIO DE LA LLAVE,30,ZENTLA,200,TENANZINTLA,1,7,2,5,1
VERACRUZ DE IGNACIO DE LA LLAVE,30,ZENTLA,200,ZAPOTAL,1,6,2,4,1
VERACRUZ DE IGNACIO DE LA LLAVE,30,ZENTLA,200,ZENTLA,3,213,117,96,12
VERACRUZ DE IGNACIO DE LA LLAVE,30,ZENTLA,200,ZOCAPA DEL ROSARIO,2,43,16,27,3
VERACRUZ DE IGNACIO DE LA LLAVE,30,ZONGOLICA,201,ACAHUALCO,2,21,9,12,2
VERACRUZ DE IGNACIO DE LA LLAVE,30,ZONGOLICA,201,ACONTLA,2,22,13,9,2
VERACRUZ DE IGNACIO DE LA LLAVE,30,ZONGOLICA,201,ACUAPA,3,92,50,42,7
VERACRUZ DE IGNACIO DE LA LLAVE,30,ZONGOLICA,201,ADOLFO RUIZ CORTINES,3,38,24,14,5
VERACRUZ DE IGNACIO DE LA LLAVE,30,ZONGOLICA,201,ALTA LUZ,2,29,16,13,3
VERACRUZ DE IGNACIO DE LA LLAVE,30,ZONGOLICA,201,AMATEPEC,3,90,51,39,5
VERACRUZ DE IGNACIO DE LA LLAVE,30,ZONGOLICA,201,AMEYALCO,2,8,2,6,1
VERACRUZ DE IGNACIO DE LA LLAVE,30,ZONGOLICA,201,APIXTEPEC,1,3,1,2,1
VERACRUZ DE IGNACIO DE LA LLAVE,30,ZONGOLICA,201,ATEXOXOCUAPA,3,95,48,47,6
VERACRUZ DE IGNACIO DE LA LLAVE,30,ZONGOLICA,201,ATICPAC,2,44,20,24,3
VERACRUZ DE IGNACIO DE LA LLAVE,30,ZONGOLICA,201,ATITLA CHICO,2,16,5,11,2
VERACRUZ DE IGNACIO DE LA LLAVE,30,ZONGOLICA,201,AXALPA,2,35,16,19,2
VERACRUZ DE IGNACIO DE LA LLAVE,30,ZONGOLICA,201,AYOJAPA DOS,2,35,14,21,2
VERACRUZ DE IGNACIO DE LA LLAVE,30,ZONGOLICA,201,AYOJAPA UNO,2,50,19,31,4
VERACRUZ DE IGNACIO DE LA LLAVE,30,ZONGOLICA,201,AZCUAHUTLAMANCA,2,37,14,23,3
VERACRUZ DE IGNACIO DE LA LLAVE,30,ZONGOLICA,201,BARRIO BUENA VISTA,1,6,3,3,1
VERACRUZ DE IGNACIO DE LA LLAVE,30,ZONGOLICA,201,CAÑADA RICA,2,16,9,7,2
VERACRUZ DE IGNACIO DE LA LLAVE,30,ZONGOLICA,201,CERRO CHICO,2,23,11,12,2
VERACRUZ DE IGNACIO DE LA LLAVE,30,ZONGOLICA,201,CHICOMAPA,6,369,200,169,20
VERACRUZ DE IGNACIO DE LA LLAVE,30,ZONGOLICA,201,CHOAPA,3,122,68,54,10
VERACRUZ DE IGNACIO DE LA LLAVE,30,ZONGOLICA,201,CIATIPA,2,19,7,12,2
VERACRUZ DE IGNACIO DE LA LLAVE,30,ZONGOLICA,201,CITLALAPA,2,12,8,4,1
VERACRUZ DE IGNACIO DE LA LLAVE,30,ZONGOLICA,201,COAPA PINOPA,2,80,42,38,4
VERACRUZ DE IGNACIO DE LA LLAVE,30,ZONGOLICA,201,COLONIA MODELO,1,4,3,1,1
VERACRUZ DE IGNACIO DE LA LLAVE,30,ZONGOLICA,201,COMALAPA,4,445,239,206,19
VERACRUZ DE IGNACIO DE LA LLAVE,30,ZONGOLICA,201,COMALAPA II,2,57,24,33,3
VERACRUZ DE IGNACIO DE LA LLAVE,30,ZONGOLICA,201,COTLAIXCO,3,100,51,49,8
VERACRUZ DE IGNACIO DE LA LLAVE,30,ZONGOLICA,201,COYAMETLA,2,28,18,10,2
VERACRUZ DE IGNACIO DE LA LLAVE,30,ZONGOLICA,201,CUAHUIXTLAHUAC,4,64,30,34,5
VERACRUZ DE IGNACIO DE LA LLAVE,30,ZONGOLICA,201,CUAHUTILICA,3,71,35,36,5
VERACRUZ DE IGNACIO DE LA LLAVE,30,ZONGOLICA,201,DOS CAMINOS,1,5,1,4,1
VERACRUZ DE IGNACIO DE LA LLAVE,30,ZONGOLICA,201,EJUITEPEC,2,41,17,24,3
VERACRUZ DE IGNACIO DE LA LLAVE,30,ZONGOLICA,201,EL AGUAJE CHICO,3,18,6,12,3
VERACRUZ DE IGNACIO DE LA LLAVE,30,ZONGOLICA,201,EL MIRADOR,2,29,19,10,2
VERACRUZ DE IGNACIO DE LA LLAVE,30,ZONGOLICA,201,EL PORVENIR,4,116,66,50,8
VERACRUZ DE IGNACIO DE LA LLAVE,30,ZONGOLICA,201,EMILIANO ZAPATA,2,65,39,26,4
VERACRUZ DE IGNACIO DE LA LLAVE,30,ZONGOLICA,201,EPTLA,2,16,8,8,2
VERACRUZ DE IGNACIO DE LA LLAVE,30,ZONGOLICA,201,GALINDONGA,2,23,11,12,2
VERACRUZ DE IGNACIO DE LA LLAVE,30,ZONGOLICA,201,HOSTOK,5,71,39,32,6
VERACRUZ DE IGNACIO DE LA LLAVE,30,ZONGOLICA,201,HUAXTÉCATL DOS,1,13,4,9,1
VERACRUZ DE IGNACIO DE LA LLAVE,30,ZONGOLICA,201,HUAXTÉCATL UNO,3,40,23,17,3
VERACRUZ DE IGNACIO DE LA LLAVE,30,ZONGOLICA,201,HUIXTLA,2,44,29,15,3
VERACRUZ DE IGNACIO DE LA LLAVE,30,ZONGOLICA,201,IXCOHUAPA,2,42,17,25,3
VERACRUZ DE IGNACIO DE LA LLAVE,30,ZONGOLICA,201,IXMALOYUCA,3,41,23,18,3
VERACRUZ DE IGNACIO DE LA LLAVE,30,ZONGOLICA,201,IXPALCUAHUTLA (MOXALA),4,218,116,102,11
VERACRUZ DE IGNACIO DE LA LLAVE,30,ZONGOLICA,201,IXPALUCA,4,145,69,76,11
VERACRUZ DE IGNACIO DE LA LLAVE,30,ZONGOLICA,201,LA ALIANZA,2,58,28,30,3
VERACRUZ DE IGNACIO DE LA LLAVE,30,ZONGOLICA,201,LA MOJONERA,2,53,28,25,3
VERACRUZ DE IGNACIO DE LA LLAVE,30,ZONGOLICA,201,LA PALMA,2,15,5,10,2
VERACRUZ DE IGNACIO DE LA LLAVE,30,ZONGOLICA,201,LA PILA,1,9,2,7,1
VERACRUZ DE IGNACIO DE LA LLAVE,30,ZONGOLICA,201,LA PROVIDENCIA,2,31,14,17,2
VERACRUZ DE IGNACIO DE LA LLAVE,30,ZONGOLICA,201,LAGUNA CHICA,2,28,18,10,2
VERACRUZ DE IGNACIO DE LA LLAVE,30,ZONGOLICA,201,LAGUNA IXPALUCA,2,47,31,16,3
VERACRUZ DE IGNACIO DE LA LLAVE,30,ZONGOLICA,201,LAS PALMAS,1,19,8,11,1
VERACRUZ DE IGNACIO DE LA LLAVE,30,ZONGOLICA,201,LINDA ESTRELLA,4,46,25,21,4
VERACRUZ DE IGNACIO DE LA LLAVE,30,ZONGOLICA,201,LOMA DE DOLORES,2,73,46,27,4
VERACRUZ DE IGNACIO DE LA LLAVE,30,ZONGOLICA,201,LOMA GRANDE,2,64,35,29,4
VERACRUZ DE IGNACIO DE LA LLAVE,30,ZONGOLICA,201,MACUILCA,4,117,66,51,10
VERACRUZ DE IGNACIO DE LA LLAVE,30,ZONGOLICA,201,MOCHICHINO,1,18,8,10,1
VERACRUZ DE IGNACIO DE LA LLAVE,30,ZONGOLICA,201,NACAXTLA,2,50,21,29,4
VERACRUZ DE IGNACIO DE LA LLAVE,30,ZONGOLICA,201,NEPOPOALCO,2,23,8,15,2
VERACRUZ DE IGNACIO DE LA LLAVE,30,ZONGOLICA,201,NOCHITLA,2,36,21,15,2
VERACRUZ DE IGNACIO DE LA LLAVE,30,ZONGOLICA,201,OCHITLA,2,38,25,13,3
VERACRUZ DE IGNACIO DE LA LLAVE,30,ZONGOLICA,201,OLLA CHICA,2,39,17,22,4
VERACRUZ DE IGNACIO DE LA LLAVE,30,ZONGOLICA,201,PALAPA,3,114,59,55,9
VERACRUZ DE IGNACIO DE LA LLAVE,30,ZONGOLICA,201,PALENQUE COTLAIXCO,2,49,26,23,4
VERACRUZ DE IGNACIO DE LA LLAVE,30,ZONGOLICA,201,PALMA SOLA,2,76,40,36,5
VERACRUZ DE IGNACIO DE LA LLAVE,30,ZONGOLICA,201,PARAJE AYOJAPA,1,4,1,3,1
VERACRUZ DE IGNACIO DE LA LLAVE,30,ZONGOLICA,201,PIEDRAS BLANCAS,2,46,20,26,3
VERACRUZ DE IGNACIO DE LA LLAVE,30,ZONGOLICA,201,PUENTE PORRAS,2,31,16,15,3
VERACRUZ DE IGNACIO DE LA LLAVE,30,ZONGOLICA,201,QUETZALTÓTOTL,2,53,33,20,2
VERACRUZ DE IGNACIO DE LA LLAVE,30,ZONGOLICA,201,REAL DEL MONTE,3,132,67,65,11
VERACRUZ DE IGNACIO DE LA LLAVE,30,ZONGOLICA,201,SAN ANTONIO,2,39,22,17,3
VERACRUZ DE IGNACIO DE LA LLAVE,30,ZONGOLICA,201,SAN FRANCISCO ATITLA,2,41,18,23,3
VERACRUZ DE IGNACIO DE LA LLAVE,30,ZONGOLICA,201,SAN GERÓNIMO TONACALCO,1,4,3,1,1
VERACRUZ DE IGNACIO DE LA LLAVE,30,ZONGOLICA,201,SAN ISIDRO,3,54,32,22,4
VERACRUZ DE IGNACIO DE LA LLAVE,30,ZONGOLICA,201,SAN ISIDRO (APANGA),1,4,2,2,1
VERACRUZ DE IGNACIO DE LA LLAVE,30,ZONGOLICA,201,SAN JOSÉ CHININIAPAN,2,26,11,15,3
VERACRUZ DE IGNACIO DE LA LLAVE,30,ZONGOLICA,201,SAN JOSÉ INDEPENDENCIA,4,236,117,119,17
VERACRUZ DE IGNACIO DE LA LLAVE,30,ZONGOLICA,201,SAN SEBASTIÁN,4,136,73,63,9
VERACRUZ DE IGNACIO DE LA LLAVE,30,ZONGOLICA,201,TECOPANGO (CHAHUILERA),2,49,28,21,3
VERACRUZ DE IGNACIO DE LA LLAVE,30,ZONGOLICA,201,TECOXCO,2,65,28,37,4
VERACRUZ DE IGNACIO DE LA LLAVE,30,ZONGOLICA,201,TEHUILANGO,1,21,10,11,1
VERACRUZ DE IGNACIO DE LA LLAVE,30,ZONGOLICA,201,TEMAXCALAPA,4,606,342,264,34
VERACRUZ DE IGNACIO DE LA LLAVE,30,ZONGOLICA,201,TEMAXCALAPA CHICO,2,8,5,3,1
VERACRUZ DE IGNACIO DE LA LLAVE,30,ZONGOLICA,201,TEOCOTLA,2,29,19,10,2
VERACRUZ DE IGNACIO DE LA LLAVE,30,ZONGOLICA,201,TEPANTÍCPAC,2,135,75,60,7
VERACRUZ DE IGNACIO DE LA LLAVE,30,ZONGOLICA,201,TEPECUITLAPA,4,66,31,35,5
VERACRUZ DE IGNACIO DE LA LLAVE,30,ZONGOLICA,201,TEPENACAXTLA,3,153,82,71,10
VERACRUZ DE IGNACIO DE LA LLAVE,30,ZONGOLICA,201,TEPEPA I,2,23,14,9,2
VERACRUZ DE IGNACIO DE LA LLAVE,30,ZONGOLICA,201,TEPEPA II,2,26,11,15,2
VERACRUZ DE IGNACIO DE LA LLAVE,30,ZONGOLICA,201,TEPETITLANAPA,3,3524,1855,1669,113
VERACRUZ DE IGNACIO DE LA LLAVE,30,ZONGOLICA,201,TEPETLAMPA,5,158,75,83,10
VERACRUZ DE IGNACIO DE LA LLAVE,30,ZONGOLICA,201,TEPETLIXPA,1,10,3,7,1
VERACRUZ DE IGNACIO DE LA LLAVE,30,ZONGOLICA,201,TETLAPANGA,2,17,7,10,2
VERACRUZ DE IGNACIO DE LA LLAVE,30,ZONGOLICA,201,TEZIZAPA,2,51,28,23,3
VERACRUZ DE IGNACIO DE LA LLAVE,30,ZONGOLICA,201,TLACUILOLA,2,54,29,25,3
VERACRUZ DE IGNACIO DE LA LLAVE,30,ZONGOLICA,201,TLACUILOLTECATL CENTRO,1,9,4,5,1
VERACRUZ DE IGNACIO DE LA LLAVE,30,ZONGOLICA,201,TLACUILOLTÉCATL CHICO (NOGALES),3,150,78,72,6
VERACRUZ DE IGNACIO DE LA LLAVE,30,ZONGOLICA,201,TLACUILOLTÉCATL GRANDE,2,18,8,10,2
VERACRUZ DE IGNACIO DE LA LLAVE,30,ZONGOLICA,201,TLACUITLAPA CHICO,2,46,23,23,3
VERACRUZ DE IGNACIO DE LA LLAVE,30,ZONGOLICA,201,TLACUITLAPA GRANDE,2,25,10,15,2
VERACRUZ DE IGNACIO DE LA LLAVE,30,ZONGOLICA,201,TLAIXCO,2,89,46,43,4
VERACRUZ DE IGNACIO DE LA LLAVE,30,ZONGOLICA,201,TLANECPAQUILA,4,243,136,107,13
VERACRUZ DE IGNACIO DE LA LLAVE,30,ZONGOLICA,201,TONALIXCO CHICO,1,3,1,2,1
VERACRUZ DE IGNACIO DE LA LLAVE,30,ZONGOLICA,201,TONALIXCO GRANDE,3,31,16,15,3
VERACRUZ DE IGNACIO DE LA LLAVE,30,ZONGOLICA,201,TONALIXCO PRIMERO,2,13,4,9,2
VERACRUZ DE IGNACIO DE LA LLAVE,30,ZONGOLICA,201,TOTOLACATLA,4,224,115,109,12
VERACRUZ DE IGNACIO DE LA LLAVE,30,ZONGOLICA,201,TOTOMOCHAPA,2,33,17,16,3
VERACRUZ DE IGNACIO DE LA LLAVE,30,ZONGOLICA,201,VICENTE GUERRERO,2,50,30,20,4
VERACRUZ DE IGNACIO DE LA LLAVE,30,ZONGOLICA,201,XOCHIOJCA,4,213,113,100,11
VERACRUZ DE IGNACIO DE LA LLAVE,30,ZONGOLICA,201,XOCHIOTEPEC,2,58,29,29,4
VERACRUZ DE IGNACIO DE LA LLAVE,30,ZONGOLICA,201,XONAMANCA,2,72,25,47,5
VERACRUZ DE IGNACIO DE LA LLAVE,30,ZONGOLICA,201,YOLOXOCHIO,3,90,53,37,5
VERACRUZ DE IGNACIO DE LA LLAVE,30,ZONGOLICA,201,YOLOXOCHITITLA,2,13,9,4,2
VERACRUZ DE IGNACIO DE LA LLAVE,30,ZONGOLICA,201,ZACATAL CHICO,2,48,25,23,3
VERACRUZ DE IGNACIO DE LA LLAVE,30,ZONGOLICA,201,ZACATAL GRANDE,2,49,28,21,3
VERACRUZ DE IGNACIO DE LA LLAVE,30,ZONGOLICA,201,ZAPALTÉCATL,3,72,32,40,4
VERACRUZ DE IGNACIO DE LA LLAVE,30,ZONGOLICA,201,ZOMAJAPA,4,119,55,64,9
VERACRUZ DE IGNACIO DE LA LLAVE,30,ZONGOLICA,201,ZONGOLICA,12,2748,1472,1276,136
VERACRUZ DE IGNACIO DE LA LLAVE,30,ZONTECOMATLÁN DE LÓPEZ Y FUENTES,202,ACOXCONTITLA,2,38,17,21,4
VERACRUZ DE IGNACIO DE LA LLAVE,30,ZONTECOMATLÁN DE LÓPEZ Y FUENTES,202,AGUA FRÍA,2,38,19,19,3
VERACRUZ DE IGNACIO DE LA LLAVE,30,ZONTECOMATLÁN DE LÓPEZ Y FUENTES,202,AGUA HEDIONDA,2,38,19,19,3
VERACRUZ DE IGNACIO DE LA LLAVE,30,ZONTECOMATLÁN DE LÓPEZ Y FUENTES,202,ALAGUACO,1,6,4,2,2
VERACRUZ DE IGNACIO DE LA LLAVE,30,ZONTECOMATLÁN DE LÓPEZ Y FUENTES,202,CABALLETE,2,33,11,22,3
VERACRUZ DE IGNACIO DE LA LLAVE,30,ZONTECOMATLÁN DE LÓPEZ Y FUENTES,202,CRUZTITLÁN,2,38,22,16,3
VERACRUZ DE IGNACIO DE LA LLAVE,30,ZONTECOMATLÁN DE LÓPEZ Y FUENTES,202,CUATECOMACO,4,338,174,164,19
VERACRUZ DE IGNACIO DE LA LLAVE,30,ZONTECOMATLÁN DE LÓPEZ Y FUENTES,202,EL CUAYO,2,130,62,68,10
VERACRUZ DE IGNACIO DE LA LLAVE,30,ZONTECOMATLÁN DE LÓPEZ Y FUENTES,202,EL CUAYO (LA ESPERANZA),2,91,43,48,6
VERACRUZ DE IGNACIO DE LA LLAVE,30,ZONTECOMATLÁN DE LÓPEZ Y FUENTES,202,EL MAMEY,2,92,40,52,10
VERACRUZ DE IGNACIO DE LA LLAVE,30,ZONTECOMATLÁN DE LÓPEZ Y FUENTES,202,EL MIRADOR,2,14,7,7,2
VERACRUZ DE IGNACIO DE LA LLAVE,30,ZONTECOMATLÁN DE LÓPEZ Y FUENTES,202,EL OJITAL,2,12,7,5,2
VERACRUZ DE IGNACIO DE LA LLAVE,30,ZONTECOMATLÁN DE LÓPEZ Y FUENTES,202,EL PARTIDERO,3,54,25,29,3
VERACRUZ DE IGNACIO DE LA LLAVE,30,ZONTECOMATLÁN DE LÓPEZ Y FUENTES,202,EL PROGRESO,2,22,12,10,3
VERACRUZ DE IGNACIO DE LA LLAVE,30,ZONTECOMATLÁN DE LÓPEZ Y FUENTES,202,EL PUENTE,3,152,68,84,11
VERACRUZ DE IGNACIO DE LA LLAVE,30,ZONTECOMATLÁN DE LÓPEZ Y FUENTES,202,EL RINCÓN,2,18,8,10,2
VERACRUZ DE IGNACIO DE LA LLAVE,30,ZONTECOMATLÁN DE LÓPEZ Y FUENTES,202,HUEYTLAMAYA,1,10,3,7,1
VERACRUZ DE IGNACIO DE LA LLAVE,30,ZONTECOMATLÁN DE LÓPEZ Y FUENTES,202,JOSÉ MARÍA PINO SUÁREZ,3,149,67,82,10
VERACRUZ DE IGNACIO DE LA LLAVE,30,ZONTECOMATLÁN DE LÓPEZ Y FUENTES,202,LA CANDELARIA,2,114,58,56,8
VERACRUZ DE IGNACIO DE LA LLAVE,30,ZONTECOMATLÁN DE LÓPEZ Y FUENTES,202,LIMONTITLA,4,178,77,101,12
VERACRUZ DE IGNACIO DE LA LLAVE,30,ZONTECOMATLÁN DE LÓPEZ Y FUENTES,202,LOS NARANJOS,2,12,5,7,2
VERACRUZ DE IGNACIO DE LA LLAVE,30,ZONTECOMATLÁN DE LÓPEZ Y FUENTES,202,MOLOXLA,2,15,6,9,2
VERACRUZ DE IGNACIO DE LA LLAVE,30,ZONTECOMATLÁN DE LÓPEZ Y FUENTES,202,OSTOTENO,2,20,11,9,2
VERACRUZ DE IGNACIO DE LA LLAVE,30,ZONTECOMATLÁN DE LÓPEZ Y FUENTES,202,OTLATZINTLA,3,136,64,72,12
VERACRUZ DE IGNACIO DE LA LLAVE,30,ZONTECOMATLÁN DE LÓPEZ Y FUENTES,202,PACHITLA,2,60,30,30,3
VERACRUZ DE IGNACIO DE LA LLAVE,30,ZONTECOMATLÁN DE LÓPEZ Y FUENTES,202,PAHUATLA,1,4,4,0,1
VERACRUZ DE IGNACIO DE LA LLAVE,30,ZONTECOMATLÁN DE LÓPEZ Y FUENTES,202,PAPALOCUATLA,3,57,28,29,5
VERACRUZ DE IGNACIO DE LA LLAVE,30,ZONTECOMATLÁN DE LÓPEZ Y FUENTES,202,POCHOCO,2,35,22,13,3
VERACRUZ DE IGNACIO DE LA LLAVE,30,ZONTECOMATLÁN DE LÓPEZ Y FUENTES,202,SANTA MARÍA LA VICTORIA,4,268,135,133,14
VERACRUZ DE IGNACIO DE LA LLAVE,30,ZONTECOMATLÁN DE LÓPEZ Y FUENTES,202,SANTIAGO ATENO,2,18,8,10,3
VERACRUZ DE IGNACIO DE LA LLAVE,30,ZONTECOMATLÁN DE LÓPEZ Y FUENTES,202,TECOMAJAPA,3,129,69,60,9
VERACRUZ DE IGNACIO DE LA LLAVE,30,ZONTECOMATLÁN DE LÓPEZ Y FUENTES,202,TECUAPA,1,27,10,17,1
VERACRUZ DE IGNACIO DE LA LLAVE,30,ZONTECOMATLÁN DE LÓPEZ Y FUENTES,202,TENAMICOYA,3,68,32,36,5
VERACRUZ DE IGNACIO DE LA LLAVE,30,ZONTECOMATLÁN DE LÓPEZ Y FUENTES,202,TENEXACO,2,55,29,26,4
VERACRUZ DE IGNACIO DE LA LLAVE,30,ZONTECOMATLÁN DE LÓPEZ Y FUENTES,202,TETLILCO,2,15,8,7,3
VERACRUZ DE IGNACIO DE LA LLAVE,30,ZONTECOMATLÁN DE LÓPEZ Y FUENTES,202,TETZACUAL,2,229,119,110,16
VERACRUZ DE IGNACIO DE LA LLAVE,30,ZONTECOMATLÁN DE LÓPEZ Y FUENTES,202,XILOTLA,2,41,24,17,3
VERACRUZ DE IGNACIO DE LA LLAVE,30,ZONTECOMATLÁN DE LÓPEZ Y FUENTES,202,ZACAMOLA,2,20,13,7,2
VERACRUZ DE IGNACIO DE LA LLAVE,30,ZONTECOMATLÁN DE LÓPEZ Y FUENTES,202,ZACAYAHUAL,1,22,6,16,1
VERACRUZ DE IGNACIO DE LA LLAVE,30,ZONTECOMATLÁN DE LÓPEZ Y FUENTES,202,ZONTECOMATLÁN DE LÓPEZ Y FUENTES,4,567,270,297,26
VERACRUZ DE IGNACIO DE LA LLAVE,30,ZOZOCOLCO DE HIDALGO,203,ACATZÁCATL,2,93,43,50,8
VERACRUZ DE IGNACIO DE LA LLAVE,30,ZOZOCOLCO DE HIDALGO,203,ANAYAL NÚMERO DOS,2,79,38,41,5
VERACRUZ DE IGNACIO DE LA LLAVE,30,ZOZOCOLCO DE HIDALGO,203,ANAYAL NÚMERO UNO,4,229,131,98,15
VERACRUZ DE IGNACIO DE LA LLAVE,30,ZOZOCOLCO DE HIDALGO,203,BUENOS AIRES,2,23,15,8,3
VERACRUZ DE IGNACIO DE LA LLAVE,30,ZOZOCOLCO DE HIDALGO,203,CAMOLATE,1,9,3,6,1
VERACRUZ DE IGNACIO DE LA LLAVE,30,ZOZOCOLCO DE HIDALGO,203,CAXUXUMAN,2,107,50,57,8
VERACRUZ DE IGNACIO DE LA LLAVE,30,ZOZOCOLCO DE HIDALGO,203,EL CALICÓN,1,27,17,10,2
VERACRUZ DE IGNACIO DE LA LLAVE,30,ZOZOCOLCO DE HIDALGO,203,EL COLÓN,2,33,14,19,3
VERACRUZ DE IGNACIO DE LA LLAVE,30,ZOZOCOLCO DE HIDALGO,203,LA HIGUERA,1,280,137,143,10
VERACRUZ DE IGNACIO DE LA LLAVE,30,ZOZOCOLCO DE HIDALGO,203,LAS BARRANCAS,1,9,6,3,1
VERACRUZ DE IGNACIO DE LA LLAVE,30,ZOZOCOLCO DE HIDALGO,203,LINDA VISTA,1,16,9,7,1
VERACRUZ DE IGNACIO DE LA LLAVE,30,ZOZOCOLCO DE HIDALGO,203,PLAN DE AYALA,2,40,21,19,4
VERACRUZ DE IGNACIO DE LA LLAVE,30,ZOZOCOLCO DE HIDALGO,203,SAN CARLOS,1,7,3,4,1
VERACRUZ DE IGNACIO DE LA LLAVE,30,ZOZOCOLCO DE HIDALGO,203,TAHUAXNI NORTE,2,113,53,60,7
VERACRUZ DE IGNACIO DE LA LLAVE,30,ZOZOCOLCO DE HIDALGO,203,TAHUAXNI SUR,2,81,38,43,6
VERACRUZ DE IGNACIO DE LA LLAVE,30,ZOZOCOLCO DE HIDALGO,203,TECUANTEPEC,4,99,48,51,8
VERACRUZ DE IGNACIO DE LA LLAVE,30,ZOZOCOLCO DE HIDALGO,203,TLALPILA,2,54,27,27,5
VERACRUZ DE IGNACIO DE LA LLAVE,30,ZOZOCOLCO DE HIDALGO,203,TRES CRUCES DOS,1,19,6,13,2
VERACRUZ DE IGNACIO DE LA LLAVE,30,ZOZOCOLCO DE HIDALGO,203,TRES CRUCES UNO,4,103,47,56,10
VERACRUZ DE IGNACIO DE LA LLAVE,30,ZOZOCOLCO DE HIDALGO,203,ZAPOTAL,4,221,103,118,14
VERACRUZ DE IGNACIO DE LA LLAVE,30,ZOZOCOLCO DE HIDALGO,203,ZOZOCOLCO DE GUERRERO,4,376,195,181,26
VERACRUZ DE IGNACIO DE LA LLAVE,30,ZOZOCOLCO DE HIDALGO,203,ZOZOCOLCO DE HIDALGO,8,1035,525,510,64
VERACRUZ DE IGNACIO DE LA LLAVE,30,AGUA DULCE,204,AGUA DULCE,48,5828,2859,2969,451
VERACRUZ DE IGNACIO DE LA LLAVE,30,AGUA DULCE,204,COLONIA GUSTAVO DÍAZ ORDAZ,1,156,85,71,8
VERACRUZ DE IGNACIO DE LA LLAVE,30,AGUA DULCE,204,CUAUHTÉMOC,1,8,4,4,1
VERACRUZ DE IGNACIO DE LA LLAVE,30,AGUA DULCE,204,EJIDO EL BURRO,4,185,77,108,13
VERACRUZ DE IGNACIO DE LA LLAVE,30,AGUA DULCE,204,EJIDO EL TORTUGUERO,1,10,2,8,1
VERACRUZ DE IGNACIO DE LA LLAVE,30,AGUA DULCE,204,EJIDO LOS SOLDADOS,2,29,13,16,4
VERACRUZ DE IGNACIO DE LA LLAVE,30,AGUA DULCE,204,EJIDO PIEDRAS NEGRAS,3,208,91,117,10
VERACRUZ DE IGNACIO DE LA LLAVE,30,AGUA DULCE,204,EL CEDRAL,1,30,10,20,2
VERACRUZ DE IGNACIO DE LA LLAVE,30,AGUA DULCE,204,EL COROZAL,1,10,6,4,1
VERACRUZ DE IGNACIO DE LA LLAVE,30,AGUA DULCE,204,EL ENCANTO (EJIDO EL ENCANTO PESQUERO),4,260,152,108,13
VERACRUZ DE IGNACIO DE LA LLAVE,30,AGUA DULCE,204,EL MUELLE (GAVILÁN NORTE),4,433,199,234,25
VERACRUZ DE IGNACIO DE LA LLAVE,30,AGUA DULCE,204,GUSTAVO DÍAZ ORDAZ,1,41,20,21,4
VERACRUZ DE IGNACIO DE LA LLAVE,30,AGUA DULCE,204,INGENIERO MARIO HERNÁNDEZ POSADA,2,36,14,22,4
VERACRUZ DE IGNACIO DE LA LLAVE,30,AGUA DULCE,204,LA ARENA,3,103,46,57,7
VERACRUZ DE IGNACIO DE LA LLAVE,30,AGUA DULCE,204,LOS MANANTIALES,4,179,99,80,14
VERACRUZ DE IGNACIO DE LA LLAVE,30,AGUA DULCE,204,MIGUEL ALEMÁN VALDÉS (COLONIA AGRÍCOLA GANADERA),1,52,24,28,5
VERACRUZ DE IGNACIO DE LA LLAVE,30,AGUA DULCE,204,PUNTA GORDA,2,20,12,8,2
VERACRUZ DE IGNACIO DE LA LLAVE,30,AGUA DULCE,204,TONALÁ,3,260,118,142,19
VERACRUZ DE IGNACIO DE LA LLAVE,30,EL HIGO,205,BELLAVISTA (PALMIRA),3,90,47,43,10
VERACRUZ DE IGNACIO DE LA LLAVE,30,EL HIGO,205,CUVE DE BADEAS,1,18,8,10,1
VERACRUZ DE IGNACIO DE LA LLAVE,30,EL HIGO,205,CUVE DE LA VEGA DEL PASO,3,125,64,61,8
VERACRUZ DE IGNACIO DE LA LLAVE,30,EL HIGO,205,CUVE DE LOS MARCOS,2,55,24,31,3
VERACRUZ DE IGNACIO DE LA LLAVE,30,EL HIGO,205,EJIDO LOS MARCOS (ALTO EL OJITE),3,66,40,26,5
VERACRUZ DE IGNACIO DE LA LLAVE,30,EL HIGO,205,EL CHIJOLAR (LOS MARCOS),4,181,88,93,12
VERACRUZ DE IGNACIO DE LA LLAVE,30,EL HIGO,205,EL HIGO,17,2260,1138,1122,171
VERACRUZ DE IGNACIO DE LA LLAVE,30,EL HIGO,205,EL HOXTON,2,104,52,52,8
VERACRUZ DE IGNACIO DE LA LLAVE,30,EL HIGO,205,EL PALMAR PRIETO,2,55,15,40,4
VERACRUZ DE IGNACIO DE LA LLAVE,30,EL HIGO,205,EL PUEBLITO,4,389,172,217,21
VERACRUZ DE IGNACIO DE LA LLAVE,30,EL HIGO,205,EMILIANO ZAPATA,2,32,18,14,3
VERACRUZ DE IGNACIO DE LA LLAVE,30,EL HIGO,205,ESTERO GRANDE (LAS PUENTES NUEVAS),2,56,26,30,6
VERACRUZ DE IGNACIO DE LA LLAVE,30,EL HIGO,205,LA CAROLINA,2,71,31,40,5
VERACRUZ DE IGNACIO DE LA LLAVE,30,EL HIGO,205,LA Y GRIEGA,1,7,1,6,1
VERACRUZ DE IGNACIO DE LA LLAVE,30,EL HIGO,205,LAS BADEAS,4,164,87,77,13
VERACRUZ DE IGNACIO DE LA LLAVE,30,EL HIGO,205,LAS PUENTES,3,44,19,25,4
VERACRUZ DE IGNACIO DE LA LLAVE,30,EL HIGO,205,PRIMERA AMPLIACIÓN DEL CHOTE,3,207,101,106,12
VERACRUZ DE IGNACIO DE LA LLAVE,30,EL HIGO,205,RANCHO ALEGRE,3,97,47,50,9
VERACRUZ DE IGNACIO DE LA LLAVE,30,EL HIGO,205,SAN ANDRÉS,3,52,27,25,5
VERACRUZ DE IGNACIO DE LA LLAVE,30,EL HIGO,205,SEGUNDA AMPLIACIÓN DEL CHOTE,1,11,9,2,1
VERACRUZ DE IGNACIO DE LA LLAVE,30,EL HIGO,205,VEGA DE LOS MARCOS,2,42,20,22,4
VERACRUZ DE IGNACIO DE LA LLAVE,30,EL HIGO,205,VEGA DEL PASO,3,129,66,63,9
VERACRUZ DE IGNACIO DE LA LLAVE,30,NANCHITAL DE LÁZARO CÁRDENAS DEL RÍO,206,EL POLLO DE ORO,1,20,7,13,1
VERACRUZ DE IGNACIO DE LA LLAVE,30,NANCHITAL DE LÁZARO CÁRDENAS DEL RÍO,206,NANCHITAL DE LÁZARO CÁRDENAS DEL RÍO,30,6610,3105,3505,397
VERACRUZ DE IGNACIO DE LA LLAVE,30,TRES VALLES,207,CAMPO MÉXICO,1,3,2,1,1
VERACRUZ DE IGNACIO DE LA LLAVE,30,TRES VALLES,207,CAMPO NUEVO,2,34,14,20,3
VERACRUZ DE IGNACIO DE LA LLAVE,30,TRES VALLES,207,CAMPO VERACRUZ,2,32,19,13,4
VERACRUZ DE IGNACIO DE LA LLAVE,30,TRES VALLES,207,COLONIA AGRÍCOLA INDEPENDENCIA,2,49,23,26,4
VERACRUZ DE IGNACIO DE LA LLAVE,30,TRES VALLES,207,COLONIA NUEVA LA POCHOTA,2,137,81,56,8
VERACRUZ DE IGNACIO DE LA LLAVE,30,TRES VALLES,207,COLONIA NUEVA OAXACA,2,35,20,15,3
VERACRUZ DE IGNACIO DE LA LLAVE,30,TRES VALLES,207,EJIDO HUAYACÁN,1,14,10,4,1
VERACRUZ DE IGNACIO DE LA LLAVE,30,TRES VALLES,207,EL CRUCERO,2,39,18,21,4
VERACRUZ DE IGNACIO DE LA LLAVE,30,TRES VALLES,207,EL JICARAL,2,17,6,11,2
VERACRUZ DE IGNACIO DE LA LLAVE,30,TRES VALLES,207,EL NUEVO MANANTIAL,3,102,55,47,8
VERACRUZ DE IGNACIO DE LA LLAVE,30,TRES VALLES,207,EL OJOCHAL,2,20,9,11,2
VERACRUZ DE IGNACIO DE LA LLAVE,30,TRES VALLES,207,EL ZAPOTAL,2,20,10,10,2
VERACRUZ DE IGNACIO DE LA LLAVE,30,TRES VALLES,207,EMILIANO ZAPATA,2,40,19,21,3
VERACRUZ DE IGNACIO DE LA LLAVE,30,TRES VALLES,207,GENERAL ÁLVARO OBREGÓN,1,6,4,2,1
VERACRUZ DE IGNACIO DE LA LLAVE,30,TRES VALLES,207,LA ESPERANZA,2,41,21,20,3
VERACRUZ DE IGNACIO DE LA LLAVE,30,TRES VALLES,207,LA GLORIOSA,2,38,24,14,3
VERACRUZ DE IGNACIO DE LA LLAVE,30,TRES VALLES,207,LA GRANJA,4,200,100,100,15
VERACRUZ DE IGNACIO DE LA LLAVE,30,TRES VALLES,207,LA GUADALUPE,4,249,120,129,15
VERACRUZ DE IGNACIO DE LA LLAVE,30,TRES VALLES,207,LA LUZ,1,33,14,19,3
VERACRUZ DE IGNACIO DE LA LLAVE,30,TRES VALLES,207,LAGUNA VERDE,3,18,7,11,3
VERACRUZ DE IGNACIO DE LA LLAVE,30,TRES VALLES,207,LAS MARAVILLAS,1,17,6,11,1
VERACRUZ DE IGNACIO DE LA LLAVE,30,TRES VALLES,207,LAS MARGARITAS,1,19,9,10,2
VERACRUZ DE IGNACIO DE LA LLAVE,30,TRES VALLES,207,LAS MARÍAS,1,10,4,6,1
VERACRUZ DE IGNACIO DE LA LLAVE,30,TRES VALLES,207,LAS MESILLAS,2,21,11,10,3
VERACRUZ DE IGNACIO DE LA LLAVE,30,TRES VALLES,207,LAS VEGAS DE JUÁREZ,2,44,23,21,4
VERACRUZ DE IGNACIO DE LA LLAVE,30,TRES VALLES,207,LAS YAGUAS,3,214,107,107,12
VERACRUZ DE IGNACIO DE LA LLAVE,30,TRES VALLES,207,LOMA DEL CHIVO,3,13,2,11,2
VERACRUZ DE IGNACIO DE LA LLAVE,30,TRES VALLES,207,LOMA SAN JUAN,2,23,13,10,2
VERACRUZ DE IGNACIO DE LA LLAVE,30,TRES VALLES,207,LOS MACUILES,2,38,26,12,3
VERACRUZ DE IGNACIO DE LA LLAVE,30,TRES VALLES,207,LOS NARANJOS,7,929,456,473,55
VERACRUZ DE IGNACIO DE LA LLAVE,30,TRES VALLES,207,LUIS ECHEVERRÍA ÁLVAREZ,1,9,3,6,1
VERACRUZ DE IGNACIO DE LA LLAVE,30,TRES VALLES,207,MATA NARANJO,1,73,39,34,4
VERACRUZ DE IGNACIO DE LA LLAVE,30,TRES VALLES,207,NOVARA,4,133,54,79,13
VERACRUZ DE IGNACIO DE LA LLAVE,30,TRES VALLES,207,NUEVO MONDONGO,2,115,61,54,8
VERACRUZ DE IGNACIO DE LA LLAVE,30,TRES VALLES,207,NUEVO SAN JOSÉ INDEPENDENCIA,4,215,110,105,16
VERACRUZ DE IGNACIO DE LA LLAVE,30,TRES VALLES,207,PARAÍSO RÍO TONTO,4,143,72,71,9
VERACRUZ DE IGNACIO DE LA LLAVE,30,TRES VALLES,207,PASO CORRAL,2,29,16,13,3
VERACRUZ DE IGNACIO DE LA LLAVE,30,TRES VALLES,207,PLAN DE ALLENDE,2,32,11,21,4
VERACRUZ DE IGNACIO DE LA LLAVE,30,TRES VALLES,207,PLAYA DE MARGARITA,1,11,9,2,1
VERACRUZ DE IGNACIO DE LA LLAVE,30,TRES VALLES,207,POBLADO TRES,4,605,314,291,34
VERACRUZ DE IGNACIO DE LA LLAVE,30,TRES VALLES,207,SABANETA CHICA,2,29,11,18,3
VERACRUZ DE IGNACIO DE LA LLAVE,30,TRES VALLES,207,SAN ANDRÉS DE LAS YAGUAS (MALA TIERRA),1,5,4,1,1
VERACRUZ DE IGNACIO DE LA LLAVE,30,TRES VALLES,207,SAN ANTONIO (EL CHAMIZAL),2,21,10,11,3
VERACRUZ DE IGNACIO DE LA LLAVE,30,TRES VALLES,207,SAN PEDRO,1,10,3,7,1
VERACRUZ DE IGNACIO DE LA LLAVE,30,TRES VALLES,207,SANTO DOMINGO,1,11,2,9,1
VERACRUZ DE IGNACIO DE LA LLAVE,30,TRES VALLES,207,TRES VALLES,33,4269,2219,2050,390
VERACRUZ DE IGNACIO DE LA LLAVE,30,TRES VALLES,207,VISTA HERMOSA,2,35,17,18,6
VERACRUZ DE IGNACIO DE LA LLAVE,30,TRES VALLES,207,ZAPOTE COLORADO,2,45,23,22,5
VERACRUZ DE IGNACIO DE LA LLAVE,30,TRES VALLES,207,ZAPOTE PALIZADA,3,38,17,21,4
VERACRUZ DE IGNACIO DE LA LLAVE,30,TRES VALLES,207,ZAPOTE REFORMA,1,16,3,13,1
VERACRUZ DE IGNACIO DE LA LLAVE,30,CARLOS A. CARRILLO,208,AMATEPEC DE VÁZQUEZ (LOS PIONCHES),2,17,7,10,2
VERACRUZ DE IGNACIO DE LA LLAVE,30,CARLOS A. CARRILLO,208,BUENA VISTA,1,12,3,9,1
VERACRUZ DE IGNACIO DE LA LLAVE,30,CARLOS A. CARRILLO,208,CARLOS A. CARRILLO,28,3607,1823,1784,351
VERACRUZ DE IGNACIO DE LA LLAVE,30,CARLOS A. CARRILLO,208,CERRO DE TORRES UNO (SAN MARTÍN DE LA BARRANCA),2,35,15,20,3
VERACRUZ DE IGNACIO DE LA LLAVE,30,CARLOS A. CARRILLO,208,EL PALMICHAL,2,35,14,21,3
VERACRUZ DE IGNACIO DE LA LLAVE,30,CARLOS A. CARRILLO,208,GUASIMAL,4,77,39,38,8
VERACRUZ DE IGNACIO DE LA LLAVE,30,CARLOS A. CARRILLO,208,LA LOMA,1,5,3,2,1
VERACRUZ DE IGNACIO DE LA LLAVE,30,CARLOS A. CARRILLO,208,LA ZANJA DEL BAJO,2,7,3,4,2
VERACRUZ DE IGNACIO DE LA LLAVE,30,CARLOS A. CARRILLO,208,LOS COCOS,2,40,24,16,4
VERACRUZ DE IGNACIO DE LA LLAVE,30,CARLOS A. CARRILLO,208,PASO ANCHO AMATEPEC (LAGUNA AMATEPEC),4,73,37,36,8
VERACRUZ DE IGNACIO DE LA LLAVE,30,CARLOS A. CARRILLO,208,PLAYA MEDINA (MATA DE AGUA),1,7,6,1,1
VERACRUZ DE IGNACIO DE LA LLAVE,30,CARLOS A. CARRILLO,208,TILAPA,3,86,37,49,7
VERACRUZ DE IGNACIO DE LA LLAVE,30,CARLOS A. CARRILLO,208,ULUAPEÑO,2,30,18,12,3
VERACRUZ DE IGNACIO DE LA LLAVE,30,CARLOS A. CARRILLO,208,VENUSTIANO CARRANZA,2,34,18,16,3
VERACRUZ DE IGNACIO DE LA LLAVE,30,CARLOS A. CARRILLO,208,VICENTE GUERRERO,1,9,5,4,1
VERACRUZ DE IGNACIO DE LA LLAVE,30,CARLOS A. CARRILLO,208,YORCA BOCA DEL PAITE,3,52,22,30,4
VERACRUZ DE IGNACIO DE LA LLAVE,30,TATAHUICAPAN DE JUÁREZ,209,BENIGNO MENDOZA,1,7,5,2,1
VERACRUZ DE IGNACIO DE LA LLAVE,30,TATAHUICAPAN DE JUÁREZ,209,EL MIRADOR PILAPA,3,81,49,32,6
VERACRUZ DE IGNACIO DE LA LLAVE,30,TATAHUICAPAN DE JUÁREZ,209,EL VIGÍA,1,11,3,8,1
VERACRUZ DE IGNACIO DE LA LLAVE,30,TATAHUICAPAN DE JUÁREZ,209,FERNANDO LÓPEZ ARIAS,1,8,2,6,1
VERACRUZ DE IGNACIO DE LA LLAVE,30,TATAHUICAPAN DE JUÁREZ,209,GUADALUPE VICTORIA,2,33,17,16,3
VERACRUZ DE IGNACIO DE LA LLAVE,30,TATAHUICAPAN DE JUÁREZ,209,HIPÓLITO LANDERO,1,8,3,5,1
VERACRUZ DE IGNACIO DE LA LLAVE,30,TATAHUICAPAN DE JUÁREZ,209,LA VALENTINA,2,54,23,31,2
VERACRUZ DE IGNACIO DE LA LLAVE,30,TATAHUICAPAN DE JUÁREZ,209,LOS LAURELES,1,9,1,8,1
VERACRUZ DE IGNACIO DE LA LLAVE,30,TATAHUICAPAN DE JUÁREZ,209,MAGALLANES,3,69,34,35,6
VERACRUZ DE IGNACIO DE LA LLAVE,30,TATAHUICAPAN DE JUÁREZ,209,MEZCALAPA,3,119,59,60,8
VERACRUZ DE IGNACIO DE LA LLAVE,30,TATAHUICAPAN DE JUÁREZ,209,OCOTAL TEXIZAPAN,2,47,27,20,3
VERACRUZ DE IGNACIO DE LA LLAVE,30,TATAHUICAPAN DE JUÁREZ,209,PEÑA HERMOSA,2,10,6,4,1
VERACRUZ DE IGNACIO DE LA LLAVE,30,TATAHUICAPAN DE JUÁREZ,209,PIEDRA LABRADA,4,185,84,101,13
VERACRUZ DE IGNACIO DE LA LLAVE,30,TATAHUICAPAN DE JUÁREZ,209,PILAPILLO,4,91,56,35,8
VERACRUZ DE IGNACIO DE LA LLAVE,30,TATAHUICAPAN DE JUÁREZ,209,SAN FRANCISCO (AGUA FRÍA),2,63,35,28,4
VERACRUZ DE IGNACIO DE LA LLAVE,30,TATAHUICAPAN DE JUÁREZ,209,SANTANÓN RODRÍGUEZ,2,9,5,4,1
VERACRUZ DE IGNACIO DE LA LLAVE,30,TATAHUICAPAN DE JUÁREZ,209,SOCHAPA DE ÁLVARO OBREGÓN,4,150,82,68,9
VERACRUZ DE IGNACIO DE LA LLAVE,30,TATAHUICAPAN DE JUÁREZ,209,TATAHUICAPAN,15,2245,1095,1150,127
VERACRUZ DE IGNACIO DE LA LLAVE,30,TATAHUICAPAN DE JUÁREZ,209,TECUANAPA,2,60,30,30,4
VERACRUZ DE IGNACIO DE LA LLAVE,30,TATAHUICAPAN DE JUÁREZ,209,ÚRSULO GALVÁN,3,130,63,67,9
VERACRUZ DE IGNACIO DE LA LLAVE,30,TATAHUICAPAN DE JUÁREZ,209,VENUSTIANO CARRANZA,2,43,19,24,3
VERACRUZ DE IGNACIO DE LA LLAVE,30,TATAHUICAPAN DE JUÁREZ,209,ZAPOAPAN,3,53,23,30,5
VERACRUZ DE IGNACIO DE LA LLAVE,30,TATAHUICAPAN DE JUÁREZ,209,ZAPOTITLÁN,4,154,69,85,11
VERACRUZ DE IGNACIO DE LA LLAVE,30,UXPANAPA,210,ADOLFO RUIZ CORTINES,2,47,25,22,3
VERACRUZ DE IGNACIO DE LA LLAVE,30,UXPANAPA,210,AGUSTÍN MELGAR,2,60,27,33,4
VERACRUZ DE IGNACIO DE LA LLAVE,30,UXPANAPA,210,ANTONIO RODRÍGUEZ MARTÍN,2,18,6,12,2
VERACRUZ DE IGNACIO DE LA LLAVE,30,UXPANAPA,210,ARROYO ZARCO BUENA VISTA,1,37,13,24,2
VERACRUZ DE IGNACIO DE LA LLAVE,30,UXPANAPA,210,BAJO GRANDE,3,24,11,13,3
VERACRUZ DE IGNACIO DE LA LLAVE,30,UXPANAPA,210,BELISARIO DOMÍNGUEZ,2,27,15,12,3
VERACRUZ DE IGNACIO DE LA LLAVE,30,UXPANAPA,210,BENITO JUÁREZ (POBLADO UNO),4,160,72,88,9
VERACRUZ DE IGNACIO DE LA LLAVE,30,UXPANAPA,210,BENITO JUÁREZ PRIMERO (POLÍGONO NOVENTA Y SIETE),2,20,11,9,2
VERACRUZ DE IGNACIO DE LA LLAVE,30,UXPANAPA,210,BENITO JUÁREZ SEGUNDO (LA RAYA),2,47,24,23,3
VERACRUZ DE IGNACIO DE LA LLAVE,30,UXPANAPA,210,BENITO JUÁREZ V,2,96,48,48,4
VERACRUZ DE IGNACIO DE LA LLAVE,30,UXPANAPA,210,BUENA VISTA,2,20,5,15,2
VERACRUZ DE IGNACIO DE LA LLAVE,30,UXPANAPA,210,CAROLINO ANAYA UNO (POBLADO UNO),3,114,53,61,7
VERACRUZ DE IGNACIO DE LA LLAVE,30,UXPANAPA,210,CHUNIAPAN DE ARRIBA,4,240,102,138,12
VERACRUZ DE IGNACIO DE LA LLAVE,30,UXPANAPA,210,COLONIA AGRÍCOLA M.,2,7,5,2,1
VERACRUZ DE IGNACIO DE LA LLAVE,30,UXPANAPA,210,COLONIA DEL VALLE (POBLADO TRECE),2,84,44,40,3
VERACRUZ DE IGNACIO DE LA LLAVE,30,UXPANAPA,210,DOS AMATES,3,88,41,47,6
VERACRUZ DE IGNACIO DE LA LLAVE,30,UXPANAPA,210,EL ARENAL,2,19,8,11,2
VERACRUZ DE IGNACIO DE LA LLAVE,30,UXPANAPA,210,EL CARMEN,3,61,39,22,4
VERACRUZ DE IGNACIO DE LA LLAVE,30,UXPANAPA,210,EL FAISÁN,2,5,4,1,1
VERACRUZ DE IGNACIO DE LA LLAVE,30,UXPANAPA,210,EL LUCHADOR,2,7,5,2,2
VERACRUZ DE IGNACIO DE LA LLAVE,30,UXPANAPA,210,EL PROGRESO,3,50,26,24,4
VERACRUZ DE IGNACIO DE LA LLAVE,30,UXPANAPA,210,EL RINCÓN,2,19,8,11,2
VERACRUZ DE IGNACIO DE LA LLAVE,30,UXPANAPA,210,EL SABINO,3,37,11,26,4
VERACRUZ DE IGNACIO DE LA LLAVE,30,UXPANAPA,210,EMILIANO ZAPATA (ANEXO NIÑOS HÉROES),6,107,48,59,8
VERACRUZ DE IGNACIO DE LA LLAVE,30,UXPANAPA,210,ENRIQUE RODRÍGUEZ CANO,2,20,12,8,2
VERACRUZ DE IGNACIO DE LA LLAVE,30,UXPANAPA,210,ENTRADA AL POBLADO CINCO (CAMINO REAL),1,110,56,54,6
VERACRUZ DE IGNACIO DE LA LLAVE,30,UXPANAPA,210,FERNANDO LÓPEZ ARIAS,3,79,41,38,6
VERACRUZ DE IGNACIO DE LA LLAVE,30,UXPANAPA,210,FRANCISCO I. MADERO,2,29,13,16,2
VERACRUZ DE IGNACIO DE LA LLAVE,30,UXPANAPA,210,FRANCISCO VILLA DOS,2,23,14,9,2
VERACRUZ DE IGNACIO DE LA LLAVE,30,UXPANAPA,210,FRANCISCO VILLA DOS (POBLADO TRES),1,5,4,1,1
VERACRUZ DE IGNACIO DE LA LLAVE,30,UXPANAPA,210,GENERAL DE DIVISIÓN CÁNDIDO AGUILAR,2,51,24,27,4
VERACRUZ DE IGNACIO DE LA LLAVE,30,UXPANAPA,210,GENERAL VALERIO TRUJANO,3,61,26,35,4
VERACRUZ DE IGNACIO DE LA LLAVE,30,UXPANAPA,210,HELIO GARCÍA ALFARO (POBLADO ONCE),4,548,268,280,26
VERACRUZ DE IGNACIO DE LA LLAVE,30,UXPANAPA,210,HERMANOS CEDILLO (POBLADO DOS A),4,400,195,205,21
VERACRUZ DE IGNACIO DE LA LLAVE,30,UXPANAPA,210,HIDALGO AMAJAC,2,52,35,17,4
VERACRUZ DE IGNACIO DE LA LLAVE,30,UXPANAPA,210,JORGE L. TAMAYO,4,113,59,54,8
VERACRUZ DE IGNACIO DE LA LLAVE,30,UXPANAPA,210,JORGE L. TAMAYO (POBLADO DOS),1,20,12,8,1
VERACRUZ DE IGNACIO DE LA LLAVE,30,UXPANAPA,210,LA HORQUETA (POBLADO DOCE),3,343,166,177,16
VERACRUZ DE IGNACIO DE LA LLAVE,30,UXPANAPA,210,LA LAGUNA (POBLADO SEIS ALMANZA),4,532,273,259,57
VERACRUZ DE IGNACIO DE LA LLAVE,30,UXPANAPA,210,LA LAGUNA [CENTRO COMERCIAL],1,26,14,12,2
VERACRUZ DE IGNACIO DE LA LLAVE,30,UXPANAPA,210,LA NUEVA VIDA,2,34,16,18,2
VERACRUZ DE IGNACIO DE LA LLAVE,30,UXPANAPA,210,LAS CAROLINAS (POBLADO NUEVE),4,143,76,67,9
VERACRUZ DE IGNACIO DE LA LLAVE,30,UXPANAPA,210,LAS JOYAS,3,49,18,31,3
VERACRUZ DE IGNACIO DE LA LLAVE,30,UXPANAPA,210,LAS MARGARITAS,2,12,7,5,2
VERACRUZ DE IGNACIO DE LA LLAVE,30,UXPANAPA,210,LÁZARO CÁRDENAS,3,20,7,13,3
VERACRUZ DE IGNACIO DE LA LLAVE,30,UXPANAPA,210,LOMA DE ORO,1,8,3,5,1
VERACRUZ DE IGNACIO DE LA LLAVE,30,UXPANAPA,210,LOS AMARILLOS (POBLADO QUINCE),2,39,21,18,2
VERACRUZ DE IGNACIO DE LA LLAVE,30,UXPANAPA,210,LOS LIBERALES,3,68,33,35,4
VERACRUZ DE IGNACIO DE LA LLAVE,30,UXPANAPA,210,LUIS ECHEVERRÍA ÁLVAREZ,3,22,12,10,3
VERACRUZ DE IGNACIO DE LA LLAVE,30,UXPANAPA,210,MIGUEL ALEMÁN,2,20,10,10,2
VERACRUZ DE IGNACIO DE LA LLAVE,30,UXPANAPA,210,MISANTLA SEGUNDO,1,1,1,0,1
VERACRUZ DE IGNACIO DE LA LLAVE,30,UXPANAPA,210,NARCISO MENDOZA,4,119,49,70,6
VERACRUZ DE IGNACIO DE LA LLAVE,30,UXPANAPA,210,NIÑOS HÉROES (LOS JUANES),5,360,177,183,15
VERACRUZ DE IGNACIO DE LA LLAVE,30,UXPANAPA,210,NORBERTO AGUIRRE PALANCARES,2,5,2,3,1
VERACRUZ DE IGNACIO DE LA LLAVE,30,UXPANAPA,210,NUEVA ESPERANZA,2,15,8,7,2
VERACRUZ DE IGNACIO DE LA LLAVE,30,UXPANAPA,210,NUEVO ACAPULCO,2,33,17,16,2
VERACRUZ DE IGNACIO DE LA LLAVE,30,UXPANAPA,210,NUEVO CANTÓN (POBLADO SIETE),4,329,166,163,14
VERACRUZ DE IGNACIO DE LA LLAVE,30,UXPANAPA,210,NUEVO CÓRDOBA,3,21,14,7,3
VERACRUZ DE IGNACIO DE LA LLAVE,30,UXPANAPA,210,PASO DEL MORAL,2,59,30,29,5
VERACRUZ DE IGNACIO DE LA LLAVE,30,UXPANAPA,210,PLAN DE ARROYO,2,162,85,77,8
VERACRUZ DE IGNACIO DE LA LLAVE,30,UXPANAPA,210,POBLADO 10,10,1477,744,733,67
VERACRUZ DE IGNACIO DE LA LLAVE,30,UXPANAPA,210,POBLADO CINCO,4,382,199,183,16
VERACRUZ DE IGNACIO DE LA LLAVE,30,UXPANAPA,210,PRIMITIVO R. VALENCIA,3,19,9,10,3
VERACRUZ DE IGNACIO DE LA LLAVE,30,UXPANAPA,210,PROGRESO CHAPULTEPEC (LINDA ESTRELLA),2,28,14,14,2
VERACRUZ DE IGNACIO DE LA LLAVE,30,UXPANAPA,210,RAFAEL MURILLO VIDAL,2,72,40,32,4
VERACRUZ DE IGNACIO DE LA LLAVE,30,UXPANAPA,210,RANCHO LA GLORIA,1,16,9,7,1
VERACRUZ DE IGNACIO DE LA LLAVE,30,UXPANAPA,210,RÍO AZUL (LICENCIADO RAFAEL MURILLO VIDAL),1,31,16,15,1
VERACRUZ DE IGNACIO DE LA LLAVE,30,UXPANAPA,210,RÍO UXPANAPA (POBLADO CATORCE),4,544,259,285,23
VERACRUZ DE IGNACIO DE LA LLAVE,30,UXPANAPA,210,SALTABARRANCA SEGUNDO,3,34,15,19,3
VERACRUZ DE IGNACIO DE LA LLAVE,30,UXPANAPA,210,SATURNINO CEDILLO (POBLADO UNO),2,68,26,42,4
VERACRUZ DE IGNACIO DE LA LLAVE,30,UXPANAPA,210,VIDAL DÍAZ MUÑOZ,3,46,17,29,3
VERACRUZ DE IGNACIO DE LA LLAVE,30,SAN RAFAEL,211,AMPLIACIÓN MANUEL ÁVILA CAMACHO,1,9,4,5,1
VERACRUZ DE IGNACIO DE LA LLAVE,30,SAN RAFAEL,211,ARROYO ZARCO,3,251,120,131,28
VERACRUZ DE IGNACIO DE LA LLAVE,30,SAN RAFAEL,211,BELLA ESPERANZA,2,4,1,3,1
VERACRUZ DE IGNACIO DE LA LLAVE,30,SAN RAFAEL,211,BENITO JUÁREZ [NUEVO CENTRO DE POBLACIÓN],1,15,8,7,1
VERACRUZ DE IGNACIO DE LA LLAVE,30,SAN RAFAEL,211,CALLE CHICA,1,8,7,1,1
VERACRUZ DE IGNACIO DE LA LLAVE,30,SAN RAFAEL,211,CEMENTERAS DEL PITAL,3,107,42,65,9
VERACRUZ DE IGNACIO DE LA LLAVE,30,SAN RAFAEL,211,DIEZ DE ABRIL,1,8,2,6,1
VERACRUZ DE IGNACIO DE LA LLAVE,30,SAN RAFAEL,211,EJIDO VEGA DE SAN MARCOS (CUERILLO),3,86,34,52,9
VERACRUZ DE IGNACIO DE LA LLAVE,30,SAN RAFAEL,211,EL CABELLAL,3,114,47,67,6
VERACRUZ DE IGNACIO DE LA LLAVE,30,SAN RAFAEL,211,EL FAISÁN,4,185,81,104,12
VERACRUZ DE IGNACIO DE LA LLAVE,30,SAN RAFAEL,211,EL GUAYABAL,3,100,48,52,8
VERACRUZ DE IGNACIO DE LA LLAVE,30,SAN RAFAEL,211,EL OJITE,1,31,11,20,2
VERACRUZ DE IGNACIO DE LA LLAVE,30,SAN RAFAEL,211,EL PITAL,3,338,179,159,22
VERACRUZ DE IGNACIO DE LA LLAVE,30,SAN RAFAEL,211,EMILIANO ZAPATA,4,143,63,80,11
VERACRUZ DE IGNACIO DE LA LLAVE,30,SAN RAFAEL,211,GALVARINO BARRIA PÉREZ,2,163,83,80,8
VERACRUZ DE IGNACIO DE LA LLAVE,30,SAN RAFAEL,211,GUADALUPE VICTORIA,5,433,205,228,30
VERACRUZ DE IGNACIO DE LA LLAVE,30,SAN RAFAEL,211,IGNACIO ZARAGOZA (LA POZA),1,13,6,7,1
VERACRUZ DE IGNACIO DE LA LLAVE,30,SAN RAFAEL,211,ISLA SANTA ROSA,2,29,15,14,3
VERACRUZ DE IGNACIO DE LA LLAVE,30,SAN RAFAEL,211,MANUEL ÁVILA CAMACHO,4,229,105,124,14
VERACRUZ DE IGNACIO DE LA LLAVE,30,SAN RAFAEL,211,NUEVO FAISÁN,1,8,2,6,1
VERACRUZ DE IGNACIO DE LA LLAVE,30,SAN RAFAEL,211,PASO DE TELAYA,2,27,13,14,3
VERACRUZ DE IGNACIO DE LA LLAVE,30,SAN RAFAEL,211,PUNTILLA ALDAMA,5,704,347,357,39
VERACRUZ DE IGNACIO DE LA LLAVE,30,SAN RAFAEL,211,SAN RAFAEL,16,2302,1173,1129,143
VERACRUZ DE IGNACIO DE LA LLAVE,30,SAN RAFAEL,211,TEPETATES,2,105,54,51,9
VERACRUZ DE IGNACIO DE LA LLAVE,30,SAN RAFAEL,211,TRES BOCAS,2,42,22,20,3
VERACRUZ DE IGNACIO DE LA LLAVE,30,SAN RAFAEL,211,TRES ENCINOS,3,61,34,27,6
VERACRUZ DE IGNACIO DE LA LLAVE,30,SAN RAFAEL,211,ÚRSULO GALVÁN,2,29,12,17,3
VERACRUZ DE IGNACIO DE LA LLAVE,30,SAN RAFAEL,211,VEGA DE SAN MARCOS,2,60,32,28,3
VERACRUZ DE IGNACIO DE LA LLAVE,30,SAN RAFAEL,211,ZANJAS DE ARENA,3,273,127,146,15
VERACRUZ DE IGNACIO DE LA LLAVE,30,SANTIAGO SOCHIAPAN,212,ARENALITO,2,17,7,10,2
VERACRUZ DE IGNACIO DE LA LLAVE,30,SANTIAGO SOCHIAPAN,212,ARROYO COLORADO (CRUZ VERDE),3,158,82,76,11
VERACRUZ DE IGNACIO DE LA LLAVE,30,SANTIAGO SOCHIAPAN,212,ARROYO SANTA MARÍA,2,22,10,12,2
VERACRUZ DE IGNACIO DE LA LLAVE,30,SANTIAGO SOCHIAPAN,212,AUGUSTO GÓMEZ VILLANUEVA,2,12,8,4,2
VERACRUZ DE IGNACIO DE LA LLAVE,30,SANTIAGO SOCHIAPAN,212,BENITO JUÁREZ,4,103,58,45,9
VERACRUZ DE IGNACIO DE LA LLAVE,30,SANTIAGO SOCHIAPAN,212,BOCA DEL MONTE,4,215,123,92,12
VERACRUZ DE IGNACIO DE LA LLAVE,30,SANTIAGO SOCHIAPAN,212,COLONIA MIGUEL ALEMÁN,1,36,15,21,2
VERACRUZ DE IGNACIO DE LA LLAVE,30,SANTIAGO SOCHIAPAN,212,DANTE DELGADO,1,8,4,4,1
VERACRUZ DE IGNACIO DE LA LLAVE,30,SANTIAGO SOCHIAPAN,212,EJIDO REVOLUCIÓN (ARROYO DEL OLVIDO),2,17,11,6,2
VERACRUZ DE IGNACIO DE LA LLAVE,30,SANTIAGO SOCHIAPAN,212,EJIDO SERGIO VERA CERVANTES,1,31,21,10,2
VERACRUZ DE IGNACIO DE LA LLAVE,30,SANTIAGO SOCHIAPAN,212,EL NUEVO PROGRESO TATAHUICAPAN,2,83,44,39,4
VERACRUZ DE IGNACIO DE LA LLAVE,30,SANTIAGO SOCHIAPAN,212,EL PARAÍSO,1,17,9,8,1
VERACRUZ DE IGNACIO DE LA LLAVE,30,SANTIAGO SOCHIAPAN,212,EMILIANO ZAPATA,3,87,40,47,5
VERACRUZ DE IGNACIO DE LA LLAVE,30,SANTIAGO SOCHIAPAN,212,GENERAL LÁZARO CÁRDENAS,1,6,2,4,1
VERACRUZ DE IGNACIO DE LA LLAVE,30,SANTIAGO SOCHIAPAN,212,LA CEIBA NUEVA,2,49,26,23,3
VERACRUZ DE IGNACIO DE LA LLAVE,30,SANTIAGO SOCHIAPAN,212,LA LAGUNA,3,76,32,44,5
VERACRUZ DE IGNACIO DE LA LLAVE,30,SANTIAGO SOCHIAPAN,212,LA UNIÓN PROGRESO TATAHUICAPA,4,152,74,78,8
VERACRUZ DE IGNACIO DE LA LLAVE,30,SANTIAGO SOCHIAPAN,212,NIÑOS HÉROES,2,49,26,23,3
VERACRUZ DE IGNACIO DE LA LLAVE,30,SANTIAGO SOCHIAPAN,212,NUEVA BOCA DEL MONTE,1,8,2,6,1
VERACRUZ DE IGNACIO DE LA LLAVE,30,SANTIAGO SOCHIAPAN,212,PUEBLA,2,18,11,7,2
VERACRUZ DE IGNACIO DE LA LLAVE,30,SANTIAGO SOCHIAPAN,212,SAN CRISTÓBAL,2,36,18,18,2
VERACRUZ DE IGNACIO DE LA LLAVE,30,SANTIAGO SOCHIAPAN,212,SAN GABRIEL DE LA CHINANTLA,2,47,22,25,3
VERACRUZ DE IGNACIO DE LA LLAVE,30,SANTIAGO SOCHIAPAN,212,SANTA MARGARITA YOGOPI,2,64,31,33,3
VERACRUZ DE IGNACIO DE LA LLAVE,30,SANTIAGO SOCHIAPAN,212,SANTA TERESA,6,325,162,163,21
VERACRUZ DE IGNACIO DE LA LLAVE,30,SANTIAGO SOCHIAPAN,212,TATAHUICAPA,4,290,143,147,16
VERACRUZ DE IGNACIO DE LA LLAVE,30,SANTIAGO SOCHIAPAN,212,VISTA HERMOSA,1,20,9,11,2
VERACRUZ DE IGNACIO DE LA LLAVE,30,SANTIAGO SOCHIAPAN,212,XOCHIAPA,8,835,405,430,44
YUCATÁN,31,ABALÁ,001,ABALÁ,4,507,254,253,36
YUCATÁN,31,ABALÁ,001,CACAO,3,36,18,18,3
YUCATÁN,31,ABALÁ,001,MUCUYCHÉ,4,128,68,60,10
YUCATÁN,31,ABALÁ,001,PEBA,2,30,17,13,3
YUCATÁN,31,ABALÁ,001,SIHUNCHÉN,2,19,10,9,3
YUCATÁN,31,ABALÁ,001,TEMOZÓN,4,148,79,69,11
YUCATÁN,31,ABALÁ,001,UAYALCEH,5,665,380,285,28
YUCATÁN,31,ACANCEH,002,ACANCEH,14,2862,1433,1429,153
YUCATÁN,31,ACANCEH,002,CANICAB,4,214,114,100,15
YUCATÁN,31,ACANCEH,002,DZITINÁ,3,10,6,4,3
YUCATÁN,31,ACANCEH,002,PETECTUNICH,4,130,61,69,9
YUCATÁN,31,ACANCEH,002,SACCHICH,2,38,18,20,3
YUCATÁN,31,ACANCEH,002,TEPICH CARRILLO,5,186,94,92,14
YUCATÁN,31,ACANCEH,002,TICOPÓ,5,483,237,246,30
YUCATÁN,31,AKIL,003,AKIL,13,2973,1507,1466,134
YUCATÁN,31,AKIL,003,PLAN CHAC POZO TRES,2,5,4,1,1
YUCATÁN,31,AKIL,003,SAN DIEGO,1,68,31,37,3
YUCATÁN,31,BACA,004,BACA,6,1061,544,517,71
YUCATÁN,31,BACA,004,SAN ISIDRO KUXUB,2,12,5,7,2
YUCATÁN,31,BACA,004,TIXKUNCHEIL,3,137,65,72,10
YUCATÁN,31,BOKOBÁ,005,BOKOBÁ,5,414,200,214,25
YUCATÁN,31,BUCTZOTZ,006,BUCTZOTZ,8,1792,872,920,87
YUCATÁN,31,BUCTZOTZ,006,LA GRAN LUCHA,3,48,26,22,5
YUCATÁN,31,BUCTZOTZ,006,SAN FRANCISCO,3,36,18,18,4
YUCATÁN,31,BUCTZOTZ,006,SANTO DOMINGO,3,42,20,22,3
YUCATÁN,31,BUCTZOTZ,006,X-BEC,4,140,63,77,10
YUCATÁN,31,CACALCHÉN,007,CACALCHÉN,8,1513,775,738,86
YUCATÁN,31,CALOTMUL,008,CALOTMUL,7,664,331,333,46
YUCATÁN,31,CALOTMUL,008,POCOBOCH,5,254,114,140,15
YUCATÁN,31,CALOTMUL,008,TAHCABO,5,120,58,62,11
YUCATÁN,31,CANSAHCAB,009,CANSAHCAB,9,1081,556,525,85
YUCATÁN,31,CANSAHCAB,009,SAN ANTONIO XIAT,2,34,14,20,7
YUCATÁN,31,CANSAHCAB,009,SANTA MARÍA,2,7,3,4,2
YUCATÁN,31,CANTAMAYEC,010,CANTAMAYEC,5,616,306,310,32
YUCATÁN,31,CANTAMAYEC,010,CHOLUL,2,95,51,44,4
YUCATÁN,31,CANTAMAYEC,010,NENELÁ,3,96,41,55,6
YUCATÁN,31,CELESTÚN,011,CELESTÚN,7,1910,927,983,88
YUCATÁN,31,CENOTILLO,012,CENOTILLO,8,756,375,381,50
YUCATÁN,31,CENOTILLO,012,TIXBACAB,4,112,49,63,8
YUCATÁN,31,CONKAL,013,CONKAL,15,3479,1546,1933,276
YUCATÁN,31,CONKAL,013,X-CUYUM,4,459,245,214,21
YUCATÁN,31,CUNCUNUL,014,CHEBALAM,3,15,9,6,3
YUCATÁN,31,CUNCUNUL,014,CUNCUNUL,5,408,184,224,27
YUCATÁN,31,CUNCUNUL,014,SAN DIEGO,2,19,4,15,2
YUCATÁN,31,CUZAMÁ,015,CHUNKANÁN,2,58,26,32,3
YUCATÁN,31,CUZAMÁ,015,CUZAMÁ,5,1041,547,494,53
YUCATÁN,31,CUZAMÁ,015,EKNAKÁN,4,148,70,78,10
YUCATÁN,31,CUZAMÁ,015,NOHCHAKÁN,2,5,1,4,1
YUCATÁN,31,CHACSINKÍN,016,CHACSINKÍN,6,849,407,442,55
YUCATÁN,31,CHACSINKÍN,016,X-BOX,3,45,25,20,3
YUCATÁN,31,CHANKOM,017,CHANKOM,4,302,162,140,19
YUCATÁN,31,CHANKOM,017,MUCHUCUXCÁH,4,126,64,62,10
YUCATÁN,31,CHANKOM,017,NICTE-HÁ,3,17,8,9,3
YUCATÁN,31,CHANKOM,017,TICIMUL,3,172,88,84,9
YUCATÁN,31,CHANKOM,017,TZUKMUC,2,12,5,7,2
YUCATÁN,31,CHANKOM,017,XANLÁ,4,98,50,48,9
YUCATÁN,31,CHANKOM,017,X-BOHOM,2,26,7,19,2
YUCATÁN,31,CHANKOM,017,X-COCAIL,2,39,23,16,2
YUCATÁN,31,CHANKOM,017,XKALAKDZONOT,5,212,108,104,13
YUCATÁN,31,CHANKOM,017,XKATÚN,3,63,34,29,4
YUCATÁN,31,CHANKOM,017,XKOPTEIL,5,209,96,113,13
YUCATÁN,31,CHAPAB,018,CHAPAB,7,551,295,256,38
YUCATÁN,31,CHAPAB,018,CITINCABCHÉN,4,209,94,115,12
YUCATÁN,31,CHEMAX,019,BUENAVISTA,3,12,7,5,2
YUCATÁN,31,CHEMAX,019,CHECHMIL,4,224,123,101,14
YUCATÁN,31,CHEMAX,019,CHEMAX,24,4828,2333,2495,227
YUCATÁN,31,CHEMAX,019,CHOLUL,3,48,17,31,4
YUCATÁN,31,CHEMAX,019,CHULUTÁN,4,171,86,85,11
YUCATÁN,31,CHEMAX,019,COCOYOL,4,208,100,108,12
YUCATÁN,31,CHEMAX,019,ESTRELLA,3,10,7,3,2
YUCATÁN,31,CHEMAX,019,HOTEOCH,3,58,31,27,4
YUCATÁN,31,CHEMAX,019,KANTÓ,3,44,23,21,4
YUCATÁN,31,CHEMAX,019,KONSAHCAB,3,5,2,3,3
YUCATÁN,31,CHEMAX,019,KUXEB,5,281,149,132,20
YUCATÁN,31,CHEMAX,019,LA ESPERANZA,2,5,4,1,2
YUCATÁN,31,CHEMAX,019,LOL-BÉ,4,96,53,43,8
YUCATÁN,31,CHEMAX,019,MUCEL,5,341,163,178,20
YUCATÁN,31,CHEMAX,019,PABALAM,3,35,20,15,4
YUCATÁN,31,CHEMAX,019,SAN JOSÉ CHAHUAY,3,29,13,16,3
YUCATÁN,31,CHEMAX,019,SAN JUAN CHEN,4,161,87,74,11
YUCATÁN,31,CHEMAX,019,SAN PEDRO CHEMAX,3,170,76,94,11
YUCATÁN,31,CHEMAX,019,SAN ROMÁN,3,23,12,11,3
YUCATÁN,31,CHEMAX,019,SANTA CLARA,3,14,7,7,3
YUCATÁN,31,CHEMAX,019,SANTA CRUZ,3,96,46,50,5
YUCATÁN,31,CHEMAX,019,SISBICHÉN,5,665,337,328,30
YUCATÁN,31,CHEMAX,019,TULÍN,2,25,11,14,2
YUCATÁN,31,CHEMAX,019,USPIBIL,4,310,136,174,16
YUCATÁN,31,CHEMAX,019,XALAÚ (X-ALAU),6,825,423,402,37
YUCATÁN,31,CHEMAX,019,X-CAN,8,1591,770,821,64
YUCATÁN,31,CHEMAX,019,X-CATZÍN (CATZÍN),6,780,360,420,31
YUCATÁN,31,CHEMAX,019,XIM-HÁ,2,10,3,7,2
YUCATÁN,31,CHICXULUB PUEBLO,020,CHICXULUB PUEBLO,5,1174,568,606,57
YUCATÁN,31,CHICHIMILÁ,021,CELTÚN,3,65,32,33,5
YUCATÁN,31,CHICHIMILÁ,021,CHAN PICH,3,23,8,15,3
YUCATÁN,31,CHICHIMILÁ,021,CHAN X-CAIL,4,260,115,145,14
YUCATÁN,31,CHICHIMILÁ,021,CHIBILUB,2,10,3,7,1
YUCATÁN,31,CHICHIMILÁ,021,CHICHIMILÁ,9,1913,889,1024,91
YUCATÁN,31,CHICHIMILÁ,021,DZITOX,4,383,192,191,19
YUCATÁN,31,CHICHIMILÁ,021,NUEVO X-HABÍN,3,29,12,17,4
YUCATÁN,31,CHICHIMILÁ,021,SAN PEDRO,4,198,98,100,11
YUCATÁN,31,CHIKINDZONOT,022,CHAN-CHICHIMILÁ,5,114,53,61,9
YUCATÁN,31,CHIKINDZONOT,022,CHIKINDZONOT,6,969,474,495,50
YUCATÁN,31,CHIKINDZONOT,022,CHUCTEIL,2,4,1,3,2
YUCATÁN,31,CHIKINDZONOT,022,ICHMUL,4,239,126,113,15
YUCATÁN,31,CHOCHOLÁ,023,CHOCHOLÁ,7,980,469,511,59
YUCATÁN,31,CHUMAYEL,024,CHUMAYEL,7,686,367,319,47
YUCATÁN,31,DZAN,025,DZAN,7,1531,794,737,76
YUCATÁN,31,DZEMUL,026,DZEMUL,6,827,452,375,49
YUCATÁN,31,DZIDZANTÚN,027,DZIDZANTÚN,14,2366,1228,1138,184
YUCATÁN,31,DZIDZANTÚN,027,SAN FRANCISCO MANZANILLA,1,23,14,9,1
YUCATÁN,31,DZILAM DE BRAVO,028,DZILAM DE BRAVO,6,577,291,286,33
YUCATÁN,31,DZILAM DE BRAVO,028,PUEBLO NUEVO,3,27,15,12,3
YUCATÁN,31,DZILAM GONZÁLEZ,029,DZILAM GONZÁLEZ,7,1226,609,617,69
YUCATÁN,31,DZITÁS,030,DZITÁS,7,754,364,390,39
YUCATÁN,31,DZITÁS,030,XOCEMPICH,4,193,91,102,12
YUCATÁN,31,DZITÁS,030,YAXCHÉ,3,13,7,6,2
YUCATÁN,31,DZONCAUICH,031,CHACMAY,4,105,52,53,9
YUCATÁN,31,DZONCAUICH,031,DZONCAUICH,5,420,206,214,34
YUCATÁN,31,ESPITA,032,ESPITA,14,2903,1409,1494,191
YUCATÁN,31,ESPITA,032,HOLCÁ,4,138,75,63,11
YUCATÁN,31,ESPITA,032,KUNCHÉ,3,164,76,88,9
YUCATÁN,31,ESPITA,032,NACUCHÉ,5,484,241,243,30
YUCATÁN,31,ESPITA,032,SAN PEDRO CHENCHELÁ,3,49,21,28,4
YUCATÁN,31,ESPITA,032,TUZIK,4,120,48,72,10
YUCATÁN,31,ESPITA,032,X-UALTEZ,2,37,17,20,3
YUCATÁN,31,ESPITA,032,XUILUB,4,109,53,56,10
YUCATÁN,31,HALACHÓ,033,CEPEDA,6,1006,507,499,60
YUCATÁN,31,HALACHÓ,033,CUCH HOLOCH,5,605,300,305,28
YUCATÁN,31,HALACHÓ,033,DZIDZIBACHÍ,4,205,103,102,15
YUCATÁN,31,HALACHÓ,033,HALACHÓ,12,2479,1242,1237,126
YUCATÁN,31,HALACHÓ,033,KANCABCHÉN,2,104,61,43,5
YUCATÁN,31,HALACHÓ,033,SAN MATEO,4,83,40,43,8
YUCATÁN,31,HALACHÓ,033,SANTA MARÍA ACÚ,5,427,194,233,20
YUCATÁN,31,HALACHÓ,033,SIHÓ,4,384,196,188,16
YUCATÁN,31,HOCABÁ,034,HOCABÁ,6,924,455,469,98
YUCATÁN,31,HOCABÁ,034,SAHCABÁ,4,596,285,311,35
YUCATÁN,31,HOCTÚN,035,HOCTÚN,7,1207,602,605,84
YUCATÁN,31,HOCTÚN,035,SAN JOSÉ ORIENTE,4,271,132,139,15
YUCATÁN,31,HOMÚN,036,HOMÚN,7,1604,818,786,78
YUCATÁN,31,HOMÚN,036,SAN ISIDRO OCHIL,4,273,125,148,16
YUCATÁN,31,HUHÍ,037,HUHÍ,8,1054,504,550,85
YUCATÁN,31,HUNUCMÁ,038,HUNKANAB,3,132,79,53,11
YUCATÁN,31,HUNUCMÁ,038,HUNUCMÁ,30,7014,3588,3426,441
YUCATÁN,31,HUNUCMÁ,038,SAN ANTONIO CHEL,2,25,13,12,2
YUCATÁN,31,HUNUCMÁ,038,SISAL,4,386,205,181,26
YUCATÁN,31,HUNUCMÁ,038,TEXÁN DE PALOMEQUE,7,950,471,479,41
YUCATÁN,31,IXIL,039,IXIL,6,823,418,405,51
YUCATÁN,31,IZAMAL,040,CITILCUM,5,466,225,241,26
YUCATÁN,31,IZAMAL,040,CUAUHTÉMOC,2,132,61,71,7
YUCATÁN,31,IZAMAL,040,IZAMAL,25,4926,2450,2476,360
YUCATÁN,31,IZAMAL,040,KIMBILÁ,6,1051,538,513,63
YUCATÁN,31,IZAMAL,040,SITILPECH,6,483,243,240,28
YUCATÁN,31,IZAMAL,040,XANABÁ,5,366,187,179,23
YUCATÁN,31,KANASÍN,041,KANASÍN,57,17303,8616,8687,737
YUCATÁN,31,KANASÍN,041,SAN ANTONIO TEHUITZ,3,235,112,123,11
YUCATÁN,31,KANASÍN,041,TEYA,4,347,151,196,15
YUCATÁN,31,KANTUNIL,042,HOLCÁ,5,507,247,260,29
YUCATÁN,31,KANTUNIL,042,KANTUNIL,7,880,472,408,57
YUCATÁN,31,KAUA,043,DZEAL,4,173,92,81,10
YUCATÁN,31,KAUA,043,KAUA,5,836,419,417,42
YUCATÁN,31,KINCHIL,044,KINCHIL,7,1760,853,907,78
YUCATÁN,31,KINCHIL,044,TAMCHÉN,3,58,25,33,4
YUCATÁN,31,KOPOMÁ,045,KOPOMÁ,4,455,226,229,32
YUCATÁN,31,KOPOMÁ,045,SAN BERNARDO,4,101,47,54,9
YUCATÁN,31,MAMA,046,MAMA,5,740,374,366,39
YUCATÁN,31,MANÍ,047,MANÍ,7,1031,516,515,54
YUCATÁN,31,MANÍ,047,TIPIKAL,6,277,146,131,15
YUCATÁN,31,MAXCANÚ,048,CHACTÚN (SAN JOSÉ CHACTÚN),2,15,10,5,2
YUCATÁN,31,MAXCANÚ,048,CHAN CHOCHOLÁ (SANTA EDUVIGES CHAN CHOCHOLÁ),4,108,56,52,9
YUCATÁN,31,MAXCANÚ,048,CHUNCHUCMIL,6,263,122,141,16
YUCATÁN,31,MAXCANÚ,048,COAHUILA (SANTA TERESA COAHUILA),3,102,50,52,6
YUCATÁN,31,MAXCANÚ,048,GRANADA (CHICAN GRANADA),2,89,38,51,5
YUCATÁN,31,MAXCANÚ,048,KANACHÉN,2,37,16,21,5
YUCATÁN,31,MAXCANÚ,048,KOCHOL,6,449,237,212,22
YUCATÁN,31,MAXCANÚ,048,MAXCANÚ,21,3888,1900,1988,240
YUCATÁN,31,MAXCANÚ,048,PARAÍSO,4,229,133,96,12
YUCATÁN,31,MAXCANÚ,048,SAN FERNANDO,2,53,28,25,3
YUCATÁN,31,MAXCANÚ,048,SAN RAFAEL,5,441,228,213,22
YUCATÁN,31,MAXCANÚ,048,SANTA CRUZ,3,19,11,8,2
YUCATÁN,31,MAXCANÚ,048,SANTA ROSA (SANTA ROSA DE LIMA),4,208,98,110,11
YUCATÁN,31,MAXCANÚ,048,SANTO DOMINGO,4,321,158,163,15
YUCATÁN,31,MAYAPÁN,049,MAYAPÁN,6,1199,565,634,61
YUCATÁN,31,MÉRIDA,050,CAUCEL,9,2968,1431,1537,139
YUCATÁN,31,MÉRIDA,050,CHABLEKAL,27,10117,5610,4507,1264
YUCATÁN,31,MÉRIDA,050,CHALMUCH,4,177,75,102,12
YUCATÁN,31,MÉRIDA,050,CHEUMÁN,2,22,8,14,2
YUCATÁN,31,MÉRIDA,050,CHOLUL,17,1862,886,976,154
YUCATÁN,31,MÉRIDA,050,COSGAYA,2,157,68,89,8
YUCATÁN,31,MÉRIDA,050,DZIBILCHALTÚN,2,4,3,1,1
YUCATÁN,31,MÉRIDA,050,DZIDZILCHÉ,3,53,22,31,4
YUCATÁN,31,MÉRIDA,050,DZITYÁ,12,3736,1924,1812,323
YUCATÁN,31,MÉRIDA,050,DZOYAXCHÉ,3,66,32,34,6
YUCATÁN,31,MÉRIDA,050,DZUNUNCÁN,4,637,346,291,28
YUCATÁN,31,MÉRIDA,050,HUNXECTAMÁN,3,39,18,21,4
YUCATÁN,31,MÉRIDA,050,KIKTEIL,2,11,5,6,2
YUCATÁN,31,MÉRIDA,050,KOMCHÉN,6,1212,615,597,75
YUCATÁN,31,MÉRIDA,050,MÉRIDA,1250,255435,128709,126726,19313
YUCATÁN,31,MÉRIDA,050,MOLAS,4,627,318,309,37
YUCATÁN,31,MÉRIDA,050,NOC AC,2,50,24,26,4
YUCATÁN,31,MÉRIDA,050,ONCÁN,2,106,55,51,6
YUCATÁN,31,MÉRIDA,050,PETAC,2,33,19,14,2
YUCATÁN,31,MÉRIDA,050,SAC-NICTÉ,3,42,23,19,3
YUCATÁN,31,MÉRIDA,050,SAN ANTONIO HOOL,3,334,167,167,24
YUCATÁN,31,MÉRIDA,050,SAN ANTONIO TZACALÁ,4,166,73,93,11
YUCATÁN,31,MÉRIDA,050,SAN IGNACIO TESIP,2,53,19,34,3
YUCATÁN,31,MÉRIDA,050,SAN JOSÉ TZAL,5,1501,728,773,74
YUCATÁN,31,MÉRIDA,050,SAN PEDRO CHIMAY,4,382,168,214,18
YUCATÁN,31,MÉRIDA,050,SANTA CRUZ PALOMEQUE,2,208,102,106,8
YUCATÁN,31,MÉRIDA,050,SANTA MARÍA CHÍ,3,35,15,20,4
YUCATÁN,31,MÉRIDA,050,SIERRA PAPACAL,4,365,161,204,18
YUCATÁN,31,MÉRIDA,050,SITPACH,4,295,134,161,15
YUCATÁN,31,MÉRIDA,050,SUSULÁ,2,65,27,38,4
YUCATÁN,31,MÉRIDA,050,SUYTUNCHÉN,2,9,5,4,2
YUCATÁN,31,MÉRIDA,050,TAHDZIBICHÉN,2,125,57,68,7
YUCATÁN,31,MÉRIDA,050,TAMANCHÉ,2,84,46,38,4
YUCATÁN,31,MÉRIDA,050,TEMOZÓN NORTE,1,35,20,15,2
YUCATÁN,31,MÉRIDA,050,TEXÁN CÁMARA,2,112,48,64,5
YUCATÁN,31,MÉRIDA,050,TIXCACAL,3,302,150,152,11
YUCATÁN,31,MÉRIDA,050,TIXCUYTÚN,2,51,27,24,3
YUCATÁN,31,MÉRIDA,050,XCANATÚN,3,259,124,135,13
YUCATÁN,31,MÉRIDA,050,XCUNYÁ,4,164,75,89,13
YUCATÁN,31,MÉRIDA,050,XMATKUIL,4,2436,1304,1132,187
YUCATÁN,31,MÉRIDA,050,YAXCHÉ CASARES,1,12,7,5,1
YUCATÁN,31,MÉRIDA,050,YAXNIC,2,140,59,81,7
YUCATÁN,31,MOCOCHÁ,051,MOCOCHÁ,6,512,246,266,39
YUCATÁN,31,MOCOCHÁ,051,TEKAT,2,19,9,10,2
YUCATÁN,31,MOCOCHÁ,051,TOÓ,2,52,22,30,3
YUCATÁN,31,MOTUL,052,DZUNUNCÁN,1,17,8,9,2
YUCATÁN,31,MOTUL,052,KAMBUL,2,23,14,9,2
YUCATÁN,31,MOTUL,052,KANCABAL,2,60,25,35,4
YUCATÁN,31,MOTUL,052,KANCABCHÉN,2,41,21,20,3
YUCATÁN,31,MOTUL,052,KANCABCHÉN UCÍ,2,10,3,7,2
YUCATÁN,31,MOTUL,052,KAXATAH,2,205,98,107,9
YUCATÁN,31,MOTUL,052,KINÍ,4,301,152,149,21
YUCATÁN,31,MOTUL,052,KOMCHÉN MARTÍNEZ,2,16,8,8,2
YUCATÁN,31,MOTUL,052,KOPTÉ,4,161,82,79,11
YUCATÁN,31,MOTUL,052,MESATUNICH,4,211,106,105,12
YUCATÁN,31,MOTUL,052,MOTUL DE CARRILLO PUERTO,33,7286,3490,3796,511
YUCATÁN,31,MOTUL,052,SACAPUC,3,111,41,70,18
YUCATÁN,31,MOTUL,052,SAN JOSÉ HILI,2,34,21,13,3
YUCATÁN,31,MOTUL,052,SAN PEDRO CÁMARA,2,24,11,13,2
YUCATÁN,31,MOTUL,052,SAN PEDRO CHACABAL,4,254,125,129,14
YUCATÁN,31,MOTUL,052,TANYÁ,4,441,230,211,18
YUCATÁN,31,MOTUL,052,TIMUL,4,210,91,119,14
YUCATÁN,31,MOTUL,052,UCÍ,4,200,100,100,24
YUCATÁN,31,MUNA,053,MUNA,14,2712,1301,1411,152
YUCATÁN,31,MUNA,053,SAN JOSÉ TIPCEH,4,112,67,45,7
YUCATÁN,31,MUNA,053,YAXHÁ,1,12,5,7,1
YUCATÁN,31,MUXUPIP,054,MUXUPIP,4,560,280,280,35
YUCATÁN,31,MUXUPIP,054,SAN JUAN KOOP,2,38,17,21,3
YUCATÁN,31,OPICHÉN,055,CALCEHTOK,4,335,177,158,18
YUCATÁN,31,OPICHÉN,055,OPICHÉN,6,1259,638,621,67
YUCATÁN,31,OXKUTZCAB,056,BOMBAHALTÚN,3,4,1,3,2
YUCATÁN,31,OXKUTZCAB,056,CHUNHUAYMIL,3,5,3,2,2
YUCATÁN,31,OXKUTZCAB,056,EMILIANO ZAPATA,7,601,297,304,30
YUCATÁN,31,OXKUTZCAB,056,OXKUTZCAB,33,8115,3819,4296,456
YUCATÁN,31,OXKUTZCAB,056,PLAN CHAC POZO CUATRO,1,11,5,6,1
YUCATÁN,31,OXKUTZCAB,056,POTOIT,3,21,11,10,3
YUCATÁN,31,OXKUTZCAB,056,SAHCAHMUCUY,2,7,4,3,2
YUCATÁN,31,OXKUTZCAB,056,SAN ANTONIO YAAXHOM,3,15,7,8,3
YUCATÁN,31,OXKUTZCAB,056,SAN JOSÉ KUNCHÉ,2,13,6,7,2
YUCATÁN,31,OXKUTZCAB,056,X-KAKAL,2,5,2,3,2
YUCATÁN,31,OXKUTZCAB,056,X-KOBENHALTÚN,3,24,14,10,3
YUCATÁN,31,OXKUTZCAB,056,XOHUAYÁN,5,413,216,197,22
YUCATÁN,31,OXKUTZCAB,056,XUL,5,448,227,221,22
YUCATÁN,31,OXKUTZCAB,056,YAXHACHÉN,5,595,300,295,27
YUCATÁN,31,PANABÁ,057,CENOTE YALSIHÓN BUENA FE,4,156,82,74,10
YUCATÁN,31,PANABÁ,057,LOCHÉ,5,404,194,210,18
YUCATÁN,31,PANABÁ,057,PANABÁ,7,1423,702,721,109
YUCATÁN,31,PANABÁ,057,SAN FRANCISCO,3,33,15,18,4
YUCATÁN,31,PANABÁ,057,SAN JUAN DEL RÍO,3,7,2,5,2
YUCATÁN,31,PETO,058,CHAN CALOTMUL,3,15,8,7,3
YUCATÁN,31,PETO,058,DZONOTCHEL,4,91,38,53,7
YUCATÁN,31,PETO,058,JUSTICIA SOCIAL,2,43,22,21,3
YUCATÁN,31,PETO,058,KAMBUL,4,96,39,57,9
YUCATÁN,31,PETO,058,LA ESPERANZA,3,21,12,9,3
YUCATÁN,31,PETO,058,PAPACAL,4,182,100,82,10
YUCATÁN,31,PETO,058,PETO,26,6711,3179,3532,383
YUCATÁN,31,PETO,058,PETULILLO,3,27,12,15,3
YUCATÁN,31,PETO,058,PROGRESITO,5,130,63,67,10
YUCATÁN,31,PETO,058,SAN DIONISIO,3,60,26,34,4
YUCATÁN,31,PETO,058,SAN FRANCISCO DE ASÍS,3,32,10,22,3
YUCATÁN,31,PETO,058,SAN MATEO,1,4,3,1,1
YUCATÁN,31,PETO,058,SAN SEBASTIÁN,3,16,7,9,3
YUCATÁN,31,PETO,058,SAN SEBASTIÁN YAXCHÉ,3,24,12,12,3
YUCATÁN,31,PETO,058,TEMOZÓN,3,68,37,31,4
YUCATÁN,31,PETO,058,TIXHUALATÚN,5,189,85,104,10
YUCATÁN,31,PETO,058,XOY,4,175,84,91,12
YUCATÁN,31,PETO,058,X-PECHIL,2,17,7,10,2
YUCATÁN,31,PETO,058,YAXCOPIL,5,259,126,133,14
YUCATÁN,31,PROGRESO,059,CAMPESTRE FLAMBOYANES,6,1203,588,615,44
YUCATÁN,31,PROGRESO,059,CHELEM,4,675,344,331,36
YUCATÁN,31,PROGRESO,059,CHICXULUB (CHICXULUB PUERTO),5,706,309,397,32
YUCATÁN,31,PROGRESO,059,CHUBURNÁ,4,597,306,291,27
YUCATÁN,31,PROGRESO,059,EL PARAÍSO,2,67,33,34,4
YUCATÁN,31,PROGRESO,059,PROGRESO,52,11278,5466,5812,733
YUCATÁN,31,PROGRESO,059,SAN IGNACIO,4,175,89,86,10
YUCATÁN,31,QUINTANA ROO,060,QUINTANA ROO,4,277,133,144,20
YUCATÁN,31,RÍO LAGARTOS,061,LAS COLORADAS,4,365,176,189,18
YUCATÁN,31,RÍO LAGARTOS,061,RÍO LAGARTOS,4,487,258,229,33
YUCATÁN,31,SACALUM,062,PLAN CHAC,2,11,7,4,2
YUCATÁN,31,SACALUM,062,SACALUM,6,1082,537,545,62
YUCATÁN,31,SACALUM,062,SAN ANTONIO SODZIL,3,113,53,60,7
YUCATÁN,31,SACALUM,062,YUNKÚ,2,22,15,7,2
YUCATÁN,31,SAMAHIL,063,KUCHEL,4,167,82,85,13
YUCATÁN,31,SAMAHIL,063,SAMAHIL,5,815,394,421,46
YUCATÁN,31,SAMAHIL,063,SAN ANTONIO TEDZIDZ,4,263,144,119,23
YUCATÁN,31,SANAHCAT,064,SANAHCAT,5,402,194,208,27
YUCATÁN,31,SAN FELIPE,065,SAN FELIPE,4,313,152,161,21
YUCATÁN,31,SANTA ELENA,066,SAN SIMÓN,4,116,45,71,10
YUCATÁN,31,SANTA ELENA,066,SANTA ELENA,6,937,449,488,62
YUCATÁN,31,SEYÉ,067,HOLACTÚN,4,131,63,68,9
YUCATÁN,31,SEYÉ,067,SAN BERNARDINO,3,49,26,23,4
YUCATÁN,31,SEYÉ,067,SEYÉ,9,1936,965,971,98
YUCATÁN,31,SINANCHÉ,068,SAN CRISANTO,4,129,69,60,10
YUCATÁN,31,SINANCHÉ,068,SINANCHÉ,6,543,262,281,42
YUCATÁN,31,SOTUTA,069,SOTUTA,8,1451,714,737,68
YUCATÁN,31,SOTUTA,069,TABÍ,5,262,112,150,15
YUCATÁN,31,SOTUTA,069,TIBOLÓN,6,444,227,217,28
YUCATÁN,31,SOTUTA,069,ZAVALA,5,118,52,66,9
YUCATÁN,31,SUCILÁ,070,SUCILÁ,5,778,385,393,46
YUCATÁN,31,SUDZAL,071,CHUMBEC,2,66,31,35,4
YUCATÁN,31,SUDZAL,071,KANCABCHÉN DE VALENCIA,2,6,4,2,1
YUCATÁN,31,SUDZAL,071,NUEVO TZALAM,2,24,15,9,2
YUCATÁN,31,SUDZAL,071,SUDZAL,5,457,223,234,33
YUCATÁN,31,SUMA,072,SUMA,6,372,157,215,29
YUCATÁN,31,TAHDZIÚ,073,MOCTÉ,2,6,3,3,1
YUCATÁN,31,TAHDZIÚ,073,PAMBIJIB,3,11,6,5,2
YUCATÁN,31,TAHDZIÚ,073,SAN ISIDRO UNO,3,9,3,6,2
YUCATÁN,31,TAHDZIÚ,073,SAN LORENZO,3,13,3,10,3
YUCATÁN,31,TAHDZIÚ,073,SAN MIGUEL,3,7,4,3,3
YUCATÁN,31,TAHDZIÚ,073,TAHDZIÚ,6,1379,660,719,58
YUCATÁN,31,TAHDZIÚ,073,TIMUL,5,294,137,157,16
YUCATÁN,31,TAHMEK,074,TAHMEK,7,641,310,331,44
YUCATÁN,31,TEABO,075,TEABO,7,2020,991,1029,106
YUCATÁN,31,TECOH,076,CHINKILÁ,3,35,14,21,4
YUCATÁN,31,TECOH,076,ITZINCAB,2,65,30,35,4
YUCATÁN,31,TECOH,076,LEPÁN,4,296,146,150,15
YUCATÁN,31,TECOH,076,MAHZUCIL,3,80,35,45,5
YUCATÁN,31,TECOH,076,OXTAPACAB,2,37,15,22,3
YUCATÁN,31,TECOH,076,PIXYÁ,4,304,149,155,15
YUCATÁN,31,TECOH,076,SABACCHÉ,2,34,16,18,2
YUCATÁN,31,TECOH,076,SOTUTA DE PEÓN,4,120,54,66,9
YUCATÁN,31,TECOH,076,TECOH,10,2145,1050,1095,113
YUCATÁN,31,TECOH,076,TELCHAQUILLO,5,359,171,188,24
YUCATÁN,31,TECOH,076,X-KANCHAKÁN,5,494,245,249,22
YUCATÁN,31,TEKAL DE VENEGAS,077,SAN FELIPE,2,6,2,4,1
YUCATÁN,31,TEKAL DE VENEGAS,077,TEKAL DE VENEGAS,6,569,284,285,37
YUCATÁN,31,TEKANTÓ,078,SAN DIEGO,1,19,6,13,2
YUCATÁN,31,TEKANTÓ,078,SAN FRANCISCO DZÓN,3,37,16,21,4
YUCATÁN,31,TEKANTÓ,078,TEKANTÓ,5,671,323,348,36
YUCATÁN,31,TEKANTÓ,078,TIXKOCHOH,2,35,16,19,3
YUCATÁN,31,TEKAX,079,ALFONSO CASO,2,51,30,21,3
YUCATÁN,31,TEKAX,079,AYIM DOS,3,12,7,5,3
YUCATÁN,31,TEKAX,079,BECANCHÉN,6,576,288,288,23
YUCATÁN,31,TEKAX,079,BENITO JUÁREZ,4,122,68,54,9
YUCATÁN,31,TEKAX,079,CANEK,3,82,45,37,5
YUCATÁN,31,TEKAX,079,CHACMULTÚN,2,29,11,18,2
YUCATÁN,31,TEKAX,079,CHAN DZINUP,3,66,26,40,4
YUCATÁN,31,TEKAX,079,HOUITZ,3,8,5,3,2
YUCATÁN,31,TEKAX,079,HUNTOCHAC,5,85,37,48,9
YUCATÁN,31,TEKAX,079,KANCAB,6,891,439,452,39
YUCATÁN,31,TEKAX,079,KANTEMÓ,4,129,68,61,10
YUCATÁN,31,TEKAX,079,KINIL,5,352,177,175,17
YUCATÁN,31,TEKAX,079,MAC-YAN (SAN ISIDRO MAC-YAN),3,20,12,8,3
YUCATÁN,31,TEKAX,079,MANUEL CEPEDA PERAZA,4,133,66,67,9
YUCATÁN,31,TEKAX,079,NOHALAL,3,12,3,9,3
YUCATÁN,31,TEKAX,079,NUEVA SANTA CRUZ (SANTA CRUZ CUTZÁ),3,11,5,6,3
YUCATÁN,31,TEKAX,079,PENCUYUT,5,577,275,302,35
YUCATÁN,31,TEKAX,079,POCOBOCH,2,14,2,12,2
YUCATÁN,31,TEKAX,079,SAN AGUSTÍN (SALVADOR ALVARADO),3,45,24,21,3
YUCATÁN,31,TEKAX,079,SAN ANTONIO TUK,2,5,2,3,1
YUCATÁN,31,TEKAX,079,SAN DIEGO BUENAVISTA,2,13,10,3,2
YUCATÁN,31,TEKAX,079,SAN DIEGO TEKAX,1,193,101,92,24
YUCATÁN,31,TEKAX,079,SAN FELIPE SEGUNDO,2,9,5,4,2
YUCATÁN,31,TEKAX,079,SAN ISIDRO YAXCHÉ,3,12,4,8,3
YUCATÁN,31,TEKAX,079,SAN JUAN TEKAX,3,27,16,11,3
YUCATÁN,31,TEKAX,079,SAN LUIS,3,20,7,13,3
YUCATÁN,31,TEKAX,079,SAN MARCELINO,1,5,1,4,1
YUCATÁN,31,TEKAX,079,SAN MARCOS,3,55,32,23,4
YUCATÁN,31,TEKAX,079,SAN PEDRO DZULÁ,3,21,10,11,3
YUCATÁN,31,TEKAX,079,SAN SALVADOR,2,7,2,5,2
YUCATÁN,31,TEKAX,079,SUDZAL CHICO,3,37,20,17,3
YUCATÁN,31,TEKAX,079,TEKAX DE ÁLVARO OBREGÓN,34,7982,3990,3992,502
YUCATÁN,31,TEKAX,079,TICUM,3,189,96,93,10
YUCATÁN,31,TEKAX,079,TIXCUYTÚN,4,153,77,76,11
YUCATÁN,31,TEKAX,079,XAYA,5,688,356,332,29
YUCATÁN,31,TEKAX,079,YALCOBÁ NUEVO,2,5,2,3,1
YUCATÁN,31,TEKIT,080,TEKIT,8,2451,1181,1270,116
YUCATÁN,31,TEKOM,081,CHIBILUB,2,47,26,21,3
YUCATÁN,31,TEKOM,081,POCBICHÉN,2,19,12,7,2
YUCATÁN,31,TEKOM,081,TEKOM,7,735,368,367,47
YUCATÁN,31,TEKOM,081,X-COCMIL,2,6,4,2,1
YUCATÁN,31,TELCHAC PUEBLO,082,TELCHAC,7,511,276,235,39
YUCATÁN,31,TELCHAC PUERTO,083,TELCHAC PUERTO,4,546,270,276,48
YUCATÁN,31,TEMAX,084,CHENCHÉ DE LAS TORRES,4,116,59,57,9
YUCATÁN,31,TEMAX,084,SAN ANTONIO CÁMARA,3,42,19,23,4
YUCATÁN,31,TEMAX,084,TEMAX,8,1374,706,668,77
YUCATÁN,31,TEMOZÓN,085,ACTUNCOH,4,152,66,86,12
YUCATÁN,31,TEMOZÓN,085,DZALBAY,5,215,112,103,12
YUCATÁN,31,TEMOZÓN,085,EKBALAM,4,97,37,60,6
YUCATÁN,31,TEMOZÓN,085,HUNUKÚ,7,960,459,501,38
YUCATÁN,31,TEMOZÓN,085,NAHBALAM,5,589,275,314,27
YUCATÁN,31,TEMOZÓN,085,SANTA RITA,4,159,74,85,12
YUCATÁN,31,TEMOZÓN,085,TEMOZÓN,9,1901,936,965,83
YUCATÁN,31,TEMOZÓN,085,X-KANCHECHÉN,2,7,5,2,1
YUCATÁN,31,TEMOZÓN,085,X'TUT,3,58,30,28,5
YUCATÁN,31,TEMOZÓN,085,X-UCH,5,128,62,66,10
YUCATÁN,31,TEMOZÓN,085,YOKDZONOT PRESENTADO,5,160,82,78,17
YUCATÁN,31,TEPAKÁN,086,KANTIRIX,2,30,19,11,2
YUCATÁN,31,TEPAKÁN,086,TEPAKÁN,5,360,187,173,19
YUCATÁN,31,TETIZ,087,NOHUAYÚN,4,275,133,142,16
YUCATÁN,31,TETIZ,087,TETIZ,6,986,458,528,48
YUCATÁN,31,TEYA,088,TEYA,4,624,297,327,42
YUCATÁN,31,TICUL,089,PUSTUNICH,5,742,368,374,39
YUCATÁN,31,TICUL,089,TICUL,38,9830,5050,4780,553
YUCATÁN,31,TICUL,089,TICUL [UNIDAD DEL VALLE],1,9,3,6,1
YUCATÁN,31,TICUL,089,YOTHOLÍN,5,660,324,336,43
YUCATÁN,31,TIMUCUY,090,SUBINCANCAB,5,322,156,166,16
YUCATÁN,31,TIMUCUY,090,TEKIK DE REGIL,5,447,215,232,21
YUCATÁN,31,TIMUCUY,090,TIMUCUY,7,943,469,474,57
YUCATÁN,31,TINUM,091,CHENDZONOT,2,5,2,3,2
YUCATÁN,31,TINUM,091,PISTÉ DE CHICHÉN ITZÁ,8,1720,867,853,85
YUCATÁN,31,TINUM,091,SAN FELIPE,3,8,5,3,2
YUCATÁN,31,TINUM,091,SAN FRANCISCO GRANDE,5,527,261,266,23
YUCATÁN,31,TINUM,091,TINUM,6,547,285,262,37
YUCATÁN,31,TINUM,091,TOHOPKÚ,4,182,91,91,11
YUCATÁN,31,TINUM,091,X-CALAKOOP,5,461,219,242,20
YUCATÁN,31,TIXCACALCUPUL,092,CAROLINA,3,9,5,4,2
YUCATÁN,31,TIXCACALCUPUL,092,EKPEDZ,5,587,294,293,26
YUCATÁN,31,TIXCACALCUPUL,092,MAHAS,3,100,39,61,6
YUCATÁN,31,TIXCACALCUPUL,092,POOP,3,129,62,67,6
YUCATÁN,31,TIXCACALCUPUL,092,SAN JOSÉ,4,255,127,128,14
YUCATÁN,31,TIXCACALCUPUL,092,TIXCACALCUPUL,7,1244,649,595,68
YUCATÁN,31,TIXCACALCUPUL,092,X-TOHBIL,3,82,39,43,5
YUCATÁN,31,TIXKOKOB,093,EKMUL,4,477,229,248,23
YUCATÁN,31,TIXKOKOB,093,EUÁN,3,175,86,89,11
YUCATÁN,31,TIXKOKOB,093,HUBILÁ,2,14,5,9,2
YUCATÁN,31,TIXKOKOB,093,NOLO,3,186,78,108,11
YUCATÁN,31,TIXKOKOB,093,RUINAS DE AKÉ,1,14,9,5,1
YUCATÁN,31,TIXKOKOB,093,SAN ANTONIO MILLET,2,84,37,47,5
YUCATÁN,31,TIXKOKOB,093,TIXKOKOB,12,2878,1450,1428,156
YUCATÁN,31,TIXMÉHUAC,094,CHALTUNPUHUY,2,6,3,3,2
YUCATÁN,31,TIXMÉHUAC,094,CHICÁN,4,202,103,99,12
YUCATÁN,31,TIXMÉHUAC,094,DZUTOH,2,35,15,20,2
YUCATÁN,31,TIXMÉHUAC,094,KIMBILÁ,5,225,98,127,15
YUCATÁN,31,TIXMÉHUAC,094,SABACCHÉ,5,252,104,148,15
YUCATÁN,31,TIXMÉHUAC,094,SISBIC,2,32,14,18,3
YUCATÁN,31,TIXMÉHUAC,094,TIXMÉHUAC,6,805,387,418,43
YUCATÁN,31,TIXMÉHUAC,094,XCOHIL,2,5,2,3,1
YUCATÁN,31,TIXPÉHUAL,095,CHOCHOH,2,62,28,34,4
YUCATÁN,31,TIXPÉHUAL,095,CUCÁ,2,11,9,2,2
YUCATÁN,31,TIXPÉHUAL,095,KILINCHÉ,2,33,11,22,3
YUCATÁN,31,TIXPÉHUAL,095,SAHÉ,2,62,34,28,3
YUCATÁN,31,TIXPÉHUAL,095,TECHOH,2,46,21,25,3
YUCATÁN,31,TIXPÉHUAL,095,TIXPÉHUAL,4,789,407,382,54
YUCATÁN,31,TIZIMÍN,096,ÁLAMO,2,18,10,8,2
YUCATÁN,31,TIZIMÍN,096,CENOTE AZUL,2,15,8,7,2
YUCATÁN,31,TIZIMÍN,096,CHAN CENOTE,6,864,416,448,37
YUCATÁN,31,TIZIMÍN,096,CHAN SAN ANTONIO,4,144,66,78,10
YUCATÁN,31,TIZIMÍN,096,CHAN TRES REYES,2,13,6,7,2
YUCATÁN,31,TIZIMÍN,096,CHENKEKÉN,3,70,32,38,5
YUCATÁN,31,TIZIMÍN,096,COLONIA YUCATÁN,4,546,267,279,39
YUCATÁN,31,TIZIMÍN,096,DZONOT AKÉ,4,161,64,97,10
YUCATÁN,31,TIZIMÍN,096,DZONOT BOX,2,10,7,3,2
YUCATÁN,31,TIZIMÍN,096,DZONOT CARRETERO,4,657,345,312,37
YUCATÁN,31,TIZIMÍN,096,DZONOT MEZO,4,119,62,57,9
YUCATÁN,31,TIZIMÍN,096,EL CUYO,4,457,242,215,23
YUCATÁN,31,TIZIMÍN,096,EL EDÉN (YAXIC),3,134,66,68,8
YUCATÁN,31,TIZIMÍN,096,EMILIANO ZAPATA,2,10,3,7,2
YUCATÁN,31,TIZIMÍN,096,FELIPE CARRILLO PUERTO NÚMERO UNO,2,6,5,1,1
YUCATÁN,31,TIZIMÍN,096,KABICHÉN,3,68,32,36,6
YUCATÁN,31,TIZIMÍN,096,KALAX YOKDZONOT,2,5,2,3,1
YUCATÁN,31,TIZIMÍN,096,KIKIL,2,36,15,21,2
YUCATÁN,31,TIZIMÍN,096,LA LIBERTAD,2,12,1,11,2
YUCATÁN,31,TIZIMÍN,096,LA SIERRA,2,69,38,31,4
YUCATÁN,31,TIZIMÍN,096,LUIS ROSADO VEGA,2,42,18,24,3
YUCATÁN,31,TIZIMÍN,096,MANUEL CEPEDA PERAZA,2,57,35,22,3
YUCATÁN,31,TIZIMÍN,096,MOCTEZUMA,4,90,54,36,9
YUCATÁN,31,TIZIMÍN,096,POPOLNÁH,6,992,494,498,49
YUCATÁN,31,TIZIMÍN,096,SAMARIA,2,12,6,6,2
YUCATÁN,31,TIZIMÍN,096,SAN ANDRÉS,3,117,64,53,6
YUCATÁN,31,TIZIMÍN,096,SAN ARTURO,3,11,6,5,3
YUCATÁN,31,TIZIMÍN,096,SAN FRANCISCO YOHACTÚN,2,17,10,7,2
YUCATÁN,31,TIZIMÍN,096,SAN HIPÓLITO,2,66,30,36,6
YUCATÁN,31,TIZIMÍN,096,SAN ISIDRO KANCABDZONOT,2,20,7,13,2
YUCATÁN,31,TIZIMÍN,096,SAN ISIDRO KILÓMETRO CATORCE (SAN ISIDRO),3,49,25,24,3
YUCATÁN,31,TIZIMÍN,096,SAN JOSÉ CONDE,2,9,4,5,2
YUCATÁN,31,TIZIMÍN,096,SAN JOSÉ MONTECRISTO,2,33,21,12,2
YUCATÁN,31,TIZIMÍN,096,SAN JUAN KILÓMETRO CUATRO,2,22,8,14,2
YUCATÁN,31,TIZIMÍN,096,SAN LORENZO CHIQUILÁ,2,61,34,27,4
YUCATÁN,31,TIZIMÍN,096,SAN LUIS TZUCTUK,2,32,14,18,3
YUCATÁN,31,TIZIMÍN,096,SAN MANUEL KILÓMETRO ONCE,3,57,30,27,4
YUCATÁN,31,TIZIMÍN,096,SAN PEDRO BACAB,3,38,18,20,4
YUCATÁN,31,TIZIMÍN,096,SAN PEDRO JUÁREZ,3,53,29,24,4
YUCATÁN,31,TIZIMÍN,096,SANTA ANA,3,62,31,31,4
YUCATÁN,31,TIZIMÍN,096,SANTA CLARA DZIBALKÚ,3,33,22,11,3
YUCATÁN,31,TIZIMÍN,096,SANTA ELENA,2,9,5,4,2
YUCATÁN,31,TIZIMÍN,096,SANTA MARÍA,3,86,35,51,6
YUCATÁN,31,TIZIMÍN,096,SANTA ROSA CONCEPCIÓN,3,32,15,17,5
YUCATÁN,31,TIZIMÍN,096,SANTA ROSA Y ANEXAS,4,205,96,109,11
YUCATÁN,31,TIZIMÍN,096,SUCOPÓ,5,448,244,204,22
YUCATÁN,31,TIZIMÍN,096,TEZOCO NUEVO,3,23,13,10,2
YUCATÁN,31,TIZIMÍN,096,TIXCANCAL,4,665,319,346,37
YUCATÁN,31,TIZIMÍN,096,TIZIMÍN,53,14333,7143,7190,944
YUCATÁN,31,TIZIMÍN,096,TRASCORRAL,3,28,14,14,3
YUCATÁN,31,TIZIMÍN,096,XBOHOM,1,5,2,3,1
YUCATÁN,31,TIZIMÍN,096,XKALAX DE DZIBALKÚ,3,16,8,8,2
YUCATÁN,31,TIZIMÍN,096,X-MAKULÁN,2,19,10,9,2
YUCATÁN,31,TIZIMÍN,096,X-PANHATORO,3,50,23,27,4
YUCATÁN,31,TIZIMÍN,096,YAXCHEKÚ,3,40,17,23,4
YUCATÁN,31,TIZIMÍN,096,YOHACTÚN DE HIDALGO,4,110,54,56,10
YUCATÁN,31,TUNKÁS,097,ONICHÉN,3,22,8,14,3
YUCATÁN,31,TUNKÁS,097,SAN ANTONIO CHUC,3,94,54,40,7
YUCATÁN,31,TUNKÁS,097,SAN JOSÉ PIBTUCH,2,23,13,10,2
YUCATÁN,31,TUNKÁS,097,TUNKÁS,8,915,427,488,92
YUCATÁN,31,TZUCACAB,098,BLANCA FLOR,3,11,3,8,2
YUCATÁN,31,TZUCACAB,098,CATMÍS,5,306,160,146,22
YUCATÁN,31,TZUCACAB,098,CAXAYTUK,3,101,51,50,4
YUCATÁN,31,TZUCACAB,098,CORRAL,5,138,66,72,10
YUCATÁN,31,TZUCACAB,098,DZÍ,3,151,68,83,5
YUCATÁN,31,TZUCACAB,098,EK-BALAM,3,140,66,74,10
YUCATÁN,31,TZUCACAB,098,EL ESCONDIDO,2,45,17,28,2
YUCATÁN,31,TZUCACAB,098,MONTANA,3,9,5,4,3
YUCATÁN,31,TZUCACAB,098,NOH-BEC,5,166,82,84,10
YUCATÁN,31,TZUCACAB,098,POLHUACXIL,2,26,13,13,2
YUCATÁN,31,TZUCACAB,098,SACBECÁN,2,57,25,32,3
YUCATÁN,31,TZUCACAB,098,SAN SALVADOR PISTE AKAL,3,32,16,16,3
YUCATÁN,31,TZUCACAB,098,TIGRE GRANDE,3,46,22,24,3
YUCATÁN,31,TZUCACAB,098,TZUCACAB,15,3092,1502,1590,159
YUCATÁN,31,TZUCACAB,098,XCOBIAKAL (XCOBILAKAL),1,5,3,2,1
YUCATÁN,31,UAYMA,099,SAN LORENZO,2,14,9,5,2
YUCATÁN,31,UAYMA,099,SANTA MARÍA AZNAR,4,132,62,70,10
YUCATÁN,31,UAYMA,099,UAYMA,5,798,404,394,47
YUCATÁN,31,UCÚ,100,UCÚ,6,1886,791,1095,321
YUCATÁN,31,UCÚ,100,YAXCHÉ DE PEÓN,2,135,68,67,7
YUCATÁN,31,UMÁN,101,BOLÓN,5,412,192,220,18
YUCATÁN,31,UMÁN,101,DZIBIKAK,5,492,247,245,22
YUCATÁN,31,UMÁN,101,HOTZUC,3,28,12,16,3
YUCATÁN,31,UMÁN,101,HUNXECTAMÁN,3,68,25,43,5
YUCATÁN,31,UMÁN,101,OXCUM,4,423,190,233,20
YUCATÁN,31,UMÁN,101,OXHOLÓN,4,235,114,121,14
YUCATÁN,31,UMÁN,101,PETEC BILTÚN,2,17,9,8,2
YUCATÁN,31,UMÁN,101,POXILÁ,5,222,128,94,14
YUCATÁN,31,UMÁN,101,SAN ANTONIO CHUM,4,184,80,104,13
YUCATÁN,31,UMÁN,101,SAN ANTONIO MULIX,5,13,9,4,3
YUCATÁN,31,UMÁN,101,TANÍL,2,63,28,35,3
YUCATÁN,31,UMÁN,101,TEBEC,4,83,43,40,9
YUCATÁN,31,UMÁN,101,TICIMUL,5,271,134,137,15
YUCATÁN,31,UMÁN,101,UMÁN,61,14411,7330,7081,756
YUCATÁN,31,UMÁN,101,XCUCUL SUR,2,49,20,29,3
YUCATÁN,31,UMÁN,101,XTEPÉN,4,113,56,57,10
YUCATÁN,31,UMÁN,101,YAXCOPOIL,4,246,129,117,22
YUCATÁN,31,VALLADOLID,102,BOLMAY,4,133,63,70,9
YUCATÁN,31,VALLADOLID,102,CHAMUL,2,10,2,8,2
YUCATÁN,31,VALLADOLID,102,CHAN YOKDZONOT,3,40,17,23,4
YUCATÁN,31,VALLADOLID,102,CHANYOKDZONOT II,3,24,9,15,3
YUCATÁN,31,VALLADOLID,102,DZITNUP,5,386,202,184,20
YUCATÁN,31,VALLADOLID,102,EBTÚN,4,184,74,110,14
YUCATÁN,31,VALLADOLID,102,KANXOC,7,1073,524,549,51
YUCATÁN,31,VALLADOLID,102,KOOPCHÉN,2,4,0,4,1
YUCATÁN,31,VALLADOLID,102,NOHSUYTÚN,5,118,57,61,10
YUCATÁN,31,VALLADOLID,102,PIXOY,5,278,146,132,15
YUCATÁN,31,VALLADOLID,102,POPOLÁ,10,1300,633,667,53
YUCATÁN,31,VALLADOLID,102,SAN ANDRÉS X-BAC,2,13,6,7,2
YUCATÁN,31,VALLADOLID,102,SAN ANTONIO,2,15,2,13,1
YUCATÁN,31,VALLADOLID,102,SAN ISIDRO,2,6,1,5,1
YUCATÁN,31,VALLADOLID,102,SANTA ELEUTERIA,3,17,7,10,3
YUCATÁN,31,VALLADOLID,102,SANTA ROSA,2,6,3,3,1
YUCATÁN,31,VALLADOLID,102,TAHMUY,5,403,198,205,19
YUCATÁN,31,VALLADOLID,102,TEPAKÁN,3,26,15,11,3
YUCATÁN,31,VALLADOLID,102,TESOCO,5,544,258,286,27
YUCATÁN,31,VALLADOLID,102,TIKUCH,5,497,255,242,23
YUCATÁN,31,VALLADOLID,102,TIXHUALACTÚN,5,602,301,301,27
YUCATÁN,31,VALLADOLID,102,VALLADOLID,79,21847,11162,10685,1585
YUCATÁN,31,VALLADOLID,102,X-BACAB,3,11,8,3,2
YUCATÁN,31,VALLADOLID,102,X-COHUÓ,2,17,8,9,2
YUCATÁN,31,VALLADOLID,102,XKAMPEPÉN,1,3,1,2,1
YUCATÁN,31,VALLADOLID,102,XOCÉN,5,696,333,363,36
YUCATÁN,31,VALLADOLID,102,XUILUB,5,270,130,140,16
YUCATÁN,31,VALLADOLID,102,YAAX-HAL,3,70,34,36,4
YUCATÁN,31,VALLADOLID,102,YALCOBÁ,6,891,424,467,64
YUCATÁN,31,VALLADOLID,102,YALCÓN,3,47,21,26,4
YUCATÁN,31,VALLADOLID,102,YAXCHÉ,2,16,9,7,2
YUCATÁN,31,VALLADOLID,102,ZODZILCHÉN,3,36,19,17,3
YUCATÁN,31,XOCCHEL,103,XOCCHEL,6,802,392,410,43
YUCATÁN,31,YAXCABÁ,104,CANAKOM,4,190,86,104,13
YUCATÁN,31,YAXCABÁ,104,CHIMAY,2,19,9,10,2
YUCATÁN,31,YAXCABÁ,104,CISTEIL,3,49,29,20,3
YUCATÁN,31,YAXCABÁ,104,HUECHEN BALAM,3,53,22,31,5
YUCATÁN,31,YAXCABÁ,104,KANCABDZONOT,5,295,153,142,15
YUCATÁN,31,YAXCABÁ,104,LIBRE UNIÓN,5,578,301,277,41
YUCATÁN,31,YAXCABÁ,104,POPOLÁ,2,31,13,18,3
YUCATÁN,31,YAXCABÁ,104,SAN ARNULFO,3,9,1,8,3
YUCATÁN,31,YAXCABÁ,104,SAN MARCOS,3,78,38,40,6
YUCATÁN,31,YAXCABÁ,104,SAN PEDRO,3,47,32,15,4
YUCATÁN,31,YAXCABÁ,104,SANTA MARÍA,5,51,30,21,6
YUCATÁN,31,YAXCABÁ,104,TAHDZIBICHÉN,5,479,245,234,25
YUCATÁN,31,YAXCABÁ,104,TIHOLOP,5,442,206,236,23
YUCATÁN,31,YAXCABÁ,104,TINUNCAH,3,44,25,19,4
YUCATÁN,31,YAXCABÁ,104,TIXCACALTUYUB,6,780,389,391,39
YUCATÁN,31,YAXCABÁ,104,XLAPAK,3,58,33,25,5
YUCATÁN,31,YAXCABÁ,104,X-MEXIL,3,17,11,6,3
YUCATÁN,31,YAXCABÁ,104,X-POM,3,35,16,19,3
YUCATÁN,31,YAXCABÁ,104,YAXCABÁ,6,972,503,469,48
YUCATÁN,31,YAXCABÁ,104,YAXUNAH,4,202,87,115,12
YUCATÁN,31,YAXCABÁ,104,YOKDZONOT,4,187,92,95,13
YUCATÁN,31,YAXCABÁ,104,YOKDZONOT-HÚ,3,18,8,10,3
YUCATÁN,31,YAXKUKUL,105,YAXKUKUL,8,665,308,357,58
YUCATÁN,31,YOBAÍN,106,CHABIHAU,4,90,43,47,8
YUCATÁN,31,YOBAÍN,106,YOBAÍN,5,369,173,196,26
ZACATECAS,32,APOZOL,001,APOZOL,7,727,391,336,42
ZACATECAS,32,APOZOL,001,BANCO DE PIEDRA,1,4,2,2,1
ZACATECAS,32,APOZOL,001,BENITO JUÁREZ (EL RESCOLDO),3,144,69,75,7
ZACATECAS,32,APOZOL,001,COLONIA FRANCISCO I. MADERO,2,28,12,16,3
ZACATECAS,32,APOZOL,001,EL TULE,1,7,4,3,1
ZACATECAS,32,APOZOL,001,LA PURÍSIMA,2,39,20,19,2
ZACATECAS,32,APOZOL,001,LA TIRICIA,2,52,24,28,3
ZACATECAS,32,APOZOL,001,LOS LLAMAS (SAN ISIDRO),3,174,73,101,11
ZACATECAS,32,APOZOL,001,PALMA CUATA,2,25,14,11,2
ZACATECAS,32,APOZOL,001,SAN MIGUEL (ATOTONILCO),3,231,135,96,13
ZACATECAS,32,APULCO,002,APULCO,4,600,312,288,34
ZACATECAS,32,APULCO,002,EL SOYATAL,3,26,13,13,3
ZACATECAS,32,APULCO,002,HUEGOLITA,2,24,12,12,2
ZACATECAS,32,APULCO,002,LA CHAVEÑA,2,17,11,6,2
ZACATECAS,32,APULCO,002,LOS MIRASOLES,1,6,2,4,1
ZACATECAS,32,APULCO,002,PASTORÍA,2,10,6,4,2
ZACATECAS,32,APULCO,002,PEDREGOSO,2,8,5,3,1
ZACATECAS,32,APULCO,002,RANCHO APULCO,3,83,37,46,5
ZACATECAS,32,APULCO,002,RANCHO NUEVO,2,22,7,15,2
ZACATECAS,32,APULCO,002,TENAYUCA,5,554,282,272,29
ZACATECAS,32,APULCO,002,TINAJAS,3,34,18,16,3
ZACATECAS,32,ATOLINGA,003,ATOLINGA,4,461,219,242,28
ZACATECAS,32,ATOLINGA,003,CERRITO PELÓN,1,3,2,1,1
ZACATECAS,32,ATOLINGA,003,EL DURAZNO,2,22,11,11,2
ZACATECAS,32,ATOLINGA,003,LAGUNA GRANDE,2,26,14,12,2
ZACATECAS,32,ATOLINGA,003,SALISFLOR,1,3,1,2,1
ZACATECAS,32,ATOLINGA,003,VILLA HIDALGO,1,1,1,0,1
ZACATECAS,32,BENITO JUÁREZ,004,FLORENCIA,7,1006,525,481,47
ZACATECAS,32,BENITO JUÁREZ,004,LOS CAMPOS,3,99,47,52,6
ZACATECAS,32,BENITO JUÁREZ,004,MESA DE RAYOS,1,7,4,3,1
ZACATECAS,32,BENITO JUÁREZ,004,POTRERILLOS,4,58,33,25,4
ZACATECAS,32,BENITO JUÁREZ,004,SAN LUCAS TEPETITLÁN,3,58,24,34,4
ZACATECAS,32,CALERA,005,EL PORVENIR,2,30,13,17,2
ZACATECAS,32,CALERA,005,EL VERGEL,1,14,5,9,1
ZACATECAS,32,CALERA,005,FRANCISCO I. MADERO (COYOTES),2,15,8,7,2
ZACATECAS,32,CALERA,005,LAS AURAS,2,23,10,13,2
ZACATECAS,32,CALERA,005,NUEVA ALIANZA (ÑATES),2,4,3,1,1
ZACATECAS,32,CALERA,005,NUEVA COLONIA FRANCISCO I. MADERO,1,20,10,10,1
ZACATECAS,32,CALERA,005,RAMÓN LÓPEZ VELARDE (TORIBIO),7,1576,792,784,58
ZACATECAS,32,CALERA,005,RÍO FRÍO,3,104,51,53,5
ZACATECAS,32,CALERA,005,VÍCTOR ROSALES,40,10241,5159,5082,533
ZACATECAS,32,CAÑITAS DE FELIPE PESCADOR,006,BOQUILLA DE ABAJO,3,154,74,80,7
ZACATECAS,32,CAÑITAS DE FELIPE PESCADOR,006,CAÑITAS DE FELIPE PESCADOR,9,1679,844,835,85
ZACATECAS,32,CAÑITAS DE FELIPE PESCADOR,006,EL PORVENIR,3,27,12,15,3
ZACATECAS,32,CAÑITAS DE FELIPE PESCADOR,006,EL SAUCILLO,2,43,23,20,2
ZACATECAS,32,CAÑITAS DE FELIPE PESCADOR,006,LA QUEMADA,3,109,69,40,6
ZACATECAS,32,CONCEPCIÓN DEL ORO,007,ANÁHUAC (SAN EUSTAQUIO),3,39,17,22,3
ZACATECAS,32,CONCEPCIÓN DEL ORO,007,CIÉNEGA DE ROCAMONTES,2,22,14,8,2
ZACATECAS,32,CONCEPCIÓN DEL ORO,007,CONCEPCIÓN DEL ORO,17,2491,1231,1260,155
ZACATECAS,32,CONCEPCIÓN DEL ORO,007,COYOTILLOS,2,21,12,9,2
ZACATECAS,32,CONCEPCIÓN DEL ORO,007,EL CHARCO (LA CIGÜEÑA),3,65,32,33,4
ZACATECAS,32,CONCEPCIÓN DEL ORO,007,EL DURAZNO,3,40,24,16,3
ZACATECAS,32,CONCEPCIÓN DEL ORO,007,EL SALERO,3,39,19,20,3
ZACATECAS,32,CONCEPCIÓN DEL ORO,007,EMANCIPACIÓN (TANQUE DEL ALTO),3,62,32,30,4
ZACATECAS,32,CONCEPCIÓN DEL ORO,007,GUADALUPE GARZARÓN,3,63,24,39,4
ZACATECAS,32,CONCEPCIÓN DEL ORO,007,LA LABORCILLA,3,53,25,28,3
ZACATECAS,32,CONCEPCIÓN DEL ORO,007,LOS ENCINOS,3,89,50,39,4
ZACATECAS,32,CONCEPCIÓN DEL ORO,007,MANUEL RODRÍGUEZ MÉNDEZ (EL ARENAL),2,35,14,21,2
ZACATECAS,32,CONCEPCIÓN DEL ORO,007,MESILLAS (EJIDO REFORMA),3,21,11,10,3
ZACATECAS,32,CONCEPCIÓN DEL ORO,007,MORELOS (SAN RAFAEL),1,2,0,2,0
ZACATECAS,32,CONCEPCIÓN DEL ORO,007,PABELLÓN HIDALGO (EL PABELLÓN),2,26,11,15,2
ZACATECAS,32,CONCEPCIÓN DEL ORO,007,PROGRESO (AGUA DULCE),2,25,12,13,2
ZACATECAS,32,CONCEPCIÓN DEL ORO,007,SAN JOSÉ DEL MEZQUITAL (EL MEZQUITAL),2,12,7,5,2
ZACATECAS,32,CUAUHTÉMOC,008,COLONIA RÍO VERDE,3,95,55,40,5
ZACATECAS,32,CUAUHTÉMOC,008,FELIPE BERRIOZÁBAL (ESTACIÓN BERRIOZÁBAL),3,119,61,58,6
ZACATECAS,32,CUAUHTÉMOC,008,PIEDRA GORDA,3,227,118,109,11
ZACATECAS,32,CUAUHTÉMOC,008,POTRERILLO (EX-HACIENDA DE POTRERILLOS),2,460,239,221,19
ZACATECAS,32,CUAUHTÉMOC,008,RANCHO NUEVO,3,420,210,210,21
ZACATECAS,32,CUAUHTÉMOC,008,SAN MIGUEL DE LA PRESA,2,5,2,3,1
ZACATECAS,32,CUAUHTÉMOC,008,SAN PEDRO PIEDRA GORDA,8,1915,969,946,90
ZACATECAS,32,CHALCHIHUITES,009,AGUA DE LA VIEJA (GENERAL JESÚS GONZÁLEZ ORTEGA),3,73,35,38,5
ZACATECAS,32,CHALCHIHUITES,009,CHALCHIHUITES,7,1224,624,600,65
ZACATECAS,32,CHALCHIHUITES,009,COLONIA AURORA,2,22,13,9,2
ZACATECAS,32,CHALCHIHUITES,009,COLONIA LÁZARO CÁRDENAS,3,99,51,48,5
ZACATECAS,32,CHALCHIHUITES,009,EL DURAZNO,3,30,19,11,3
ZACATECAS,32,CHALCHIHUITES,009,EL HORMIGUERO,4,69,26,43,4
ZACATECAS,32,CHALCHIHUITES,009,EL OJO DE AGUA DEL MANTO,2,5,2,3,1
ZACATECAS,32,CHALCHIHUITES,009,EL PINO,1,3,1,2,1
ZACATECAS,32,CHALCHIHUITES,009,EL REFUGIO,1,18,9,9,1
ZACATECAS,32,CHALCHIHUITES,009,GUALTERIO,4,229,126,103,13
ZACATECAS,32,CHALCHIHUITES,009,HIDALGO DEL MANTO,3,68,33,35,4
ZACATECAS,32,CHALCHIHUITES,009,JESÚS MARÍA,2,35,19,16,2
ZACATECAS,32,CHALCHIHUITES,009,JOSÉ MARÍA MORELOS (SAN JOSÉ DE GRACIA),4,313,161,152,17
ZACATECAS,32,CHALCHIHUITES,009,LA COFRADÍA,1,17,6,11,1
ZACATECAS,32,CHALCHIHUITES,009,LA MAGDALENA,3,23,14,9,4
ZACATECAS,32,CHALCHIHUITES,009,LA PURÍSIMA (OJO DEL TORO),3,72,37,35,4
ZACATECAS,32,CHALCHIHUITES,009,LAS PILITAS,2,7,3,4,2
ZACATECAS,32,CHALCHIHUITES,009,PIEDRAS AZULES,3,167,84,83,8
ZACATECAS,32,CHALCHIHUITES,009,RANCHO COLORADO,2,46,23,23,3
ZACATECAS,32,CHALCHIHUITES,009,RANCHO DEL CURA (EL CURA),2,23,13,10,2
ZACATECAS,32,CHALCHIHUITES,009,SAN ANTONIO DE GUADALUPE,3,63,32,31,4
ZACATECAS,32,CHALCHIHUITES,009,SAN JOSÉ DE BUENAVISTA (SAN JOSÉ DE ABAJO),3,117,50,67,6
ZACATECAS,32,CHALCHIHUITES,009,SOLEDAD DE PIEDRAS AZULES (LA SOLEDAD DE PIEDRA),2,21,9,12,2
ZACATECAS,32,FRESNILLO,010,ALTAMIRA,3,353,187,166,19
ZACATECAS,32,FRESNILLO,010,ATENAS,3,16,7,9,3
ZACATECAS,32,FRESNILLO,010,BAJÍO DE SAN GABRIEL,2,41,15,26,3
ZACATECAS,32,FRESNILLO,010,BOCA DE RÍO CHICO,3,37,22,15,3
ZACATECAS,32,FRESNILLO,010,BUENAVISTA DE TRUJILLO,4,614,304,310,27
ZACATECAS,32,FRESNILLO,010,CARRILLO,3,247,124,123,11
ZACATECAS,32,FRESNILLO,010,CHICHIMEQUILLAS,3,345,182,163,16
ZACATECAS,32,FRESNILLO,010,CIENEGUITAS DE MARIANA,3,72,36,36,4
ZACATECAS,32,FRESNILLO,010,COLONIA BAÑUELOS (BAJÍO DE BAÑUELOS),3,75,42,33,4
ZACATECAS,32,FRESNILLO,010,COLONIA BENITO JUÁREZ,3,108,58,50,6
ZACATECAS,32,FRESNILLO,010,COLONIA EL ÁGUILA (EL ÁGUILA),3,85,37,48,4
ZACATECAS,32,FRESNILLO,010,COLONIA EL OBLIGADO,3,67,42,25,4
ZACATECAS,32,FRESNILLO,010,COLONIA EMANCIPACIÓN,3,144,70,74,8
ZACATECAS,32,FRESNILLO,010,COLONIA GUANAJUATO,3,76,36,40,4
ZACATECAS,32,FRESNILLO,010,COLONIA MONTEMARIANA (COLONIA MARIANA),4,394,198,196,21
ZACATECAS,32,FRESNILLO,010,COLONIA PLENITUD,3,377,181,196,20
ZACATECAS,32,FRESNILLO,010,COLONIA PRESA DE LINARES (PRESA DE LINARES),3,99,48,51,5
ZACATECAS,32,FRESNILLO,010,COLONIA PURÍSIMA DEL MAGUEY,3,25,14,11,3
ZACATECAS,32,FRESNILLO,010,COLONIA SANTA ANITA,3,139,74,65,7
ZACATECAS,32,FRESNILLO,010,CONCEPCIÓN RIVERA,3,99,59,40,5
ZACATECAS,32,FRESNILLO,010,EL AHIJADERO,3,143,65,78,7
ZACATECAS,32,FRESNILLO,010,EL ANGELITO,2,9,4,5,1
ZACATECAS,32,FRESNILLO,010,EL BALUARTE,4,304,171,133,15
ZACATECAS,32,FRESNILLO,010,EL CARRIZALILLO (CARRIZALILLO DE ÁBREGO),2,19,11,8,2
ZACATECAS,32,FRESNILLO,010,EL CENTRO,4,227,118,109,14
ZACATECAS,32,FRESNILLO,010,EL EPAZOTE,3,127,57,70,7
ZACATECAS,32,FRESNILLO,010,EL PARDILLO SEGUNDO,4,145,73,72,7
ZACATECAS,32,FRESNILLO,010,EL PARDILLO TERCERO,4,484,242,242,24
ZACATECAS,32,FRESNILLO,010,EL REFUGIO DE ÁBREGO (BENITO JUÁREZ),3,84,38,46,4
ZACATECAS,32,FRESNILLO,010,EL SALITRILLO,1,24,14,10,1
ZACATECAS,32,FRESNILLO,010,EL SALTO,4,968,510,458,39
ZACATECAS,32,FRESNILLO,010,EL SAUCITO,1,53,27,26,3
ZACATECAS,32,FRESNILLO,010,EL SUPIRIO,2,11,5,6,1
ZACATECAS,32,FRESNILLO,010,EL TEJUJÁN,2,25,13,12,2
ZACATECAS,32,FRESNILLO,010,EL TIGRE (LOS NOPALES),3,21,9,12,3
ZACATECAS,32,FRESNILLO,010,EMILIANO ZAPATA (EL TERREADERO),3,60,27,33,4
ZACATECAS,32,FRESNILLO,010,ERÉNDIRA,4,145,80,65,9
ZACATECAS,32,FRESNILLO,010,ERMITA DE GUADALUPE,2,21,7,14,2
ZACATECAS,32,FRESNILLO,010,ESTACIÓN GUTIÉRREZ,4,336,167,169,19
ZACATECAS,32,FRESNILLO,010,ESTACIÓN SAN JOSÉ,4,1528,826,702,92
ZACATECAS,32,FRESNILLO,010,FELIPE ÁNGELES (EL BARRANCO),3,130,55,75,6
ZACATECAS,32,FRESNILLO,010,FRACCIONAMIENTO SAN FELIPE,1,52,26,26,2
ZACATECAS,32,FRESNILLO,010,FRANCISCO GARCÍA SALINAS (LA LARGA),3,61,24,37,4
ZACATECAS,32,FRESNILLO,010,FRANCISCO I. MADERO,3,152,68,84,9
ZACATECAS,32,FRESNILLO,010,FRESNILLO,171,37503,18767,18736,2640
ZACATECAS,32,FRESNILLO,010,GUADALUPE DE TRUJILLO,4,161,83,78,9
ZACATECAS,32,FRESNILLO,010,JOSÉ MARÍA MORELOS,3,293,142,151,15
ZACATECAS,32,FRESNILLO,010,LA BLANCA,1,16,9,7,1
ZACATECAS,32,FRESNILLO,010,LA CANTERA,3,133,58,75,6
ZACATECAS,32,FRESNILLO,010,LA CASITA,3,147,65,82,7
ZACATECAS,32,FRESNILLO,010,LA ENCANTADA,3,150,74,76,8
ZACATECAS,32,FRESNILLO,010,LA LUZ (EL JAGÜEY),1,19,10,9,1
ZACATECAS,32,FRESNILLO,010,LA MANGA,3,60,26,34,4
ZACATECAS,32,FRESNILLO,010,LA QUEMADA (FRANCISCO I. MADERO),3,68,28,40,4
ZACATECAS,32,FRESNILLO,010,LA SALADA,3,122,60,62,6
ZACATECAS,32,FRESNILLO,010,LA SOLEDAD,3,59,37,22,4
ZACATECAS,32,FRESNILLO,010,LA ZARQUILLA,2,7,6,1,1
ZACATECAS,32,FRESNILLO,010,LABOR DE SANTA BÁRBARA,4,201,100,101,10
ZACATECAS,32,FRESNILLO,010,LAGUNA SECA,4,272,135,137,13
ZACATECAS,32,FRESNILLO,010,LAS CATARINAS,4,491,247,244,26
ZACATECAS,32,FRESNILLO,010,LAS MERCEDES,3,73,32,41,4
ZACATECAS,32,FRESNILLO,010,LAS PIEDRAS,3,65,33,32,4
ZACATECAS,32,FRESNILLO,010,LÁZARO CÁRDENAS (RANCHO GRANDE),6,1226,600,626,83
ZACATECAS,32,FRESNILLO,010,LOS ÁNGELES,1,31,13,18,2
ZACATECAS,32,FRESNILLO,010,LOS ÁNGELES DE LOS MEDRANO,2,122,56,66,6
ZACATECAS,32,FRESNILLO,010,LOS CHARCOS,1,4,3,1,1
ZACATECAS,32,FRESNILLO,010,LOS CHILITOS,1,263,129,134,8
ZACATECAS,32,FRESNILLO,010,LOS CORRALES (EMILIANO ZAPATA),2,17,11,6,2
ZACATECAS,32,FRESNILLO,010,LOS EJIDOS,2,7,4,3,1
ZACATECAS,32,FRESNILLO,010,LOS LIRIOS,2,5,3,2,1
ZACATECAS,32,FRESNILLO,010,LOS POCITOS,3,31,19,12,3
ZACATECAS,32,FRESNILLO,010,LOS RÍOS,2,4,2,2,1
ZACATECAS,32,FRESNILLO,010,LOS ROSALES (EL CUERVO),1,10,5,5,1
ZACATECAS,32,FRESNILLO,010,MATÍAS RAMOS,3,211,109,102,11
ZACATECAS,32,FRESNILLO,010,MELCHOR OCAMPO (SAN JERÓNIMO),3,229,121,108,11
ZACATECAS,32,FRESNILLO,010,MENDOZA,3,86,48,38,6
ZACATECAS,32,FRESNILLO,010,MÉXICO NUEVO UNO (MÉXICO NUEVO),3,180,85,95,8
ZACATECAS,32,FRESNILLO,010,MIGUEL HIDALGO (HIDALGO),6,986,513,473,43
ZACATECAS,32,FRESNILLO,010,MILPILLAS DE LA SIERRA,3,113,51,62,6
ZACATECAS,32,FRESNILLO,010,MODELO,3,29,12,17,3
ZACATECAS,32,FRESNILLO,010,MORFÍN CHÁVEZ,3,113,67,46,5
ZACATECAS,32,FRESNILLO,010,NUEVO DÍA,3,100,47,53,6
ZACATECAS,32,FRESNILLO,010,NUEVO ZARAGOZA,3,124,55,69,6
ZACATECAS,32,FRESNILLO,010,OJO DE AGUA DE RAMOS (RAMOS),3,52,27,25,3
ZACATECAS,32,FRESNILLO,010,OJO DE AGUA DEL TULE,2,20,8,12,2
ZACATECAS,32,FRESNILLO,010,ÓRGANOS,2,18,9,9,2
ZACATECAS,32,FRESNILLO,010,ORILLA DEL LLANO,2,27,16,11,2
ZACATECAS,32,FRESNILLO,010,PALMIRA,3,108,48,60,6
ZACATECAS,32,FRESNILLO,010,PLAN DE VALLECITOS,3,97,48,49,6
ZACATECAS,32,FRESNILLO,010,PLATEROS,7,1764,911,853,129
ZACATECAS,32,FRESNILLO,010,POTRERO BLANCO,2,7,3,4,1
ZACATECAS,32,FRESNILLO,010,PRESA DEL MEZQUITE (TAPIAS DEL MEZQUITE),3,26,15,11,3
ZACATECAS,32,FRESNILLO,010,PRESA LEOBARDO REYNOSO (PRIMERO DE MAYO),3,185,92,93,8
ZACATECAS,32,FRESNILLO,010,PROVIDENCIA (ENRIQUE RAMÍREZ),3,173,89,84,8
ZACATECAS,32,FRESNILLO,010,PUEBLA DEL PALMAR (EL MEMBRILLO),3,58,28,30,4
ZACATECAS,32,FRESNILLO,010,RAFAEL YÁÑEZ SOSA (EL MEZQUITE),4,574,299,275,28
ZACATECAS,32,FRESNILLO,010,RAMÓN LÓPEZ VELARDE (LA CHICHARRONA),3,150,65,85,8
ZACATECAS,32,FRESNILLO,010,REDENCIÓN,2,48,27,21,3
ZACATECAS,32,FRESNILLO,010,REFUGIO DE SANTA ROSA (EL REFUGIO),3,39,23,16,3
ZACATECAS,32,FRESNILLO,010,RINCÓN DE LA FLORIDA,2,24,11,13,2
ZACATECAS,32,FRESNILLO,010,RÍO FLORIDO,5,1192,618,574,64
ZACATECAS,32,FRESNILLO,010,SAN ANTONIO DE BUENAVISTA,2,29,13,16,2
ZACATECAS,32,FRESNILLO,010,SAN CRISTÓBAL,3,170,92,78,9
ZACATECAS,32,FRESNILLO,010,SAN GABRIEL,3,208,110,98,11
ZACATECAS,32,FRESNILLO,010,SAN IGNACIO,4,271,139,132,15
ZACATECAS,32,FRESNILLO,010,SAN ISIDRO DE CABRALES,3,80,24,56,4
ZACATECAS,32,FRESNILLO,010,SAN ISIDRO DE TRUJILLO,2,7,4,3,1
ZACATECAS,32,FRESNILLO,010,SAN ISIDRO DEL CERRO GORDO,3,67,28,39,4
ZACATECAS,32,FRESNILLO,010,SAN JOSÉ DE LOURDES,7,1526,794,732,95
ZACATECAS,32,FRESNILLO,010,SAN JOSÉ DEL ALAMITO,3,205,104,101,11
ZACATECAS,32,FRESNILLO,010,SAN JOSÉ DEL QUELITE,3,41,24,17,3
ZACATECAS,32,FRESNILLO,010,SAN JOSÉ DEL RÍO,3,179,89,90,10
ZACATECAS,32,FRESNILLO,010,SAN JUAN DE LA CASIMIRA,3,55,24,31,4
ZACATECAS,32,FRESNILLO,010,SAN JUAN DE LOS HORNILLOS,2,21,8,13,2
ZACATECAS,32,FRESNILLO,010,SAN JUAN DEL CENTRO (EL PORVENIR DEL CENTRO),3,69,33,36,4
ZACATECAS,32,FRESNILLO,010,SAN MARCOS DE ÁBREGO,3,39,23,16,3
ZACATECAS,32,FRESNILLO,010,SAN MARTÍN DE LOS PAJARITOS,3,38,20,18,3
ZACATECAS,32,FRESNILLO,010,SAN MIGUEL DE SOSA,2,25,12,13,2
ZACATECAS,32,FRESNILLO,010,SAN MIGUEL DEL VERGEL,1,8,4,4,1
ZACATECAS,32,FRESNILLO,010,SAN PABLO DE LOS PUERTOS,2,32,21,11,2
ZACATECAS,32,FRESNILLO,010,SAN PABLO DE RANCHO GRANDE,3,131,63,68,6
ZACATECAS,32,FRESNILLO,010,SAN TADEO,3,25,13,12,3
ZACATECAS,32,FRESNILLO,010,SANTA ANA,2,37,24,13,3
ZACATECAS,32,FRESNILLO,010,SANTA LUCÍA,3,38,16,22,3
ZACATECAS,32,FRESNILLO,010,SANTA ROSA,3,79,41,38,4
ZACATECAS,32,FRESNILLO,010,SANTIAGUILLO,4,377,184,193,22
ZACATECAS,32,FRESNILLO,010,SAUCITO DEL POLEO,2,52,31,21,3
ZACATECAS,32,FRESNILLO,010,SECTOR LAS CUMBRES (EJIDO NUEVO ZARAGOZA),1,4,3,1,1
ZACATECAS,32,FRESNILLO,010,SEIS DE ENERO,4,747,375,372,32
ZACATECAS,32,FRESNILLO,010,SOMBRERETILLO,3,35,15,20,4
ZACATECAS,32,FRESNILLO,010,TAPIAS DE SANTA CRUZ (PEDRO RUIZ GONZÁLEZ),3,386,200,186,22
ZACATECAS,32,FRESNILLO,010,TEPETATILLO,3,46,20,26,3
ZACATECAS,32,FRESNILLO,010,TORREÓN DE LOS PASTORES,3,156,68,88,8
ZACATECAS,32,FRESNILLO,010,TORTUGUILLAS (LA SALUD),3,27,12,15,3
ZACATECAS,32,FRESNILLO,010,TRUJILLO,3,144,70,74,8
ZACATECAS,32,FRESNILLO,010,URITE,3,33,16,17,3
ZACATECAS,32,FRESNILLO,010,VALDECAÑAS,3,125,61,64,5
ZACATECAS,32,FRESNILLO,010,VALLE DE SAN ISIDRO (SAN ISIDRO),3,60,27,33,4
ZACATECAS,32,FRESNILLO,010,VASCO DE QUIROGA,3,64,39,25,4
ZACATECAS,32,FRESNILLO,010,VICENTE GUERRERO (ÁBREGO),4,155,85,70,7
ZACATECAS,32,TRINIDAD GARCÍA DE LA CADENA,011,LA CEJA,3,61,28,33,4
ZACATECAS,32,TRINIDAD GARCÍA DE LA CADENA,011,LA ESTANZUELA,6,675,369,306,34
ZACATECAS,32,TRINIDAD GARCÍA DE LA CADENA,011,LAS HIGUERAS,1,5,3,2,1
ZACATECAS,32,GENARO CODINA,012,COLONIA EL REFUGIO,3,48,22,26,4
ZACATECAS,32,GENARO CODINA,012,COLONIA SAN ISIDRO,4,170,83,87,9
ZACATECAS,32,GENARO CODINA,012,CORRALILLO,3,35,17,18,3
ZACATECAS,32,GENARO CODINA,012,DELGADILLO,1,4,1,3,1
ZACATECAS,32,GENARO CODINA,012,EL LAUREL,3,152,65,87,8
ZACATECAS,32,GENARO CODINA,012,EL PALMARITO,2,22,12,10,2
ZACATECAS,32,GENARO CODINA,012,EL SALTO PRIETO,1,3,2,1,1
ZACATECAS,32,GENARO CODINA,012,EL TEPETATE,3,133,66,67,6
ZACATECAS,32,GENARO CODINA,012,ENRIQUE ESTRADA,3,57,28,29,4
ZACATECAS,32,GENARO CODINA,012,GENARO CODINA,4,728,366,362,36
ZACATECAS,32,GENARO CODINA,012,LA PRESILLA,2,9,4,5,1
ZACATECAS,32,GENARO CODINA,012,LA PURÍSIMA,3,48,19,29,4
ZACATECAS,32,GENARO CODINA,012,LA SALADITA,1,6,5,1,1
ZACATECAS,32,GENARO CODINA,012,LAS TINAJAS,3,7,3,4,3
ZACATECAS,32,GENARO CODINA,012,MACARENOS,2,6,4,2,1
ZACATECAS,32,GENARO CODINA,012,MINILLAS,3,57,30,27,4
ZACATECAS,32,GENARO CODINA,012,OJO DE AGUA DEL PROGRESO (OJO DE AGUA),3,68,33,35,4
ZACATECAS,32,GENARO CODINA,012,OJO SECO,1,5,3,2,1
ZACATECAS,32,GENARO CODINA,012,PASO DE MÉNDEZ,3,264,130,134,12
ZACATECAS,32,GENARO CODINA,012,PERALES,3,111,50,61,5
ZACATECAS,32,GENARO CODINA,012,SAN FERNANDO,3,28,14,14,3
ZACATECAS,32,GENARO CODINA,012,SAN MARTÍN,2,8,4,4,2
ZACATECAS,32,GENARO CODINA,012,SANTA CRUZ DE PIEDRAS CARGADAS,3,11,6,5,2
ZACATECAS,32,GENARO CODINA,012,SANTA CRUZ DE SIERRA FRÍA,2,14,8,6,2
ZACATECAS,32,GENARO CODINA,012,SANTA INÉS,3,196,111,85,11
ZACATECAS,32,GENARO CODINA,012,SANTA TERESA,2,20,9,11,2
ZACATECAS,32,GENERAL ENRIQUE ESTRADA,013,ADJUNTAS DEL PEÑASCO (EL PEÑASCO),3,85,41,44,4
ZACATECAS,32,GENERAL ENRIQUE ESTRADA,013,CIENEGUITAS DE TAPIAS,3,27,14,13,3
ZACATECAS,32,GENERAL ENRIQUE ESTRADA,013,GENERAL ENRIQUE ESTRADA,9,2487,1259,1228,129
ZACATECAS,32,GENERAL ENRIQUE ESTRADA,013,GENERAL FÉLIX U. GÓMEZ (EL MUERTO),4,277,123,154,16
ZACATECAS,32,GENERAL ENRIQUE ESTRADA,013,MESA DE FUENTES,2,17,14,3,2
ZACATECAS,32,GENERAL FRANCISCO R. MURGUÍA,014,ALFONSO MEDINA,3,108,49,59,6
ZACATECAS,32,GENERAL FRANCISCO R. MURGUÍA,014,APASEO,3,74,31,43,4
ZACATECAS,32,GENERAL FRANCISCO R. MURGUÍA,014,ATOTONILCO,3,63,33,30,4
ZACATECAS,32,GENERAL FRANCISCO R. MURGUÍA,014,CHUPADEROS (SERANO),3,32,12,20,3
ZACATECAS,32,GENERAL FRANCISCO R. MURGUÍA,014,CIENEGUILLA (NORIA Y CIENEGUILLA),4,238,121,117,14
ZACATECAS,32,GENERAL FRANCISCO R. MURGUÍA,014,COLONIA BENITO JUÁREZ (EL TULILLO),3,50,26,24,3
ZACATECAS,32,GENERAL FRANCISCO R. MURGUÍA,014,COLONIA CHAPULTEPEC,3,70,31,39,4
ZACATECAS,32,GENERAL FRANCISCO R. MURGUÍA,014,EL ANCÓN,3,46,23,23,3
ZACATECAS,32,GENERAL FRANCISCO R. MURGUÍA,014,EL CARNERITO (EL CARNERO),3,42,24,18,4
ZACATECAS,32,GENERAL FRANCISCO R. MURGUÍA,014,EL CARRIZAL,3,119,58,61,7
ZACATECAS,32,GENERAL FRANCISCO R. MURGUÍA,014,EL PORVENIR (EL PORVENIR DEL CARMEN),3,39,17,22,3
ZACATECAS,32,GENERAL FRANCISCO R. MURGUÍA,014,EL POTRERO,3,55,22,33,4
ZACATECAS,32,GENERAL FRANCISCO R. MURGUÍA,014,EL REFUGIO (ESTANCIA DEL REFUGIO),2,6,3,3,1
ZACATECAS,32,GENERAL FRANCISCO R. MURGUÍA,014,EL ROSARIO,1,3,1,2,1
ZACATECAS,32,GENERAL FRANCISCO R. MURGUÍA,014,EL ROSARIO (RANCHO DE LOS ROJAS),1,11,5,6,1
ZACATECAS,32,GENERAL FRANCISCO R. MURGUÍA,014,EL SAUZ,2,11,5,6,2
ZACATECAS,32,GENERAL FRANCISCO R. MURGUÍA,014,EL VERGEL,2,18,9,9,2
ZACATECAS,32,GENERAL FRANCISCO R. MURGUÍA,014,EMANCIPACIÓN,3,72,30,42,4
ZACATECAS,32,GENERAL FRANCISCO R. MURGUÍA,014,FRANCISCO I. MADERO (COLONIA MADERO),3,212,110,102,11
ZACATECAS,32,GENERAL FRANCISCO R. MURGUÍA,014,GENERAL MANUEL ÁVILA CAMACHO (MESILLAS),3,78,42,36,4
ZACATECAS,32,GENERAL FRANCISCO R. MURGUÍA,014,INDEPENDENCIA SAN MARTÍN (SAN MARTÍN),3,204,102,102,10
ZACATECAS,32,GENERAL FRANCISCO R. MURGUÍA,014,JARALILLO,3,100,52,48,5
ZACATECAS,32,GENERAL FRANCISCO R. MURGUÍA,014,LA ESTANZUELA,3,122,58,64,6
ZACATECAS,32,GENERAL FRANCISCO R. MURGUÍA,014,LA LAGUNA (LA LAGUNA VALENCIANA),4,477,250,227,17
ZACATECAS,32,GENERAL FRANCISCO R. MURGUÍA,014,LAS BOCAS,3,78,35,43,5
ZACATECAS,32,GENERAL FRANCISCO R. MURGUÍA,014,LAS NORIAS (NORIAS),3,108,52,56,6
ZACATECAS,32,GENERAL FRANCISCO R. MURGUÍA,014,LUIS MOYA,3,138,71,67,7
ZACATECAS,32,GENERAL FRANCISCO R. MURGUÍA,014,LUIS MOYA (ESTACIÓN ALAMILLO),3,4,2,2,3
ZACATECAS,32,GENERAL FRANCISCO R. MURGUÍA,014,MATÍAS RAMOS (EL TÁNGER),3,60,28,32,4
ZACATECAS,32,GENERAL FRANCISCO R. MURGUÍA,014,MÉRIDA CUATRO,2,5,1,4,1
ZACATECAS,32,GENERAL FRANCISCO R. MURGUÍA,014,MIGUEL HIDALGO,3,43,22,21,3
ZACATECAS,32,GENERAL FRANCISCO R. MURGUÍA,014,NIEVES,9,2031,1137,894,148
ZACATECAS,32,GENERAL FRANCISCO R. MURGUÍA,014,ORAN,3,130,70,60,7
ZACATECAS,32,GENERAL FRANCISCO R. MURGUÍA,014,PACHECO (ESTACIÓN PACHECO),3,37,19,18,4
ZACATECAS,32,GENERAL FRANCISCO R. MURGUÍA,014,PROVIDENCIA,2,21,10,11,2
ZACATECAS,32,GENERAL FRANCISCO R. MURGUÍA,014,SAN BUENAVENTURA (PICACHOS),3,20,11,9,3
ZACATECAS,32,GENERAL FRANCISCO R. MURGUÍA,014,SAN FRANCISCO DE LOS GALLARDO (SAN FRANCISCO),2,17,10,7,2
ZACATECAS,32,GENERAL FRANCISCO R. MURGUÍA,014,SAN GIL,2,17,9,8,2
ZACATECAS,32,GENERAL FRANCISCO R. MURGUÍA,014,SAN IGNACIO,2,9,6,3,1
ZACATECAS,32,GENERAL FRANCISCO R. MURGUÍA,014,SAN ISIDRO,1,26,11,15,1
ZACATECAS,32,GENERAL FRANCISCO R. MURGUÍA,014,SAN JOSÉ DE MORTEROS (MORTEROS),3,127,70,57,7
ZACATECAS,32,GENERAL FRANCISCO R. MURGUÍA,014,SAN LUCAS,3,158,94,64,18
ZACATECAS,32,GENERAL FRANCISCO R. MURGUÍA,014,SANTA RITA,4,293,147,146,15
ZACATECAS,32,GENERAL FRANCISCO R. MURGUÍA,014,SANTA ROSA,2,85,49,36,4
ZACATECAS,32,GENERAL FRANCISCO R. MURGUÍA,014,VALENCIANA (OJO DE AGUA),3,108,54,54,6
ZACATECAS,32,GENERAL FRANCISCO R. MURGUÍA,014,VILLA CÁRDENAS,3,154,78,76,8
ZACATECAS,32,EL PLATEADO DE JOAQUÍN AMARO,015,COLONIA ANTONIO R. VELA (SAN LORENZO),3,40,20,20,3
ZACATECAS,32,EL PLATEADO DE JOAQUÍN AMARO,015,EL PLATEADO DE JOAQUÍN AMARO,4,200,103,97,11
ZACATECAS,32,EL PLATEADO DE JOAQUÍN AMARO,015,FRANCISCO I. MADERO (RANCHO DEL PADRE),1,10,4,6,1
ZACATECAS,32,EL PLATEADO DE JOAQUÍN AMARO,015,OJO DE AGUA DE LOS SOLÍS,2,11,8,3,1
ZACATECAS,32,EL PLATEADO DE JOAQUÍN AMARO,015,PALO ALTO,2,8,5,3,2
ZACATECAS,32,EL PLATEADO DE JOAQUÍN AMARO,015,SAN ANTONIO DE LA CALERA (LA CALERA),3,66,34,32,4
ZACATECAS,32,GENERAL PÁNFILO NATERA,016,COLONIA AURELIO PÁMANES ESCOBEDO (EL SOCORRO),3,87,45,42,5
ZACATECAS,32,GENERAL PÁNFILO NATERA,016,COLONIA LAS AMAPOLAS,1,2,0,2,1
ZACATECAS,32,GENERAL PÁNFILO NATERA,016,EL MARÍN (MARÍN),2,17,7,10,2
ZACATECAS,32,GENERAL PÁNFILO NATERA,016,EL SAUCITO (EL HORNO),6,943,472,471,70
ZACATECAS,32,GENERAL PÁNFILO NATERA,016,EL TULE,3,339,178,161,18
ZACATECAS,32,GENERAL PÁNFILO NATERA,016,GENERAL PÁNFILO NATERA,7,1144,544,600,64
ZACATECAS,32,GENERAL PÁNFILO NATERA,016,GUANAJUATILLO,4,268,134,134,14
ZACATECAS,32,GENERAL PÁNFILO NATERA,016,LA CANDELARIA,1,8,4,4,1
ZACATECAS,32,GENERAL PÁNFILO NATERA,016,LA HACIENDITA,3,45,20,25,3
ZACATECAS,32,GENERAL PÁNFILO NATERA,016,LA PRESA DEL COLORADITO,3,64,33,31,4
ZACATECAS,32,GENERAL PÁNFILO NATERA,016,LA TESORERA (BAJÍO DE LA TESORERA),3,380,208,172,19
ZACATECAS,32,GENERAL PÁNFILO NATERA,016,LA UNIÓN DE SAN ANTONIO (UNIÓN DE LAS BORREGAS),3,215,110,105,11
ZACATECAS,32,GENERAL PÁNFILO NATERA,016,NINGUNO,1,4,2,2,1
ZACATECAS,32,GENERAL PÁNFILO NATERA,016,NORIA DEL CERRO DE SANTIAGO (EL CERRO),3,71,37,34,5
ZACATECAS,32,GENERAL PÁNFILO NATERA,016,PROVIDENCIA,3,85,40,45,5
ZACATECAS,32,GENERAL PÁNFILO NATERA,016,RANCHO NUEVO,4,238,110,128,12
ZACATECAS,32,GENERAL PÁNFILO NATERA,016,SAN ANTONIO DEL BORDO,2,17,7,10,2
ZACATECAS,32,GENERAL PÁNFILO NATERA,016,SAN JOSÉ EL SALADILLO (EL SALADILLO),5,702,368,334,33
ZACATECAS,32,GENERAL PÁNFILO NATERA,016,SAN PABLO,5,505,271,234,38
ZACATECAS,32,GENERAL PÁNFILO NATERA,016,SAN RAFAEL,2,47,23,24,3
ZACATECAS,32,GENERAL PÁNFILO NATERA,016,SAN RAMÓN,3,161,74,87,9
ZACATECAS,32,GENERAL PÁNFILO NATERA,016,SANTA ELENA (FRANCISCO ZARCO),3,479,253,226,22
ZACATECAS,32,GENERAL PÁNFILO NATERA,016,TAHONAS,3,72,34,38,4
ZACATECAS,32,GUADALUPE,017,BAÑUELOS,3,148,70,78,7
ZACATECAS,32,GUADALUPE,017,CASA BLANCA,5,333,167,166,17
ZACATECAS,32,GUADALUPE,017,CIENEGUITAS,8,3295,1522,1773,296
ZACATECAS,32,GUADALUPE,017,COLONIA OSIRIS,3,76,35,41,5
ZACATECAS,32,GUADALUPE,017,EL BORDO DE BUENAVISTA (EL BORDO),3,420,189,231,20
ZACATECAS,32,GUADALUPE,017,EL MASTRANTO,2,47,16,31,3
ZACATECAS,32,GUADALUPE,017,FRANCISCO E. GARCÍA (LOS RANCHEROS),3,87,43,44,5
ZACATECAS,32,GUADALUPE,017,GENERAL EMILIANO ZAPATA (LA COCINERA),3,109,54,55,4
ZACATECAS,32,GUADALUPE,017,GUADALUPE,224,42866,22059,20807,2939
ZACATECAS,32,GUADALUPE,017,LA LUZ,3,241,132,109,13
ZACATECAS,32,GUADALUPE,017,LA VICTORIA,2,236,115,121,8
ZACATECAS,32,GUADALUPE,017,LA ZACATECANA,5,1120,578,542,47
ZACATECAS,32,GUADALUPE,017,LAGUNA DE ARRIBA,1,31,12,19,6
ZACATECAS,32,GUADALUPE,017,LAGUNA HONDA,2,18,11,7,2
ZACATECAS,32,GUADALUPE,017,LOMAS DE GUADALUPE (LA OREJA),1,37,24,13,2
ZACATECAS,32,GUADALUPE,017,MARTÍNEZ DOMÍNGUEZ,4,859,417,442,43
ZACATECAS,32,GUADALUPE,017,OJO DE AGUA,3,121,61,60,6
ZACATECAS,32,GUADALUPE,017,POZOS COLECTIVOS (GERARDO TREJO PÉREZ),2,30,12,18,3
ZACATECAS,32,GUADALUPE,017,SAN IGNACIO,3,100,44,56,5
ZACATECAS,32,GUADALUPE,017,SAN ISIDRO BOCANEGRA,3,47,25,22,3
ZACATECAS,32,GUADALUPE,017,SAN JERÓNIMO,5,943,465,478,46
ZACATECAS,32,GUADALUPE,017,SAN RAMÓN,3,397,207,190,16
ZACATECAS,32,GUADALUPE,017,SANTA MÓNICA,3,296,152,144,12
ZACATECAS,32,GUADALUPE,017,TACOALECHE,10,2705,1426,1279,127
ZACATECAS,32,GUADALUPE,017,VIBORITAS,3,92,41,51,5
ZACATECAS,32,GUADALUPE,017,ZÓQUITE,8,1204,626,578,67
ZACATECAS,32,HUANUSCO,018,ARELLANOS,2,82,38,44,4
ZACATECAS,32,HUANUSCO,018,CIÉNEGA DE SAN FELIPE (CIÉNEGA DE ABAJO),1,27,16,11,2
ZACATECAS,32,HUANUSCO,018,EL GUAJE (EL NACIONAL),1,8,2,6,1
ZACATECAS,32,HUANUSCO,018,EL TEPEHUE,1,11,3,8,1
ZACATECAS,32,HUANUSCO,018,EL YERBANÍS,1,10,7,3,1
ZACATECAS,32,HUANUSCO,018,HUANUSCO,6,463,229,234,34
ZACATECAS,32,HUANUSCO,018,LA HIGUERA,2,27,18,9,2
ZACATECAS,32,HUANUSCO,018,LA LUZ,1,13,6,7,1
ZACATECAS,32,HUANUSCO,018,LA MARGARITA,2,11,5,6,1
ZACATECAS,32,HUANUSCO,018,LOS MORALEÑOS,2,14,6,8,2
ZACATECAS,32,HUANUSCO,018,LOS RODRÍGUEZ,2,16,9,7,2
ZACATECAS,32,HUANUSCO,018,LOS SOYATES,4,63,26,37,7
ZACATECAS,32,HUANUSCO,018,MEXIQUITO (RANCHO NUEVO),1,8,1,7,1
ZACATECAS,32,HUANUSCO,018,RANCHO NUEVO,2,52,27,25,3
ZACATECAS,32,HUANUSCO,018,REMUDADERO DE ABAJO (REMUDADERO),2,21,8,13,2
ZACATECAS,32,HUANUSCO,018,SAN JOSÉ DE LA PALMA,3,59,23,36,4
ZACATECAS,32,HUANUSCO,018,ZAPOTE DE ABAJO,3,26,14,12,3
ZACATECAS,32,JALPA,019,BARRIO DE LA CRUZ (PAREDONES BLANCOS),2,111,61,50,5
ZACATECAS,32,JALPA,019,CABALLERÍAS,2,12,4,8,1
ZACATECAS,32,JALPA,019,CHALCHISCO DE ABAJO (SAN RAFAEL),3,70,34,36,4
ZACATECAS,32,JALPA,019,COFRADÍA,1,17,5,12,1
ZACATECAS,32,JALPA,019,COLONIA ARÉCHIGA,2,13,10,3,2
ZACATECAS,32,JALPA,019,COLONIA JOSÉ MARÍA MORELOS (ARROYO DE LA TROJE),1,5,1,4,1
ZACATECAS,32,JALPA,019,COLONIA UNIÓN OBRERA,2,356,180,176,15
ZACATECAS,32,JALPA,019,CORRAL DE PIEDRA,2,8,3,5,1
ZACATECAS,32,JALPA,019,EL BARREAL,2,27,17,10,2
ZACATECAS,32,JALPA,019,EL CARACOL,3,68,33,35,4
ZACATECAS,32,JALPA,019,EL MEZQUITE,2,11,5,6,2
ZACATECAS,32,JALPA,019,EL RODEO,3,56,26,30,4
ZACATECAS,32,JALPA,019,EL TUITÁN,3,66,34,32,4
ZACATECAS,32,JALPA,019,EL ZAPOTILLO,1,8,4,4,1
ZACATECAS,32,JALPA,019,GUADALUPE VICTORIA (LA VILLITA),4,237,120,117,14
ZACATECAS,32,JALPA,019,JALPA,28,4482,2287,2195,290
ZACATECAS,32,JALPA,019,LA CHAVEÑA,3,25,10,15,2
ZACATECAS,32,JALPA,019,LA PITAYA,3,74,36,38,4
ZACATECAS,32,JALPA,019,LAS PALMITAS,2,17,10,7,2
ZACATECAS,32,JALPA,019,LAS PRESAS,3,27,9,18,2
ZACATECAS,32,JALPA,019,LOS SABINOS,1,5,3,2,1
ZACATECAS,32,JALPA,019,LOS SANTIAGOS,3,282,121,161,12
ZACATECAS,32,JALPA,019,PALMILLOS,4,104,57,47,8
ZACATECAS,32,JALPA,019,RANCHO DE ARRIBA,2,23,10,13,2
ZACATECAS,32,JALPA,019,REALITO DE ARRIBA,2,15,8,7,3
ZACATECAS,32,JALPA,019,SAN BERNARDO,3,78,52,26,4
ZACATECAS,32,JALPA,019,SAN FRANCISCO (EL TECOLOTE),1,18,6,12,1
ZACATECAS,32,JALPA,019,SAN JOSÉ DE HUARACHA,3,54,29,25,4
ZACATECAS,32,JALPA,019,SAN VICENTE,3,59,27,32,4
ZACATECAS,32,JALPA,019,SANTA JUANA (IGNACIO ZARAGOZA),3,62,29,33,3
ZACATECAS,32,JALPA,019,SANTO DOMINGO,1,21,11,10,1
ZACATECAS,32,JALPA,019,TENAYUCA,3,34,16,18,3
ZACATECAS,32,JALPA,019,TEOCALTICHILLO,3,83,44,39,5
ZACATECAS,32,JALPA,019,VILLITA DE ABAJO (LA VILLITA SAN LORENZO),2,27,14,13,2
ZACATECAS,32,JEREZ,020,COLONIA BENITO JUÁREZ,3,62,30,32,4
ZACATECAS,32,JEREZ,020,COLONIA BRISEÑO,2,14,5,9,2
ZACATECAS,32,JEREZ,020,COLONIA MIGUEL HIDALGO,2,11,5,6,1
ZACATECAS,32,JEREZ,020,EL CARGADERO,3,76,34,42,5
ZACATECAS,32,JEREZ,020,EL DURAZNO,3,40,18,22,3
ZACATECAS,32,JEREZ,020,EL HUEJOTE,3,45,23,22,4
ZACATECAS,32,JEREZ,020,EL MAGUEYITO,2,16,10,6,2
ZACATECAS,32,JEREZ,020,EL MORAL,3,72,38,34,4
ZACATECAS,32,JEREZ,020,EL NARANJAL,2,12,3,9,1
ZACATECAS,32,JEREZ,020,EL PORVENIR,3,55,29,26,4
ZACATECAS,32,JEREZ,020,EL TAMBOR,3,41,21,20,3
ZACATECAS,32,JEREZ,020,ERMITA DE GUADALUPE,4,672,311,361,44
ZACATECAS,32,JEREZ,020,ERMITA DE LOS CORREA,5,244,130,114,15
ZACATECAS,32,JEREZ,020,ERMITA DE LOS MURILLO (LOS MURILLO),1,14,8,6,1
ZACATECAS,32,JEREZ,020,GUADALUPE VICTORIA (EL YEGE),3,16,10,6,3
ZACATECAS,32,JEREZ,020,IGNACIO ALLENDE (SANTA FE),3,33,17,16,3
ZACATECAS,32,JEREZ,020,JEREZ DE GARCÍA SALINAS,69,11134,5650,5484,703
ZACATECAS,32,JEREZ,020,JOMULQUILLO,3,29,16,13,3
ZACATECAS,32,JEREZ,020,LA CIÉNEGA,2,289,142,147,13
ZACATECAS,32,JEREZ,020,LA GAVIA,3,100,59,41,5
ZACATECAS,32,JEREZ,020,LA LABOR,2,16,7,9,2
ZACATECAS,32,JEREZ,020,LA ORDEÑA,3,28,13,15,3
ZACATECAS,32,JEREZ,020,LINDAVISTA (OJO DE AGUA DE LA MULA),3,7,3,4,2
ZACATECAS,32,JEREZ,020,LO DE LUNA,2,19,9,10,2
ZACATECAS,32,JEREZ,020,LO DE NAVA,2,16,7,9,2
ZACATECAS,32,JEREZ,020,LOS FÉLIX,3,27,20,7,3
ZACATECAS,32,JEREZ,020,LOS HARO,4,179,85,94,10
ZACATECAS,32,JEREZ,020,LOS JUÁREZ,2,10,6,4,1
ZACATECAS,32,JEREZ,020,LOS MOTA,2,22,10,12,2
ZACATECAS,32,JEREZ,020,LOS RODARTE,3,30,13,17,3
ZACATECAS,32,JEREZ,020,MONTE DE LOS GARCÍA,1,12,9,3,1
ZACATECAS,32,JEREZ,020,PALMAS ALTAS,3,51,20,31,4
ZACATECAS,32,JEREZ,020,PLAN DE CARRILLO,2,19,10,9,2
ZACATECAS,32,JEREZ,020,PUERTA DE CHULA,2,19,8,11,2
ZACATECAS,32,JEREZ,020,SAN CAYETANO,3,22,11,11,3
ZACATECAS,32,JEREZ,020,SAN ISIDRO DEL SALTO,2,29,21,8,2
ZACATECAS,32,JEREZ,020,SAN JUAN DEL CENTRO,3,56,32,24,4
ZACATECAS,32,JEREZ,020,SAN RAFAEL,1,11,4,7,1
ZACATECAS,32,JEREZ,020,SANTA RITA (LUIS MOYA),4,224,117,107,14
ZACATECAS,32,JEREZ,020,SARABIA,3,29,10,19,3
ZACATECAS,32,JEREZ,020,SAUZ DE LOS GARCÍA DE ARRIBA,1,10,5,5,1
ZACATECAS,32,JEREZ,020,TANQUE DE SAN JUAN,3,55,31,24,4
ZACATECAS,32,JEREZ,020,TETILLAS,3,19,10,9,3
ZACATECAS,32,JEREZ,020,VILLA HERMOSA,1,15,8,7,1
ZACATECAS,32,JIMÉNEZ DEL TEUL,021,ATOTONILCO,3,209,93,116,11
ZACATECAS,32,JIMÉNEZ DEL TEUL,021,CARRETAS (EL CARACOL),3,69,37,32,4
ZACATECAS,32,JIMÉNEZ DEL TEUL,021,EL CARRIZO,3,30,11,19,3
ZACATECAS,32,JIMÉNEZ DEL TEUL,021,EL TEPOZÁN,3,40,24,16,3
ZACATECAS,32,JIMÉNEZ DEL TEUL,021,JIMÉNEZ DEL TEUL,8,666,343,323,37
ZACATECAS,32,JIMÉNEZ DEL TEUL,021,LA CIENEGUITA,2,5,0,5,1
ZACATECAS,32,JIMÉNEZ DEL TEUL,021,LA LAGUNA,1,8,5,3,1
ZACATECAS,32,JIMÉNEZ DEL TEUL,021,LA LAGUNITA,2,20,9,11,2
ZACATECAS,32,JIMÉNEZ DEL TEUL,021,LAS BOCAS,3,39,21,18,3
ZACATECAS,32,JIMÉNEZ DEL TEUL,021,LUIS MOYA DE ABAJO,2,21,7,14,2
ZACATECAS,32,JIMÉNEZ DEL TEUL,021,MEZQUITE BLANCO,2,22,15,7,2
ZACATECAS,32,JIMÉNEZ DEL TEUL,021,MOLINA,2,7,4,3,1
ZACATECAS,32,JIMÉNEZ DEL TEUL,021,POTRERO DE ABAJO,3,39,19,20,3
ZACATECAS,32,JIMÉNEZ DEL TEUL,021,SAUCES DE ABAJO (SAN JOSÉ DE LOS SAUCES),1,10,3,7,1
ZACATECAS,32,JIMÉNEZ DEL TEUL,021,SAUCES DE ARRIBA,3,71,43,28,4
ZACATECAS,32,JIMÉNEZ DEL TEUL,021,TEPETATITA,3,9,2,7,3
ZACATECAS,32,JIMÉNEZ DEL TEUL,021,VENTURA (BUENAVENTURA),2,8,5,3,1
ZACATECAS,32,JUAN ALDAMA,022,CORRALES,3,61,36,25,4
ZACATECAS,32,JUAN ALDAMA,022,ESPÍRITU SANTO,4,178,84,94,12
ZACATECAS,32,JUAN ALDAMA,022,GENERAL JUAN JOSÉ RÍOS (CIÉNEGA DE SAN FRANCISCO),3,201,89,112,11
ZACATECAS,32,JUAN ALDAMA,022,JALPA,3,59,26,33,4
ZACATECAS,32,JUAN ALDAMA,022,JOSÉ MARÍA MORELOS (MORELOS),1,13,9,4,1
ZACATECAS,32,JUAN ALDAMA,022,JUAN ALDAMA,24,4160,2069,2091,258
ZACATECAS,32,JUAN ALDAMA,022,LAS NORIAS,3,7,2,5,2
ZACATECAS,32,JUAN ALDAMA,022,OJITOS,3,261,120,141,15
ZACATECAS,32,JUAN ALDAMA,022,PARADILLAS,4,102,62,40,9
ZACATECAS,32,JUAN ALDAMA,022,SAN FELIPE DE JESÚS (EL ZACATÓN),3,36,19,17,3
ZACATECAS,32,JUCHIPILA,023,BARRIO DE GUADALUPE VICTORIA,2,59,34,25,4
ZACATECAS,32,JUCHIPILA,023,BONIFACIO FALCÓN (SAN SEBASTIÁN),3,197,92,105,10
ZACATECAS,32,JUCHIPILA,023,CONTITLÁN,1,9,4,5,1
ZACATECAS,32,JUCHIPILA,023,EL PAISANO,2,44,21,23,3
ZACATECAS,32,JUCHIPILA,023,EL REMOLINO,4,606,283,323,37
ZACATECAS,32,JUCHIPILA,023,FRACCIONAMIENTO JUCHIPILA,1,21,5,16,1
ZACATECAS,32,JUCHIPILA,023,GUADALAJARITA,2,16,8,8,2
ZACATECAS,32,JUCHIPILA,023,JUCHIPILA,14,2358,1297,1061,173
ZACATECAS,32,JUCHIPILA,023,LA CANTERA (LA CANTERA DE ARRIBA),2,26,13,13,2
ZACATECAS,32,JUCHIPILA,023,LA RINCONADA,2,18,7,11,2
ZACATECAS,32,JUCHIPILA,023,MEZQUITERA NORTE,1,5,2,3,1
ZACATECAS,32,JUCHIPILA,023,MEZQUITERA SUR,3,216,108,108,10
ZACATECAS,32,JUCHIPILA,023,PUEBLO VIEJO,2,15,8,7,2
ZACATECAS,32,LORETO,024,BIMBALETES,3,331,177,154,15
ZACATECAS,32,LORETO,024,COLONIA HIDALGO (EL TECOLOTE),3,516,257,259,22
ZACATECAS,32,LORETO,024,COLONIA VICTORIA (EL CUIJE),1,8,4,4,1
ZACATECAS,32,LORETO,024,CRISÓSTOMOS,3,296,156,140,17
ZACATECAS,32,LORETO,024,EJIDO HIDALGO,4,452,209,243,23
ZACATECAS,32,LORETO,024,EL CARREÑO,2,16,7,9,2
ZACATECAS,32,LORETO,024,EL HINOJO,3,87,33,54,5
ZACATECAS,32,LORETO,024,EL LOBO,3,260,124,136,13
ZACATECAS,32,LORETO,024,EL MASTRANTO,2,32,16,16,2
ZACATECAS,32,LORETO,024,EL PRIETO,1,106,48,58,5
ZACATECAS,32,LORETO,024,EL TEPETATE,3,108,56,52,5
ZACATECAS,32,LORETO,024,EMILIO CARRANZA (ARENAL DEL PICACHO),3,103,53,50,6
ZACATECAS,32,LORETO,024,FELIPE CARRILLO PUERTO (CARRILLO PUERTO),4,249,121,128,14
ZACATECAS,32,LORETO,024,JESÚS MARÍA,2,25,10,15,2
ZACATECAS,32,LORETO,024,LA ALQUERÍA,4,352,179,173,19
ZACATECAS,32,LORETO,024,LA CASCARONA,4,36,16,20,5
ZACATECAS,32,LORETO,024,LA CONCEPCIÓN,4,436,233,203,21
ZACATECAS,32,LORETO,024,LA FLORIDA,3,141,71,70,7
ZACATECAS,32,LORETO,024,LA LOMA (EL BAJÍO),2,187,83,104,8
ZACATECAS,32,LORETO,024,LA LUZ,2,58,29,29,3
ZACATECAS,32,LORETO,024,LA SOLEDAD,1,9,3,6,1
ZACATECAS,32,LORETO,024,LA VICTORIA,3,53,24,29,4
ZACATECAS,32,LORETO,024,LAS PLAYAS,2,27,16,11,2
ZACATECAS,32,LORETO,024,LINARES,2,53,24,29,3
ZACATECAS,32,LORETO,024,LORETO,38,8822,4473,4349,499
ZACATECAS,32,LORETO,024,NORIAS DE GUADALUPE,3,59,27,32,5
ZACATECAS,32,LORETO,024,NORIAS DE LA VENTA,2,21,9,12,2
ZACATECAS,32,LORETO,024,NORIAS DE SAN MIGUEL,2,256,133,123,10
ZACATECAS,32,LORETO,024,SAN BLAS,3,382,185,197,20
ZACATECAS,32,LORETO,024,SAN MARCOS,5,1191,604,587,93
ZACATECAS,32,LORETO,024,SAN MATÍAS,2,33,16,17,2
ZACATECAS,32,LORETO,024,SANTA MARÍA DE LOS ÁNGELES,4,396,185,211,22
ZACATECAS,32,LORETO,024,TIERRA BLANCA,3,579,297,282,34
ZACATECAS,32,LUIS MOYA,025,BARRANQUILLAS (BARRANQUILLA),2,12,7,5,2
ZACATECAS,32,LUIS MOYA,025,COECILLO,3,369,184,185,18
ZACATECAS,32,LUIS MOYA,025,COLONIA HIDALGO,4,433,196,237,20
ZACATECAS,32,LUIS MOYA,025,COLONIA JULIÁN ADAME (CHARCO DE LA GALLINA),3,141,73,68,7
ZACATECAS,32,LUIS MOYA,025,COLONIA VEINTE DE NOVIEMBRE,3,251,135,116,13
ZACATECAS,32,LUIS MOYA,025,EL DURAZNILLO,2,15,6,9,3
ZACATECAS,32,LUIS MOYA,025,ESTEBAN S. CASTORENA (CASAS COLORADAS),3,126,65,61,7
ZACATECAS,32,LUIS MOYA,025,LA MANGA (LAS MANGAS),2,17,7,10,2
ZACATECAS,32,LUIS MOYA,025,LEYVA [GRANJA],2,16,8,8,2
ZACATECAS,32,LUIS MOYA,025,LOS GRIEGOS (GRIEGOS),3,181,92,89,9
ZACATECAS,32,LUIS MOYA,025,LUIS MOYA,9,2109,1109,1000,96
ZACATECAS,32,LUIS MOYA,025,NORIA DE MOLINOS,3,110,53,57,6
ZACATECAS,32,MAZAPIL,026,APIZOLAYA,4,189,115,74,15
ZACATECAS,32,MAZAPIL,026,BANDERITA DOS,3,33,17,16,3
ZACATECAS,32,MAZAPIL,026,BENITO JUÁREZ (EL TIGRE),1,6,5,1,1
ZACATECAS,32,MAZAPIL,026,BONANZA,3,58,28,30,4
ZACATECAS,32,MAZAPIL,026,CAÑADA BLANCA,1,22,7,15,1
ZACATECAS,32,MAZAPIL,026,CAOPAS,4,299,145,154,16
ZACATECAS,32,MAZAPIL,026,CEDROS,3,432,229,203,22
ZACATECAS,32,MAZAPIL,026,CERRITOS DE JESÚS (CERROS DE JESÚS),2,17,9,8,2
ZACATECAS,32,MAZAPIL,026,CONCEPCIÓN DE LA NORMA,3,35,14,21,3
ZACATECAS,32,MAZAPIL,026,EL BERRENDO,3,49,28,21,3
ZACATECAS,32,MAZAPIL,026,EL CARDITO,3,42,20,22,3
ZACATECAS,32,MAZAPIL,026,EL JAZMÍN,3,72,31,41,5
ZACATECAS,32,MAZAPIL,026,EL PEÑASQUITO (EL PEÑASCO),2,16,11,5,2
ZACATECAS,32,MAZAPIL,026,EL RODEO,3,59,36,23,4
ZACATECAS,32,MAZAPIL,026,EL ROSARIO (PUERTO DEL ROSARIO),3,57,22,35,4
ZACATECAS,32,MAZAPIL,026,EL VERGEL,3,168,76,92,8
ZACATECAS,32,MAZAPIL,026,ESTACIÓN CAMACHO,4,450,221,229,27
ZACATECAS,32,MAZAPIL,026,ESTACIÓN OPAL,3,59,32,27,4
ZACATECAS,32,MAZAPIL,026,ESTANQUE GALLEGOS (GALLEGOS),3,132,65,67,6
ZACATECAS,32,MAZAPIL,026,FRANCISCO VILLA,2,9,6,3,2
ZACATECAS,32,MAZAPIL,026,FRANCISCO VILLA UNO,2,24,12,12,2
ZACATECAS,32,MAZAPIL,026,GENERAL FELIPE ÁNGELES (TECOLOTES),1,16,11,5,1
ZACATECAS,32,MAZAPIL,026,GRUÑIDORA,1,4,3,1,1
ZACATECAS,32,MAZAPIL,026,IGNACIO ALLENDE (SAN ÁNGEL),3,24,11,13,3
ZACATECAS,32,MAZAPIL,026,LA CANDELARIA,3,28,14,14,3
ZACATECAS,32,MAZAPIL,026,LA LAJA (RINCÓN DE LOS CABALLOS),3,35,14,21,3
ZACATECAS,32,MAZAPIL,026,LA PALMILLA,3,95,57,38,5
ZACATECAS,32,MAZAPIL,026,LA PARDITA,3,63,27,36,4
ZACATECAS,32,MAZAPIL,026,LA PRESITA,3,34,17,17,3
ZACATECAS,32,MAZAPIL,026,LA TASAJERA,3,76,35,41,3
ZACATECAS,32,MAZAPIL,026,LA TORTUGA,2,26,15,11,2
ZACATECAS,32,MAZAPIL,026,LAGUNILLA,3,38,18,20,3
ZACATECAS,32,MAZAPIL,026,LAS MESAS (MESAS DEL PORTEZUELO),3,92,38,54,5
ZACATECAS,32,MAZAPIL,026,LOS CHARCOS,2,14,7,7,1
ZACATECAS,32,MAZAPIL,026,LOS HARO,2,14,8,6,1
ZACATECAS,32,MAZAPIL,026,LOS INDIOS ROMUALDO (ROMUALDO),4,88,45,43,5
ZACATECAS,32,MAZAPIL,026,MAJOMA,3,79,40,39,4
ZACATECAS,32,MAZAPIL,026,MARIANITAS (MARIANA ELÍAS DE RODRÍGUEZ),2,17,5,12,2
ZACATECAS,32,MAZAPIL,026,MAZAPIL,4,653,294,359,56
ZACATECAS,32,MAZAPIL,026,NORIA DEL JUNCO (EL JUNCO),2,17,10,7,2
ZACATECAS,32,MAZAPIL,026,PALMAS GRANDES,2,54,20,34,3
ZACATECAS,32,MAZAPIL,026,PENDENCIA,3,48,26,22,4
ZACATECAS,32,MAZAPIL,026,POZO DE SAN JUAN,2,22,11,11,2
ZACATECAS,32,MAZAPIL,026,POZO HIDALGO (HIDALGO),3,73,41,32,4
ZACATECAS,32,MAZAPIL,026,PRESA DEL JUNCO,3,57,30,27,4
ZACATECAS,32,MAZAPIL,026,PUERTO EL MIMBRE,3,15,5,10,3
ZACATECAS,32,MAZAPIL,026,RANCHO NUEVO DE LA CARDONA (RANCHO NUEVO),3,75,35,40,4
ZACATECAS,32,MAZAPIL,026,SÁBANA GRANDE,3,79,36,43,4
ZACATECAS,32,MAZAPIL,026,SALAVERNA,3,30,13,17,3
ZACATECAS,32,MAZAPIL,026,SAN ANTONIO DEL PORTEZUELO,3,39,27,12,3
ZACATECAS,32,MAZAPIL,026,SAN ELÍAS DE LA CARDONA,3,36,20,16,3
ZACATECAS,32,MAZAPIL,026,SAN FELIPE DEL TEYRA (SAN FELIPE),2,15,10,5,2
ZACATECAS,32,MAZAPIL,026,SAN FELIPE NUEVO MERCURIO (EL NUEVO),3,40,21,19,3
ZACATECAS,32,MAZAPIL,026,SAN FRANCISCO DE LOS QUIJANO,1,16,4,12,1
ZACATECAS,32,MAZAPIL,026,SAN ISIDRO,2,4,1,3,2
ZACATECAS,32,MAZAPIL,026,SAN JOSÉ DE CARBONERILLAS,2,5,3,2,1
ZACATECAS,32,MAZAPIL,026,SAN RAFAEL (JOSÉ MARÍA MORELOS),3,108,54,54,6
ZACATECAS,32,MAZAPIL,026,SAN TIBURCIO,4,481,242,239,19
ZACATECAS,32,MAZAPIL,026,SANTA OLAYA,2,4,0,4,1
ZACATECAS,32,MAZAPIL,026,SANTA ROSA (SAN FRANCISCO),3,44,22,22,3
ZACATECAS,32,MAZAPIL,026,TAMPICO (NUEVO TAMPICO),3,37,15,22,3
ZACATECAS,32,MAZAPIL,026,TANQUE DE LOS HACHEROS (HACHEROS),1,2,0,2,1
ZACATECAS,32,MAZAPIL,026,TANQUE VIEJO,2,10,4,6,1
ZACATECAS,32,MAZAPIL,026,TANQUECILLOS,3,47,24,23,3
ZACATECAS,32,MAZAPIL,026,TANQUES DE GUADALUPE,2,24,15,9,2
ZACATECAS,32,MAZAPIL,026,TERMINAL DE PROVIDENCIA (TERMINAL),4,324,163,161,20
ZACATECAS,32,MAZAPIL,026,VEINTIUNO DE MARZO,1,4,2,2,1
ZACATECAS,32,MELCHOR OCAMPO,027,EL JAGÜEY,3,84,43,41,4
ZACATECAS,32,MELCHOR OCAMPO,027,LA MAROMA,3,68,33,35,4
ZACATECAS,32,MELCHOR OCAMPO,027,MATAMOROS,3,79,41,38,4
ZACATECAS,32,MELCHOR OCAMPO,027,MELCHOR OCAMPO,4,263,134,129,14
ZACATECAS,32,MELCHOR OCAMPO,027,MINERAL DE NOCHE BUENA,3,32,16,16,3
ZACATECAS,32,MELCHOR OCAMPO,027,PRESA DE LOS ÁNGELES (LA PRESA),2,16,10,6,2
ZACATECAS,32,MELCHOR OCAMPO,027,SAN JERÓNIMO (LA NORIA),3,90,44,46,6
ZACATECAS,32,MELCHOR OCAMPO,027,SAN MIGUEL,3,38,21,17,3
ZACATECAS,32,MELCHOR OCAMPO,027,SANTA ELENA DE LA CRUZ (NUEVO RODEO),2,14,4,10,2
ZACATECAS,32,MEZQUITAL DEL ORO,028,AGUA CALIENTE,2,14,6,8,2
ZACATECAS,32,MEZQUITAL DEL ORO,028,EL MALACATE,1,8,3,5,1
ZACATECAS,32,MEZQUITAL DEL ORO,028,EL OCOTE,2,22,15,7,2
ZACATECAS,32,MEZQUITAL DEL ORO,028,EL TANQUE,3,50,18,32,4
ZACATECAS,32,MEZQUITAL DEL ORO,028,EL TEMAZCAL,3,23,13,10,3
ZACATECAS,32,MEZQUITAL DEL ORO,028,LA HUERTA GRANDE,2,18,13,5,2
ZACATECAS,32,MEZQUITAL DEL ORO,028,LAS ÁNIMAS,3,40,20,20,3
ZACATECAS,32,MEZQUITAL DEL ORO,028,LOS ARROYOS,2,9,3,6,1
ZACATECAS,32,MEZQUITAL DEL ORO,028,LOS GUAJES,3,42,17,25,3
ZACATECAS,32,MEZQUITAL DEL ORO,028,MEZQUITAL DEL ORO,4,327,183,144,16
ZACATECAS,32,MEZQUITAL DEL ORO,028,PALO VERDE,1,13,8,5,1
ZACATECAS,32,MEZQUITAL DEL ORO,028,PRESA DEL ZAPOTE,2,44,21,23,3
ZACATECAS,32,MIGUEL AUZA,029,COLONIA MIGUEL ALEMÁN,1,30,17,13,2
ZACATECAS,32,MIGUEL AUZA,029,COLONIA VEINTE DE NOVIEMBRE (SANTA ANA),4,262,127,135,14
ZACATECAS,32,MIGUEL AUZA,029,DELICIAS DE LÓPEZ VELARDE (EL BUEYERO),3,25,11,14,3
ZACATECAS,32,MIGUEL AUZA,029,EL FRAILE (LOS TRIANA),3,19,12,7,3
ZACATECAS,32,MIGUEL AUZA,029,EMILIO CARRANZA,4,496,260,236,37
ZACATECAS,32,MIGUEL AUZA,029,JUAN SALAS FERNÁNDEZ,2,20,9,11,2
ZACATECAS,32,MIGUEL AUZA,029,MANANTIAL DE LA HONDA (CARBONERAS),3,138,79,59,9
ZACATECAS,32,MIGUEL AUZA,029,MIGUEL AUZA,19,3820,1958,1862,179
ZACATECAS,32,MIGUEL AUZA,029,TIERRA GENEROSA,3,104,46,58,6
ZACATECAS,32,MOMAX,030,LOS REALES,2,30,16,14,2
ZACATECAS,32,MOMAX,030,LOS VELA,3,30,16,14,3
ZACATECAS,32,MOMAX,030,MOMAX,6,541,284,257,33
ZACATECAS,32,MOMAX,030,SAN LORENZO,1,3,0,3,1
ZACATECAS,32,MONTE ESCOBEDO,031,ADJUNTAS DEL REFUGIO,3,41,24,17,3
ZACATECAS,32,MONTE ESCOBEDO,031,COLONIA ANACLETO LÓPEZ (COLONIA FLORES),2,16,9,7,2
ZACATECAS,32,MONTE ESCOBEDO,031,COLONIA POTRERO NUEVO (LA COLONIA),2,30,21,9,2
ZACATECAS,32,MONTE ESCOBEDO,031,COLONIA VICENTE GUERRERO,3,32,20,12,3
ZACATECAS,32,MONTE ESCOBEDO,031,EL CAPULÍN DE LOS RUIZ,3,28,14,14,3
ZACATECAS,32,MONTE ESCOBEDO,031,EL DURAZNO,3,63,34,29,4
ZACATECAS,32,MONTE ESCOBEDO,031,EL PORTILLO,2,5,2,3,1
ZACATECAS,32,MONTE ESCOBEDO,031,ESTANCIA DE GARCÍA,1,6,3,3,1
ZACATECAS,32,MONTE ESCOBEDO,031,ESTANCIA DE JESÚS MARÍA,3,27,10,17,3
ZACATECAS,32,MONTE ESCOBEDO,031,GÓMEZ,4,83,36,47,7
ZACATECAS,32,MONTE ESCOBEDO,031,HUEJUQUILLITA DE LOS MÁRQUEZ,1,15,7,8,1
ZACATECAS,32,MONTE ESCOBEDO,031,JOCOTIC,2,21,7,14,2
ZACATECAS,32,MONTE ESCOBEDO,031,LA MASITA,3,55,25,30,4
ZACATECAS,32,MONTE ESCOBEDO,031,LAGUNA GRANDE,4,258,155,103,15
ZACATECAS,32,MONTE ESCOBEDO,031,LOS CARDOS,2,6,3,3,1
ZACATECAS,32,MONTE ESCOBEDO,031,MARÍA DE LA TORRE,3,56,29,27,4
ZACATECAS,32,MONTE ESCOBEDO,031,MONTE ESCOBEDO,10,1004,498,506,64
ZACATECAS,32,MONTE ESCOBEDO,031,PASO DEL RÍO ATOLOAC,2,10,3,7,1
ZACATECAS,32,MONTE ESCOBEDO,031,SAN ANTONIO DE ARRIBA,1,14,6,8,1
ZACATECAS,32,MONTE ESCOBEDO,031,SAN LUIS (EL GATO),2,9,3,6,1
ZACATECAS,32,MONTE ESCOBEDO,031,SAN PEDRO DE LOS NAVA,2,7,4,3,1
ZACATECAS,32,MONTE ESCOBEDO,031,SAN RAMÓN,3,9,4,5,2
ZACATECAS,32,MONTE ESCOBEDO,031,SANTA BÁRBARA,3,15,9,6,2
ZACATECAS,32,MONTE ESCOBEDO,031,SANTA TERESA,1,6,4,2,1
ZACATECAS,32,MORELOS,032,HACIENDA NUEVA,5,773,387,386,37
ZACATECAS,32,MORELOS,032,LAS PILAS,3,241,121,120,11
ZACATECAS,32,MORELOS,032,MORELOS,8,2051,1035,1016,107
ZACATECAS,32,MORELOS,032,NORIA DE LOS GRINGOS (LOS GRINGOS),3,62,33,29,6
ZACATECAS,32,MORELOS,032,SAN PABLO,1,4,3,1,1
ZACATECAS,32,MOYAHUA DE ESTRADA,033,ALAMEDA JUÁREZ (SANTA ROSA),3,40,17,23,3
ZACATECAS,32,MOYAHUA DE ESTRADA,033,CUXPALA,3,68,38,30,4
ZACATECAS,32,MOYAHUA DE ESTRADA,033,EL LIMÓN,2,56,24,32,3
ZACATECAS,32,MOYAHUA DE ESTRADA,033,JESÚS MARÍA,1,15,8,7,1
ZACATECAS,32,MOYAHUA DE ESTRADA,033,LAS PALMAS,3,54,26,28,4
ZACATECAS,32,MOYAHUA DE ESTRADA,033,MOYAHUA DE ESTRADA,6,638,320,318,72
ZACATECAS,32,MOYAHUA DE ESTRADA,033,PALMAREJO,3,72,37,35,5
ZACATECAS,32,NOCHISTLÁN DE MEJÍA,034,BARRANCA DE MORENO,2,6,2,4,1
ZACATECAS,32,NOCHISTLÁN DE MEJÍA,034,CAPULÍN DE ABAJO,1,9,2,7,1
ZACATECAS,32,NOCHISTLÁN DE MEJÍA,034,CASAS GRANDES (SANTO DOMINGO),3,50,26,24,4
ZACATECAS,32,NOCHISTLÁN DE MEJÍA,034,DANIEL CAMARENA (LAS ÁNIMAS),3,117,56,61,8
ZACATECAS,32,NOCHISTLÁN DE MEJÍA,034,EL JAGÜEY,2,13,8,5,1
ZACATECAS,32,NOCHISTLÁN DE MEJÍA,034,EL MOLINO,3,26,11,15,3
ZACATECAS,32,NOCHISTLÁN DE MEJÍA,034,EL PORVENIR DEL NORTE (LOS ADOBES),2,13,6,7,2
ZACATECAS,32,NOCHISTLÁN DE MEJÍA,034,EL SITIO,3,18,7,11,3
ZACATECAS,32,NOCHISTLÁN DE MEJÍA,034,EMILIANO ZAPATA (PIEDRA PARADA),1,8,3,5,1
ZACATECAS,32,NOCHISTLÁN DE MEJÍA,034,LA CIÉNEGA,2,9,4,5,1
ZACATECAS,32,NOCHISTLÁN DE MEJÍA,034,LA COFRADÍA,3,79,29,50,4
ZACATECAS,32,NOCHISTLÁN DE MEJÍA,034,LA ESTANCIA,3,64,31,33,4
ZACATECAS,32,NOCHISTLÁN DE MEJÍA,034,LA JABONERA,3,38,19,19,3
ZACATECAS,32,NOCHISTLÁN DE MEJÍA,034,LA LABOR,2,15,6,9,2
ZACATECAS,32,NOCHISTLÁN DE MEJÍA,034,LA LAGUNA,2,8,3,5,1
ZACATECAS,32,NOCHISTLÁN DE MEJÍA,034,LA MAJADA,3,34,22,12,3
ZACATECAS,32,NOCHISTLÁN DE MEJÍA,034,LA NOCHE BUENA,1,13,6,7,1
ZACATECAS,32,NOCHISTLÁN DE MEJÍA,034,LA PORTILLA,1,17,7,10,1
ZACATECAS,32,NOCHISTLÁN DE MEJÍA,034,LA VILLITA,3,120,59,61,6
ZACATECAS,32,NOCHISTLÁN DE MEJÍA,034,LAS CRUCES,3,39,16,23,3
ZACATECAS,32,NOCHISTLÁN DE MEJÍA,034,LAS DELICIAS,3,132,57,75,7
ZACATECAS,32,NOCHISTLÁN DE MEJÍA,034,LAS HUERTAS,2,10,2,8,1
ZACATECAS,32,NOCHISTLÁN DE MEJÍA,034,LAS PRESITAS,1,5,4,1,1
ZACATECAS,32,NOCHISTLÁN DE MEJÍA,034,LAS TUZAS (TAJALOTA),1,5,4,1,1
ZACATECAS,32,NOCHISTLÁN DE MEJÍA,034,LLANO GRANDE,2,16,10,6,2
ZACATECAS,32,NOCHISTLÁN DE MEJÍA,034,LOS CARDOS,1,11,6,5,1
ZACATECAS,32,NOCHISTLÁN DE MEJÍA,034,LOS SANDOVALES,2,21,7,14,2
ZACATECAS,32,NOCHISTLÁN DE MEJÍA,034,MESA DE FRÍAS,3,21,13,8,3
ZACATECAS,32,NOCHISTLÁN DE MEJÍA,034,MESA DE LA PROVIDENCIA,1,9,5,4,1
ZACATECAS,32,NOCHISTLÁN DE MEJÍA,034,MOCTEZUMA,3,31,14,17,3
ZACATECAS,32,NOCHISTLÁN DE MEJÍA,034,NOCHISTLÁN DE MEJÍA,32,5285,2652,2633,275
ZACATECAS,32,NOCHISTLÁN DE MEJÍA,034,OJO DE AGUA DE LATAS,1,20,12,8,1
ZACATECAS,32,NOCHISTLÁN DE MEJÍA,034,PLAN DEL SAUZ,3,16,12,4,3
ZACATECAS,32,NOCHISTLÁN DE MEJÍA,034,PORVENIR DE ORIENTE,2,27,14,13,2
ZACATECAS,32,NOCHISTLÁN DE MEJÍA,034,TLACHICHILA,5,377,182,195,29
ZACATECAS,32,NOCHISTLÁN DE MEJÍA,034,TOYAHUA DE ABAJO,4,215,93,122,13
ZACATECAS,32,NOCHISTLÁN DE MEJÍA,034,TOYAHUA DE ARRIBA,3,141,74,67,6
ZACATECAS,32,NOCHISTLÁN DE MEJÍA,034,VALLECITOS,3,44,19,25,3
ZACATECAS,32,NOCHISTLÁN DE MEJÍA,034,VELADORES,2,30,11,19,2
ZACATECAS,32,NORIA DE ÁNGELES,035,COLONIA FRANCISCO I. MADERO,3,72,32,40,4
ZACATECAS,32,NORIA DE ÁNGELES,035,COLONIA INDEPENDENCIA (LA SOLEDAD),3,93,43,50,6
ZACATECAS,32,NORIA DE ÁNGELES,035,COLONIA MADERO (MADERO),3,223,98,125,12
ZACATECAS,32,NORIA DE ÁNGELES,035,COLONIA POZO COLORADO,2,55,29,26,3
ZACATECAS,32,NORIA DE ÁNGELES,035,COLONIA SAN FRANCISCO (SAN FRANCISCO),3,409,185,224,20
ZACATECAS,32,NORIA DE ÁNGELES,035,DE GUADALUPE [GRANJAS],2,36,14,22,2
ZACATECAS,32,NORIA DE ÁNGELES,035,EL LUCERO (SAN CARLOS),1,6,0,6,1
ZACATECAS,32,NORIA DE ÁNGELES,035,EL SALVADOR,3,19,12,7,3
ZACATECAS,32,NORIA DE ÁNGELES,035,EL TEPOZÁN,3,271,139,132,12
ZACATECAS,32,NORIA DE ÁNGELES,035,GENERAL GUADALUPE VICTORIA (ESTACIÓN LA HONDA),3,287,149,138,14
ZACATECAS,32,NORIA DE ÁNGELES,035,GENERAL LAURO G. CALOCA (EL RASCÓN),3,285,144,141,15
ZACATECAS,32,NORIA DE ÁNGELES,035,IGNACIO ZARAGOZA (SAN DIEGO),4,882,434,448,44
ZACATECAS,32,NORIA DE ÁNGELES,035,MARAVILLAS,4,849,442,407,69
ZACATECAS,32,NORIA DE ÁNGELES,035,NORIA DE ÁNGELES,7,375,193,182,23
ZACATECAS,32,NORIA DE ÁNGELES,035,PLAYAS DEL REFUGIO (HUERTAS DE MARAVILLAS),3,118,58,60,6
ZACATECAS,32,NORIA DE ÁNGELES,035,PUERTO DE JUAN ALBERTO,3,178,92,86,8
ZACATECAS,32,NORIA DE ÁNGELES,035,RANCHO NUEVO DE MORELOS (DE GUADALUPE),10,504,248,256,25
ZACATECAS,32,NORIA DE ÁNGELES,035,REAL DE ÁNGELES,2,16,9,7,2
ZACATECAS,32,NORIA DE ÁNGELES,035,SAN ANTONIO DE LA MULA,3,155,83,72,8
ZACATECAS,32,OJOCALIENTE,036,BOQUILLAS,2,14,6,8,2
ZACATECAS,32,OJOCALIENTE,036,BUENAVISTA,3,141,63,78,7
ZACATECAS,32,OJOCALIENTE,036,CERRITO DE LA CRUZ,4,441,241,200,21
ZACATECAS,32,OJOCALIENTE,036,CERRITO DEL AGUA,2,233,115,118,11
ZACATECAS,32,OJOCALIENTE,036,EL CHEPINQUE,3,42,26,16,4
ZACATECAS,32,OJOCALIENTE,036,EL REFUGIO,3,238,110,128,11
ZACATECAS,32,OJOCALIENTE,036,ESTACIÓN PALMIRA,3,69,33,36,4
ZACATECAS,32,OJOCALIENTE,036,JARILLAS (EX-HACIENDA DE JARILLAS),3,252,123,129,11
ZACATECAS,32,OJOCALIENTE,036,LA CAPILLA (SAN ISIDRO DE MORADILLAS),5,481,223,258,26
ZACATECAS,32,OJOCALIENTE,036,LA CONCEPCIÓN,3,335,163,172,20
ZACATECAS,32,OJOCALIENTE,036,LA LOMA LINDA (LA LOMA) [RANCHO],2,20,11,9,2
ZACATECAS,32,OJOCALIENTE,036,LA VERDE,2,24,14,10,2
ZACATECAS,32,OJOCALIENTE,036,LAS COLORADAS,3,145,65,80,7
ZACATECAS,32,OJOCALIENTE,036,LAS LAJAS,3,119,64,55,6
ZACATECAS,32,OJOCALIENTE,036,MILAGROS,4,327,145,182,19
ZACATECAS,32,OJOCALIENTE,036,NUEVO MUNDO,3,185,85,100,9
ZACATECAS,32,OJOCALIENTE,036,OJOCALIENTE,25,6382,3261,3121,398
ZACATECAS,32,OJOCALIENTE,036,PALMILLAS,3,203,98,105,11
ZACATECAS,32,OJOCALIENTE,036,PASTORÍA,4,217,102,115,14
ZACATECAS,32,OJOCALIENTE,036,PERALES,1,5,1,4,1
ZACATECAS,32,OJOCALIENTE,036,POZO DE JARILLAS,3,389,199,190,19
ZACATECAS,32,OJOCALIENTE,036,SAN ANTONIO DEL VOLCÁN (SAN ANTONIO),3,77,40,37,5
ZACATECAS,32,OJOCALIENTE,036,SAN BLAS DE COPUDAS (EL TILDÍO),3,73,40,33,4
ZACATECAS,32,OJOCALIENTE,036,SAN CRISTÓBAL,3,505,233,272,24
ZACATECAS,32,OJOCALIENTE,036,SAN JOSÉ DE LOS LLANOS,3,130,59,71,7
ZACATECAS,32,OJOCALIENTE,036,SAN JUAN DE CARBONERAS (SAN JUAN ZINHAUA),3,66,27,39,4
ZACATECAS,32,OJOCALIENTE,036,SANTO TOMÁS,3,60,35,25,4
ZACATECAS,32,OJOCALIENTE,036,SANTO TOMÁS VENADITOS (VENADITOS),3,241,124,117,11
ZACATECAS,32,OJOCALIENTE,036,SAUCEDA DE MULATOS,3,157,78,79,9
ZACATECAS,32,OJOCALIENTE,036,TLACOTES,3,136,78,58,7
ZACATECAS,32,PÁNUCO,037,CASA DE CERROS,3,261,127,134,12
ZACATECAS,32,PÁNUCO,037,EL ESPEJO,3,29,16,13,3
ZACATECAS,32,PÁNUCO,037,EL REY,1,8,6,2,1
ZACATECAS,32,PÁNUCO,037,EL TEPOZÁN,1,22,10,12,1
ZACATECAS,32,PÁNUCO,037,JESÚS MARÍA,3,70,36,34,4
ZACATECAS,32,PÁNUCO,037,LA INDIA,3,91,41,50,4
ZACATECAS,32,PÁNUCO,037,LAGUNA SECA,3,406,198,208,22
ZACATECAS,32,PÁNUCO,037,LLANO BLANCO NORTE,3,188,98,90,9
ZACATECAS,32,PÁNUCO,037,LLANO BLANCO SUR,1,3,1,2,1
ZACATECAS,32,PÁNUCO,037,LOS NÚMEROS,1,40,21,19,2
ZACATECAS,32,PÁNUCO,037,LOS POZOS,3,191,103,88,9
ZACATECAS,32,PÁNUCO,037,MULEROS,3,99,37,62,5
ZACATECAS,32,PÁNUCO,037,PÁNUCO,4,223,107,116,14
ZACATECAS,32,PÁNUCO,037,POZO DE GAMBOA,7,1494,766,728,56
ZACATECAS,32,PÁNUCO,037,PUENTE NUEVO (EL PUENTE MATA PULGAS),2,7,3,4,1
ZACATECAS,32,PÁNUCO,037,SAN ANTONIO DEL CIPRÉS,4,706,353,353,40
ZACATECAS,32,PÁNUCO,037,SAN JOSÉ DE LA ERA,1,18,10,8,1
ZACATECAS,32,PÁNUCO,037,SAN JUAN,4,260,135,125,15
ZACATECAS,32,PINOS,038,AGUA GORDA DE LOS PATOS,3,321,153,168,16
ZACATECAS,32,PINOS,038,AHIJADEROS,3,228,108,120,11
ZACATECAS,32,PINOS,038,ARROYO HONDO,3,48,26,22,3
ZACATECAS,32,PINOS,038,BUENAVISTA,4,267,134,133,13
ZACATECAS,32,PINOS,038,BUENAVISTA (BUENAVISTA DE LA PENDENCIA),3,49,19,30,3
ZACATECAS,32,PINOS,038,CAÑÓN DEL BALAZO,1,3,0,3,1
ZACATECAS,32,PINOS,038,CASTELLANOS (CASTELLANO DE ARRIBA),3,127,50,77,7
ZACATECAS,32,PINOS,038,CERRITO DE DOLORES,3,111,54,57,6
ZACATECAS,32,PINOS,038,CERRO DE LA BUFA (EL ENCINO),3,28,12,16,3
ZACATECAS,32,PINOS,038,CERRO GORDO,3,11,8,3,3
ZACATECAS,32,PINOS,038,CIENEGUILLA,4,140,73,67,9
ZACATECAS,32,PINOS,038,COLONIA BELISARIO DOMÍNGUEZ (LAS GÜERITAS),3,53,30,23,4
ZACATECAS,32,PINOS,038,COLONIA LOS CHÁVEZ,2,17,5,12,2
ZACATECAS,32,PINOS,038,COLONIA LOS ENCINITOS,3,127,64,63,6
ZACATECAS,32,PINOS,038,EL BAJÍO (EL BAJÍO DE MANUELILLO),3,38,21,17,4
ZACATECAS,32,PINOS,038,EL BRAVO,3,99,40,59,6
ZACATECAS,32,PINOS,038,EL CANALIZO,3,86,44,42,4
ZACATECAS,32,PINOS,038,EL CARMEN,3,104,53,51,6
ZACATECAS,32,PINOS,038,EL CHAPARRAL,3,83,40,43,4
ZACATECAS,32,PINOS,038,EL CHARQUILLO,2,12,7,5,2
ZACATECAS,32,PINOS,038,EL CHINO,3,216,109,107,11
ZACATECAS,32,PINOS,038,EL CHIQUIHUITILLO,3,72,30,42,4
ZACATECAS,32,PINOS,038,EL CHIRLÍN,2,9,7,2,1
ZACATECAS,32,PINOS,038,EL CONEJO,2,6,2,4,1
ZACATECAS,32,PINOS,038,EL COYOTE (FONSECA),3,31,12,19,4
ZACATECAS,32,PINOS,038,EL CUIJAL (SANTA LUCÍA),2,15,7,8,2
ZACATECAS,32,PINOS,038,EL GARABATILLO,2,8,6,2,2
ZACATECAS,32,PINOS,038,EL GOLPE,3,41,20,21,3
ZACATECAS,32,PINOS,038,EL HUIZACHE (POTRERILLOS),2,11,5,6,1
ZACATECAS,32,PINOS,038,EL JAIBITO,3,107,59,48,6
ZACATECAS,32,PINOS,038,EL LLANO,3,15,10,5,2
ZACATECAS,32,PINOS,038,EL MACHUCADO (COLONIA EL ROSARIO),3,88,38,50,4
ZACATECAS,32,PINOS,038,EL MEZQUITE,3,41,24,17,4
ZACATECAS,32,PINOS,038,EL NIGROMANTE,4,434,218,216,33
ZACATECAS,32,PINOS,038,EL OBRAJE,4,478,249,229,24
ZACATECAS,32,PINOS,038,EL PATROCINIO,3,71,32,39,4
ZACATECAS,32,PINOS,038,EL RAMONAL,3,174,91,83,9
ZACATECAS,32,PINOS,038,EL RAYO,6,147,71,76,9
ZACATECAS,32,PINOS,038,EL REMANENTE,3,74,44,30,4
ZACATECAS,32,PINOS,038,EL RINCÓN DE PIÑA,3,35,19,16,3
ZACATECAS,32,PINOS,038,EL SALITRE,2,25,15,10,3
ZACATECAS,32,PINOS,038,EL SALITRILLO,3,145,64,81,8
ZACATECAS,32,PINOS,038,EL SALTO,3,66,30,36,4
ZACATECAS,32,PINOS,038,EL SITIO,4,364,194,170,22
ZACATECAS,32,PINOS,038,EL TECOMATE,3,60,36,24,4
ZACATECAS,32,PINOS,038,EL ZACATAL,3,85,44,41,4
ZACATECAS,32,PINOS,038,EL ZAPATERO,2,9,5,4,1
ZACATECAS,32,PINOS,038,ESPÍRITU SANTO,4,340,172,168,17
ZACATECAS,32,PINOS,038,ESPÍRITU SANTO [ESTACIÓN],2,53,23,30,3
ZACATECAS,32,PINOS,038,ESQUINA DE DOLORES,2,5,1,4,2
ZACATECAS,32,PINOS,038,ESTANCIA DE GUADALUPE,4,531,271,260,27
ZACATECAS,32,PINOS,038,FRANCISCO GARCÍA SALINAS (PRESA SAN PABLO),3,55,29,26,4
ZACATECAS,32,PINOS,038,GUADALUPE DE LOS POZOS,3,70,43,27,5
ZACATECAS,32,PINOS,038,GUADALUPE DE LOS SAUCES,3,216,105,111,10
ZACATECAS,32,PINOS,038,GUADALUPE VICTORIA (TIERRA BOFA),3,126,70,56,6
ZACATECAS,32,PINOS,038,HUERTAS DEL MEZQUITE,3,156,75,81,8
ZACATECAS,32,PINOS,038,JALTOMATE,2,129,60,69,7
ZACATECAS,32,PINOS,038,JAULA DE ABAJO,4,269,123,146,16
ZACATECAS,32,PINOS,038,JAULA DE ARRIBA,3,148,74,74,9
ZACATECAS,32,PINOS,038,JESÚS MARÍA SUR (SAN ANTONIO DE LA CRUZ),2,12,3,9,2
ZACATECAS,32,PINOS,038,JOSÉ MARÍA MORELOS (POZO DE LOS RATONES),3,191,91,100,9
ZACATECAS,32,PINOS,038,JOSÉ MARÍA PINO SUÁREZ (LA COLORADA),4,498,274,224,44
ZACATECAS,32,PINOS,038,LA BLANCA (CHIHUAHUA),3,196,87,109,11
ZACATECAS,32,PINOS,038,LA BOQUILLA (PALO COLORADO),2,12,8,4,1
ZACATECAS,32,PINOS,038,LA CALERILLA,2,13,4,9,2
ZACATECAS,32,PINOS,038,LA CARBONERA,3,30,19,11,3
ZACATECAS,32,PINOS,038,LA CHIQUILLA,3,69,40,29,4
ZACATECAS,32,PINOS,038,LA CIENEGUITA,1,22,7,15,1
ZACATECAS,32,PINOS,038,LA CRUZ,3,70,32,38,4
ZACATECAS,32,PINOS,038,LA CUADRILLA,2,90,49,41,5
ZACATECAS,32,PINOS,038,LA CUESTA,1,18,5,13,1
ZACATECAS,32,PINOS,038,LA ENCARNACIÓN,2,6,1,5,1
ZACATECAS,32,PINOS,038,LA ESCONDIDA (CERRITO DEL CALVARIO),3,40,19,21,4
ZACATECAS,32,PINOS,038,LA ESMERALDA,3,38,15,23,3
ZACATECAS,32,PINOS,038,LA ESTRELLA,3,228,116,112,11
ZACATECAS,32,PINOS,038,LA JAULILLA,3,88,38,50,6
ZACATECAS,32,PINOS,038,LA JOYA,3,45,16,29,3
ZACATECAS,32,PINOS,038,LA LABORCILLA,3,207,112,95,11
ZACATECAS,32,PINOS,038,LA LOBEÑA,3,225,110,115,12
ZACATECAS,32,PINOS,038,LA MAZAMORRA,3,49,22,27,4
ZACATECAS,32,PINOS,038,LA MESILLA,3,72,38,34,4
ZACATECAS,32,PINOS,038,LA PACHONA (SAN ANDRÉS),3,124,54,70,6
ZACATECAS,32,PINOS,038,LA PENDENCIA,4,399,201,198,23
ZACATECAS,32,PINOS,038,LA PIEDRERA,3,22,14,8,3
ZACATECAS,32,PINOS,038,LA PRESA DE SAN JOSÉ,3,70,38,32,5
ZACATECAS,32,PINOS,038,LA PRESITA,3,106,49,57,6
ZACATECAS,32,PINOS,038,LA PUERTA DE LA PETACA,2,19,8,11,3
ZACATECAS,32,PINOS,038,LA PUERTA DE LOS CENIZOS,2,6,4,2,1
ZACATECAS,32,PINOS,038,LA PURÍSIMA,3,62,35,27,4
ZACATECAS,32,PINOS,038,LA PURÍSIMA (LA PURÍSIMA SUR),2,119,54,65,7
ZACATECAS,32,PINOS,038,LA VAQUITA,3,120,61,59,6
ZACATECAS,32,PINOS,038,LA VENTA DE SAN AGUSTÍN,1,10,3,7,1
ZACATECAS,32,PINOS,038,LA VICTORIA,4,611,323,288,33
ZACATECAS,32,PINOS,038,LAS CABRAS,3,62,24,38,5
ZACATECAS,32,PINOS,038,LAS JABONERAS,2,11,5,6,1
ZACATECAS,32,PINOS,038,LAS MEZCLITAS (LA MEZCLITA),3,40,15,25,3
ZACATECAS,32,PINOS,038,LAS MORADAS,3,31,17,14,3
ZACATECAS,32,PINOS,038,LAS PILAS,3,27,11,16,3
ZACATECAS,32,PINOS,038,LAS POLLAS,3,108,58,50,6
ZACATECAS,32,PINOS,038,LOMA LINDA,2,27,15,12,2
ZACATECAS,32,PINOS,038,LOS ALPES,3,28,13,15,3
ZACATECAS,32,PINOS,038,LOS ARQUITOS,3,140,77,63,6
ZACATECAS,32,PINOS,038,LOS CORREDORES,1,6,2,4,1
ZACATECAS,32,PINOS,038,LOS CUATES,2,13,6,7,2
ZACATECAS,32,PINOS,038,MANUEL MARÍA,3,75,36,39,4
ZACATECAS,32,PINOS,038,MESA DE LA TORTUGA,2,7,4,3,1
ZACATECAS,32,PINOS,038,MESA LOS TANQUES,2,5,2,3,1
ZACATECAS,32,PINOS,038,NORIA DE SAN PABLO (SAN PABLO),2,46,18,28,3
ZACATECAS,32,PINOS,038,OJO DE AGUA DE LA PALMA,3,209,96,113,10
ZACATECAS,32,PINOS,038,PASO BLANCO,2,34,13,21,3
ZACATECAS,32,PINOS,038,PASTORES,2,18,6,12,2
ZACATECAS,32,PINOS,038,PEDREGOSO,4,845,442,403,64
ZACATECAS,32,PINOS,038,PINOS,12,2308,1182,1126,153
ZACATECAS,32,PINOS,038,PRESA NUEVA,3,155,74,81,8
ZACATECAS,32,PINOS,038,PUEBLITO DE GUADALUPE (EL PUEBLITO),3,66,37,29,4
ZACATECAS,32,PINOS,038,PURÍSIMA DE ABAJO,1,26,14,12,2
ZACATECAS,32,PINOS,038,PURÍSIMA DEL SALTO DE ARRIBA,3,51,26,25,5
ZACATECAS,32,PINOS,038,REFUGIO DE LOS ORTIZ,3,209,108,101,10
ZACATECAS,32,PINOS,038,SALDAÑA,3,226,119,107,11
ZACATECAS,32,PINOS,038,SAN ANDRÉS,3,250,125,125,11
ZACATECAS,32,PINOS,038,SAN ANTONIO DE LAS NUECES,3,30,16,14,3
ZACATECAS,32,PINOS,038,SAN CARLOS,3,55,24,31,4
ZACATECAS,32,PINOS,038,SAN CRISTÓBAL,3,40,19,21,4
ZACATECAS,32,PINOS,038,SAN GIL (LOS LADRILLOS),2,5,5,0,1
ZACATECAS,32,PINOS,038,SAN IGNACIO,1,1,0,1,1
ZACATECAS,32,PINOS,038,SAN ISIDRO,2,3,2,1,2
ZACATECAS,32,PINOS,038,SAN JOAQUÍN,1,22,13,9,1
ZACATECAS,32,PINOS,038,SAN JOSÉ DE BERNALEJO,3,131,72,59,6
ZACATECAS,32,PINOS,038,SAN JOSÉ DE CASTELLANOS,4,568,295,273,27
ZACATECAS,32,PINOS,038,SAN JOSÉ DE ESPÍRITU SANTO,3,58,35,23,3
ZACATECAS,32,PINOS,038,SAN JOSÉ DE LA VENTA,3,181,85,96,9
ZACATECAS,32,PINOS,038,SAN JUAN DE LA PALMA,2,15,10,5,2
ZACATECAS,32,PINOS,038,SAN JUAN DE LOS HERRERA,3,35,20,15,3
ZACATECAS,32,PINOS,038,SAN MANUEL,3,38,17,21,4
ZACATECAS,32,PINOS,038,SAN MARTÍN,4,192,103,89,12
ZACATECAS,32,PINOS,038,SAN MIGUEL (SAN MIGUEL DEL ZACATAL),3,89,43,46,4
ZACATECAS,32,PINOS,038,SAN RAFAEL DE LOS ALEMÁN (SAN RAFAEL),3,32,16,16,3
ZACATECAS,32,PINOS,038,SANTA ANA,4,605,290,315,27
ZACATECAS,32,PINOS,038,SANTA ELENA,4,441,221,220,22
ZACATECAS,32,PINOS,038,SANTA FE,3,68,38,30,4
ZACATECAS,32,PINOS,038,SANTA GENOVEVA,1,6,3,3,1
ZACATECAS,32,PINOS,038,SANTA GERTRUDIS,3,204,97,107,12
ZACATECAS,32,PINOS,038,SANTIAGO,3,474,219,255,23
ZACATECAS,32,PINOS,038,SAUCILLO,2,13,6,7,2
ZACATECAS,32,PINOS,038,SAUCITO DE ESCAJEDO (CIENEGUILLA),2,15,10,5,2
ZACATECAS,32,PINOS,038,SAUZ DE SAN MARTÍN,3,36,23,13,3
ZACATECAS,32,PINOS,038,TOLOSA,4,239,117,122,13
ZACATECAS,32,PINOS,038,TRINIDAD DE BUENAVISTA (LA TRINIDAD),3,121,64,57,6
ZACATECAS,32,PINOS,038,TRINIDAD NORTE,3,127,62,65,6
ZACATECAS,32,PINOS,038,VÍA CORTA EL PATROCINIO,3,17,7,10,3
ZACATECAS,32,PINOS,038,VÍCTOR ROSALES (LA PAZ),3,89,38,51,5
ZACATECAS,32,RÍO GRANDE,039,ANASTASIO V. HINOJOSA,3,65,31,34,4
ZACATECAS,32,RÍO GRANDE,039,BOQUILLA DE ARRIBA,4,347,170,177,17
ZACATECAS,32,RÍO GRANDE,039,CIÉNEGA Y MANCILLAS,4,167,68,99,11
ZACATECAS,32,RÍO GRANDE,039,EL CAÑÓN (LOS TORRES) [RANCHO],3,20,10,10,3
ZACATECAS,32,RÍO GRANDE,039,EL FUERTE,3,485,247,238,21
ZACATECAS,32,RÍO GRANDE,039,EMILIANO ZAPATA (MORONES),5,488,258,230,23
ZACATECAS,32,RÍO GRANDE,039,FRANCISCO GARCÍA SALINAS,3,314,161,153,18
ZACATECAS,32,RÍO GRANDE,039,GUADALUPE (EX-HACIENDA DE GUADALUPE),2,23,14,9,2
ZACATECAS,32,RÍO GRANDE,039,IGNACIO LÓPEZ RAYÓN (LOS DELGADO),3,94,40,54,5
ZACATECAS,32,RÍO GRANDE,039,IGNACIO ZARAGOZA (LA RASTRERA),4,111,51,60,6
ZACATECAS,32,RÍO GRANDE,039,JOSÉ MARÍA MORELOS Y PAVÓN (LA ALMOLOYA),3,644,323,321,39
ZACATECAS,32,RÍO GRANDE,039,LA FLORIDA,3,190,100,90,10
ZACATECAS,32,RÍO GRANDE,039,LAS ESPERANZAS (EL RANCHITO),2,372,160,212,18
ZACATECAS,32,RÍO GRANDE,039,LAS PIEDRAS,3,129,59,70,7
ZACATECAS,32,RÍO GRANDE,039,LORETO,4,528,242,286,33
ZACATECAS,32,RÍO GRANDE,039,LOS CONDE,3,366,179,187,21
ZACATECAS,32,RÍO GRANDE,039,LOS MÁRQUEZ,3,56,27,29,4
ZACATECAS,32,RÍO GRANDE,039,LOS RAMÍREZ,3,392,176,216,22
ZACATECAS,32,RÍO GRANDE,039,LOS RODRÍGUEZ,2,14,6,8,2
ZACATECAS,32,RÍO GRANDE,039,NORIA DEL BOYERO,3,153,75,78,7
ZACATECAS,32,RÍO GRANDE,039,PASTELERA,3,233,122,111,12
ZACATECAS,32,RÍO GRANDE,039,PROGRESO DE ALFONSO MEDINA (COLONIA PROGRESO),4,440,224,216,31
ZACATECAS,32,RÍO GRANDE,039,RÍO GRANDE,56,10941,5550,5391,723
ZACATECAS,32,RÍO GRANDE,039,SAN FELIPE,3,224,94,130,11
ZACATECAS,32,RÍO GRANDE,039,TETILLAS (EX-HACIENDA DE TETILLAS),4,366,186,180,24
ZACATECAS,32,RÍO GRANDE,039,TIERRA BLANCA,3,109,56,53,6
ZACATECAS,32,SAIN ALTO,040,ATOTONILCO,1,17,11,6,1
ZACATECAS,32,SAIN ALTO,040,BARRANCAS,3,221,101,120,11
ZACATECAS,32,SAIN ALTO,040,CANTUNA,3,210,93,117,12
ZACATECAS,32,SAIN ALTO,040,CAÑAS,3,340,175,165,16
ZACATECAS,32,SAIN ALTO,040,EL CAZADERO,4,472,224,248,24
ZACATECAS,32,SAIN ALTO,040,EL FRAYLE,3,13,5,8,3
ZACATECAS,32,SAIN ALTO,040,EL FRESNO,3,256,124,132,13
ZACATECAS,32,SAIN ALTO,040,EL LINDERO,3,5,3,2,2
ZACATECAS,32,SAIN ALTO,040,EL MOLINO,2,6,3,3,2
ZACATECAS,32,SAIN ALTO,040,EL NUEVO SAUCILLO,2,7,4,3,1
ZACATECAS,32,SAIN ALTO,040,EL SAUZ,3,105,45,60,7
ZACATECAS,32,SAIN ALTO,040,EMILIANO ZAPATA (SAN JOSÉ),3,498,234,264,22
ZACATECAS,32,SAIN ALTO,040,FRANCISCO I. MADERO (SAN ISIDRO),3,120,55,65,6
ZACATECAS,32,SAIN ALTO,040,JOSÉ MARÍA MORELOS (SANTA MÓNICA),3,337,171,166,15
ZACATECAS,32,SAIN ALTO,040,LA LABORCITA,3,151,77,74,8
ZACATECAS,32,SAIN ALTO,040,LAGUNA BLANCA (LA LAGUNA BLANCA),1,12,5,7,1
ZACATECAS,32,SAIN ALTO,040,LUIS MOYA,3,138,70,68,7
ZACATECAS,32,SAIN ALTO,040,MERCURIO (MINA MERCURIO),3,177,90,87,8
ZACATECAS,32,SAIN ALTO,040,MESA DE LA CRUZ (LA CRUZ),1,11,5,6,1
ZACATECAS,32,SAIN ALTO,040,MIGUEL HIDALGO (LAS CUEVAS),3,107,50,57,4
ZACATECAS,32,SAIN ALTO,040,NICOLÁS BRAVO (SAN NICOLÁS),3,219,110,109,10
ZACATECAS,32,SAIN ALTO,040,QUINCE DE SEPTIEMBRE (SANTA ROSA),3,42,22,20,3
ZACATECAS,32,SAIN ALTO,040,RÍO DE MEDINA,4,546,260,286,28
ZACATECAS,32,SAIN ALTO,040,SAIN ALTO,10,1820,973,847,77
ZACATECAS,32,SAIN ALTO,040,SAÍN BAJO,3,311,149,162,16
ZACATECAS,32,SAIN ALTO,040,SAN ANTONIO DEL ÁLAMO,2,4,1,3,1
ZACATECAS,32,SAIN ALTO,040,SAN RAFAEL,3,14,6,8,2
ZACATECAS,32,SAIN ALTO,040,SANTA EDUVIGES,1,1,0,1,1
ZACATECAS,32,EL SALVADOR,041,CLAVELLINAS,3,71,35,36,5
ZACATECAS,32,EL SALVADOR,041,EL SALVADOR,5,257,136,121,19
ZACATECAS,32,EL SALVADOR,041,GENERAL GERTRUDIS SÁNCHEZ (SANTA RITA),2,16,7,9,2
ZACATECAS,32,EL SALVADOR,041,MATEHUAPIL (EL MACHETAZO),3,29,13,16,3
ZACATECAS,32,EL SALVADOR,041,OJO DE AGUA (OJO DE AGUA DEL CAPULÍN),1,10,2,8,1
ZACATECAS,32,EL SALVADOR,041,TANQUE NUEVO,4,246,128,118,15
ZACATECAS,32,SOMBRERETE,042,AGUA ZARCA,3,128,55,73,6
ZACATECAS,32,SOMBRERETE,042,ALFREDO V. BONFIL (ALFREDO BONFIL),3,100,44,56,7
ZACATECAS,32,SOMBRERETE,042,ÁLVARO OBREGÓN (BARAJAS),3,104,47,57,6
ZACATECAS,32,SOMBRERETE,042,BENITO JUÁREZ,3,203,98,105,8
ZACATECAS,32,SOMBRERETE,042,BERROS Y OJO SANTO,3,103,50,53,7
ZACATECAS,32,SOMBRERETE,042,BUENAVISTA,3,20,13,7,3
ZACATECAS,32,SOMBRERETE,042,CHARCO BLANCO,4,644,324,320,43
ZACATECAS,32,SOMBRERETE,042,COLONIA AQUILES SERDÁN,2,32,13,19,2
ZACATECAS,32,SOMBRERETE,042,COLONIA CUAUHTÉMOC (SANTA CATARINA),4,206,98,108,13
ZACATECAS,32,SOMBRERETE,042,COLONIA EL ORIÓN,2,23,6,17,2
ZACATECAS,32,SOMBRERETE,042,COLONIA FELIPE ÁNGELES (EL BARRANCO),4,197,98,99,14
ZACATECAS,32,SOMBRERETE,042,COLONIA FLORES GARCÍA,3,235,118,117,11
ZACATECAS,32,SOMBRERETE,042,COLONIA GONZÁLEZ ORTEGA,6,1328,689,639,72
ZACATECAS,32,SOMBRERETE,042,CORRALES,4,280,130,150,15
ZACATECAS,32,SOMBRERETE,042,DOROTEO ARANGO (GATAS MOCHAS),3,57,31,26,4
ZACATECAS,32,SOMBRERETE,042,EJIDO INDEPENDENCIA (EL CAPRICHO),3,83,33,50,4
ZACATECAS,32,SOMBRERETE,042,EJIDO ZARAGOZA (FRANCISCO R. MURGUÍA),2,189,101,88,9
ZACATECAS,32,SOMBRERETE,042,EL ASTILLERO,2,12,4,8,2
ZACATECAS,32,SOMBRERETE,042,EL ESCRITORIO,2,5,1,4,1
ZACATECAS,32,SOMBRERETE,042,EL SAUCILLO,3,44,28,16,3
ZACATECAS,32,SOMBRERETE,042,EL SAUZ DEL TERRERO,3,91,47,44,4
ZACATECAS,32,SOMBRERETE,042,EMILIANO ZAPATA (JUANES),3,154,65,89,7
ZACATECAS,32,SOMBRERETE,042,ESTANCIA DE GUADALUPE,3,109,54,55,7
ZACATECAS,32,SOMBRERETE,042,FELIPE ÁNGELES (LA ESTANCIA),1,28,9,19,2
ZACATECAS,32,SOMBRERETE,042,FELIPE CARRILLO PUERTO (EL ARENAL),3,147,77,70,7
ZACATECAS,32,SOMBRERETE,042,FRANCISCO I. MADERO (JUANES),3,50,26,24,3
ZACATECAS,32,SOMBRERETE,042,FRANCISCO VILLA (LA BOQUILLA),3,32,12,20,3
ZACATECAS,32,SOMBRERETE,042,GENERAL FRANCISCO R. MURGUÍA,2,20,9,11,2
ZACATECAS,32,SOMBRERETE,042,HIDALGO (COLONIA HIDALGO),4,835,430,405,50
ZACATECAS,32,SOMBRERETE,042,IGNACIO ALLENDE,3,87,42,45,5
ZACATECAS,32,SOMBRERETE,042,IGNACIO ZARAGOZA (COLONIA IGNACIO ZARAGOZA),3,234,117,117,12
ZACATECAS,32,SOMBRERETE,042,IGNACIO ZARAGOZA (ESTACIÓN FRÍO),3,115,59,56,5
ZACATECAS,32,SOMBRERETE,042,JOSÉ MARÍA MORELOS (MORELOS),3,159,75,84,8
ZACATECAS,32,SOMBRERETE,042,JOSÉ SANTOS BAÑUELOS (BAÑUELOS NUEVO),5,444,227,217,21
ZACATECAS,32,SOMBRERETE,042,LA PURÍSIMA,2,6,3,3,1
ZACATECAS,32,SOMBRERETE,042,LAS HUERTAS (LA HUERTA DE LOS SANTOS NIÑOS),2,206,93,113,7
ZACATECAS,32,SOMBRERETE,042,LO DE MENA,3,58,23,35,4
ZACATECAS,32,SOMBRERETE,042,LOS PACHECO,2,6,4,2,1
ZACATECAS,32,SOMBRERETE,042,LUIS MOYA,2,31,16,15,2
ZACATECAS,32,SOMBRERETE,042,MILPILLAS,1,41,17,24,2
ZACATECAS,32,SOMBRERETE,042,NICOLÁS FERNÁNDEZ CARRILLO (MATEO GÓMEZ),4,185,94,91,12
ZACATECAS,32,SOMBRERETE,042,NIÑO ARTILLERO,3,69,39,30,4
ZACATECAS,32,SOMBRERETE,042,NORIA SAN PANTALEÓN (LA NORIA),2,6,2,4,1
ZACATECAS,32,SOMBRERETE,042,OJO DE AGUA,2,76,33,43,4
ZACATECAS,32,SOMBRERETE,042,OJO DE AGUA LA BATEA,3,53,36,17,4
ZACATECAS,32,SOMBRERETE,042,PLAN DE GUADALUPE,3,104,52,52,6
ZACATECAS,32,SOMBRERETE,042,PROAÑO,1,4,3,1,1
ZACATECAS,32,SOMBRERETE,042,PROVIDENCIA,1,6,5,1,1
ZACATECAS,32,SOMBRERETE,042,QUINCE DE ENERO,3,65,30,35,4
ZACATECAS,32,SOMBRERETE,042,RANCHO NUEVO DEL CARMEN (RANCHO NUEVO),3,17,7,10,3
ZACATECAS,32,SOMBRERETE,042,REFUGIO DE LOS POZOS,3,67,37,30,4
ZACATECAS,32,SOMBRERETE,042,RICARDO FLORES MAGÓN (LA CIÉNEGA),3,170,88,82,8
ZACATECAS,32,SOMBRERETE,042,SALAS PÉREZ,2,27,14,13,2
ZACATECAS,32,SOMBRERETE,042,SAN AGUSTÍN (SAN AGUSTÍN DE LA VICTORIA),2,16,6,10,2
ZACATECAS,32,SOMBRERETE,042,SAN ANTONIO DEL CERRITO (EL CERRITO),3,43,19,24,3
ZACATECAS,32,SOMBRERETE,042,SAN ANTONIO DEL TEPETATE,2,22,11,11,2
ZACATECAS,32,SOMBRERETE,042,SAN FRANCISCO DE LAS FLORES (EL RANCHITO),2,6,4,2,1
ZACATECAS,32,SOMBRERETE,042,SAN FRANCISCO DE ÓRGANOS,3,55,33,22,4
ZACATECAS,32,SOMBRERETE,042,SAN JERÓNIMO DE SAUCES (SAUCES),2,20,11,9,2
ZACATECAS,32,SOMBRERETE,042,SAN JOSÉ DE CANUTILLO (CANUTILLO),3,23,18,5,3
ZACATECAS,32,SOMBRERETE,042,SAN JOSÉ DE FÉLIX,3,297,142,155,15
ZACATECAS,32,SOMBRERETE,042,SAN JOSÉ DE LA PARADA (FELIPE ÁNGELES UNO),4,78,38,40,5
ZACATECAS,32,SOMBRERETE,042,SAN JOSÉ DE MESILLAS (MESILLAS),3,74,39,35,4
ZACATECAS,32,SOMBRERETE,042,SAN JOSÉ DE RANCHOS (RANCHOS),3,176,83,93,9
ZACATECAS,32,SOMBRERETE,042,SAN JUAN DE LA TAPIA (LA TAPIA),3,99,54,45,5
ZACATECAS,32,SOMBRERETE,042,SAN JUAN DE LOS HORNILLOS (SAN JUAN DEL R.),2,11,6,5,2
ZACATECAS,32,SOMBRERETE,042,SAN MARTÍN,4,349,181,168,20
ZACATECAS,32,SOMBRERETE,042,SAN MIGUEL DE LA HERRADURA,2,15,8,7,2
ZACATECAS,32,SOMBRERETE,042,SAN PASCUAL,1,12,6,6,1
ZACATECAS,32,SOMBRERETE,042,SAN PEDRO CHUPADEROS (CHUPADEROS),3,35,15,20,3
ZACATECAS,32,SOMBRERETE,042,SAN RAFAEL,1,2,2,0,0
ZACATECAS,32,SOMBRERETE,042,SANTA LUCÍA,3,101,45,56,5
ZACATECAS,32,SOMBRERETE,042,SANTIAGO DE LA HERRADURA,3,40,19,21,3
ZACATECAS,32,SOMBRERETE,042,SOMBRERETE,33,7728,3917,3811,401
ZACATECAS,32,SOMBRERETE,042,VEINTE DE NOVIEMBRE (SAN JOSÉ DE LA ESTANCIA),3,36,12,24,3
ZACATECAS,32,SOMBRERETE,042,VERGELITOS,2,8,5,3,1
ZACATECAS,32,SOMBRERETE,042,VILLA INSURGENTES (EL CALABAZAL),3,289,140,149,22
ZACATECAS,32,SUSTICACÁN,043,EL CHIQUIHUITE,3,52,28,24,3
ZACATECAS,32,SUSTICACÁN,043,LOS CUERVOS,2,13,7,6,2
ZACATECAS,32,SUSTICACÁN,043,SUSTICACÁN,4,193,90,103,12
ZACATECAS,32,TABASCO,044,AGUA BLANCA,3,49,22,27,3
ZACATECAS,32,TABASCO,044,AGUACATE DE ABAJO,3,93,41,52,4
ZACATECAS,32,TABASCO,044,AGUACATE DE ARRIBA,3,37,25,12,3
ZACATECAS,32,TABASCO,044,CIÉNEGA DE ABAJO,2,78,33,45,4
ZACATECAS,32,TABASCO,044,CIÉNEGA DE ARRIBA,3,68,41,27,4
ZACATECAS,32,TABASCO,044,COLONIA PEDRO RAYGOZA (LOS SAUCES),4,141,68,73,9
ZACATECAS,32,TABASCO,044,COSALIMA (SAN JOSÉ DE COSALIMA),3,87,43,44,4
ZACATECAS,32,TABASCO,044,COYOQUE,3,81,35,46,5
ZACATECAS,32,TABASCO,044,CRUZ VERDE,1,9,5,4,1
ZACATECAS,32,TABASCO,044,EL JARALILLO,3,80,40,40,5
ZACATECAS,32,TABASCO,044,EL RODEO,2,49,23,26,3
ZACATECAS,32,TABASCO,044,HUISCOLCO,4,239,112,127,13
ZACATECAS,32,TABASCO,044,LOS ENCINOS,1,6,0,6,1
ZACATECAS,32,TABASCO,044,SAN FRANCISCO,2,24,12,12,2
ZACATECAS,32,TABASCO,044,SAN JOSÉ TENANGUILLO,1,99,55,44,5
ZACATECAS,32,TABASCO,044,SAN LUIS DE CUSTIQUE,3,272,141,131,12
ZACATECAS,32,TABASCO,044,SANTIAGO EL CHIQUE (EL CHIQUE),6,584,287,297,31
ZACATECAS,32,TABASCO,044,TABASCO,11,1920,959,961,100
ZACATECAS,32,TABASCO,044,TENANGUILLO,3,227,113,114,11
ZACATECAS,32,TABASCO,044,TIERRA BLANCA,2,24,11,13,2
ZACATECAS,32,TABASCO,044,VARAL DE ABAJO (EL VARAL),3,24,15,9,3
ZACATECAS,32,TEPECHITLÁN,045,CARRETONES,1,5,2,3,1
ZACATECAS,32,TEPECHITLÁN,045,CERRO CHINO,3,42,22,20,3
ZACATECAS,32,TEPECHITLÁN,045,EL TERRERO,2,24,11,13,2
ZACATECAS,32,TEPECHITLÁN,045,LA HIERBABUENA,2,9,5,4,2
ZACATECAS,32,TEPECHITLÁN,045,LA VILLITA,3,80,41,39,5
ZACATECAS,32,TEPECHITLÁN,045,LAS PILAS,1,10,6,4,1
ZACATECAS,32,TEPECHITLÁN,045,LOS RAMÍREZ,1,5,2,3,1
ZACATECAS,32,TEPECHITLÁN,045,RANCHO NUEVO,1,9,5,4,1
ZACATECAS,32,TEPECHITLÁN,045,SAN JOSÉ DE BUENAVISTA,2,6,4,2,1
ZACATECAS,32,TEPECHITLÁN,045,SAN PEDRO OCOTLÁN,4,236,118,118,14
ZACATECAS,32,TEPECHITLÁN,045,SANTIAGO NEXCALTITÁN,3,41,26,15,3
ZACATECAS,32,TEPECHITLÁN,045,TALESTEIPA,2,70,32,38,3
ZACATECAS,32,TEPECHITLÁN,045,TEPECHITLÁN,9,1641,831,810,139
ZACATECAS,32,TEPECHITLÁN,045,VILLA JUÁREZ (EL TECOLOTE),3,30,17,13,3
ZACATECAS,32,TEPETONGO,046,ARROYO SECO DE ABAJO,2,24,11,13,2
ZACATECAS,32,TEPETONGO,046,ARROYO SECO DE ARRIBA,1,7,2,5,1
ZACATECAS,32,TEPETONGO,046,BUENAVISTA,4,226,107,119,13
ZACATECAS,32,TEPETONGO,046,CAPULÍN DE LOS SALINAS,3,22,14,8,3
ZACATECAS,32,TEPETONGO,046,EL ALAMITO,1,4,3,1,1
ZACATECAS,32,TEPETONGO,046,EL CUIDADO,3,42,14,28,4
ZACATECAS,32,TEPETONGO,046,EL LAUREL,1,9,5,4,1
ZACATECAS,32,TEPETONGO,046,EL SALITRE,2,12,7,5,2
ZACATECAS,32,TEPETONGO,046,ESTANCIA DE LOS BERUMEN,2,23,10,13,2
ZACATECAS,32,TEPETONGO,046,IGNACIO ZARAGOZA (ZARAGOZA),3,23,8,15,3
ZACATECAS,32,TEPETONGO,046,JUANCHORREY,2,8,3,5,2
ZACATECAS,32,TEPETONGO,046,LA LECHUGUILLA (IGNACIO ZARAGOZA),2,23,14,9,2
ZACATECAS,32,TEPETONGO,046,LA TROJE,3,55,28,27,4
ZACATECAS,32,TEPETONGO,046,LA TROJITA,1,11,4,7,1
ZACATECAS,32,TEPETONGO,046,LOS APARICIO,1,5,0,5,1
ZACATECAS,32,TEPETONGO,046,SAN PASCUAL,1,6,2,4,1
ZACATECAS,32,TEPETONGO,046,SAN TADEO,2,30,16,14,2
ZACATECAS,32,TEPETONGO,046,TEPETONGO,5,564,281,283,35
ZACATECAS,32,TEPETONGO,046,VÍBORAS,3,116,56,60,7
ZACATECAS,32,TEÚL DE GONZÁLEZ ORTEGA,047,COLONIA ALAMITOS (LOS ÁLAMOS),3,30,14,16,3
ZACATECAS,32,TEÚL DE GONZÁLEZ ORTEGA,047,HACIENDA DE GUADALUPE,2,28,12,16,2
ZACATECAS,32,TEÚL DE GONZÁLEZ ORTEGA,047,HUITZILA,4,212,116,96,14
ZACATECAS,32,TEÚL DE GONZÁLEZ ORTEGA,047,LA LOBERA,2,18,9,9,2
ZACATECAS,32,TEÚL DE GONZÁLEZ ORTEGA,047,LOMA ALTA,2,5,2,3,1
ZACATECAS,32,TEÚL DE GONZÁLEZ ORTEGA,047,MILPILLAS DE ALLENDE,4,126,59,67,8
ZACATECAS,32,TEÚL DE GONZÁLEZ ORTEGA,047,PALO ALTO,3,31,19,12,3
ZACATECAS,32,TEÚL DE GONZÁLEZ ORTEGA,047,ROSA MARÍA,2,7,4,3,1
ZACATECAS,32,TEÚL DE GONZÁLEZ ORTEGA,047,TEÚL DE GONZÁLEZ ORTEGA,7,848,432,416,51
ZACATECAS,32,TLALTENANGO DE SÁNCHEZ ROMÁN,048,AGUAJES DE ARRIBA,2,9,3,6,2
ZACATECAS,32,TLALTENANGO DE SÁNCHEZ ROMÁN,048,BANCO DE AGUA BLANCA,2,34,18,16,2
ZACATECAS,32,TLALTENANGO DE SÁNCHEZ ROMÁN,048,CANOAS,1,5,3,2,1
ZACATECAS,32,TLALTENANGO DE SÁNCHEZ ROMÁN,048,CARRIZALILLO,3,40,22,18,3
ZACATECAS,32,TLALTENANGO DE SÁNCHEZ ROMÁN,048,CICACALCO,4,298,145,153,17
ZACATECAS,32,TLALTENANGO DE SÁNCHEZ ROMÁN,048,CONTRERAS,3,26,14,12,4
ZACATECAS,32,TLALTENANGO DE SÁNCHEZ ROMÁN,048,EL AGUACATE,3,17,7,10,3
ZACATECAS,32,TLALTENANGO DE SÁNCHEZ ROMÁN,048,EL PUERTECITO,1,5,4,1,1
ZACATECAS,32,TLALTENANGO DE SÁNCHEZ ROMÁN,048,EL SAUZ MOCHO,3,32,18,14,3
ZACATECAS,32,TLALTENANGO DE SÁNCHEZ ROMÁN,048,FRACCIONAMIENTO SANTO SANTIAGO,1,109,53,56,5
ZACATECAS,32,TLALTENANGO DE SÁNCHEZ ROMÁN,048,GUADALUPE VICTORIA (LA MEZQUITERA),3,32,11,21,3
ZACATECAS,32,TLALTENANGO DE SÁNCHEZ ROMÁN,048,JESÚS MARÍA,3,35,18,17,3
ZACATECAS,32,TLALTENANGO DE SÁNCHEZ ROMÁN,048,LA ERA,2,16,8,8,2
ZACATECAS,32,TLALTENANGO DE SÁNCHEZ ROMÁN,048,LAS AZUCENAS,3,45,21,24,3
ZACATECAS,32,TLALTENANGO DE SÁNCHEZ ROMÁN,048,LAS HUERTAS,2,17,12,5,2
ZACATECAS,32,TLALTENANGO DE SÁNCHEZ ROMÁN,048,LAS MESITAS,3,22,6,16,3
ZACATECAS,32,TLALTENANGO DE SÁNCHEZ ROMÁN,048,LOS CARDOS,3,27,9,18,3
ZACATECAS,32,TLALTENANGO DE SÁNCHEZ ROMÁN,048,LOS FRESNOS,3,127,66,61,7
ZACATECAS,32,TLALTENANGO DE SÁNCHEZ ROMÁN,048,LOS GUAPOS,2,26,15,11,2
ZACATECAS,32,TLALTENANGO DE SÁNCHEZ ROMÁN,048,LOS LLAMAS,1,10,5,5,1
ZACATECAS,32,TLALTENANGO DE SÁNCHEZ ROMÁN,048,LOS RAMOS,3,50,25,25,4
ZACATECAS,32,TLALTENANGO DE SÁNCHEZ ROMÁN,048,LOS RANCHITOS,2,7,4,3,2
ZACATECAS,32,TLALTENANGO DE SÁNCHEZ ROMÁN,048,LOS SAUCES,2,14,7,7,2
ZACATECAS,32,TLALTENANGO DE SÁNCHEZ ROMÁN,048,LOS SEDANOS,3,31,19,12,3
ZACATECAS,32,TLALTENANGO DE SÁNCHEZ ROMÁN,048,MESA DE PALMIRA (MESA DE LA VIRGEN),3,53,30,23,4
ZACATECAS,32,TLALTENANGO DE SÁNCHEZ ROMÁN,048,MORONES,3,56,27,29,4
ZACATECAS,32,TLALTENANGO DE SÁNCHEZ ROMÁN,048,RINCÓN GRANDE,1,6,2,4,1
ZACATECAS,32,TLALTENANGO DE SÁNCHEZ ROMÁN,048,SALAZARES,3,88,48,40,4
ZACATECAS,32,TLALTENANGO DE SÁNCHEZ ROMÁN,048,SAN ANTONIO DE LA COFRADÍA,3,44,26,18,3
ZACATECAS,32,TLALTENANGO DE SÁNCHEZ ROMÁN,048,SAN JOSÉ DE VELADORES,2,22,11,11,2
ZACATECAS,32,TLALTENANGO DE SÁNCHEZ ROMÁN,048,SANTA GERTRUDIS (LA VICTORIA),1,5,3,2,1
ZACATECAS,32,TLALTENANGO DE SÁNCHEZ ROMÁN,048,SANTO NIÑO (LA SAUCEDA),2,34,14,20,3
ZACATECAS,32,TLALTENANGO DE SÁNCHEZ ROMÁN,048,TEOCALTICHE,3,51,30,21,4
ZACATECAS,32,TLALTENANGO DE SÁNCHEZ ROMÁN,048,TIERRAS MORADAS,1,5,3,2,1
ZACATECAS,32,TLALTENANGO DE SÁNCHEZ ROMÁN,048,TLALTENANGO DE SÁNCHEZ ROMÁN,27,6004,3136,2868,340
ZACATECAS,32,TLALTENANGO DE SÁNCHEZ ROMÁN,048,TOCATIC (SANTA ANA),3,116,51,65,7
ZACATECAS,32,TLALTENANGO DE SÁNCHEZ ROMÁN,048,VILLARREALES (SAN ISIDRO),5,110,53,57,7
ZACATECAS,32,VALPARAÍSO,049,ACATITA DE AMECA,3,43,15,28,3
ZACATECAS,32,VALPARAÍSO,049,ACATITA DE ARRIBA,3,37,18,19,3
ZACATECAS,32,VALPARAÍSO,049,AMECA (LA HACIENDA),4,119,67,52,8
ZACATECAS,32,VALPARAÍSO,049,AMECA EL VIEJO,3,35,18,17,3
ZACATECAS,32,VALPARAÍSO,049,ATOTONILCO,3,83,42,41,5
ZACATECAS,32,VALPARAÍSO,049,BOQUILLA DEL REFUGIO,3,36,14,22,4
ZACATECAS,32,VALPARAÍSO,049,CALERA DE SAN MIGUEL,3,32,18,14,3
ZACATECAS,32,VALPARAÍSO,049,CHALIGÜEY (NOGALITOS),2,41,21,20,3
ZACATECAS,32,VALPARAÍSO,049,CIÉNEGA DE PURÍSIMA,1,1,1,0,1
ZACATECAS,32,VALPARAÍSO,049,COLONIA MORELOS,3,59,25,34,4
ZACATECAS,32,VALPARAÍSO,049,CORRALITOS,3,41,24,17,3
ZACATECAS,32,VALPARAÍSO,049,CUEVA GRANDE,3,36,17,19,3
ZACATECAS,32,VALPARAÍSO,049,EL ASTILLERO,3,18,12,6,2
ZACATECAS,32,VALPARAÍSO,049,EL CHALIGÜEY,1,14,7,7,1
ZACATECAS,32,VALPARAÍSO,049,EL CRUCERO DE SANTA CRUZ,1,7,5,2,1
ZACATECAS,32,VALPARAÍSO,049,EL MIRADOR,3,21,15,6,3
ZACATECAS,32,VALPARAÍSO,049,EL PEINILLO,1,4,4,0,1
ZACATECAS,32,VALPARAÍSO,049,EL REFUGIO,1,13,4,9,1
ZACATECAS,32,VALPARAÍSO,049,EL REFUGIO (COYOTES),2,6,2,4,2
ZACATECAS,32,VALPARAÍSO,049,EL RESBALÓN,2,63,33,30,4
ZACATECAS,32,VALPARAÍSO,049,EL SALITRE,3,56,27,29,4
ZACATECAS,32,VALPARAÍSO,049,EL SAUZ DE LA SIERRA,2,9,4,5,1
ZACATECAS,32,VALPARAÍSO,049,EL SAUZ DE SAN MATEO (LOS SAUCES),2,8,2,6,1
ZACATECAS,32,VALPARAÍSO,049,EL TEJUJÁN,2,23,13,10,2
ZACATECAS,32,VALPARAÍSO,049,EL TULILLO,3,52,26,26,4
ZACATECAS,32,VALPARAÍSO,049,EL ZAPOTE,3,30,19,11,3
ZACATECAS,32,VALPARAÍSO,049,FELIPE ÁNGELES (PASTORES),3,26,11,15,3
ZACATECAS,32,VALPARAÍSO,049,J. JESÚS GONZÁLEZ ORTEGA (SAN MATEO),4,225,120,105,20
ZACATECAS,32,VALPARAÍSO,049,JAMAICA,2,26,10,16,2
ZACATECAS,32,VALPARAÍSO,049,LA FLORIDA,2,18,5,13,2
ZACATECAS,32,VALPARAÍSO,049,LA TORRECILLA,2,8,6,2,1
ZACATECAS,32,VALPARAÍSO,049,LA VICTORINA,2,9,4,5,1
ZACATECAS,32,VALPARAÍSO,049,LAS POMAS (LAS PALOMAS),2,20,9,11,2
ZACATECAS,32,VALPARAÍSO,049,LOBATOS,4,298,154,144,23
ZACATECAS,32,VALPARAÍSO,049,LOS CARACOLES,3,43,23,20,3
ZACATECAS,32,VALPARAÍSO,049,LOS TANQUES DE SANTA TERESA,3,36,17,19,3
ZACATECAS,32,VALPARAÍSO,049,LOS ZAPOTES,2,8,2,6,1
ZACATECAS,32,VALPARAÍSO,049,MALA NOCHE,3,43,23,20,3
ZACATECAS,32,VALPARAÍSO,049,MILPILLAS DE LA SIERRA,3,103,49,54,6
ZACATECAS,32,VALPARAÍSO,049,MIMBRES,3,89,43,46,6
ZACATECAS,32,VALPARAÍSO,049,PASO DE HUAZAMOTA,3,35,17,18,3
ZACATECAS,32,VALPARAÍSO,049,PEÑITAS DE SAN MATEO (PEÑITAS),3,64,29,35,4
ZACATECAS,32,VALPARAÍSO,049,POTRERO DE GALLEGOS,3,40,23,17,4
ZACATECAS,32,VALPARAÍSO,049,PRESA DEL ROSARITO,3,27,12,15,3
ZACATECAS,32,VALPARAÍSO,049,PUENTILLO,1,10,4,6,1
ZACATECAS,32,VALPARAÍSO,049,RANCHITO DEL TANQUE,2,30,14,16,3
ZACATECAS,32,VALPARAÍSO,049,RANCHO VIEJO,2,6,2,4,1
ZACATECAS,32,VALPARAÍSO,049,ROMERILLO DEL SUR (EL ROMERILLO),1,6,2,4,1
ZACATECAS,32,VALPARAÍSO,049,SAN ANTONIO DE PADUA,4,222,125,97,14
ZACATECAS,32,VALPARAÍSO,049,SAN DIEGO,1,4,2,2,1
ZACATECAS,32,VALPARAÍSO,049,SAN JOSÉ DE LLANETES,3,31,12,19,3
ZACATECAS,32,VALPARAÍSO,049,SAN JOSÉ DEL VERGEL (COLONIA SAN JOSÉ DEL VERGEL),4,142,70,72,9
ZACATECAS,32,VALPARAÍSO,049,SAN JUAN CAPISTRANO,3,121,59,62,7
ZACATECAS,32,VALPARAÍSO,049,SAN MARTÍN (SAN MARTÍN DE LA PALMA),3,60,28,32,4
ZACATECAS,32,VALPARAÍSO,049,SAN MIGUEL,3,109,61,48,6
ZACATECAS,32,VALPARAÍSO,049,SAN MIGUEL DE PAJARITOS,1,23,16,7,1
ZACATECAS,32,VALPARAÍSO,049,SAN PEDRO DE LA SIERRA,3,35,16,19,8
ZACATECAS,32,VALPARAÍSO,049,SAN RAFAEL DE LAS TABLAS,4,180,101,79,11
ZACATECAS,32,VALPARAÍSO,049,SANTA ANA DE ARRIBA,2,28,13,15,2
ZACATECAS,32,VALPARAÍSO,049,SANTA CRUZ DE TEPETATES,2,24,15,9,2
ZACATECAS,32,VALPARAÍSO,049,SANTA LUCÍA DE LA SIERRA,4,207,107,100,14
ZACATECAS,32,VALPARAÍSO,049,SANTA POTENCIANA DE ABAJO (CIANA DE ABAJO),2,36,13,23,3
ZACATECAS,32,VALPARAÍSO,049,SANTA POTENCIANA DE ARRIBA (CIANA DE ARRIBA),3,54,29,25,4
ZACATECAS,32,VALPARAÍSO,049,SANTA ROSA DE LIMA,3,43,20,23,3
ZACATECAS,32,VALPARAÍSO,049,TEJONES,3,26,13,13,3
ZACATECAS,32,VALPARAÍSO,049,TROJES,3,93,44,49,6
ZACATECAS,32,VALPARAÍSO,049,VALPARAÍSO,27,4324,2227,2097,267
ZACATECAS,32,VALPARAÍSO,049,XOCONOSTLE,3,72,33,39,5
ZACATECAS,32,VETAGRANDE,050,CATA DE JUANES,1,9,3,6,1
ZACATECAS,32,VETAGRANDE,050,EL LAMPOTAL,4,746,416,330,73
ZACATECAS,32,VETAGRANDE,050,EL LLANO DE LAS VÍRGENES,1,9,6,3,1
ZACATECAS,32,VETAGRANDE,050,GUADALUPITO,2,61,30,31,3
ZACATECAS,32,VETAGRANDE,050,LAS HUERTAS DE AMAYA,3,31,11,20,3
ZACATECAS,32,VETAGRANDE,050,LAS NORIAS,2,86,38,48,4
ZACATECAS,32,VETAGRANDE,050,SAN JOSÉ DE LA ERA,3,262,129,133,12
ZACATECAS,32,VETAGRANDE,050,SANTA RITA,2,383,185,198,17
ZACATECAS,32,VETAGRANDE,050,SAUCEDA DE LA BORDA,5,860,390,470,39
ZACATECAS,32,VETAGRANDE,050,VETAGRANDE,6,390,188,202,22
ZACATECAS,32,VILLA DE COS,051,AGUA NUEVA,2,31,13,18,2
ZACATECAS,32,VILLA DE COS,051,ALDEA DE CODORNICES (JESÚS MARÍA),2,20,8,12,2
ZACATECAS,32,VILLA DE COS,051,ALLENDE (SAN EUSEBIO),2,13,3,10,2
ZACATECAS,32,VILLA DE COS,051,BENITO JUÁREZ (SIERRA HERMOSA),4,45,22,23,4
ZACATECAS,32,VILLA DE COS,051,BENITO JUÁREZ UNO (SAN COSME),2,16,5,11,2
ZACATECAS,32,VILLA DE COS,051,CAÑAS,3,92,44,48,4
ZACATECAS,32,VILLA DE COS,051,CAPIROTE,3,25,16,9,3
ZACATECAS,32,VILLA DE COS,051,CERVANTES,3,88,45,43,5
ZACATECAS,32,VILLA DE COS,051,CHAPARROSA,7,1272,665,607,56
ZACATECAS,32,VILLA DE COS,051,CHARCO BLANCO (EL CHARCO BLANCO),3,115,61,54,6
ZACATECAS,32,VILLA DE COS,051,CHARQUILLOS,2,12,3,9,2
ZACATECAS,32,VILLA DE COS,051,CHUPADEROS,5,821,419,402,38
ZACATECAS,32,VILLA DE COS,051,COLONIA ALFONSO GARZÓN SANTIBÁÑEZ (EL MALEFICIO),3,62,21,41,4
ZACATECAS,32,VILLA DE COS,051,COLONIA GREVER (PURÍSIMA),2,15,6,9,2
ZACATECAS,32,VILLA DE COS,051,EFIGENIA,4,141,73,68,10
ZACATECAS,32,VILLA DE COS,051,EL ENCINO,2,11,2,9,2
ZACATECAS,32,VILLA DE COS,051,EL PARDILLO,3,108,43,65,6
ZACATECAS,32,VILLA DE COS,051,EL RUCIO,4,391,204,187,23
ZACATECAS,32,VILLA DE COS,051,EL SOCORRO,3,23,16,7,3
ZACATECAS,32,VILLA DE COS,051,EL ZAPOTE,2,12,9,3,1
ZACATECAS,32,VILLA DE COS,051,EMILIANO ZAPATA (SAN ANTONIO DEL BURRO),4,219,99,120,12
ZACATECAS,32,VILLA DE COS,051,ESTANCIA LA COLORADA,3,37,17,20,3
ZACATECAS,32,VILLA DE COS,051,FELIPE CARRILLO PUERTO (CARRILLO),3,28,13,15,3
ZACATECAS,32,VILLA DE COS,051,GONZÁLEZ ORTEGA (BAÑÓN),7,1580,804,776,72
ZACATECAS,32,VILLA DE COS,051,GUADALUPE DE LAS CORRIENTES,3,131,63,68,7
ZACATECAS,32,VILLA DE COS,051,LA ABUNDANCIA,3,32,13,19,3
ZACATECAS,32,VILLA DE COS,051,LA CAMPECHANA,3,34,13,21,3
ZACATECAS,32,VILLA DE COS,051,LA COLORADA [ESTACIÓN DE FERROCARRIL],4,273,131,142,14
ZACATECAS,32,VILLA DE COS,051,LA LUZ,2,99,45,54,6
ZACATECAS,32,VILLA DE COS,051,LA PRIETA,4,203,104,99,13
ZACATECAS,32,VILLA DE COS,051,LAS CANOAS,2,7,3,4,2
ZACATECAS,32,VILLA DE COS,051,LOS AMARILLOS (LAS AURAS),2,11,7,4,2
ZACATECAS,32,VILLA DE COS,051,LOS CHARCOS [RANCHO],2,24,14,10,2
ZACATECAS,32,VILLA DE COS,051,MANGANITA,3,88,40,48,5
ZACATECAS,32,VILLA DE COS,051,MARIANA,3,15,5,10,3
ZACATECAS,32,VILLA DE COS,051,MEZQUITILLO,4,191,85,106,12
ZACATECAS,32,VILLA DE COS,051,NORIA DE LUIS,3,82,40,42,4
ZACATECAS,32,VILLA DE COS,051,NORIA DEL BURRO,2,18,7,11,2
ZACATECAS,32,VILLA DE COS,051,NUEVA PASTORÍA (LAS PEÑITAS),3,99,45,54,6
ZACATECAS,32,VILLA DE COS,051,PABELLÓN (DOLORES),3,29,13,16,3
ZACATECAS,32,VILLA DE COS,051,POZO HONDO,3,37,18,19,3
ZACATECAS,32,VILLA DE COS,051,PRIMERO DE MAYO (SAN JUAN DE ULÚA),3,66,38,28,4
ZACATECAS,32,VILLA DE COS,051,PUERTO DE SIGALA,3,48,21,27,3
ZACATECAS,32,VILLA DE COS,051,PUERTO MADERO (ESTANCIA DE SAN ANDRÉS),3,57,32,25,4
ZACATECAS,32,VILLA DE COS,051,RUCIO DOS,2,15,9,6,2
ZACATECAS,32,VILLA DE COS,051,SAN ANTONIO DE LA ROSA (SAN ANTONIO),3,65,35,30,5
ZACATECAS,32,VILLA DE COS,051,SAN FELIPE,2,35,10,25,2
ZACATECAS,32,VILLA DE COS,051,SAN RAMÓN,3,134,73,61,7
ZACATECAS,32,VILLA DE COS,051,SARTENEJA,3,92,45,47,5
ZACATECAS,32,VILLA DE COS,051,SIERRA VIEJA,3,48,26,22,4
ZACATECAS,32,VILLA DE COS,051,TIERRA Y LIBERTAD (SAN BLAS),3,122,57,65,7
ZACATECAS,32,VILLA DE COS,051,VICENTE GUERRERO,3,41,23,18,3
ZACATECAS,32,VILLA DE COS,051,VILLA DE COS,10,1883,972,911,97
ZACATECAS,32,VILLA GARCÍA,052,AGUA GORDA,4,275,115,160,14
ZACATECAS,32,VILLA GARCÍA,052,AGUA GORDITA,3,228,128,100,11
ZACATECAS,32,VILLA GARCÍA,052,BENITO JUÁREZ (COYOTES),3,117,51,66,5
ZACATECAS,32,VILLA GARCÍA,052,EL BAUTISMO,2,18,5,13,2
ZACATECAS,32,VILLA GARCÍA,052,EL COPETILLO,3,426,205,221,23
ZACATECAS,32,VILLA GARCÍA,052,EL RAYO,1,4,1,3,1
ZACATECAS,32,VILLA GARCÍA,052,EL TANQUE DE PINO,2,32,17,15,2
ZACATECAS,32,VILLA GARCÍA,052,EL TEPETATILLO,1,18,10,8,1
ZACATECAS,32,VILLA GARCÍA,052,EMILIANO ZAPATA (ARREBIATADAS),2,31,13,18,2
ZACATECAS,32,VILLA GARCÍA,052,FRANCISCO I. MADERO (AGUAS MUERTAS),3,31,17,14,3
ZACATECAS,32,VILLA GARCÍA,052,GRANADAS,4,405,184,221,20
ZACATECAS,32,VILLA GARCÍA,052,IGNACIO ZARAGOZA (SAN IGNACIO),2,39,20,19,3
ZACATECAS,32,VILLA GARCÍA,052,LA MILPA,2,23,14,9,2
ZACATECAS,32,VILLA GARCÍA,052,LA MONTESA,3,115,67,48,6
ZACATECAS,32,VILLA GARCÍA,052,LA PUERTA DE JALISCO,1,36,19,17,2
ZACATECAS,32,VILLA GARCÍA,052,LAS CRUCES,1,7,2,5,1
ZACATECAS,32,VILLA GARCÍA,052,LOS CAMPOS,4,800,376,424,37
ZACATECAS,32,VILLA GARCÍA,052,LOS HORCONES,2,20,5,15,2
ZACATECAS,32,VILLA GARCÍA,052,LOS PLANES,1,5,2,3,1
ZACATECAS,32,VILLA GARCÍA,052,PRESA DEL CAPULÍN,2,51,26,25,3
ZACATECAS,32,VILLA GARCÍA,052,RANCHO NUEVO,3,103,56,47,5
ZACATECAS,32,VILLA GARCÍA,052,TIERRITAS BLANCAS,3,176,92,84,14
ZACATECAS,32,VILLA GARCÍA,052,UNIÓN Y PROGRESO,3,117,58,59,5
ZACATECAS,32,VILLA GARCÍA,052,VILLA GARCÍA,9,2119,1062,1057,99
ZACATECAS,32,VILLA GONZÁLEZ ORTEGA,053,BAJÍO DE SAN NICOLÁS (SAN NICOLÁS),4,592,297,295,29
ZACATECAS,32,VILLA GONZÁLEZ ORTEGA,053,CERRITO DEL AGUA,1,72,35,37,4
ZACATECAS,32,VILLA GONZÁLEZ ORTEGA,053,COLONIA DIEZ DE NOVIEMBRE (EL CAMPAMENTO),4,293,154,139,15
ZACATECAS,32,VILLA GONZÁLEZ ORTEGA,053,COLONIA LOS RIVERA (EL PALMAREJO),2,29,18,11,3
ZACATECAS,32,VILLA GONZÁLEZ ORTEGA,053,EL REFUGIO DEL ZACATE,3,68,32,36,4
ZACATECAS,32,VILLA GONZÁLEZ ORTEGA,053,ESTANCIA DE ÁNIMAS,7,821,435,386,87
ZACATECAS,32,VILLA GONZÁLEZ ORTEGA,053,LAGUNA GRANDE,3,29,14,15,4
ZACATECAS,32,VILLA GONZÁLEZ ORTEGA,053,SAN ANTONIO DE LAS HUERTAS,3,26,11,15,3
ZACATECAS,32,VILLA GONZÁLEZ ORTEGA,053,SAN DIONISIO,3,120,55,65,7
ZACATECAS,32,VILLA GONZÁLEZ ORTEGA,053,VILLA GONZÁLEZ ORTEGA,9,1764,896,868,82
ZACATECAS,32,VILLA HIDALGO,054,CABALLERÍAS (CABALLERÍA VILLA HIDALGO),3,227,111,116,11
ZACATECAS,32,VILLA HIDALGO,054,CANOAS,4,149,87,62,9
ZACATECAS,32,VILLA HIDALGO,054,CERRO PRIETO,3,66,30,36,4
ZACATECAS,32,VILLA HIDALGO,054,COLONIA JOSÉ MARÍA MORELOS,3,450,247,203,22
ZACATECAS,32,VILLA HIDALGO,054,COLONIA JUÁREZ,1,5,1,4,1
ZACATECAS,32,VILLA HIDALGO,054,EL MAGUEY,3,179,86,93,9
ZACATECAS,32,VILLA HIDALGO,054,EL REFUGIO,4,601,302,299,27
ZACATECAS,32,VILLA HIDALGO,054,EL SALITRE,3,205,100,105,11
ZACATECAS,32,VILLA HIDALGO,054,EL SOTOLILLO,3,76,37,39,5
ZACATECAS,32,VILLA HIDALGO,054,EL TEPETATE,3,151,73,78,8
ZACATECAS,32,VILLA HIDALGO,054,EL VERDE (EL SOCORRO),2,30,11,19,2
ZACATECAS,32,VILLA HIDALGO,054,FRACCIONAMIENTO VICTORIA (LA VICTORIA),3,209,106,103,9
ZACATECAS,32,VILLA HIDALGO,054,LA BALLENA,4,534,275,259,26
ZACATECAS,32,VILLA HIDALGO,054,LA CERCA (CAN CAN),3,112,59,53,5
ZACATECAS,32,VILLA HIDALGO,054,LA LAGUNITA,3,147,63,84,7
ZACATECAS,32,VILLA HIDALGO,054,LOS DÁVILA,3,32,17,15,3
ZACATECAS,32,VILLA HIDALGO,054,LOS REYES,3,114,58,56,6
ZACATECAS,32,VILLA HIDALGO,054,MONTE GRANDE,3,71,35,36,4
ZACATECAS,32,VILLA HIDALGO,054,PRESA DE VALENZUELA (LAGUNA DE VALENZUELA),3,198,102,96,11
ZACATECAS,32,VILLA HIDALGO,054,PROVIDENCIA,3,275,144,131,13
ZACATECAS,32,VILLA HIDALGO,054,PURÍSIMA DEL RUCIO (EL RUCIO),4,231,126,105,11
ZACATECAS,32,VILLA HIDALGO,054,SAN AGUSTÍN,3,77,41,36,4
ZACATECAS,32,VILLA HIDALGO,054,SAN ANTONIO DE LA CRUZ,3,18,13,5,3
ZACATECAS,32,VILLA HIDALGO,054,SAN ANTONIO DEL BAJÍO (PUERTO DE PALMAS),2,46,19,27,3
ZACATECAS,32,VILLA HIDALGO,054,VILLA HIDALGO,7,1435,756,679,112
ZACATECAS,32,VILLA HIDALGO,054,VILLANUEVA,3,78,40,38,4
ZACATECAS,32,VILLA HIDALGO,054,ZONA BENITO JUÁREZ (BENITO JUÁREZ),3,54,29,25,4
ZACATECAS,32,VILLANUEVA,055,ADJUNTAS DEL REFUGIO (LAS ADJUNTAS),3,40,17,23,3
ZACATECAS,32,VILLANUEVA,055,ATITANAC,3,82,44,38,5
ZACATECAS,32,VILLANUEVA,055,BOCA DE RIVERA,3,65,30,35,4
ZACATECAS,32,VILLANUEVA,055,COLONIA ADOLFO LÓPEZ MATEOS (MAJADAS),3,29,17,12,3
ZACATECAS,32,VILLANUEVA,055,COLONIA DEL CARMEN (LA BOQUILLA),3,39,19,20,3
ZACATECAS,32,VILLANUEVA,055,COLONIA EMILIANO ZAPATA (EL JARAL),2,21,12,9,2
ZACATECAS,32,VILLANUEVA,055,COLONIA FELIPE ÁNGELES,4,250,123,127,12
ZACATECAS,32,VILLANUEVA,055,COLONIA LÁZARO CÁRDENAS,3,23,10,13,3
ZACATECAS,32,VILLANUEVA,055,COLONIA PEDRO RUIZ GONZÁLEZ (LA MAGUEYERA),2,10,5,5,2
ZACATECAS,32,VILLANUEVA,055,EL FUERTE,3,178,89,89,8
ZACATECAS,32,VILLANUEVA,055,EL JAGÜEY,3,61,33,28,4
ZACATECAS,32,VILLANUEVA,055,EL PANTANO,3,39,19,20,3
ZACATECAS,32,VILLANUEVA,055,EL SALTO,3,105,50,55,4
ZACATECAS,32,VILLANUEVA,055,EL TIGRE,3,123,59,64,6
ZACATECAS,32,VILLANUEVA,055,EL UNCIDERO (EL REFUGIO),3,24,17,7,3
ZACATECAS,32,VILLANUEVA,055,EL VERGEL,2,15,8,7,2
ZACATECAS,32,VILLANUEVA,055,FRANCISCO I. MADERO (SANTA ROSA),3,47,20,27,4
ZACATECAS,32,VILLANUEVA,055,FRANCISCO VILLA (EL CABALLETE),3,101,48,53,5
ZACATECAS,32,VILLANUEVA,055,GENERAL FRANCISCO MURGUÍA,3,52,23,29,4
ZACATECAS,32,VILLANUEVA,055,LA ENCARNACIÓN,4,131,66,65,8
ZACATECAS,32,VILLANUEVA,055,LA QUEMADA (HACIENDA LA QUEMADA),5,261,118,143,16
ZACATECAS,32,VILLANUEVA,055,LAGUNA DE LAS ROSAS (LA LAGUNA),2,2,0,2,1
ZACATECAS,32,VILLANUEVA,055,LAGUNA DEL CARRETERO,3,55,33,22,4
ZACATECAS,32,VILLANUEVA,055,LOS CAÑOS,3,36,18,18,3
ZACATECAS,32,VILLANUEVA,055,MALPASO,8,959,498,461,60
ZACATECAS,32,VILLANUEVA,055,MARAVILLAS,3,30,13,17,3
ZACATECAS,32,VILLANUEVA,055,PALOMAS VIEJAS (SAN FRANCISCO DE LA SIERRA),2,21,9,12,2
ZACATECAS,32,VILLANUEVA,055,PRESA DE MARAVILLAS,2,17,8,9,2
ZACATECAS,32,VILLANUEVA,055,SAN DIEGO,3,32,14,18,3
ZACATECAS,32,VILLANUEVA,055,SAN JOSÉ,1,7,5,2,1
ZACATECAS,32,VILLANUEVA,055,SAN MIGUEL,3,38,17,21,3
ZACATECAS,32,VILLANUEVA,055,TARASCO (SAN ANTONIO DE TARASCO),3,123,62,61,7
ZACATECAS,32,VILLANUEVA,055,TAYAHUA (SAN JOSÉ DE TAYAHUA),6,538,277,261,41
ZACATECAS,32,VILLANUEVA,055,TENANGO,1,12,3,9,1
ZACATECAS,32,VILLANUEVA,055,VILLANUEVA,19,3345,1721,1624,211
ZACATECAS,32,VILLANUEVA,055,ZAPOQUI,3,26,17,9,3
ZACATECAS,32,ZACATECAS,056,BENITO JUÁREZ (SAN CAYETANO),4,215,122,93,12
ZACATECAS,32,ZACATECAS,056,CALERILLA,2,5,2,3,1
ZACATECAS,32,ZACATECAS,056,CIENEGUILLAS,4,1461,583,878,76
ZACATECAS,32,ZACATECAS,056,EL MAGUEY,3,85,41,44,4
ZACATECAS,32,ZACATECAS,056,EL MOLINO,3,69,33,36,4
ZACATECAS,32,ZACATECAS,056,FRANCISCO I. MADERO,6,205,97,108,13
ZACATECAS,32,ZACATECAS,056,GARCÍA DE LA CADENA (EL VISITADOR),3,145,78,67,7
ZACATECAS,32,ZACATECAS,056,GONZÁLEZ ORTEGA (MACHINES),4,260,123,137,14
ZACATECAS,32,ZACATECAS,056,LA PIMIENTA,3,182,84,98,10
ZACATECAS,32,ZACATECAS,056,LA SOLEDAD (LA CHOLE),3,61,24,37,5
ZACATECAS,32,ZACATECAS,056,LAS BOQUILLAS,3,91,49,42,4
ZACATECAS,32,ZACATECAS,056,LAS CHILITAS,3,104,53,51,5
ZACATECAS,32,ZACATECAS,056,MIGUEL HIDALGO (SAN MIGUEL),3,58,29,29,4
ZACATECAS,32,ZACATECAS,056,OJO DE AGUA DE MELÉNDEZ (OJO DE AGUA),2,24,10,14,3
ZACATECAS,32,ZACATECAS,056,PICONES,3,251,116,135,15
ZACATECAS,32,ZACATECAS,056,RANCHO NUEVO,3,85,48,37,4
ZACATECAS,32,ZACATECAS,056,SAN ANTONIO DE LOS NEGROS (LOS NEGROS),1,11,8,3,1
ZACATECAS,32,ZACATECAS,056,ZACATECAS,254,71762,38333,33429,5355
ZACATECAS,32,TRANCOSO,057,EL PORVENIR,4,295,153,142,16
ZACATECAS,32,TRANCOSO,057,LA BLANQUITA,3,151,84,67,8
ZACATECAS,32,TRANCOSO,057,LOS INSURGENTES (LA PUERTA DE FIERRO),1,6,3,3,1
ZACATECAS,32,TRANCOSO,057,RUBÉN JARAMILLO (LA CHIRIPA),3,115,53,62,6
ZACATECAS,32,TRANCOSO,057,SAN JOSÉ DEL CARMEN,4,455,232,223,22
ZACATECAS,32,TRANCOSO,057,SAN SALVADOR DEL BAJÍO,3,55,24,31,4
ZACATECAS,32,TRANCOSO,057,SANTA ROSA DE LIMA,2,14,10,4,2
ZACATECAS,32,TRANCOSO,057,TRANCOSO,25,4784,2417,2367,196
ZACATECAS,32,SANTA MARÍA DE LA PAZ,058,EL PICACHO (HIDALGO),3,15,6,9,3
ZACATECAS,32,SANTA MARÍA DE LA PAZ,058,EL SOTO,3,30,12,18,3
ZACATECAS,32,SANTA MARÍA DE LA PAZ,058,HACIENDA VIEJA,2,8,6,2,1
ZACATECAS,32,SANTA MARÍA DE LA PAZ,058,LAS TABLAS,3,14,6,8,2
ZACATECAS,32,SANTA MARÍA DE LA PAZ,058,LOS TRIGOS (MESA DE LOS TRIGOS),2,16,9,7,2
ZACATECAS,32,SANTA MARÍA DE LA PAZ,058,MESA GRANDE,3,46,28,18,4
ZACATECAS,32,SANTA MARÍA DE LA PAZ,058,SAN MIGUEL TEPETITLÁN,1,20,9,11,1
ZACATECAS,32,SANTA MARÍA DE LA PAZ,058,SANTA MARÍA DE LA PAZ,4,545,272,273,32